"job_name";"taxonomy";"coverage";"specificity";"accessions";"eligible";"match";"mismatch";"nodata";"outgroup_matchable";"outgroup_matched"
"V4mis2";"SILVA (only NR);Unclassified;";"0.0";"0";"0";"0";"0";"0";"0";"457183";"391207"
"V4mis2";"SILVA (only NR);Archaea;";"95.9";"14.9";"20197";"19983";"19158";"825";"214";"437200";"372049"
"V4mis2";"SILVA (only NR);Archaea;Aenigmarchaeota;";"89.8";"14.4";"319";"313";"281";"32";"6";"456870";"390926"
"V4mis2";"SILVA (only NR);Archaea;Aenigmarchaeota;Aenigmarchaeia;";"93.5";"14.4";"161";"155";"145";"10";"6";"457028";"391062"
"V4mis2";"SILVA (only NR);Archaea;Aenigmarchaeota;Aenigmarchaeia;Aenigmarchaeales;";"93.5";"14.4";"161";"155";"145";"10";"6";"457028";"391062"
"V4mis2";"SILVA (only NR);Archaea;Aenigmarchaeota;Aenigmarchaeia;Aenigmarchaeales;Candidatus Aenigmarchaeum;";"87.5";"14.4";"16";"16";"14";"2";"0";"457167";"391193"
"V4mis2";"SILVA (only NR);Archaea;Aenigmarchaeota;Deep Sea Euryarchaeotic Group(DSEG);";"85.8";"14.4";"155";"155";"133";"22";"0";"457028";"391074"
"V4mis2";"SILVA (only NR);Archaea;Altiarchaeota;";"100.0";"14.4";"41";"40";"40";"0";"1";"457143";"391167"
"V4mis2";"SILVA (only NR);Archaea;Altiarchaeota;Altiarchaeia;";"100.0";"14.4";"41";"40";"40";"0";"1";"457143";"391167"
"V4mis2";"SILVA (only NR);Archaea;Altiarchaeota;Altiarchaeia;Altiarchaeales;";"100.0";"14.4";"41";"40";"40";"0";"1";"457143";"391167"
"V4mis2";"SILVA (only NR);Archaea;Altiarchaeota;Altiarchaeia;Altiarchaeales;Altiarchaeaceae;";"100.0";"14.4";"41";"40";"40";"0";"1";"457143";"391167"
"V4mis2";"SILVA (only NR);Archaea;Altiarchaeota;Altiarchaeia;Altiarchaeales;Altiarchaeaceae;Candidatus Altiarchaeum;";"100.0";"14.4";"41";"40";"40";"0";"1";"457143";"391167"
"V4mis2";"SILVA (only NR);Archaea;Asgardarchaeota;";"89.9";"14.4";"670";"661";"594";"67";"9";"456522";"390613"
"V4mis2";"SILVA (only NR);Archaea;Asgardarchaeota;Heimdallarchaeia;";"95.3";"14.4";"45";"43";"41";"2";"2";"457140";"391166"
"V4mis2";"SILVA (only NR);Archaea;Asgardarchaeota;Lokiarchaeia;";"88.9";"14.4";"527";"524";"466";"58";"3";"456659";"390741"
"V4mis2";"SILVA (only NR);Archaea;Asgardarchaeota;Odinarchaeia;";"93.4";"14.4";"95";"91";"85";"6";"4";"457092";"391122"
"V4mis2";"SILVA (only NR);Archaea;Crenarchaeota;";"96.9";"14.6";"7625";"7552";"7321";"231";"73";"449631";"383886"
"V4mis2";"SILVA (only NR);Archaea;Crenarchaeota;Bathyarchaeia;";"98.0";"14.5";"3641";"3604";"3532";"72";"37";"453579";"387675"
"V4mis2";"SILVA (only NR);Archaea;Crenarchaeota;Methanomethylicia;";"97.1";"14.4";"34";"34";"33";"1";"0";"457149";"391174"
"V4mis2";"SILVA (only NR);Archaea;Crenarchaeota;Methanomethylicia;Methanomethyliales;";"97.1";"14.4";"34";"34";"33";"1";"0";"457149";"391174"
"V4mis2";"SILVA (only NR);Archaea;Crenarchaeota;Methanomethylicia;Methanomethyliales;Methanomethyliaceae;";"97.1";"14.4";"34";"34";"33";"1";"0";"457149";"391174"
"V4mis2";"SILVA (only NR);Archaea;Crenarchaeota;Methanomethylicia;Methanomethyliales;Methanomethyliaceae;Candidatus Methanomethylicus;";"96.4";"14.4";"28";"28";"27";"1";"0";"457155";"391180"
"V4mis2";"SILVA (only NR);Archaea;Crenarchaeota;Nitrososphaeria;";"95.8";"14.5";"3259";"3225";"3088";"137";"34";"453958";"388119"
"V4mis2";"SILVA (only NR);Archaea;Crenarchaeota;Nitrososphaeria;Caldiarchaeales;";"97.6";"14.4";"170";"170";"166";"4";"0";"457013";"391041"
"V4mis2";"SILVA (only NR);Archaea;Crenarchaeota;Nitrososphaeria;Caldiarchaeales;Caldiarchaeaceae;";"98.3";"14.4";"58";"58";"57";"1";"0";"457125";"391150"
"V4mis2";"SILVA (only NR);Archaea;Crenarchaeota;Nitrososphaeria;Caldiarchaeales;Caldiarchaeaceae;Candidatus Caldiarchaeum;";"98.3";"14.4";"58";"58";"57";"1";"0";"457125";"391150"
"V4mis2";"SILVA (only NR);Archaea;Crenarchaeota;Nitrososphaeria;Caldiarchaeales;Geothermarchaeaceae;";"97.0";"14.4";"66";"66";"64";"2";"0";"457117";"391143"
"V4mis2";"SILVA (only NR);Archaea;Crenarchaeota;Nitrososphaeria;Caldiarchaeales;Terrestrial Hot Spring Gp(THSCG);";"97.8";"14.4";"46";"46";"45";"1";"0";"457137";"391162"
"V4mis2";"SILVA (only NR);Archaea;Crenarchaeota;Nitrososphaeria;Group 1.1c;";"97.4";"14.4";"233";"231";"225";"6";"2";"456952";"390982"
"V4mis2";"SILVA (only NR);Archaea;Crenarchaeota;Nitrososphaeria;Marine Benthic Group A;";"98.4";"14.4";"131";"128";"126";"2";"3";"457055";"391081"
"V4mis2";"SILVA (only NR);Archaea;Crenarchaeota;Nitrososphaeria;Nitrosocaldales;";"97.3";"14.4";"37";"37";"36";"1";"0";"457146";"391171"
"V4mis2";"SILVA (only NR);Archaea;Crenarchaeota;Nitrososphaeria;Nitrosocaldales;Nitrosocaldaceae;";"97.3";"14.4";"37";"37";"36";"1";"0";"457146";"391171"
"V4mis2";"SILVA (only NR);Archaea;Crenarchaeota;Nitrososphaeria;Nitrosocaldales;Nitrosocaldaceae;Candidatus Nitrosocaldus;";"94.4";"14.4";"18";"18";"17";"1";"0";"457165";"391190"
"V4mis2";"SILVA (only NR);Archaea;Crenarchaeota;Nitrososphaeria;Nitrosocaldales;Nitrosocaldaceae;uncultured;";"100.0";"14.4";"19";"19";"19";"0";"0";"457164";"391188"
"V4mis2";"SILVA (only NR);Archaea;Crenarchaeota;Nitrososphaeria;Nitrosopumilales;";"96.0";"14.5";"1831";"1810";"1738";"72";"21";"455373";"389469"
"V4mis2";"SILVA (only NR);Archaea;Crenarchaeota;Nitrososphaeria;Nitrosopumilales;Nitrosopumilaceae;";"96.0";"14.5";"1831";"1810";"1738";"72";"21";"455373";"389469"
"V4mis2";"SILVA (only NR);Archaea;Crenarchaeota;Nitrososphaeria;Nitrosopumilales;Nitrosopumilaceae;Candidatus Nitrosopelagicus;";"100.0";"14.4";"51";"49";"49";"0";"2";"457134";"391158"
"V4mis2";"SILVA (only NR);Archaea;Crenarchaeota;Nitrososphaeria;Nitrosopumilales;Nitrosopumilaceae;Candidatus Nitrosopumilus;";"94.0";"14.4";"717";"712";"669";"43";"5";"456471";"390538"
"V4mis2";"SILVA (only NR);Archaea;Crenarchaeota;Nitrososphaeria;Nitrosopumilales;Nitrosopumilaceae;Candidatus Nitrosotenuis;";"90.6";"14.4";"34";"32";"29";"3";"2";"457151";"391178"
"V4mis2";"SILVA (only NR);Archaea;Crenarchaeota;Nitrososphaeria;Nitrosopumilales;Nitrosopumilaceae;Cenarchaeum;";"96.3";"14.4";"27";"27";"26";"1";"0";"457156";"391181"
"V4mis2";"SILVA (only NR);Archaea;Crenarchaeota;Nitrososphaeria;Nitrosopumilales;Nitrosopumilaceae;Nitrosarchaeum;";"95.2";"14.4";"63";"63";"60";"3";"0";"457120";"391147"
"V4mis2";"SILVA (only NR);Archaea;Crenarchaeota;Nitrososphaeria;Nitrososphaerales;";"93.1";"14.4";"603";"598";"557";"41";"5";"456585";"390650"
"V4mis2";"SILVA (only NR);Archaea;Crenarchaeota;Nitrososphaeria;Nitrososphaerales;Nitrososphaeraceae;";"93.1";"14.4";"603";"598";"557";"41";"5";"456585";"390650"
"V4mis2";"SILVA (only NR);Archaea;Crenarchaeota;Nitrososphaeria;Nitrososphaerales;Nitrososphaeraceae;Candidatus Nitrocosmicus;";"93.9";"14.4";"49";"49";"46";"3";"0";"457134";"391161"
"V4mis2";"SILVA (only NR);Archaea;Crenarchaeota;Nitrososphaeria;Nitrososphaerales;Nitrososphaeraceae;Candidatus Nitrososphaera;";"89.1";"14.4";"233";"230";"205";"25";"3";"456953";"391002"
"V4mis2";"SILVA (only NR);Archaea;Crenarchaeota;Nitrososphaeria;Nitrosotaleales;";"95.0";"14.4";"141";"139";"132";"7";"2";"457044";"391075"
"V4mis2";"SILVA (only NR);Archaea;Crenarchaeota;Nitrososphaeria;Nitrosotaleales;Nitrosotaleaceae;";"95.0";"14.4";"141";"139";"132";"7";"2";"457044";"391075"
"V4mis2";"SILVA (only NR);Archaea;Crenarchaeota;Nitrososphaeria;Nitrosotaleales;Nitrosotaleaceae;Candidatus Nitrosotalea;";"94.1";"14.4";"17";"17";"16";"1";"0";"457166";"391191"
"V4mis2";"SILVA (only NR);Archaea;Crenarchaeota;Nitrososphaeria;SCGC AB-179-E04;";"98.2";"14.4";"57";"56";"55";"1";"1";"457127";"391152"
"V4mis2";"SILVA (only NR);Archaea;Crenarchaeota;Nitrososphaeria;uncultured;";"94.6";"14.4";"56";"56";"53";"3";"0";"457127";"391154"
"V4mis2";"SILVA (only NR);Archaea;Crenarchaeota;Thermoprotei;";"97.0";"14.4";"691";"689";"668";"21";"2";"456494";"390539"
"V4mis2";"SILVA (only NR);Archaea;Crenarchaeota;Thermoprotei;Desulfurococcales;";"97.7";"14.4";"219";"219";"214";"5";"0";"456964";"390993"
"V4mis2";"SILVA (only NR);Archaea;Crenarchaeota;Thermoprotei;Desulfurococcales;Acidilobaceae;";"98.6";"14.4";"71";"71";"70";"1";"0";"457112";"391137"
"V4mis2";"SILVA (only NR);Archaea;Crenarchaeota;Thermoprotei;Desulfurococcales;Acidilobaceae;Acidilobus;";"90.0";"14.4";"10";"10";"9";"1";"0";"457173";"391198"
"V4mis2";"SILVA (only NR);Archaea;Crenarchaeota;Thermoprotei;Desulfurococcales;Acidilobaceae;Aeropyrum;";"100.0";"14.4";"27";"27";"27";"0";"0";"457156";"391180"
"V4mis2";"SILVA (only NR);Archaea;Crenarchaeota;Thermoprotei;Desulfurococcales;Acidilobaceae;Caldisphaera;";"100.0";"14.4";"13";"13";"13";"0";"0";"457170";"391194"
"V4mis2";"SILVA (only NR);Archaea;Crenarchaeota;Thermoprotei;Desulfurococcales;Acidilobaceae;Stetteria;";"100.0";"14.4";"4";"4";"4";"0";"0";"457179";"391203"
"V4mis2";"SILVA (only NR);Archaea;Crenarchaeota;Thermoprotei;Desulfurococcales;Acidilobaceae;Thermodiscus;";"100.0";"14.4";"12";"12";"12";"0";"0";"457171";"391195"
"V4mis2";"SILVA (only NR);Archaea;Crenarchaeota;Thermoprotei;Desulfurococcales;Desulfurococcaceae;";"97.7";"14.4";"44";"44";"43";"1";"0";"457139";"391164"
"V4mis2";"SILVA (only NR);Archaea;Crenarchaeota;Thermoprotei;Desulfurococcales;Desulfurococcaceae;Desulfurococcus;";"100.0";"14.4";"9";"9";"9";"0";"0";"457174";"391198"
"V4mis2";"SILVA (only NR);Archaea;Crenarchaeota;Thermoprotei;Desulfurococcales;Desulfurococcaceae;Staphylothermus;";"100.0";"14.4";"16";"16";"16";"0";"0";"457167";"391191"
"V4mis2";"SILVA (only NR);Archaea;Crenarchaeota;Thermoprotei;Desulfurococcales;Desulfurococcaceae;Sulfophobococcus;";"100.0";"14.4";"1";"1";"1";"0";"0";"457182";"391206"
"V4mis2";"SILVA (only NR);Archaea;Crenarchaeota;Thermoprotei;Desulfurococcales;Desulfurococcaceae;Thermogladius;";"100.0";"14.4";"4";"4";"4";"0";"0";"457179";"391203"
"V4mis2";"SILVA (only NR);Archaea;Crenarchaeota;Thermoprotei;Desulfurococcales;Desulfurococcaceae;Thermosphaera;";"88.9";"14.4";"9";"9";"8";"1";"0";"457174";"391199"
"V4mis2";"SILVA (only NR);Archaea;Crenarchaeota;Thermoprotei;Desulfurococcales;Desulfurococcaceae;uncultured;";"100.0";"14.4";"3";"3";"3";"0";"0";"457180";"391204"
"V4mis2";"SILVA (only NR);Archaea;Crenarchaeota;Thermoprotei;Desulfurococcales;Ignicoccaceae;";"90.9";"14.4";"11";"11";"10";"1";"0";"457172";"391197"
"V4mis2";"SILVA (only NR);Archaea;Crenarchaeota;Thermoprotei;Desulfurococcales;Ignicoccaceae;Ignicoccus;";"90.9";"14.4";"11";"11";"10";"1";"0";"457172";"391197"
"V4mis2";"SILVA (only NR);Archaea;Crenarchaeota;Thermoprotei;Desulfurococcales;Ignisphaeraceae;";"98.1";"14.4";"54";"54";"53";"1";"0";"457129";"391154"
"V4mis2";"SILVA (only NR);Archaea;Crenarchaeota;Thermoprotei;Desulfurococcales;Ignisphaeraceae;Ignisphaera;";"100.0";"14.4";"29";"29";"29";"0";"0";"457154";"391178"
"V4mis2";"SILVA (only NR);Archaea;Crenarchaeota;Thermoprotei;Desulfurococcales;Ignisphaeraceae;uncultured;";"95.8";"14.4";"24";"24";"23";"1";"0";"457159";"391184"
"V4mis2";"SILVA (only NR);Archaea;Crenarchaeota;Thermoprotei;Desulfurococcales;Pyrodictiaceae;";"96.7";"14.4";"30";"30";"29";"1";"0";"457153";"391178"
"V4mis2";"SILVA (only NR);Archaea;Crenarchaeota;Thermoprotei;Desulfurococcales;Pyrodictiaceae;Hyperthermus;";"100.0";"14.4";"3";"3";"3";"0";"0";"457180";"391204"
"V4mis2";"SILVA (only NR);Archaea;Crenarchaeota;Thermoprotei;Desulfurococcales;Pyrodictiaceae;Pyrodictium;";"90.0";"14.4";"10";"10";"9";"1";"0";"457173";"391198"
"V4mis2";"SILVA (only NR);Archaea;Crenarchaeota;Thermoprotei;Desulfurococcales;Pyrodictiaceae;uncultured;";"100.0";"14.4";"13";"13";"13";"0";"0";"457170";"391194"
"V4mis2";"SILVA (only NR);Archaea;Crenarchaeota;Thermoprotei;Desulfurococcales;uncultured;";"100.0";"14.4";"8";"8";"8";"0";"0";"457175";"391199"
"V4mis2";"SILVA (only NR);Archaea;Crenarchaeota;Thermoprotei;Fervidicoccales;";"91.7";"14.4";"36";"36";"33";"3";"0";"457147";"391174"
"V4mis2";"SILVA (only NR);Archaea;Crenarchaeota;Thermoprotei;Fervidicoccales;Fervidicoccaceae;";"91.7";"14.4";"36";"36";"33";"3";"0";"457147";"391174"
"V4mis2";"SILVA (only NR);Archaea;Crenarchaeota;Thermoprotei;Fervidicoccales;Fervidicoccaceae;Fervidicoccus;";"100.0";"14.4";"15";"15";"15";"0";"0";"457168";"391192"
"V4mis2";"SILVA (only NR);Archaea;Crenarchaeota;Thermoprotei;Fervidicoccales;Fervidicoccaceae;uncultured;";"85.7";"14.4";"21";"21";"18";"3";"0";"457162";"391189"
"V4mis2";"SILVA (only NR);Archaea;Crenarchaeota;Thermoprotei;Geoarchaeales;";"98.1";"14.4";"54";"54";"53";"1";"0";"457129";"391154"
"V4mis2";"SILVA (only NR);Archaea;Crenarchaeota;Thermoprotei;Geoarchaeales;SCGC AAA261-C22;";"100.0";"14.4";"10";"10";"10";"0";"0";"457173";"391197"
"V4mis2";"SILVA (only NR);Archaea;Crenarchaeota;Thermoprotei;Geoarchaeales;SCGC AAA471-B05;";"100.0";"14.4";"3";"3";"3";"0";"0";"457180";"391204"
"V4mis2";"SILVA (only NR);Archaea;Crenarchaeota;Thermoprotei;Sulfolobales;";"97.1";"14.4";"211";"209";"203";"6";"2";"456974";"391004"
"V4mis2";"SILVA (only NR);Archaea;Crenarchaeota;Thermoprotei;Sulfolobales;Sulfolobaceae;";"97.1";"14.4";"211";"209";"203";"6";"2";"456974";"391004"
"V4mis2";"SILVA (only NR);Archaea;Crenarchaeota;Thermoprotei;Sulfolobales;Sulfolobaceae;Acidianus;";"88.9";"14.4";"27";"27";"24";"3";"0";"457156";"391183"
"V4mis2";"SILVA (only NR);Archaea;Crenarchaeota;Thermoprotei;Sulfolobales;Sulfolobaceae;Metallosphaera;";"100.0";"14.4";"46";"46";"46";"0";"0";"457137";"391161"
"V4mis2";"SILVA (only NR);Archaea;Crenarchaeota;Thermoprotei;Sulfolobales;Sulfolobaceae;Saccharolobus;";"98.0";"14.4";"51";"51";"50";"1";"0";"457132";"391157"
"V4mis2";"SILVA (only NR);Archaea;Crenarchaeota;Thermoprotei;Sulfolobales;Sulfolobaceae;Stygiolobus;";"94.4";"14.4";"18";"18";"17";"1";"0";"457165";"391190"
"V4mis2";"SILVA (only NR);Archaea;Crenarchaeota;Thermoprotei;Sulfolobales;Sulfolobaceae;Sulfolobus;";"100.0";"14.4";"35";"33";"33";"0";"2";"457150";"391174"
"V4mis2";"SILVA (only NR);Archaea;Crenarchaeota;Thermoprotei;Sulfolobales;Sulfolobaceae;Sulfurisphaera;";"100.0";"14.4";"4";"4";"4";"0";"0";"457179";"391203"
"V4mis2";"SILVA (only NR);Archaea;Crenarchaeota;Thermoprotei;Sulfolobales;Sulfolobaceae;uncultured;";"100.0";"14.4";"25";"25";"25";"0";"0";"457158";"391182"
"V4mis2";"SILVA (only NR);Archaea;Crenarchaeota;Thermoprotei;Terrestrial Miscellaneous Gp(TMCG);";"90.0";"14.4";"10";"10";"9";"1";"0";"457173";"391198"
"V4mis2";"SILVA (only NR);Archaea;Crenarchaeota;Thermoprotei;Thermoproteales;";"97.4";"14.4";"156";"156";"152";"4";"0";"457027";"391055"
"V4mis2";"SILVA (only NR);Archaea;Crenarchaeota;Thermoprotei;Thermoproteales;Thermofilaceae;";"95.7";"14.4";"46";"46";"44";"2";"0";"457137";"391163"
"V4mis2";"SILVA (only NR);Archaea;Crenarchaeota;Thermoprotei;Thermoproteales;Thermofilaceae;Thermofilum;";"95.7";"14.4";"46";"46";"44";"2";"0";"457137";"391163"
"V4mis2";"SILVA (only NR);Archaea;Crenarchaeota;Thermoprotei;Thermoproteales;Thermoproteaceae;";"98.2";"14.4";"110";"110";"108";"2";"0";"457073";"391099"
"V4mis2";"SILVA (only NR);Archaea;Crenarchaeota;Thermoprotei;Thermoproteales;Thermoproteaceae;Caldivirga;";"100.0";"14.4";"5";"5";"5";"0";"0";"457178";"391202"
"V4mis2";"SILVA (only NR);Archaea;Crenarchaeota;Thermoprotei;Thermoproteales;Thermoproteaceae;Pyrobaculum;";"96.9";"14.4";"32";"32";"31";"1";"0";"457151";"391176"
"V4mis2";"SILVA (only NR);Archaea;Crenarchaeota;Thermoprotei;Thermoproteales;Thermoproteaceae;Thermocladium;";"100.0";"14.4";"7";"7";"7";"0";"0";"457176";"391200"
"V4mis2";"SILVA (only NR);Archaea;Crenarchaeota;Thermoprotei;Thermoproteales;Thermoproteaceae;Thermoproteus;";"100.0";"14.4";"9";"9";"9";"0";"0";"457174";"391198"
"V4mis2";"SILVA (only NR);Archaea;Crenarchaeota;Thermoprotei;Thermoproteales;Thermoproteaceae;Vulcanisaeta;";"100.0";"14.4";"31";"31";"31";"0";"0";"457152";"391176"
"V4mis2";"SILVA (only NR);Archaea;Crenarchaeota;Thermoprotei;Thermoproteales;Thermoproteaceae;uncultured;";"94.4";"14.4";"18";"18";"17";"1";"0";"457165";"391190"
"V4mis2";"SILVA (only NR);Archaea;Crenarchaeota;Thermoprotei;uncultured;";"66.7";"14.4";"3";"3";"2";"1";"0";"457180";"391205"
"V4mis2";"SILVA (only NR);Archaea;Euryarchaeota;";"96.5";"14.5";"1993";"1988";"1919";"69";"5";"455195";"389288"
"V4mis2";"SILVA (only NR);Archaea;Euryarchaeota;Methanobacteria;";"97.5";"14.5";"1500";"1499";"1461";"38";"1";"455684";"389746"
"V4mis2";"SILVA (only NR);Archaea;Euryarchaeota;Methanobacteria;Methanobacteriales;";"97.5";"14.5";"1500";"1499";"1461";"38";"1";"455684";"389746"
"V4mis2";"SILVA (only NR);Archaea;Euryarchaeota;Methanobacteria;Methanobacteriales;Methanobacteriaceae;";"97.4";"14.5";"1451";"1450";"1412";"38";"1";"455733";"389795"
"V4mis2";"SILVA (only NR);Archaea;Euryarchaeota;Methanobacteria;Methanobacteriales;Methanobacteriaceae;Methanobacterium;";"98.1";"14.4";"216";"215";"211";"4";"1";"456968";"390996"
"V4mis2";"SILVA (only NR);Archaea;Euryarchaeota;Methanobacteria;Methanobacteriales;Methanobacteriaceae;Methanobrevibacter;";"98.5";"14.5";"1030";"1030";"1015";"15";"0";"456153";"390192"
"V4mis2";"SILVA (only NR);Archaea;Euryarchaeota;Methanobacteria;Methanobacteriales;Methanobacteriaceae;Methanosphaera;";"90.4";"14.4";"198";"198";"179";"19";"0";"456985";"391028"
"V4mis2";"SILVA (only NR);Archaea;Euryarchaeota;Methanobacteria;Methanobacteriales;Methanobacteriaceae;uncultured;";"100.0";"14.4";"6";"6";"6";"0";"0";"457177";"391201"
"V4mis2";"SILVA (only NR);Archaea;Euryarchaeota;Methanobacteria;Methanobacteriales;Methanothermaceae;";"100.0";"14.4";"2";"2";"2";"0";"0";"457181";"391205"
"V4mis2";"SILVA (only NR);Archaea;Euryarchaeota;Methanobacteria;Methanobacteriales;Methanothermaceae;Methanothermus;";"100.0";"14.4";"2";"2";"2";"0";"0";"457181";"391205"
"V4mis2";"SILVA (only NR);Archaea;Euryarchaeota;Methanobacteria;Methanobacteriales;Methanothermobacteriaceae;";"100.0";"14.4";"47";"47";"47";"0";"0";"457136";"391160"
"V4mis2";"SILVA (only NR);Archaea;Euryarchaeota;Methanobacteria;Methanobacteriales;Methanothermobacteriaceae;Methanothermobacter;";"100.0";"14.4";"47";"47";"47";"0";"0";"457136";"391160"
"V4mis2";"SILVA (only NR);Archaea;Euryarchaeota;Methanococci;";"92.8";"14.4";"83";"83";"77";"6";"0";"457100";"391130"
"V4mis2";"SILVA (only NR);Archaea;Euryarchaeota;Methanococci;Methanococcales;";"92.8";"14.4";"83";"83";"77";"6";"0";"457100";"391130"
"V4mis2";"SILVA (only NR);Archaea;Euryarchaeota;Methanococci;Methanococcales;Methanocaldococcaceae;";"100.0";"14.4";"27";"27";"27";"0";"0";"457156";"391180"
"V4mis2";"SILVA (only NR);Archaea;Euryarchaeota;Methanococci;Methanococcales;Methanocaldococcaceae;Methanocaldococcus;";"100.0";"14.4";"27";"27";"27";"0";"0";"457156";"391180"
"V4mis2";"SILVA (only NR);Archaea;Euryarchaeota;Methanococci;Methanococcales;Methanococcaceae;";"89.3";"14.4";"56";"56";"50";"6";"0";"457127";"391157"
"V4mis2";"SILVA (only NR);Archaea;Euryarchaeota;Methanococci;Methanococcales;Methanococcaceae;Methanococcus;";"100.0";"14.4";"28";"28";"28";"0";"0";"457155";"391179"
"V4mis2";"SILVA (only NR);Archaea;Euryarchaeota;Methanococci;Methanococcales;Methanococcaceae;Methanothermococcus;";"100.0";"14.4";"9";"9";"9";"0";"0";"457174";"391198"
"V4mis2";"SILVA (only NR);Archaea;Euryarchaeota;Methanococci;Methanococcales;Methanococcaceae;Methanotorris;";"57.1";"14.4";"14";"14";"8";"6";"0";"457169";"391199"
"V4mis2";"SILVA (only NR);Archaea;Euryarchaeota;Methanococci;Methanococcales;Methanococcaceae;uncultured;";"100.0";"14.4";"4";"4";"4";"0";"0";"457179";"391203"
"V4mis2";"SILVA (only NR);Archaea;Euryarchaeota;Methanopyri;";"100.0";"14.4";"9";"9";"9";"0";"0";"457174";"391198"
"V4mis2";"SILVA (only NR);Archaea;Euryarchaeota;Methanopyri;Methanopyrales;";"100.0";"14.4";"9";"9";"9";"0";"0";"457174";"391198"
"V4mis2";"SILVA (only NR);Archaea;Euryarchaeota;Methanopyri;Methanopyrales;Methanopyraceae;";"100.0";"14.4";"9";"9";"9";"0";"0";"457174";"391198"
"V4mis2";"SILVA (only NR);Archaea;Euryarchaeota;Methanopyri;Methanopyrales;Methanopyraceae;Methanopyrus;";"100.0";"14.4";"9";"9";"9";"0";"0";"457174";"391198"
"V4mis2";"SILVA (only NR);Archaea;Euryarchaeota;Thermococci;";"93.7";"14.4";"401";"397";"372";"25";"4";"456786";"390835"
"V4mis2";"SILVA (only NR);Archaea;Euryarchaeota;Thermococci;Methanofastidiosales;";"95.3";"14.4";"195";"191";"182";"9";"4";"456992";"391025"
"V4mis2";"SILVA (only NR);Archaea;Euryarchaeota;Thermococci;Methanofastidiosales;Methanofastidiosaceae;";"93.2";"14.4";"60";"59";"55";"4";"1";"457124";"391152"
"V4mis2";"SILVA (only NR);Archaea;Euryarchaeota;Thermococci;Methanofastidiosales;Methanofastidiosaceae;Candidatus Methanofastidiosum;";"93.2";"14.4";"60";"59";"55";"4";"1";"457124";"391152"
"V4mis2";"SILVA (only NR);Archaea;Euryarchaeota;Thermococci;Methanofastidiosales;uncultured;";"96.1";"14.4";"132";"129";"124";"5";"3";"457054";"391083"
"V4mis2";"SILVA (only NR);Archaea;Euryarchaeota;Thermococci;Thermococcales;";"92.2";"14.4";"206";"206";"190";"16";"0";"456977";"391017"
"V4mis2";"SILVA (only NR);Archaea;Euryarchaeota;Thermococci;Thermococcales;Thermococcaceae;";"92.2";"14.4";"206";"206";"190";"16";"0";"456977";"391017"
"V4mis2";"SILVA (only NR);Archaea;Euryarchaeota;Thermococci;Thermococcales;Thermococcaceae;Palaeococcus;";"100.0";"14.4";"9";"9";"9";"0";"0";"457174";"391198"
"V4mis2";"SILVA (only NR);Archaea;Euryarchaeota;Thermococci;Thermococcales;Thermococcaceae;Pyrococcus;";"100.0";"14.4";"23";"23";"23";"0";"0";"457160";"391184"
"V4mis2";"SILVA (only NR);Archaea;Euryarchaeota;Thermococci;Thermococcales;Thermococcaceae;Thermococcus;";"90.8";"14.4";"174";"174";"158";"16";"0";"457009";"391049"
"V4mis2";"SILVA (only NR);Archaea;Hadarchaeota;";"93.6";"14.4";"300";"299";"280";"19";"1";"456884";"390927"
"V4mis2";"SILVA (only NR);Archaea;Hadarchaeota;Hadarchaeia;";"93.6";"14.4";"300";"299";"280";"19";"1";"456884";"390927"
"V4mis2";"SILVA (only NR);Archaea;Hadarchaeota;Hadarchaeia;Hadarchaeales;";"93.6";"14.4";"300";"299";"280";"19";"1";"456884";"390927"
"V4mis2";"SILVA (only NR);Archaea;Halobacterota;";"96.4";"14.6";"5352";"5297";"5108";"189";"55";"451886";"386099"
"V4mis2";"SILVA (only NR);Archaea;Halobacterota;ANME-1;";"91.4";"14.4";"154";"151";"138";"13";"3";"457032";"391069"
"V4mis2";"SILVA (only NR);Archaea;Halobacterota;ANME-1;ANME-1a;";"83.7";"14.4";"45";"43";"36";"7";"2";"457140";"391171"
"V4mis2";"SILVA (only NR);Archaea;Halobacterota;ANME-1;ANME-1b;";"93.5";"14.4";"94";"93";"87";"6";"1";"457090";"391120"
"V4mis2";"SILVA (only NR);Archaea;Halobacterota;Archaeoglobi;";"98.8";"14.4";"80";"80";"79";"1";"0";"457103";"391128"
"V4mis2";"SILVA (only NR);Archaea;Halobacterota;Archaeoglobi;Archaeoglobales;";"98.8";"14.4";"80";"80";"79";"1";"0";"457103";"391128"
"V4mis2";"SILVA (only NR);Archaea;Halobacterota;Archaeoglobi;Archaeoglobales;Archaeoglobaceae;";"98.8";"14.4";"80";"80";"79";"1";"0";"457103";"391128"
"V4mis2";"SILVA (only NR);Archaea;Halobacterota;Archaeoglobi;Archaeoglobales;Archaeoglobaceae;Archaeoglobus;";"96.9";"14.4";"32";"32";"31";"1";"0";"457151";"391176"
"V4mis2";"SILVA (only NR);Archaea;Halobacterota;Archaeoglobi;Archaeoglobales;Archaeoglobaceae;Ferroglobus;";"100.0";"14.4";"3";"3";"3";"0";"0";"457180";"391204"
"V4mis2";"SILVA (only NR);Archaea;Halobacterota;Archaeoglobi;Archaeoglobales;Archaeoglobaceae;Geoglobus;";"100.0";"14.4";"12";"12";"12";"0";"0";"457171";"391195"
"V4mis2";"SILVA (only NR);Archaea;Halobacterota;Archaeoglobi;Archaeoglobales;Archaeoglobaceae;JdFR-20;";"100.0";"14.4";"2";"2";"2";"0";"0";"457181";"391205"
"V4mis2";"SILVA (only NR);Archaea;Halobacterota;Archaeoglobi;Archaeoglobales;Archaeoglobaceae;uncultured;";"100.0";"14.4";"23";"23";"23";"0";"0";"457160";"391184"
"V4mis2";"SILVA (only NR);Archaea;Halobacterota;Halobacteria;";"97.5";"14.5";"2624";"2603";"2537";"66";"21";"454580";"388670"
"V4mis2";"SILVA (only NR);Archaea;Halobacterota;Halobacteria;Halobacterales;";"97.5";"14.5";"2624";"2603";"2537";"66";"21";"454580";"388670"
"V4mis2";"SILVA (only NR);Archaea;Halobacterota;Halobacteria;Halobacterales;Haloadaptaceae;";"96.9";"14.4";"32";"32";"31";"1";"0";"457151";"391176"
"V4mis2";"SILVA (only NR);Archaea;Halobacterota;Halobacteria;Halobacterales;Haloadaptaceae;Haladaptatus;";"96.9";"14.4";"32";"32";"31";"1";"0";"457151";"391176"
"V4mis2";"SILVA (only NR);Archaea;Halobacterota;Halobacteria;Halobacterales;Halobacteriaceae;";"98.6";"14.4";"147";"146";"144";"2";"1";"457037";"391063"
"V4mis2";"SILVA (only NR);Archaea;Halobacterota;Halobacteria;Halobacterales;Halobacteriaceae;Halanaeroarchaeum;";"100.0";"14.4";"19";"19";"19";"0";"0";"457164";"391188"
"V4mis2";"SILVA (only NR);Archaea;Halobacterota;Halobacteria;Halobacterales;Halobacteriaceae;Halarchaeum;";"100.0";"14.4";"25";"24";"24";"0";"1";"457159";"391183"
"V4mis2";"SILVA (only NR);Archaea;Halobacterota;Halobacteria;Halobacterales;Halobacteriaceae;Halobacterium;";"97.6";"14.4";"82";"82";"80";"2";"0";"457101";"391127"
"V4mis2";"SILVA (only NR);Archaea;Halobacterota;Halobacteria;Halobacterales;Halobacteriaceae;Halocalculus;";"100.0";"14.4";"1";"1";"1";"0";"0";"457182";"391206"
"V4mis2";"SILVA (only NR);Archaea;Halobacterota;Halobacteria;Halobacterales;Halobacteriaceae;Halodesulfurarchaeum;";"100.0";"14.4";"13";"13";"13";"0";"0";"457170";"391194"
"V4mis2";"SILVA (only NR);Archaea;Halobacterota;Halobacteria;Halobacterales;Halobacteriaceae;Salarchaeum;";"100.0";"14.4";"3";"3";"3";"0";"0";"457180";"391204"
"V4mis2";"SILVA (only NR);Archaea;Halobacterota;Halobacteria;Halobacterales;Halobacteriaceae;uncultured;";"100.0";"14.4";"2";"2";"2";"0";"0";"457181";"391205"
"V4mis2";"SILVA (only NR);Archaea;Halobacterota;Halobacteria;Halobacterales;Halococcaceae;";"92.9";"14.4";"86";"85";"79";"6";"1";"457098";"391128"
"V4mis2";"SILVA (only NR);Archaea;Halobacterota;Halobacteria;Halobacterales;Halococcaceae;Halalkalicoccus;";"100.0";"14.4";"14";"14";"14";"0";"0";"457169";"391193"
"V4mis2";"SILVA (only NR);Archaea;Halobacterota;Halobacteria;Halobacterales;Halococcaceae;Halococcus;";"90.5";"14.4";"64";"63";"57";"6";"1";"457120";"391150"
"V4mis2";"SILVA (only NR);Archaea;Halobacterota;Halobacteria;Halobacterales;Halococcaceae;Halostella;";"100.0";"14.4";"5";"5";"5";"0";"0";"457178";"391202"
"V4mis2";"SILVA (only NR);Archaea;Halobacterota;Halobacteria;Halobacterales;Halococcaceae;uncultured;";"100.0";"14.4";"3";"3";"3";"0";"0";"457180";"391204"
"V4mis2";"SILVA (only NR);Archaea;Halobacterota;Halobacteria;Halobacterales;Haloferacaceae;";"97.0";"14.5";"1634";"1619";"1571";"48";"15";"455564";"389636"
"V4mis2";"SILVA (only NR);Archaea;Halobacterota;Halobacteria;Halobacterales;Haloferacaceae;A07HB70;";"100.0";"14.4";"17";"17";"17";"0";"0";"457166";"391190"
"V4mis2";"SILVA (only NR);Archaea;Halobacterota;Halobacteria;Halobacterales;Haloferacaceae;Candidatus Haloectosymbiotes;";"100.0";"14.4";"1";"1";"1";"0";"0";"457182";"391206"
"V4mis2";"SILVA (only NR);Archaea;Halobacterota;Halobacteria;Halobacterales;Haloferacaceae;Haloarchaeobius;";"100.0";"14.4";"23";"23";"23";"0";"0";"457160";"391184"
"V4mis2";"SILVA (only NR);Archaea;Halobacterota;Halobacteria;Halobacterales;Haloferacaceae;Halobaculum;";"100.0";"14.4";"18";"18";"18";"0";"0";"457165";"391189"
"V4mis2";"SILVA (only NR);Archaea;Halobacterota;Halobacteria;Halobacterales;Haloferacaceae;Halobellus;";"97.7";"14.4";"44";"44";"43";"1";"0";"457139";"391164"
"V4mis2";"SILVA (only NR);Archaea;Halobacterota;Halobacteria;Halobacterales;Haloferacaceae;Halobiforma;";"92.9";"14.4";"14";"14";"13";"1";"0";"457169";"391194"
"V4mis2";"SILVA (only NR);Archaea;Halobacterota;Halobacteria;Halobacterales;Haloferacaceae;Haloferax;";"91.1";"14.4";"113";"112";"102";"10";"1";"457071";"391105"
"V4mis2";"SILVA (only NR);Archaea;Halobacterota;Halobacteria;Halobacterales;Haloferacaceae;Halogeometricum;";"94.6";"14.4";"37";"37";"35";"2";"0";"457146";"391172"
"V4mis2";"SILVA (only NR);Archaea;Halobacterota;Halobacteria;Halobacterales;Haloferacaceae;Halogranum;";"100.0";"14.4";"16";"16";"16";"0";"0";"457167";"391191"
"V4mis2";"SILVA (only NR);Archaea;Halobacterota;Halobacteria;Halobacterales;Haloferacaceae;Halohasta;";"100.0";"14.4";"18";"17";"17";"0";"1";"457166";"391190"
"V4mis2";"SILVA (only NR);Archaea;Halobacterota;Halobacteria;Halobacterales;Haloferacaceae;Halolamina;";"98.4";"14.4";"68";"64";"63";"1";"4";"457119";"391144"
"V4mis2";"SILVA (only NR);Archaea;Halobacterota;Halobacteria;Halobacterales;Haloferacaceae;Halonotius;";"100.0";"14.4";"98";"97";"97";"0";"1";"457086";"391110"
"V4mis2";"SILVA (only NR);Archaea;Halobacterota;Halobacteria;Halobacterales;Haloferacaceae;Haloparvum;";"94.7";"14.4";"38";"38";"36";"2";"0";"457145";"391171"
"V4mis2";"SILVA (only NR);Archaea;Halobacterota;Halobacteria;Halobacterales;Haloferacaceae;Halopelagius;";"100.0";"14.4";"8";"8";"8";"0";"0";"457175";"391199"
"V4mis2";"SILVA (only NR);Archaea;Halobacterota;Halobacteria;Halobacterales;Haloferacaceae;Halopenitus;";"100.0";"14.4";"7";"7";"7";"0";"0";"457176";"391200"
"V4mis2";"SILVA (only NR);Archaea;Halobacterota;Halobacteria;Halobacterales;Haloferacaceae;Halopiger;";"96.0";"14.4";"25";"25";"24";"1";"0";"457158";"391183"
"V4mis2";"SILVA (only NR);Archaea;Halobacterota;Halobacteria;Halobacterales;Haloferacaceae;Haloplanus;";"97.7";"14.4";"44";"44";"43";"1";"0";"457139";"391164"
"V4mis2";"SILVA (only NR);Archaea;Halobacterota;Halobacteria;Halobacterales;Haloferacaceae;Haloquadratum;";"100.0";"14.4";"70";"70";"70";"0";"0";"457113";"391137"
"V4mis2";"SILVA (only NR);Archaea;Halobacterota;Halobacteria;Halobacterales;Haloferacaceae;Halorubellus;";"93.8";"14.4";"16";"16";"15";"1";"0";"457167";"391192"
"V4mis2";"SILVA (only NR);Archaea;Halobacterota;Halobacteria;Halobacterales;Haloferacaceae;Halorubrum;";"96.5";"14.4";"345";"342";"330";"12";"3";"456841";"390877"
"V4mis2";"SILVA (only NR);Archaea;Halobacterota;Halobacteria;Halobacterales;Haloferacaceae;Halorussus;";"97.0";"14.4";"33";"33";"32";"1";"0";"457150";"391175"
"V4mis2";"SILVA (only NR);Archaea;Halobacterota;Halobacteria;Halobacterales;Haloferacaceae;Halostagnicola;";"100.0";"14.4";"17";"17";"17";"0";"0";"457166";"391190"
"V4mis2";"SILVA (only NR);Archaea;Halobacterota;Halobacteria;Halobacterales;Haloferacaceae;Haloterrigena;";"98.4";"14.4";"123";"123";"121";"2";"0";"457060";"391086"
"V4mis2";"SILVA (only NR);Archaea;Halobacterota;Halobacteria;Halobacterales;Haloferacaceae;Halovarius;";"100.0";"14.4";"1";"1";"1";"0";"0";"457182";"391206"
"V4mis2";"SILVA (only NR);Archaea;Halobacterota;Halobacteria;Halobacterales;Haloferacaceae;Halovenus;";"100.0";"14.4";"22";"22";"22";"0";"0";"457161";"391185"
"V4mis2";"SILVA (only NR);Archaea;Halobacterota;Halobacteria;Halobacterales;Haloferacaceae;Halovivax;";"100.0";"14.4";"19";"19";"19";"0";"0";"457164";"391188"
"V4mis2";"SILVA (only NR);Archaea;Halobacterota;Halobacteria;Halobacterales;Haloferacaceae;Natrialba;";"95.7";"14.4";"47";"47";"45";"2";"0";"457136";"391162"
"V4mis2";"SILVA (only NR);Archaea;Halobacterota;Halobacteria;Halobacterales;Haloferacaceae;Natribaculum;";"100.0";"14.4";"2";"2";"2";"0";"0";"457181";"391205"
"V4mis2";"SILVA (only NR);Archaea;Halobacterota;Halobacteria;Halobacterales;Haloferacaceae;Natrinema;";"93.1";"14.4";"29";"29";"27";"2";"0";"457154";"391180"
"V4mis2";"SILVA (only NR);Archaea;Halobacterota;Halobacteria;Halobacterales;Haloferacaceae;Natronoarchaeum;";"100.0";"14.4";"26";"26";"26";"0";"0";"457157";"391181"
"V4mis2";"SILVA (only NR);Archaea;Halobacterota;Halobacteria;Halobacterales;Haloferacaceae;Natronobacterium;";"100.0";"14.4";"10";"9";"9";"0";"1";"457174";"391198"
"V4mis2";"SILVA (only NR);Archaea;Halobacterota;Halobacteria;Halobacterales;Haloferacaceae;Natronococcus;";"92.1";"14.4";"38";"38";"35";"3";"0";"457145";"391172"
"V4mis2";"SILVA (only NR);Archaea;Halobacterota;Halobacteria;Halobacterales;Haloferacaceae;Natronolimnobius;";"81.8";"14.4";"12";"11";"9";"2";"1";"457172";"391198"
"V4mis2";"SILVA (only NR);Archaea;Halobacterota;Halobacteria;Halobacterales;Haloferacaceae;Natronorubrum;";"100.0";"14.4";"43";"43";"43";"0";"0";"457140";"391164"
"V4mis2";"SILVA (only NR);Archaea;Halobacterota;Halobacteria;Halobacterales;Haloferacaceae;Salinarchaeum;";"100.0";"14.4";"17";"17";"17";"0";"0";"457166";"391190"
"V4mis2";"SILVA (only NR);Archaea;Halobacterota;Halobacteria;Halobacterales;Haloferacaceae;Salinigranum;";"100.0";"14.4";"19";"19";"19";"0";"0";"457164";"391188"
"V4mis2";"SILVA (only NR);Archaea;Halobacterota;Halobacteria;Halobacterales;Haloferacaceae;Saliphagus;";"100.0";"14.4";"5";"5";"5";"0";"0";"457178";"391202"
"V4mis2";"SILVA (only NR);Archaea;Halobacterota;Halobacteria;Halobacterales;Haloferacaceae;uncultured;";"100.0";"14.4";"116";"114";"114";"0";"2";"457069";"391093"
"V4mis2";"SILVA (only NR);Archaea;Halobacterota;Halobacteria;Halobacterales;Halomicrobiaceae;";"98.6";"14.4";"641";"637";"628";"9";"4";"456546";"390579"
"V4mis2";"SILVA (only NR);Archaea;Halobacterota;Halobacteria;Halobacterales;Halomicrobiaceae;Candidatus Halobonum;";"100.0";"14.4";"19";"19";"19";"0";"0";"457164";"391188"
"V4mis2";"SILVA (only NR);Archaea;Halobacterota;Halobacteria;Halobacterales;Halomicrobiaceae;Halapricum;";"98.0";"14.4";"50";"50";"49";"1";"0";"457133";"391158"
"V4mis2";"SILVA (only NR);Archaea;Halobacterota;Halobacteria;Halobacterales;Halomicrobiaceae;Haloarcula;";"98.1";"14.4";"214";"212";"208";"4";"2";"456971";"390999"
"V4mis2";"SILVA (only NR);Archaea;Halobacterota;Halobacteria;Halobacterales;Halomicrobiaceae;Halomarina;";"100.0";"14.4";"21";"21";"21";"0";"0";"457162";"391186"
"V4mis2";"SILVA (only NR);Archaea;Halobacterota;Halobacteria;Halobacterales;Halomicrobiaceae;Halomicroarcula;";"100.0";"14.4";"40";"40";"40";"0";"0";"457143";"391167"
"V4mis2";"SILVA (only NR);Archaea;Halobacterota;Halobacteria;Halobacterales;Halomicrobiaceae;Halomicrobium;";"100.0";"14.4";"64";"62";"62";"0";"2";"457121";"391145"
"V4mis2";"SILVA (only NR);Archaea;Halobacterota;Halobacteria;Halobacterales;Halomicrobiaceae;Halorhabdus;";"95.0";"14.4";"20";"20";"19";"1";"0";"457163";"391188"
"V4mis2";"SILVA (only NR);Archaea;Halobacterota;Halobacteria;Halobacterales;Halomicrobiaceae;Halorientalis;";"100.0";"14.4";"18";"18";"18";"0";"0";"457165";"391189"
"V4mis2";"SILVA (only NR);Archaea;Halobacterota;Halobacteria;Halobacterales;Halomicrobiaceae;Halosiccatus;";"100.0";"14.4";"3";"3";"3";"0";"0";"457180";"391204"
"V4mis2";"SILVA (only NR);Archaea;Halobacterota;Halobacteria;Halobacterales;Halomicrobiaceae;Halosimplex;";"100.0";"14.4";"38";"38";"38";"0";"0";"457145";"391169"
"V4mis2";"SILVA (only NR);Archaea;Halobacterota;Halobacteria;Halobacterales;Halomicrobiaceae;Natronomonas;";"97.5";"14.4";"79";"79";"77";"2";"0";"457104";"391130"
"V4mis2";"SILVA (only NR);Archaea;Halobacterota;Halobacteria;Halobacterales;Halomicrobiaceae;Salinirubrum;";"100.0";"14.4";"4";"4";"4";"0";"0";"457179";"391203"
"V4mis2";"SILVA (only NR);Archaea;Halobacterota;Halobacteria;Halobacterales;Halomicrobiaceae;uncultured;";"98.4";"14.4";"64";"64";"63";"1";"0";"457119";"391144"
"V4mis2";"SILVA (only NR);Archaea;Halobacterota;Halobacteria;Halobacterales;J07HX5;";"100.0";"14.4";"3";"3";"3";"0";"0";"457180";"391204"
"V4mis2";"SILVA (only NR);Archaea;Halobacterota;Halobacteria;Halobacterales;uncultured;";"100.0";"14.4";"77";"77";"77";"0";"0";"457106";"391130"
"V4mis2";"SILVA (only NR);Archaea;Halobacterota;Methanocellia;";"95.0";"14.4";"101";"101";"96";"5";"0";"457082";"391111"
"V4mis2";"SILVA (only NR);Archaea;Halobacterota;Methanocellia;Methanocellales;";"95.0";"14.4";"101";"101";"96";"5";"0";"457082";"391111"
"V4mis2";"SILVA (only NR);Archaea;Halobacterota;Methanocellia;Methanocellales;Methanocellaceae;";"96.4";"14.4";"83";"83";"80";"3";"0";"457100";"391127"
"V4mis2";"SILVA (only NR);Archaea;Halobacterota;Methanocellia;Methanocellales;Methanocellaceae;Methanocella;";"93.9";"14.4";"49";"49";"46";"3";"0";"457134";"391161"
"V4mis2";"SILVA (only NR);Archaea;Halobacterota;Methanocellia;Methanocellales;Methanocellaceae;Rice Cluster I;";"100.0";"14.4";"33";"33";"33";"0";"0";"457150";"391174"
"V4mis2";"SILVA (only NR);Archaea;Halobacterota;Methanocellia;Methanocellales;uncultured;";"88.9";"14.4";"18";"18";"16";"2";"0";"457165";"391191"
"V4mis2";"SILVA (only NR);Archaea;Halobacterota;Methanomicrobia;";"95.9";"14.5";"891";"876";"840";"36";"15";"456307";"390367"
"V4mis2";"SILVA (only NR);Archaea;Halobacterota;Methanomicrobia;Methanomicrobiales;";"95.9";"14.5";"891";"876";"840";"36";"15";"456307";"390367"
"V4mis2";"SILVA (only NR);Archaea;Halobacterota;Methanomicrobia;Methanomicrobiales;Methanocorpusculaceae;";"97.4";"14.4";"79";"77";"75";"2";"2";"457106";"391132"
"V4mis2";"SILVA (only NR);Archaea;Halobacterota;Methanomicrobia;Methanomicrobiales;Methanocorpusculaceae;Methanocalculus;";"100.0";"14.4";"34";"34";"34";"0";"0";"457149";"391173"
"V4mis2";"SILVA (only NR);Archaea;Halobacterota;Methanomicrobia;Methanomicrobiales;Methanocorpusculaceae;Methanocorpusculum;";"95.3";"14.4";"45";"43";"41";"2";"2";"457140";"391166"
"V4mis2";"SILVA (only NR);Archaea;Halobacterota;Methanomicrobia;Methanomicrobiales;Methanomicrobiaceae;";"97.8";"14.4";"368";"365";"357";"8";"3";"456818";"390850"
"V4mis2";"SILVA (only NR);Archaea;Halobacterota;Methanomicrobia;Methanomicrobiales;Methanomicrobiaceae;Methanoculleus;";"98.0";"14.4";"204";"202";"198";"4";"2";"456981";"391009"
"V4mis2";"SILVA (only NR);Archaea;Halobacterota;Methanomicrobia;Methanomicrobiales;Methanomicrobiaceae;Methanofollis;";"100.0";"14.4";"22";"22";"22";"0";"0";"457161";"391185"
"V4mis2";"SILVA (only NR);Archaea;Halobacterota;Methanomicrobia;Methanomicrobiales;Methanomicrobiaceae;Methanogenium;";"100.0";"14.4";"32";"32";"32";"0";"0";"457151";"391175"
"V4mis2";"SILVA (only NR);Archaea;Halobacterota;Methanomicrobia;Methanomicrobiales;Methanomicrobiaceae;Methanolacinia;";"100.0";"14.4";"6";"6";"6";"0";"0";"457177";"391201"
"V4mis2";"SILVA (only NR);Archaea;Halobacterota;Methanomicrobia;Methanomicrobiales;Methanomicrobiaceae;Methanomicrobium;";"94.9";"14.4";"39";"39";"37";"2";"0";"457144";"391170"
"V4mis2";"SILVA (only NR);Archaea;Halobacterota;Methanomicrobia;Methanomicrobiales;Methanomicrobiaceae;Methanoplanus;";"100.0";"14.4";"5";"5";"5";"0";"0";"457178";"391202"
"V4mis2";"SILVA (only NR);Archaea;Halobacterota;Methanomicrobia;Methanomicrobiales;Methanomicrobiaceae;SDB;";"100.0";"14.4";"2";"2";"2";"0";"0";"457181";"391205"
"V4mis2";"SILVA (only NR);Archaea;Halobacterota;Methanomicrobia;Methanomicrobiales;Methanomicrobiaceae;uncultured;";"96.2";"14.4";"54";"53";"51";"2";"1";"457130";"391156"
"V4mis2";"SILVA (only NR);Archaea;Halobacterota;Methanomicrobia;Methanomicrobiales;Methanoregulaceae;";"92.7";"14.4";"289";"287";"266";"21";"2";"456896";"390941"
"V4mis2";"SILVA (only NR);Archaea;Halobacterota;Methanomicrobia;Methanomicrobiales;Methanoregulaceae;Methanolinea;";"99.0";"14.4";"99";"97";"96";"1";"2";"457086";"391111"
"V4mis2";"SILVA (only NR);Archaea;Halobacterota;Methanomicrobia;Methanomicrobiales;Methanoregulaceae;Methanoregula;";"89.2";"14.4";"186";"186";"166";"20";"0";"456997";"391041"
"V4mis2";"SILVA (only NR);Archaea;Halobacterota;Methanomicrobia;Methanomicrobiales;Methanoregulaceae;Methanosphaerula;";"100.0";"14.4";"4";"4";"4";"0";"0";"457179";"391203"
"V4mis2";"SILVA (only NR);Archaea;Halobacterota;Methanomicrobia;Methanomicrobiales;Methanospirillaceae;";"95.6";"14.4";"115";"113";"108";"5";"2";"457070";"391099"
"V4mis2";"SILVA (only NR);Archaea;Halobacterota;Methanomicrobia;Methanomicrobiales;Methanospirillaceae;Methanospirillum;";"95.6";"14.4";"115";"113";"108";"5";"2";"457070";"391099"
"V4mis2";"SILVA (only NR);Archaea;Halobacterota;Methanomicrobia;Methanomicrobiales;Rice Cluster II;";"100.0";"14.4";"18";"14";"14";"0";"4";"457169";"391193"
"V4mis2";"SILVA (only NR);Archaea;Halobacterota;Methanomicrobia;Methanomicrobiales;uncultured;";"100.0";"14.4";"20";"19";"19";"0";"1";"457164";"391188"
"V4mis2";"SILVA (only NR);Archaea;Halobacterota;Methanonatronarchaeia;";"100.0";"14.4";"15";"15";"15";"0";"0";"457168";"391192"
"V4mis2";"SILVA (only NR);Archaea;Halobacterota;Methanonatronarchaeia;Methanonatronaechaeales;";"100.0";"14.4";"15";"15";"15";"0";"0";"457168";"391192"
"V4mis2";"SILVA (only NR);Archaea;Halobacterota;Methanonatronarchaeia;Methanonatronaechaeales;Methanonatronarchaeaceae;";"100.0";"14.4";"15";"15";"15";"0";"0";"457168";"391192"
"V4mis2";"SILVA (only NR);Archaea;Halobacterota;Methanosarcinia;";"95.4";"14.5";"1470";"1454";"1387";"67";"16";"455729";"389820"
"V4mis2";"SILVA (only NR);Archaea;Halobacterota;Methanosarcinia;Methanosarciniales;";"95.4";"14.5";"1470";"1454";"1387";"67";"16";"455729";"389820"
"V4mis2";"SILVA (only NR);Archaea;Halobacterota;Methanosarcinia;Methanosarciniales;ANME-2a-2b;";"94.5";"14.4";"111";"110";"104";"6";"1";"457073";"391103"
"V4mis2";"SILVA (only NR);Archaea;Halobacterota;Methanosarcinia;Methanosarciniales;ANME-2a-2b;ANME-2b;";"100.0";"14.4";"11";"11";"11";"0";"0";"457172";"391196"
"V4mis2";"SILVA (only NR);Archaea;Halobacterota;Methanosarcinia;Methanosarciniales;ANME-2c;";"92.9";"14.4";"86";"85";"79";"6";"1";"457098";"391128"
"V4mis2";"SILVA (only NR);Archaea;Halobacterota;Methanosarcinia;Methanosarciniales;Methanoperedenaceae;";"99.1";"14.4";"117";"117";"116";"1";"0";"457066";"391091"
"V4mis2";"SILVA (only NR);Archaea;Halobacterota;Methanosarcinia;Methanosarciniales;Methanoperedenaceae;Candidatus Methanoperedens;";"98.9";"14.4";"87";"87";"86";"1";"0";"457096";"391121"
"V4mis2";"SILVA (only NR);Archaea;Halobacterota;Methanosarcinia;Methanosarciniales;Methanosaetaceae;";"94.8";"14.4";"564";"560";"531";"29";"4";"456623";"390676"
"V4mis2";"SILVA (only NR);Archaea;Halobacterota;Methanosarcinia;Methanosarciniales;Methanosaetaceae;Methanosaeta;";"94.8";"14.4";"564";"560";"531";"29";"4";"456623";"390676"
"V4mis2";"SILVA (only NR);Archaea;Halobacterota;Methanosarcinia;Methanosarciniales;Methanosarcinaceae;";"95.4";"14.4";"555";"545";"520";"25";"10";"456638";"390687"
"V4mis2";"SILVA (only NR);Archaea;Halobacterota;Methanosarcinia;Methanosarciniales;Methanosarcinaceae;ANME-3;";"97.8";"14.4";"46";"46";"45";"1";"0";"457137";"391162"
"V4mis2";"SILVA (only NR);Archaea;Halobacterota;Methanosarcinia;Methanosarciniales;Methanosarcinaceae;Methanimicrococcus;";"100.0";"14.4";"34";"34";"34";"0";"0";"457149";"391173"
"V4mis2";"SILVA (only NR);Archaea;Halobacterota;Methanosarcinia;Methanosarciniales;Methanosarcinaceae;Methanococcoides;";"95.6";"14.4";"45";"45";"43";"2";"0";"457138";"391164"
"V4mis2";"SILVA (only NR);Archaea;Halobacterota;Methanosarcinia;Methanosarciniales;Methanosarcinaceae;Methanohalobium;";"100.0";"14.4";"4";"4";"4";"0";"0";"457179";"391203"
"V4mis2";"SILVA (only NR);Archaea;Halobacterota;Methanosarcinia;Methanosarciniales;Methanosarcinaceae;Methanohalophilus;";"92.3";"14.4";"39";"39";"36";"3";"0";"457144";"391171"
"V4mis2";"SILVA (only NR);Archaea;Halobacterota;Methanosarcinia;Methanosarciniales;Methanosarcinaceae;Methanolobus;";"93.9";"14.4";"66";"66";"62";"4";"0";"457117";"391145"
"V4mis2";"SILVA (only NR);Archaea;Halobacterota;Methanosarcinia;Methanosarciniales;Methanosarcinaceae;Methanomethylovorans;";"95.9";"14.4";"49";"49";"47";"2";"0";"457134";"391160"
"V4mis2";"SILVA (only NR);Archaea;Halobacterota;Methanosarcinia;Methanosarciniales;Methanosarcinaceae;Methanosalsum;";"100.0";"14.4";"3";"3";"3";"0";"0";"457180";"391204"
"V4mis2";"SILVA (only NR);Archaea;Halobacterota;Methanosarcinia;Methanosarciniales;Methanosarcinaceae;Methanosarcina;";"95.0";"14.4";"251";"241";"229";"12";"10";"456942";"390978"
"V4mis2";"SILVA (only NR);Archaea;Halobacterota;Methanosarcinia;Methanosarciniales;Methanosarcinaceae;uncultured;";"94.4";"14.4";"18";"18";"17";"1";"0";"457165";"391190"
"V4mis2";"SILVA (only NR);Archaea;Halobacterota;Methanosarcinia;Methanosarciniales;Methermicoccaceae;";"100.0";"14.4";"5";"5";"5";"0";"0";"457178";"391202"
"V4mis2";"SILVA (only NR);Archaea;Halobacterota;Methanosarcinia;Methanosarciniales;Methermicoccaceae;Methermicoccus;";"100.0";"14.4";"4";"4";"4";"0";"0";"457179";"391203"
"V4mis2";"SILVA (only NR);Archaea;Halobacterota;Methanosarcinia;Methanosarciniales;Syntrophoarchaeaceae;";"100.0";"14.4";"28";"28";"28";"0";"0";"457155";"391179"
"V4mis2";"SILVA (only NR);Archaea;Halobacterota;Methanosarcinia;Methanosarciniales;Syntrophoarchaeaceae;Candidatus Syntrophoarchaeum;";"100.0";"14.4";"4";"4";"4";"0";"0";"457179";"391203"
"V4mis2";"SILVA (only NR);Archaea;Halobacterota;uncultured;";"94.1";"14.4";"17";"17";"16";"1";"0";"457166";"391191"
"V4mis2";"SILVA (only NR);Archaea;Hydrothermarchaeota;";"98.1";"14.4";"212";"212";"208";"4";"0";"456971";"390999"
"V4mis2";"SILVA (only NR);Archaea;Hydrothermarchaeota;Hydrothermarchaeia;";"98.1";"14.4";"212";"212";"208";"4";"0";"456971";"390999"
"V4mis2";"SILVA (only NR);Archaea;Hydrothermarchaeota;Hydrothermarchaeia;Hydrothermarchaeales;";"98.1";"14.4";"212";"212";"208";"4";"0";"456971";"390999"
"V4mis2";"SILVA (only NR);Archaea;Iainarchaeota;";"91.1";"14.4";"46";"45";"41";"4";"1";"457138";"391166"
"V4mis2";"SILVA (only NR);Archaea;Iainarchaeota;Iainarchaeia;";"91.1";"14.4";"46";"45";"41";"4";"1";"457138";"391166"
"V4mis2";"SILVA (only NR);Archaea;Iainarchaeota;Iainarchaeia;Iainarchaeales;";"91.1";"14.4";"46";"45";"41";"4";"1";"457138";"391166"
"V4mis2";"SILVA (only NR);Archaea;Iainarchaeota;Iainarchaeia;Iainarchaeales;Candidatus Iainarchaeum;";"86.7";"14.4";"15";"15";"13";"2";"0";"457168";"391194"
"V4mis2";"SILVA (only NR);Archaea;Korarchaeota;";"96.7";"14.4";"62";"61";"59";"2";"1";"457122";"391148"
"V4mis2";"SILVA (only NR);Archaea;Korarchaeota;Korarchaeia;";"96.7";"14.4";"62";"61";"59";"2";"1";"457122";"391148"
"V4mis2";"SILVA (only NR);Archaea;Korarchaeota;Korarchaeia;Korarchaeales;";"96.7";"14.4";"62";"61";"59";"2";"1";"457122";"391148"
"V4mis2";"SILVA (only NR);Archaea;Korarchaeota;Korarchaeia;Korarchaeales;Korarchaeaceae;";"96.7";"14.4";"62";"61";"59";"2";"1";"457122";"391148"
"V4mis2";"SILVA (only NR);Archaea;Korarchaeota;Korarchaeia;Korarchaeales;Korarchaeaceae;Candidatus Korarchaeum;";"96.7";"14.4";"62";"61";"59";"2";"1";"457122";"391148"
"V4mis2";"SILVA (only NR);Archaea;Micrarchaeota;";"75.6";"14.4";"88";"86";"65";"21";"2";"457097";"391142"
"V4mis2";"SILVA (only NR);Archaea;Micrarchaeota;Micrarchaeia;";"75.6";"14.4";"88";"86";"65";"21";"2";"457097";"391142"
"V4mis2";"SILVA (only NR);Archaea;Micrarchaeota;Micrarchaeia;Micrarchaeales;";"75.6";"14.4";"88";"86";"65";"21";"2";"457097";"391142"
"V4mis2";"SILVA (only NR);Archaea;Micrarchaeota;Micrarchaeia;Micrarchaeales;CG1-02-32-21;";"100.0";"14.4";"12";"12";"12";"0";"0";"457171";"391195"
"V4mis2";"SILVA (only NR);Archaea;Micrarchaeota;Micrarchaeia;Micrarchaeales;Candidatus Micrarchaeum;";"100.0";"14.4";"10";"10";"10";"0";"0";"457173";"391197"
"V4mis2";"SILVA (only NR);Archaea;Nanoarchaeota;";"84.0";"14.4";"550";"514";"432";"82";"36";"456669";"390775"
"V4mis2";"SILVA (only NR);Archaea;Nanoarchaeota;Nanoarchaeia;";"84.0";"14.4";"550";"514";"432";"82";"36";"456669";"390775"
"V4mis2";"SILVA (only NR);Archaea;Nanoarchaeota;Nanoarchaeia;Nanoarchaeales;";"2.6";"14.4";"40";"39";"1";"38";"1";"457144";"391206"
"V4mis2";"SILVA (only NR);Archaea;Nanoarchaeota;Nanoarchaeia;Nanoarchaeales;Nanoarchaeaceae;";"4.8";"14.4";"22";"21";"1";"20";"1";"457162";"391206"
"V4mis2";"SILVA (only NR);Archaea;Nanoarchaeota;Nanoarchaeia;Nanoarchaeales;Nanoarchaeaceae;Nanoarchaeum;";"4.8";"14.4";"22";"21";"1";"20";"1";"457162";"391206"
"V4mis2";"SILVA (only NR);Archaea;Nanoarchaeota;Nanoarchaeia;Nanoarchaeales;Nanopusillaceae;";"0.0";"0";"18";"18";"0";"18";"0";"457165";"391207"
"V4mis2";"SILVA (only NR);Archaea;Nanoarchaeota;Nanoarchaeia;Nanoarchaeales;Nanopusillaceae;Candidatus Nanobsidianus;";"0.0";"0";"11";"11";"0";"11";"0";"457172";"391207"
"V4mis2";"SILVA (only NR);Archaea;Nanoarchaeota;Nanoarchaeia;Nanoarchaeales;Nanopusillaceae;Candidatus Nanopusillus;";"0.0";"0";"7";"7";"0";"7";"0";"457176";"391207"
"V4mis2";"SILVA (only NR);Archaea;Nanoarchaeota;Nanoarchaeia;Woesearchaeales;";"90.7";"14.4";"510";"475";"431";"44";"35";"456708";"390776"
"V4mis2";"SILVA (only NR);Archaea;Nanoarchaeota;Nanoarchaeia;Woesearchaeales;CG1-02-57-44;";"100.0";"14.4";"10";"10";"10";"0";"0";"457173";"391197"
"V4mis2";"SILVA (only NR);Archaea;Nanoarchaeota;Nanoarchaeia;Woesearchaeales;GW2011;";"96.8";"14.4";"32";"31";"30";"1";"1";"457152";"391177"
"V4mis2";"SILVA (only NR);Archaea;Nanoarchaeota;Nanoarchaeia;Woesearchaeales;GW2011;AR15;";"100.0";"14.4";"28";"27";"27";"0";"1";"457156";"391180"
"V4mis2";"SILVA (only NR);Archaea;Nanoarchaeota;Nanoarchaeia;Woesearchaeales;GW2011;AR20;";"75.0";"14.4";"4";"4";"3";"1";"0";"457179";"391204"
"V4mis2";"SILVA (only NR);Archaea;Nanoarchaeota;Nanoarchaeia;Woesearchaeales;GW2011_GWC1_47_15;";"100.0";"14.4";"6";"6";"6";"0";"0";"457177";"391201"
"V4mis2";"SILVA (only NR);Archaea;Nanoarchaeota;Nanoarchaeia;Woesearchaeales;SCGC AAA011-D5;";"100.0";"14.4";"17";"14";"14";"0";"3";"457169";"391193"
"V4mis2";"SILVA (only NR);Archaea;Nanoarchaeota;Nanoarchaeia;Woesearchaeales;SCGC AAA286-E23;";"100.0";"14.4";"6";"6";"6";"0";"0";"457177";"391201"
"V4mis2";"SILVA (only NR);Archaea;Nanohaloarchaeota;";"100.0";"14.4";"34";"34";"34";"0";"0";"457149";"391173"
"V4mis2";"SILVA (only NR);Archaea;Nanohaloarchaeota;Nanosalinia;";"100.0";"14.4";"34";"34";"34";"0";"0";"457149";"391173"
"V4mis2";"SILVA (only NR);Archaea;Nanohaloarchaeota;Nanosalinia;Nanosalinales;";"100.0";"14.4";"34";"34";"34";"0";"0";"457149";"391173"
"V4mis2";"SILVA (only NR);Archaea;Nanohaloarchaeota;Nanosalinia;Nanosalinales;Nanosalinaceae;";"100.0";"14.4";"34";"34";"34";"0";"0";"457149";"391173"
"V4mis2";"SILVA (only NR);Archaea;Nanohaloarchaeota;Nanosalinia;Nanosalinales;Nanosalinaceae;Candidatus Haloredivivus;";"100.0";"14.4";"18";"18";"18";"0";"0";"457165";"391189"
"V4mis2";"SILVA (only NR);Archaea;Nanohaloarchaeota;Nanosalinia;Nanosalinales;Nanosalinaceae;Candidatus Nanosalinarum;";"100.0";"14.4";"6";"6";"6";"0";"0";"457177";"391201"
"V4mis2";"SILVA (only NR);Archaea;Thermoplasmatota;";"96.4";"14.5";"2896";"2872";"2769";"103";"24";"454311";"388438"
"V4mis2";"SILVA (only NR);Archaea;Thermoplasmatota;Thermoplasmata;";"96.3";"14.5";"2819";"2796";"2693";"103";"23";"454387";"388514"
"V4mis2";"SILVA (only NR);Archaea;Thermoplasmatota;Thermoplasmata;A10;";"93.1";"14.4";"29";"29";"27";"2";"0";"457154";"391180"
"V4mis2";"SILVA (only NR);Archaea;Thermoplasmatota;Thermoplasmata;Acidiprofundales;";"100.0";"14.4";"35";"35";"35";"0";"0";"457148";"391172"
"V4mis2";"SILVA (only NR);Archaea;Thermoplasmatota;Thermoplasmata;Acidiprofundales;Aciduliprofundaceae;";"100.0";"14.4";"35";"35";"35";"0";"0";"457148";"391172"
"V4mis2";"SILVA (only NR);Archaea;Thermoplasmatota;Thermoplasmata;Acidiprofundales;Aciduliprofundaceae;Aciduliprofundum;";"100.0";"14.4";"32";"32";"32";"0";"0";"457151";"391175"
"V4mis2";"SILVA (only NR);Archaea;Thermoplasmatota;Thermoplasmata;Acidiprofundales;Aciduliprofundaceae;JdFR-45;";"100.0";"14.4";"3";"3";"3";"0";"0";"457180";"391204"
"V4mis2";"SILVA (only NR);Archaea;Thermoplasmatota;Thermoplasmata;BSLdp215;";"96.0";"14.4";"25";"25";"24";"1";"0";"457158";"391183"
"V4mis2";"SILVA (only NR);Archaea;Thermoplasmatota;Thermoplasmata;JdFR-43;";"63.6";"14.4";"44";"44";"28";"16";"0";"457139";"391179"
"V4mis2";"SILVA (only NR);Archaea;Thermoplasmatota;Thermoplasmata;Marine Benthic Group D and DHVEG-1;";"97.1";"14.5";"765";"758";"736";"22";"7";"456425";"390471"
"V4mis2";"SILVA (only NR);Archaea;Thermoplasmatota;Thermoplasmata;Marine Group II;";"96.3";"14.4";"574";"570";"549";"21";"4";"456613";"390658"
"V4mis2";"SILVA (only NR);Archaea;Thermoplasmatota;Thermoplasmata;Marine Group III;";"98.2";"14.4";"282";"275";"270";"5";"7";"456908";"390937"
"V4mis2";"SILVA (only NR);Archaea;Thermoplasmatota;Thermoplasmata;Methanomassiliicoccales;";"98.2";"14.4";"495";"495";"486";"9";"0";"456688";"390721"
"V4mis2";"SILVA (only NR);Archaea;Thermoplasmatota;Thermoplasmata;Methanomassiliicoccales;Methanomassiliicoccaceae;";"98.4";"14.4";"62";"62";"61";"1";"0";"457121";"391146"
"V4mis2";"SILVA (only NR);Archaea;Thermoplasmatota;Thermoplasmata;Methanomassiliicoccales;Methanomassiliicoccaceae;Methanomassiliicoccus;";"95.0";"14.4";"20";"20";"19";"1";"0";"457163";"391188"
"V4mis2";"SILVA (only NR);Archaea;Thermoplasmatota;Thermoplasmata;Methanomassiliicoccales;Methanomassiliicoccaceae;uncultured;";"100.0";"14.4";"42";"42";"42";"0";"0";"457141";"391165"
"V4mis2";"SILVA (only NR);Archaea;Thermoplasmatota;Thermoplasmata;Methanomassiliicoccales;Methanomethylophilaceae;";"98.3";"14.4";"347";"347";"341";"6";"0";"456836";"390866"
"V4mis2";"SILVA (only NR);Archaea;Thermoplasmatota;Thermoplasmata;Methanomassiliicoccales;Methanomethylophilaceae;Candidatus Methanogranum;";"100.0";"14.4";"7";"7";"7";"0";"0";"457176";"391200"
"V4mis2";"SILVA (only NR);Archaea;Thermoplasmatota;Thermoplasmata;Methanomassiliicoccales;Methanomethylophilaceae;Candidatus Methanomethylophilus;";"98.6";"14.4";"71";"71";"70";"1";"0";"457112";"391137"
"V4mis2";"SILVA (only NR);Archaea;Thermoplasmatota;Thermoplasmata;Methanomassiliicoccales;Methanomethylophilaceae;Candidatus Methanoplasma;";"93.1";"14.4";"29";"29";"27";"2";"0";"457154";"391180"
"V4mis2";"SILVA (only NR);Archaea;Thermoplasmatota;Thermoplasmata;Methanomassiliicoccales;Methanomethylophilaceae;RumEn M2;";"92.3";"14.4";"13";"13";"12";"1";"0";"457170";"391195"
"V4mis2";"SILVA (only NR);Archaea;Thermoplasmatota;Thermoplasmata;Methanomassiliicoccales;Methanomethylophilaceae;uncultured;";"99.1";"14.4";"224";"224";"222";"2";"0";"456959";"390985"
"V4mis2";"SILVA (only NR);Archaea;Thermoplasmatota;Thermoplasmata;Methanomassiliicoccales;uncultured;";"97.7";"14.4";"86";"86";"84";"2";"0";"457097";"391123"
"V4mis2";"SILVA (only NR);Archaea;Thermoplasmatota;Thermoplasmata;SG8-5;";"96.8";"14.4";"63";"63";"61";"2";"0";"457120";"391146"
"V4mis2";"SILVA (only NR);Archaea;Thermoplasmatota;Thermoplasmata;Thermoplasmatales;";"97.5";"14.4";"161";"159";"155";"4";"2";"457024";"391052"
"V4mis2";"SILVA (only NR);Archaea;Thermoplasmatota;Thermoplasmata;Thermoplasmatales;Ferroplasmaceae;";"100.0";"14.4";"69";"68";"68";"0";"1";"457115";"391139"
"V4mis2";"SILVA (only NR);Archaea;Thermoplasmatota;Thermoplasmata;Thermoplasmatales;Ferroplasmaceae;Acidiplasma;";"100.0";"14.4";"8";"7";"7";"0";"1";"457176";"391200"
"V4mis2";"SILVA (only NR);Archaea;Thermoplasmatota;Thermoplasmata;Thermoplasmatales;Ferroplasmaceae;Ferroplasma;";"100.0";"14.4";"38";"38";"38";"0";"0";"457145";"391169"
"V4mis2";"SILVA (only NR);Archaea;Thermoplasmatota;Thermoplasmata;Thermoplasmatales;Ferroplasmaceae;uncultured;";"100.0";"14.4";"15";"15";"15";"0";"0";"457168";"391192"
"V4mis2";"SILVA (only NR);Archaea;Thermoplasmatota;Thermoplasmata;Thermoplasmatales;Picrophilaceae;";"100.0";"14.4";"2";"2";"2";"0";"0";"457181";"391205"
"V4mis2";"SILVA (only NR);Archaea;Thermoplasmatota;Thermoplasmata;Thermoplasmatales;Picrophilaceae;Picrophilus;";"100.0";"14.4";"2";"2";"2";"0";"0";"457181";"391205"
"V4mis2";"SILVA (only NR);Archaea;Thermoplasmatota;Thermoplasmata;Thermoplasmatales;Thermogymnomonas;";"100.0";"14.4";"1";"1";"1";"0";"0";"457182";"391206"
"V4mis2";"SILVA (only NR);Archaea;Thermoplasmatota;Thermoplasmata;Thermoplasmatales;Thermoplasmataceae;";"95.5";"14.4";"89";"88";"84";"4";"1";"457095";"391123"
"V4mis2";"SILVA (only NR);Archaea;Thermoplasmatota;Thermoplasmata;Thermoplasmatales;Thermoplasmataceae;A-plasma;";"92.9";"14.4";"14";"14";"13";"1";"0";"457169";"391194"
"V4mis2";"SILVA (only NR);Archaea;Thermoplasmatota;Thermoplasmata;Thermoplasmatales;Thermoplasmataceae;Cuniculiplasma;";"100.0";"14.4";"12";"12";"12";"0";"0";"457171";"391195"
"V4mis2";"SILVA (only NR);Archaea;Thermoplasmatota;Thermoplasmata;Thermoplasmatales;Thermoplasmataceae;E-plasma;";"100.0";"14.4";"10";"10";"10";"0";"0";"457173";"391197"
"V4mis2";"SILVA (only NR);Archaea;Thermoplasmatota;Thermoplasmata;Thermoplasmatales;Thermoplasmataceae;Thermoplasma;";"100.0";"14.4";"11";"11";"11";"0";"0";"457172";"391196"
"V4mis2";"SILVA (only NR);Archaea;Thermoplasmatota;Thermoplasmata;Thermoplasmatales;Thermoplasmataceae;uncultured;";"92.1";"14.4";"39";"38";"35";"3";"1";"457145";"391172"
"V4mis2";"SILVA (only NR);Archaea;Thermoplasmatota;Thermoplasmata;uncultured;";"93.9";"14.4";"345";"342";"321";"21";"3";"456841";"390886"
"V4mis2";"SILVA (only NR);Archaea;Thermoplasmatota;uncultured;";"100.0";"14.4";"76";"75";"75";"0";"1";"457108";"391132"
"V4mis2";"SILVA (only NR);Archaea;uncultured;";"75.0";"14.4";"8";"8";"6";"2";"0";"457175";"391201"
"V4mis2";"SILVA (only NR);Bacteria;";"94.8";"61.2";"381535";"381528";"361832";"19696";"7";"75655";"29375"
"V4mis2";"SILVA (only NR);Bacteria;10bav-F6;";"100.0";"14.4";"6";"6";"6";"0";"0";"457177";"391201"
"V4mis2";"SILVA (only NR);Bacteria;Abditibacteriota;";"95.7";"14.4";"162";"162";"155";"7";"0";"457021";"391052"
"V4mis2";"SILVA (only NR);Bacteria;Abditibacteriota;Abditibacteria;";"95.7";"14.4";"162";"162";"155";"7";"0";"457021";"391052"
"V4mis2";"SILVA (only NR);Bacteria;Abditibacteriota;Abditibacteria;Abditibacteriales;";"95.7";"14.4";"162";"162";"155";"7";"0";"457021";"391052"
"V4mis2";"SILVA (only NR);Bacteria;Abditibacteriota;Abditibacteria;Abditibacteriales;Abditibacteriaceae;";"95.7";"14.4";"162";"162";"155";"7";"0";"457021";"391052"
"V4mis2";"SILVA (only NR);Bacteria;Abditibacteriota;Abditibacteria;Abditibacteriales;Abditibacteriaceae;Abditibacterium;";"95.7";"14.4";"162";"162";"155";"7";"0";"457021";"391052"
"V4mis2";"SILVA (only NR);Bacteria;Acetothermia;";"98.2";"14.4";"169";"169";"166";"3";"0";"457014";"391041"
"V4mis2";"SILVA (only NR);Bacteria;Acetothermia;Acetothermiia;";"98.2";"14.4";"169";"169";"166";"3";"0";"457014";"391041"
"V4mis2";"SILVA (only NR);Bacteria;Acidobacteriota;";"96.1";"14.7";"11563";"11563";"11108";"455";"0";"445620";"380099"
"V4mis2";"SILVA (only NR);Bacteria;Acidobacteriota;AT-s3-28;";"96.3";"14.4";"27";"27";"26";"1";"0";"457156";"391181"
"V4mis2";"SILVA (only NR);Bacteria;Acidobacteriota;Acidobacteriae;";"96.9";"14.5";"3697";"3697";"3581";"116";"0";"453486";"387626"
"V4mis2";"SILVA (only NR);Bacteria;Acidobacteriota;Acidobacteriae;AKIW659;";"93.1";"14.4";"29";"29";"27";"2";"0";"457154";"391180"
"V4mis2";"SILVA (only NR);Bacteria;Acidobacteriota;Acidobacteriae;AMGG11;";"100.0";"14.4";"5";"5";"5";"0";"0";"457178";"391202"
"V4mis2";"SILVA (only NR);Bacteria;Acidobacteriota;Acidobacteriae;Acidobacteriales;";"97.3";"14.5";"1621";"1621";"1577";"44";"0";"455562";"389630"
"V4mis2";"SILVA (only NR);Bacteria;Acidobacteriota;Acidobacteriae;Acidobacteriales;Acidobacteriaceae (Subgroup 1);";"96.8";"14.4";"740";"740";"716";"24";"0";"456443";"390491"
"V4mis2";"SILVA (only NR);Bacteria;Acidobacteriota;Acidobacteriae;Acidobacteriales;Acidobacteriaceae (Subgroup 1);Acidicapsa;";"100.0";"14.4";"19";"19";"19";"0";"0";"457164";"391188"
"V4mis2";"SILVA (only NR);Bacteria;Acidobacteriota;Acidobacteriae;Acidobacteriales;Acidobacteriaceae (Subgroup 1);Acidipila-Silvibacterium;";"98.8";"14.4";"83";"83";"82";"1";"0";"457100";"391125"
"V4mis2";"SILVA (only NR);Bacteria;Acidobacteriota;Acidobacteriae;Acidobacteriales;Acidobacteriaceae (Subgroup 1);Acidobacterium;";"100.0";"14.4";"12";"12";"12";"0";"0";"457171";"391195"
"V4mis2";"SILVA (only NR);Bacteria;Acidobacteriota;Acidobacteriae;Acidobacteriales;Acidobacteriaceae (Subgroup 1);Bryocella;";"96.4";"14.4";"28";"28";"27";"1";"0";"457155";"391180"
"V4mis2";"SILVA (only NR);Bacteria;Acidobacteriota;Acidobacteriae;Acidobacteriales;Acidobacteriaceae (Subgroup 1);Edaphobacter;";"98.1";"14.4";"52";"52";"51";"1";"0";"457131";"391156"
"V4mis2";"SILVA (only NR);Bacteria;Acidobacteriota;Acidobacteriae;Acidobacteriales;Acidobacteriaceae (Subgroup 1);Granulicella;";"94.7";"14.4";"190";"190";"180";"10";"0";"456993";"391027"
"V4mis2";"SILVA (only NR);Bacteria;Acidobacteriota;Acidobacteriae;Acidobacteriales;Acidobacteriaceae (Subgroup 1);Occallatibacter;";"98.4";"14.4";"126";"126";"124";"2";"0";"457057";"391083"
"V4mis2";"SILVA (only NR);Bacteria;Acidobacteriota;Acidobacteriae;Acidobacteriales;Acidobacteriaceae (Subgroup 1);Telmatobacter;";"100.0";"14.4";"4";"4";"4";"0";"0";"457179";"391203"
"V4mis2";"SILVA (only NR);Bacteria;Acidobacteriota;Acidobacteriae;Acidobacteriales;Acidobacteriaceae (Subgroup 1);Terracidiphilus;";"100.0";"14.4";"9";"9";"9";"0";"0";"457174";"391198"
"V4mis2";"SILVA (only NR);Bacteria;Acidobacteriota;Acidobacteriae;Acidobacteriales;Acidobacteriaceae (Subgroup 1);Terriglobus;";"100.0";"14.4";"27";"27";"27";"0";"0";"457156";"391180"
"V4mis2";"SILVA (only NR);Bacteria;Acidobacteriota;Acidobacteriae;Acidobacteriales;Acidobacteriaceae (Subgroup 1);uncultured;";"95.1";"14.4";"184";"184";"175";"9";"0";"456999";"391032"
"V4mis2";"SILVA (only NR);Bacteria;Acidobacteriota;Acidobacteriae;Acidobacteriales;Koribacteraceae;";"98.9";"14.4";"90";"90";"89";"1";"0";"457093";"391118"
"V4mis2";"SILVA (only NR);Bacteria;Acidobacteriota;Acidobacteriae;Acidobacteriales;Koribacteraceae;Candidatus Koribacter;";"98.9";"14.4";"90";"90";"89";"1";"0";"457093";"391118"
"V4mis2";"SILVA (only NR);Bacteria;Acidobacteriota;Acidobacteriae;Acidobacteriales;uncultured;";"97.6";"14.5";"785";"785";"766";"19";"0";"456398";"390441"
"V4mis2";"SILVA (only NR);Bacteria;Acidobacteriota;Acidobacteriae;Bryobacterales;";"94.6";"14.4";"663";"663";"627";"36";"0";"456520";"390580"
"V4mis2";"SILVA (only NR);Bacteria;Acidobacteriota;Acidobacteriae;Bryobacterales;Bryobacteraceae;";"94.6";"14.4";"663";"663";"627";"36";"0";"456520";"390580"
"V4mis2";"SILVA (only NR);Bacteria;Acidobacteriota;Acidobacteriae;Bryobacterales;Bryobacteraceae;Bryobacter;";"94.6";"14.4";"663";"663";"627";"36";"0";"456520";"390580"
"V4mis2";"SILVA (only NR);Bacteria;Acidobacteriota;Acidobacteriae;Elev-16S-1166;";"100.0";"14.4";"16";"16";"16";"0";"0";"457167";"391191"
"V4mis2";"SILVA (only NR);Bacteria;Acidobacteriota;Acidobacteriae;GOUTB8;";"100.0";"14.4";"16";"16";"16";"0";"0";"457167";"391191"
"V4mis2";"SILVA (only NR);Bacteria;Acidobacteriota;Acidobacteriae;PAUC26f;";"96.4";"14.4";"84";"84";"81";"3";"0";"457099";"391126"
"V4mis2";"SILVA (only NR);Bacteria;Acidobacteriota;Acidobacteriae;Paludibaculum;";"98.1";"14.4";"103";"103";"101";"2";"0";"457080";"391106"
"V4mis2";"SILVA (only NR);Bacteria;Acidobacteriota;Acidobacteriae;Solibacterales;";"97.1";"14.4";"551";"551";"535";"16";"0";"456632";"390672"
"V4mis2";"SILVA (only NR);Bacteria;Acidobacteriota;Acidobacteriae;Solibacterales;Solibacteraceae;";"97.1";"14.4";"551";"551";"535";"16";"0";"456632";"390672"
"V4mis2";"SILVA (only NR);Bacteria;Acidobacteriota;Acidobacteriae;Solibacterales;Solibacteraceae;Candidatus Solibacter;";"97.1";"14.4";"551";"551";"535";"16";"0";"456632";"390672"
"V4mis2";"SILVA (only NR);Bacteria;Acidobacteriota;Acidobacteriae;Subgroup 12;";"100.0";"14.4";"11";"11";"11";"0";"0";"457172";"391196"
"V4mis2";"SILVA (only NR);Bacteria;Acidobacteriota;Acidobacteriae;Subgroup 13;";"98.9";"14.4";"88";"88";"87";"1";"0";"457095";"391120"
"V4mis2";"SILVA (only NR);Bacteria;Acidobacteriota;Acidobacteriae;Subgroup 15;";"96.2";"14.4";"52";"52";"50";"2";"0";"457131";"391157"
"V4mis2";"SILVA (only NR);Bacteria;Acidobacteriota;Acidobacteriae;Subgroup 2;";"97.8";"14.4";"450";"450";"440";"10";"0";"456733";"390767"
"V4mis2";"SILVA (only NR);Bacteria;Acidobacteriota;Acidobacteriae;TSBb06;";"100.0";"14.4";"2";"2";"2";"0";"0";"457181";"391205"
"V4mis2";"SILVA (only NR);Bacteria;Acidobacteriota;Aminicenantia;";"95.6";"14.4";"459";"459";"439";"20";"0";"456724";"390768"
"V4mis2";"SILVA (only NR);Bacteria;Acidobacteriota;Aminicenantia;Aminicenantales;";"95.6";"14.4";"459";"459";"439";"20";"0";"456724";"390768"
"V4mis2";"SILVA (only NR);Bacteria;Acidobacteriota;Blastocatellia;";"94.7";"14.5";"1876";"1876";"1777";"99";"0";"455307";"389430"
"V4mis2";"SILVA (only NR);Bacteria;Acidobacteriota;Blastocatellia;11-24;";"94.5";"14.4";"292";"292";"276";"16";"0";"456891";"390931"
"V4mis2";"SILVA (only NR);Bacteria;Acidobacteriota;Blastocatellia;Blastocatellales;";"96.9";"14.4";"647";"647";"627";"20";"0";"456536";"390580"
"V4mis2";"SILVA (only NR);Bacteria;Acidobacteriota;Blastocatellia;Blastocatellales;Blastocatellaceae;";"96.9";"14.4";"647";"647";"627";"20";"0";"456536";"390580"
"V4mis2";"SILVA (only NR);Bacteria;Acidobacteriota;Blastocatellia;Blastocatellales;Blastocatellaceae;Aridibacter;";"100.0";"14.4";"24";"24";"24";"0";"0";"457159";"391183"
"V4mis2";"SILVA (only NR);Bacteria;Acidobacteriota;Blastocatellia;Blastocatellales;Blastocatellaceae;Blastocatella;";"97.0";"14.4";"165";"165";"160";"5";"0";"457018";"391047"
"V4mis2";"SILVA (only NR);Bacteria;Acidobacteriota;Blastocatellia;Blastocatellales;Blastocatellaceae;JGI 0001001-H03;";"95.5";"14.4";"156";"156";"149";"7";"0";"457027";"391058"
"V4mis2";"SILVA (only NR);Bacteria;Acidobacteriota;Blastocatellia;Blastocatellales;Blastocatellaceae;OLB17;";"100.0";"14.4";"9";"9";"9";"0";"0";"457174";"391198"
"V4mis2";"SILVA (only NR);Bacteria;Acidobacteriota;Blastocatellia;Blastocatellales;Blastocatellaceae;Stenotrophobacter;";"97.1";"14.4";"104";"104";"101";"3";"0";"457079";"391106"
"V4mis2";"SILVA (only NR);Bacteria;Acidobacteriota;Blastocatellia;Blastocatellales;Blastocatellaceae;Tellurimicrobium;";"100.0";"14.4";"4";"4";"4";"0";"0";"457179";"391203"
"V4mis2";"SILVA (only NR);Bacteria;Acidobacteriota;Blastocatellia;Blastocatellales;Blastocatellaceae;uncultured;";"97.2";"14.4";"180";"180";"175";"5";"0";"457003";"391032"
"V4mis2";"SILVA (only NR);Bacteria;Acidobacteriota;Blastocatellia;Chloracidobacteriales;";"100.0";"14.4";"13";"13";"13";"0";"0";"457170";"391194"
"V4mis2";"SILVA (only NR);Bacteria;Acidobacteriota;Blastocatellia;Chloracidobacteriales;Chloracidobacteriaceae;";"100.0";"14.4";"13";"13";"13";"0";"0";"457170";"391194"
"V4mis2";"SILVA (only NR);Bacteria;Acidobacteriota;Blastocatellia;Chloracidobacteriales;Chloracidobacteriaceae;Chloracidobacterium;";"100.0";"14.4";"13";"13";"13";"0";"0";"457170";"391194"
"V4mis2";"SILVA (only NR);Bacteria;Acidobacteriota;Blastocatellia;DS-100;";"97.4";"14.4";"38";"38";"37";"1";"0";"457145";"391170"
"V4mis2";"SILVA (only NR);Bacteria;Acidobacteriota;Blastocatellia;Elev-16S-573;";"100.0";"14.4";"36";"36";"36";"0";"0";"457147";"391171"
"V4mis2";"SILVA (only NR);Bacteria;Acidobacteriota;Blastocatellia;Pyrinomonadales;";"92.7";"14.4";"850";"850";"788";"62";"0";"456333";"390419"
"V4mis2";"SILVA (only NR);Bacteria;Acidobacteriota;Blastocatellia;Pyrinomonadales;Pyrinomonadaceae;";"92.7";"14.4";"850";"850";"788";"62";"0";"456333";"390419"
"V4mis2";"SILVA (only NR);Bacteria;Acidobacteriota;Blastocatellia;Pyrinomonadales;Pyrinomonadaceae;Pyrinomonas;";"100.0";"14.4";"4";"4";"4";"0";"0";"457179";"391203"
"V4mis2";"SILVA (only NR);Bacteria;Acidobacteriota;Blastocatellia;Pyrinomonadales;Pyrinomonadaceae;RB41;";"92.7";"14.4";"846";"846";"784";"62";"0";"456337";"390423"
"V4mis2";"SILVA (only NR);Bacteria;Acidobacteriota;FFCH5909;";"100.0";"14.4";"4";"4";"4";"0";"0";"457179";"391203"
"V4mis2";"SILVA (only NR);Bacteria;Acidobacteriota;GBS-L1-B05;";"100.0";"14.4";"3";"3";"3";"0";"0";"457180";"391204"
"V4mis2";"SILVA (only NR);Bacteria;Acidobacteriota;Holophagae;";"96.0";"14.4";"655";"655";"629";"26";"0";"456528";"390578"
"V4mis2";"SILVA (only NR);Bacteria;Acidobacteriota;Holophagae;Acanthopleuribacterales;";"100.0";"14.4";"34";"34";"34";"0";"0";"457149";"391173"
"V4mis2";"SILVA (only NR);Bacteria;Acidobacteriota;Holophagae;Acanthopleuribacterales;Acanthopleuribacteraceae;";"100.0";"14.4";"34";"34";"34";"0";"0";"457149";"391173"
"V4mis2";"SILVA (only NR);Bacteria;Acidobacteriota;Holophagae;Acanthopleuribacterales;Acanthopleuribacteraceae;Acanthopleuribacter;";"100.0";"14.4";"25";"25";"25";"0";"0";"457158";"391182"
"V4mis2";"SILVA (only NR);Bacteria;Acidobacteriota;Holophagae;Acanthopleuribacterales;Acanthopleuribacteraceae;Thermotomaculum;";"100.0";"14.4";"9";"9";"9";"0";"0";"457174";"391198"
"V4mis2";"SILVA (only NR);Bacteria;Acidobacteriota;Holophagae;Holophagales;";"98.9";"14.4";"184";"184";"182";"2";"0";"456999";"391025"
"V4mis2";"SILVA (only NR);Bacteria;Acidobacteriota;Holophagae;Holophagales;Holophagaceae;";"98.9";"14.4";"184";"184";"182";"2";"0";"456999";"391025"
"V4mis2";"SILVA (only NR);Bacteria;Acidobacteriota;Holophagae;Holophagales;Holophagaceae;Geothrix;";"98.0";"14.4";"50";"50";"49";"1";"0";"457133";"391158"
"V4mis2";"SILVA (only NR);Bacteria;Acidobacteriota;Holophagae;Holophagales;Holophagaceae;Holophaga;";"94.7";"14.4";"19";"19";"18";"1";"0";"457164";"391189"
"V4mis2";"SILVA (only NR);Bacteria;Acidobacteriota;Holophagae;Holophagales;Holophagaceae;marine group;";"100.0";"14.4";"34";"34";"34";"0";"0";"457149";"391173"
"V4mis2";"SILVA (only NR);Bacteria;Acidobacteriota;Holophagae;Holophagales;Holophagaceae;uncultured;";"100.0";"14.4";"70";"70";"70";"0";"0";"457113";"391137"
"V4mis2";"SILVA (only NR);Bacteria;Acidobacteriota;Holophagae;Subgroup 7;";"94.5";"14.4";"437";"437";"413";"24";"0";"456746";"390794"
"V4mis2";"SILVA (only NR);Bacteria;Acidobacteriota;ODP1230B23.02;";"100.0";"14.4";"13";"13";"13";"0";"0";"457170";"391194"
"V4mis2";"SILVA (only NR);Bacteria;Acidobacteriota;Subgroup 11;";"100.0";"14.4";"52";"52";"52";"0";"0";"457131";"391155"
"V4mis2";"SILVA (only NR);Bacteria;Acidobacteriota;Subgroup 18;";"99.2";"14.4";"131";"131";"130";"1";"0";"457052";"391077"
"V4mis2";"SILVA (only NR);Bacteria;Acidobacteriota;Subgroup 19;";"100.0";"14.4";"3";"3";"3";"0";"0";"457180";"391204"
"V4mis2";"SILVA (only NR);Bacteria;Acidobacteriota;Subgroup 20;";"100.0";"14.4";"5";"5";"5";"0";"0";"457178";"391202"
"V4mis2";"SILVA (only NR);Bacteria;Acidobacteriota;Subgroup 21;";"96.6";"14.4";"178";"178";"172";"6";"0";"457005";"391035"
"V4mis2";"SILVA (only NR);Bacteria;Acidobacteriota;Subgroup 22;";"97.3";"14.4";"337";"337";"328";"9";"0";"456846";"390879"
"V4mis2";"SILVA (only NR);Bacteria;Acidobacteriota;Subgroup 25;";"96.6";"14.4";"59";"59";"57";"2";"0";"457124";"391150"
"V4mis2";"SILVA (only NR);Bacteria;Acidobacteriota;Subgroup 26;";"96.6";"14.4";"58";"58";"56";"2";"0";"457125";"391151"
"V4mis2";"SILVA (only NR);Bacteria;Acidobacteriota;Subgroup 5;";"96.9";"14.4";"255";"255";"247";"8";"0";"456928";"390960"
"V4mis2";"SILVA (only NR);Bacteria;Acidobacteriota;Thermoanaerobaculia;";"94.0";"14.4";"602";"602";"566";"36";"0";"456581";"390641"
"V4mis2";"SILVA (only NR);Bacteria;Acidobacteriota;Thermoanaerobaculia;Thermoanaerobaculales;";"94.0";"14.4";"602";"602";"566";"36";"0";"456581";"390641"
"V4mis2";"SILVA (only NR);Bacteria;Acidobacteriota;Thermoanaerobaculia;Thermoanaerobaculales;Thermoanaerobaculaceae;";"94.0";"14.4";"602";"602";"566";"36";"0";"456581";"390641"
"V4mis2";"SILVA (only NR);Bacteria;Acidobacteriota;Thermoanaerobaculia;Thermoanaerobaculales;Thermoanaerobaculaceae;B276-D12;";"100.0";"14.4";"3";"3";"3";"0";"0";"457180";"391204"
"V4mis2";"SILVA (only NR);Bacteria;Acidobacteriota;Thermoanaerobaculia;Thermoanaerobaculales;Thermoanaerobaculaceae;Subgroup 10;";"93.9";"14.4";"425";"425";"399";"26";"0";"456758";"390808"
"V4mis2";"SILVA (only NR);Bacteria;Acidobacteriota;Thermoanaerobaculia;Thermoanaerobaculales;Thermoanaerobaculaceae;Subgroup 23;";"93.0";"14.4";"129";"129";"120";"9";"0";"457054";"391087"
"V4mis2";"SILVA (only NR);Bacteria;Acidobacteriota;Thermoanaerobaculia;Thermoanaerobaculales;Thermoanaerobaculaceae;TPD-58;";"100.0";"14.4";"18";"18";"18";"0";"0";"457165";"391189"
"V4mis2";"SILVA (only NR);Bacteria;Acidobacteriota;Thermoanaerobaculia;Thermoanaerobaculales;Thermoanaerobaculaceae;Thermoanaerobaculum;";"96.3";"14.4";"27";"27";"26";"1";"0";"457156";"391181"
"V4mis2";"SILVA (only NR);Bacteria;Acidobacteriota;Vicinamibacteria;";"95.9";"14.5";"3118";"3118";"2991";"127";"0";"454065";"388216"
"V4mis2";"SILVA (only NR);Bacteria;Acidobacteriota;Vicinamibacteria;11B-2;";"100.0";"14.4";"3";"3";"3";"0";"0";"457180";"391204"
"V4mis2";"SILVA (only NR);Bacteria;Acidobacteriota;Vicinamibacteria;Subgroup 17;";"97.4";"14.4";"227";"227";"221";"6";"0";"456956";"390986"
"V4mis2";"SILVA (only NR);Bacteria;Acidobacteriota;Vicinamibacteria;Subgroup 9;";"96.9";"14.4";"130";"130";"126";"4";"0";"457053";"391081"
"V4mis2";"SILVA (only NR);Bacteria;Acidobacteriota;Vicinamibacteria;Vicinamibacterales;";"95.8";"14.5";"2758";"2758";"2641";"117";"0";"454425";"388566"
"V4mis2";"SILVA (only NR);Bacteria;Acidobacteriota;Vicinamibacteria;Vicinamibacterales;Vicinamibacteraceae;";"95.4";"14.5";"1056";"1056";"1007";"49";"0";"456127";"390200"
"V4mis2";"SILVA (only NR);Bacteria;Acidobacteriota;Vicinamibacteria;Vicinamibacterales;Vicinamibacteraceae;Luteitalea;";"94.7";"14.4";"57";"57";"54";"3";"0";"457126";"391153"
"V4mis2";"SILVA (only NR);Bacteria;Acidobacteriota;Vicinamibacteria;Vicinamibacterales;Vicinamibacteraceae;Vicinamibacter;";"91.7";"14.4";"24";"24";"22";"2";"0";"457159";"391185"
"V4mis2";"SILVA (only NR);Bacteria;Acidobacteriota;Vicinamibacteria;Vicinamibacterales;Vicinamibacteraceae;uncultured;";"92.9";"14.4";"42";"42";"39";"3";"0";"457141";"391168"
"V4mis2";"SILVA (only NR);Bacteria;Acidobacteriota;Vicinamibacteria;Vicinamibacterales;uncultured;";"96.0";"14.5";"1688";"1688";"1620";"68";"0";"455495";"389587"
"V4mis2";"SILVA (only NR);Bacteria;Acidobacteriota;c5LKS83;";"81.8";"14.4";"11";"11";"9";"2";"0";"457172";"391198"
"V4mis2";"SILVA (only NR);Bacteria;Acidobacteriota;d142;";"100.0";"14.4";"17";"17";"17";"0";"0";"457166";"391190"
"V4mis2";"SILVA (only NR);Bacteria;Actinobacteriota;";"94.3";"15.2";"36942";"36942";"34838";"2104";"0";"420241";"356369"
"V4mis2";"SILVA (only NR);Bacteria;Actinobacteriota;Acidimicrobiia;";"96.1";"14.5";"2771";"2771";"2663";"108";"0";"454412";"388544"
"V4mis2";"SILVA (only NR);Bacteria;Actinobacteriota;Acidimicrobiia;Acidimicrobiales;";"100.0";"14.4";"64";"64";"64";"0";"0";"457119";"391143"
"V4mis2";"SILVA (only NR);Bacteria;Actinobacteriota;Acidimicrobiia;Acidimicrobiales;Acidimicrobiaceae;";"100.0";"14.4";"60";"60";"60";"0";"0";"457123";"391147"
"V4mis2";"SILVA (only NR);Bacteria;Actinobacteriota;Acidimicrobiia;Acidimicrobiales;Acidimicrobiaceae;Acidimicrobium;";"100.0";"14.4";"9";"9";"9";"0";"0";"457174";"391198"
"V4mis2";"SILVA (only NR);Bacteria;Actinobacteriota;Acidimicrobiia;Acidimicrobiales;Acidimicrobiaceae;Acidithrix;";"100.0";"14.4";"13";"13";"13";"0";"0";"457170";"391194"
"V4mis2";"SILVA (only NR);Bacteria;Actinobacteriota;Acidimicrobiia;Acidimicrobiales;Acidimicrobiaceae;Ferrimicrobium;";"100.0";"14.4";"9";"9";"9";"0";"0";"457174";"391198"
"V4mis2";"SILVA (only NR);Bacteria;Actinobacteriota;Acidimicrobiia;Acidimicrobiales;Acidimicrobiaceae;Ferrithrix;";"100.0";"14.4";"16";"16";"16";"0";"0";"457167";"391191"
"V4mis2";"SILVA (only NR);Bacteria;Actinobacteriota;Acidimicrobiia;Acidimicrobiales;Acidimicrobiaceae;uncultured;";"100.0";"14.4";"12";"12";"12";"0";"0";"457171";"391195"
"V4mis2";"SILVA (only NR);Bacteria;Actinobacteriota;Acidimicrobiia;Acidimicrobiales;Acidimicrobiales Incertae Sedis;";"100.0";"14.4";"4";"4";"4";"0";"0";"457179";"391203"
"V4mis2";"SILVA (only NR);Bacteria;Actinobacteriota;Acidimicrobiia;Acidimicrobiales;Acidimicrobiales Incertae Sedis;Aciditerrimonas;";"100.0";"14.4";"4";"4";"4";"0";"0";"457179";"391203"
"V4mis2";"SILVA (only NR);Bacteria;Actinobacteriota;Acidimicrobiia;Actinomarinales;";"95.6";"14.4";"666";"666";"637";"29";"0";"456517";"390570"
"V4mis2";"SILVA (only NR);Bacteria;Actinobacteriota;Acidimicrobiia;Actinomarinales;Actinomarinaceae;";"97.2";"14.4";"178";"178";"173";"5";"0";"457005";"391034"
"V4mis2";"SILVA (only NR);Bacteria;Actinobacteriota;Acidimicrobiia;Actinomarinales;Actinomarinaceae;Candidatus Actinomarina;";"97.2";"14.4";"178";"178";"173";"5";"0";"457005";"391034"
"V4mis2";"SILVA (only NR);Bacteria;Actinobacteriota;Acidimicrobiia;Actinomarinales;uncultured;";"95.1";"14.4";"485";"485";"461";"24";"0";"456698";"390746"
"V4mis2";"SILVA (only NR);Bacteria;Actinobacteriota;Acidimicrobiia;IMCC26256;";"97.8";"14.4";"321";"321";"314";"7";"0";"456862";"390893"
"V4mis2";"SILVA (only NR);Bacteria;Actinobacteriota;Acidimicrobiia;Microtrichales;";"95.9";"14.5";"1496";"1496";"1434";"62";"0";"455687";"389773"
"V4mis2";"SILVA (only NR);Bacteria;Actinobacteriota;Acidimicrobiia;Microtrichales;Iamiaceae;";"97.2";"14.4";"144";"144";"140";"4";"0";"457039";"391067"
"V4mis2";"SILVA (only NR);Bacteria;Actinobacteriota;Acidimicrobiia;Microtrichales;Iamiaceae;Iamia;";"97.2";"14.4";"144";"144";"140";"4";"0";"457039";"391067"
"V4mis2";"SILVA (only NR);Bacteria;Actinobacteriota;Acidimicrobiia;Microtrichales;Ilumatobacteraceae;";"95.1";"14.4";"546";"546";"519";"27";"0";"456637";"390688"
"V4mis2";"SILVA (only NR);Bacteria;Actinobacteriota;Acidimicrobiia;Microtrichales;Ilumatobacteraceae;CL500-29 marine group;";"96.9";"14.4";"256";"256";"248";"8";"0";"456927";"390959"
"V4mis2";"SILVA (only NR);Bacteria;Actinobacteriota;Acidimicrobiia;Microtrichales;Ilumatobacteraceae;Ilumatobacter;";"95.8";"14.4";"96";"96";"92";"4";"0";"457087";"391115"
"V4mis2";"SILVA (only NR);Bacteria;Actinobacteriota;Acidimicrobiia;Microtrichales;Ilumatobacteraceae;uncultured;";"92.1";"14.4";"189";"189";"174";"15";"0";"456994";"391033"
"V4mis2";"SILVA (only NR);Bacteria;Actinobacteriota;Acidimicrobiia;Microtrichales;Microtrichaceae;";"96.0";"14.4";"521";"521";"500";"21";"0";"456662";"390707"
"V4mis2";"SILVA (only NR);Bacteria;Actinobacteriota;Acidimicrobiia;Microtrichales;Microtrichaceae;Candidatus Microthrix;";"100.0";"14.4";"35";"35";"35";"0";"0";"457148";"391172"
"V4mis2";"SILVA (only NR);Bacteria;Actinobacteriota;Acidimicrobiia;Microtrichales;Microtrichaceae;IMCC26207;";"100.0";"14.4";"44";"44";"44";"0";"0";"457139";"391163"
"V4mis2";"SILVA (only NR);Bacteria;Actinobacteriota;Acidimicrobiia;Microtrichales;Microtrichaceae;Sva0996 marine group;";"94.8";"14.4";"307";"307";"291";"16";"0";"456876";"390916"
"V4mis2";"SILVA (only NR);Bacteria;Actinobacteriota;Acidimicrobiia;Microtrichales;Microtrichaceae;uncultured;";"96.3";"14.4";"135";"135";"130";"5";"0";"457048";"391077"
"V4mis2";"SILVA (only NR);Bacteria;Actinobacteriota;Acidimicrobiia;Microtrichales;uncultured;";"96.4";"14.4";"281";"281";"271";"10";"0";"456902";"390936"
"V4mis2";"SILVA (only NR);Bacteria;Actinobacteriota;Acidimicrobiia;uncultured;";"95.5";"14.4";"223";"223";"213";"10";"0";"456960";"390994"
"V4mis2";"SILVA (only NR);Bacteria;Actinobacteriota;Actinobacteria;";"94.0";"15";"30683";"30683";"28833";"1850";"0";"426500";"362374"
"V4mis2";"SILVA (only NR);Bacteria;Actinobacteriota;Actinobacteria;0319-7L14;";"91.4";"14.4";"35";"35";"32";"3";"0";"457148";"391175"
"V4mis2";"SILVA (only NR);Bacteria;Actinobacteriota;Actinobacteria;Actinomycetales;";"96.4";"14.5";"942";"942";"908";"34";"0";"456241";"390299"
"V4mis2";"SILVA (only NR);Bacteria;Actinobacteriota;Actinobacteria;Actinomycetales;Actinomycetaceae;";"96.3";"14.5";"919";"919";"885";"34";"0";"456264";"390322"
"V4mis2";"SILVA (only NR);Bacteria;Actinobacteriota;Actinobacteria;Actinomycetales;Actinomycetaceae;Actinobaculum;";"100.0";"14.4";"2";"2";"2";"0";"0";"457181";"391205"
"V4mis2";"SILVA (only NR);Bacteria;Actinobacteriota;Actinobacteria;Actinomycetales;Actinomycetaceae;Actinomyces;";"95.7";"14.4";"691";"691";"661";"30";"0";"456492";"390546"
"V4mis2";"SILVA (only NR);Bacteria;Actinobacteriota;Actinobacteria;Actinomycetales;Actinomycetaceae;Actinotignum;";"100.0";"14.4";"15";"15";"15";"0";"0";"457168";"391192"
"V4mis2";"SILVA (only NR);Bacteria;Actinobacteriota;Actinobacteria;Actinomycetales;Actinomycetaceae;Arcanobacterium;";"100.0";"14.4";"30";"30";"30";"0";"0";"457153";"391177"
"V4mis2";"SILVA (only NR);Bacteria;Actinobacteriota;Actinobacteria;Actinomycetales;Actinomycetaceae;F0332;";"98.0";"14.4";"49";"49";"48";"1";"0";"457134";"391159"
"V4mis2";"SILVA (only NR);Bacteria;Actinobacteriota;Actinobacteria;Actinomycetales;Actinomycetaceae;Flaviflexus;";"100.0";"14.4";"13";"13";"13";"0";"0";"457170";"391194"
"V4mis2";"SILVA (only NR);Bacteria;Actinobacteriota;Actinobacteria;Actinomycetales;Actinomycetaceae;Mobiluncus;";"100.0";"14.4";"34";"34";"34";"0";"0";"457149";"391173"
"V4mis2";"SILVA (only NR);Bacteria;Actinobacteriota;Actinobacteria;Actinomycetales;Actinomycetaceae;Trueperella;";"96.7";"14.4";"30";"30";"29";"1";"0";"457153";"391178"
"V4mis2";"SILVA (only NR);Bacteria;Actinobacteriota;Actinobacteria;Actinomycetales;Actinomycetaceae;Varibaculum;";"94.6";"14.4";"37";"37";"35";"2";"0";"457146";"391172"
"V4mis2";"SILVA (only NR);Bacteria;Actinobacteriota;Actinobacteria;Actinomycetales;Actinomycetaceae;uncultured;";"100.0";"14.4";"10";"10";"10";"0";"0";"457173";"391197"
"V4mis2";"SILVA (only NR);Bacteria;Actinobacteriota;Actinobacteria;Actinomycetales;Actinomycetales Incertae Sedis;";"100.0";"14.4";"23";"23";"23";"0";"0";"457160";"391184"
"V4mis2";"SILVA (only NR);Bacteria;Actinobacteriota;Actinobacteria;Actinomycetales;Actinomycetales Incertae Sedis;Candidatus Ancillula;";"100.0";"14.4";"23";"23";"23";"0";"0";"457160";"391184"
"V4mis2";"SILVA (only NR);Bacteria;Actinobacteriota;Actinobacteria;Bifidobacteriales;";"96.2";"14.4";"505";"505";"486";"19";"0";"456678";"390721"
"V4mis2";"SILVA (only NR);Bacteria;Actinobacteriota;Actinobacteria;Bifidobacteriales;Bifidobacteriaceae;";"96.2";"14.4";"505";"505";"486";"19";"0";"456678";"390721"
"V4mis2";"SILVA (only NR);Bacteria;Actinobacteriota;Actinobacteria;Bifidobacteriales;Bifidobacteriaceae;Aeriscardovia;";"100.0";"14.4";"5";"5";"5";"0";"0";"457178";"391202"
"V4mis2";"SILVA (only NR);Bacteria;Actinobacteriota;Actinobacteria;Bifidobacteriales;Bifidobacteriaceae;Alloscardovia;";"100.0";"14.4";"16";"16";"16";"0";"0";"457167";"391191"
"V4mis2";"SILVA (only NR);Bacteria;Actinobacteriota;Actinobacteria;Bifidobacteriales;Bifidobacteriaceae;Bifidobacterium;";"96.0";"14.4";"449";"449";"431";"18";"0";"456734";"390776"
"V4mis2";"SILVA (only NR);Bacteria;Actinobacteriota;Actinobacteria;Bifidobacteriales;Bifidobacteriaceae;Bombiscardovia;";"66.7";"14.4";"3";"3";"2";"1";"0";"457180";"391205"
"V4mis2";"SILVA (only NR);Bacteria;Actinobacteriota;Actinobacteria;Bifidobacteriales;Bifidobacteriaceae;Gardnerella;";"100.0";"14.4";"15";"15";"15";"0";"0";"457168";"391192"
"V4mis2";"SILVA (only NR);Bacteria;Actinobacteriota;Actinobacteria;Bifidobacteriales;Bifidobacteriaceae;Neoscardovia;";"100.0";"14.4";"1";"1";"1";"0";"0";"457182";"391206"
"V4mis2";"SILVA (only NR);Bacteria;Actinobacteriota;Actinobacteria;Bifidobacteriales;Bifidobacteriaceae;Parascardovia;";"100.0";"14.4";"4";"4";"4";"0";"0";"457179";"391203"
"V4mis2";"SILVA (only NR);Bacteria;Actinobacteriota;Actinobacteria;Bifidobacteriales;Bifidobacteriaceae;Pseudoscardovia;";"100.0";"14.4";"3";"3";"3";"0";"0";"457180";"391204"
"V4mis2";"SILVA (only NR);Bacteria;Actinobacteriota;Actinobacteria;Bifidobacteriales;Bifidobacteriaceae;Scardovia;";"100.0";"14.4";"5";"5";"5";"0";"0";"457178";"391202"
"V4mis2";"SILVA (only NR);Bacteria;Actinobacteriota;Actinobacteria;Bifidobacteriales;Bifidobacteriaceae;uncultured;";"100.0";"14.4";"2";"2";"2";"0";"0";"457181";"391205"
"V4mis2";"SILVA (only NR);Bacteria;Actinobacteriota;Actinobacteria;Catenulisporales;";"100.0";"14.4";"36";"36";"36";"0";"0";"457147";"391171"
"V4mis2";"SILVA (only NR);Bacteria;Actinobacteriota;Actinobacteria;Catenulisporales;Actinospicaceae;";"100.0";"14.4";"26";"26";"26";"0";"0";"457157";"391181"
"V4mis2";"SILVA (only NR);Bacteria;Actinobacteriota;Actinobacteria;Catenulisporales;Actinospicaceae;Actinospica;";"100.0";"14.4";"26";"26";"26";"0";"0";"457157";"391181"
"V4mis2";"SILVA (only NR);Bacteria;Actinobacteriota;Actinobacteria;Catenulisporales;Catenulisporaceae;";"100.0";"14.4";"10";"10";"10";"0";"0";"457173";"391197"
"V4mis2";"SILVA (only NR);Bacteria;Actinobacteriota;Actinobacteria;Catenulisporales;Catenulisporaceae;Catenulispora;";"100.0";"14.4";"10";"10";"10";"0";"0";"457173";"391197"
"V4mis2";"SILVA (only NR);Bacteria;Actinobacteriota;Actinobacteria;Corynebacteriales;";"93.6";"14.5";"6456";"6456";"6044";"412";"0";"450727";"385163"
"V4mis2";"SILVA (only NR);Bacteria;Actinobacteriota;Actinobacteria;Corynebacteriales;Corynebacteriaceae;";"89.6";"14.5";"3111";"3111";"2788";"323";"0";"454072";"388419"
"V4mis2";"SILVA (only NR);Bacteria;Actinobacteriota;Actinobacteria;Corynebacteriales;Corynebacteriaceae;Corynebacterium;";"90.1";"14.5";"2941";"2941";"2650";"291";"0";"454242";"388557"
"V4mis2";"SILVA (only NR);Bacteria;Actinobacteriota;Actinobacteria;Corynebacteriales;Corynebacteriaceae;Lawsonella;";"79.6";"14.4";"142";"142";"113";"29";"0";"457041";"391094"
"V4mis2";"SILVA (only NR);Bacteria;Actinobacteriota;Actinobacteria;Corynebacteriales;Corynebacteriaceae;Turicella;";"84.2";"14.4";"19";"19";"16";"3";"0";"457164";"391191"
"V4mis2";"SILVA (only NR);Bacteria;Actinobacteriota;Actinobacteria;Corynebacteriales;Corynebacteriaceae;uncultured;";"100.0";"14.4";"3";"3";"3";"0";"0";"457180";"391204"
"V4mis2";"SILVA (only NR);Bacteria;Actinobacteriota;Actinobacteria;Corynebacteriales;Corynebacteriales Incertae Sedis;";"100.0";"14.4";"6";"6";"6";"0";"0";"457177";"391201"
"V4mis2";"SILVA (only NR);Bacteria;Actinobacteriota;Actinobacteria;Corynebacteriales;Corynebacteriales Incertae Sedis;Tomitella;";"100.0";"14.4";"6";"6";"6";"0";"0";"457177";"391201"
"V4mis2";"SILVA (only NR);Bacteria;Actinobacteriota;Actinobacteria;Corynebacteriales;Dietziaceae;";"93.3";"14.4";"120";"120";"112";"8";"0";"457063";"391095"
"V4mis2";"SILVA (only NR);Bacteria;Actinobacteriota;Actinobacteria;Corynebacteriales;Dietziaceae;Dietzia;";"93.3";"14.4";"120";"120";"112";"8";"0";"457063";"391095"
"V4mis2";"SILVA (only NR);Bacteria;Actinobacteriota;Actinobacteria;Corynebacteriales;Mycobacteriaceae;";"98.2";"14.5";"1535";"1535";"1508";"27";"0";"455648";"389699"
"V4mis2";"SILVA (only NR);Bacteria;Actinobacteriota;Actinobacteria;Corynebacteriales;Mycobacteriaceae;Hoyosella;";"100.0";"14.4";"7";"7";"7";"0";"0";"457176";"391200"
"V4mis2";"SILVA (only NR);Bacteria;Actinobacteriota;Actinobacteria;Corynebacteriales;Mycobacteriaceae;Mycobacterium;";"98.2";"14.5";"1528";"1528";"1501";"27";"0";"455655";"389706"
"V4mis2";"SILVA (only NR);Bacteria;Actinobacteriota;Actinobacteria;Corynebacteriales;Nocardiaceae;";"96.7";"14.5";"1618";"1618";"1565";"53";"0";"455565";"389642"
"V4mis2";"SILVA (only NR);Bacteria;Actinobacteriota;Actinobacteria;Corynebacteriales;Nocardiaceae;Gordonia;";"95.4";"14.4";"238";"238";"227";"11";"0";"456945";"390980"
"V4mis2";"SILVA (only NR);Bacteria;Actinobacteriota;Actinobacteria;Corynebacteriales;Nocardiaceae;Millisia;";"100.0";"14.4";"1";"1";"1";"0";"0";"457182";"391206"
"V4mis2";"SILVA (only NR);Bacteria;Actinobacteriota;Actinobacteria;Corynebacteriales;Nocardiaceae;Nocardia;";"98.7";"14.5";"678";"678";"669";"9";"0";"456505";"390538"
"V4mis2";"SILVA (only NR);Bacteria;Actinobacteriota;Actinobacteria;Corynebacteriales;Nocardiaceae;Rhodococcus;";"95.0";"14.4";"645";"645";"613";"32";"0";"456538";"390594"
"V4mis2";"SILVA (only NR);Bacteria;Actinobacteriota;Actinobacteria;Corynebacteriales;Nocardiaceae;Skermania;";"100.0";"14.4";"4";"4";"4";"0";"0";"457179";"391203"
"V4mis2";"SILVA (only NR);Bacteria;Actinobacteriota;Actinobacteria;Corynebacteriales;Nocardiaceae;Smaragdicoccus;";"87.5";"14.4";"8";"8";"7";"1";"0";"457175";"391200"
"V4mis2";"SILVA (only NR);Bacteria;Actinobacteriota;Actinobacteria;Corynebacteriales;Nocardiaceae;Williamsia;";"100.0";"14.4";"38";"38";"38";"0";"0";"457145";"391169"
"V4mis2";"SILVA (only NR);Bacteria;Actinobacteriota;Actinobacteria;Corynebacteriales;Segniliparaceae;";"100.0";"14.4";"10";"10";"10";"0";"0";"457173";"391197"
"V4mis2";"SILVA (only NR);Bacteria;Actinobacteriota;Actinobacteria;Corynebacteriales;Segniliparaceae;Segniliparus;";"100.0";"14.4";"6";"6";"6";"0";"0";"457177";"391201"
"V4mis2";"SILVA (only NR);Bacteria;Actinobacteriota;Actinobacteria;Corynebacteriales;Segniliparaceae;uncultured;";"100.0";"14.4";"4";"4";"4";"0";"0";"457179";"391203"
"V4mis2";"SILVA (only NR);Bacteria;Actinobacteriota;Actinobacteria;Corynebacteriales;Tsukamurellaceae;";"98.0";"14.4";"51";"51";"50";"1";"0";"457132";"391157"
"V4mis2";"SILVA (only NR);Bacteria;Actinobacteriota;Actinobacteria;Corynebacteriales;Tsukamurellaceae;Tsukamurella;";"98.0";"14.4";"51";"51";"50";"1";"0";"457132";"391157"
"V4mis2";"SILVA (only NR);Bacteria;Actinobacteriota;Actinobacteria;Corynebacteriales;uncultured;";"100.0";"14.4";"4";"4";"4";"0";"0";"457179";"391203"
"V4mis2";"SILVA (only NR);Bacteria;Actinobacteriota;Actinobacteria;Elev-16S-976;";"100.0";"14.4";"4";"4";"4";"0";"0";"457179";"391203"
"V4mis2";"SILVA (only NR);Bacteria;Actinobacteriota;Actinobacteria;Euzebyales;";"82.9";"14.4";"111";"111";"92";"19";"0";"457072";"391115"
"V4mis2";"SILVA (only NR);Bacteria;Actinobacteriota;Actinobacteria;Euzebyales;Euzebyaceae;";"82.9";"14.4";"111";"111";"92";"19";"0";"457072";"391115"
"V4mis2";"SILVA (only NR);Bacteria;Actinobacteriota;Actinobacteria;Euzebyales;Euzebyaceae;Egibacter;";"100.0";"14.4";"4";"4";"4";"0";"0";"457179";"391203"
"V4mis2";"SILVA (only NR);Bacteria;Actinobacteriota;Actinobacteria;Euzebyales;Euzebyaceae;Euzebya;";"100.0";"14.4";"8";"8";"8";"0";"0";"457175";"391199"
"V4mis2";"SILVA (only NR);Bacteria;Actinobacteriota;Actinobacteria;Euzebyales;Euzebyaceae;uncultured;";"80.8";"14.4";"99";"99";"80";"19";"0";"457084";"391127"
"V4mis2";"SILVA (only NR);Bacteria;Actinobacteriota;Actinobacteria;FFCH16263;";"100.0";"14.4";"3";"3";"3";"0";"0";"457180";"391204"
"V4mis2";"SILVA (only NR);Bacteria;Actinobacteriota;Actinobacteria;Frankiales;";"97.0";"14.5";"1118";"1118";"1085";"33";"0";"456065";"390122"
"V4mis2";"SILVA (only NR);Bacteria;Actinobacteriota;Actinobacteria;Frankiales;Acidothermaceae;";"99.0";"14.4";"97";"97";"96";"1";"0";"457086";"391111"
"V4mis2";"SILVA (only NR);Bacteria;Actinobacteriota;Actinobacteria;Frankiales;Acidothermaceae;Acidothermus;";"99.0";"14.4";"97";"97";"96";"1";"0";"457086";"391111"
"V4mis2";"SILVA (only NR);Bacteria;Actinobacteriota;Actinobacteria;Frankiales;Cryptosporangiaceae;";"100.0";"14.4";"17";"17";"17";"0";"0";"457166";"391190"
"V4mis2";"SILVA (only NR);Bacteria;Actinobacteriota;Actinobacteria;Frankiales;Cryptosporangiaceae;Cryptosporangium;";"100.0";"14.4";"15";"15";"15";"0";"0";"457168";"391192"
"V4mis2";"SILVA (only NR);Bacteria;Actinobacteriota;Actinobacteria;Frankiales;Cryptosporangiaceae;Fodinicola;";"100.0";"14.4";"2";"2";"2";"0";"0";"457181";"391205"
"V4mis2";"SILVA (only NR);Bacteria;Actinobacteriota;Actinobacteria;Frankiales;Frankiaceae;";"96.4";"14.4";"140";"140";"135";"5";"0";"457043";"391072"
"V4mis2";"SILVA (only NR);Bacteria;Actinobacteriota;Actinobacteria;Frankiales;Frankiaceae;Frankia;";"95.7";"14.4";"46";"46";"44";"2";"0";"457137";"391163"
"V4mis2";"SILVA (only NR);Bacteria;Actinobacteriota;Actinobacteria;Frankiales;Frankiaceae;Jatrophihabitans;";"96.8";"14.4";"94";"94";"91";"3";"0";"457089";"391116"
"V4mis2";"SILVA (only NR);Bacteria;Actinobacteriota;Actinobacteria;Frankiales;Geodermatophilaceae;";"94.6";"14.4";"239";"239";"226";"13";"0";"456944";"390981"
"V4mis2";"SILVA (only NR);Bacteria;Actinobacteriota;Actinobacteria;Frankiales;Geodermatophilaceae;Antricoccus;";"100.0";"14.4";"14";"14";"14";"0";"0";"457169";"391193"
"V4mis2";"SILVA (only NR);Bacteria;Actinobacteriota;Actinobacteria;Frankiales;Geodermatophilaceae;Blastococcus;";"92.2";"14.4";"102";"102";"94";"8";"0";"457081";"391113"
"V4mis2";"SILVA (only NR);Bacteria;Actinobacteriota;Actinobacteria;Frankiales;Geodermatophilaceae;Geodermatophilus;";"93.7";"14.4";"63";"63";"59";"4";"0";"457120";"391148"
"V4mis2";"SILVA (only NR);Bacteria;Actinobacteriota;Actinobacteria;Frankiales;Geodermatophilaceae;Klenkia;";"100.0";"14.4";"14";"14";"14";"0";"0";"457169";"391193"
"V4mis2";"SILVA (only NR);Bacteria;Actinobacteriota;Actinobacteria;Frankiales;Geodermatophilaceae;Modestobacter;";"97.7";"14.4";"44";"44";"43";"1";"0";"457139";"391164"
"V4mis2";"SILVA (only NR);Bacteria;Actinobacteriota;Actinobacteria;Frankiales;Nakamurellaceae;";"95.2";"14.4";"84";"84";"80";"4";"0";"457099";"391127"
"V4mis2";"SILVA (only NR);Bacteria;Actinobacteriota;Actinobacteria;Frankiales;Nakamurellaceae;Nakamurella;";"95.2";"14.4";"84";"84";"80";"4";"0";"457099";"391127"
"V4mis2";"SILVA (only NR);Bacteria;Actinobacteriota;Actinobacteria;Frankiales;Sporichthyaceae;";"97.9";"14.4";"420";"420";"411";"9";"0";"456763";"390796"
"V4mis2";"SILVA (only NR);Bacteria;Actinobacteriota;Actinobacteria;Frankiales;Sporichthyaceae;Candidatus Planktophila;";"100.0";"14.4";"21";"21";"21";"0";"0";"457162";"391186"
"V4mis2";"SILVA (only NR);Bacteria;Actinobacteriota;Actinobacteria;Frankiales;Sporichthyaceae;Longivirga;";"100.0";"14.4";"8";"8";"8";"0";"0";"457175";"391199"
"V4mis2";"SILVA (only NR);Bacteria;Actinobacteriota;Actinobacteria;Frankiales;Sporichthyaceae;Sporichthya;";"100.0";"14.4";"13";"13";"13";"0";"0";"457170";"391194"
"V4mis2";"SILVA (only NR);Bacteria;Actinobacteriota;Actinobacteria;Frankiales;Sporichthyaceae;hgcI clade;";"97.3";"14.4";"329";"329";"320";"9";"0";"456854";"390887"
"V4mis2";"SILVA (only NR);Bacteria;Actinobacteriota;Actinobacteria;Frankiales;Sporichthyaceae;uncultured;";"100.0";"14.4";"29";"29";"29";"0";"0";"457154";"391178"
"V4mis2";"SILVA (only NR);Bacteria;Actinobacteriota;Actinobacteria;Frankiales;uncultured;";"99.1";"14.4";"108";"108";"107";"1";"0";"457075";"391100"
"V4mis2";"SILVA (only NR);Bacteria;Actinobacteriota;Actinobacteria;Glycomycetales;";"94.0";"14.4";"83";"83";"78";"5";"0";"457100";"391129"
"V4mis2";"SILVA (only NR);Bacteria;Actinobacteriota;Actinobacteria;Glycomycetales;Glycomycetaceae;";"94.0";"14.4";"83";"83";"78";"5";"0";"457100";"391129"
"V4mis2";"SILVA (only NR);Bacteria;Actinobacteriota;Actinobacteria;Glycomycetales;Glycomycetaceae;Glycomyces;";"94.4";"14.4";"71";"71";"67";"4";"0";"457112";"391140"
"V4mis2";"SILVA (only NR);Bacteria;Actinobacteriota;Actinobacteria;Glycomycetales;Glycomycetaceae;Haloglycomyces;";"100.0";"14.4";"1";"1";"1";"0";"0";"457182";"391206"
"V4mis2";"SILVA (only NR);Bacteria;Actinobacteriota;Actinobacteria;Glycomycetales;Glycomycetaceae;Salilacibacter;";"100.0";"14.4";"2";"2";"2";"0";"0";"457181";"391205"
"V4mis2";"SILVA (only NR);Bacteria;Actinobacteriota;Actinobacteria;Glycomycetales;Glycomycetaceae;Salininema;";"100.0";"14.4";"1";"1";"1";"0";"0";"457182";"391206"
"V4mis2";"SILVA (only NR);Bacteria;Actinobacteriota;Actinobacteria;Glycomycetales;Glycomycetaceae;uncultured;";"100.0";"14.4";"6";"6";"6";"0";"0";"457177";"391201"
"V4mis2";"SILVA (only NR);Bacteria;Actinobacteriota;Actinobacteria;KIST-JJY010;";"100.0";"14.4";"5";"5";"5";"0";"0";"457178";"391202"
"V4mis2";"SILVA (only NR);Bacteria;Actinobacteriota;Actinobacteria;Kineosporiales;";"99.3";"14.4";"140";"140";"139";"1";"0";"457043";"391068"
"V4mis2";"SILVA (only NR);Bacteria;Actinobacteriota;Actinobacteria;Kineosporiales;Kineosporiaceae;";"99.3";"14.4";"140";"140";"139";"1";"0";"457043";"391068"
"V4mis2";"SILVA (only NR);Bacteria;Actinobacteriota;Actinobacteria;Kineosporiales;Kineosporiaceae;Angustibacter;";"100.0";"14.4";"16";"16";"16";"0";"0";"457167";"391191"
"V4mis2";"SILVA (only NR);Bacteria;Actinobacteriota;Actinobacteria;Kineosporiales;Kineosporiaceae;Kineococcus;";"100.0";"14.4";"41";"41";"41";"0";"0";"457142";"391166"
"V4mis2";"SILVA (only NR);Bacteria;Actinobacteriota;Actinobacteria;Kineosporiales;Kineosporiaceae;Kineosporia;";"100.0";"14.4";"29";"29";"29";"0";"0";"457154";"391178"
"V4mis2";"SILVA (only NR);Bacteria;Actinobacteriota;Actinobacteria;Kineosporiales;Kineosporiaceae;Pseudokineococcus;";"100.0";"14.4";"5";"5";"5";"0";"0";"457178";"391202"
"V4mis2";"SILVA (only NR);Bacteria;Actinobacteriota;Actinobacteria;Kineosporiales;Kineosporiaceae;Quadrisphaera;";"97.6";"14.4";"41";"41";"40";"1";"0";"457142";"391167"
"V4mis2";"SILVA (only NR);Bacteria;Actinobacteriota;Actinobacteria;Kineosporiales;Kineosporiaceae;uncultured;";"100.0";"14.4";"6";"6";"6";"0";"0";"457177";"391201"
"V4mis2";"SILVA (only NR);Bacteria;Actinobacteriota;Actinobacteria;Micrococcales;";"95.3";"14.6";"7473";"7473";"7122";"351";"0";"449710";"384085"
"V4mis2";"SILVA (only NR);Bacteria;Actinobacteriota;Actinobacteria;Micrococcales;AKAU3644;";"100.0";"14.4";"4";"4";"4";"0";"0";"457179";"391203"
"V4mis2";"SILVA (only NR);Bacteria;Actinobacteriota;Actinobacteria;Micrococcales;Beutenbergiaceae;";"100.0";"14.4";"14";"14";"14";"0";"0";"457169";"391193"
"V4mis2";"SILVA (only NR);Bacteria;Actinobacteriota;Actinobacteria;Micrococcales;Beutenbergiaceae;Beutenbergia;";"100.0";"14.4";"2";"2";"2";"0";"0";"457181";"391205"
"V4mis2";"SILVA (only NR);Bacteria;Actinobacteriota;Actinobacteria;Micrococcales;Beutenbergiaceae;Miniimonas;";"100.0";"14.4";"2";"2";"2";"0";"0";"457181";"391205"
"V4mis2";"SILVA (only NR);Bacteria;Actinobacteriota;Actinobacteria;Micrococcales;Beutenbergiaceae;Salana;";"100.0";"14.4";"5";"5";"5";"0";"0";"457178";"391202"
"V4mis2";"SILVA (only NR);Bacteria;Actinobacteriota;Actinobacteria;Micrococcales;Beutenbergiaceae;Serinibacter;";"100.0";"14.4";"4";"4";"4";"0";"0";"457179";"391203"
"V4mis2";"SILVA (only NR);Bacteria;Actinobacteriota;Actinobacteria;Micrococcales;Bogoriellaceae;";"98.2";"14.4";"56";"56";"55";"1";"0";"457127";"391152"
"V4mis2";"SILVA (only NR);Bacteria;Actinobacteriota;Actinobacteria;Micrococcales;Bogoriellaceae;Bogoriella;";"100.0";"14.4";"7";"7";"7";"0";"0";"457176";"391200"
"V4mis2";"SILVA (only NR);Bacteria;Actinobacteriota;Actinobacteria;Micrococcales;Bogoriellaceae;Georgenia;";"98.0";"14.4";"49";"49";"48";"1";"0";"457134";"391159"
"V4mis2";"SILVA (only NR);Bacteria;Actinobacteriota;Actinobacteria;Micrococcales;Brevibacteriaceae;";"93.4";"14.4";"258";"258";"241";"17";"0";"456925";"390966"
"V4mis2";"SILVA (only NR);Bacteria;Actinobacteriota;Actinobacteria;Micrococcales;Brevibacteriaceae;Brevibacterium;";"93.3";"14.4";"255";"255";"238";"17";"0";"456928";"390969"
"V4mis2";"SILVA (only NR);Bacteria;Actinobacteriota;Actinobacteria;Micrococcales;Brevibacteriaceae;Sediminivirga;";"100.0";"14.4";"1";"1";"1";"0";"0";"457182";"391206"
"V4mis2";"SILVA (only NR);Bacteria;Actinobacteriota;Actinobacteria;Micrococcales;Brevibacteriaceae;Spelaeicoccus;";"100.0";"14.4";"2";"2";"2";"0";"0";"457181";"391205"
"V4mis2";"SILVA (only NR);Bacteria;Actinobacteriota;Actinobacteria;Micrococcales;Cellulomonadaceae;";"98.3";"14.4";"230";"230";"226";"4";"0";"456953";"390981"
"V4mis2";"SILVA (only NR);Bacteria;Actinobacteriota;Actinobacteria;Micrococcales;Cellulomonadaceae;Actinotalea;";"100.0";"14.4";"26";"26";"26";"0";"0";"457157";"391181"
"V4mis2";"SILVA (only NR);Bacteria;Actinobacteriota;Actinobacteria;Micrococcales;Cellulomonadaceae;Cellulomonas;";"97.4";"14.4";"154";"154";"150";"4";"0";"457029";"391057"
"V4mis2";"SILVA (only NR);Bacteria;Actinobacteriota;Actinobacteria;Micrococcales;Cellulomonadaceae;Oerskovia;";"100.0";"14.4";"21";"21";"21";"0";"0";"457162";"391186"
"V4mis2";"SILVA (only NR);Bacteria;Actinobacteriota;Actinobacteria;Micrococcales;Cellulomonadaceae;Paraoerskovia;";"100.0";"14.4";"8";"8";"8";"0";"0";"457175";"391199"
"V4mis2";"SILVA (only NR);Bacteria;Actinobacteriota;Actinobacteria;Micrococcales;Cellulomonadaceae;Pseudactinotalea;";"100.0";"14.4";"13";"13";"13";"0";"0";"457170";"391194"
"V4mis2";"SILVA (only NR);Bacteria;Actinobacteriota;Actinobacteria;Micrococcales;Cellulomonadaceae;Sediminihabitans;";"100.0";"14.4";"1";"1";"1";"0";"0";"457182";"391206"
"V4mis2";"SILVA (only NR);Bacteria;Actinobacteriota;Actinobacteria;Micrococcales;Cellulomonadaceae;Tropheryma;";"100.0";"14.4";"3";"3";"3";"0";"0";"457180";"391204"
"V4mis2";"SILVA (only NR);Bacteria;Actinobacteriota;Actinobacteria;Micrococcales;Cellulomonadaceae;Tropicihabitans;";"100.0";"14.4";"1";"1";"1";"0";"0";"457182";"391206"
"V4mis2";"SILVA (only NR);Bacteria;Actinobacteriota;Actinobacteria;Micrococcales;Demequinaceae;";"100.0";"14.4";"62";"62";"62";"0";"0";"457121";"391145"
"V4mis2";"SILVA (only NR);Bacteria;Actinobacteriota;Actinobacteria;Micrococcales;Demequinaceae;Demequina;";"100.0";"14.4";"41";"41";"41";"0";"0";"457142";"391166"
"V4mis2";"SILVA (only NR);Bacteria;Actinobacteriota;Actinobacteria;Micrococcales;Demequinaceae;Lysinimicrobium;";"100.0";"14.4";"16";"16";"16";"0";"0";"457167";"391191"
"V4mis2";"SILVA (only NR);Bacteria;Actinobacteriota;Actinobacteria;Micrococcales;Demequinaceae;uncultured;";"100.0";"14.4";"4";"4";"4";"0";"0";"457179";"391203"
"V4mis2";"SILVA (only NR);Bacteria;Actinobacteriota;Actinobacteria;Micrococcales;Dermabacteraceae;";"96.3";"14.4";"188";"188";"181";"7";"0";"456995";"391026"
"V4mis2";"SILVA (only NR);Bacteria;Actinobacteriota;Actinobacteria;Micrococcales;Dermabacteraceae;Brachybacterium;";"97.3";"14.4";"148";"148";"144";"4";"0";"457035";"391063"
"V4mis2";"SILVA (only NR);Bacteria;Actinobacteriota;Actinobacteria;Micrococcales;Dermabacteraceae;Dermabacter;";"85.7";"14.4";"21";"21";"18";"3";"0";"457162";"391189"
"V4mis2";"SILVA (only NR);Bacteria;Actinobacteriota;Actinobacteria;Micrococcales;Dermabacteraceae;Devriesea;";"100.0";"14.4";"2";"2";"2";"0";"0";"457181";"391205"
"V4mis2";"SILVA (only NR);Bacteria;Actinobacteriota;Actinobacteria;Micrococcales;Dermabacteraceae;Helcobacillus;";"100.0";"14.4";"13";"13";"13";"0";"0";"457170";"391194"
"V4mis2";"SILVA (only NR);Bacteria;Actinobacteriota;Actinobacteria;Micrococcales;Dermabacteraceae;uncultured;";"100.0";"14.4";"4";"4";"4";"0";"0";"457179";"391203"
"V4mis2";"SILVA (only NR);Bacteria;Actinobacteriota;Actinobacteria;Micrococcales;Dermacoccaceae;";"97.1";"14.4";"70";"70";"68";"2";"0";"457113";"391139"
"V4mis2";"SILVA (only NR);Bacteria;Actinobacteriota;Actinobacteria;Micrococcales;Dermacoccaceae;Allobranchiibius;";"100.0";"14.4";"3";"3";"3";"0";"0";"457180";"391204"
"V4mis2";"SILVA (only NR);Bacteria;Actinobacteriota;Actinobacteria;Micrococcales;Dermacoccaceae;Barrientosiimonas;";"100.0";"14.4";"3";"3";"3";"0";"0";"457180";"391204"
"V4mis2";"SILVA (only NR);Bacteria;Actinobacteriota;Actinobacteria;Micrococcales;Dermacoccaceae;Branchiibius;";"100.0";"14.4";"3";"3";"3";"0";"0";"457180";"391204"
"V4mis2";"SILVA (only NR);Bacteria;Actinobacteriota;Actinobacteria;Micrococcales;Dermacoccaceae;Calidifontibacter;";"100.0";"14.4";"3";"3";"3";"0";"0";"457180";"391204"
"V4mis2";"SILVA (only NR);Bacteria;Actinobacteriota;Actinobacteria;Micrococcales;Dermacoccaceae;Demetria;";"100.0";"14.4";"4";"4";"4";"0";"0";"457179";"391203"
"V4mis2";"SILVA (only NR);Bacteria;Actinobacteriota;Actinobacteria;Micrococcales;Dermacoccaceae;Dermacoccus;";"94.7";"14.4";"19";"19";"18";"1";"0";"457164";"391189"
"V4mis2";"SILVA (only NR);Bacteria;Actinobacteriota;Actinobacteria;Micrococcales;Dermacoccaceae;Flexivirga;";"100.0";"14.4";"10";"10";"10";"0";"0";"457173";"391197"
"V4mis2";"SILVA (only NR);Bacteria;Actinobacteriota;Actinobacteria;Micrococcales;Dermacoccaceae;Kytococcus;";"91.7";"14.4";"12";"12";"11";"1";"0";"457171";"391196"
"V4mis2";"SILVA (only NR);Bacteria;Actinobacteriota;Actinobacteria;Micrococcales;Dermacoccaceae;Luteipulveratus;";"100.0";"14.4";"3";"3";"3";"0";"0";"457180";"391204"
"V4mis2";"SILVA (only NR);Bacteria;Actinobacteriota;Actinobacteria;Micrococcales;Dermacoccaceae;Rudaeicoccus;";"100.0";"14.4";"1";"1";"1";"0";"0";"457182";"391206"
"V4mis2";"SILVA (only NR);Bacteria;Actinobacteriota;Actinobacteria;Micrococcales;Dermacoccaceae;Yimella;";"100.0";"14.4";"2";"2";"2";"0";"0";"457181";"391205"
"V4mis2";"SILVA (only NR);Bacteria;Actinobacteriota;Actinobacteria;Micrococcales;Dermatophilaceae;";"98.8";"14.4";"86";"86";"85";"1";"0";"457097";"391122"
"V4mis2";"SILVA (only NR);Bacteria;Actinobacteriota;Actinobacteria;Micrococcales;Dermatophilaceae;Austwickia;";"100.0";"14.4";"4";"4";"4";"0";"0";"457179";"391203"
"V4mis2";"SILVA (only NR);Bacteria;Actinobacteriota;Actinobacteria;Micrococcales;Dermatophilaceae;Dermatophilus;";"100.0";"14.4";"6";"6";"6";"0";"0";"457177";"391201"
"V4mis2";"SILVA (only NR);Bacteria;Actinobacteriota;Actinobacteria;Micrococcales;Dermatophilaceae;Kineosphaera;";"100.0";"14.4";"4";"4";"4";"0";"0";"457179";"391203"
"V4mis2";"SILVA (only NR);Bacteria;Actinobacteriota;Actinobacteria;Micrococcales;Dermatophilaceae;Mobilicoccus;";"100.0";"14.4";"8";"8";"8";"0";"0";"457175";"391199"
"V4mis2";"SILVA (only NR);Bacteria;Actinobacteriota;Actinobacteria;Micrococcales;Dermatophilaceae;Piscicoccus;";"100.0";"14.4";"2";"2";"2";"0";"0";"457181";"391205"
"V4mis2";"SILVA (only NR);Bacteria;Actinobacteriota;Actinobacteria;Micrococcales;Dermatophilaceae;Tonsilliphilus;";"100.0";"14.4";"2";"2";"2";"0";"0";"457181";"391205"
"V4mis2";"SILVA (only NR);Bacteria;Actinobacteriota;Actinobacteria;Micrococcales;Dermatophilaceae;uncultured;";"98.3";"14.4";"58";"58";"57";"1";"0";"457125";"391150"
"V4mis2";"SILVA (only NR);Bacteria;Actinobacteriota;Actinobacteria;Micrococcales;Intrasporangiaceae;";"96.9";"14.4";"454";"454";"440";"14";"0";"456729";"390767"
"V4mis2";"SILVA (only NR);Bacteria;Actinobacteriota;Actinobacteria;Micrococcales;Intrasporangiaceae;Aquipuribacter;";"100.0";"14.4";"9";"9";"9";"0";"0";"457174";"391198"
"V4mis2";"SILVA (only NR);Bacteria;Actinobacteriota;Actinobacteria;Micrococcales;Intrasporangiaceae;Arsenicicoccus;";"100.0";"14.4";"5";"5";"5";"0";"0";"457178";"391202"
"V4mis2";"SILVA (only NR);Bacteria;Actinobacteriota;Actinobacteria;Micrococcales;Intrasporangiaceae;Fodinibacter;";"100.0";"14.4";"2";"2";"2";"0";"0";"457181";"391205"
"V4mis2";"SILVA (only NR);Bacteria;Actinobacteriota;Actinobacteria;Micrococcales;Intrasporangiaceae;Humibacillus;";"100.0";"14.4";"7";"7";"7";"0";"0";"457176";"391200"
"V4mis2";"SILVA (only NR);Bacteria;Actinobacteriota;Actinobacteria;Micrococcales;Intrasporangiaceae;Intrasporangium;";"95.0";"14.4";"20";"20";"19";"1";"0";"457163";"391188"
"V4mis2";"SILVA (only NR);Bacteria;Actinobacteriota;Actinobacteria;Micrococcales;Intrasporangiaceae;Janibacter;";"94.0";"14.4";"67";"67";"63";"4";"0";"457116";"391144"
"V4mis2";"SILVA (only NR);Bacteria;Actinobacteriota;Actinobacteria;Micrococcales;Intrasporangiaceae;Knoellia;";"94.3";"14.4";"35";"35";"33";"2";"0";"457148";"391174"
"V4mis2";"SILVA (only NR);Bacteria;Actinobacteriota;Actinobacteria;Micrococcales;Intrasporangiaceae;Kribbia;";"100.0";"14.4";"2";"2";"2";"0";"0";"457181";"391205"
"V4mis2";"SILVA (only NR);Bacteria;Actinobacteriota;Actinobacteria;Micrococcales;Intrasporangiaceae;Lapillicoccus;";"100.0";"14.4";"19";"19";"19";"0";"0";"457164";"391188"
"V4mis2";"SILVA (only NR);Bacteria;Actinobacteriota;Actinobacteria;Micrococcales;Intrasporangiaceae;Marihabitans;";"100.0";"14.4";"2";"2";"2";"0";"0";"457181";"391205"
"V4mis2";"SILVA (only NR);Bacteria;Actinobacteriota;Actinobacteria;Micrococcales;Intrasporangiaceae;Ornithinibacter;";"90.0";"14.4";"10";"10";"9";"1";"0";"457173";"391198"
"V4mis2";"SILVA (only NR);Bacteria;Actinobacteriota;Actinobacteria;Micrococcales;Intrasporangiaceae;Ornithinicoccus;";"100.0";"14.4";"18";"18";"18";"0";"0";"457165";"391189"
"V4mis2";"SILVA (only NR);Bacteria;Actinobacteriota;Actinobacteria;Micrococcales;Intrasporangiaceae;Ornithinimicrobium;";"97.6";"14.4";"41";"41";"40";"1";"0";"457142";"391167"
"V4mis2";"SILVA (only NR);Bacteria;Actinobacteriota;Actinobacteria;Micrococcales;Intrasporangiaceae;Oryzihumus;";"95.0";"14.4";"20";"20";"19";"1";"0";"457163";"391188"
"V4mis2";"SILVA (only NR);Bacteria;Actinobacteriota;Actinobacteria;Micrococcales;Intrasporangiaceae;Pedococcus-Phycicoccus;";"97.1";"14.4";"34";"34";"33";"1";"0";"457149";"391174"
"V4mis2";"SILVA (only NR);Bacteria;Actinobacteriota;Actinobacteria;Micrococcales;Intrasporangiaceae;Serinicoccus;";"100.0";"14.4";"10";"10";"10";"0";"0";"457173";"391197"
"V4mis2";"SILVA (only NR);Bacteria;Actinobacteriota;Actinobacteria;Micrococcales;Intrasporangiaceae;Terrabacter;";"100.0";"14.4";"33";"33";"33";"0";"0";"457150";"391174"
"V4mis2";"SILVA (only NR);Bacteria;Actinobacteriota;Actinobacteria;Micrococcales;Intrasporangiaceae;Terracoccus;";"100.0";"14.4";"1";"1";"1";"0";"0";"457182";"391206"
"V4mis2";"SILVA (only NR);Bacteria;Actinobacteriota;Actinobacteria;Micrococcales;Intrasporangiaceae;Tetrasphaera;";"97.8";"14.4";"89";"89";"87";"2";"0";"457094";"391120"
"V4mis2";"SILVA (only NR);Bacteria;Actinobacteriota;Actinobacteria;Micrococcales;Intrasporangiaceae;uncultured;";"95.2";"14.4";"21";"21";"20";"1";"0";"457162";"391187"
"V4mis2";"SILVA (only NR);Bacteria;Actinobacteriota;Actinobacteria;Micrococcales;Jonesiaceae;";"100.0";"14.4";"13";"13";"13";"0";"0";"457170";"391194"
"V4mis2";"SILVA (only NR);Bacteria;Actinobacteriota;Actinobacteria;Micrococcales;Jonesiaceae;Jonesia;";"100.0";"14.4";"13";"13";"13";"0";"0";"457170";"391194"
"V4mis2";"SILVA (only NR);Bacteria;Actinobacteriota;Actinobacteria;Micrococcales;Microbacteriaceae;";"96.7";"14.5";"2679";"2679";"2590";"89";"0";"454504";"388617"
"V4mis2";"SILVA (only NR);Bacteria;Actinobacteriota;Actinobacteria;Micrococcales;Microbacteriaceae;Agreia;";"100.0";"14.4";"5";"5";"5";"0";"0";"457178";"391202"
"V4mis2";"SILVA (only NR);Bacteria;Actinobacteriota;Actinobacteria;Micrococcales;Microbacteriaceae;Agrococcus;";"97.4";"14.4";"78";"78";"76";"2";"0";"457105";"391131"
"V4mis2";"SILVA (only NR);Bacteria;Actinobacteriota;Actinobacteria;Micrococcales;Microbacteriaceae;Agromyces;";"95.5";"14.4";"177";"177";"169";"8";"0";"457006";"391038"
"V4mis2";"SILVA (only NR);Bacteria;Actinobacteriota;Actinobacteria;Micrococcales;Microbacteriaceae;Allohumibacter;";"100.0";"14.4";"1";"1";"1";"0";"0";"457182";"391206"
"V4mis2";"SILVA (only NR);Bacteria;Actinobacteriota;Actinobacteria;Micrococcales;Microbacteriaceae;Alpinimonas;";"100.0";"14.4";"1";"1";"1";"0";"0";"457182";"391206"
"V4mis2";"SILVA (only NR);Bacteria;Actinobacteriota;Actinobacteria;Micrococcales;Microbacteriaceae;Amnibacterium;";"92.9";"14.4";"14";"14";"13";"1";"0";"457169";"391194"
"V4mis2";"SILVA (only NR);Bacteria;Actinobacteriota;Actinobacteria;Micrococcales;Microbacteriaceae;Aurantimicrobium;";"100.0";"14.4";"19";"19";"19";"0";"0";"457164";"391188"
"V4mis2";"SILVA (only NR);Bacteria;Actinobacteriota;Actinobacteria;Micrococcales;Microbacteriaceae;Candidatus Aquiluna;";"92.0";"14.4";"50";"50";"46";"4";"0";"457133";"391161"
"V4mis2";"SILVA (only NR);Bacteria;Actinobacteriota;Actinobacteria;Micrococcales;Microbacteriaceae;Candidatus Flaviluna;";"100.0";"14.4";"3";"3";"3";"0";"0";"457180";"391204"
"V4mis2";"SILVA (only NR);Bacteria;Actinobacteriota;Actinobacteria;Micrococcales;Microbacteriaceae;Candidatus Limnoluna;";"100.0";"14.4";"11";"11";"11";"0";"0";"457172";"391196"
"V4mis2";"SILVA (only NR);Bacteria;Actinobacteriota;Actinobacteria;Micrococcales;Microbacteriaceae;Candidatus Planktoluna;";"88.2";"14.4";"17";"17";"15";"2";"0";"457166";"391192"
"V4mis2";"SILVA (only NR);Bacteria;Actinobacteriota;Actinobacteria;Micrococcales;Microbacteriaceae;Chryseoglobus;";"100.0";"14.4";"11";"11";"11";"0";"0";"457172";"391196"
"V4mis2";"SILVA (only NR);Bacteria;Actinobacteriota;Actinobacteria;Micrococcales;Microbacteriaceae;Clavibacter;";"98.1";"14.4";"53";"53";"52";"1";"0";"457130";"391155"
"V4mis2";"SILVA (only NR);Bacteria;Actinobacteriota;Actinobacteria;Micrococcales;Microbacteriaceae;Cnuibacter;";"100.0";"14.4";"4";"4";"4";"0";"0";"457179";"391203"
"V4mis2";"SILVA (only NR);Bacteria;Actinobacteriota;Actinobacteria;Micrococcales;Microbacteriaceae;Compostimonas;";"100.0";"14.4";"1";"1";"1";"0";"0";"457182";"391206"
"V4mis2";"SILVA (only NR);Bacteria;Actinobacteriota;Actinobacteria;Micrococcales;Microbacteriaceae;Conyzicola;";"100.0";"14.4";"11";"11";"11";"0";"0";"457172";"391196"
"V4mis2";"SILVA (only NR);Bacteria;Actinobacteriota;Actinobacteria;Micrococcales;Microbacteriaceae;Cryobacterium;";"98.3";"14.4";"58";"58";"57";"1";"0";"457125";"391150"
"V4mis2";"SILVA (only NR);Bacteria;Actinobacteriota;Actinobacteria;Micrococcales;Microbacteriaceae;Cryocola;";"100.0";"14.4";"2";"2";"2";"0";"0";"457181";"391205"
"V4mis2";"SILVA (only NR);Bacteria;Actinobacteriota;Actinobacteria;Micrococcales;Microbacteriaceae;Curtobacterium;";"95.7";"14.4";"139";"139";"133";"6";"0";"457044";"391074"
"V4mis2";"SILVA (only NR);Bacteria;Actinobacteriota;Actinobacteria;Micrococcales;Microbacteriaceae;DS001;";"100.0";"14.4";"2";"2";"2";"0";"0";"457181";"391205"
"V4mis2";"SILVA (only NR);Bacteria;Actinobacteriota;Actinobacteria;Micrococcales;Microbacteriaceae;Diaminobutyricibacter;";"100.0";"14.4";"1";"1";"1";"0";"0";"457182";"391206"
"V4mis2";"SILVA (only NR);Bacteria;Actinobacteriota;Actinobacteria;Micrococcales;Microbacteriaceae;Diaminobutyricimonas;";"100.0";"14.4";"7";"7";"7";"0";"0";"457176";"391200"
"V4mis2";"SILVA (only NR);Bacteria;Actinobacteriota;Actinobacteria;Micrococcales;Microbacteriaceae;Frigoribacterium;";"96.3";"14.4";"27";"27";"26";"1";"0";"457156";"391181"
"V4mis2";"SILVA (only NR);Bacteria;Actinobacteriota;Actinobacteria;Micrococcales;Microbacteriaceae;Frondihabitans;";"94.1";"14.4";"17";"17";"16";"1";"0";"457166";"391191"
"V4mis2";"SILVA (only NR);Bacteria;Actinobacteriota;Actinobacteria;Micrococcales;Microbacteriaceae;Galbitalea;";"100.0";"14.4";"23";"23";"23";"0";"0";"457160";"391184"
"V4mis2";"SILVA (only NR);Bacteria;Actinobacteriota;Actinobacteria;Micrococcales;Microbacteriaceae;Glaciibacter;";"100.0";"14.4";"4";"4";"4";"0";"0";"457179";"391203"
"V4mis2";"SILVA (only NR);Bacteria;Actinobacteriota;Actinobacteria;Micrococcales;Microbacteriaceae;Glaciihabitans;";"100.0";"14.4";"6";"6";"6";"0";"0";"457177";"391201"
"V4mis2";"SILVA (only NR);Bacteria;Actinobacteriota;Actinobacteria;Micrococcales;Microbacteriaceae;Gryllotalpicola;";"100.0";"14.4";"17";"17";"17";"0";"0";"457166";"391190"
"V4mis2";"SILVA (only NR);Bacteria;Actinobacteriota;Actinobacteria;Micrococcales;Microbacteriaceae;Gulosibacter;";"100.0";"14.4";"8";"8";"8";"0";"0";"457175";"391199"
"V4mis2";"SILVA (only NR);Bacteria;Actinobacteriota;Actinobacteria;Micrococcales;Microbacteriaceae;Herbiconiux;";"100.0";"14.4";"15";"15";"15";"0";"0";"457168";"391192"
"V4mis2";"SILVA (only NR);Bacteria;Actinobacteriota;Actinobacteria;Micrococcales;Microbacteriaceae;Homoserinibacter;";"100.0";"14.4";"4";"4";"4";"0";"0";"457179";"391203"
"V4mis2";"SILVA (only NR);Bacteria;Actinobacteriota;Actinobacteria;Micrococcales;Microbacteriaceae;Homoserinimonas;";"100.0";"14.4";"3";"3";"3";"0";"0";"457180";"391204"
"V4mis2";"SILVA (only NR);Bacteria;Actinobacteriota;Actinobacteria;Micrococcales;Microbacteriaceae;Huakuichenia;";"100.0";"14.4";"7";"7";"7";"0";"0";"457176";"391200"
"V4mis2";"SILVA (only NR);Bacteria;Actinobacteriota;Actinobacteria;Micrococcales;Microbacteriaceae;Humibacter;";"100.0";"14.4";"12";"12";"12";"0";"0";"457171";"391195"
"V4mis2";"SILVA (only NR);Bacteria;Actinobacteriota;Actinobacteria;Micrococcales;Microbacteriaceae;Klugiella;";"100.0";"14.4";"4";"4";"4";"0";"0";"457179";"391203"
"V4mis2";"SILVA (only NR);Bacteria;Actinobacteriota;Actinobacteria;Micrococcales;Microbacteriaceae;Labedella;";"100.0";"14.4";"4";"4";"4";"0";"0";"457179";"391203"
"V4mis2";"SILVA (only NR);Bacteria;Actinobacteriota;Actinobacteria;Micrococcales;Microbacteriaceae;Leifsonia;";"98.0";"14.4";"98";"98";"96";"2";"0";"457085";"391111"
"V4mis2";"SILVA (only NR);Bacteria;Actinobacteriota;Actinobacteria;Micrococcales;Microbacteriaceae;Leucobacter;";"96.0";"14.4";"227";"227";"218";"9";"0";"456956";"390989"
"V4mis2";"SILVA (only NR);Bacteria;Actinobacteriota;Actinobacteria;Micrococcales;Microbacteriaceae;Luethyella;";"100.0";"14.4";"1";"1";"1";"0";"0";"457182";"391206"
"V4mis2";"SILVA (only NR);Bacteria;Actinobacteriota;Actinobacteria;Micrococcales;Microbacteriaceae;Lysinimonas;";"100.0";"14.4";"15";"15";"15";"0";"0";"457168";"391192"
"V4mis2";"SILVA (only NR);Bacteria;Actinobacteriota;Actinobacteria;Micrococcales;Microbacteriaceae;ML602J-51;";"100.0";"14.4";"9";"9";"9";"0";"0";"457174";"391198"
"V4mis2";"SILVA (only NR);Bacteria;Actinobacteriota;Actinobacteria;Micrococcales;Microbacteriaceae;MWH-Ta3;";"100.0";"14.4";"5";"5";"5";"0";"0";"457178";"391202"
"V4mis2";"SILVA (only NR);Bacteria;Actinobacteriota;Actinobacteria;Micrococcales;Microbacteriaceae;Marisediminicola;";"100.0";"14.4";"12";"12";"12";"0";"0";"457171";"391195"
"V4mis2";"SILVA (only NR);Bacteria;Actinobacteriota;Actinobacteria;Micrococcales;Microbacteriaceae;Microbacterium;";"96.7";"14.5";"1150";"1150";"1112";"38";"0";"456033";"390095"
"V4mis2";"SILVA (only NR);Bacteria;Actinobacteriota;Actinobacteria;Micrococcales;Microbacteriaceae;Microcella;";"100.0";"14.4";"5";"5";"5";"0";"0";"457178";"391202"
"V4mis2";"SILVA (only NR);Bacteria;Actinobacteriota;Actinobacteria;Micrococcales;Microbacteriaceae;Microterricola;";"80.0";"14.4";"5";"5";"4";"1";"0";"457178";"391203"
"V4mis2";"SILVA (only NR);Bacteria;Actinobacteriota;Actinobacteria;Micrococcales;Microbacteriaceae;Mycetocola;";"93.8";"14.4";"32";"32";"30";"2";"0";"457151";"391177"
"V4mis2";"SILVA (only NR);Bacteria;Actinobacteriota;Actinobacteria;Micrococcales;Microbacteriaceae;Naasia;";"75.0";"14.4";"4";"4";"3";"1";"0";"457179";"391204"
"V4mis2";"SILVA (only NR);Bacteria;Actinobacteriota;Actinobacteria;Micrococcales;Microbacteriaceae;Okibacterium;";"100.0";"14.4";"9";"9";"9";"0";"0";"457174";"391198"
"V4mis2";"SILVA (only NR);Bacteria;Actinobacteriota;Actinobacteria;Micrococcales;Microbacteriaceae;Parafrigoribacterium;";"97.9";"14.4";"47";"47";"46";"1";"0";"457136";"391161"
"V4mis2";"SILVA (only NR);Bacteria;Actinobacteriota;Actinobacteria;Micrococcales;Microbacteriaceae;Plantibacter;";"94.7";"14.4";"19";"19";"18";"1";"0";"457164";"391189"
"V4mis2";"SILVA (only NR);Bacteria;Actinobacteriota;Actinobacteria;Micrococcales;Microbacteriaceae;Pontimonas;";"100.0";"14.4";"3";"3";"3";"0";"0";"457180";"391204"
"V4mis2";"SILVA (only NR);Bacteria;Actinobacteriota;Actinobacteria;Micrococcales;Microbacteriaceae;Pseudoclavibacter;";"97.6";"14.4";"41";"41";"40";"1";"0";"457142";"391167"
"V4mis2";"SILVA (only NR);Bacteria;Actinobacteriota;Actinobacteria;Micrococcales;Microbacteriaceae;Rathayibacter;";"88.9";"14.4";"27";"27";"24";"3";"0";"457156";"391183"
"V4mis2";"SILVA (only NR);Bacteria;Actinobacteriota;Actinobacteria;Micrococcales;Microbacteriaceae;Rhodoglobus;";"100.0";"14.4";"8";"8";"8";"0";"0";"457175";"391199"
"V4mis2";"SILVA (only NR);Bacteria;Actinobacteriota;Actinobacteria;Micrococcales;Microbacteriaceae;Rhodoluna;";"100.0";"14.4";"18";"18";"18";"0";"0";"457165";"391189"
"V4mis2";"SILVA (only NR);Bacteria;Actinobacteriota;Actinobacteria;Micrococcales;Microbacteriaceae;Rudaibacter;";"100.0";"14.4";"1";"1";"1";"0";"0";"457182";"391206"
"V4mis2";"SILVA (only NR);Bacteria;Actinobacteriota;Actinobacteria;Micrococcales;Microbacteriaceae;SV1-3;";"100.0";"14.4";"3";"3";"3";"0";"0";"457180";"391204"
"V4mis2";"SILVA (only NR);Bacteria;Actinobacteriota;Actinobacteria;Micrococcales;Microbacteriaceae;Salinibacterium;";"100.0";"14.4";"20";"20";"20";"0";"0";"457163";"391187"
"V4mis2";"SILVA (only NR);Bacteria;Actinobacteriota;Actinobacteria;Micrococcales;Microbacteriaceae;Schumannella;";"100.0";"14.4";"5";"5";"5";"0";"0";"457178";"391202"
"V4mis2";"SILVA (only NR);Bacteria;Actinobacteriota;Actinobacteria;Micrococcales;Microbacteriaceae;Subtercola;";"100.0";"14.4";"18";"18";"18";"0";"0";"457165";"391189"
"V4mis2";"SILVA (only NR);Bacteria;Actinobacteriota;Actinobacteria;Micrococcales;Microbacteriaceae;Yonghaparkia;";"83.3";"14.4";"6";"6";"5";"1";"0";"457177";"391202"
"V4mis2";"SILVA (only NR);Bacteria;Actinobacteriota;Actinobacteria;Micrococcales;Microbacteriaceae;uncultured;";"98.1";"14.4";"54";"54";"53";"1";"0";"457129";"391154"
"V4mis2";"SILVA (only NR);Bacteria;Actinobacteriota;Actinobacteria;Micrococcales;Micrococcaceae;";"93.2";"14.5";"3001";"3001";"2798";"203";"0";"454182";"388409"
"V4mis2";"SILVA (only NR);Bacteria;Actinobacteriota;Actinobacteria;Micrococcales;Micrococcaceae;Acaricomes;";"100.0";"14.4";"3";"3";"3";"0";"0";"457180";"391204"
"V4mis2";"SILVA (only NR);Bacteria;Actinobacteriota;Actinobacteria;Micrococcales;Micrococcaceae;Arthrobacter;";"96.4";"14.4";"690";"690";"665";"25";"0";"456493";"390542"
"V4mis2";"SILVA (only NR);Bacteria;Actinobacteriota;Actinobacteria;Micrococcales;Micrococcaceae;Auritidibacter;";"100.0";"14.4";"4";"4";"4";"0";"0";"457179";"391203"
"V4mis2";"SILVA (only NR);Bacteria;Actinobacteriota;Actinobacteria;Micrococcales;Micrococcaceae;Citricoccus;";"97.1";"14.4";"34";"34";"33";"1";"0";"457149";"391174"
"V4mis2";"SILVA (only NR);Bacteria;Actinobacteriota;Actinobacteria;Micrococcales;Micrococcaceae;Enteractinococcus;";"100.0";"14.4";"17";"17";"17";"0";"0";"457166";"391190"
"V4mis2";"SILVA (only NR);Bacteria;Actinobacteriota;Actinobacteria;Micrococcales;Micrococcaceae;Falsarthrobacter;";"100.0";"14.4";"2";"2";"2";"0";"0";"457181";"391205"
"V4mis2";"SILVA (only NR);Bacteria;Actinobacteriota;Actinobacteria;Micrococcales;Micrococcaceae;Garicola;";"100.0";"14.4";"10";"10";"10";"0";"0";"457173";"391197"
"V4mis2";"SILVA (only NR);Bacteria;Actinobacteriota;Actinobacteria;Micrococcales;Micrococcaceae;Glutamicibacter;";"94.1";"14.4";"170";"170";"160";"10";"0";"457013";"391047"
"V4mis2";"SILVA (only NR);Bacteria;Actinobacteriota;Actinobacteria;Micrococcales;Micrococcaceae;Haematomicrobium;";"100.0";"14.4";"1";"1";"1";"0";"0";"457182";"391206"
"V4mis2";"SILVA (only NR);Bacteria;Actinobacteriota;Actinobacteria;Micrococcales;Micrococcaceae;Kocuria;";"89.9";"14.4";"336";"336";"302";"34";"0";"456847";"390905"
"V4mis2";"SILVA (only NR);Bacteria;Actinobacteriota;Actinobacteria;Micrococcales;Micrococcaceae;Micrococcus;";"87.5";"14.4";"327";"327";"286";"41";"0";"456856";"390921"
"V4mis2";"SILVA (only NR);Bacteria;Actinobacteriota;Actinobacteria;Micrococcales;Micrococcaceae;Neomicrococcus;";"100.0";"14.4";"6";"6";"6";"0";"0";"457177";"391201"
"V4mis2";"SILVA (only NR);Bacteria;Actinobacteriota;Actinobacteria;Micrococcales;Micrococcaceae;Nesterenkonia;";"96.1";"14.4";"76";"76";"73";"3";"0";"457107";"391134"
"V4mis2";"SILVA (only NR);Bacteria;Actinobacteriota;Actinobacteria;Micrococcales;Micrococcaceae;Paenarthrobacter;";"91.0";"14.4";"144";"144";"131";"13";"0";"457039";"391076"
"V4mis2";"SILVA (only NR);Bacteria;Actinobacteriota;Actinobacteria;Micrococcales;Micrococcaceae;Paeniglutamicibacter;";"96.8";"14.4";"62";"62";"60";"2";"0";"457121";"391147"
"V4mis2";"SILVA (only NR);Bacteria;Actinobacteriota;Actinobacteria;Micrococcales;Micrococcaceae;Pseudarthrobacter;";"94.1";"14.4";"439";"439";"413";"26";"0";"456744";"390794"
"V4mis2";"SILVA (only NR);Bacteria;Actinobacteriota;Actinobacteria;Micrococcales;Micrococcaceae;Pseudoglutamicibacter;";"100.0";"14.4";"4";"4";"4";"0";"0";"457179";"391203"
"V4mis2";"SILVA (only NR);Bacteria;Actinobacteriota;Actinobacteria;Micrococcales;Micrococcaceae;Renibacterium;";"100.0";"14.4";"8";"8";"8";"0";"0";"457175";"391199"
"V4mis2";"SILVA (only NR);Bacteria;Actinobacteriota;Actinobacteria;Micrococcales;Micrococcaceae;Rothia;";"93.0";"14.4";"582";"582";"541";"41";"0";"456601";"390666"
"V4mis2";"SILVA (only NR);Bacteria;Actinobacteriota;Actinobacteria;Micrococcales;Micrococcaceae;Sinomonas;";"95.1";"14.4";"41";"41";"39";"2";"0";"457142";"391168"
"V4mis2";"SILVA (only NR);Bacteria;Actinobacteriota;Actinobacteria;Micrococcales;Micrococcaceae;Tersicoccus;";"100.0";"14.4";"4";"4";"4";"0";"0";"457179";"391203"
"V4mis2";"SILVA (only NR);Bacteria;Actinobacteriota;Actinobacteria;Micrococcales;Micrococcaceae;Yaniella;";"100.0";"14.4";"8";"8";"8";"0";"0";"457175";"391199"
"V4mis2";"SILVA (only NR);Bacteria;Actinobacteriota;Actinobacteria;Micrococcales;Micrococcaceae;Zhihengliuella;";"100.0";"14.4";"11";"11";"11";"0";"0";"457172";"391196"
"V4mis2";"SILVA (only NR);Bacteria;Actinobacteriota;Actinobacteria;Micrococcales;Micrococcaceae;uncultured;";"54.5";"14.4";"11";"11";"6";"5";"0";"457172";"391201"
"V4mis2";"SILVA (only NR);Bacteria;Actinobacteriota;Actinobacteria;Micrococcales;Micrococcales Incertae Sedis;";"92.6";"14.4";"27";"27";"25";"2";"0";"457156";"391182"
"V4mis2";"SILVA (only NR);Bacteria;Actinobacteriota;Actinobacteria;Micrococcales;Micrococcales Incertae Sedis;Luteimicrobium;";"100.0";"14.4";"6";"6";"6";"0";"0";"457177";"391201"
"V4mis2";"SILVA (only NR);Bacteria;Actinobacteriota;Actinobacteria;Micrococcales;Micrococcales Incertae Sedis;Timonella;";"90.5";"14.4";"21";"21";"19";"2";"0";"457162";"391188"
"V4mis2";"SILVA (only NR);Bacteria;Actinobacteriota;Actinobacteria;Micrococcales;Promicromonosporaceae;";"96.8";"14.4";"247";"247";"239";"8";"0";"456936";"390968"
"V4mis2";"SILVA (only NR);Bacteria;Actinobacteriota;Actinobacteria;Micrococcales;Promicromonosporaceae;Cellulosimicrobium;";"92.7";"14.4";"82";"82";"76";"6";"0";"457101";"391131"
"V4mis2";"SILVA (only NR);Bacteria;Actinobacteriota;Actinobacteria;Micrococcales;Promicromonosporaceae;Isoptericola;";"97.0";"14.4";"66";"66";"64";"2";"0";"457117";"391143"
"V4mis2";"SILVA (only NR);Bacteria;Actinobacteriota;Actinobacteria;Micrococcales;Promicromonosporaceae;Krasilnikoviella;";"100.0";"14.4";"2";"2";"2";"0";"0";"457181";"391205"
"V4mis2";"SILVA (only NR);Bacteria;Actinobacteriota;Actinobacteria;Micrococcales;Promicromonosporaceae;Myceligenerans;";"100.0";"14.4";"15";"15";"15";"0";"0";"457168";"391192"
"V4mis2";"SILVA (only NR);Bacteria;Actinobacteriota;Actinobacteria;Micrococcales;Promicromonosporaceae;Promicromonospora;";"100.0";"14.4";"70";"70";"70";"0";"0";"457113";"391137"
"V4mis2";"SILVA (only NR);Bacteria;Actinobacteriota;Actinobacteria;Micrococcales;Promicromonosporaceae;Xylanibacterium;";"100.0";"14.4";"1";"1";"1";"0";"0";"457182";"391206"
"V4mis2";"SILVA (only NR);Bacteria;Actinobacteriota;Actinobacteria;Micrococcales;Promicromonosporaceae;Xylanimicrobium;";"100.0";"14.4";"2";"2";"2";"0";"0";"457181";"391205"
"V4mis2";"SILVA (only NR);Bacteria;Actinobacteriota;Actinobacteria;Micrococcales;Promicromonosporaceae;Xylanimonas;";"100.0";"14.4";"2";"2";"2";"0";"0";"457181";"391205"
"V4mis2";"SILVA (only NR);Bacteria;Actinobacteriota;Actinobacteria;Micrococcales;Promicromonosporaceae;uncultured;";"100.0";"14.4";"2";"2";"2";"0";"0";"457181";"391205"
"V4mis2";"SILVA (only NR);Bacteria;Actinobacteriota;Actinobacteria;Micrococcales;Rarobacteraceae;";"100.0";"14.4";"6";"6";"6";"0";"0";"457177";"391201"
"V4mis2";"SILVA (only NR);Bacteria;Actinobacteriota;Actinobacteria;Micrococcales;Rarobacteraceae;Rarobacter;";"100.0";"14.4";"6";"6";"6";"0";"0";"457177";"391201"
"V4mis2";"SILVA (only NR);Bacteria;Actinobacteriota;Actinobacteria;Micrococcales;Ruaniaceae;";"87.5";"14.4";"8";"8";"7";"1";"0";"457175";"391200"
"V4mis2";"SILVA (only NR);Bacteria;Actinobacteriota;Actinobacteria;Micrococcales;Ruaniaceae;Haloactinobacterium;";"66.7";"14.4";"3";"3";"2";"1";"0";"457180";"391205"
"V4mis2";"SILVA (only NR);Bacteria;Actinobacteriota;Actinobacteria;Micrococcales;Ruaniaceae;Ruania;";"100.0";"14.4";"5";"5";"5";"0";"0";"457178";"391202"
"V4mis2";"SILVA (only NR);Bacteria;Actinobacteriota;Actinobacteria;Micrococcales;Sanguibacteraceae;";"95.9";"14.4";"49";"49";"47";"2";"0";"457134";"391160"
"V4mis2";"SILVA (only NR);Bacteria;Actinobacteriota;Actinobacteria;Micrococcales;Sanguibacteraceae;Sanguibacter-Flavimobilis;";"95.9";"14.4";"49";"49";"47";"2";"0";"457134";"391160"
"V4mis2";"SILVA (only NR);Bacteria;Actinobacteriota;Actinobacteria;Micrococcales;uncultured;";"100.0";"14.4";"11";"11";"11";"0";"0";"457172";"391196"
"V4mis2";"SILVA (only NR);Bacteria;Actinobacteriota;Actinobacteria;Micromonosporales;";"96.7";"14.5";"1197";"1197";"1158";"39";"0";"455986";"390049"
"V4mis2";"SILVA (only NR);Bacteria;Actinobacteriota;Actinobacteria;Micromonosporales;Micromonosporaceae;";"96.7";"14.5";"1197";"1197";"1158";"39";"0";"455986";"390049"
"V4mis2";"SILVA (only NR);Bacteria;Actinobacteriota;Actinobacteria;Micromonosporales;Micromonosporaceae;Actinocatenispora;";"100.0";"14.4";"8";"8";"8";"0";"0";"457175";"391199"
"V4mis2";"SILVA (only NR);Bacteria;Actinobacteriota;Actinobacteria;Micromonosporales;Micromonosporaceae;Actinoplanes;";"97.4";"14.4";"232";"232";"226";"6";"0";"456951";"390981"
"V4mis2";"SILVA (only NR);Bacteria;Actinobacteriota;Actinobacteria;Micromonosporales;Micromonosporaceae;Actinorhabdospora;";"100.0";"14.4";"1";"1";"1";"0";"0";"457182";"391206"
"V4mis2";"SILVA (only NR);Bacteria;Actinobacteriota;Actinobacteria;Micromonosporales;Micromonosporaceae;Allocatelliglobosispora;";"100.0";"14.4";"4";"4";"4";"0";"0";"457179";"391203"
"V4mis2";"SILVA (only NR);Bacteria;Actinobacteriota;Actinobacteria;Micromonosporales;Micromonosporaceae;Asanoa;";"91.3";"14.4";"23";"23";"21";"2";"0";"457160";"391186"
"V4mis2";"SILVA (only NR);Bacteria;Actinobacteriota;Actinobacteria;Micromonosporales;Micromonosporaceae;Catellatospora;";"100.0";"14.4";"16";"16";"16";"0";"0";"457167";"391191"
"V4mis2";"SILVA (only NR);Bacteria;Actinobacteriota;Actinobacteria;Micromonosporales;Micromonosporaceae;Catelliglobosispora;";"100.0";"14.4";"2";"2";"2";"0";"0";"457181";"391205"
"V4mis2";"SILVA (only NR);Bacteria;Actinobacteriota;Actinobacteria;Micromonosporales;Micromonosporaceae;Catenuloplanes;";"100.0";"14.4";"19";"19";"19";"0";"0";"457164";"391188"
"V4mis2";"SILVA (only NR);Bacteria;Actinobacteriota;Actinobacteria;Micromonosporales;Micromonosporaceae;Couchioplanes;";"100.0";"14.4";"5";"5";"5";"0";"0";"457178";"391202"
"V4mis2";"SILVA (only NR);Bacteria;Actinobacteriota;Actinobacteria;Micromonosporales;Micromonosporaceae;Dactylosporangium;";"100.0";"14.4";"41";"41";"41";"0";"0";"457142";"391166"
"V4mis2";"SILVA (only NR);Bacteria;Actinobacteriota;Actinobacteria;Micromonosporales;Micromonosporaceae;Hamadaea;";"100.0";"14.4";"9";"9";"9";"0";"0";"457174";"391198"
"V4mis2";"SILVA (only NR);Bacteria;Actinobacteriota;Actinobacteria;Micromonosporales;Micromonosporaceae;Krasilnikovia;";"100.0";"14.4";"8";"8";"8";"0";"0";"457175";"391199"
"V4mis2";"SILVA (only NR);Bacteria;Actinobacteriota;Actinobacteria;Micromonosporales;Micromonosporaceae;Longispora;";"95.2";"14.4";"21";"21";"20";"1";"0";"457162";"391187"
"V4mis2";"SILVA (only NR);Bacteria;Actinobacteriota;Actinobacteria;Micromonosporales;Micromonosporaceae;Luedemannella;";"97.1";"14.4";"34";"34";"33";"1";"0";"457149";"391174"
"V4mis2";"SILVA (only NR);Bacteria;Actinobacteriota;Actinobacteria;Micromonosporales;Micromonosporaceae;Micromonospora;";"95.9";"14.4";"532";"532";"510";"22";"0";"456651";"390697"
"V4mis2";"SILVA (only NR);Bacteria;Actinobacteriota;Actinobacteria;Micromonosporales;Micromonosporaceae;Phytohabitans;";"100.0";"14.4";"13";"13";"13";"0";"0";"457170";"391194"
"V4mis2";"SILVA (only NR);Bacteria;Actinobacteriota;Actinobacteria;Micromonosporales;Micromonosporaceae;Phytomonospora;";"100.0";"14.4";"2";"2";"2";"0";"0";"457181";"391205"
"V4mis2";"SILVA (only NR);Bacteria;Actinobacteriota;Actinobacteria;Micromonosporales;Micromonosporaceae;Pilimelia;";"100.0";"14.4";"5";"5";"5";"0";"0";"457178";"391202"
"V4mis2";"SILVA (only NR);Bacteria;Actinobacteriota;Actinobacteria;Micromonosporales;Micromonosporaceae;Planosporangium;";"100.0";"14.4";"5";"5";"5";"0";"0";"457178";"391202"
"V4mis2";"SILVA (only NR);Bacteria;Actinobacteriota;Actinobacteria;Micromonosporales;Micromonosporaceae;Plantactinospora;";"100.0";"14.4";"21";"21";"21";"0";"0";"457162";"391186"
"V4mis2";"SILVA (only NR);Bacteria;Actinobacteriota;Actinobacteria;Micromonosporales;Micromonosporaceae;Polymorphospora;";"100.0";"14.4";"1";"1";"1";"0";"0";"457182";"391206"
"V4mis2";"SILVA (only NR);Bacteria;Actinobacteriota;Actinobacteria;Micromonosporales;Micromonosporaceae;Pseudosporangium;";"100.0";"14.4";"2";"2";"2";"0";"0";"457181";"391205"
"V4mis2";"SILVA (only NR);Bacteria;Actinobacteriota;Actinobacteria;Micromonosporales;Micromonosporaceae;Rhizocola;";"100.0";"14.4";"4";"4";"4";"0";"0";"457179";"391203"
"V4mis2";"SILVA (only NR);Bacteria;Actinobacteriota;Actinobacteria;Micromonosporales;Micromonosporaceae;Rugosimonospora;";"100.0";"14.4";"2";"2";"2";"0";"0";"457181";"391205"
"V4mis2";"SILVA (only NR);Bacteria;Actinobacteriota;Actinobacteria;Micromonosporales;Micromonosporaceae;Salinispora;";"94.4";"14.4";"36";"36";"34";"2";"0";"457147";"391173"
"V4mis2";"SILVA (only NR);Bacteria;Actinobacteriota;Actinobacteria;Micromonosporales;Micromonosporaceae;Spirilliplanes;";"100.0";"14.4";"2";"2";"2";"0";"0";"457181";"391205"
"V4mis2";"SILVA (only NR);Bacteria;Actinobacteriota;Actinobacteria;Micromonosporales;Micromonosporaceae;Stackebrandtia;";"100.0";"14.4";"9";"9";"9";"0";"0";"457174";"391198"
"V4mis2";"SILVA (only NR);Bacteria;Actinobacteriota;Actinobacteria;Micromonosporales;Micromonosporaceae;Verrucosispora;";"96.3";"14.4";"27";"27";"26";"1";"0";"457156";"391181"
"V4mis2";"SILVA (only NR);Bacteria;Actinobacteriota;Actinobacteria;Micromonosporales;Micromonosporaceae;Virgisporangium;";"100.0";"14.4";"11";"11";"11";"0";"0";"457172";"391196"
"V4mis2";"SILVA (only NR);Bacteria;Actinobacteriota;Actinobacteria;Micromonosporales;Micromonosporaceae;Wangella;";"100.0";"14.4";"4";"4";"4";"0";"0";"457179";"391203"
"V4mis2";"SILVA (only NR);Bacteria;Actinobacteriota;Actinobacteria;Micromonosporales;Micromonosporaceae;Xiangella;";"100.0";"14.4";"2";"2";"2";"0";"0";"457181";"391205"
"V4mis2";"SILVA (only NR);Bacteria;Actinobacteriota;Actinobacteria;Micromonosporales;Micromonosporaceae;uncultured;";"95.4";"14.4";"87";"87";"83";"4";"0";"457096";"391124"
"V4mis2";"SILVA (only NR);Bacteria;Actinobacteriota;Actinobacteria;Nitriliruptorales;";"87.9";"14.4";"66";"66";"58";"8";"0";"457117";"391149"
"V4mis2";"SILVA (only NR);Bacteria;Actinobacteriota;Actinobacteria;Nitriliruptorales;Nitriliruptoraceae;";"87.9";"14.4";"66";"66";"58";"8";"0";"457117";"391149"
"V4mis2";"SILVA (only NR);Bacteria;Actinobacteriota;Actinobacteria;Nitriliruptorales;Nitriliruptoraceae;Egicoccus;";"100.0";"14.4";"8";"8";"8";"0";"0";"457175";"391199"
"V4mis2";"SILVA (only NR);Bacteria;Actinobacteriota;Actinobacteria;Nitriliruptorales;Nitriliruptoraceae;Nitriliruptor;";"100.0";"14.4";"3";"3";"3";"0";"0";"457180";"391204"
"V4mis2";"SILVA (only NR);Bacteria;Actinobacteriota;Actinobacteria;Nitriliruptorales;Nitriliruptoraceae;YC-ZSS-LKJ90;";"100.0";"14.4";"4";"4";"4";"0";"0";"457179";"391203"
"V4mis2";"SILVA (only NR);Bacteria;Actinobacteriota;Actinobacteria;PeM15;";"96.8";"14.4";"95";"95";"92";"3";"0";"457088";"391115"
"V4mis2";"SILVA (only NR);Bacteria;Actinobacteriota;Actinobacteria;Propionibacteriales;";"83.2";"14.4";"3584";"3584";"2983";"601";"0";"453599";"388224"
"V4mis2";"SILVA (only NR);Bacteria;Actinobacteriota;Actinobacteria;Propionibacteriales;Nocardioidaceae;";"96.2";"14.5";"1197";"1197";"1152";"45";"0";"455986";"390055"
"V4mis2";"SILVA (only NR);Bacteria;Actinobacteriota;Actinobacteria;Propionibacteriales;Nocardioidaceae;Actinopolymorpha;";"90.0";"14.4";"10";"10";"9";"1";"0";"457173";"391198"
"V4mis2";"SILVA (only NR);Bacteria;Actinobacteriota;Actinobacteria;Propionibacteriales;Nocardioidaceae;Aeromicrobium;";"94.7";"14.4";"94";"94";"89";"5";"0";"457089";"391118"
"V4mis2";"SILVA (only NR);Bacteria;Actinobacteriota;Actinobacteria;Propionibacteriales;Nocardioidaceae;Flindersiella;";"75.0";"14.4";"4";"4";"3";"1";"0";"457179";"391204"
"V4mis2";"SILVA (only NR);Bacteria;Actinobacteriota;Actinobacteria;Propionibacteriales;Nocardioidaceae;Kribbella;";"91.4";"14.4";"81";"81";"74";"7";"0";"457102";"391133"
"V4mis2";"SILVA (only NR);Bacteria;Actinobacteriota;Actinobacteria;Propionibacteriales;Nocardioidaceae;Marmoricola;";"94.7";"14.4";"75";"75";"71";"4";"0";"457108";"391136"
"V4mis2";"SILVA (only NR);Bacteria;Actinobacteriota;Actinobacteria;Propionibacteriales;Nocardioidaceae;Mumia;";"100.0";"14.4";"7";"7";"7";"0";"0";"457176";"391200"
"V4mis2";"SILVA (only NR);Bacteria;Actinobacteriota;Actinobacteria;Propionibacteriales;Nocardioidaceae;Nocardioides;";"97.5";"14.5";"839";"839";"818";"21";"0";"456344";"390389"
"V4mis2";"SILVA (only NR);Bacteria;Actinobacteriota;Actinobacteria;Propionibacteriales;Nocardioidaceae;Tenggerimyces;";"100.0";"14.4";"3";"3";"3";"0";"0";"457180";"391204"
"V4mis2";"SILVA (only NR);Bacteria;Actinobacteriota;Actinobacteria;Propionibacteriales;Nocardioidaceae;Thermasporomyces;";"100.0";"14.4";"1";"1";"1";"0";"0";"457182";"391206"
"V4mis2";"SILVA (only NR);Bacteria;Actinobacteriota;Actinobacteria;Propionibacteriales;Nocardioidaceae;uncultured;";"93.8";"14.4";"81";"81";"76";"5";"0";"457102";"391131"
"V4mis2";"SILVA (only NR);Bacteria;Actinobacteriota;Actinobacteria;Propionibacteriales;Propionibacteriaceae;";"76.7";"14.4";"2387";"2387";"1831";"556";"0";"454796";"389376"
"V4mis2";"SILVA (only NR);Bacteria;Actinobacteriota;Actinobacteria;Propionibacteriales;Propionibacteriaceae;Acidipropionibacterium;";"95.2";"14.4";"21";"21";"20";"1";"0";"457162";"391187"
"V4mis2";"SILVA (only NR);Bacteria;Actinobacteriota;Actinobacteria;Propionibacteriales;Propionibacteriaceae;Aestuariimicrobium;";"100.0";"14.4";"24";"24";"24";"0";"0";"457159";"391183"
"V4mis2";"SILVA (only NR);Bacteria;Actinobacteriota;Actinobacteria;Propionibacteriales;Propionibacteriaceae;Auraticoccus;";"100.0";"14.4";"4";"4";"4";"0";"0";"457179";"391203"
"V4mis2";"SILVA (only NR);Bacteria;Actinobacteriota;Actinobacteria;Propionibacteriales;Propionibacteriaceae;Brooklawnia;";"100.0";"14.4";"8";"8";"8";"0";"0";"457175";"391199"
"V4mis2";"SILVA (only NR);Bacteria;Actinobacteriota;Actinobacteria;Propionibacteriales;Propionibacteriaceae;Cutibacterium;";"68.2";"14.4";"1643";"1643";"1120";"523";"0";"455540";"390087"
"V4mis2";"SILVA (only NR);Bacteria;Actinobacteriota;Actinobacteria;Propionibacteriales;Propionibacteriaceae;Friedmanniella;";"98.5";"14.4";"65";"65";"64";"1";"0";"457118";"391143"
"V4mis2";"SILVA (only NR);Bacteria;Actinobacteriota;Actinobacteria;Propionibacteriales;Propionibacteriaceae;Granulicoccus;";"100.0";"14.4";"3";"3";"3";"0";"0";"457180";"391204"
"V4mis2";"SILVA (only NR);Bacteria;Actinobacteriota;Actinobacteria;Propionibacteriales;Propionibacteriaceae;Haloactinopolyspora;";"100.0";"14.4";"32";"32";"32";"0";"0";"457151";"391175"
"V4mis2";"SILVA (only NR);Bacteria;Actinobacteriota;Actinobacteria;Propionibacteriales;Propionibacteriaceae;Jiangella;";"100.0";"14.4";"19";"19";"19";"0";"0";"457164";"391188"
"V4mis2";"SILVA (only NR);Bacteria;Actinobacteriota;Actinobacteria;Propionibacteriales;Propionibacteriaceae;Luteococcus;";"100.0";"14.4";"13";"13";"13";"0";"0";"457170";"391194"
"V4mis2";"SILVA (only NR);Bacteria;Actinobacteriota;Actinobacteria;Propionibacteriales;Propionibacteriaceae;Marinilutecoccus;";"100.0";"14.4";"10";"10";"10";"0";"0";"457173";"391197"
"V4mis2";"SILVA (only NR);Bacteria;Actinobacteriota;Actinobacteria;Propionibacteriales;Propionibacteriaceae;Microlunatus;";"96.3";"14.4";"80";"80";"77";"3";"0";"457103";"391130"
"V4mis2";"SILVA (only NR);Bacteria;Actinobacteriota;Actinobacteria;Propionibacteriales;Propionibacteriaceae;Micropruina;";"91.7";"14.4";"12";"12";"11";"1";"0";"457171";"391196"
"V4mis2";"SILVA (only NR);Bacteria;Actinobacteriota;Actinobacteria;Propionibacteriales;Propionibacteriaceae;Naumannella;";"100.0";"14.4";"3";"3";"3";"0";"0";"457180";"391204"
"V4mis2";"SILVA (only NR);Bacteria;Actinobacteriota;Actinobacteria;Propionibacteriales;Propionibacteriaceae;Phytoactinopolyspora;";"100.0";"14.4";"10";"10";"10";"0";"0";"457173";"391197"
"V4mis2";"SILVA (only NR);Bacteria;Actinobacteriota;Actinobacteria;Propionibacteriales;Propionibacteriaceae;Propionibacterium;";"96.7";"14.4";"60";"60";"58";"2";"0";"457123";"391149"
"V4mis2";"SILVA (only NR);Bacteria;Actinobacteriota;Actinobacteria;Propionibacteriales;Propionibacteriaceae;Propionicicella;";"80.0";"14.4";"30";"30";"24";"6";"0";"457153";"391183"
"V4mis2";"SILVA (only NR);Bacteria;Actinobacteriota;Actinobacteria;Propionibacteriales;Propionibacteriaceae;Propioniciclava;";"97.4";"14.4";"39";"39";"38";"1";"0";"457144";"391169"
"V4mis2";"SILVA (only NR);Bacteria;Actinobacteriota;Actinobacteria;Propionibacteriales;Propionibacteriaceae;Propionicimonas;";"92.3";"14.4";"13";"13";"12";"1";"0";"457170";"391195"
"V4mis2";"SILVA (only NR);Bacteria;Actinobacteriota;Actinobacteria;Propionibacteriales;Propionibacteriaceae;Propioniferax;";"100.0";"14.4";"3";"3";"3";"0";"0";"457180";"391204"
"V4mis2";"SILVA (only NR);Bacteria;Actinobacteriota;Actinobacteria;Propionibacteriales;Propionibacteriaceae;Propionimicrobium;";"83.3";"14.4";"6";"6";"5";"1";"0";"457177";"391202"
"V4mis2";"SILVA (only NR);Bacteria;Actinobacteriota;Actinobacteria;Propionibacteriales;Propionibacteriaceae;Pseudopropionibacterium;";"98.7";"14.4";"78";"78";"77";"1";"0";"457105";"391130"
"V4mis2";"SILVA (only NR);Bacteria;Actinobacteriota;Actinobacteria;Propionibacteriales;Propionibacteriaceae;Raineyella;";"100.0";"14.4";"11";"11";"11";"0";"0";"457172";"391196"
"V4mis2";"SILVA (only NR);Bacteria;Actinobacteriota;Actinobacteria;Propionibacteriales;Propionibacteriaceae;Tessaracoccus;";"98.4";"14.4";"62";"62";"61";"1";"0";"457121";"391146"
"V4mis2";"SILVA (only NR);Bacteria;Actinobacteriota;Actinobacteria;Propionibacteriales;Propionibacteriaceae;uncultured;";"89.0";"14.4";"127";"127";"113";"14";"0";"457056";"391094"
"V4mis2";"SILVA (only NR);Bacteria;Actinobacteriota;Actinobacteria;Pseudonocardiales;";"95.8";"14.5";"1365";"1365";"1307";"58";"0";"455818";"389900"
"V4mis2";"SILVA (only NR);Bacteria;Actinobacteriota;Actinobacteria;Pseudonocardiales;Pseudonocardiaceae;";"95.8";"14.5";"1365";"1365";"1307";"58";"0";"455818";"389900"
"V4mis2";"SILVA (only NR);Bacteria;Actinobacteriota;Actinobacteria;Pseudonocardiales;Pseudonocardiaceae;Actinoalloteichus;";"100.0";"14.4";"14";"14";"14";"0";"0";"457169";"391193"
"V4mis2";"SILVA (only NR);Bacteria;Actinobacteriota;Actinobacteria;Pseudonocardiales;Pseudonocardiaceae;Actinokineospora;";"100.0";"14.4";"29";"29";"29";"0";"0";"457154";"391178"
"V4mis2";"SILVA (only NR);Bacteria;Actinobacteriota;Actinobacteria;Pseudonocardiales;Pseudonocardiaceae;Actinomycetospora;";"95.0";"14.4";"40";"40";"38";"2";"0";"457143";"391169"
"V4mis2";"SILVA (only NR);Bacteria;Actinobacteriota;Actinobacteria;Pseudonocardiales;Pseudonocardiaceae;Actinophytocola;";"95.9";"14.4";"49";"49";"47";"2";"0";"457134";"391160"
"V4mis2";"SILVA (only NR);Bacteria;Actinobacteriota;Actinobacteria;Pseudonocardiales;Pseudonocardiaceae;Actinopolyspora;";"96.8";"14.4";"31";"31";"30";"1";"0";"457152";"391177"
"V4mis2";"SILVA (only NR);Bacteria;Actinobacteriota;Actinobacteria;Pseudonocardiales;Pseudonocardiaceae;Actinorectispora;";"77.8";"14.4";"9";"9";"7";"2";"0";"457174";"391200"
"V4mis2";"SILVA (only NR);Bacteria;Actinobacteriota;Actinobacteria;Pseudonocardiales;Pseudonocardiaceae;Actinosynnema;";"100.0";"14.4";"8";"8";"8";"0";"0";"457175";"391199"
"V4mis2";"SILVA (only NR);Bacteria;Actinobacteriota;Actinobacteria;Pseudonocardiales;Pseudonocardiaceae;Alloactinosynnema;";"100.0";"14.4";"7";"7";"7";"0";"0";"457176";"391200"
"V4mis2";"SILVA (only NR);Bacteria;Actinobacteriota;Actinobacteria;Pseudonocardiales;Pseudonocardiaceae;Allokutzneria;";"100.0";"14.4";"5";"5";"5";"0";"0";"457178";"391202"
"V4mis2";"SILVA (only NR);Bacteria;Actinobacteriota;Actinobacteria;Pseudonocardiales;Pseudonocardiaceae;Amycolatopsis;";"96.6";"14.4";"261";"261";"252";"9";"0";"456922";"390955"
"V4mis2";"SILVA (only NR);Bacteria;Actinobacteriota;Actinobacteria;Pseudonocardiales;Pseudonocardiaceae;Bounagaea;";"100.0";"14.4";"1";"1";"1";"0";"0";"457182";"391206"
"V4mis2";"SILVA (only NR);Bacteria;Actinobacteriota;Actinobacteria;Pseudonocardiales;Pseudonocardiaceae;Crossiella;";"93.7";"14.4";"142";"142";"133";"9";"0";"457041";"391074"
"V4mis2";"SILVA (only NR);Bacteria;Actinobacteriota;Actinobacteria;Pseudonocardiales;Pseudonocardiaceae;Goodfellowiella;";"100.0";"14.4";"5";"5";"5";"0";"0";"457178";"391202"
"V4mis2";"SILVA (only NR);Bacteria;Actinobacteriota;Actinobacteria;Pseudonocardiales;Pseudonocardiaceae;Haloechinothrix;";"100.0";"14.4";"1";"1";"1";"0";"0";"457182";"391206"
"V4mis2";"SILVA (only NR);Bacteria;Actinobacteriota;Actinobacteria;Pseudonocardiales;Pseudonocardiaceae;Halopolyspora;";"100.0";"14.4";"4";"4";"4";"0";"0";"457179";"391203"
"V4mis2";"SILVA (only NR);Bacteria;Actinobacteriota;Actinobacteria;Pseudonocardiales;Pseudonocardiaceae;Herbihabitans;";"100.0";"14.4";"4";"4";"4";"0";"0";"457179";"391203"
"V4mis2";"SILVA (only NR);Bacteria;Actinobacteriota;Actinobacteria;Pseudonocardiales;Pseudonocardiaceae;Kibdelosporangium;";"95.8";"14.4";"24";"24";"23";"1";"0";"457159";"391184"
"V4mis2";"SILVA (only NR);Bacteria;Actinobacteriota;Actinobacteria;Pseudonocardiales;Pseudonocardiaceae;Kutzneria;";"100.0";"14.4";"6";"6";"6";"0";"0";"457177";"391201"
"V4mis2";"SILVA (only NR);Bacteria;Actinobacteriota;Actinobacteria;Pseudonocardiales;Pseudonocardiaceae;Labedaea;";"100.0";"14.4";"1";"1";"1";"0";"0";"457182";"391206"
"V4mis2";"SILVA (only NR);Bacteria;Actinobacteriota;Actinobacteria;Pseudonocardiales;Pseudonocardiaceae;Lechevalieria;";"100.0";"14.4";"67";"67";"67";"0";"0";"457116";"391140"
"V4mis2";"SILVA (only NR);Bacteria;Actinobacteriota;Actinobacteria;Pseudonocardiales;Pseudonocardiaceae;Longimycelium;";"87.5";"14.4";"8";"8";"7";"1";"0";"457175";"391200"
"V4mis2";"SILVA (only NR);Bacteria;Actinobacteriota;Actinobacteria;Pseudonocardiales;Pseudonocardiaceae;Prauserella;";"100.0";"14.4";"26";"26";"26";"0";"0";"457157";"391181"
"V4mis2";"SILVA (only NR);Bacteria;Actinobacteriota;Actinobacteria;Pseudonocardiales;Pseudonocardiaceae;Pseudonocardia;";"95.3";"14.4";"359";"359";"342";"17";"0";"456824";"390865"
"V4mis2";"SILVA (only NR);Bacteria;Actinobacteriota;Actinobacteria;Pseudonocardiales;Pseudonocardiaceae;Saccharomonospora;";"90.1";"14.4";"71";"71";"64";"7";"0";"457112";"391143"
"V4mis2";"SILVA (only NR);Bacteria;Actinobacteriota;Actinobacteria;Pseudonocardiales;Pseudonocardiaceae;Saccharopolyspora;";"93.9";"14.4";"98";"98";"92";"6";"0";"457085";"391115"
"V4mis2";"SILVA (only NR);Bacteria;Actinobacteriota;Actinobacteria;Pseudonocardiales;Pseudonocardiaceae;Saccharothrix;";"98.2";"14.4";"57";"57";"56";"1";"0";"457126";"391151"
"V4mis2";"SILVA (only NR);Bacteria;Actinobacteriota;Actinobacteria;Pseudonocardiales;Pseudonocardiaceae;Sciscionella;";"100.0";"14.4";"3";"3";"3";"0";"0";"457180";"391204"
"V4mis2";"SILVA (only NR);Bacteria;Actinobacteriota;Actinobacteria;Pseudonocardiales;Pseudonocardiaceae;Streptoalloteichus;";"100.0";"14.4";"4";"4";"4";"0";"0";"457179";"391203"
"V4mis2";"SILVA (only NR);Bacteria;Actinobacteriota;Actinobacteria;Pseudonocardiales;Pseudonocardiaceae;Tamaricihabitans;";"100.0";"14.4";"1";"1";"1";"0";"0";"457182";"391206"
"V4mis2";"SILVA (only NR);Bacteria;Actinobacteriota;Actinobacteria;Pseudonocardiales;Pseudonocardiaceae;Thermocrispum;";"100.0";"14.4";"8";"8";"8";"0";"0";"457175";"391199"
"V4mis2";"SILVA (only NR);Bacteria;Actinobacteriota;Actinobacteria;Pseudonocardiales;Pseudonocardiaceae;Thermotunica;";"100.0";"14.4";"2";"2";"2";"0";"0";"457181";"391205"
"V4mis2";"SILVA (only NR);Bacteria;Actinobacteriota;Actinobacteria;Pseudonocardiales;Pseudonocardiaceae;Umezawaea;";"100.0";"14.4";"3";"3";"3";"0";"0";"457180";"391204"
"V4mis2";"SILVA (only NR);Bacteria;Actinobacteriota;Actinobacteria;Pseudonocardiales;Pseudonocardiaceae;Yuhushiella;";"100.0";"14.4";"4";"4";"4";"0";"0";"457179";"391203"
"V4mis2";"SILVA (only NR);Bacteria;Actinobacteriota;Actinobacteria;Pseudonocardiales;Pseudonocardiaceae;uncultured;";"100.0";"14.4";"3";"3";"3";"0";"0";"457180";"391204"
"V4mis2";"SILVA (only NR);Bacteria;Actinobacteriota;Actinobacteria;Streptomycetales;";"96.6";"14.6";"6216";"6216";"6004";"212";"0";"450967";"385203"
"V4mis2";"SILVA (only NR);Bacteria;Actinobacteriota;Actinobacteria;Streptomycetales;Streptomycetaceae;";"96.6";"14.6";"6216";"6216";"6004";"212";"0";"450967";"385203"
"V4mis2";"SILVA (only NR);Bacteria;Actinobacteriota;Actinobacteria;Streptomycetales;Streptomycetaceae;Allostreptomyces;";"100.0";"14.4";"3";"3";"3";"0";"0";"457180";"391204"
"V4mis2";"SILVA (only NR);Bacteria;Actinobacteriota;Actinobacteria;Streptomycetales;Streptomycetaceae;E1B-B3-114;";"100.0";"14.4";"2";"2";"2";"0";"0";"457181";"391205"
"V4mis2";"SILVA (only NR);Bacteria;Actinobacteriota;Actinobacteria;Streptomycetales;Streptomycetaceae;Kitasatospora;";"98.2";"14.4";"168";"168";"165";"3";"0";"457015";"391042"
"V4mis2";"SILVA (only NR);Bacteria;Actinobacteriota;Actinobacteria;Streptomycetales;Streptomycetaceae;Streptacidiphilus;";"100.0";"14.4";"31";"31";"31";"0";"0";"457152";"391176"
"V4mis2";"SILVA (only NR);Bacteria;Actinobacteriota;Actinobacteria;Streptomycetales;Streptomycetaceae;Streptomyces;";"96.5";"14.6";"6011";"6011";"5802";"209";"0";"451172";"385405"
"V4mis2";"SILVA (only NR);Bacteria;Actinobacteriota;Actinobacteria;Streptosporangiales;";"95.8";"14.5";"1229";"1229";"1177";"52";"0";"455954";"390030"
"V4mis2";"SILVA (only NR);Bacteria;Actinobacteriota;Actinobacteria;Streptosporangiales;Nocardiopsaceae;";"96.1";"14.4";"355";"355";"341";"14";"0";"456828";"390866"
"V4mis2";"SILVA (only NR);Bacteria;Actinobacteriota;Actinobacteria;Streptosporangiales;Nocardiopsaceae;Actinorugispora;";"100.0";"14.4";"1";"1";"1";"0";"0";"457182";"391206"
"V4mis2";"SILVA (only NR);Bacteria;Actinobacteriota;Actinobacteria;Streptosporangiales;Nocardiopsaceae;Allonocardiopsis;";"100.0";"14.4";"1";"1";"1";"0";"0";"457182";"391206"
"V4mis2";"SILVA (only NR);Bacteria;Actinobacteriota;Actinobacteria;Streptosporangiales;Nocardiopsaceae;Allosalinactinospora;";"50.0";"14.4";"2";"2";"1";"1";"0";"457181";"391206"
"V4mis2";"SILVA (only NR);Bacteria;Actinobacteriota;Actinobacteria;Streptosporangiales;Nocardiopsaceae;Haloactinospora;";"100.0";"14.4";"1";"1";"1";"0";"0";"457182";"391206"
"V4mis2";"SILVA (only NR);Bacteria;Actinobacteriota;Actinobacteria;Streptosporangiales;Nocardiopsaceae;Lipingzhangella;";"100.0";"14.4";"5";"5";"5";"0";"0";"457178";"391202"
"V4mis2";"SILVA (only NR);Bacteria;Actinobacteriota;Actinobacteria;Streptosporangiales;Nocardiopsaceae;Marinactinospora;";"100.0";"14.4";"2";"2";"2";"0";"0";"457181";"391205"
"V4mis2";"SILVA (only NR);Bacteria;Actinobacteriota;Actinobacteria;Streptosporangiales;Nocardiopsaceae;Marinateneraspora;";"100.0";"14.4";"1";"1";"1";"0";"0";"457182";"391206"
"V4mis2";"SILVA (only NR);Bacteria;Actinobacteriota;Actinobacteria;Streptosporangiales;Nocardiopsaceae;Murinocardiopsis;";"100.0";"14.4";"1";"1";"1";"0";"0";"457182";"391206"
"V4mis2";"SILVA (only NR);Bacteria;Actinobacteriota;Actinobacteria;Streptosporangiales;Nocardiopsaceae;Nocardiopsis;";"96.2";"14.4";"291";"291";"280";"11";"0";"456892";"390927"
"V4mis2";"SILVA (only NR);Bacteria;Actinobacteriota;Actinobacteria;Streptosporangiales;Nocardiopsaceae;Salinactinospora;";"100.0";"14.4";"1";"1";"1";"0";"0";"457182";"391206"
"V4mis2";"SILVA (only NR);Bacteria;Actinobacteriota;Actinobacteria;Streptosporangiales;Nocardiopsaceae;Spinactinospora;";"100.0";"14.4";"1";"1";"1";"0";"0";"457182";"391206"
"V4mis2";"SILVA (only NR);Bacteria;Actinobacteriota;Actinobacteria;Streptosporangiales;Nocardiopsaceae;Streptomonospora;";"95.7";"14.4";"23";"23";"22";"1";"0";"457160";"391185"
"V4mis2";"SILVA (only NR);Bacteria;Actinobacteriota;Actinobacteria;Streptosporangiales;Nocardiopsaceae;Thermobifida;";"94.7";"14.4";"19";"19";"18";"1";"0";"457164";"391189"
"V4mis2";"SILVA (only NR);Bacteria;Actinobacteriota;Actinobacteria;Streptosporangiales;Nocardiopsaceae;uncultured;";"100.0";"14.4";"2";"2";"2";"0";"0";"457181";"391205"
"V4mis2";"SILVA (only NR);Bacteria;Actinobacteriota;Actinobacteria;Streptosporangiales;Streptosporangiaceae;";"95.0";"14.4";"497";"497";"472";"25";"0";"456686";"390735"
"V4mis2";"SILVA (only NR);Bacteria;Actinobacteriota;Actinobacteria;Streptosporangiales;Streptosporangiaceae;Acrocarpospora;";"100.0";"14.4";"10";"10";"10";"0";"0";"457173";"391197"
"V4mis2";"SILVA (only NR);Bacteria;Actinobacteriota;Actinobacteria;Streptosporangiales;Streptosporangiaceae;Herbidospora;";"100.0";"14.4";"8";"8";"8";"0";"0";"457175";"391199"
"V4mis2";"SILVA (only NR);Bacteria;Actinobacteriota;Actinobacteria;Streptosporangiales;Streptosporangiaceae;Microbispora;";"98.1";"14.4";"53";"53";"52";"1";"0";"457130";"391155"
"V4mis2";"SILVA (only NR);Bacteria;Actinobacteriota;Actinobacteria;Streptosporangiales;Streptosporangiaceae;Microtetraspora;";"100.0";"14.4";"8";"8";"8";"0";"0";"457175";"391199"
"V4mis2";"SILVA (only NR);Bacteria;Actinobacteriota;Actinobacteria;Streptosporangiales;Streptosporangiaceae;Nonomuraea;";"94.9";"14.4";"195";"195";"185";"10";"0";"456988";"391022"
"V4mis2";"SILVA (only NR);Bacteria;Actinobacteriota;Actinobacteria;Streptosporangiales;Streptosporangiaceae;Planobispora;";"100.0";"14.4";"4";"4";"4";"0";"0";"457179";"391203"
"V4mis2";"SILVA (only NR);Bacteria;Actinobacteriota;Actinobacteria;Streptosporangiales;Streptosporangiaceae;Planomonospora;";"100.0";"14.4";"10";"10";"10";"0";"0";"457173";"391197"
"V4mis2";"SILVA (only NR);Bacteria;Actinobacteriota;Actinobacteria;Streptosporangiales;Streptosporangiaceae;Planotetraspora;";"100.0";"14.4";"14";"14";"14";"0";"0";"457169";"391193"
"V4mis2";"SILVA (only NR);Bacteria;Actinobacteriota;Actinobacteria;Streptosporangiales;Streptosporangiaceae;Sinosporangium;";"100.0";"14.4";"3";"3";"3";"0";"0";"457180";"391204"
"V4mis2";"SILVA (only NR);Bacteria;Actinobacteriota;Actinobacteria;Streptosporangiales;Streptosporangiaceae;Sphaerimonospora;";"100.0";"14.4";"6";"6";"6";"0";"0";"457177";"391201"
"V4mis2";"SILVA (only NR);Bacteria;Actinobacteriota;Actinobacteria;Streptosporangiales;Streptosporangiaceae;Sphaerisporangium;";"91.7";"14.4";"48";"48";"44";"4";"0";"457135";"391163"
"V4mis2";"SILVA (only NR);Bacteria;Actinobacteriota;Actinobacteria;Streptosporangiales;Streptosporangiaceae;Streptosporangium;";"92.2";"14.4";"116";"116";"107";"9";"0";"457067";"391100"
"V4mis2";"SILVA (only NR);Bacteria;Actinobacteriota;Actinobacteria;Streptosporangiales;Streptosporangiaceae;Thermoactinospora;";"100.0";"14.4";"1";"1";"1";"0";"0";"457182";"391206"
"V4mis2";"SILVA (only NR);Bacteria;Actinobacteriota;Actinobacteria;Streptosporangiales;Streptosporangiaceae;Thermocatellispora;";"100.0";"14.4";"3";"3";"3";"0";"0";"457180";"391204"
"V4mis2";"SILVA (only NR);Bacteria;Actinobacteriota;Actinobacteria;Streptosporangiales;Streptosporangiaceae;Thermopolyspora;";"100.0";"14.4";"4";"4";"4";"0";"0";"457179";"391203"
"V4mis2";"SILVA (only NR);Bacteria;Actinobacteriota;Actinobacteria;Streptosporangiales;Streptosporangiaceae;uncultured;";"100.0";"14.4";"6";"6";"6";"0";"0";"457177";"391201"
"V4mis2";"SILVA (only NR);Bacteria;Actinobacteriota;Actinobacteria;Streptosporangiales;Streptosporangiales Incertae Sedis;";"100.0";"14.4";"6";"6";"6";"0";"0";"457177";"391201"
"V4mis2";"SILVA (only NR);Bacteria;Actinobacteriota;Actinobacteria;Streptosporangiales;Streptosporangiales Incertae Sedis;Motilibacter;";"100.0";"14.4";"6";"6";"6";"0";"0";"457177";"391201"
"V4mis2";"SILVA (only NR);Bacteria;Actinobacteriota;Actinobacteria;Streptosporangiales;Thermomonosporaceae;";"96.5";"14.4";"369";"369";"356";"13";"0";"456814";"390851"
"V4mis2";"SILVA (only NR);Bacteria;Actinobacteriota;Actinobacteria;Streptosporangiales;Thermomonosporaceae;Actinoallomurus;";"97.6";"14.4";"42";"42";"41";"1";"0";"457141";"391166"
"V4mis2";"SILVA (only NR);Bacteria;Actinobacteriota;Actinobacteria;Streptosporangiales;Thermomonosporaceae;Actinocorallia;";"100.0";"14.4";"26";"26";"26";"0";"0";"457157";"391181"
"V4mis2";"SILVA (only NR);Bacteria;Actinobacteriota;Actinobacteria;Streptosporangiales;Thermomonosporaceae;Actinomadura;";"96.7";"14.4";"242";"242";"234";"8";"0";"456941";"390973"
"V4mis2";"SILVA (only NR);Bacteria;Actinobacteriota;Actinobacteria;Streptosporangiales;Thermomonosporaceae;Spirillospora;";"100.0";"14.4";"7";"7";"7";"0";"0";"457176";"391200"
"V4mis2";"SILVA (only NR);Bacteria;Actinobacteriota;Actinobacteria;Streptosporangiales;Thermomonosporaceae;Thermobispora;";"100.0";"14.4";"9";"9";"9";"0";"0";"457174";"391198"
"V4mis2";"SILVA (only NR);Bacteria;Actinobacteriota;Actinobacteria;Streptosporangiales;Thermomonosporaceae;Thermomonospora;";"100.0";"14.4";"9";"9";"9";"0";"0";"457174";"391198"
"V4mis2";"SILVA (only NR);Bacteria;Actinobacteriota;Actinobacteria;Streptosporangiales;Thermomonosporaceae;Thermostaphylospora;";"100.0";"14.4";"10";"10";"10";"0";"0";"457173";"391197"
"V4mis2";"SILVA (only NR);Bacteria;Actinobacteriota;Actinobacteria;Streptosporangiales;Thermomonosporaceae;[Streptomyces] thermoautotrophicus;";"100.0";"14.4";"3";"3";"3";"0";"0";"457180";"391204"
"V4mis2";"SILVA (only NR);Bacteria;Actinobacteriota;Actinobacteria;Streptosporangiales;Thermomonosporaceae;uncultured;";"75.0";"14.4";"4";"4";"3";"1";"0";"457179";"391204"
"V4mis2";"SILVA (only NR);Bacteria;Actinobacteriota;Actinobacteria;uncultured;";"100.0";"14.4";"15";"15";"15";"0";"0";"457168";"391192"
"V4mis2";"SILVA (only NR);Bacteria;Actinobacteriota;Coriobacteriia;";"97.5";"14.5";"1162";"1162";"1133";"29";"0";"456021";"390074"
"V4mis2";"SILVA (only NR);Bacteria;Actinobacteriota;Coriobacteriia;CG2-30-50-142;";"100.0";"14.4";"8";"8";"8";"0";"0";"457175";"391199"
"V4mis2";"SILVA (only NR);Bacteria;Actinobacteriota;Coriobacteriia;Coriobacteriales;";"97.6";"14.5";"1040";"1040";"1015";"25";"0";"456143";"390192"
"V4mis2";"SILVA (only NR);Bacteria;Actinobacteriota;Coriobacteriia;Coriobacteriales;Atopobiaceae;";"94.8";"14.4";"211";"211";"200";"11";"0";"456972";"391007"
"V4mis2";"SILVA (only NR);Bacteria;Actinobacteriota;Coriobacteriia;Coriobacteriales;Atopobiaceae;Atopobium;";"89.3";"14.4";"75";"75";"67";"8";"0";"457108";"391140"
"V4mis2";"SILVA (only NR);Bacteria;Actinobacteriota;Coriobacteriia;Coriobacteriales;Atopobiaceae;Coriobacteriaceae UCG-002;";"100.0";"14.4";"17";"17";"17";"0";"0";"457166";"391190"
"V4mis2";"SILVA (only NR);Bacteria;Actinobacteriota;Coriobacteriia;Coriobacteriales;Atopobiaceae;Coriobacteriaceae UCG-003;";"100.0";"14.4";"9";"9";"9";"0";"0";"457174";"391198"
"V4mis2";"SILVA (only NR);Bacteria;Actinobacteriota;Coriobacteriia;Coriobacteriales;Atopobiaceae;Libanicoccus;";"100.0";"14.4";"15";"15";"15";"0";"0";"457168";"391192"
"V4mis2";"SILVA (only NR);Bacteria;Actinobacteriota;Coriobacteriia;Coriobacteriales;Atopobiaceae;Olsenella;";"97.7";"14.4";"86";"86";"84";"2";"0";"457097";"391123"
"V4mis2";"SILVA (only NR);Bacteria;Actinobacteriota;Coriobacteriia;Coriobacteriales;Atopobiaceae;uncultured;";"85.7";"14.4";"7";"7";"6";"1";"0";"457176";"391201"
"V4mis2";"SILVA (only NR);Bacteria;Actinobacteriota;Coriobacteriia;Coriobacteriales;Coriobacteriaceae;";"98.3";"14.4";"351";"351";"345";"6";"0";"456832";"390862"
"V4mis2";"SILVA (only NR);Bacteria;Actinobacteriota;Coriobacteriia;Coriobacteriales;Coriobacteriaceae;Collinsella;";"98.2";"14.4";"334";"334";"328";"6";"0";"456849";"390879"
"V4mis2";"SILVA (only NR);Bacteria;Actinobacteriota;Coriobacteriia;Coriobacteriales;Coriobacteriaceae;Coriobacterium;";"100.0";"14.4";"8";"8";"8";"0";"0";"457175";"391199"
"V4mis2";"SILVA (only NR);Bacteria;Actinobacteriota;Coriobacteriia;Coriobacteriales;Coriobacteriaceae;Enorma;";"100.0";"14.4";"9";"9";"9";"0";"0";"457174";"391198"
"V4mis2";"SILVA (only NR);Bacteria;Actinobacteriota;Coriobacteriia;Coriobacteriales;Coriobacteriales Incertae Sedis;";"100.0";"14.4";"68";"68";"68";"0";"0";"457115";"391139"
"V4mis2";"SILVA (only NR);Bacteria;Actinobacteriota;Coriobacteriia;Coriobacteriales;Coriobacteriales Incertae Sedis;Phoenicibacter;";"100.0";"14.4";"8";"8";"8";"0";"0";"457175";"391199"
"V4mis2";"SILVA (only NR);Bacteria;Actinobacteriota;Coriobacteriia;Coriobacteriales;Coriobacteriales Incertae Sedis;Raoultibacter;";"100.0";"14.4";"16";"16";"16";"0";"0";"457167";"391191"
"V4mis2";"SILVA (only NR);Bacteria;Actinobacteriota;Coriobacteriia;Coriobacteriales;Coriobacteriales Incertae Sedis;uncultured;";"100.0";"14.4";"44";"44";"44";"0";"0";"457139";"391163"
"V4mis2";"SILVA (only NR);Bacteria;Actinobacteriota;Coriobacteriia;Coriobacteriales;Eggerthellaceae;";"97.9";"14.4";"387";"387";"379";"8";"0";"456796";"390828"
"V4mis2";"SILVA (only NR);Bacteria;Actinobacteriota;Coriobacteriia;Coriobacteriales;Eggerthellaceae;Adlercreutzia;";"100.0";"14.4";"10";"10";"10";"0";"0";"457173";"391197"
"V4mis2";"SILVA (only NR);Bacteria;Actinobacteriota;Coriobacteriia;Coriobacteriales;Eggerthellaceae;Asaccharobacter;";"100.0";"14.4";"2";"2";"2";"0";"0";"457181";"391205"
"V4mis2";"SILVA (only NR);Bacteria;Actinobacteriota;Coriobacteriia;Coriobacteriales;Eggerthellaceae;CHKCI002;";"100.0";"14.4";"2";"2";"2";"0";"0";"457181";"391205"
"V4mis2";"SILVA (only NR);Bacteria;Actinobacteriota;Coriobacteriia;Coriobacteriales;Eggerthellaceae;Cryptobacterium;";"100.0";"14.4";"3";"3";"3";"0";"0";"457180";"391204"
"V4mis2";"SILVA (only NR);Bacteria;Actinobacteriota;Coriobacteriia;Coriobacteriales;Eggerthellaceae;DNF00809;";"100.0";"14.4";"13";"13";"13";"0";"0";"457170";"391194"
"V4mis2";"SILVA (only NR);Bacteria;Actinobacteriota;Coriobacteriia;Coriobacteriales;Eggerthellaceae;Denitrobacterium;";"100.0";"14.4";"4";"4";"4";"0";"0";"457179";"391203"
"V4mis2";"SILVA (only NR);Bacteria;Actinobacteriota;Coriobacteriia;Coriobacteriales;Eggerthellaceae;Eggerthella;";"100.0";"14.4";"32";"32";"32";"0";"0";"457151";"391175"
"V4mis2";"SILVA (only NR);Bacteria;Actinobacteriota;Coriobacteriia;Coriobacteriales;Eggerthellaceae;Enterorhabdus;";"97.1";"14.4";"136";"136";"132";"4";"0";"457047";"391075"
"V4mis2";"SILVA (only NR);Bacteria;Actinobacteriota;Coriobacteriia;Coriobacteriales;Eggerthellaceae;Enteroscipio;";"100.0";"14.4";"2";"2";"2";"0";"0";"457181";"391205"
"V4mis2";"SILVA (only NR);Bacteria;Actinobacteriota;Coriobacteriia;Coriobacteriales;Eggerthellaceae;Gordonibacter;";"100.0";"14.4";"23";"23";"23";"0";"0";"457160";"391184"
"V4mis2";"SILVA (only NR);Bacteria;Actinobacteriota;Coriobacteriia;Coriobacteriales;Eggerthellaceae;Paraeggerthella;";"100.0";"14.4";"7";"7";"7";"0";"0";"457176";"391200"
"V4mis2";"SILVA (only NR);Bacteria;Actinobacteriota;Coriobacteriia;Coriobacteriales;Eggerthellaceae;Parvibacter;";"100.0";"14.4";"6";"6";"6";"0";"0";"457177";"391201"
"V4mis2";"SILVA (only NR);Bacteria;Actinobacteriota;Coriobacteriia;Coriobacteriales;Eggerthellaceae;Senegalimassilia;";"100.0";"14.4";"24";"24";"24";"0";"0";"457159";"391183"
"V4mis2";"SILVA (only NR);Bacteria;Actinobacteriota;Coriobacteriia;Coriobacteriales;Eggerthellaceae;Slackia;";"96.1";"14.4";"51";"51";"49";"2";"0";"457132";"391158"
"V4mis2";"SILVA (only NR);Bacteria;Actinobacteriota;Coriobacteriia;Coriobacteriales;Eggerthellaceae;uncultured;";"97.2";"14.4";"72";"72";"70";"2";"0";"457111";"391137"
"V4mis2";"SILVA (only NR);Bacteria;Actinobacteriota;Coriobacteriia;Coriobacteriales;uncultured;";"100.0";"14.4";"22";"22";"22";"0";"0";"457161";"391185"
"V4mis2";"SILVA (only NR);Bacteria;Actinobacteriota;Coriobacteriia;FS118-23B-02;";"100.0";"14.4";"11";"11";"11";"0";"0";"457172";"391196"
"V4mis2";"SILVA (only NR);Bacteria;Actinobacteriota;Coriobacteriia;OPB41;";"96.1";"14.4";"103";"103";"99";"4";"0";"457080";"391108"
"V4mis2";"SILVA (only NR);Bacteria;Actinobacteriota;MB-A2-108;";"94.3";"14.4";"194";"194";"183";"11";"0";"456989";"391024"
"V4mis2";"SILVA (only NR);Bacteria;Actinobacteriota;RBG-16-55-12;";"96.9";"14.4";"32";"32";"31";"1";"0";"457151";"391176"
"V4mis2";"SILVA (only NR);Bacteria;Actinobacteriota;Rubrobacteria;";"93.1";"14.4";"261";"261";"243";"18";"0";"456922";"390964"
"V4mis2";"SILVA (only NR);Bacteria;Actinobacteriota;Rubrobacteria;Rubrobacterales;";"93.1";"14.4";"261";"261";"243";"18";"0";"456922";"390964"
"V4mis2";"SILVA (only NR);Bacteria;Actinobacteriota;Rubrobacteria;Rubrobacterales;Rubrobacteriaceae;";"93.1";"14.4";"261";"261";"243";"18";"0";"456922";"390964"
"V4mis2";"SILVA (only NR);Bacteria;Actinobacteriota;Rubrobacteria;Rubrobacterales;Rubrobacteriaceae;Rubrobacter;";"93.1";"14.4";"261";"261";"243";"18";"0";"456922";"390964"
"V4mis2";"SILVA (only NR);Bacteria;Actinobacteriota;Thermoleophilia;";"95.3";"14.5";"1750";"1750";"1668";"82";"0";"455433";"389539"
"V4mis2";"SILVA (only NR);Bacteria;Actinobacteriota;Thermoleophilia;Gaiellales;";"95.7";"14.5";"1029";"1029";"985";"44";"0";"456154";"390222"
"V4mis2";"SILVA (only NR);Bacteria;Actinobacteriota;Thermoleophilia;Gaiellales;Gaiellaceae;";"95.6";"14.4";"203";"203";"194";"9";"0";"456980";"391013"
"V4mis2";"SILVA (only NR);Bacteria;Actinobacteriota;Thermoleophilia;Gaiellales;Gaiellaceae;Gaiella;";"95.6";"14.4";"203";"203";"194";"9";"0";"456980";"391013"
"V4mis2";"SILVA (only NR);Bacteria;Actinobacteriota;Thermoleophilia;Gaiellales;uncultured;";"95.7";"14.4";"823";"823";"788";"35";"0";"456360";"390419"
"V4mis2";"SILVA (only NR);Bacteria;Actinobacteriota;Thermoleophilia;Solirubrobacterales;";"94.7";"14.4";"692";"692";"655";"37";"0";"456491";"390552"
"V4mis2";"SILVA (only NR);Bacteria;Actinobacteriota;Thermoleophilia;Solirubrobacterales;67-14;";"93.3";"14.4";"327";"327";"305";"22";"0";"456856";"390902"
"V4mis2";"SILVA (only NR);Bacteria;Actinobacteriota;Thermoleophilia;Solirubrobacterales;Solirubrobacteraceae;";"95.9";"14.4";"365";"365";"350";"15";"0";"456818";"390857"
"V4mis2";"SILVA (only NR);Bacteria;Actinobacteriota;Thermoleophilia;Solirubrobacterales;Solirubrobacteraceae;Conexibacter;";"98.2";"14.4";"110";"110";"108";"2";"0";"457073";"391099"
"V4mis2";"SILVA (only NR);Bacteria;Actinobacteriota;Thermoleophilia;Solirubrobacterales;Solirubrobacteraceae;JCM 18997;";"100.0";"14.4";"5";"5";"5";"0";"0";"457178";"391202"
"V4mis2";"SILVA (only NR);Bacteria;Actinobacteriota;Thermoleophilia;Solirubrobacterales;Solirubrobacteraceae;Parviterribacter;";"76.9";"14.4";"13";"13";"10";"3";"0";"457170";"391197"
"V4mis2";"SILVA (only NR);Bacteria;Actinobacteriota;Thermoleophilia;Solirubrobacterales;Solirubrobacteraceae;Patulibacter;";"100.0";"14.4";"17";"17";"17";"0";"0";"457166";"391190"
"V4mis2";"SILVA (only NR);Bacteria;Actinobacteriota;Thermoleophilia;Solirubrobacterales;Solirubrobacteraceae;Solirubrobacter;";"96.2";"14.4";"183";"183";"176";"7";"0";"457000";"391031"
"V4mis2";"SILVA (only NR);Bacteria;Actinobacteriota;Thermoleophilia;Solirubrobacterales;Solirubrobacteraceae;uncultured;";"91.2";"14.4";"34";"34";"31";"3";"0";"457149";"391176"
"V4mis2";"SILVA (only NR);Bacteria;Actinobacteriota;Thermoleophilia;Thermophilales;";"100.0";"14.4";"5";"5";"5";"0";"0";"457178";"391202"
"V4mis2";"SILVA (only NR);Bacteria;Actinobacteriota;Thermoleophilia;Thermophilales;Thermoleophilaceae;";"100.0";"14.4";"5";"5";"5";"0";"0";"457178";"391202"
"V4mis2";"SILVA (only NR);Bacteria;Actinobacteriota;Thermoleophilia;Thermophilales;Thermoleophilaceae;Thermoleophilum;";"100.0";"14.4";"5";"5";"5";"0";"0";"457178";"391202"
"V4mis2";"SILVA (only NR);Bacteria;Actinobacteriota;Thermoleophilia;uncultured;";"95.8";"14.4";"24";"24";"23";"1";"0";"457159";"391184"
"V4mis2";"SILVA (only NR);Bacteria;Actinobacteriota;WCHB1-81;";"94.4";"14.4";"89";"89";"84";"5";"0";"457094";"391123"
"V4mis2";"SILVA (only NR);Bacteria;Aerophobota;";"97.1";"14.4";"70";"70";"68";"2";"0";"457113";"391139"
"V4mis2";"SILVA (only NR);Bacteria;Aerophobota;Aerophobia;";"97.1";"14.4";"70";"70";"68";"2";"0";"457113";"391139"
"V4mis2";"SILVA (only NR);Bacteria;Aerophobota;Aerophobia;Aerophobales;";"97.1";"14.4";"70";"70";"68";"2";"0";"457113";"391139"
"V4mis2";"SILVA (only NR);Bacteria;AncK6;";"100.0";"14.4";"23";"23";"23";"0";"0";"457160";"391184"
"V4mis2";"SILVA (only NR);Bacteria;Apal-E12;";"66.7";"14.4";"3";"3";"2";"1";"0";"457180";"391205"
"V4mis2";"SILVA (only NR);Bacteria;Aquificota;";"95.7";"14.4";"253";"253";"242";"11";"0";"456930";"390965"
"V4mis2";"SILVA (only NR);Bacteria;Aquificota;Aquificae;";"95.6";"14.4";"226";"226";"216";"10";"0";"456957";"390991"
"V4mis2";"SILVA (only NR);Bacteria;Aquificota;Aquificae;Aquificales;";"95.4";"14.4";"130";"130";"124";"6";"0";"457053";"391083"
"V4mis2";"SILVA (only NR);Bacteria;Aquificota;Aquificae;Aquificales;Aquificaceae;";"94.4";"14.4";"90";"90";"85";"5";"0";"457093";"391122"
"V4mis2";"SILVA (only NR);Bacteria;Aquificota;Aquificae;Aquificales;Aquificaceae;Aquifex;";"100.0";"14.4";"3";"3";"3";"0";"0";"457180";"391204"
"V4mis2";"SILVA (only NR);Bacteria;Aquificota;Aquificae;Aquificales;Aquificaceae;Hydrogenivirga;";"100.0";"14.4";"4";"4";"4";"0";"0";"457179";"391203"
"V4mis2";"SILVA (only NR);Bacteria;Aquificota;Aquificae;Aquificales;Aquificaceae;Hydrogenobacter;";"90.0";"14.4";"30";"30";"27";"3";"0";"457153";"391180"
"V4mis2";"SILVA (only NR);Bacteria;Aquificota;Aquificae;Aquificales;Aquificaceae;Thermocrinis;";"95.8";"14.4";"48";"48";"46";"2";"0";"457135";"391161"
"V4mis2";"SILVA (only NR);Bacteria;Aquificota;Aquificae;Aquificales;Aquificaceae;uncultured;";"100.0";"14.4";"2";"2";"2";"0";"0";"457181";"391205"
"V4mis2";"SILVA (only NR);Bacteria;Aquificota;Aquificae;Aquificales;Hydrogenobaculaceae;";"97.5";"14.4";"40";"40";"39";"1";"0";"457143";"391168"
"V4mis2";"SILVA (only NR);Bacteria;Aquificota;Aquificae;Aquificales;Hydrogenobaculaceae;Hydrogenobaculum;";"97.5";"14.4";"40";"40";"39";"1";"0";"457143";"391168"
"V4mis2";"SILVA (only NR);Bacteria;Aquificota;Aquificae;Hydrogenothermales;";"95.8";"14.4";"96";"96";"92";"4";"0";"457087";"391115"
"V4mis2";"SILVA (only NR);Bacteria;Aquificota;Aquificae;Hydrogenothermales;Hydrogenothermaceae;";"95.8";"14.4";"96";"96";"92";"4";"0";"457087";"391115"
"V4mis2";"SILVA (only NR);Bacteria;Aquificota;Aquificae;Hydrogenothermales;Hydrogenothermaceae;Hydrogenothermus;";"85.7";"14.4";"7";"7";"6";"1";"0";"457176";"391201"
"V4mis2";"SILVA (only NR);Bacteria;Aquificota;Aquificae;Hydrogenothermales;Hydrogenothermaceae;Persephonella;";"93.8";"14.4";"16";"16";"15";"1";"0";"457167";"391192"
"V4mis2";"SILVA (only NR);Bacteria;Aquificota;Aquificae;Hydrogenothermales;Hydrogenothermaceae;Sulfurihydrogenibium;";"96.3";"14.4";"54";"54";"52";"2";"0";"457129";"391155"
"V4mis2";"SILVA (only NR);Bacteria;Aquificota;Aquificae;Hydrogenothermales;Hydrogenothermaceae;Venenivibrio;";"100.0";"14.4";"9";"9";"9";"0";"0";"457174";"391198"
"V4mis2";"SILVA (only NR);Bacteria;Aquificota;Aquificae;Hydrogenothermales;Hydrogenothermaceae;uncultured;";"100.0";"14.4";"7";"7";"7";"0";"0";"457176";"391200"
"V4mis2";"SILVA (only NR);Bacteria;Aquificota;Desulfurobacteriia;";"96.3";"14.4";"27";"27";"26";"1";"0";"457156";"391181"
"V4mis2";"SILVA (only NR);Bacteria;Aquificota;Desulfurobacteriia;Desulfurobacteriales;";"96.3";"14.4";"27";"27";"26";"1";"0";"457156";"391181"
"V4mis2";"SILVA (only NR);Bacteria;Aquificota;Desulfurobacteriia;Desulfurobacteriales;Desulfurobacteriaceae;";"96.3";"14.4";"27";"27";"26";"1";"0";"457156";"391181"
"V4mis2";"SILVA (only NR);Bacteria;Aquificota;Desulfurobacteriia;Desulfurobacteriales;Desulfurobacteriaceae;Balnearium;";"100.0";"14.4";"2";"2";"2";"0";"0";"457181";"391205"
"V4mis2";"SILVA (only NR);Bacteria;Aquificota;Desulfurobacteriia;Desulfurobacteriales;Desulfurobacteriaceae;Desulfurobacterium;";"94.4";"14.4";"18";"18";"17";"1";"0";"457165";"391190"
"V4mis2";"SILVA (only NR);Bacteria;Aquificota;Desulfurobacteriia;Desulfurobacteriales;Desulfurobacteriaceae;Phorcysia;";"100.0";"14.4";"1";"1";"1";"0";"0";"457182";"391206"
"V4mis2";"SILVA (only NR);Bacteria;Aquificota;Desulfurobacteriia;Desulfurobacteriales;Desulfurobacteriaceae;Thermovibrio;";"100.0";"14.4";"5";"5";"5";"0";"0";"457178";"391202"
"V4mis2";"SILVA (only NR);Bacteria;Armatimonadota;";"96.4";"14.4";"776";"776";"748";"28";"0";"456407";"390459"
"V4mis2";"SILVA (only NR);Bacteria;Armatimonadota;Armatimonadia;";"96.8";"14.4";"156";"156";"151";"5";"0";"457027";"391056"
"V4mis2";"SILVA (only NR);Bacteria;Armatimonadota;Armatimonadia;Armatimonadales;";"96.8";"14.4";"156";"156";"151";"5";"0";"457027";"391056"
"V4mis2";"SILVA (only NR);Bacteria;Armatimonadota;Armatimonadia;Armatimonadales;Armatimonadaceae;";"100.0";"14.4";"12";"12";"12";"0";"0";"457171";"391195"
"V4mis2";"SILVA (only NR);Bacteria;Armatimonadota;Armatimonadia;Armatimonadales;Armatimonadaceae;Armatimonas;";"100.0";"14.4";"12";"12";"12";"0";"0";"457171";"391195"
"V4mis2";"SILVA (only NR);Bacteria;Armatimonadota;Chthonomonadetes;";"98.9";"14.4";"88";"88";"87";"1";"0";"457095";"391120"
"V4mis2";"SILVA (only NR);Bacteria;Armatimonadota;Chthonomonadetes;Chthonomonadales;";"98.9";"14.4";"88";"88";"87";"1";"0";"457095";"391120"
"V4mis2";"SILVA (only NR);Bacteria;Armatimonadota;Chthonomonadetes;Chthonomonadales;Chthonomonadaceae;";"100.0";"14.4";"34";"34";"34";"0";"0";"457149";"391173"
"V4mis2";"SILVA (only NR);Bacteria;Armatimonadota;Chthonomonadetes;Chthonomonadales;Chthonomonadaceae;Chthonomonas;";"100.0";"14.4";"34";"34";"34";"0";"0";"457149";"391173"
"V4mis2";"SILVA (only NR);Bacteria;Armatimonadota;DG-56;";"95.2";"14.4";"21";"21";"20";"1";"0";"457162";"391187"
"V4mis2";"SILVA (only NR);Bacteria;Armatimonadota;Fimbriimonadia;";"97.3";"14.4";"220";"220";"214";"6";"0";"456963";"390993"
"V4mis2";"SILVA (only NR);Bacteria;Armatimonadota;Fimbriimonadia;Fimbriimonadales;";"97.3";"14.4";"220";"220";"214";"6";"0";"456963";"390993"
"V4mis2";"SILVA (only NR);Bacteria;Armatimonadota;Fimbriimonadia;Fimbriimonadales;Fimbriimonadaceae;";"98.3";"14.4";"172";"172";"169";"3";"0";"457011";"391038"
"V4mis2";"SILVA (only NR);Bacteria;Armatimonadota;Fimbriimonadia;Fimbriimonadales;Fimbriimonadaceae;Fimbriimonas;";"100.0";"14.4";"7";"7";"7";"0";"0";"457176";"391200"
"V4mis2";"SILVA (only NR);Bacteria;Armatimonadota;uncultured;";"94.8";"14.4";"291";"291";"276";"15";"0";"456892";"390931"
"V4mis2";"SILVA (only NR);Bacteria;BHI80-139;";"95.1";"14.4";"41";"41";"39";"2";"0";"457142";"391168"
"V4mis2";"SILVA (only NR);Bacteria;Bacteroidota;";"95.9";"15.6";"45751";"45751";"43887";"1864";"0";"411432";"347320"
"V4mis2";"SILVA (only NR);Bacteria;Bacteroidota;Bacteroidia;";"95.9";"15.5";"42694";"42694";"40954";"1740";"0";"414489";"350253"
"V4mis2";"SILVA (only NR);Bacteria;Bacteroidota;Bacteroidia;Bacteroidales;";"95.4";"14.9";"21842";"21842";"20835";"1007";"0";"435341";"370372"
"V4mis2";"SILVA (only NR);Bacteria;Bacteroidota;Bacteroidia;Bacteroidales;009E01-B-SD-P15;";"100.0";"14.4";"9";"9";"9";"0";"0";"457174";"391198"
"V4mis2";"SILVA (only NR);Bacteria;Bacteroidota;Bacteroidia;Bacteroidales;3M1PL1-52 termite group;";"100.0";"14.4";"13";"13";"13";"0";"0";"457170";"391194"
"V4mis2";"SILVA (only NR);Bacteria;Bacteroidota;Bacteroidia;Bacteroidales;Bacteroidaceae;";"95.6";"14.5";"3631";"3631";"3470";"161";"0";"453552";"387737"
"V4mis2";"SILVA (only NR);Bacteria;Bacteroidota;Bacteroidia;Bacteroidales;Bacteroidaceae;Bacteroides;";"95.6";"14.5";"3631";"3631";"3470";"161";"0";"453552";"387737"
"V4mis2";"SILVA (only NR);Bacteria;Bacteroidota;Bacteroidia;Bacteroidales;Bacteroidales BS11 gut group;";"97.9";"14.4";"97";"97";"95";"2";"0";"457086";"391112"
"V4mis2";"SILVA (only NR);Bacteria;Bacteroidota;Bacteroidia;Bacteroidales;Bacteroidales Incertae Sedis;";"100.0";"14.4";"3";"3";"3";"0";"0";"457180";"391204"
"V4mis2";"SILVA (only NR);Bacteria;Bacteroidota;Bacteroidia;Bacteroidales;Bacteroidales Incertae Sedis;Phocaeicola;";"100.0";"14.4";"3";"3";"3";"0";"0";"457180";"391204"
"V4mis2";"SILVA (only NR);Bacteria;Bacteroidota;Bacteroidia;Bacteroidales;Bacteroidales RF16 group;";"98.4";"14.4";"125";"125";"123";"2";"0";"457058";"391084"
"V4mis2";"SILVA (only NR);Bacteria;Bacteroidota;Bacteroidia;Bacteroidales;Bacteroidales UCG-001;";"99.2";"14.4";"133";"133";"132";"1";"0";"457050";"391075"
"V4mis2";"SILVA (only NR);Bacteria;Bacteroidota;Bacteroidia;Bacteroidales;Bacteroidetes BD2-2;";"94.9";"14.4";"586";"586";"556";"30";"0";"456597";"390651"
"V4mis2";"SILVA (only NR);Bacteria;Bacteroidota;Bacteroidia;Bacteroidales;Bacteroidetes vadinHA17;";"97.0";"14.4";"333";"333";"323";"10";"0";"456850";"390884"
"V4mis2";"SILVA (only NR);Bacteria;Bacteroidota;Bacteroidia;Bacteroidales;Barnesiellaceae;";"97.1";"14.4";"140";"140";"136";"4";"0";"457043";"391071"
"V4mis2";"SILVA (only NR);Bacteria;Bacteroidota;Bacteroidia;Bacteroidales;Barnesiellaceae;Barnesiella;";"96.4";"14.4";"84";"84";"81";"3";"0";"457099";"391126"
"V4mis2";"SILVA (only NR);Bacteria;Bacteroidota;Bacteroidia;Bacteroidales;Barnesiellaceae;Coprobacter;";"100.0";"14.4";"26";"26";"26";"0";"0";"457157";"391181"
"V4mis2";"SILVA (only NR);Bacteria;Bacteroidota;Bacteroidia;Bacteroidales;Barnesiellaceae;uncultured;";"96.7";"14.4";"30";"30";"29";"1";"0";"457153";"391178"
"V4mis2";"SILVA (only NR);Bacteria;Bacteroidota;Bacteroidia;Bacteroidales;CAP-aah99b04;";"80.0";"14.4";"5";"5";"4";"1";"0";"457178";"391203"
"V4mis2";"SILVA (only NR);Bacteria;Bacteroidota;Bacteroidia;Bacteroidales;COB P4-1 termite group;";"100.0";"14.4";"11";"11";"11";"0";"0";"457172";"391196"
"V4mis2";"SILVA (only NR);Bacteria;Bacteroidota;Bacteroidia;Bacteroidales;CR-115;";"100.0";"14.4";"4";"4";"4";"0";"0";"457179";"391203"
"V4mis2";"SILVA (only NR);Bacteria;Bacteroidota;Bacteroidia;Bacteroidales;Dysgonomonadaceae;";"96.6";"14.5";"876";"876";"846";"30";"0";"456307";"390361"
"V4mis2";"SILVA (only NR);Bacteria;Bacteroidota;Bacteroidia;Bacteroidales;Dysgonomonadaceae;Candidatus Armantifilum;";"100.0";"14.4";"44";"44";"44";"0";"0";"457139";"391163"
"V4mis2";"SILVA (only NR);Bacteria;Bacteroidota;Bacteroidia;Bacteroidales;Dysgonomonadaceae;Candidatus Azobacteroides;";"100.0";"14.4";"23";"23";"23";"0";"0";"457160";"391184"
"V4mis2";"SILVA (only NR);Bacteria;Bacteroidota;Bacteroidia;Bacteroidales;Dysgonomonadaceae;Candidatus Symbiothrix;";"100.0";"14.4";"75";"75";"75";"0";"0";"457108";"391132"
"V4mis2";"SILVA (only NR);Bacteria;Bacteroidota;Bacteroidia;Bacteroidales;Dysgonomonadaceae;Dysgonomonas;";"95.0";"14.4";"159";"159";"151";"8";"0";"457024";"391056"
"V4mis2";"SILVA (only NR);Bacteria;Bacteroidota;Bacteroidia;Bacteroidales;Dysgonomonadaceae;Fermentimonas;";"96.3";"14.4";"136";"136";"131";"5";"0";"457047";"391076"
"V4mis2";"SILVA (only NR);Bacteria;Bacteroidota;Bacteroidia;Bacteroidales;Dysgonomonadaceae;Petrimonas;";"95.7";"14.4";"47";"47";"45";"2";"0";"457136";"391162"
"V4mis2";"SILVA (only NR);Bacteria;Bacteroidota;Bacteroidia;Bacteroidales;Dysgonomonadaceae;Proteiniphilum;";"96.0";"14.4";"275";"275";"264";"11";"0";"456908";"390943"
"V4mis2";"SILVA (only NR);Bacteria;Bacteroidota;Bacteroidia;Bacteroidales;Dysgonomonadaceae;uncultured;";"96.4";"14.4";"110";"110";"106";"4";"0";"457073";"391101"
"V4mis2";"SILVA (only NR);Bacteria;Bacteroidota;Bacteroidia;Bacteroidales;F082;";"95.4";"14.4";"366";"366";"349";"17";"0";"456817";"390858"
"V4mis2";"SILVA (only NR);Bacteria;Bacteroidota;Bacteroidia;Bacteroidales;FTLpost3;";"88.9";"14.4";"9";"9";"8";"1";"0";"457174";"391199"
"V4mis2";"SILVA (only NR);Bacteria;Bacteroidota;Bacteroidia;Bacteroidales;GZKB124;";"100.0";"14.4";"5";"5";"5";"0";"0";"457178";"391202"
"V4mis2";"SILVA (only NR);Bacteria;Bacteroidota;Bacteroidia;Bacteroidales;HAW-RM37-2;";"100.0";"14.4";"2";"2";"2";"0";"0";"457181";"391205"
"V4mis2";"SILVA (only NR);Bacteria;Bacteroidota;Bacteroidia;Bacteroidales;Ika33;";"100.0";"14.4";"7";"7";"7";"0";"0";"457176";"391200"
"V4mis2";"SILVA (only NR);Bacteria;Bacteroidota;Bacteroidia;Bacteroidales;LKC2.127-25;";"100.0";"14.4";"7";"7";"7";"0";"0";"457176";"391200"
"V4mis2";"SILVA (only NR);Bacteria;Bacteroidota;Bacteroidia;Bacteroidales;M2PB4-65 termite group;";"93.2";"14.4";"44";"44";"41";"3";"0";"457139";"391166"
"V4mis2";"SILVA (only NR);Bacteria;Bacteroidota;Bacteroidia;Bacteroidales;ML635J-40 aquatic group;";"91.7";"14.4";"120";"120";"110";"10";"0";"457063";"391097"
"V4mis2";"SILVA (only NR);Bacteria;Bacteroidota;Bacteroidia;Bacteroidales;Marinifilaceae;";"95.1";"14.4";"472";"472";"449";"23";"0";"456711";"390758"
"V4mis2";"SILVA (only NR);Bacteria;Bacteroidota;Bacteroidia;Bacteroidales;Marinifilaceae;Butyricimonas;";"98.2";"14.4";"56";"56";"55";"1";"0";"457127";"391152"
"V4mis2";"SILVA (only NR);Bacteria;Bacteroidota;Bacteroidia;Bacteroidales;Marinifilaceae;Marinifilum;";"93.3";"14.4";"224";"224";"209";"15";"0";"456959";"390998"
"V4mis2";"SILVA (only NR);Bacteria;Bacteroidota;Bacteroidia;Bacteroidales;Marinifilaceae;Odoribacter;";"95.1";"14.4";"102";"102";"97";"5";"0";"457081";"391110"
"V4mis2";"SILVA (only NR);Bacteria;Bacteroidota;Bacteroidia;Bacteroidales;Marinifilaceae;Sanguibacteroides;";"100.0";"14.4";"8";"8";"8";"0";"0";"457175";"391199"
"V4mis2";"SILVA (only NR);Bacteria;Bacteroidota;Bacteroidia;Bacteroidales;Marinifilaceae;uncultured;";"97.6";"14.4";"82";"82";"80";"2";"0";"457101";"391127"
"V4mis2";"SILVA (only NR);Bacteria;Bacteroidota;Bacteroidia;Bacteroidales;Marinilabiliaceae;";"94.1";"14.4";"611";"611";"575";"36";"0";"456572";"390632"
"V4mis2";"SILVA (only NR);Bacteria;Bacteroidota;Bacteroidia;Bacteroidales;Marinilabiliaceae;Alkaliflexus;";"88.2";"14.4";"17";"17";"15";"2";"0";"457166";"391192"
"V4mis2";"SILVA (only NR);Bacteria;Bacteroidota;Bacteroidia;Bacteroidales;Marinilabiliaceae;Alkalitalea;";"100.0";"14.4";"3";"3";"3";"0";"0";"457180";"391204"
"V4mis2";"SILVA (only NR);Bacteria;Bacteroidota;Bacteroidia;Bacteroidales;Marinilabiliaceae;Anaerophaga;";"95.8";"14.4";"24";"24";"23";"1";"0";"457159";"391184"
"V4mis2";"SILVA (only NR);Bacteria;Bacteroidota;Bacteroidia;Bacteroidales;Marinilabiliaceae;Carboxylicivirga;";"96.1";"14.4";"51";"51";"49";"2";"0";"457132";"391158"
"V4mis2";"SILVA (only NR);Bacteria;Bacteroidota;Bacteroidia;Bacteroidales;Marinilabiliaceae;Geofilum;";"100.0";"14.4";"1";"1";"1";"0";"0";"457182";"391206"
"V4mis2";"SILVA (only NR);Bacteria;Bacteroidota;Bacteroidia;Bacteroidales;Marinilabiliaceae;Labilibacter;";"100.0";"14.4";"14";"14";"14";"0";"0";"457169";"391193"
"V4mis2";"SILVA (only NR);Bacteria;Bacteroidota;Bacteroidia;Bacteroidales;Marinilabiliaceae;Mangroviflexus;";"81.8";"14.4";"11";"11";"9";"2";"0";"457172";"391198"
"V4mis2";"SILVA (only NR);Bacteria;Bacteroidota;Bacteroidia;Bacteroidales;Marinilabiliaceae;Marinilabilia;";"87.5";"14.4";"8";"8";"7";"1";"0";"457175";"391200"
"V4mis2";"SILVA (only NR);Bacteria;Bacteroidota;Bacteroidia;Bacteroidales;Marinilabiliaceae;Natronoflexus;";"100.0";"14.4";"1";"1";"1";"0";"0";"457182";"391206"
"V4mis2";"SILVA (only NR);Bacteria;Bacteroidota;Bacteroidia;Bacteroidales;Marinilabiliaceae;Ruminofilibacter;";"100.0";"14.4";"8";"8";"8";"0";"0";"457175";"391199"
"V4mis2";"SILVA (only NR);Bacteria;Bacteroidota;Bacteroidia;Bacteroidales;Marinilabiliaceae;Saccharicrinis;";"80.0";"14.4";"5";"5";"4";"1";"0";"457178";"391203"
"V4mis2";"SILVA (only NR);Bacteria;Bacteroidota;Bacteroidia;Bacteroidales;Marinilabiliaceae;Thermophagus;";"100.0";"14.4";"1";"1";"1";"0";"0";"457182";"391206"
"V4mis2";"SILVA (only NR);Bacteria;Bacteroidota;Bacteroidia;Bacteroidales;Marinilabiliaceae;[Cytophaga] xylanolytica group;";"100.0";"14.4";"14";"14";"14";"0";"0";"457169";"391193"
"V4mis2";"SILVA (only NR);Bacteria;Bacteroidota;Bacteroidia;Bacteroidales;Marinilabiliaceae;uncultured;";"94.2";"14.4";"449";"449";"423";"26";"0";"456734";"390784"
"V4mis2";"SILVA (only NR);Bacteria;Bacteroidota;Bacteroidia;Bacteroidales;MgMjR-022;";"100.0";"14.4";"7";"7";"7";"0";"0";"457176";"391200"
"V4mis2";"SILVA (only NR);Bacteria;Bacteroidota;Bacteroidia;Bacteroidales;Muribaculaceae;";"93.7";"14.5";"2753";"2753";"2579";"174";"0";"454430";"388628"
"V4mis2";"SILVA (only NR);Bacteria;Bacteroidota;Bacteroidia;Bacteroidales;Muribaculaceae;CAG-873;";"100.0";"14.4";"8";"8";"8";"0";"0";"457175";"391199"
"V4mis2";"SILVA (only NR);Bacteria;Bacteroidota;Bacteroidia;Bacteroidales;Muribaculaceae;Muribaculum;";"100.0";"14.4";"25";"25";"25";"0";"0";"457158";"391182"
"V4mis2";"SILVA (only NR);Bacteria;Bacteroidota;Bacteroidia;Bacteroidales;Paludibacteraceae;";"98.2";"14.4";"391";"391";"384";"7";"0";"456792";"390823"
"V4mis2";"SILVA (only NR);Bacteria;Bacteroidota;Bacteroidia;Bacteroidales;Paludibacteraceae;F0058;";"97.9";"14.4";"47";"47";"46";"1";"0";"457136";"391161"
"V4mis2";"SILVA (only NR);Bacteria;Bacteroidota;Bacteroidia;Bacteroidales;Paludibacteraceae;H1;";"100.0";"14.4";"13";"13";"13";"0";"0";"457170";"391194"
"V4mis2";"SILVA (only NR);Bacteria;Bacteroidota;Bacteroidia;Bacteroidales;Paludibacteraceae;Microbacter;";"90.0";"14.4";"10";"10";"9";"1";"0";"457173";"391198"
"V4mis2";"SILVA (only NR);Bacteria;Bacteroidota;Bacteroidia;Bacteroidales;Paludibacteraceae;Paludibacter;";"99.3";"14.4";"151";"151";"150";"1";"0";"457032";"391057"
"V4mis2";"SILVA (only NR);Bacteria;Bacteroidota;Bacteroidia;Bacteroidales;Paludibacteraceae;uncultured;";"97.6";"14.4";"170";"170";"166";"4";"0";"457013";"391041"
"V4mis2";"SILVA (only NR);Bacteria;Bacteroidota;Bacteroidia;Bacteroidales;PeH15;";"100.0";"14.4";"14";"14";"14";"0";"0";"457169";"391193"
"V4mis2";"SILVA (only NR);Bacteria;Bacteroidota;Bacteroidia;Bacteroidales;Porphyromonadaceae;";"94.6";"14.4";"647";"647";"612";"35";"0";"456536";"390595"
"V4mis2";"SILVA (only NR);Bacteria;Bacteroidota;Bacteroidia;Bacteroidales;Porphyromonadaceae;Falsiporphyromonas;";"100.0";"14.4";"1";"1";"1";"0";"0";"457182";"391206"
"V4mis2";"SILVA (only NR);Bacteria;Bacteroidota;Bacteroidia;Bacteroidales;Porphyromonadaceae;Porphyromonas;";"94.7";"14.4";"644";"644";"610";"34";"0";"456539";"390597"
"V4mis2";"SILVA (only NR);Bacteria;Bacteroidota;Bacteroidia;Bacteroidales;Prevotellaceae;";"95.4";"14.5";"5074";"5074";"4841";"233";"0";"452109";"386366"
"V4mis2";"SILVA (only NR);Bacteria;Bacteroidota;Bacteroidia;Bacteroidales;Prevotellaceae;Alloprevotella;";"93.6";"14.4";"435";"435";"407";"28";"0";"456748";"390800"
"V4mis2";"SILVA (only NR);Bacteria;Bacteroidota;Bacteroidia;Bacteroidales;Prevotellaceae;Paraprevotella;";"93.0";"14.4";"43";"43";"40";"3";"0";"457140";"391167"
"V4mis2";"SILVA (only NR);Bacteria;Bacteroidota;Bacteroidia;Bacteroidales;Prevotellaceae;Prevotella;";"96.1";"14.5";"2164";"2164";"2079";"85";"0";"455019";"389128"
"V4mis2";"SILVA (only NR);Bacteria;Bacteroidota;Bacteroidia;Bacteroidales;Prevotellaceae;Prevotella_7;";"94.4";"14.4";"535";"535";"505";"30";"0";"456648";"390702"
"V4mis2";"SILVA (only NR);Bacteria;Bacteroidota;Bacteroidia;Bacteroidales;Prevotellaceae;Prevotella_9;";"95.8";"14.5";"1041";"1041";"997";"44";"0";"456142";"390210"
"V4mis2";"SILVA (only NR);Bacteria;Bacteroidota;Bacteroidia;Bacteroidales;Prevotellaceae;Prevotellaceae Ga6A1 group;";"100.0";"14.4";"21";"21";"21";"0";"0";"457162";"391186"
"V4mis2";"SILVA (only NR);Bacteria;Bacteroidota;Bacteroidia;Bacteroidales;Prevotellaceae;Prevotellaceae NK3B31 group;";"96.5";"14.4";"115";"115";"111";"4";"0";"457068";"391096"
"V4mis2";"SILVA (only NR);Bacteria;Bacteroidota;Bacteroidia;Bacteroidales;Prevotellaceae;Prevotellaceae UCG-001;";"92.2";"14.4";"321";"321";"296";"25";"0";"456862";"390911"
"V4mis2";"SILVA (only NR);Bacteria;Bacteroidota;Bacteroidia;Bacteroidales;Prevotellaceae;Prevotellaceae UCG-003;";"98.1";"14.4";"158";"158";"155";"3";"0";"457025";"391052"
"V4mis2";"SILVA (only NR);Bacteria;Bacteroidota;Bacteroidia;Bacteroidales;Prevotellaceae;Prevotellaceae UCG-004;";"96.0";"14.4";"100";"100";"96";"4";"0";"457083";"391111"
"V4mis2";"SILVA (only NR);Bacteria;Bacteroidota;Bacteroidia;Bacteroidales;Prevotellaceae;Prevotellaceae YAB2003 group;";"77.8";"14.4";"9";"9";"7";"2";"0";"457174";"391200"
"V4mis2";"SILVA (only NR);Bacteria;Bacteroidota;Bacteroidia;Bacteroidales;Prevotellaceae;uncultured;";"96.1";"14.4";"129";"129";"124";"5";"0";"457054";"391083"
"V4mis2";"SILVA (only NR);Bacteria;Bacteroidota;Bacteroidia;Bacteroidales;Prolixibacteraceae;";"96.3";"14.4";"755";"755";"727";"28";"0";"456428";"390480"
"V4mis2";"SILVA (only NR);Bacteria;Bacteroidota;Bacteroidia;Bacteroidales;Prolixibacteraceae;BSV13;";"95.3";"14.4";"86";"86";"82";"4";"0";"457097";"391125"
"V4mis2";"SILVA (only NR);Bacteria;Bacteroidota;Bacteroidia;Bacteroidales;Prolixibacteraceae;Draconibacterium;";"92.6";"14.4";"54";"54";"50";"4";"0";"457129";"391157"
"V4mis2";"SILVA (only NR);Bacteria;Bacteroidota;Bacteroidia;Bacteroidales;Prolixibacteraceae;Mangrovibacterium;";"100.0";"14.4";"4";"4";"4";"0";"0";"457179";"391203"
"V4mis2";"SILVA (only NR);Bacteria;Bacteroidota;Bacteroidia;Bacteroidales;Prolixibacteraceae;Mariniphaga;";"100.0";"14.4";"7";"7";"7";"0";"0";"457176";"391200"
"V4mis2";"SILVA (only NR);Bacteria;Bacteroidota;Bacteroidia;Bacteroidales;Prolixibacteraceae;Meniscus;";"88.2";"14.4";"17";"17";"15";"2";"0";"457166";"391192"
"V4mis2";"SILVA (only NR);Bacteria;Bacteroidota;Bacteroidia;Bacteroidales;Prolixibacteraceae;Prolixibacter;";"92.9";"14.4";"14";"14";"13";"1";"0";"457169";"391194"
"V4mis2";"SILVA (only NR);Bacteria;Bacteroidota;Bacteroidia;Bacteroidales;Prolixibacteraceae;Roseimarinus;";"95.1";"14.4";"81";"81";"77";"4";"0";"457102";"391130"
"V4mis2";"SILVA (only NR);Bacteria;Bacteroidota;Bacteroidia;Bacteroidales;Prolixibacteraceae;Sunxiuqinia;";"93.3";"14.4";"15";"15";"14";"1";"0";"457168";"391193"
"V4mis2";"SILVA (only NR);Bacteria;Bacteroidota;Bacteroidia;Bacteroidales;Prolixibacteraceae;Tangfeifania;";"85.2";"14.4";"27";"27";"23";"4";"0";"457156";"391184"
"V4mis2";"SILVA (only NR);Bacteria;Bacteroidota;Bacteroidia;Bacteroidales;Prolixibacteraceae;WCHB1-32;";"99.4";"14.4";"176";"176";"175";"1";"0";"457007";"391032"
"V4mis2";"SILVA (only NR);Bacteria;Bacteroidota;Bacteroidia;Bacteroidales;Prolixibacteraceae;uncultured;";"97.3";"14.4";"264";"264";"257";"7";"0";"456919";"390950"
"V4mis2";"SILVA (only NR);Bacteria;Bacteroidota;Bacteroidia;Bacteroidales;RH-aaj90h05;";"100.0";"14.4";"3";"3";"3";"0";"0";"457180";"391204"
"V4mis2";"SILVA (only NR);Bacteria;Bacteroidota;Bacteroidia;Bacteroidales;Rikenellaceae;";"96.1";"14.5";"2859";"2859";"2747";"112";"0";"454324";"388460"
"V4mis2";"SILVA (only NR);Bacteria;Bacteroidota;Bacteroidia;Bacteroidales;Rikenellaceae;Alistipes;";"95.5";"14.4";"554";"554";"529";"25";"0";"456629";"390678"
"V4mis2";"SILVA (only NR);Bacteria;Bacteroidota;Bacteroidia;Bacteroidales;Rikenellaceae;Anaerocella;";"89.5";"14.4";"19";"19";"17";"2";"0";"457164";"391190"
"V4mis2";"SILVA (only NR);Bacteria;Bacteroidota;Bacteroidia;Bacteroidales;Rikenellaceae;Bact-08;";"83.3";"14.4";"6";"6";"5";"1";"0";"457177";"391202"
"V4mis2";"SILVA (only NR);Bacteria;Bacteroidota;Bacteroidia;Bacteroidales;Rikenellaceae;DMER64;";"97.4";"14.4";"152";"152";"148";"4";"0";"457031";"391059"
"V4mis2";"SILVA (only NR);Bacteria;Bacteroidota;Bacteroidia;Bacteroidales;Rikenellaceae;M2PB4-61 termite group;";"86.4";"14.4";"22";"22";"19";"3";"0";"457161";"391188"
"V4mis2";"SILVA (only NR);Bacteria;Bacteroidota;Bacteroidia;Bacteroidales;Rikenellaceae;Mucinivorans;";"75.0";"14.4";"4";"4";"3";"1";"0";"457179";"391204"
"V4mis2";"SILVA (only NR);Bacteria;Bacteroidota;Bacteroidia;Bacteroidales;Rikenellaceae;Rikenella;";"100.0";"14.4";"39";"39";"39";"0";"0";"457144";"391168"
"V4mis2";"SILVA (only NR);Bacteria;Bacteroidota;Bacteroidia;Bacteroidales;Rikenellaceae;Rikenellaceae RC9 gut group;";"96.5";"14.5";"1613";"1613";"1557";"56";"0";"455570";"389650"
"V4mis2";"SILVA (only NR);Bacteria;Bacteroidota;Bacteroidia;Bacteroidales;Rikenellaceae;S50 wastewater-sludge group;";"100.0";"14.4";"5";"5";"5";"0";"0";"457178";"391202"
"V4mis2";"SILVA (only NR);Bacteria;Bacteroidota;Bacteroidia;Bacteroidales;Rikenellaceae;SP3-e08;";"100.0";"14.4";"19";"19";"19";"0";"0";"457164";"391188"
"V4mis2";"SILVA (only NR);Bacteria;Bacteroidota;Bacteroidia;Bacteroidales;Rikenellaceae;U29-B03;";"94.7";"14.4";"19";"19";"18";"1";"0";"457164";"391189"
"V4mis2";"SILVA (only NR);Bacteria;Bacteroidota;Bacteroidia;Bacteroidales;Rikenellaceae;dgA-11 gut group;";"91.1";"14.4";"45";"45";"41";"4";"0";"457138";"391166"
"V4mis2";"SILVA (only NR);Bacteria;Bacteroidota;Bacteroidia;Bacteroidales;Rikenellaceae;hoa5-07d05 gut group;";"100.0";"14.4";"12";"12";"12";"0";"0";"457171";"391195"
"V4mis2";"SILVA (only NR);Bacteria;Bacteroidota;Bacteroidia;Bacteroidales;Rikenellaceae;uncultured;";"95.6";"14.4";"343";"343";"328";"15";"0";"456840";"390879"
"V4mis2";"SILVA (only NR);Bacteria;Bacteroidota;Bacteroidia;Bacteroidales;Rs-E47 termite group;";"99.0";"14.4";"99";"99";"98";"1";"0";"457084";"391109"
"V4mis2";"SILVA (only NR);Bacteria;Bacteroidota;Bacteroidia;Bacteroidales;Rs-E47 termite group;GWE2-42-42;";"98.8";"14.4";"81";"81";"80";"1";"0";"457102";"391127"
"V4mis2";"SILVA (only NR);Bacteria;Bacteroidota;Bacteroidia;Bacteroidales;SB-5;";"94.0";"14.4";"383";"383";"360";"23";"0";"456800";"390847"
"V4mis2";"SILVA (only NR);Bacteria;Bacteroidota;Bacteroidia;Bacteroidales;Salinivirgaceae;";"90.5";"14.4";"179";"179";"162";"17";"0";"457004";"391045"
"V4mis2";"SILVA (only NR);Bacteria;Bacteroidota;Bacteroidia;Bacteroidales;Salinivirgaceae;Salinivirga;";"86.5";"14.4";"52";"52";"45";"7";"0";"457131";"391162"
"V4mis2";"SILVA (only NR);Bacteria;Bacteroidota;Bacteroidia;Bacteroidales;Salinivirgaceae;uncultured;";"92.1";"14.4";"127";"127";"117";"10";"0";"457056";"391090"
"V4mis2";"SILVA (only NR);Bacteria;Bacteroidota;Bacteroidia;Bacteroidales;Tannerellaceae;";"95.4";"14.4";"659";"659";"629";"30";"0";"456524";"390578"
"V4mis2";"SILVA (only NR);Bacteria;Bacteroidota;Bacteroidia;Bacteroidales;Tannerellaceae;Candidatus Vestibaculum;";"100.0";"14.4";"34";"34";"34";"0";"0";"457149";"391173"
"V4mis2";"SILVA (only NR);Bacteria;Bacteroidota;Bacteroidia;Bacteroidales;Tannerellaceae;Macellibacteroides;";"88.7";"14.4";"62";"62";"55";"7";"0";"457121";"391152"
"V4mis2";"SILVA (only NR);Bacteria;Bacteroidota;Bacteroidia;Bacteroidales;Tannerellaceae;Parabacteroides;";"95.9";"14.4";"460";"460";"441";"19";"0";"456723";"390766"
"V4mis2";"SILVA (only NR);Bacteria;Bacteroidota;Bacteroidia;Bacteroidales;Tannerellaceae;Tannerella;";"94.9";"14.4";"78";"78";"74";"4";"0";"457105";"391133"
"V4mis2";"SILVA (only NR);Bacteria;Bacteroidota;Bacteroidia;Bacteroidales;Tannerellaceae;uncultured;";"100.0";"14.4";"21";"21";"21";"0";"0";"457162";"391186"
"V4mis2";"SILVA (only NR);Bacteria;Bacteroidota;Bacteroidia;Bacteroidales;Williamwhitmaniaceae;";"94.7";"14.4";"152";"152";"144";"8";"0";"457031";"391063"
"V4mis2";"SILVA (only NR);Bacteria;Bacteroidota;Bacteroidia;Bacteroidales;Williamwhitmaniaceae;Acetobacteroides;";"100.0";"14.4";"14";"14";"14";"0";"0";"457169";"391193"
"V4mis2";"SILVA (only NR);Bacteria;Bacteroidota;Bacteroidia;Bacteroidales;Williamwhitmaniaceae;BCf9-17 termite group;";"100.0";"14.4";"26";"26";"26";"0";"0";"457157";"391181"
"V4mis2";"SILVA (only NR);Bacteria;Bacteroidota;Bacteroidia;Bacteroidales;Williamwhitmaniaceae;Blvii28 wastewater-sludge group;";"89.3";"14.4";"75";"75";"67";"8";"0";"457108";"391140"
"V4mis2";"SILVA (only NR);Bacteria;Bacteroidota;Bacteroidia;Bacteroidales;Williamwhitmaniaceae;Rs-D38 termite group;";"100.0";"14.4";"22";"22";"22";"0";"0";"457161";"391185"
"V4mis2";"SILVA (only NR);Bacteria;Bacteroidota;Bacteroidia;Bacteroidales;Williamwhitmaniaceae;Williamwhitmania;";"100.0";"14.4";"6";"6";"6";"0";"0";"457177";"391201"
"V4mis2";"SILVA (only NR);Bacteria;Bacteroidota;Bacteroidia;Bacteroidales;Williamwhitmaniaceae;uncultured;";"100.0";"14.4";"8";"8";"8";"0";"0";"457175";"391199"
"V4mis2";"SILVA (only NR);Bacteria;Bacteroidota;Bacteroidia;Bacteroidales;gir-aah93h0;";"100.0";"14.4";"6";"6";"6";"0";"0";"457177";"391201"
"V4mis2";"SILVA (only NR);Bacteria;Bacteroidota;Bacteroidia;Bacteroidales;p-251-o5;";"97.1";"14.4";"139";"139";"135";"4";"0";"457044";"391072"
"V4mis2";"SILVA (only NR);Bacteria;Bacteroidota;Bacteroidia;Bacteroidales;p-2534-18B5 gut group;";"100.0";"14.4";"32";"32";"32";"0";"0";"457151";"391175"
"V4mis2";"SILVA (only NR);Bacteria;Bacteroidota;Bacteroidia;Bacteroidales;uncultured;";"97.1";"14.4";"69";"69";"67";"2";"0";"457114";"391140"
"V4mis2";"SILVA (only NR);Bacteria;Bacteroidota;Bacteroidia;Bacteroidales;vadinHA21;";"75.0";"14.4";"8";"8";"6";"2";"0";"457175";"391201"
"V4mis2";"SILVA (only NR);Bacteria;Bacteroidota;Bacteroidia;Bacteroidetes VC2.1 Bac22;";"98.6";"14.4";"214";"214";"211";"3";"0";"456969";"390996"
"V4mis2";"SILVA (only NR);Bacteria;Bacteroidota;Bacteroidia;Chitinophagales;";"96.0";"14.5";"4399";"4399";"4222";"177";"0";"452784";"386985"
"V4mis2";"SILVA (only NR);Bacteria;Bacteroidota;Bacteroidia;Chitinophagales;37-13;";"98.5";"14.4";"66";"66";"65";"1";"0";"457117";"391142"
"V4mis2";"SILVA (only NR);Bacteria;Bacteroidota;Bacteroidia;Chitinophagales;Chitinophagaceae;";"96.4";"14.5";"2544";"2544";"2453";"91";"0";"454639";"388754"
"V4mis2";"SILVA (only NR);Bacteria;Bacteroidota;Bacteroidia;Chitinophagales;Chitinophagaceae;Arachidicoccus;";"88.9";"14.4";"18";"18";"16";"2";"0";"457165";"391191"
"V4mis2";"SILVA (only NR);Bacteria;Bacteroidota;Bacteroidia;Chitinophagales;Chitinophagaceae;Asinibacterium;";"100.0";"14.4";"8";"8";"8";"0";"0";"457175";"391199"
"V4mis2";"SILVA (only NR);Bacteria;Bacteroidota;Bacteroidia;Chitinophagales;Chitinophagaceae;Aurantisolimonas;";"98.4";"14.4";"61";"61";"60";"1";"0";"457122";"391147"
"V4mis2";"SILVA (only NR);Bacteria;Bacteroidota;Bacteroidia;Chitinophagales;Chitinophagaceae;Chitinophaga;";"96.6";"14.4";"175";"175";"169";"6";"0";"457008";"391038"
"V4mis2";"SILVA (only NR);Bacteria;Bacteroidota;Bacteroidia;Chitinophagales;Chitinophagaceae;Cnuella;";"96.9";"14.4";"32";"32";"31";"1";"0";"457151";"391176"
"V4mis2";"SILVA (only NR);Bacteria;Bacteroidota;Bacteroidia;Chitinophagales;Chitinophagaceae;Crenotalea;";"100.0";"14.4";"1";"1";"1";"0";"0";"457182";"391206"
"V4mis2";"SILVA (only NR);Bacteria;Bacteroidota;Bacteroidia;Chitinophagales;Chitinophagaceae;Dinghuibacter;";"100.0";"14.4";"57";"57";"57";"0";"0";"457126";"391150"
"V4mis2";"SILVA (only NR);Bacteria;Bacteroidota;Bacteroidia;Chitinophagales;Chitinophagaceae;Edaphobaculum;";"98.9";"14.4";"189";"189";"187";"2";"0";"456994";"391020"
"V4mis2";"SILVA (only NR);Bacteria;Bacteroidota;Bacteroidia;Chitinophagales;Chitinophagaceae;Ferruginibacter;";"95.8";"14.4";"308";"308";"295";"13";"0";"456875";"390912"
"V4mis2";"SILVA (only NR);Bacteria;Bacteroidota;Bacteroidia;Chitinophagales;Chitinophagaceae;Filimonas;";"100.0";"14.4";"22";"22";"22";"0";"0";"457161";"391185"
"V4mis2";"SILVA (only NR);Bacteria;Bacteroidota;Bacteroidia;Chitinophagales;Chitinophagaceae;Filobacterium;";"100.0";"14.4";"4";"4";"4";"0";"0";"457179";"391203"
"V4mis2";"SILVA (only NR);Bacteria;Bacteroidota;Bacteroidia;Chitinophagales;Chitinophagaceae;Flaviaesturariibacter;";"94.7";"14.4";"19";"19";"18";"1";"0";"457164";"391189"
"V4mis2";"SILVA (only NR);Bacteria;Bacteroidota;Bacteroidia;Chitinophagales;Chitinophagaceae;Flavihumibacter;";"95.8";"14.4";"24";"24";"23";"1";"0";"457159";"391184"
"V4mis2";"SILVA (only NR);Bacteria;Bacteroidota;Bacteroidia;Chitinophagales;Chitinophagaceae;Flavisolibacter;";"99.0";"14.4";"196";"196";"194";"2";"0";"456987";"391013"
"V4mis2";"SILVA (only NR);Bacteria;Bacteroidota;Bacteroidia;Chitinophagales;Chitinophagaceae;Flavitalea;";"91.3";"14.4";"46";"46";"42";"4";"0";"457137";"391165"
"V4mis2";"SILVA (only NR);Bacteria;Bacteroidota;Bacteroidia;Chitinophagales;Chitinophagaceae;Haoranjiania;";"100.0";"14.4";"6";"6";"6";"0";"0";"457177";"391201"
"V4mis2";"SILVA (only NR);Bacteria;Bacteroidota;Bacteroidia;Chitinophagales;Chitinophagaceae;Heliimonas;";"85.7";"14.4";"7";"7";"6";"1";"0";"457176";"391201"
"V4mis2";"SILVA (only NR);Bacteria;Bacteroidota;Bacteroidia;Chitinophagales;Chitinophagaceae;Hydrobacter;";"100.0";"14.4";"2";"2";"2";"0";"0";"457181";"391205"
"V4mis2";"SILVA (only NR);Bacteria;Bacteroidota;Bacteroidia;Chitinophagales;Chitinophagaceae;Hydrotalea;";"87.5";"14.4";"8";"8";"7";"1";"0";"457175";"391200"
"V4mis2";"SILVA (only NR);Bacteria;Bacteroidota;Bacteroidia;Chitinophagales;Chitinophagaceae;Lacibacter;";"100.0";"14.4";"16";"16";"16";"0";"0";"457167";"391191"
"V4mis2";"SILVA (only NR);Bacteria;Bacteroidota;Bacteroidia;Chitinophagales;Chitinophagaceae;Niabella;";"93.3";"14.4";"60";"60";"56";"4";"0";"457123";"391151"
"V4mis2";"SILVA (only NR);Bacteria;Bacteroidota;Bacteroidia;Chitinophagales;Chitinophagaceae;Niastella;";"96.5";"14.4";"57";"57";"55";"2";"0";"457126";"391152"
"V4mis2";"SILVA (only NR);Bacteria;Bacteroidota;Bacteroidia;Chitinophagales;Chitinophagaceae;Niveitalea;";"100.0";"14.4";"1";"1";"1";"0";"0";"457182";"391206"
"V4mis2";"SILVA (only NR);Bacteria;Bacteroidota;Bacteroidia;Chitinophagales;Chitinophagaceae;Parafilimonas;";"95.0";"14.4";"20";"20";"19";"1";"0";"457163";"391188"
"V4mis2";"SILVA (only NR);Bacteria;Bacteroidota;Bacteroidia;Chitinophagales;Chitinophagaceae;Parasediminibacterium;";"100.0";"14.4";"11";"11";"11";"0";"0";"457172";"391196"
"V4mis2";"SILVA (only NR);Bacteria;Bacteroidota;Bacteroidia;Chitinophagales;Chitinophagaceae;Parasegetibacter;";"94.1";"14.4";"17";"17";"16";"1";"0";"457166";"391191"
"V4mis2";"SILVA (only NR);Bacteria;Bacteroidota;Bacteroidia;Chitinophagales;Chitinophagaceae;Pseudoflavitalea;";"100.0";"14.4";"24";"24";"24";"0";"0";"457159";"391183"
"V4mis2";"SILVA (only NR);Bacteria;Bacteroidota;Bacteroidia;Chitinophagales;Chitinophagaceae;Puia;";"91.1";"14.4";"79";"79";"72";"7";"0";"457104";"391135"
"V4mis2";"SILVA (only NR);Bacteria;Bacteroidota;Bacteroidia;Chitinophagales;Chitinophagaceae;Rurimicrobium;";"100.0";"14.4";"6";"6";"6";"0";"0";"457177";"391201"
"V4mis2";"SILVA (only NR);Bacteria;Bacteroidota;Bacteroidia;Chitinophagales;Chitinophagaceae;Sediminibacterium;";"95.8";"14.4";"95";"95";"91";"4";"0";"457088";"391116"
"V4mis2";"SILVA (only NR);Bacteria;Bacteroidota;Bacteroidia;Chitinophagales;Chitinophagaceae;Segetibacter;";"96.9";"14.4";"128";"128";"124";"4";"0";"457055";"391083"
"V4mis2";"SILVA (only NR);Bacteria;Bacteroidota;Bacteroidia;Chitinophagales;Chitinophagaceae;Taibaiella;";"93.9";"14.4";"99";"99";"93";"6";"0";"457084";"391114"
"V4mis2";"SILVA (only NR);Bacteria;Bacteroidota;Bacteroidia;Chitinophagales;Chitinophagaceae;Terrimonas;";"96.2";"14.4";"211";"211";"203";"8";"0";"456972";"391004"
"V4mis2";"SILVA (only NR);Bacteria;Bacteroidota;Bacteroidia;Chitinophagales;Chitinophagaceae;Thermoflavifilum;";"75.0";"14.4";"4";"4";"3";"1";"0";"457179";"391204"
"V4mis2";"SILVA (only NR);Bacteria;Bacteroidota;Bacteroidia;Chitinophagales;Chitinophagaceae;UTBCD1;";"100.0";"14.4";"13";"13";"13";"0";"0";"457170";"391194"
"V4mis2";"SILVA (only NR);Bacteria;Bacteroidota;Bacteroidia;Chitinophagales;Chitinophagaceae;Vibrionimonas;";"100.0";"14.4";"5";"5";"5";"0";"0";"457178";"391202"
"V4mis2";"SILVA (only NR);Bacteria;Bacteroidota;Bacteroidia;Chitinophagales;Chitinophagaceae;uncultured;";"96.4";"14.4";"505";"505";"487";"18";"0";"456678";"390720"
"V4mis2";"SILVA (only NR);Bacteria;Bacteroidota;Bacteroidia;Chitinophagales;Saprospiraceae;";"94.7";"14.5";"1415";"1415";"1340";"75";"0";"455768";"389867"
"V4mis2";"SILVA (only NR);Bacteria;Bacteroidota;Bacteroidia;Chitinophagales;Saprospiraceae;Aureispira;";"96.3";"14.4";"27";"27";"26";"1";"0";"457156";"391181"
"V4mis2";"SILVA (only NR);Bacteria;Bacteroidota;Bacteroidia;Chitinophagales;Saprospiraceae;Candidatus Aquirestis;";"92.6";"14.4";"27";"27";"25";"2";"0";"457156";"391182"
"V4mis2";"SILVA (only NR);Bacteria;Bacteroidota;Bacteroidia;Chitinophagales;Saprospiraceae;Haliscomenobacter;";"85.3";"14.4";"34";"34";"29";"5";"0";"457149";"391178"
"V4mis2";"SILVA (only NR);Bacteria;Bacteroidota;Bacteroidia;Chitinophagales;Saprospiraceae;Lewinella;";"98.5";"14.4";"136";"136";"134";"2";"0";"457047";"391073"
"V4mis2";"SILVA (only NR);Bacteria;Bacteroidota;Bacteroidia;Chitinophagales;Saprospiraceae;Membranicola;";"90.5";"14.4";"21";"21";"19";"2";"0";"457162";"391188"
"V4mis2";"SILVA (only NR);Bacteria;Bacteroidota;Bacteroidia;Chitinophagales;Saprospiraceae;OLB8;";"100.0";"14.4";"18";"18";"18";"0";"0";"457165";"391189"
"V4mis2";"SILVA (only NR);Bacteria;Bacteroidota;Bacteroidia;Chitinophagales;Saprospiraceae;Phaeodactylibacter;";"92.2";"14.4";"179";"179";"165";"14";"0";"457004";"391042"
"V4mis2";"SILVA (only NR);Bacteria;Bacteroidota;Bacteroidia;Chitinophagales;Saprospiraceae;Portibacter;";"94.1";"14.4";"34";"34";"32";"2";"0";"457149";"391175"
"V4mis2";"SILVA (only NR);Bacteria;Bacteroidota;Bacteroidia;Chitinophagales;Saprospiraceae;Rubidimonas;";"100.0";"14.4";"18";"18";"18";"0";"0";"457165";"391189"
"V4mis2";"SILVA (only NR);Bacteria;Bacteroidota;Bacteroidia;Chitinophagales;Saprospiraceae;Saprospira;";"100.0";"14.4";"12";"12";"12";"0";"0";"457171";"391195"
"V4mis2";"SILVA (only NR);Bacteria;Bacteroidota;Bacteroidia;Chitinophagales;Saprospiraceae;uncultured;";"94.8";"14.4";"909";"909";"862";"47";"0";"456274";"390345"
"V4mis2";"SILVA (only NR);Bacteria;Bacteroidota;Bacteroidia;Chitinophagales;uncultured;";"97.3";"14.4";"374";"374";"364";"10";"0";"456809";"390843"
"V4mis2";"SILVA (only NR);Bacteria;Bacteroidota;Bacteroidia;Cytophagales;";"96.9";"14.5";"3573";"3573";"3461";"112";"0";"453610";"387746"
"V4mis2";"SILVA (only NR);Bacteria;Bacteroidota;Bacteroidia;Cytophagales;Amoebophilaceae;";"93.3";"14.4";"135";"135";"126";"9";"0";"457048";"391081"
"V4mis2";"SILVA (only NR);Bacteria;Bacteroidota;Bacteroidia;Cytophagales;Amoebophilaceae;Candidatus Amoebophilus;";"86.7";"14.4";"60";"60";"52";"8";"0";"457123";"391155"
"V4mis2";"SILVA (only NR);Bacteria;Bacteroidota;Bacteroidia;Cytophagales;Amoebophilaceae;Candidatus Cardinium;";"100.0";"14.4";"23";"23";"23";"0";"0";"457160";"391184"
"V4mis2";"SILVA (only NR);Bacteria;Bacteroidota;Bacteroidia;Cytophagales;Amoebophilaceae;Candidatus Paenicardinium;";"100.0";"14.4";"6";"6";"6";"0";"0";"457177";"391201"
"V4mis2";"SILVA (only NR);Bacteria;Bacteroidota;Bacteroidia;Cytophagales;Amoebophilaceae;uncultured;";"97.7";"14.4";"43";"43";"42";"1";"0";"457140";"391165"
"V4mis2";"SILVA (only NR);Bacteria;Bacteroidota;Bacteroidia;Cytophagales;Bernardetiaceae;";"84.6";"14.4";"13";"13";"11";"2";"0";"457170";"391196"
"V4mis2";"SILVA (only NR);Bacteria;Bacteroidota;Bacteroidia;Cytophagales;Bernardetiaceae;Bernardetia;";"100.0";"14.4";"3";"3";"3";"0";"0";"457180";"391204"
"V4mis2";"SILVA (only NR);Bacteria;Bacteroidota;Bacteroidia;Cytophagales;Bernardetiaceae;Garritya;";"50.0";"14.4";"2";"2";"1";"1";"0";"457181";"391206"
"V4mis2";"SILVA (only NR);Bacteria;Bacteroidota;Bacteroidia;Cytophagales;Bernardetiaceae;Hugenholtzia;";"80.0";"14.4";"5";"5";"4";"1";"0";"457178";"391203"
"V4mis2";"SILVA (only NR);Bacteria;Bacteroidota;Bacteroidia;Cytophagales;Bernardetiaceae;uncultured;";"100.0";"14.4";"3";"3";"3";"0";"0";"457180";"391204"
"V4mis2";"SILVA (only NR);Bacteria;Bacteroidota;Bacteroidia;Cytophagales;Cyclobacteriaceae;";"96.5";"14.5";"953";"953";"920";"33";"0";"456230";"390287"
"V4mis2";"SILVA (only NR);Bacteria;Bacteroidota;Bacteroidia;Cytophagales;Cyclobacteriaceae;Algoriphagus;";"98.8";"14.4";"165";"165";"163";"2";"0";"457018";"391044"
"V4mis2";"SILVA (only NR);Bacteria;Bacteroidota;Bacteroidia;Cytophagales;Cyclobacteriaceae;Anditalea;";"100.0";"14.4";"2";"2";"2";"0";"0";"457181";"391205"
"V4mis2";"SILVA (only NR);Bacteria;Bacteroidota;Bacteroidia;Cytophagales;Cyclobacteriaceae;Aquiflexum;";"100.0";"14.4";"14";"14";"14";"0";"0";"457169";"391193"
"V4mis2";"SILVA (only NR);Bacteria;Bacteroidota;Bacteroidia;Cytophagales;Cyclobacteriaceae;Aureibacter;";"100.0";"14.4";"1";"1";"1";"0";"0";"457182";"391206"
"V4mis2";"SILVA (only NR);Bacteria;Bacteroidota;Bacteroidia;Cytophagales;Cyclobacteriaceae;Belliella;";"100.0";"14.4";"12";"12";"12";"0";"0";"457171";"391195"
"V4mis2";"SILVA (only NR);Bacteria;Bacteroidota;Bacteroidia;Cytophagales;Cyclobacteriaceae;Catalinimonas;";"100.0";"14.4";"12";"12";"12";"0";"0";"457171";"391195"
"V4mis2";"SILVA (only NR);Bacteria;Bacteroidota;Bacteroidia;Cytophagales;Cyclobacteriaceae;Cecembia;";"100.0";"14.4";"6";"6";"6";"0";"0";"457177";"391201"
"V4mis2";"SILVA (only NR);Bacteria;Bacteroidota;Bacteroidia;Cytophagales;Cyclobacteriaceae;Cesiribacter;";"100.0";"14.4";"11";"11";"11";"0";"0";"457172";"391196"
"V4mis2";"SILVA (only NR);Bacteria;Bacteroidota;Bacteroidia;Cytophagales;Cyclobacteriaceae;Cyclobacterium;";"97.1";"14.4";"34";"34";"33";"1";"0";"457149";"391174"
"V4mis2";"SILVA (only NR);Bacteria;Bacteroidota;Bacteroidia;Cytophagales;Cyclobacteriaceae;Echinicola;";"100.0";"14.4";"15";"15";"15";"0";"0";"457168";"391192"
"V4mis2";"SILVA (only NR);Bacteria;Bacteroidota;Bacteroidia;Cytophagales;Cyclobacteriaceae;Ekhidna;";"97.1";"14.4";"34";"34";"33";"1";"0";"457149";"391174"
"V4mis2";"SILVA (only NR);Bacteria;Bacteroidota;Bacteroidia;Cytophagales;Cyclobacteriaceae;Fabibacter;";"95.8";"14.4";"24";"24";"23";"1";"0";"457159";"391184"
"V4mis2";"SILVA (only NR);Bacteria;Bacteroidota;Bacteroidia;Cytophagales;Cyclobacteriaceae;Fontibacter;";"100.0";"14.4";"3";"3";"3";"0";"0";"457180";"391204"
"V4mis2";"SILVA (only NR);Bacteria;Bacteroidota;Bacteroidia;Cytophagales;Cyclobacteriaceae;Fulvitalea;";"100.0";"14.4";"1";"1";"1";"0";"0";"457182";"391206"
"V4mis2";"SILVA (only NR);Bacteria;Bacteroidota;Bacteroidia;Cytophagales;Cyclobacteriaceae;Fulvivirga;";"95.2";"14.4";"42";"42";"40";"2";"0";"457141";"391167"
"V4mis2";"SILVA (only NR);Bacteria;Bacteroidota;Bacteroidia;Cytophagales;Cyclobacteriaceae;Imperialibacter;";"95.0";"14.4";"20";"20";"19";"1";"0";"457163";"391188"
"V4mis2";"SILVA (only NR);Bacteria;Bacteroidota;Bacteroidia;Cytophagales;Cyclobacteriaceae;Indibacter;";"100.0";"14.4";"4";"4";"4";"0";"0";"457179";"391203"
"V4mis2";"SILVA (only NR);Bacteria;Bacteroidota;Bacteroidia;Cytophagales;Cyclobacteriaceae;Litoribacter;";"100.0";"14.4";"2";"2";"2";"0";"0";"457181";"391205"
"V4mis2";"SILVA (only NR);Bacteria;Bacteroidota;Bacteroidia;Cytophagales;Cyclobacteriaceae;Lunatimonas;";"100.0";"14.4";"4";"4";"4";"0";"0";"457179";"391203"
"V4mis2";"SILVA (only NR);Bacteria;Bacteroidota;Bacteroidia;Cytophagales;Cyclobacteriaceae;Mariniradius;";"100.0";"14.4";"4";"4";"4";"0";"0";"457179";"391203"
"V4mis2";"SILVA (only NR);Bacteria;Bacteroidota;Bacteroidia;Cytophagales;Cyclobacteriaceae;Marinoscillum;";"93.3";"14.4";"75";"75";"70";"5";"0";"457108";"391137"
"V4mis2";"SILVA (only NR);Bacteria;Bacteroidota;Bacteroidia;Cytophagales;Cyclobacteriaceae;Marivirga;";"88.5";"14.4";"26";"26";"23";"3";"0";"457157";"391184"
"V4mis2";"SILVA (only NR);Bacteria;Bacteroidota;Bacteroidia;Cytophagales;Cyclobacteriaceae;Mongoliibacter;";"100.0";"14.4";"1";"1";"1";"0";"0";"457182";"391206"
"V4mis2";"SILVA (only NR);Bacteria;Bacteroidota;Bacteroidia;Cytophagales;Cyclobacteriaceae;Mongoliicoccus;";"100.0";"14.4";"4";"4";"4";"0";"0";"457179";"391203"
"V4mis2";"SILVA (only NR);Bacteria;Bacteroidota;Bacteroidia;Cytophagales;Cyclobacteriaceae;Mongoliitalea;";"100.0";"14.4";"5";"5";"5";"0";"0";"457178";"391202"
"V4mis2";"SILVA (only NR);Bacteria;Bacteroidota;Bacteroidia;Cytophagales;Cyclobacteriaceae;Nafulsella;";"100.0";"14.4";"3";"3";"3";"0";"0";"457180";"391204"
"V4mis2";"SILVA (only NR);Bacteria;Bacteroidota;Bacteroidia;Cytophagales;Cyclobacteriaceae;Negadavirga;";"100.0";"14.4";"2";"2";"2";"0";"0";"457181";"391205"
"V4mis2";"SILVA (only NR);Bacteria;Bacteroidota;Bacteroidia;Cytophagales;Cyclobacteriaceae;Nitritalea;";"100.0";"14.4";"2";"2";"2";"0";"0";"457181";"391205"
"V4mis2";"SILVA (only NR);Bacteria;Bacteroidota;Bacteroidia;Cytophagales;Cyclobacteriaceae;Persicobacter;";"85.7";"14.4";"7";"7";"6";"1";"0";"457176";"391201"
"V4mis2";"SILVA (only NR);Bacteria;Bacteroidota;Bacteroidia;Cytophagales;Cyclobacteriaceae;Reichenbachiella;";"100.0";"14.4";"26";"26";"26";"0";"0";"457157";"391181"
"V4mis2";"SILVA (only NR);Bacteria;Bacteroidota;Bacteroidia;Cytophagales;Cyclobacteriaceae;Rhodonellum;";"100.0";"14.4";"2";"2";"2";"0";"0";"457181";"391205"
"V4mis2";"SILVA (only NR);Bacteria;Bacteroidota;Bacteroidia;Cytophagales;Cyclobacteriaceae;Roseivirga;";"100.0";"14.4";"14";"14";"14";"0";"0";"457169";"391193"
"V4mis2";"SILVA (only NR);Bacteria;Bacteroidota;Bacteroidia;Cytophagales;Cyclobacteriaceae;Shivajiella;";"100.0";"14.4";"3";"3";"3";"0";"0";"457180";"391204"
"V4mis2";"SILVA (only NR);Bacteria;Bacteroidota;Bacteroidia;Cytophagales;Cyclobacteriaceae;Tunicatimonas;";"84.6";"14.4";"13";"13";"11";"2";"0";"457170";"391196"
"V4mis2";"SILVA (only NR);Bacteria;Bacteroidota;Bacteroidia;Cytophagales;Cyclobacteriaceae;uncultured;";"95.9";"14.4";"345";"345";"331";"14";"0";"456838";"390876"
"V4mis2";"SILVA (only NR);Bacteria;Bacteroidota;Bacteroidia;Cytophagales;Cytophagaceae;";"90.8";"14.4";"130";"130";"118";"12";"0";"457053";"391089"
"V4mis2";"SILVA (only NR);Bacteria;Bacteroidota;Bacteroidia;Cytophagales;Cytophagaceae;Cytophaga;";"96.1";"14.4";"51";"51";"49";"2";"0";"457132";"391158"
"V4mis2";"SILVA (only NR);Bacteria;Bacteroidota;Bacteroidia;Cytophagales;Cytophagaceae;Rhodocytophaga;";"70.0";"14.4";"30";"30";"21";"9";"0";"457153";"391186"
"V4mis2";"SILVA (only NR);Bacteria;Bacteroidota;Bacteroidia;Cytophagales;Cytophagaceae;Siphonobacter;";"100.0";"14.4";"9";"9";"9";"0";"0";"457174";"391198"
"V4mis2";"SILVA (only NR);Bacteria;Bacteroidota;Bacteroidia;Cytophagales;Cytophagaceae;Sporocytophaga;";"97.2";"14.4";"36";"36";"35";"1";"0";"457147";"391172"
"V4mis2";"SILVA (only NR);Bacteria;Bacteroidota;Bacteroidia;Cytophagales;Cytophagaceae;uncultured;";"100.0";"14.4";"3";"3";"3";"0";"0";"457180";"391204"
"V4mis2";"SILVA (only NR);Bacteria;Bacteroidota;Bacteroidia;Cytophagales;Flammeovirgaceae;";"95.9";"14.4";"97";"97";"93";"4";"0";"457086";"391114"
"V4mis2";"SILVA (only NR);Bacteria;Bacteroidota;Bacteroidia;Cytophagales;Flammeovirgaceae;Algivirga;";"100.0";"14.4";"3";"3";"3";"0";"0";"457180";"391204"
"V4mis2";"SILVA (only NR);Bacteria;Bacteroidota;Bacteroidia;Cytophagales;Flammeovirgaceae;Flammeovirga;";"94.4";"14.4";"36";"36";"34";"2";"0";"457147";"391173"
"V4mis2";"SILVA (only NR);Bacteria;Bacteroidota;Bacteroidia;Cytophagales;Flammeovirgaceae;Flexithrix;";"92.3";"14.4";"26";"26";"24";"2";"0";"457157";"391183"
"V4mis2";"SILVA (only NR);Bacteria;Bacteroidota;Bacteroidia;Cytophagales;Flammeovirgaceae;Limibacter;";"100.0";"14.4";"2";"2";"2";"0";"0";"457181";"391205"
"V4mis2";"SILVA (only NR);Bacteria;Bacteroidota;Bacteroidia;Cytophagales;Flammeovirgaceae;Luteivirga;";"100.0";"14.4";"8";"8";"8";"0";"0";"457175";"391199"
"V4mis2";"SILVA (only NR);Bacteria;Bacteroidota;Bacteroidia;Cytophagales;Flammeovirgaceae;Perexilibacter;";"100.0";"14.4";"3";"3";"3";"0";"0";"457180";"391204"
"V4mis2";"SILVA (only NR);Bacteria;Bacteroidota;Bacteroidia;Cytophagales;Flammeovirgaceae;Rapidithrix;";"100.0";"14.4";"10";"10";"10";"0";"0";"457173";"391197"
"V4mis2";"SILVA (only NR);Bacteria;Bacteroidota;Bacteroidia;Cytophagales;Flammeovirgaceae;Sediminitomix;";"100.0";"14.4";"2";"2";"2";"0";"0";"457181";"391205"
"V4mis2";"SILVA (only NR);Bacteria;Bacteroidota;Bacteroidia;Cytophagales;Flammeovirgaceae;uncultured;";"100.0";"14.4";"6";"6";"6";"0";"0";"457177";"391201"
"V4mis2";"SILVA (only NR);Bacteria;Bacteroidota;Bacteroidia;Cytophagales;Hymenobacteraceae;";"98.6";"14.5";"898";"898";"885";"13";"0";"456285";"390322"
"V4mis2";"SILVA (only NR);Bacteria;Bacteroidota;Bacteroidia;Cytophagales;Hymenobacteraceae;Adhaeribacter;";"98.3";"14.4";"118";"118";"116";"2";"0";"457065";"391091"
"V4mis2";"SILVA (only NR);Bacteria;Bacteroidota;Bacteroidia;Cytophagales;Hymenobacteraceae;Hymenobacter;";"98.4";"14.4";"567";"567";"558";"9";"0";"456616";"390649"
"V4mis2";"SILVA (only NR);Bacteria;Bacteroidota;Bacteroidia;Cytophagales;Hymenobacteraceae;Nibribacter;";"95.2";"14.4";"21";"21";"20";"1";"0";"457162";"391187"
"V4mis2";"SILVA (only NR);Bacteria;Bacteroidota;Bacteroidia;Cytophagales;Hymenobacteraceae;Pontibacter;";"99.4";"14.4";"169";"169";"168";"1";"0";"457014";"391039"
"V4mis2";"SILVA (only NR);Bacteria;Bacteroidota;Bacteroidia;Cytophagales;Hymenobacteraceae;Rufibacter;";"100.0";"14.4";"23";"23";"23";"0";"0";"457160";"391184"
"V4mis2";"SILVA (only NR);Bacteria;Bacteroidota;Bacteroidia;Cytophagales;MWH-CFBk5;";"90.0";"14.4";"40";"40";"36";"4";"0";"457143";"391171"
"V4mis2";"SILVA (only NR);Bacteria;Bacteroidota;Bacteroidia;Cytophagales;Microscillaceae;";"96.7";"14.4";"660";"660";"638";"22";"0";"456523";"390569"
"V4mis2";"SILVA (only NR);Bacteria;Bacteroidota;Bacteroidia;Cytophagales;Microscillaceae;Chryseolinea;";"100.0";"14.4";"65";"65";"65";"0";"0";"457118";"391142"
"V4mis2";"SILVA (only NR);Bacteria;Bacteroidota;Bacteroidia;Cytophagales;Microscillaceae;Eisenibacter;";"85.7";"14.4";"7";"7";"6";"1";"0";"457176";"391201"
"V4mis2";"SILVA (only NR);Bacteria;Bacteroidota;Bacteroidia;Cytophagales;Microscillaceae;Flexibacter;";"94.1";"14.4";"17";"17";"16";"1";"0";"457166";"391191"
"V4mis2";"SILVA (only NR);Bacteria;Bacteroidota;Bacteroidia;Cytophagales;Microscillaceae;Hassallia;";"98.2";"14.4";"57";"57";"56";"1";"0";"457126";"391151"
"V4mis2";"SILVA (only NR);Bacteria;Bacteroidota;Bacteroidia;Cytophagales;Microscillaceae;Microscilla;";"91.7";"14.4";"12";"12";"11";"1";"0";"457171";"391196"
"V4mis2";"SILVA (only NR);Bacteria;Bacteroidota;Bacteroidia;Cytophagales;Microscillaceae;OLB12;";"100.0";"14.4";"36";"36";"36";"0";"0";"457147";"391171"
"V4mis2";"SILVA (only NR);Bacteria;Bacteroidota;Bacteroidia;Cytophagales;Microscillaceae;Ohtaekwangia;";"100.0";"14.4";"53";"53";"53";"0";"0";"457130";"391154"
"V4mis2";"SILVA (only NR);Bacteria;Bacteroidota;Bacteroidia;Cytophagales;Microscillaceae;Thermoflexibacter;";"100.0";"14.4";"7";"7";"7";"0";"0";"457176";"391200"
"V4mis2";"SILVA (only NR);Bacteria;Bacteroidota;Bacteroidia;Cytophagales;Microscillaceae;uncultured;";"95.5";"14.4";"404";"404";"386";"18";"0";"456779";"390821"
"V4mis2";"SILVA (only NR);Bacteria;Bacteroidota;Bacteroidia;Cytophagales;Mooreiaceae;";"100.0";"14.4";"3";"3";"3";"0";"0";"457180";"391204"
"V4mis2";"SILVA (only NR);Bacteria;Bacteroidota;Bacteroidia;Cytophagales;Mooreiaceae;Mooreia;";"100.0";"14.4";"3";"3";"3";"0";"0";"457180";"391204"
"V4mis2";"SILVA (only NR);Bacteria;Bacteroidota;Bacteroidia;Cytophagales;Raineyaceae;";"100.0";"14.4";"16";"16";"16";"0";"0";"457167";"391191"
"V4mis2";"SILVA (only NR);Bacteria;Bacteroidota;Bacteroidia;Cytophagales;Raineyaceae;Raineya;";"100.0";"14.4";"16";"16";"16";"0";"0";"457167";"391191"
"V4mis2";"SILVA (only NR);Bacteria;Bacteroidota;Bacteroidia;Cytophagales;Spirosomaceae;";"98.0";"14.4";"603";"603";"591";"12";"0";"456580";"390616"
"V4mis2";"SILVA (only NR);Bacteria;Bacteroidota;Bacteroidia;Cytophagales;Spirosomaceae;Arcicella;";"100.0";"14.4";"44";"44";"44";"0";"0";"457139";"391163"
"V4mis2";"SILVA (only NR);Bacteria;Bacteroidota;Bacteroidia;Cytophagales;Spirosomaceae;Arsenicibacter;";"100.0";"14.4";"3";"3";"3";"0";"0";"457180";"391204"
"V4mis2";"SILVA (only NR);Bacteria;Bacteroidota;Bacteroidia;Cytophagales;Spirosomaceae;Dyadobacter;";"97.7";"14.4";"133";"133";"130";"3";"0";"457050";"391077"
"V4mis2";"SILVA (only NR);Bacteria;Bacteroidota;Bacteroidia;Cytophagales;Spirosomaceae;Emticicia;";"100.0";"14.4";"31";"31";"31";"0";"0";"457152";"391176"
"V4mis2";"SILVA (only NR);Bacteria;Bacteroidota;Bacteroidia;Cytophagales;Spirosomaceae;Fibrella;";"100.0";"14.4";"13";"13";"13";"0";"0";"457170";"391194"
"V4mis2";"SILVA (only NR);Bacteria;Bacteroidota;Bacteroidia;Cytophagales;Spirosomaceae;Fibrisoma;";"100.0";"14.4";"9";"9";"9";"0";"0";"457174";"391198"
"V4mis2";"SILVA (only NR);Bacteria;Bacteroidota;Bacteroidia;Cytophagales;Spirosomaceae;Flectobacillus;";"100.0";"14.4";"19";"19";"19";"0";"0";"457164";"391188"
"V4mis2";"SILVA (only NR);Bacteria;Bacteroidota;Bacteroidia;Cytophagales;Spirosomaceae;Fluviimonas;";"100.0";"14.4";"3";"3";"3";"0";"0";"457180";"391204"
"V4mis2";"SILVA (only NR);Bacteria;Bacteroidota;Bacteroidia;Cytophagales;Spirosomaceae;Huanghella;";"100.0";"14.4";"1";"1";"1";"0";"0";"457182";"391206"
"V4mis2";"SILVA (only NR);Bacteria;Bacteroidota;Bacteroidia;Cytophagales;Spirosomaceae;Lacihabitans;";"100.0";"14.4";"20";"20";"20";"0";"0";"457163";"391187"
"V4mis2";"SILVA (only NR);Bacteria;Bacteroidota;Bacteroidia;Cytophagales;Spirosomaceae;Larkinella;";"100.0";"14.4";"26";"26";"26";"0";"0";"457157";"391181"
"V4mis2";"SILVA (only NR);Bacteria;Bacteroidota;Bacteroidia;Cytophagales;Spirosomaceae;Leadbetterella;";"94.7";"14.4";"19";"19";"18";"1";"0";"457164";"391189"
"V4mis2";"SILVA (only NR);Bacteria;Bacteroidota;Bacteroidia;Cytophagales;Spirosomaceae;Nibrella;";"100.0";"14.4";"5";"5";"5";"0";"0";"457178";"391202"
"V4mis2";"SILVA (only NR);Bacteria;Bacteroidota;Bacteroidia;Cytophagales;Spirosomaceae;Persicitalea;";"100.0";"14.4";"17";"17";"17";"0";"0";"457166";"391190"
"V4mis2";"SILVA (only NR);Bacteria;Bacteroidota;Bacteroidia;Cytophagales;Spirosomaceae;Pseudarcicella;";"90.0";"14.4";"30";"30";"27";"3";"0";"457153";"391180"
"V4mis2";"SILVA (only NR);Bacteria;Bacteroidota;Bacteroidia;Cytophagales;Spirosomaceae;Rhabdobacter;";"100.0";"14.4";"6";"6";"6";"0";"0";"457177";"391201"
"V4mis2";"SILVA (only NR);Bacteria;Bacteroidota;Bacteroidia;Cytophagales;Spirosomaceae;Rudanella;";"100.0";"14.4";"4";"4";"4";"0";"0";"457179";"391203"
"V4mis2";"SILVA (only NR);Bacteria;Bacteroidota;Bacteroidia;Cytophagales;Spirosomaceae;Runella;";"88.9";"14.4";"36";"36";"32";"4";"0";"457147";"391175"
"V4mis2";"SILVA (only NR);Bacteria;Bacteroidota;Bacteroidia;Cytophagales;Spirosomaceae;Spirosoma;";"100.0";"14.4";"129";"129";"129";"0";"0";"457054";"391078"
"V4mis2";"SILVA (only NR);Bacteria;Bacteroidota;Bacteroidia;Cytophagales;Spirosomaceae;Taeseokella;";"100.0";"14.4";"7";"7";"7";"0";"0";"457176";"391200"
"V4mis2";"SILVA (only NR);Bacteria;Bacteroidota;Bacteroidia;Cytophagales;Spirosomaceae;uncultured;";"97.6";"14.4";"42";"42";"41";"1";"0";"457141";"391166"
"V4mis2";"SILVA (only NR);Bacteria;Bacteroidota;Bacteroidia;Cytophagales;Thermonemataceae;";"100.0";"14.4";"5";"5";"5";"0";"0";"457178";"391202"
"V4mis2";"SILVA (only NR);Bacteria;Bacteroidota;Bacteroidia;Cytophagales;Thermonemataceae;Thermonema;";"100.0";"14.4";"5";"5";"5";"0";"0";"457178";"391202"
"V4mis2";"SILVA (only NR);Bacteria;Bacteroidota;Bacteroidia;Cytophagales;uncultured;";"94.7";"14.4";"19";"19";"18";"1";"0";"457164";"391189"
"V4mis2";"SILVA (only NR);Bacteria;Bacteroidota;Bacteroidia;Flavobacteriales;";"96.5";"14.7";"9773";"9773";"9434";"339";"0";"447410";"381773"
"V4mis2";"SILVA (only NR);Bacteria;Bacteroidota;Bacteroidia;Flavobacteriales;Blattabacteriaceae;";"96.3";"14.4";"267";"267";"257";"10";"0";"456916";"390950"
"V4mis2";"SILVA (only NR);Bacteria;Bacteroidota;Bacteroidia;Flavobacteriales;Blattabacteriaceae;Blattabacterium;";"91.3";"14.4";"46";"46";"42";"4";"0";"457137";"391165"
"V4mis2";"SILVA (only NR);Bacteria;Bacteroidota;Bacteroidia;Flavobacteriales;Blattabacteriaceae;Candidatus Brownia;";"85.7";"14.4";"14";"14";"12";"2";"0";"457169";"391195"
"V4mis2";"SILVA (only NR);Bacteria;Bacteroidota;Bacteroidia;Flavobacteriales;Blattabacteriaceae;Candidatus Sulcia;";"97.4";"14.4";"117";"117";"114";"3";"0";"457066";"391093"
"V4mis2";"SILVA (only NR);Bacteria;Bacteroidota;Bacteroidia;Flavobacteriales;Blattabacteriaceae;Candidatus Uzinura;";"98.6";"14.4";"74";"74";"73";"1";"0";"457109";"391134"
"V4mis2";"SILVA (only NR);Bacteria;Bacteroidota;Bacteroidia;Flavobacteriales;Blattabacteriaceae;uncultured;";"100.0";"14.4";"12";"12";"12";"0";"0";"457171";"391195"
"V4mis2";"SILVA (only NR);Bacteria;Bacteroidota;Bacteroidia;Flavobacteriales;Crocinitomicaceae;";"97.4";"14.4";"387";"387";"377";"10";"0";"456796";"390830"
"V4mis2";"SILVA (only NR);Bacteria;Bacteroidota;Bacteroidia;Flavobacteriales;Crocinitomicaceae;Brumimicrobium;";"100.0";"14.4";"22";"22";"22";"0";"0";"457161";"391185"
"V4mis2";"SILVA (only NR);Bacteria;Bacteroidota;Bacteroidia;Flavobacteriales;Crocinitomicaceae;Crocinitomix;";"94.0";"14.4";"84";"84";"79";"5";"0";"457099";"391128"
"V4mis2";"SILVA (only NR);Bacteria;Bacteroidota;Bacteroidia;Flavobacteriales;Crocinitomicaceae;Fluviicola;";"97.8";"14.4";"230";"230";"225";"5";"0";"456953";"390982"
"V4mis2";"SILVA (only NR);Bacteria;Bacteroidota;Bacteroidia;Flavobacteriales;Crocinitomicaceae;Lishizhenia;";"100.0";"14.4";"3";"3";"3";"0";"0";"457180";"391204"
"V4mis2";"SILVA (only NR);Bacteria;Bacteroidota;Bacteroidia;Flavobacteriales;Crocinitomicaceae;Salinirepens;";"100.0";"14.4";"12";"12";"12";"0";"0";"457171";"391195"
"V4mis2";"SILVA (only NR);Bacteria;Bacteroidota;Bacteroidia;Flavobacteriales;Crocinitomicaceae;Wandonia;";"100.0";"14.4";"7";"7";"7";"0";"0";"457176";"391200"
"V4mis2";"SILVA (only NR);Bacteria;Bacteroidota;Bacteroidia;Flavobacteriales;Crocinitomicaceae;uncultured;";"100.0";"14.4";"29";"29";"29";"0";"0";"457154";"391178"
"V4mis2";"SILVA (only NR);Bacteria;Bacteroidota;Bacteroidia;Flavobacteriales;Cryomorphaceae;";"96.2";"14.4";"425";"425";"409";"16";"0";"456758";"390798"
"V4mis2";"SILVA (only NR);Bacteria;Bacteroidota;Bacteroidia;Flavobacteriales;Cryomorphaceae;Cryomorpha;";"94.0";"14.4";"50";"50";"47";"3";"0";"457133";"391160"
"V4mis2";"SILVA (only NR);Bacteria;Bacteroidota;Bacteroidia;Flavobacteriales;Cryomorphaceae;Luteibaculum;";"100.0";"14.4";"8";"8";"8";"0";"0";"457175";"391199"
"V4mis2";"SILVA (only NR);Bacteria;Bacteroidota;Bacteroidia;Flavobacteriales;Cryomorphaceae;NS10 marine group;";"97.6";"14.4";"41";"41";"40";"1";"0";"457142";"391167"
"V4mis2";"SILVA (only NR);Bacteria;Bacteroidota;Bacteroidia;Flavobacteriales;Cryomorphaceae;Owenweeksia;";"100.0";"14.4";"34";"34";"34";"0";"0";"457149";"391173"
"V4mis2";"SILVA (only NR);Bacteria;Bacteroidota;Bacteroidia;Flavobacteriales;Cryomorphaceae;Phaeocystidibacter;";"100.0";"14.4";"7";"7";"7";"0";"0";"457176";"391200"
"V4mis2";"SILVA (only NR);Bacteria;Bacteroidota;Bacteroidia;Flavobacteriales;Cryomorphaceae;Vicingus;";"92.5";"14.4";"67";"67";"62";"5";"0";"457116";"391145"
"V4mis2";"SILVA (only NR);Bacteria;Bacteroidota;Bacteroidia;Flavobacteriales;Cryomorphaceae;uncultured;";"96.7";"14.4";"215";"215";"208";"7";"0";"456968";"390999"
"V4mis2";"SILVA (only NR);Bacteria;Bacteroidota;Bacteroidia;Flavobacteriales;Flavobacteriaceae;";"96.7";"14.6";"6681";"6681";"6460";"221";"0";"450502";"384747"
"V4mis2";"SILVA (only NR);Bacteria;Bacteroidota;Bacteroidia;Flavobacteriales;Flavobacteriaceae;Actibacter;";"100.0";"14.4";"20";"20";"20";"0";"0";"457163";"391187"
"V4mis2";"SILVA (only NR);Bacteria;Bacteroidota;Bacteroidia;Flavobacteriales;Flavobacteriaceae;Aequorivita;";"97.0";"14.4";"33";"33";"32";"1";"0";"457150";"391175"
"V4mis2";"SILVA (only NR);Bacteria;Bacteroidota;Bacteroidia;Flavobacteriales;Flavobacteriaceae;Aestuariibaculum;";"100.0";"14.4";"7";"7";"7";"0";"0";"457176";"391200"
"V4mis2";"SILVA (only NR);Bacteria;Bacteroidota;Bacteroidia;Flavobacteriales;Flavobacteriaceae;Aestuariimonas;";"100.0";"14.4";"4";"4";"4";"0";"0";"457179";"391203"
"V4mis2";"SILVA (only NR);Bacteria;Bacteroidota;Bacteroidia;Flavobacteriales;Flavobacteriaceae;Aestuariivivens;";"100.0";"14.4";"3";"3";"3";"0";"0";"457180";"391204"
"V4mis2";"SILVA (only NR);Bacteria;Bacteroidota;Bacteroidia;Flavobacteriales;Flavobacteriaceae;Algibacter;";"95.0";"14.4";"40";"40";"38";"2";"0";"457143";"391169"
"V4mis2";"SILVA (only NR);Bacteria;Bacteroidota;Bacteroidia;Flavobacteriales;Flavobacteriaceae;Algitalea;";"90.0";"14.4";"10";"10";"9";"1";"0";"457173";"391198"
"V4mis2";"SILVA (only NR);Bacteria;Bacteroidota;Bacteroidia;Flavobacteriales;Flavobacteriaceae;Antarcticibacterium;";"100.0";"14.4";"30";"30";"30";"0";"0";"457153";"391177"
"V4mis2";"SILVA (only NR);Bacteria;Bacteroidota;Bacteroidia;Flavobacteriales;Flavobacteriaceae;Antarcticimonas;";"100.0";"14.4";"2";"2";"2";"0";"0";"457181";"391205"
"V4mis2";"SILVA (only NR);Bacteria;Bacteroidota;Bacteroidia;Flavobacteriales;Flavobacteriaceae;Aquibacter;";"97.2";"14.4";"108";"108";"105";"3";"0";"457075";"391102"
"V4mis2";"SILVA (only NR);Bacteria;Bacteroidota;Bacteroidia;Flavobacteriales;Flavobacteriaceae;Aquimarina;";"95.5";"14.4";"67";"67";"64";"3";"0";"457116";"391143"
"V4mis2";"SILVA (only NR);Bacteria;Bacteroidota;Bacteroidia;Flavobacteriales;Flavobacteriaceae;Arcticiflavibacter;";"100.0";"14.4";"19";"19";"19";"0";"0";"457164";"391188"
"V4mis2";"SILVA (only NR);Bacteria;Bacteroidota;Bacteroidia;Flavobacteriales;Flavobacteriaceae;Arenibacter;";"100.0";"14.4";"49";"49";"49";"0";"0";"457134";"391158"
"V4mis2";"SILVA (only NR);Bacteria;Bacteroidota;Bacteroidia;Flavobacteriales;Flavobacteriaceae;Arenitalea;";"100.0";"14.4";"1";"1";"1";"0";"0";"457182";"391206"
"V4mis2";"SILVA (only NR);Bacteria;Bacteroidota;Bacteroidia;Flavobacteriales;Flavobacteriaceae;Ascidiimonas;";"100.0";"14.4";"3";"3";"3";"0";"0";"457180";"391204"
"V4mis2";"SILVA (only NR);Bacteria;Bacteroidota;Bacteroidia;Flavobacteriales;Flavobacteriaceae;Aurantiacicella;";"100.0";"14.4";"1";"1";"1";"0";"0";"457182";"391206"
"V4mis2";"SILVA (only NR);Bacteria;Bacteroidota;Bacteroidia;Flavobacteriales;Flavobacteriaceae;Aurantivirga;";"100.0";"14.4";"14";"14";"14";"0";"0";"457169";"391193"
"V4mis2";"SILVA (only NR);Bacteria;Bacteroidota;Bacteroidia;Flavobacteriales;Flavobacteriaceae;Aureicoccus;";"100.0";"14.4";"1";"1";"1";"0";"0";"457182";"391206"
"V4mis2";"SILVA (only NR);Bacteria;Bacteroidota;Bacteroidia;Flavobacteriales;Flavobacteriaceae;Aureimarina;";"100.0";"14.4";"2";"2";"2";"0";"0";"457181";"391205"
"V4mis2";"SILVA (only NR);Bacteria;Bacteroidota;Bacteroidia;Flavobacteriales;Flavobacteriaceae;Aureisphaera;";"100.0";"14.4";"5";"5";"5";"0";"0";"457178";"391202"
"V4mis2";"SILVA (only NR);Bacteria;Bacteroidota;Bacteroidia;Flavobacteriales;Flavobacteriaceae;Aureitalea;";"100.0";"14.4";"2";"2";"2";"0";"0";"457181";"391205"
"V4mis2";"SILVA (only NR);Bacteria;Bacteroidota;Bacteroidia;Flavobacteriales;Flavobacteriaceae;Aureivirga;";"100.0";"14.4";"2";"2";"2";"0";"0";"457181";"391205"
"V4mis2";"SILVA (only NR);Bacteria;Bacteroidota;Bacteroidia;Flavobacteriales;Flavobacteriaceae;Bizionia;";"90.9";"14.4";"22";"22";"20";"2";"0";"457161";"391187"
"V4mis2";"SILVA (only NR);Bacteria;Bacteroidota;Bacteroidia;Flavobacteriales;Flavobacteriaceae;Capnocytophaga;";"96.1";"14.4";"482";"482";"463";"19";"0";"456701";"390744"
"V4mis2";"SILVA (only NR);Bacteria;Bacteroidota;Bacteroidia;Flavobacteriales;Flavobacteriaceae;Cellulophaga;";"95.2";"14.4";"63";"63";"60";"3";"0";"457120";"391147"
"V4mis2";"SILVA (only NR);Bacteria;Bacteroidota;Bacteroidia;Flavobacteriales;Flavobacteriaceae;Changchengzhania;";"100.0";"14.4";"4";"4";"4";"0";"0";"457179";"391203"
"V4mis2";"SILVA (only NR);Bacteria;Bacteroidota;Bacteroidia;Flavobacteriales;Flavobacteriaceae;Citreitalea;";"100.0";"14.4";"9";"9";"9";"0";"0";"457174";"391198"
"V4mis2";"SILVA (only NR);Bacteria;Bacteroidota;Bacteroidia;Flavobacteriales;Flavobacteriaceae;Coenonia;";"80.0";"14.4";"5";"5";"4";"1";"0";"457178";"391203"
"V4mis2";"SILVA (only NR);Bacteria;Bacteroidota;Bacteroidia;Flavobacteriales;Flavobacteriaceae;Confluentibacter;";"100.0";"14.4";"9";"9";"9";"0";"0";"457174";"391198"
"V4mis2";"SILVA (only NR);Bacteria;Bacteroidota;Bacteroidia;Flavobacteriales;Flavobacteriaceae;Corallibacter;";"100.0";"14.4";"3";"3";"3";"0";"0";"457180";"391204"
"V4mis2";"SILVA (only NR);Bacteria;Bacteroidota;Bacteroidia;Flavobacteriales;Flavobacteriaceae;Costertonia;";"100.0";"14.4";"6";"6";"6";"0";"0";"457177";"391201"
"V4mis2";"SILVA (only NR);Bacteria;Bacteroidota;Bacteroidia;Flavobacteriales;Flavobacteriaceae;Croceibacter;";"100.0";"14.4";"4";"4";"4";"0";"0";"457179";"391203"
"V4mis2";"SILVA (only NR);Bacteria;Bacteroidota;Bacteroidia;Flavobacteriales;Flavobacteriaceae;Croceitalea;";"93.8";"14.4";"16";"16";"15";"1";"0";"457167";"391192"
"V4mis2";"SILVA (only NR);Bacteria;Bacteroidota;Bacteroidia;Flavobacteriales;Flavobacteriaceae;Dokdonia;";"100.0";"14.4";"48";"48";"48";"0";"0";"457135";"391159"
"V4mis2";"SILVA (only NR);Bacteria;Bacteroidota;Bacteroidia;Flavobacteriales;Flavobacteriaceae;Eudoraea;";"100.0";"14.4";"9";"9";"9";"0";"0";"457174";"391198"
"V4mis2";"SILVA (only NR);Bacteria;Bacteroidota;Bacteroidia;Flavobacteriales;Flavobacteriaceae;Euzebyella;";"100.0";"14.4";"15";"15";"15";"0";"0";"457168";"391192"
"V4mis2";"SILVA (only NR);Bacteria;Bacteroidota;Bacteroidia;Flavobacteriales;Flavobacteriaceae;Flagellimonas;";"100.0";"14.4";"4";"4";"4";"0";"0";"457179";"391203"
"V4mis2";"SILVA (only NR);Bacteria;Bacteroidota;Bacteroidia;Flavobacteriales;Flavobacteriaceae;Flavicella;";"100.0";"14.4";"10";"10";"10";"0";"0";"457173";"391197"
"V4mis2";"SILVA (only NR);Bacteria;Bacteroidota;Bacteroidia;Flavobacteriales;Flavobacteriaceae;Flavimarina;";"100.0";"14.4";"7";"7";"7";"0";"0";"457176";"391200"
"V4mis2";"SILVA (only NR);Bacteria;Bacteroidota;Bacteroidia;Flavobacteriales;Flavobacteriaceae;Flaviramulus;";"100.0";"14.4";"2";"2";"2";"0";"0";"457181";"391205"
"V4mis2";"SILVA (only NR);Bacteria;Bacteroidota;Bacteroidia;Flavobacteriales;Flavobacteriaceae;Flavirhabdus;";"93.3";"14.4";"15";"15";"14";"1";"0";"457168";"391193"
"V4mis2";"SILVA (only NR);Bacteria;Bacteroidota;Bacteroidia;Flavobacteriales;Flavobacteriaceae;Flavivirga;";"100.0";"14.4";"4";"4";"4";"0";"0";"457179";"391203"
"V4mis2";"SILVA (only NR);Bacteria;Bacteroidota;Bacteroidia;Flavobacteriales;Flavobacteriaceae;Flavobacterium;";"96.4";"14.5";"2191";"2191";"2113";"78";"0";"454992";"389094"
"V4mis2";"SILVA (only NR);Bacteria;Bacteroidota;Bacteroidia;Flavobacteriales;Flavobacteriaceae;Formosa;";"99.0";"14.4";"104";"104";"103";"1";"0";"457079";"391104"
"V4mis2";"SILVA (only NR);Bacteria;Bacteroidota;Bacteroidia;Flavobacteriales;Flavobacteriaceae;Frondibacter;";"100.0";"14.4";"2";"2";"2";"0";"0";"457181";"391205"
"V4mis2";"SILVA (only NR);Bacteria;Bacteroidota;Bacteroidia;Flavobacteriales;Flavobacteriaceae;Fulvibacter;";"100.0";"14.4";"2";"2";"2";"0";"0";"457181";"391205"
"V4mis2";"SILVA (only NR);Bacteria;Bacteroidota;Bacteroidia;Flavobacteriales;Flavobacteriaceae;Gaetbulibacter;";"100.0";"14.4";"17";"17";"17";"0";"0";"457166";"391190"
"V4mis2";"SILVA (only NR);Bacteria;Bacteroidota;Bacteroidia;Flavobacteriales;Flavobacteriaceae;Galbibacter;";"100.0";"14.4";"6";"6";"6";"0";"0";"457177";"391201"
"V4mis2";"SILVA (only NR);Bacteria;Bacteroidota;Bacteroidia;Flavobacteriales;Flavobacteriaceae;Gangjinia;";"100.0";"14.4";"9";"9";"9";"0";"0";"457174";"391198"
"V4mis2";"SILVA (only NR);Bacteria;Bacteroidota;Bacteroidia;Flavobacteriales;Flavobacteriaceae;Gelidibacter;";"100.0";"14.4";"17";"17";"17";"0";"0";"457166";"391190"
"V4mis2";"SILVA (only NR);Bacteria;Bacteroidota;Bacteroidia;Flavobacteriales;Flavobacteriaceae;Geojedonia;";"100.0";"14.4";"3";"3";"3";"0";"0";"457180";"391204"
"V4mis2";"SILVA (only NR);Bacteria;Bacteroidota;Bacteroidia;Flavobacteriales;Flavobacteriaceae;Gillisia;";"100.0";"14.4";"37";"37";"37";"0";"0";"457146";"391170"
"V4mis2";"SILVA (only NR);Bacteria;Bacteroidota;Bacteroidia;Flavobacteriales;Flavobacteriaceae;Gilvibacter;";"100.0";"14.4";"10";"10";"10";"0";"0";"457173";"391197"
"V4mis2";"SILVA (only NR);Bacteria;Bacteroidota;Bacteroidia;Flavobacteriales;Flavobacteriaceae;Gramella;";"97.7";"14.4";"44";"44";"43";"1";"0";"457139";"391164"
"V4mis2";"SILVA (only NR);Bacteria;Bacteroidota;Bacteroidia;Flavobacteriales;Flavobacteriaceae;Hanstruepera;";"100.0";"14.4";"2";"2";"2";"0";"0";"457181";"391205"
"V4mis2";"SILVA (only NR);Bacteria;Bacteroidota;Bacteroidia;Flavobacteriales;Flavobacteriaceae;Hoppeia;";"100.0";"14.4";"12";"12";"12";"0";"0";"457171";"391195"
"V4mis2";"SILVA (only NR);Bacteria;Bacteroidota;Bacteroidia;Flavobacteriales;Flavobacteriaceae;Hwangdonia;";"100.0";"14.4";"3";"3";"3";"0";"0";"457180";"391204"
"V4mis2";"SILVA (only NR);Bacteria;Bacteroidota;Bacteroidia;Flavobacteriales;Flavobacteriaceae;Hyunsoonleella;";"81.8";"14.4";"11";"11";"9";"2";"0";"457172";"391198"
"V4mis2";"SILVA (only NR);Bacteria;Bacteroidota;Bacteroidia;Flavobacteriales;Flavobacteriaceae;Ichthyenterobacterium;";"100.0";"14.4";"3";"3";"3";"0";"0";"457180";"391204"
"V4mis2";"SILVA (only NR);Bacteria;Bacteroidota;Bacteroidia;Flavobacteriales;Flavobacteriaceae;Imtechella;";"100.0";"14.4";"2";"2";"2";"0";"0";"457181";"391205"
"V4mis2";"SILVA (only NR);Bacteria;Bacteroidota;Bacteroidia;Flavobacteriales;Flavobacteriaceae;Jejudonia;";"85.7";"14.4";"7";"7";"6";"1";"0";"457176";"391201"
"V4mis2";"SILVA (only NR);Bacteria;Bacteroidota;Bacteroidia;Flavobacteriales;Flavobacteriaceae;Jejuia;";"100.0";"14.4";"3";"3";"3";"0";"0";"457180";"391204"
"V4mis2";"SILVA (only NR);Bacteria;Bacteroidota;Bacteroidia;Flavobacteriales;Flavobacteriaceae;Joostella;";"100.0";"14.4";"9";"9";"9";"0";"0";"457174";"391198"
"V4mis2";"SILVA (only NR);Bacteria;Bacteroidota;Bacteroidia;Flavobacteriales;Flavobacteriaceae;Kordia;";"100.0";"14.4";"32";"32";"32";"0";"0";"457151";"391175"
"V4mis2";"SILVA (only NR);Bacteria;Bacteroidota;Bacteroidia;Flavobacteriales;Flavobacteriaceae;Kriegella;";"100.0";"14.4";"2";"2";"2";"0";"0";"457181";"391205"
"V4mis2";"SILVA (only NR);Bacteria;Bacteroidota;Bacteroidia;Flavobacteriales;Flavobacteriaceae;Lacinutrix;";"100.0";"14.4";"20";"20";"20";"0";"0";"457163";"391187"
"V4mis2";"SILVA (only NR);Bacteria;Bacteroidota;Bacteroidia;Flavobacteriales;Flavobacteriaceae;Leeuwenhoekiella;";"87.5";"14.4";"24";"24";"21";"3";"0";"457159";"391186"
"V4mis2";"SILVA (only NR);Bacteria;Bacteroidota;Bacteroidia;Flavobacteriales;Flavobacteriaceae;Leptobacterium;";"100.0";"14.4";"2";"2";"2";"0";"0";"457181";"391205"
"V4mis2";"SILVA (only NR);Bacteria;Bacteroidota;Bacteroidia;Flavobacteriales;Flavobacteriaceae;Litoribaculum;";"100.0";"14.4";"1";"1";"1";"0";"0";"457182";"391206"
"V4mis2";"SILVA (only NR);Bacteria;Bacteroidota;Bacteroidia;Flavobacteriales;Flavobacteriaceae;Lutaonella;";"100.0";"14.4";"1";"1";"1";"0";"0";"457182";"391206"
"V4mis2";"SILVA (only NR);Bacteria;Bacteroidota;Bacteroidia;Flavobacteriales;Flavobacteriaceae;Lutibacter;";"100.0";"14.4";"68";"68";"68";"0";"0";"457115";"391139"
"V4mis2";"SILVA (only NR);Bacteria;Bacteroidota;Bacteroidia;Flavobacteriales;Flavobacteriaceae;Lutimonas;";"100.0";"14.4";"14";"14";"14";"0";"0";"457169";"391193"
"V4mis2";"SILVA (only NR);Bacteria;Bacteroidota;Bacteroidia;Flavobacteriales;Flavobacteriaceae;Mangrovimonas;";"100.0";"14.4";"5";"5";"5";"0";"0";"457178";"391202"
"V4mis2";"SILVA (only NR);Bacteria;Bacteroidota;Bacteroidia;Flavobacteriales;Flavobacteriaceae;Maribacter;";"94.4";"14.4";"124";"124";"117";"7";"0";"457059";"391090"
"V4mis2";"SILVA (only NR);Bacteria;Bacteroidota;Bacteroidia;Flavobacteriales;Flavobacteriaceae;Mariniflexile;";"100.0";"14.4";"10";"10";"10";"0";"0";"457173";"391197"
"V4mis2";"SILVA (only NR);Bacteria;Bacteroidota;Bacteroidia;Flavobacteriales;Flavobacteriaceae;Maritimimonas;";"97.0";"14.4";"135";"135";"131";"4";"0";"457048";"391076"
"V4mis2";"SILVA (only NR);Bacteria;Bacteroidota;Bacteroidia;Flavobacteriales;Flavobacteriaceae;Marixanthomonas;";"100.0";"14.4";"10";"10";"10";"0";"0";"457173";"391197"
"V4mis2";"SILVA (only NR);Bacteria;Bacteroidota;Bacteroidia;Flavobacteriales;Flavobacteriaceae;Meridianimaribacter;";"100.0";"14.4";"4";"4";"4";"0";"0";"457179";"391203"
"V4mis2";"SILVA (only NR);Bacteria;Bacteroidota;Bacteroidia;Flavobacteriales;Flavobacteriaceae;Mesoflavibacter;";"95.0";"14.4";"20";"20";"19";"1";"0";"457163";"391188"
"V4mis2";"SILVA (only NR);Bacteria;Bacteroidota;Bacteroidia;Flavobacteriales;Flavobacteriaceae;Mesonia;";"84.0";"14.4";"25";"25";"21";"4";"0";"457158";"391186"
"V4mis2";"SILVA (only NR);Bacteria;Bacteroidota;Bacteroidia;Flavobacteriales;Flavobacteriaceae;Muricauda;";"99.1";"14.4";"111";"111";"110";"1";"0";"457072";"391097"
"V4mis2";"SILVA (only NR);Bacteria;Bacteroidota;Bacteroidia;Flavobacteriales;Flavobacteriaceae;Muriicola;";"100.0";"14.4";"8";"8";"8";"0";"0";"457175";"391199"
"V4mis2";"SILVA (only NR);Bacteria;Bacteroidota;Bacteroidia;Flavobacteriales;Flavobacteriaceae;Myroides;";"94.4";"14.4";"89";"89";"84";"5";"0";"457094";"391123"
"V4mis2";"SILVA (only NR);Bacteria;Bacteroidota;Bacteroidia;Flavobacteriales;Flavobacteriaceae;NS2b marine group;";"100.0";"14.4";"54";"54";"54";"0";"0";"457129";"391153"
"V4mis2";"SILVA (only NR);Bacteria;Bacteroidota;Bacteroidia;Flavobacteriales;Flavobacteriaceae;NS3a marine group;";"100.0";"14.4";"35";"35";"35";"0";"0";"457148";"391172"
"V4mis2";"SILVA (only NR);Bacteria;Bacteroidota;Bacteroidia;Flavobacteriales;Flavobacteriaceae;NS4 marine group;";"97.9";"14.4";"144";"144";"141";"3";"0";"457039";"391066"
"V4mis2";"SILVA (only NR);Bacteria;Bacteroidota;Bacteroidia;Flavobacteriales;Flavobacteriaceae;NS5 marine group;";"98.8";"14.4";"249";"249";"246";"3";"0";"456934";"390961"
"V4mis2";"SILVA (only NR);Bacteria;Bacteroidota;Bacteroidia;Flavobacteriales;Flavobacteriaceae;Neptunitalea;";"100.0";"14.4";"4";"4";"4";"0";"0";"457179";"391203"
"V4mis2";"SILVA (only NR);Bacteria;Bacteroidota;Bacteroidia;Flavobacteriales;Flavobacteriaceae;Nonlabens;";"94.5";"14.4";"55";"55";"52";"3";"0";"457128";"391155"
"V4mis2";"SILVA (only NR);Bacteria;Bacteroidota;Bacteroidia;Flavobacteriales;Flavobacteriaceae;Ochrovirga;";"100.0";"14.4";"1";"1";"1";"0";"0";"457182";"391206"
"V4mis2";"SILVA (only NR);Bacteria;Bacteroidota;Bacteroidia;Flavobacteriales;Flavobacteriaceae;Olleya;";"100.0";"14.4";"20";"20";"20";"0";"0";"457163";"391187"
"V4mis2";"SILVA (only NR);Bacteria;Bacteroidota;Bacteroidia;Flavobacteriales;Flavobacteriaceae;Pibocella;";"100.0";"14.4";"7";"7";"7";"0";"0";"457176";"391200"
"V4mis2";"SILVA (only NR);Bacteria;Bacteroidota;Bacteroidia;Flavobacteriales;Flavobacteriaceae;Planktosalinus;";"100.0";"14.4";"12";"12";"12";"0";"0";"457171";"391195"
"V4mis2";"SILVA (only NR);Bacteria;Bacteroidota;Bacteroidia;Flavobacteriales;Flavobacteriaceae;Polaribacter;";"96.7";"14.4";"181";"181";"175";"6";"0";"457002";"391032"
"V4mis2";"SILVA (only NR);Bacteria;Bacteroidota;Bacteroidia;Flavobacteriales;Flavobacteriaceae;Postechiella;";"100.0";"14.4";"3";"3";"3";"0";"0";"457180";"391204"
"V4mis2";"SILVA (only NR);Bacteria;Bacteroidota;Bacteroidia;Flavobacteriales;Flavobacteriaceae;Pricia;";"90.0";"14.4";"10";"10";"9";"1";"0";"457173";"391198"
"V4mis2";"SILVA (only NR);Bacteria;Bacteroidota;Bacteroidia;Flavobacteriales;Flavobacteriaceae;Pseudofulvibacter;";"94.6";"14.4";"129";"129";"122";"7";"0";"457054";"391085"
"V4mis2";"SILVA (only NR);Bacteria;Bacteroidota;Bacteroidia;Flavobacteriales;Flavobacteriaceae;Pseudozobellia;";"100.0";"14.4";"2";"2";"2";"0";"0";"457181";"391205"
"V4mis2";"SILVA (only NR);Bacteria;Bacteroidota;Bacteroidia;Flavobacteriales;Flavobacteriaceae;Psychroflexus;";"96.1";"14.4";"103";"103";"99";"4";"0";"457080";"391108"
"V4mis2";"SILVA (only NR);Bacteria;Bacteroidota;Bacteroidia;Flavobacteriales;Flavobacteriaceae;Psychroserpens;";"100.0";"14.4";"35";"35";"35";"0";"0";"457148";"391172"
"V4mis2";"SILVA (only NR);Bacteria;Bacteroidota;Bacteroidia;Flavobacteriales;Flavobacteriaceae;Pustulibacterium;";"100.0";"14.4";"1";"1";"1";"0";"0";"457182";"391206"
"V4mis2";"SILVA (only NR);Bacteria;Bacteroidota;Bacteroidia;Flavobacteriales;Flavobacteriaceae;Robertkochia;";"100.0";"14.4";"1";"1";"1";"0";"0";"457182";"391206"
"V4mis2";"SILVA (only NR);Bacteria;Bacteroidota;Bacteroidia;Flavobacteriales;Flavobacteriaceae;Robiginitalea;";"93.5";"14.4";"46";"46";"43";"3";"0";"457137";"391164"
"V4mis2";"SILVA (only NR);Bacteria;Bacteroidota;Bacteroidia;Flavobacteriales;Flavobacteriaceae;Sabulilitoribacter;";"100.0";"14.4";"2";"2";"2";"0";"0";"457181";"391205"
"V4mis2";"SILVA (only NR);Bacteria;Bacteroidota;Bacteroidia;Flavobacteriales;Flavobacteriaceae;Salegentibacter;";"95.1";"14.4";"82";"82";"78";"4";"0";"457101";"391129"
"V4mis2";"SILVA (only NR);Bacteria;Bacteroidota;Bacteroidia;Flavobacteriales;Flavobacteriaceae;Salinimicrobium;";"97.5";"14.4";"79";"79";"77";"2";"0";"457104";"391130"
"V4mis2";"SILVA (only NR);Bacteria;Bacteroidota;Bacteroidia;Flavobacteriales;Flavobacteriaceae;Sediminibacter;";"100.0";"14.4";"4";"4";"4";"0";"0";"457179";"391203"
"V4mis2";"SILVA (only NR);Bacteria;Bacteroidota;Bacteroidia;Flavobacteriales;Flavobacteriaceae;Sediminicola;";"100.0";"14.4";"14";"14";"14";"0";"0";"457169";"391193"
"V4mis2";"SILVA (only NR);Bacteria;Bacteroidota;Bacteroidia;Flavobacteriales;Flavobacteriaceae;Seonamhaeicola;";"100.0";"14.4";"14";"14";"14";"0";"0";"457169";"391193"
"V4mis2";"SILVA (only NR);Bacteria;Bacteroidota;Bacteroidia;Flavobacteriales;Flavobacteriaceae;Siansivirga;";"100.0";"14.4";"3";"3";"3";"0";"0";"457180";"391204"
"V4mis2";"SILVA (only NR);Bacteria;Bacteroidota;Bacteroidia;Flavobacteriales;Flavobacteriaceae;Sinomicrobium;";"100.0";"14.4";"11";"11";"11";"0";"0";"457172";"391196"
"V4mis2";"SILVA (only NR);Bacteria;Bacteroidota;Bacteroidia;Flavobacteriales;Flavobacteriaceae;Snuella;";"100.0";"14.4";"2";"2";"2";"0";"0";"457181";"391205"
"V4mis2";"SILVA (only NR);Bacteria;Bacteroidota;Bacteroidia;Flavobacteriales;Flavobacteriaceae;Spongiibacterium;";"100.0";"14.4";"7";"7";"7";"0";"0";"457176";"391200"
"V4mis2";"SILVA (only NR);Bacteria;Bacteroidota;Bacteroidia;Flavobacteriales;Flavobacteriaceae;Spongiiferula;";"100.0";"14.4";"2";"2";"2";"0";"0";"457181";"391205"
"V4mis2";"SILVA (only NR);Bacteria;Bacteroidota;Bacteroidia;Flavobacteriales;Flavobacteriaceae;Spongiimicrobium;";"100.0";"14.4";"5";"5";"5";"0";"0";"457178";"391202"
"V4mis2";"SILVA (only NR);Bacteria;Bacteroidota;Bacteroidia;Flavobacteriales;Flavobacteriaceae;Spongiimonas;";"100.0";"14.4";"5";"5";"5";"0";"0";"457178";"391202"
"V4mis2";"SILVA (only NR);Bacteria;Bacteroidota;Bacteroidia;Flavobacteriales;Flavobacteriaceae;Spongiivirga;";"100.0";"14.4";"5";"5";"5";"0";"0";"457178";"391202"
"V4mis2";"SILVA (only NR);Bacteria;Bacteroidota;Bacteroidia;Flavobacteriales;Flavobacteriaceae;Subsaxibacter;";"100.0";"14.4";"17";"17";"17";"0";"0";"457166";"391190"
"V4mis2";"SILVA (only NR);Bacteria;Bacteroidota;Bacteroidia;Flavobacteriales;Flavobacteriaceae;Subsaximicrobium;";"100.0";"14.4";"4";"4";"4";"0";"0";"457179";"391203"
"V4mis2";"SILVA (only NR);Bacteria;Bacteroidota;Bacteroidia;Flavobacteriales;Flavobacteriaceae;Sufflavibacter;";"100.0";"14.4";"1";"1";"1";"0";"0";"457182";"391206"
"V4mis2";"SILVA (only NR);Bacteria;Bacteroidota;Bacteroidia;Flavobacteriales;Flavobacteriaceae;Sungkyunkwania;";"100.0";"14.4";"4";"4";"4";"0";"0";"457179";"391203"
"V4mis2";"SILVA (only NR);Bacteria;Bacteroidota;Bacteroidia;Flavobacteriales;Flavobacteriaceae;Tamlana;";"94.4";"14.4";"18";"18";"17";"1";"0";"457165";"391190"
"V4mis2";"SILVA (only NR);Bacteria;Bacteroidota;Bacteroidia;Flavobacteriales;Flavobacteriaceae;Tenacibaculum;";"98.2";"14.4";"227";"227";"223";"4";"0";"456956";"390984"
"V4mis2";"SILVA (only NR);Bacteria;Bacteroidota;Bacteroidia;Flavobacteriales;Flavobacteriaceae;Ulvibacter;";"96.8";"14.4";"63";"63";"61";"2";"0";"457120";"391146"
"V4mis2";"SILVA (only NR);Bacteria;Bacteroidota;Bacteroidia;Flavobacteriales;Flavobacteriaceae;Vitellibacter;";"95.7";"14.4";"23";"23";"22";"1";"0";"457160";"391185"
"V4mis2";"SILVA (only NR);Bacteria;Bacteroidota;Bacteroidia;Flavobacteriales;Flavobacteriaceae;Wenyingzhuangia;";"100.0";"14.4";"12";"12";"12";"0";"0";"457171";"391195"
"V4mis2";"SILVA (only NR);Bacteria;Bacteroidota;Bacteroidia;Flavobacteriales;Flavobacteriaceae;Winogradskyella;";"97.7";"14.4";"131";"131";"128";"3";"0";"457052";"391079"
"V4mis2";"SILVA (only NR);Bacteria;Bacteroidota;Bacteroidia;Flavobacteriales;Flavobacteriaceae;Xanthomarina;";"66.7";"14.4";"6";"6";"4";"2";"0";"457177";"391203"
"V4mis2";"SILVA (only NR);Bacteria;Bacteroidota;Bacteroidia;Flavobacteriales;Flavobacteriaceae;Yeosuana;";"100.0";"14.4";"3";"3";"3";"0";"0";"457180";"391204"
"V4mis2";"SILVA (only NR);Bacteria;Bacteroidota;Bacteroidia;Flavobacteriales;Flavobacteriaceae;Zeaxanthinibacter;";"95.5";"14.4";"22";"22";"21";"1";"0";"457161";"391186"
"V4mis2";"SILVA (only NR);Bacteria;Bacteroidota;Bacteroidia;Flavobacteriales;Flavobacteriaceae;Zhouia;";"100.0";"14.4";"2";"2";"2";"0";"0";"457181";"391205"
"V4mis2";"SILVA (only NR);Bacteria;Bacteroidota;Bacteroidia;Flavobacteriales;Flavobacteriaceae;Zobellia;";"94.7";"14.4";"19";"19";"18";"1";"0";"457164";"391189"
"V4mis2";"SILVA (only NR);Bacteria;Bacteroidota;Bacteroidia;Flavobacteriales;Flavobacteriaceae;Zunongwangia;";"93.8";"14.4";"16";"16";"15";"1";"0";"457167";"391192"
"V4mis2";"SILVA (only NR);Bacteria;Bacteroidota;Bacteroidia;Flavobacteriales;Flavobacteriaceae;uncultured;";"93.4";"14.4";"361";"361";"337";"24";"0";"456822";"390870"
"V4mis2";"SILVA (only NR);Bacteria;Bacteroidota;Bacteroidia;Flavobacteriales;Flavobacteriales Incertae Sedis;";"100.0";"14.4";"11";"11";"11";"0";"0";"457172";"391196"
"V4mis2";"SILVA (only NR);Bacteria;Bacteroidota;Bacteroidia;Flavobacteriales;Flavobacteriales Incertae Sedis;Ichthyobacterium;";"100.0";"14.4";"11";"11";"11";"0";"0";"457172";"391196"
"V4mis2";"SILVA (only NR);Bacteria;Bacteroidota;Bacteroidia;Flavobacteriales;NS7 marine group;";"97.6";"14.4";"42";"42";"41";"1";"0";"457141";"391166"
"V4mis2";"SILVA (only NR);Bacteria;Bacteroidota;Bacteroidia;Flavobacteriales;NS9 marine group;";"96.6";"14.4";"477";"477";"461";"16";"0";"456706";"390746"
"V4mis2";"SILVA (only NR);Bacteria;Bacteroidota;Bacteroidia;Flavobacteriales;Schleiferiaceae;";"100.0";"14.4";"48";"48";"48";"0";"0";"457135";"391159"
"V4mis2";"SILVA (only NR);Bacteria;Bacteroidota;Bacteroidia;Flavobacteriales;Schleiferiaceae;Schleiferia;";"100.0";"14.4";"48";"48";"48";"0";"0";"457135";"391159"
"V4mis2";"SILVA (only NR);Bacteria;Bacteroidota;Bacteroidia;Flavobacteriales;Weeksellaceae;";"95.5";"14.5";"1433";"1433";"1368";"65";"0";"455750";"389839"
"V4mis2";"SILVA (only NR);Bacteria;Bacteroidota;Bacteroidia;Flavobacteriales;Weeksellaceae;Algoriella;";"100.0";"14.4";"2";"2";"2";"0";"0";"457181";"391205"
"V4mis2";"SILVA (only NR);Bacteria;Bacteroidota;Bacteroidia;Flavobacteriales;Weeksellaceae;Apibacter;";"100.0";"14.4";"9";"9";"9";"0";"0";"457174";"391198"
"V4mis2";"SILVA (only NR);Bacteria;Bacteroidota;Bacteroidia;Flavobacteriales;Weeksellaceae;Bergeyella;";"91.3";"14.4";"138";"138";"126";"12";"0";"457045";"391081"
"V4mis2";"SILVA (only NR);Bacteria;Bacteroidota;Bacteroidia;Flavobacteriales;Weeksellaceae;Candidatus Hemobacterium;";"100.0";"14.4";"1";"1";"1";"0";"0";"457182";"391206"
"V4mis2";"SILVA (only NR);Bacteria;Bacteroidota;Bacteroidia;Flavobacteriales;Weeksellaceae;Chishuiella;";"75.0";"14.4";"4";"4";"3";"1";"0";"457179";"391204"
"V4mis2";"SILVA (only NR);Bacteria;Bacteroidota;Bacteroidia;Flavobacteriales;Weeksellaceae;Chryseobacterium;";"97.7";"14.5";"750";"750";"733";"17";"0";"456433";"390474"
"V4mis2";"SILVA (only NR);Bacteria;Bacteroidota;Bacteroidia;Flavobacteriales;Weeksellaceae;Cloacibacterium;";"91.2";"14.4";"227";"227";"207";"20";"0";"456956";"391000"
"V4mis2";"SILVA (only NR);Bacteria;Bacteroidota;Bacteroidia;Flavobacteriales;Weeksellaceae;Cruoricaptor;";"100.0";"14.4";"2";"2";"2";"0";"0";"457181";"391205"
"V4mis2";"SILVA (only NR);Bacteria;Bacteroidota;Bacteroidia;Flavobacteriales;Weeksellaceae;Elizabethkingia;";"95.2";"14.4";"62";"62";"59";"3";"0";"457121";"391148"
"V4mis2";"SILVA (only NR);Bacteria;Bacteroidota;Bacteroidia;Flavobacteriales;Weeksellaceae;Empedobacter;";"85.2";"14.4";"27";"27";"23";"4";"0";"457156";"391184"
"V4mis2";"SILVA (only NR);Bacteria;Bacteroidota;Bacteroidia;Flavobacteriales;Weeksellaceae;Moheibacter;";"90.7";"14.4";"43";"43";"39";"4";"0";"457140";"391168"
"V4mis2";"SILVA (only NR);Bacteria;Bacteroidota;Bacteroidia;Flavobacteriales;Weeksellaceae;Ornithobacterium;";"100.0";"14.4";"36";"36";"36";"0";"0";"457147";"391171"
"V4mis2";"SILVA (only NR);Bacteria;Bacteroidota;Bacteroidia;Flavobacteriales;Weeksellaceae;Riemerella;";"97.1";"14.4";"34";"34";"33";"1";"0";"457149";"391174"
"V4mis2";"SILVA (only NR);Bacteria;Bacteroidota;Bacteroidia;Flavobacteriales;Weeksellaceae;Soonwooa;";"100.0";"14.4";"5";"5";"5";"0";"0";"457178";"391202"
"V4mis2";"SILVA (only NR);Bacteria;Bacteroidota;Bacteroidia;Flavobacteriales;Weeksellaceae;Wautersiella;";"100.0";"14.4";"3";"3";"3";"0";"0";"457180";"391204"
"V4mis2";"SILVA (only NR);Bacteria;Bacteroidota;Bacteroidia;Flavobacteriales;Weeksellaceae;Weeksella;";"100.0";"14.4";"10";"10";"10";"0";"0";"457173";"391197"
"V4mis2";"SILVA (only NR);Bacteria;Bacteroidota;Bacteroidia;Flavobacteriales;Weeksellaceae;uncultured;";"95.8";"14.4";"72";"72";"69";"3";"0";"457111";"391138"
"V4mis2";"SILVA (only NR);Bacteria;Bacteroidota;Bacteroidia;ML602M-17;";"90.0";"14.4";"10";"10";"9";"1";"0";"457173";"391198"
"V4mis2";"SILVA (only NR);Bacteria;Bacteroidota;Bacteroidia;SM1A07;";"98.3";"14.4";"59";"59";"58";"1";"0";"457124";"391149"
"V4mis2";"SILVA (only NR);Bacteria;Bacteroidota;Bacteroidia;Sphingobacteriales;";"96.5";"14.5";"2824";"2824";"2724";"100";"0";"454359";"388483"
"V4mis2";"SILVA (only NR);Bacteria;Bacteroidota;Bacteroidia;Sphingobacteriales;ADurb.Bin408;";"100.0";"14.4";"7";"7";"7";"0";"0";"457176";"391200"
"V4mis2";"SILVA (only NR);Bacteria;Bacteroidota;Bacteroidia;Sphingobacteriales;AKYH767;";"98.1";"14.4";"106";"106";"104";"2";"0";"457077";"391103"
"V4mis2";"SILVA (only NR);Bacteria;Bacteroidota;Bacteroidia;Sphingobacteriales;CMW-169;";"100.0";"14.4";"7";"7";"7";"0";"0";"457176";"391200"
"V4mis2";"SILVA (only NR);Bacteria;Bacteroidota;Bacteroidia;Sphingobacteriales;CWT CU03-E12;";"100.0";"14.4";"6";"6";"6";"0";"0";"457177";"391201"
"V4mis2";"SILVA (only NR);Bacteria;Bacteroidota;Bacteroidia;Sphingobacteriales;E6aC02;";"93.0";"14.4";"86";"86";"80";"6";"0";"457097";"391127"
"V4mis2";"SILVA (only NR);Bacteria;Bacteroidota;Bacteroidia;Sphingobacteriales;FFCH9454;";"100.0";"14.4";"6";"6";"6";"0";"0";"457177";"391201"
"V4mis2";"SILVA (only NR);Bacteria;Bacteroidota;Bacteroidia;Sphingobacteriales;GWF2-29-10;";"100.0";"14.4";"5";"5";"5";"0";"0";"457178";"391202"
"V4mis2";"SILVA (only NR);Bacteria;Bacteroidota;Bacteroidia;Sphingobacteriales;KD1-131;";"100.0";"14.4";"15";"15";"15";"0";"0";"457168";"391192"
"V4mis2";"SILVA (only NR);Bacteria;Bacteroidota;Bacteroidia;Sphingobacteriales;KD3-93;";"100.0";"14.4";"49";"49";"49";"0";"0";"457134";"391158"
"V4mis2";"SILVA (only NR);Bacteria;Bacteroidota;Bacteroidia;Sphingobacteriales;Lentimicrobiaceae;";"95.9";"14.4";"534";"534";"512";"22";"0";"456649";"390695"
"V4mis2";"SILVA (only NR);Bacteria;Bacteroidota;Bacteroidia;Sphingobacteriales;Lentimicrobiaceae;Lentimicrobium;";"95.1";"14.4";"266";"266";"253";"13";"0";"456917";"390954"
"V4mis2";"SILVA (only NR);Bacteria;Bacteroidota;Bacteroidia;Sphingobacteriales;LiUU-11-161;";"95.0";"14.4";"20";"20";"19";"1";"0";"457163";"391188"
"V4mis2";"SILVA (only NR);Bacteria;Bacteroidota;Bacteroidia;Sphingobacteriales;NS11-12 marine group;";"96.4";"14.4";"196";"196";"189";"7";"0";"456987";"391018"
"V4mis2";"SILVA (only NR);Bacteria;Bacteroidota;Bacteroidia;Sphingobacteriales;S15-21;";"100.0";"14.4";"2";"2";"2";"0";"0";"457181";"391205"
"V4mis2";"SILVA (only NR);Bacteria;Bacteroidota;Bacteroidia;Sphingobacteriales;S15A-MN91;";"85.7";"14.4";"14";"14";"12";"2";"0";"457169";"391195"
"V4mis2";"SILVA (only NR);Bacteria;Bacteroidota;Bacteroidia;Sphingobacteriales;SBYC-2600;";"100.0";"14.4";"3";"3";"3";"0";"0";"457180";"391204"
"V4mis2";"SILVA (only NR);Bacteria;Bacteroidota;Bacteroidia;Sphingobacteriales;ST-12K33;";"95.9";"14.4";"49";"49";"47";"2";"0";"457134";"391160"
"V4mis2";"SILVA (only NR);Bacteria;Bacteroidota;Bacteroidia;Sphingobacteriales;Sphingobacteriaceae;";"96.7";"14.5";"1491";"1491";"1442";"49";"0";"455692";"389765"
"V4mis2";"SILVA (only NR);Bacteria;Bacteroidota;Bacteroidia;Sphingobacteriales;Sphingobacteriaceae;Anseongella;";"100.0";"14.4";"8";"8";"8";"0";"0";"457175";"391199"
"V4mis2";"SILVA (only NR);Bacteria;Bacteroidota;Bacteroidia;Sphingobacteriales;Sphingobacteriaceae;Arcticibacter;";"100.0";"14.4";"22";"22";"22";"0";"0";"457161";"391185"
"V4mis2";"SILVA (only NR);Bacteria;Bacteroidota;Bacteroidia;Sphingobacteriales;Sphingobacteriaceae;Mucilaginibacter;";"98.4";"14.4";"309";"309";"304";"5";"0";"456874";"390903"
"V4mis2";"SILVA (only NR);Bacteria;Bacteroidota;Bacteroidia;Sphingobacteriales;Sphingobacteriaceae;Nubsella;";"100.0";"14.4";"21";"21";"21";"0";"0";"457162";"391186"
"V4mis2";"SILVA (only NR);Bacteria;Bacteroidota;Bacteroidia;Sphingobacteriales;Sphingobacteriaceae;Olivibacter;";"100.0";"14.4";"33";"33";"33";"0";"0";"457150";"391174"
"V4mis2";"SILVA (only NR);Bacteria;Bacteroidota;Bacteroidia;Sphingobacteriales;Sphingobacteriaceae;Parapedobacter;";"98.0";"14.4";"51";"51";"50";"1";"0";"457132";"391157"
"V4mis2";"SILVA (only NR);Bacteria;Bacteroidota;Bacteroidia;Sphingobacteriales;Sphingobacteriaceae;Pedobacter;";"97.7";"14.4";"518";"518";"506";"12";"0";"456665";"390701"
"V4mis2";"SILVA (only NR);Bacteria;Bacteroidota;Bacteroidia;Sphingobacteriales;Sphingobacteriaceae;Pelobium;";"100.0";"14.4";"4";"4";"4";"0";"0";"457179";"391203"
"V4mis2";"SILVA (only NR);Bacteria;Bacteroidota;Bacteroidia;Sphingobacteriales;Sphingobacteriaceae;Pseudopedobacter;";"83.3";"14.4";"18";"18";"15";"3";"0";"457165";"391192"
"V4mis2";"SILVA (only NR);Bacteria;Bacteroidota;Bacteroidia;Sphingobacteriales;Sphingobacteriaceae;Pseudosphingobacterium;";"100.0";"14.4";"6";"6";"6";"0";"0";"457177";"391201"
"V4mis2";"SILVA (only NR);Bacteria;Bacteroidota;Bacteroidia;Sphingobacteriales;Sphingobacteriaceae;Solitalea;";"91.2";"14.4";"34";"34";"31";"3";"0";"457149";"391176"
"V4mis2";"SILVA (only NR);Bacteria;Bacteroidota;Bacteroidia;Sphingobacteriales;Sphingobacteriaceae;Sphingobacterium;";"93.4";"14.4";"380";"380";"355";"25";"0";"456803";"390852"
"V4mis2";"SILVA (only NR);Bacteria;Bacteroidota;Bacteroidia;Sphingobacteriales;Sphingobacteriaceae;uncultured;";"100.0";"14.4";"79";"79";"79";"0";"0";"457104";"391128"
"V4mis2";"SILVA (only NR);Bacteria;Bacteroidota;Bacteroidia;Sphingobacteriales;Z4MB62;";"100.0";"14.4";"3";"3";"3";"0";"0";"457180";"391204"
"V4mis2";"SILVA (only NR);Bacteria;Bacteroidota;Bacteroidia;Sphingobacteriales;env.OPS 17;";"95.8";"14.4";"212";"212";"203";"9";"0";"456971";"391004"
"V4mis2";"SILVA (only NR);Bacteria;Bacteroidota;Bacteroidia;Sphingobacteriales;s74e-6049;";"100.0";"14.4";"4";"4";"4";"0";"0";"457179";"391203"
"V4mis2";"SILVA (only NR);Bacteria;Bacteroidota;Bacteroidia;Sphingobacteriales;uncultured;";"100.0";"14.4";"3";"3";"3";"0";"0";"457180";"391204"
"V4mis2";"SILVA (only NR);Bacteria;Bacteroidota;Chlorobia;";"96.1";"14.4";"153";"153";"147";"6";"0";"457030";"391060"
"V4mis2";"SILVA (only NR);Bacteria;Bacteroidota;Chlorobia;Chlorobiales;";"96.1";"14.4";"153";"153";"147";"6";"0";"457030";"391060"
"V4mis2";"SILVA (only NR);Bacteria;Bacteroidota;Chlorobia;Chlorobiales;Chlorobiaceae;";"96.3";"14.4";"134";"134";"129";"5";"0";"457049";"391078"
"V4mis2";"SILVA (only NR);Bacteria;Bacteroidota;Chlorobia;Chlorobiales;Chlorobiaceae;Chlorobaculum;";"97.4";"14.4";"38";"38";"37";"1";"0";"457145";"391170"
"V4mis2";"SILVA (only NR);Bacteria;Bacteroidota;Chlorobia;Chlorobiales;Chlorobiaceae;Chlorobium;";"97.1";"14.4";"70";"70";"68";"2";"0";"457113";"391139"
"V4mis2";"SILVA (only NR);Bacteria;Bacteroidota;Chlorobia;Chlorobiales;Chlorobiaceae;Prosthecochloris;";"91.3";"14.4";"23";"23";"21";"2";"0";"457160";"391186"
"V4mis2";"SILVA (only NR);Bacteria;Bacteroidota;Chlorobia;Chlorobiales;Chlorobiaceae;uncultured;";"100.0";"14.4";"3";"3";"3";"0";"0";"457180";"391204"
"V4mis2";"SILVA (only NR);Bacteria;Bacteroidota;Chlorobia;Chlorobiales;Chloroherpetonaceae;";"94.7";"14.4";"19";"19";"18";"1";"0";"457164";"391189"
"V4mis2";"SILVA (only NR);Bacteria;Bacteroidota;Chlorobia;Chlorobiales;Chloroherpetonaceae;Chloroherpeton;";"100.0";"14.4";"4";"4";"4";"0";"0";"457179";"391203"
"V4mis2";"SILVA (only NR);Bacteria;Bacteroidota;Chlorobia;Chlorobiales;Chloroherpetonaceae;GBChlB;";"93.3";"14.4";"15";"15";"14";"1";"0";"457168";"391193"
"V4mis2";"SILVA (only NR);Bacteria;Bacteroidota;Ignavibacteria;";"95.8";"14.4";"378";"378";"362";"16";"0";"456805";"390845"
"V4mis2";"SILVA (only NR);Bacteria;Bacteroidota;Ignavibacteria;Ignavibacteriales;";"95.7";"14.4";"282";"282";"270";"12";"0";"456901";"390937"
"V4mis2";"SILVA (only NR);Bacteria;Bacteroidota;Ignavibacteria;Ignavibacteriales;BSN166;";"100.0";"14.4";"6";"6";"6";"0";"0";"457177";"391201"
"V4mis2";"SILVA (only NR);Bacteria;Bacteroidota;Ignavibacteria;Ignavibacteriales;BSV40;";"100.0";"14.4";"11";"11";"11";"0";"0";"457172";"391196"
"V4mis2";"SILVA (only NR);Bacteria;Bacteroidota;Ignavibacteria;Ignavibacteriales;Ignavibacteriaceae;";"93.4";"14.4";"76";"76";"71";"5";"0";"457107";"391136"
"V4mis2";"SILVA (only NR);Bacteria;Bacteroidota;Ignavibacteria;Ignavibacteriales;Ignavibacteriaceae;Ignavibacterium;";"93.4";"14.4";"76";"76";"71";"5";"0";"457107";"391136"
"V4mis2";"SILVA (only NR);Bacteria;Bacteroidota;Ignavibacteria;Ignavibacteriales;LD-RB-34;";"100.0";"14.4";"15";"15";"15";"0";"0";"457168";"391192"
"V4mis2";"SILVA (only NR);Bacteria;Bacteroidota;Ignavibacteria;Ignavibacteriales;Melioribacteraceae;";"95.9";"14.4";"73";"73";"70";"3";"0";"457110";"391137"
"V4mis2";"SILVA (only NR);Bacteria;Bacteroidota;Ignavibacteria;Ignavibacteriales;Melioribacteraceae;IheB3-7;";"94.9";"14.4";"59";"59";"56";"3";"0";"457124";"391151"
"V4mis2";"SILVA (only NR);Bacteria;Bacteroidota;Ignavibacteria;Ignavibacteriales;Melioribacteraceae;Melioribacter;";"100.0";"14.4";"13";"13";"13";"0";"0";"457170";"391194"
"V4mis2";"SILVA (only NR);Bacteria;Bacteroidota;Ignavibacteria;Ignavibacteriales;PHOS-HE36;";"97.0";"14.4";"67";"67";"65";"2";"0";"457116";"391142"
"V4mis2";"SILVA (only NR);Bacteria;Bacteroidota;Ignavibacteria;Ignavibacteriales;SM1H02;";"100.0";"14.4";"8";"8";"8";"0";"0";"457175";"391199"
"V4mis2";"SILVA (only NR);Bacteria;Bacteroidota;Ignavibacteria;Ignavibacteriales;SR-FBR-L83;";"90.0";"14.4";"20";"20";"18";"2";"0";"457163";"391189"
"V4mis2";"SILVA (only NR);Bacteria;Bacteroidota;Ignavibacteria;Ignavibacteriales;UA-50;";"100.0";"14.4";"3";"3";"3";"0";"0";"457180";"391204"
"V4mis2";"SILVA (only NR);Bacteria;Bacteroidota;Ignavibacteria;SJA-28;";"95.8";"14.4";"96";"96";"92";"4";"0";"457087";"391115"
"V4mis2";"SILVA (only NR);Bacteria;Bacteroidota;Kapabacteria;";"96.7";"14.4";"246";"246";"238";"8";"0";"456937";"390969"
"V4mis2";"SILVA (only NR);Bacteria;Bacteroidota;Kapabacteria;Kapabacteriales;";"96.7";"14.4";"246";"246";"238";"8";"0";"456937";"390969"
"V4mis2";"SILVA (only NR);Bacteria;Bacteroidota;Kryptonia;";"95.9";"14.4";"170";"170";"163";"7";"0";"457013";"391044"
"V4mis2";"SILVA (only NR);Bacteria;Bacteroidota;Kryptonia;Kryptoniales;";"95.9";"14.4";"170";"170";"163";"7";"0";"457013";"391044"
"V4mis2";"SILVA (only NR);Bacteria;Bacteroidota;Kryptonia;Kryptoniales;BSV26;";"95.3";"14.4";"150";"150";"143";"7";"0";"457033";"391064"
"V4mis2";"SILVA (only NR);Bacteria;Bacteroidota;Kryptonia;Kryptoniales;Kryptoniaceae;";"100.0";"14.4";"7";"7";"7";"0";"0";"457176";"391200"
"V4mis2";"SILVA (only NR);Bacteria;Bacteroidota;Kryptonia;Kryptoniales;Kryptoniaceae;Candidatus Chrysopegis;";"100.0";"14.4";"1";"1";"1";"0";"0";"457182";"391206"
"V4mis2";"SILVA (only NR);Bacteria;Bacteroidota;Kryptonia;Kryptoniales;Kryptoniaceae;Candidatus Kryptobacter;";"100.0";"14.4";"1";"1";"1";"0";"0";"457182";"391206"
"V4mis2";"SILVA (only NR);Bacteria;Bacteroidota;Kryptonia;Kryptoniales;Kryptoniaceae;Candidatus Kryptonium;";"100.0";"14.4";"2";"2";"2";"0";"0";"457181";"391205"
"V4mis2";"SILVA (only NR);Bacteria;Bacteroidota;Kryptonia;Kryptoniales;Kryptoniaceae;Candidatus Thermokryptus;";"100.0";"14.4";"1";"1";"1";"0";"0";"457182";"391206"
"V4mis2";"SILVA (only NR);Bacteria;Bacteroidota;Kryptonia;Kryptoniales;MSB-3C8;";"100.0";"14.4";"13";"13";"13";"0";"0";"457170";"391194"
"V4mis2";"SILVA (only NR);Bacteria;Bacteroidota;OC31;";"75.0";"14.4";"8";"8";"6";"2";"0";"457175";"391201"
"V4mis2";"SILVA (only NR);Bacteria;Bacteroidota;Rhodothermia;";"96.0";"14.5";"2102";"2102";"2017";"85";"0";"455081";"389190"
"V4mis2";"SILVA (only NR);Bacteria;Bacteroidota;Rhodothermia;Balneolales;";"97.2";"14.4";"351";"351";"341";"10";"0";"456832";"390866"
"V4mis2";"SILVA (only NR);Bacteria;Bacteroidota;Rhodothermia;Balneolales;Balneolaceae;";"97.2";"14.4";"351";"351";"341";"10";"0";"456832";"390866"
"V4mis2";"SILVA (only NR);Bacteria;Bacteroidota;Rhodothermia;Balneolales;Balneolaceae;A815;";"100.0";"14.4";"2";"2";"2";"0";"0";"457181";"391205"
"V4mis2";"SILVA (only NR);Bacteria;Bacteroidota;Rhodothermia;Balneolales;Balneolaceae;Aliifodinibius;";"100.0";"14.4";"13";"13";"13";"0";"0";"457170";"391194"
"V4mis2";"SILVA (only NR);Bacteria;Bacteroidota;Rhodothermia;Balneolales;Balneolaceae;B2706-C7;";"100.0";"14.4";"4";"4";"4";"0";"0";"457179";"391203"
"V4mis2";"SILVA (only NR);Bacteria;Bacteroidota;Rhodothermia;Balneolales;Balneolaceae;Balneola;";"97.4";"14.4";"38";"38";"37";"1";"0";"457145";"391170"
"V4mis2";"SILVA (only NR);Bacteria;Bacteroidota;Rhodothermia;Balneolales;Balneolaceae;CK06-06-Mud-MAS4B-21;";"100.0";"14.4";"5";"5";"5";"0";"0";"457178";"391202"
"V4mis2";"SILVA (only NR);Bacteria;Bacteroidota;Rhodothermia;Balneolales;Balneolaceae;F1-37X2;";"100.0";"14.4";"7";"7";"7";"0";"0";"457176";"391200"
"V4mis2";"SILVA (only NR);Bacteria;Bacteroidota;Rhodothermia;Balneolales;Balneolaceae;Fodinibius;";"100.0";"14.4";"6";"6";"6";"0";"0";"457177";"391201"
"V4mis2";"SILVA (only NR);Bacteria;Bacteroidota;Rhodothermia;Balneolales;Balneolaceae;Gracilimonas;";"97.5";"14.4";"40";"40";"39";"1";"0";"457143";"391168"
"V4mis2";"SILVA (only NR);Bacteria;Bacteroidota;Rhodothermia;Balneolales;Balneolaceae;HK-RBC54;";"100.0";"14.4";"2";"2";"2";"0";"0";"457181";"391205"
"V4mis2";"SILVA (only NR);Bacteria;Bacteroidota;Rhodothermia;Balneolales;Balneolaceae;MAT-CR-P4-C12;";"100.0";"14.4";"11";"11";"11";"0";"0";"457172";"391196"
"V4mis2";"SILVA (only NR);Bacteria;Bacteroidota;Rhodothermia;Balneolales;Balneolaceae;ML310M-34;";"100.0";"14.4";"8";"8";"8";"0";"0";"457175";"391199"
"V4mis2";"SILVA (only NR);Bacteria;Bacteroidota;Rhodothermia;Balneolales;Balneolaceae;Rhodohalobacter;";"80.0";"14.4";"5";"5";"4";"1";"0";"457178";"391203"
"V4mis2";"SILVA (only NR);Bacteria;Bacteroidota;Rhodothermia;Balneolales;Balneolaceae;Soortia;";"100.0";"14.4";"2";"2";"2";"0";"0";"457181";"391205"
"V4mis2";"SILVA (only NR);Bacteria;Bacteroidota;Rhodothermia;Balneolales;Balneolaceae;uncultured;";"96.6";"14.4";"203";"203";"196";"7";"0";"456980";"391011"
"V4mis2";"SILVA (only NR);Bacteria;Bacteroidota;Rhodothermia;Rhodothermales;";"95.7";"14.5";"1751";"1751";"1676";"75";"0";"455432";"389531"
"V4mis2";"SILVA (only NR);Bacteria;Bacteroidota;Rhodothermia;Rhodothermales;Rhodothermaceae;";"95.7";"14.5";"1751";"1751";"1676";"75";"0";"455432";"389531"
"V4mis2";"SILVA (only NR);Bacteria;Bacteroidota;Rhodothermia;Rhodothermales;Rhodothermaceae;Longimonas;";"100.0";"14.4";"8";"8";"8";"0";"0";"457175";"391199"
"V4mis2";"SILVA (only NR);Bacteria;Bacteroidota;Rhodothermia;Rhodothermales;Rhodothermaceae;Natronotalea;";"100.0";"14.4";"2";"2";"2";"0";"0";"457181";"391205"
"V4mis2";"SILVA (only NR);Bacteria;Bacteroidota;Rhodothermia;Rhodothermales;Rhodothermaceae;Rhodothermus;";"94.4";"14.4";"18";"18";"17";"1";"0";"457165";"391190"
"V4mis2";"SILVA (only NR);Bacteria;Bacteroidota;Rhodothermia;Rhodothermales;Rhodothermaceae;Rubricoccus;";"100.0";"14.4";"2";"2";"2";"0";"0";"457181";"391205"
"V4mis2";"SILVA (only NR);Bacteria;Bacteroidota;Rhodothermia;Rhodothermales;Rhodothermaceae;Rubrivirga;";"100.0";"14.4";"11";"11";"11";"0";"0";"457172";"391196"
"V4mis2";"SILVA (only NR);Bacteria;Bacteroidota;Rhodothermia;Rhodothermales;Rhodothermaceae;Salinibacter;";"96.0";"14.5";"1559";"1559";"1496";"63";"0";"455624";"389711"
"V4mis2";"SILVA (only NR);Bacteria;Bacteroidota;Rhodothermia;Rhodothermales;Rhodothermaceae;Salisaeta;";"100.0";"14.4";"10";"10";"10";"0";"0";"457173";"391197"
"V4mis2";"SILVA (only NR);Bacteria;Bacteroidota;Rhodothermia;Rhodothermales;Rhodothermaceae;uncultured;";"93.1";"14.4";"131";"131";"122";"9";"0";"457052";"391085"
"V4mis2";"SILVA (only NR);Bacteria;Bdellovibrionota;";"97.8";"14.5";"1665";"1665";"1628";"37";"0";"455518";"389579"
"V4mis2";"SILVA (only NR);Bacteria;Bdellovibrionota;Bdellovibrionia;";"97.6";"14.5";"1013";"1013";"989";"24";"0";"456170";"390218"
"V4mis2";"SILVA (only NR);Bacteria;Bdellovibrionota;Bdellovibrionia;Bacteriovoracales;";"98.1";"14.4";"362";"362";"355";"7";"0";"456821";"390852"
"V4mis2";"SILVA (only NR);Bacteria;Bdellovibrionota;Bdellovibrionia;Bacteriovoracales;Bacteriovoracaceae;";"98.1";"14.4";"362";"362";"355";"7";"0";"456821";"390852"
"V4mis2";"SILVA (only NR);Bacteria;Bdellovibrionota;Bdellovibrionia;Bacteriovoracales;Bacteriovoracaceae;Bacteriovorax;";"100.0";"14.4";"28";"28";"28";"0";"0";"457155";"391179"
"V4mis2";"SILVA (only NR);Bacteria;Bdellovibrionota;Bdellovibrionia;Bacteriovoracales;Bacteriovoracaceae;Halobacteriovorax;";"97.0";"14.4";"101";"101";"98";"3";"0";"457082";"391109"
"V4mis2";"SILVA (only NR);Bacteria;Bdellovibrionota;Bdellovibrionia;Bacteriovoracales;Bacteriovoracaceae;Peredibacter;";"98.7";"14.4";"154";"154";"152";"2";"0";"457029";"391055"
"V4mis2";"SILVA (only NR);Bacteria;Bdellovibrionota;Bdellovibrionia;Bacteriovoracales;Bacteriovoracaceae;uncultured;";"97.4";"14.4";"76";"76";"74";"2";"0";"457107";"391133"
"V4mis2";"SILVA (only NR);Bacteria;Bdellovibrionota;Bdellovibrionia;Bdellovibrionales;";"97.4";"14.4";"651";"651";"634";"17";"0";"456532";"390573"
"V4mis2";"SILVA (only NR);Bacteria;Bdellovibrionota;Bdellovibrionia;Bdellovibrionales;Bdellovibrionaceae;";"97.4";"14.4";"651";"651";"634";"17";"0";"456532";"390573"
"V4mis2";"SILVA (only NR);Bacteria;Bdellovibrionota;Bdellovibrionia;Bdellovibrionales;Bdellovibrionaceae;Bdellovibrio;";"97.1";"14.4";"345";"345";"335";"10";"0";"456838";"390872"
"V4mis2";"SILVA (only NR);Bacteria;Bdellovibrionota;Bdellovibrionia;Bdellovibrionales;Bdellovibrionaceae;OM27 clade;";"97.7";"14.4";"304";"304";"297";"7";"0";"456879";"390910"
"V4mis2";"SILVA (only NR);Bacteria;Bdellovibrionota;Bdellovibrionia;Bdellovibrionales;Bdellovibrionaceae;uncultured;";"100.0";"14.4";"2";"2";"2";"0";"0";"457181";"391205"
"V4mis2";"SILVA (only NR);Bacteria;Bdellovibrionota;Oligoflexia;";"98.0";"14.4";"652";"652";"639";"13";"0";"456531";"390568"
"V4mis2";"SILVA (only NR);Bacteria;Bdellovibrionota;Oligoflexia;0319-6G20;";"97.6";"14.4";"372";"372";"363";"9";"0";"456811";"390844"
"V4mis2";"SILVA (only NR);Bacteria;Bdellovibrionota;Oligoflexia;053A03-B-DI-P58;";"92.9";"14.4";"28";"28";"26";"2";"0";"457155";"391181"
"V4mis2";"SILVA (only NR);Bacteria;Bdellovibrionota;Oligoflexia;Oligoflexales;";"99.1";"14.4";"219";"219";"217";"2";"0";"456964";"390990"
"V4mis2";"SILVA (only NR);Bacteria;Bdellovibrionota;Oligoflexia;Oligoflexales;Oligoflexaceae;";"99.1";"14.4";"219";"219";"217";"2";"0";"456964";"390990"
"V4mis2";"SILVA (only NR);Bacteria;Bdellovibrionota;Oligoflexia;Oligoflexales;Oligoflexaceae;Oligoflexus;";"100.0";"14.4";"31";"31";"31";"0";"0";"457152";"391176"
"V4mis2";"SILVA (only NR);Bacteria;Bdellovibrionota;Oligoflexia;Oligoflexales;Oligoflexaceae;Pseudobacteriovorax;";"100.0";"14.4";"7";"7";"7";"0";"0";"457176";"391200"
"V4mis2";"SILVA (only NR);Bacteria;Bdellovibrionota;Oligoflexia;Oligoflexales;Oligoflexaceae;uncultured;";"98.9";"14.4";"178";"178";"176";"2";"0";"457005";"391031"
"V4mis2";"SILVA (only NR);Bacteria;Bdellovibrionota;Oligoflexia;Silvanigrellales;";"100.0";"14.4";"29";"29";"29";"0";"0";"457154";"391178"
"V4mis2";"SILVA (only NR);Bacteria;Bdellovibrionota;Oligoflexia;Silvanigrellales;Silvanigrellaceae;";"100.0";"14.4";"29";"29";"29";"0";"0";"457154";"391178"
"V4mis2";"SILVA (only NR);Bacteria;Bdellovibrionota;Oligoflexia;Silvanigrellales;Silvanigrellaceae;Candidatus Turbabacter;";"100.0";"14.4";"2";"2";"2";"0";"0";"457181";"391205"
"V4mis2";"SILVA (only NR);Bacteria;Bdellovibrionota;Oligoflexia;Silvanigrellales;Silvanigrellaceae;Silvanigrella;";"100.0";"14.4";"13";"13";"13";"0";"0";"457170";"391194"
"V4mis2";"SILVA (only NR);Bacteria;Bdellovibrionota;Oligoflexia;Silvanigrellales;Silvanigrellaceae;uncultured;";"100.0";"14.4";"12";"12";"12";"0";"0";"457171";"391195"
"V4mis2";"SILVA (only NR);Bacteria;Bdellovibrionota;Oligoflexia;uncultured;";"100.0";"14.4";"3";"3";"3";"0";"0";"457180";"391204"
"V4mis2";"SILVA (only NR);Bacteria;CK-2C2-2;";"90.9";"14.4";"22";"22";"20";"2";"0";"457161";"391187"
"V4mis2";"SILVA (only NR);Bacteria;Caldatribacteriota;";"96.2";"14.4";"391";"391";"376";"15";"0";"456792";"390831"
"V4mis2";"SILVA (only NR);Bacteria;Caldatribacteriota;Caldatribacteriia;";"100.0";"14.4";"48";"48";"48";"0";"0";"457135";"391159"
"V4mis2";"SILVA (only NR);Bacteria;Caldatribacteriota;Caldatribacteriia;Caldatribacteriales;";"100.0";"14.4";"48";"48";"48";"0";"0";"457135";"391159"
"V4mis2";"SILVA (only NR);Bacteria;Caldatribacteriota;Caldatribacteriia;Caldatribacteriales;Caldatribacteriaceae;";"100.0";"14.4";"48";"48";"48";"0";"0";"457135";"391159"
"V4mis2";"SILVA (only NR);Bacteria;Caldatribacteriota;Caldatribacteriia;Caldatribacteriales;Caldatribacteriaceae;Candidatus Caldatribacterium;";"100.0";"14.4";"48";"48";"48";"0";"0";"457135";"391159"
"V4mis2";"SILVA (only NR);Bacteria;Caldatribacteriota;JS1;";"95.6";"14.4";"343";"343";"328";"15";"0";"456840";"390879"
"V4mis2";"SILVA (only NR);Bacteria;Caldisericota;";"93.9";"14.4";"99";"99";"93";"6";"0";"457084";"391114"
"V4mis2";"SILVA (only NR);Bacteria;Caldisericota;Caldisericia;";"93.9";"14.4";"99";"99";"93";"6";"0";"457084";"391114"
"V4mis2";"SILVA (only NR);Bacteria;Caldisericota;Caldisericia;Caldisericales;";"93.9";"14.4";"99";"99";"93";"6";"0";"457084";"391114"
"V4mis2";"SILVA (only NR);Bacteria;Caldisericota;Caldisericia;Caldisericales;Caldisericaceae;";"100.0";"14.4";"33";"33";"33";"0";"0";"457150";"391174"
"V4mis2";"SILVA (only NR);Bacteria;Caldisericota;Caldisericia;Caldisericales;Caldisericaceae;Caldisericum;";"100.0";"14.4";"33";"33";"33";"0";"0";"457150";"391174"
"V4mis2";"SILVA (only NR);Bacteria;Caldisericota;Caldisericia;Caldisericales;LF045;";"93.1";"14.4";"29";"29";"27";"2";"0";"457154";"391180"
"V4mis2";"SILVA (only NR);Bacteria;Caldisericota;Caldisericia;Caldisericales;TTA-B15;";"100.0";"14.4";"3";"3";"3";"0";"0";"457180";"391204"
"V4mis2";"SILVA (only NR);Bacteria;Caldisericota;Caldisericia;Caldisericales;TTA-B1;";"76.5";"14.4";"17";"17";"13";"4";"0";"457166";"391194"
"V4mis2";"SILVA (only NR);Bacteria;Caldisericota;Caldisericia;Caldisericales;WCHB1-02;";"100.0";"14.4";"17";"17";"17";"0";"0";"457166";"391190"
"V4mis2";"SILVA (only NR);Bacteria;Calditrichota;";"94.3";"14.4";"296";"296";"279";"17";"0";"456887";"390928"
"V4mis2";"SILVA (only NR);Bacteria;Calditrichota;Calditrichia;";"94.3";"14.4";"296";"296";"279";"17";"0";"456887";"390928"
"V4mis2";"SILVA (only NR);Bacteria;Calditrichota;Calditrichia;Calditrichales;";"94.3";"14.4";"296";"296";"279";"17";"0";"456887";"390928"
"V4mis2";"SILVA (only NR);Bacteria;Calditrichota;Calditrichia;Calditrichales;Calditrichaceae;";"94.3";"14.4";"296";"296";"279";"17";"0";"456887";"390928"
"V4mis2";"SILVA (only NR);Bacteria;Calditrichota;Calditrichia;Calditrichales;Calditrichaceae;Caldithrix;";"100.0";"14.4";"23";"23";"23";"0";"0";"457160";"391184"
"V4mis2";"SILVA (only NR);Bacteria;Calditrichota;Calditrichia;Calditrichales;Calditrichaceae;Calorithrix;";"100.0";"14.4";"24";"24";"24";"0";"0";"457159";"391183"
"V4mis2";"SILVA (only NR);Bacteria;Calditrichota;Calditrichia;Calditrichales;Calditrichaceae;JdFR-76;";"100.0";"14.4";"24";"24";"24";"0";"0";"457159";"391183"
"V4mis2";"SILVA (only NR);Bacteria;Calditrichota;Calditrichia;Calditrichales;Calditrichaceae;SM23-31;";"96.8";"14.4";"31";"31";"30";"1";"0";"457152";"391177"
"V4mis2";"SILVA (only NR);Bacteria;Calescamantes;";"100.0";"14.4";"3";"3";"3";"0";"0";"457180";"391204"
"V4mis2";"SILVA (only NR);Bacteria;Calescamantes;Calescibacteriia;";"100.0";"14.4";"3";"3";"3";"0";"0";"457180";"391204"
"V4mis2";"SILVA (only NR);Bacteria;Calescamantes;Calescibacteriia;Calescibacteriales;";"100.0";"14.4";"3";"3";"3";"0";"0";"457180";"391204"
"V4mis2";"SILVA (only NR);Bacteria;Calescamantes;Calescibacteriia;Calescibacteriales;Calescibacteriaceae;";"100.0";"14.4";"3";"3";"3";"0";"0";"457180";"391204"
"V4mis2";"SILVA (only NR);Bacteria;Campylobacterota;";"96.8";"14.5";"4220";"4220";"4087";"133";"0";"452963";"387120"
"V4mis2";"SILVA (only NR);Bacteria;Campylobacterota;Campylobacteria;";"96.8";"14.5";"4188";"4188";"4055";"133";"0";"452995";"387152"
"V4mis2";"SILVA (only NR);Bacteria;Campylobacterota;Campylobacteria;Campylobacterales;";"96.8";"14.5";"4127";"4127";"3996";"131";"0";"453056";"387211"
"V4mis2";"SILVA (only NR);Bacteria;Campylobacterota;Campylobacteria;Campylobacterales;Arcobacteraceae;";"95.5";"14.4";"578";"578";"552";"26";"0";"456605";"390655"
"V4mis2";"SILVA (only NR);Bacteria;Campylobacterota;Campylobacteria;Campylobacterales;Arcobacteraceae;Arcobacter;";"95.7";"14.4";"70";"70";"67";"3";"0";"457113";"391140"
"V4mis2";"SILVA (only NR);Bacteria;Campylobacterota;Campylobacteria;Campylobacterales;Arcobacteraceae;Halarcobacter;";"88.2";"14.4";"51";"51";"45";"6";"0";"457132";"391162"
"V4mis2";"SILVA (only NR);Bacteria;Campylobacterota;Campylobacteria;Campylobacterales;Arcobacteraceae;Malaciobacter;";"97.1";"14.4";"34";"34";"33";"1";"0";"457149";"391174"
"V4mis2";"SILVA (only NR);Bacteria;Campylobacterota;Campylobacteria;Campylobacterales;Arcobacteraceae;Poseidonibacter;";"100.0";"14.4";"5";"5";"5";"0";"0";"457178";"391202"
"V4mis2";"SILVA (only NR);Bacteria;Campylobacterota;Campylobacteria;Campylobacterales;Arcobacteraceae;Pseudarcobacter;";"92.4";"14.4";"66";"66";"61";"5";"0";"457117";"391146"
"V4mis2";"SILVA (only NR);Bacteria;Campylobacterota;Campylobacteria;Campylobacterales;Arcobacteraceae;uncultured;";"96.7";"14.4";"331";"331";"320";"11";"0";"456852";"390887"
"V4mis2";"SILVA (only NR);Bacteria;Campylobacterota;Campylobacteria;Campylobacterales;CH8-1-BAC;";"100.0";"14.4";"2";"2";"2";"0";"0";"457181";"391205"
"V4mis2";"SILVA (only NR);Bacteria;Campylobacterota;Campylobacteria;Campylobacterales;Campylobacteraceae;";"98.6";"14.5";"724";"724";"714";"10";"0";"456459";"390493"
"V4mis2";"SILVA (only NR);Bacteria;Campylobacterota;Campylobacteria;Campylobacterales;Campylobacteraceae;Campylobacter;";"98.6";"14.5";"724";"724";"714";"10";"0";"456459";"390493"
"V4mis2";"SILVA (only NR);Bacteria;Campylobacterota;Campylobacteria;Campylobacterales;Helicobacteraceae;";"98.1";"14.4";"514";"514";"504";"10";"0";"456669";"390703"
"V4mis2";"SILVA (only NR);Bacteria;Campylobacterota;Campylobacteria;Campylobacterales;Helicobacteraceae;Helicobacter;";"98.3";"14.4";"469";"469";"461";"8";"0";"456714";"390746"
"V4mis2";"SILVA (only NR);Bacteria;Campylobacterota;Campylobacteria;Campylobacterales;Helicobacteraceae;Wolinella;";"100.0";"14.4";"5";"5";"5";"0";"0";"457178";"391202"
"V4mis2";"SILVA (only NR);Bacteria;Campylobacterota;Campylobacteria;Campylobacterales;Helicobacteraceae;uncultured;";"94.9";"14.4";"39";"39";"37";"2";"0";"457144";"391170"
"V4mis2";"SILVA (only NR);Bacteria;Campylobacterota;Campylobacteria;Campylobacterales;Hydrogenimonadaceae;";"95.0";"14.4";"20";"20";"19";"1";"0";"457163";"391188"
"V4mis2";"SILVA (only NR);Bacteria;Campylobacterota;Campylobacteria;Campylobacterales;Hydrogenimonadaceae;Hydrogenimonas;";"95.0";"14.4";"20";"20";"19";"1";"0";"457163";"391188"
"V4mis2";"SILVA (only NR);Bacteria;Campylobacterota;Campylobacteria;Campylobacterales;Incertae Sedis;";"100.0";"14.4";"7";"7";"7";"0";"0";"457176";"391200"
"V4mis2";"SILVA (only NR);Bacteria;Campylobacterota;Campylobacteria;Campylobacterales;Incertae Sedis;Thiofractor;";"100.0";"14.4";"7";"7";"7";"0";"0";"457176";"391200"
"V4mis2";"SILVA (only NR);Bacteria;Campylobacterota;Campylobacteria;Campylobacterales;Nitratiruptoraceae;";"100.0";"14.4";"18";"18";"18";"0";"0";"457165";"391189"
"V4mis2";"SILVA (only NR);Bacteria;Campylobacterota;Campylobacteria;Campylobacterales;Nitratiruptoraceae;Nitratiruptor;";"100.0";"14.4";"18";"18";"18";"0";"0";"457165";"391189"
"V4mis2";"SILVA (only NR);Bacteria;Campylobacterota;Campylobacteria;Campylobacterales;P6-b51;";"100.0";"14.4";"2";"2";"2";"0";"0";"457181";"391205"
"V4mis2";"SILVA (only NR);Bacteria;Campylobacterota;Campylobacteria;Campylobacterales;PS-B32;";"100.0";"14.4";"2";"2";"2";"0";"0";"457181";"391205"
"V4mis2";"SILVA (only NR);Bacteria;Campylobacterota;Campylobacteria;Campylobacterales;Rs-M59 termite group;";"100.0";"14.4";"12";"12";"12";"0";"0";"457171";"391195"
"V4mis2";"SILVA (only NR);Bacteria;Campylobacterota;Campylobacteria;Campylobacterales;Sulfurimonadaceae;";"95.6";"14.4";"814";"814";"778";"36";"0";"456369";"390429"
"V4mis2";"SILVA (only NR);Bacteria;Campylobacterota;Campylobacteria;Campylobacterales;Sulfurimonadaceae;Sulfuricurvum;";"94.5";"14.4";"164";"164";"155";"9";"0";"457019";"391052"
"V4mis2";"SILVA (only NR);Bacteria;Campylobacterota;Campylobacteria;Campylobacterales;Sulfurimonadaceae;Sulfurimonas;";"95.8";"14.4";"641";"641";"614";"27";"0";"456542";"390593"
"V4mis2";"SILVA (only NR);Bacteria;Campylobacterota;Campylobacteria;Campylobacterales;Sulfurimonadaceae;Thiovulum;";"100.0";"14.4";"9";"9";"9";"0";"0";"457174";"391198"
"V4mis2";"SILVA (only NR);Bacteria;Campylobacterota;Campylobacteria;Campylobacterales;Sulfurospirillaceae;";"95.2";"14.4";"168";"168";"160";"8";"0";"457015";"391047"
"V4mis2";"SILVA (only NR);Bacteria;Campylobacterota;Campylobacteria;Campylobacterales;Sulfurospirillaceae;Sulfurospirillum;";"95.2";"14.4";"168";"168";"160";"8";"0";"457015";"391047"
"V4mis2";"SILVA (only NR);Bacteria;Campylobacterota;Campylobacteria;Campylobacterales;Sulfurovaceae;";"96.8";"14.5";"1219";"1219";"1180";"39";"0";"455964";"390027"
"V4mis2";"SILVA (only NR);Bacteria;Campylobacterota;Campylobacteria;Campylobacterales;Sulfurovaceae;Nitratifractor;";"92.8";"14.4";"83";"83";"77";"6";"0";"457100";"391130"
"V4mis2";"SILVA (only NR);Bacteria;Campylobacterota;Campylobacteria;Campylobacterales;Sulfurovaceae;Sulfurovum;";"97.1";"14.5";"1136";"1136";"1103";"33";"0";"456047";"390104"
"V4mis2";"SILVA (only NR);Bacteria;Campylobacterota;Campylobacteria;Campylobacterales;Thioreductoraceae;";"100.0";"14.4";"7";"7";"7";"0";"0";"457176";"391200"
"V4mis2";"SILVA (only NR);Bacteria;Campylobacterota;Campylobacteria;Campylobacterales;Thioreductoraceae;Thioreductor;";"100.0";"14.4";"7";"7";"7";"0";"0";"457176";"391200"
"V4mis2";"SILVA (only NR);Bacteria;Campylobacterota;Campylobacteria;Campylobacterales;uncultured;";"97.4";"14.4";"39";"39";"38";"1";"0";"457144";"391169"
"V4mis2";"SILVA (only NR);Bacteria;Campylobacterota;Campylobacteria;Nautiliales;";"96.7";"14.4";"61";"61";"59";"2";"0";"457122";"391148"
"V4mis2";"SILVA (only NR);Bacteria;Campylobacterota;Campylobacteria;Nautiliales;Nautiliaceae;";"96.7";"14.4";"61";"61";"59";"2";"0";"457122";"391148"
"V4mis2";"SILVA (only NR);Bacteria;Campylobacterota;Campylobacteria;Nautiliales;Nautiliaceae;Caminibacter;";"96.3";"14.4";"27";"27";"26";"1";"0";"457156";"391181"
"V4mis2";"SILVA (only NR);Bacteria;Campylobacterota;Campylobacteria;Nautiliales;Nautiliaceae;Lebetimonas;";"100.0";"14.4";"8";"8";"8";"0";"0";"457175";"391199"
"V4mis2";"SILVA (only NR);Bacteria;Campylobacterota;Campylobacteria;Nautiliales;Nautiliaceae;Nautilia;";"100.0";"14.4";"8";"8";"8";"0";"0";"457175";"391199"
"V4mis2";"SILVA (only NR);Bacteria;Campylobacterota;Campylobacteria;Nautiliales;Nautiliaceae;uncultured;";"92.9";"14.4";"14";"14";"13";"1";"0";"457169";"391194"
"V4mis2";"SILVA (only NR);Bacteria;Campylobacterota;Desulfurellia;";"100.0";"14.4";"32";"32";"32";"0";"0";"457151";"391175"
"V4mis2";"SILVA (only NR);Bacteria;Campylobacterota;Desulfurellia;Desulfurellales;";"100.0";"14.4";"32";"32";"32";"0";"0";"457151";"391175"
"V4mis2";"SILVA (only NR);Bacteria;Campylobacterota;Desulfurellia;Desulfurellales;Desulfurellaceae;";"100.0";"14.4";"17";"17";"17";"0";"0";"457166";"391190"
"V4mis2";"SILVA (only NR);Bacteria;Campylobacterota;Desulfurellia;Desulfurellales;Desulfurellaceae;Desulfurella;";"100.0";"14.4";"17";"17";"17";"0";"0";"457166";"391190"
"V4mis2";"SILVA (only NR);Bacteria;Campylobacterota;Desulfurellia;Desulfurellales;Hippeaceae;";"100.0";"14.4";"11";"11";"11";"0";"0";"457172";"391196"
"V4mis2";"SILVA (only NR);Bacteria;Campylobacterota;Desulfurellia;Desulfurellales;Hippeaceae;Hippea;";"100.0";"14.4";"11";"11";"11";"0";"0";"457172";"391196"
"V4mis2";"SILVA (only NR);Bacteria;Campylobacterota;Desulfurellia;Desulfurellales;uncultured;";"100.0";"14.4";"4";"4";"4";"0";"0";"457179";"391203"
"V4mis2";"SILVA (only NR);Bacteria;Chloroflexi;";"95.0";"14.6";"9049";"9049";"8598";"451";"0";"448134";"382609"
"V4mis2";"SILVA (only NR);Bacteria;Chloroflexi;AD3;";"97.8";"14.4";"93";"93";"91";"2";"0";"457090";"391116"
"V4mis2";"SILVA (only NR);Bacteria;Chloroflexi;Anaerolineae;";"93.6";"14.5";"5491";"5491";"5140";"351";"0";"451692";"386067"
"V4mis2";"SILVA (only NR);Bacteria;Chloroflexi;Anaerolineae;1-20;";"100.0";"14.4";"19";"19";"19";"0";"0";"457164";"391188"
"V4mis2";"SILVA (only NR);Bacteria;Chloroflexi;Anaerolineae;ADurb.Bin180;";"100.0";"14.4";"29";"29";"29";"0";"0";"457154";"391178"
"V4mis2";"SILVA (only NR);Bacteria;Chloroflexi;Anaerolineae;Anaerolineales;";"95.1";"14.5";"2052";"2052";"1952";"100";"0";"455131";"389255"
"V4mis2";"SILVA (only NR);Bacteria;Chloroflexi;Anaerolineae;Anaerolineales;Anaerolineaceae;";"95.1";"14.5";"2052";"2052";"1952";"100";"0";"455131";"389255"
"V4mis2";"SILVA (only NR);Bacteria;Chloroflexi;Anaerolineae;Anaerolineales;Anaerolineaceae;ADurb.Bin120;";"93.3";"14.4";"45";"45";"42";"3";"0";"457138";"391165"
"V4mis2";"SILVA (only NR);Bacteria;Chloroflexi;Anaerolineae;Anaerolineales;Anaerolineaceae;Anaerolinea;";"97.3";"14.4";"111";"111";"108";"3";"0";"457072";"391099"
"V4mis2";"SILVA (only NR);Bacteria;Chloroflexi;Anaerolineae;Anaerolineales;Anaerolineaceae;Anaerolineaceae UCG-001;";"95.7";"14.4";"23";"23";"22";"1";"0";"457160";"391185"
"V4mis2";"SILVA (only NR);Bacteria;Chloroflexi;Anaerolineae;Anaerolineales;Anaerolineaceae;Bellilinea;";"100.0";"14.4";"12";"12";"12";"0";"0";"457171";"391195"
"V4mis2";"SILVA (only NR);Bacteria;Chloroflexi;Anaerolineae;Anaerolineales;Anaerolineaceae;Flexilinea;";"100.0";"14.4";"30";"30";"30";"0";"0";"457153";"391177"
"V4mis2";"SILVA (only NR);Bacteria;Chloroflexi;Anaerolineae;Anaerolineales;Anaerolineaceae;GWD2-49-16;";"100.0";"14.4";"4";"4";"4";"0";"0";"457179";"391203"
"V4mis2";"SILVA (only NR);Bacteria;Chloroflexi;Anaerolineae;Anaerolineales;Anaerolineaceae;Leptolinea;";"96.1";"14.4";"127";"127";"122";"5";"0";"457056";"391085"
"V4mis2";"SILVA (only NR);Bacteria;Chloroflexi;Anaerolineae;Anaerolineales;Anaerolineaceae;Levilinea;";"100.0";"14.4";"17";"17";"17";"0";"0";"457166";"391190"
"V4mis2";"SILVA (only NR);Bacteria;Chloroflexi;Anaerolineae;Anaerolineales;Anaerolineaceae;Longilinea;";"97.5";"14.4";"163";"163";"159";"4";"0";"457020";"391048"
"V4mis2";"SILVA (only NR);Bacteria;Chloroflexi;Anaerolineae;Anaerolineales;Anaerolineaceae;Ornatilinea;";"100.0";"14.4";"25";"25";"25";"0";"0";"457158";"391182"
"V4mis2";"SILVA (only NR);Bacteria;Chloroflexi;Anaerolineae;Anaerolineales;Anaerolineaceae;Pelolinea;";"97.9";"14.4";"47";"47";"46";"1";"0";"457136";"391161"
"V4mis2";"SILVA (only NR);Bacteria;Chloroflexi;Anaerolineae;Anaerolineales;Anaerolineaceae;RBG-16-58-14;";"100.0";"14.4";"12";"12";"12";"0";"0";"457171";"391195"
"V4mis2";"SILVA (only NR);Bacteria;Chloroflexi;Anaerolineae;Anaerolineales;Anaerolineaceae;Thermanaerothrix;";"50.0";"14.4";"2";"2";"1";"1";"0";"457181";"391206"
"V4mis2";"SILVA (only NR);Bacteria;Chloroflexi;Anaerolineae;Anaerolineales;Anaerolineaceae;Thermomarinilinea;";"90.9";"14.4";"11";"11";"10";"1";"0";"457172";"391197"
"V4mis2";"SILVA (only NR);Bacteria;Chloroflexi;Anaerolineae;Anaerolineales;Anaerolineaceae;UTCFX1;";"90.2";"14.4";"41";"41";"37";"4";"0";"457142";"391170"
"V4mis2";"SILVA (only NR);Bacteria;Chloroflexi;Anaerolineae;Anaerolineales;Anaerolineaceae;uncultured;";"94.4";"14.5";"1375";"1375";"1298";"77";"0";"455808";"389909"
"V4mis2";"SILVA (only NR);Bacteria;Chloroflexi;Anaerolineae;Ardenticatenales;";"88.2";"14.4";"592";"592";"522";"70";"0";"456591";"390685"
"V4mis2";"SILVA (only NR);Bacteria;Chloroflexi;Anaerolineae;Ardenticatenales;Ardenticatenaceae;";"84.8";"14.4";"66";"66";"56";"10";"0";"457117";"391151"
"V4mis2";"SILVA (only NR);Bacteria;Chloroflexi;Anaerolineae;Ardenticatenales;Ardenticatenaceae;Ardenticatena;";"100.0";"14.4";"4";"4";"4";"0";"0";"457179";"391203"
"V4mis2";"SILVA (only NR);Bacteria;Chloroflexi;Anaerolineae;Ardenticatenales;Ardenticatenaceae;uncultured;";"83.6";"14.4";"61";"61";"51";"10";"0";"457122";"391156"
"V4mis2";"SILVA (only NR);Bacteria;Chloroflexi;Anaerolineae;Ardenticatenales;uncultured;";"88.6";"14.4";"526";"526";"466";"60";"0";"456657";"390741"
"V4mis2";"SILVA (only NR);Bacteria;Chloroflexi;Anaerolineae;C10-SB1A;";"100.0";"14.4";"8";"8";"8";"0";"0";"457175";"391199"
"V4mis2";"SILVA (only NR);Bacteria;Chloroflexi;Anaerolineae;Caldilineales;";"94.3";"14.4";"314";"314";"296";"18";"0";"456869";"390911"
"V4mis2";"SILVA (only NR);Bacteria;Chloroflexi;Anaerolineae;Caldilineales;Caldilineaceae;";"94.3";"14.4";"314";"314";"296";"18";"0";"456869";"390911"
"V4mis2";"SILVA (only NR);Bacteria;Chloroflexi;Anaerolineae;Caldilineales;Caldilineaceae;Caldilinea;";"87.5";"14.4";"8";"8";"7";"1";"0";"457175";"391200"
"V4mis2";"SILVA (only NR);Bacteria;Chloroflexi;Anaerolineae;Caldilineales;Caldilineaceae;Litorilinea;";"82.6";"14.4";"23";"23";"19";"4";"0";"457160";"391188"
"V4mis2";"SILVA (only NR);Bacteria;Chloroflexi;Anaerolineae;Caldilineales;Caldilineaceae;uncultured;";"95.4";"14.4";"280";"280";"267";"13";"0";"456903";"390940"
"V4mis2";"SILVA (only NR);Bacteria;Chloroflexi;Anaerolineae;KZNMV-5-B42;";"100.0";"14.4";"3";"3";"3";"0";"0";"457180";"391204"
"V4mis2";"SILVA (only NR);Bacteria;Chloroflexi;Anaerolineae;MSB-5B2;";"89.5";"14.4";"19";"19";"17";"2";"0";"457164";"391190"
"V4mis2";"SILVA (only NR);Bacteria;Chloroflexi;Anaerolineae;MSB-5E12;";"100.0";"14.4";"7";"7";"7";"0";"0";"457176";"391200"
"V4mis2";"SILVA (only NR);Bacteria;Chloroflexi;Anaerolineae;RBG-13-54-9;";"97.8";"14.4";"270";"270";"264";"6";"0";"456913";"390943"
"V4mis2";"SILVA (only NR);Bacteria;Chloroflexi;Anaerolineae;SBR1031;";"92.4";"14.5";"1974";"1974";"1824";"150";"0";"455209";"389383"
"V4mis2";"SILVA (only NR);Bacteria;Chloroflexi;Anaerolineae;SBR1031;A4b;";"94.5";"14.4";"565";"565";"534";"31";"0";"456618";"390673"
"V4mis2";"SILVA (only NR);Bacteria;Chloroflexi;Anaerolineae;SBR1031;A4b;OLB13;";"86.7";"14.4";"15";"15";"13";"2";"0";"457168";"391194"
"V4mis2";"SILVA (only NR);Bacteria;Chloroflexi;Anaerolineae;SBR1031;A4b;OLB15;";"100.0";"14.4";"2";"2";"2";"0";"0";"457181";"391205"
"V4mis2";"SILVA (only NR);Bacteria;Chloroflexi;Anaerolineae;SJA-15;";"100.0";"14.4";"73";"73";"73";"0";"0";"457110";"391134"
"V4mis2";"SILVA (only NR);Bacteria;Chloroflexi;Anaerolineae;Thermoflexales;";"98.0";"14.4";"51";"51";"50";"1";"0";"457132";"391157"
"V4mis2";"SILVA (only NR);Bacteria;Chloroflexi;Anaerolineae;Thermoflexales;Thermoflexaceae;";"98.0";"14.4";"51";"51";"50";"1";"0";"457132";"391157"
"V4mis2";"SILVA (only NR);Bacteria;Chloroflexi;Anaerolineae;Thermoflexales;Thermoflexaceae;Thermoflexus;";"98.0";"14.4";"51";"51";"50";"1";"0";"457132";"391157"
"V4mis2";"SILVA (only NR);Bacteria;Chloroflexi;Anaerolineae;uncultured;";"97.4";"14.4";"77";"77";"75";"2";"0";"457106";"391132"
"V4mis2";"SILVA (only NR);Bacteria;Chloroflexi;Chloroflexia;";"95.4";"14.4";"700";"700";"668";"32";"0";"456483";"390539"
"V4mis2";"SILVA (only NR);Bacteria;Chloroflexi;Chloroflexia;Chloroflexales;";"96.6";"14.4";"409";"409";"395";"14";"0";"456774";"390812"
"V4mis2";"SILVA (only NR);Bacteria;Chloroflexi;Chloroflexia;Chloroflexales;Chloroflexaceae;";"95.5";"14.4";"201";"201";"192";"9";"0";"456982";"391015"
"V4mis2";"SILVA (only NR);Bacteria;Chloroflexi;Chloroflexia;Chloroflexales;Chloroflexaceae;Candidatus Chloroploca;";"100.0";"14.4";"12";"12";"12";"0";"0";"457171";"391195"
"V4mis2";"SILVA (only NR);Bacteria;Chloroflexi;Chloroflexia;Chloroflexales;Chloroflexaceae;Candidatus Chlorothrix;";"96.5";"14.4";"113";"113";"109";"4";"0";"457070";"391098"
"V4mis2";"SILVA (only NR);Bacteria;Chloroflexi;Chloroflexia;Chloroflexales;Chloroflexaceae;Chloroflexus;";"92.9";"14.4";"42";"42";"39";"3";"0";"457141";"391168"
"V4mis2";"SILVA (only NR);Bacteria;Chloroflexi;Chloroflexia;Chloroflexales;Chloroflexaceae;Chloronema;";"100.0";"14.4";"7";"7";"7";"0";"0";"457176";"391200"
"V4mis2";"SILVA (only NR);Bacteria;Chloroflexi;Chloroflexia;Chloroflexales;Chloroflexaceae;FFCH7168;";"89.5";"14.4";"19";"19";"17";"2";"0";"457164";"391190"
"V4mis2";"SILVA (only NR);Bacteria;Chloroflexi;Chloroflexia;Chloroflexales;Chloroflexaceae;Oscillochloris;";"100.0";"14.4";"5";"5";"5";"0";"0";"457178";"391202"
"V4mis2";"SILVA (only NR);Bacteria;Chloroflexi;Chloroflexia;Chloroflexales;Chloroflexaceae;uncultured;";"100.0";"14.4";"2";"2";"2";"0";"0";"457181";"391205"
"V4mis2";"SILVA (only NR);Bacteria;Chloroflexi;Chloroflexia;Chloroflexales;Herpetosiphonaceae;";"100.0";"14.4";"17";"17";"17";"0";"0";"457166";"391190"
"V4mis2";"SILVA (only NR);Bacteria;Chloroflexi;Chloroflexia;Chloroflexales;Herpetosiphonaceae;Herpetosiphon;";"100.0";"14.4";"17";"17";"17";"0";"0";"457166";"391190"
"V4mis2";"SILVA (only NR);Bacteria;Chloroflexi;Chloroflexia;Chloroflexales;Roseiflexaceae;";"97.4";"14.4";"191";"191";"186";"5";"0";"456992";"391021"
"V4mis2";"SILVA (only NR);Bacteria;Chloroflexi;Chloroflexia;Chloroflexales;Roseiflexaceae;Kouleothrix;";"100.0";"14.4";"10";"10";"10";"0";"0";"457173";"391197"
"V4mis2";"SILVA (only NR);Bacteria;Chloroflexi;Chloroflexia;Chloroflexales;Roseiflexaceae;Roseiflexus;";"96.7";"14.4";"30";"30";"29";"1";"0";"457153";"391178"
"V4mis2";"SILVA (only NR);Bacteria;Chloroflexi;Chloroflexia;Chloroflexales;Roseiflexaceae;uncultured;";"97.4";"14.4";"151";"151";"147";"4";"0";"457032";"391060"
"V4mis2";"SILVA (only NR);Bacteria;Chloroflexi;Chloroflexia;Elev-1554;";"100.0";"14.4";"9";"9";"9";"0";"0";"457174";"391198"
"V4mis2";"SILVA (only NR);Bacteria;Chloroflexi;Chloroflexia;Kallotenuales;";"97.8";"14.4";"46";"46";"45";"1";"0";"457137";"391162"
"V4mis2";"SILVA (only NR);Bacteria;Chloroflexi;Chloroflexia;Kallotenuales;AKIW781;";"97.6";"14.4";"42";"42";"41";"1";"0";"457141";"391166"
"V4mis2";"SILVA (only NR);Bacteria;Chloroflexi;Chloroflexia;Kallotenuales;Kallotenuaceae;";"100.0";"14.4";"4";"4";"4";"0";"0";"457179";"391203"
"V4mis2";"SILVA (only NR);Bacteria;Chloroflexi;Chloroflexia;Kallotenuales;Kallotenuaceae;Kallotenue;";"100.0";"14.4";"4";"4";"4";"0";"0";"457179";"391203"
"V4mis2";"SILVA (only NR);Bacteria;Chloroflexi;Chloroflexia;Thermobaculales;";"100.0";"14.4";"12";"12";"12";"0";"0";"457171";"391195"
"V4mis2";"SILVA (only NR);Bacteria;Chloroflexi;Chloroflexia;Thermobaculales;Thermobaculaceae;";"100.0";"14.4";"12";"12";"12";"0";"0";"457171";"391195"
"V4mis2";"SILVA (only NR);Bacteria;Chloroflexi;Chloroflexia;Thermobaculales;Thermobaculaceae;Thermobaculum;";"100.0";"14.4";"12";"12";"12";"0";"0";"457171";"391195"
"V4mis2";"SILVA (only NR);Bacteria;Chloroflexi;Chloroflexia;Thermomicrobiales;";"92.4";"14.4";"224";"224";"207";"17";"0";"456959";"391000"
"V4mis2";"SILVA (only NR);Bacteria;Chloroflexi;Chloroflexia;Thermomicrobiales;AKYG1722;";"89.6";"14.4";"48";"48";"43";"5";"0";"457135";"391164"
"V4mis2";"SILVA (only NR);Bacteria;Chloroflexi;Chloroflexia;Thermomicrobiales;JG30-KF-CM45;";"94.2";"14.4";"137";"137";"129";"8";"0";"457046";"391078"
"V4mis2";"SILVA (only NR);Bacteria;Chloroflexi;Chloroflexia;Thermomicrobiales;Thermomicrobiaceae;";"89.7";"14.4";"39";"39";"35";"4";"0";"457144";"391172"
"V4mis2";"SILVA (only NR);Bacteria;Chloroflexi;Chloroflexia;Thermomicrobiales;Thermomicrobiaceae;Nitrolancea;";"84.2";"14.4";"19";"19";"16";"3";"0";"457164";"391191"
"V4mis2";"SILVA (only NR);Bacteria;Chloroflexi;Chloroflexia;Thermomicrobiales;Thermomicrobiaceae;Sphaerobacter;";"100.0";"14.4";"7";"7";"7";"0";"0";"457176";"391200"
"V4mis2";"SILVA (only NR);Bacteria;Chloroflexi;Chloroflexia;Thermomicrobiales;Thermomicrobiaceae;Thermomicrobium;";"100.0";"14.4";"10";"10";"10";"0";"0";"457173";"391197"
"V4mis2";"SILVA (only NR);Bacteria;Chloroflexi;Chloroflexia;Thermomicrobiales;Thermomicrobiaceae;Thermorudis;";"50.0";"14.4";"2";"2";"1";"1";"0";"457181";"391206"
"V4mis2";"SILVA (only NR);Bacteria;Chloroflexi;Dehalococcoidia;";"98.2";"14.5";"1601";"1601";"1572";"29";"0";"455582";"389635"
"V4mis2";"SILVA (only NR);Bacteria;Chloroflexi;Dehalococcoidia;1226B1H1-22-FL;";"100.0";"14.4";"3";"3";"3";"0";"0";"457180";"391204"
"V4mis2";"SILVA (only NR);Bacteria;Chloroflexi;Dehalococcoidia;185B01;";"100.0";"14.4";"3";"3";"3";"0";"0";"457180";"391204"
"V4mis2";"SILVA (only NR);Bacteria;Chloroflexi;Dehalococcoidia;3051bac4-16;";"100.0";"14.4";"5";"5";"5";"0";"0";"457178";"391202"
"V4mis2";"SILVA (only NR);Bacteria;Chloroflexi;Dehalococcoidia;661239;";"100.0";"14.4";"16";"16";"16";"0";"0";"457167";"391191"
"V4mis2";"SILVA (only NR);Bacteria;Chloroflexi;Dehalococcoidia;Dehalococcoidales;";"93.2";"14.4";"88";"88";"82";"6";"0";"457095";"391125"
"V4mis2";"SILVA (only NR);Bacteria;Chloroflexi;Dehalococcoidia;Dehalococcoidales;Dehalococcoidaceae;";"94.1";"14.4";"51";"51";"48";"3";"0";"457132";"391159"
"V4mis2";"SILVA (only NR);Bacteria;Chloroflexi;Dehalococcoidia;Dehalococcoidales;Dehalococcoidaceae;Dehalococcoides;";"92.1";"14.4";"38";"38";"35";"3";"0";"457145";"391172"
"V4mis2";"SILVA (only NR);Bacteria;Chloroflexi;Dehalococcoidia;Dehalococcoidales;Dehalococcoidaceae;Dehalogenimonas;";"100.0";"14.4";"13";"13";"13";"0";"0";"457170";"391194"
"V4mis2";"SILVA (only NR);Bacteria;Chloroflexi;Dehalococcoidia;Dehalococcoidales;Dehalococcoidales Incertae Sedis;";"71.4";"14.4";"7";"7";"5";"2";"0";"457176";"391202"
"V4mis2";"SILVA (only NR);Bacteria;Chloroflexi;Dehalococcoidia;Dehalococcoidales;Dehalococcoidales Incertae Sedis;Dehalobium;";"71.4";"14.4";"7";"7";"5";"2";"0";"457176";"391202"
"V4mis2";"SILVA (only NR);Bacteria;Chloroflexi;Dehalococcoidia;Dehalococcoidales;uncultured;";"96.6";"14.4";"29";"29";"28";"1";"0";"457154";"391179"
"V4mis2";"SILVA (only NR);Bacteria;Chloroflexi;Dehalococcoidia;DscP2;";"98.2";"14.4";"111";"111";"109";"2";"0";"457072";"391098"
"V4mis2";"SILVA (only NR);Bacteria;Chloroflexi;Dehalococcoidia;ER-E4-17;";"100.0";"14.4";"4";"4";"4";"0";"0";"457179";"391203"
"V4mis2";"SILVA (only NR);Bacteria;Chloroflexi;Dehalococcoidia;FS117-23B-02;";"100.0";"14.4";"21";"21";"21";"0";"0";"457162";"391186"
"V4mis2";"SILVA (only NR);Bacteria;Chloroflexi;Dehalococcoidia;FW22;";"98.0";"14.4";"49";"49";"48";"1";"0";"457134";"391159"
"V4mis2";"SILVA (only NR);Bacteria;Chloroflexi;Dehalococcoidia;GIF3;";"100.0";"14.4";"91";"91";"91";"0";"0";"457092";"391116"
"V4mis2";"SILVA (only NR);Bacteria;Chloroflexi;Dehalococcoidia;GIF9;";"98.5";"14.4";"137";"137";"135";"2";"0";"457046";"391072"
"V4mis2";"SILVA (only NR);Bacteria;Chloroflexi;Dehalococcoidia;GIF9;AB-539-J10;";"98.8";"14.4";"86";"86";"85";"1";"0";"457097";"391122"
"V4mis2";"SILVA (only NR);Bacteria;Chloroflexi;Dehalococcoidia;GIF9;AB-539-J10;Dsc1;";"100.0";"14.4";"2";"2";"2";"0";"0";"457181";"391205"
"V4mis2";"SILVA (only NR);Bacteria;Chloroflexi;Dehalococcoidia;GIF9;AB-539-J10;SCGC-AB-539-J10;";"100.0";"14.4";"50";"50";"50";"0";"0";"457133";"391157"
"V4mis2";"SILVA (only NR);Bacteria;Chloroflexi;Dehalococcoidia;H3.93;";"100.0";"14.4";"40";"40";"40";"0";"0";"457143";"391167"
"V4mis2";"SILVA (only NR);Bacteria;Chloroflexi;Dehalococcoidia;JdFR-54;";"100.0";"14.4";"2";"2";"2";"0";"0";"457181";"391205"
"V4mis2";"SILVA (only NR);Bacteria;Chloroflexi;Dehalococcoidia;MB-C2-126;";"100.0";"14.4";"9";"9";"9";"0";"0";"457174";"391198"
"V4mis2";"SILVA (only NR);Bacteria;Chloroflexi;Dehalococcoidia;MSBL5;";"100.0";"14.4";"80";"80";"80";"0";"0";"457103";"391127"
"V4mis2";"SILVA (only NR);Bacteria;Chloroflexi;Dehalococcoidia;Napoli-4B-65;";"98.6";"14.4";"71";"71";"70";"1";"0";"457112";"391137"
"V4mis2";"SILVA (only NR);Bacteria;Chloroflexi;Dehalococcoidia;RBG-13-46-9;";"85.7";"14.4";"7";"7";"6";"1";"0";"457176";"391201"
"V4mis2";"SILVA (only NR);Bacteria;Chloroflexi;Dehalococcoidia;S085;";"97.2";"14.4";"180";"180";"175";"5";"0";"457003";"391032"
"V4mis2";"SILVA (only NR);Bacteria;Chloroflexi;Dehalococcoidia;SAR202 clade;";"97.9";"14.4";"475";"475";"465";"10";"0";"456708";"390742"
"V4mis2";"SILVA (only NR);Bacteria;Chloroflexi;Dehalococcoidia;SPG12-343-353-B75;";"100.0";"14.4";"6";"6";"6";"0";"0";"457177";"391201"
"V4mis2";"SILVA (only NR);Bacteria;Chloroflexi;Dehalococcoidia;SPG12-461-471-B8;";"100.0";"14.4";"5";"5";"5";"0";"0";"457178";"391202"
"V4mis2";"SILVA (only NR);Bacteria;Chloroflexi;Dehalococcoidia;Sh765B-AG-111;";"99.1";"14.4";"107";"107";"106";"1";"0";"457076";"391101"
"V4mis2";"SILVA (only NR);Bacteria;Chloroflexi;Dehalococcoidia;Sh765B-TzT-20;";"100.0";"14.4";"10";"10";"10";"0";"0";"457173";"391197"
"V4mis2";"SILVA (only NR);Bacteria;Chloroflexi;Dehalococcoidia;t0.6.f;";"100.0";"14.4";"23";"23";"23";"0";"0";"457160";"391184"
"V4mis2";"SILVA (only NR);Bacteria;Chloroflexi;Dehalococcoidia;vadinBA26;";"100.0";"14.4";"41";"41";"41";"0";"0";"457142";"391166"
"V4mis2";"SILVA (only NR);Bacteria;Chloroflexi;Gitt-GS-136;";"84.6";"14.4";"39";"39";"33";"6";"0";"457144";"391174"
"V4mis2";"SILVA (only NR);Bacteria;Chloroflexi;JG30-KF-CM66;";"98.4";"14.4";"127";"127";"125";"2";"0";"457056";"391082"
"V4mis2";"SILVA (only NR);Bacteria;Chloroflexi;KD4-96;";"91.3";"14.4";"150";"150";"137";"13";"0";"457033";"391070"
"V4mis2";"SILVA (only NR);Bacteria;Chloroflexi;Ktedonobacteria;";"97.9";"14.4";"485";"485";"475";"10";"0";"456698";"390732"
"V4mis2";"SILVA (only NR);Bacteria;Chloroflexi;Ktedonobacteria;B10-SB3A;";"100.0";"14.4";"5";"5";"5";"0";"0";"457178";"391202"
"V4mis2";"SILVA (only NR);Bacteria;Chloroflexi;Ktedonobacteria;B12-WMSP1;";"94.7";"14.4";"19";"19";"18";"1";"0";"457164";"391189"
"V4mis2";"SILVA (only NR);Bacteria;Chloroflexi;Ktedonobacteria;C0119;";"94.4";"14.4";"54";"54";"51";"3";"0";"457129";"391156"
"V4mis2";"SILVA (only NR);Bacteria;Chloroflexi;Ktedonobacteria;Ktedonobacterales;";"98.7";"14.4";"390";"390";"385";"5";"0";"456793";"390822"
"V4mis2";"SILVA (only NR);Bacteria;Chloroflexi;Ktedonobacteria;Ktedonobacterales;JG30-KF-AS9;";"100.0";"14.4";"23";"23";"23";"0";"0";"457160";"391184"
"V4mis2";"SILVA (only NR);Bacteria;Chloroflexi;Ktedonobacteria;Ktedonobacterales;Ktedonobacteraceae;";"98.6";"14.4";"366";"366";"361";"5";"0";"456817";"390846"
"V4mis2";"SILVA (only NR);Bacteria;Chloroflexi;Ktedonobacteria;Ktedonobacterales;Ktedonobacteraceae;1921-2;";"100.0";"14.4";"12";"12";"12";"0";"0";"457171";"391195"
"V4mis2";"SILVA (only NR);Bacteria;Chloroflexi;Ktedonobacteria;Ktedonobacterales;Ktedonobacteraceae;1921-3;";"100.0";"14.4";"24";"24";"24";"0";"0";"457159";"391183"
"V4mis2";"SILVA (only NR);Bacteria;Chloroflexi;Ktedonobacteria;Ktedonobacterales;Ktedonobacteraceae;1959-1;";"92.3";"14.4";"13";"13";"12";"1";"0";"457170";"391195"
"V4mis2";"SILVA (only NR);Bacteria;Chloroflexi;Ktedonobacteria;Ktedonobacterales;Ktedonobacteraceae;BacC-u-018;";"100.0";"14.4";"7";"7";"7";"0";"0";"457176";"391200"
"V4mis2";"SILVA (only NR);Bacteria;Chloroflexi;Ktedonobacteria;Ktedonobacterales;Ktedonobacteraceae;FCPS473;";"100.0";"14.4";"29";"29";"29";"0";"0";"457154";"391178"
"V4mis2";"SILVA (only NR);Bacteria;Chloroflexi;Ktedonobacteria;Ktedonobacterales;Ktedonobacteraceae;G12-WMSP1;";"100.0";"14.4";"16";"16";"16";"0";"0";"457167";"391191"
"V4mis2";"SILVA (only NR);Bacteria;Chloroflexi;Ktedonobacteria;Ktedonobacterales;Ktedonobacteraceae;HSB OF53-F07;";"97.0";"14.4";"33";"33";"32";"1";"0";"457150";"391175"
"V4mis2";"SILVA (only NR);Bacteria;Chloroflexi;Ktedonobacteria;Ktedonobacterales;Ktedonobacteraceae;JG30a-KF-32;";"100.0";"14.4";"21";"21";"21";"0";"0";"457162";"391186"
"V4mis2";"SILVA (only NR);Bacteria;Chloroflexi;Ktedonobacteria;Ktedonobacterales;Ktedonobacteraceae;Ktedonobacter;";"100.0";"14.4";"28";"28";"28";"0";"0";"457155";"391179"
"V4mis2";"SILVA (only NR);Bacteria;Chloroflexi;Ktedonobacteria;Ktedonobacterales;Ktedonobacteraceae;Thermogemmatispora;";"100.0";"14.4";"8";"8";"8";"0";"0";"457175";"391199"
"V4mis2";"SILVA (only NR);Bacteria;Chloroflexi;Ktedonobacteria;Ktedonobacterales;Ktedonobacteraceae;Thermosporothrix;";"100.0";"14.4";"8";"8";"8";"0";"0";"457175";"391199"
"V4mis2";"SILVA (only NR);Bacteria;Chloroflexi;Ktedonobacteria;Ktedonobacterales;Ktedonobacteraceae;uncultured;";"98.2";"14.4";"164";"164";"161";"3";"0";"457019";"391046"
"V4mis2";"SILVA (only NR);Bacteria;Chloroflexi;Ktedonobacteria;MVP-21;";"93.8";"14.4";"16";"16";"15";"1";"0";"457167";"391192"
"V4mis2";"SILVA (only NR);Bacteria;Chloroflexi;N9D0;";"100.0";"14.4";"4";"4";"4";"0";"0";"457179";"391203"
"V4mis2";"SILVA (only NR);Bacteria;Chloroflexi;NLS2-31;";"100.0";"14.4";"2";"2";"2";"0";"0";"457181";"391205"
"V4mis2";"SILVA (only NR);Bacteria;Chloroflexi;OLB14;";"100.0";"14.4";"46";"46";"46";"0";"0";"457137";"391161"
"V4mis2";"SILVA (only NR);Bacteria;Chloroflexi;P2-11E;";"100.0";"14.4";"33";"33";"33";"0";"0";"457150";"391174"
"V4mis2";"SILVA (only NR);Bacteria;Chloroflexi;SHA-26;";"100.0";"14.4";"42";"42";"42";"0";"0";"457141";"391165"
"V4mis2";"SILVA (only NR);Bacteria;Chloroflexi;SL56 marine group;";"100.0";"14.4";"21";"21";"21";"0";"0";"457162";"391186"
"V4mis2";"SILVA (only NR);Bacteria;Chloroflexi;TK10;";"97.3";"14.4";"187";"187";"182";"5";"0";"456996";"391025"
"V4mis2";"SILVA (only NR);Bacteria;Chloroflexi;TK17;";"100.0";"14.4";"18";"18";"18";"0";"0";"457165";"391189"
"V4mis2";"SILVA (only NR);Bacteria;Chloroflexi;TK30;";"83.3";"14.4";"6";"6";"5";"1";"0";"457177";"391202"
"V4mis2";"SILVA (only NR);Bacteria;Chrysiogenetota;";"100.0";"14.4";"8";"8";"8";"0";"0";"457175";"391199"
"V4mis2";"SILVA (only NR);Bacteria;Chrysiogenetota;Chrysiogenetes;";"100.0";"14.4";"8";"8";"8";"0";"0";"457175";"391199"
"V4mis2";"SILVA (only NR);Bacteria;Chrysiogenetota;Chrysiogenetes;Chrysiogenales;";"100.0";"14.4";"8";"8";"8";"0";"0";"457175";"391199"
"V4mis2";"SILVA (only NR);Bacteria;Chrysiogenetota;Chrysiogenetes;Chrysiogenales;Chrysiogenaceae;";"100.0";"14.4";"8";"8";"8";"0";"0";"457175";"391199"
"V4mis2";"SILVA (only NR);Bacteria;Chrysiogenetota;Chrysiogenetes;Chrysiogenales;Chrysiogenaceae;Chrysiogenes;";"100.0";"14.4";"1";"1";"1";"0";"0";"457182";"391206"
"V4mis2";"SILVA (only NR);Bacteria;Chrysiogenetota;Chrysiogenetes;Chrysiogenales;Chrysiogenaceae;Desulfurispira;";"100.0";"14.4";"2";"2";"2";"0";"0";"457181";"391205"
"V4mis2";"SILVA (only NR);Bacteria;Chrysiogenetota;Chrysiogenetes;Chrysiogenales;Chrysiogenaceae;Desulfurispirillum;";"100.0";"14.4";"5";"5";"5";"0";"0";"457178";"391202"
"V4mis2";"SILVA (only NR);Bacteria;Cloacimonadota;";"95.3";"14.4";"299";"299";"285";"14";"0";"456884";"390922"
"V4mis2";"SILVA (only NR);Bacteria;Cloacimonadota;Cloacimonadia;";"95.3";"14.4";"299";"299";"285";"14";"0";"456884";"390922"
"V4mis2";"SILVA (only NR);Bacteria;Cloacimonadota;Cloacimonadia;Cloacimonadales;";"95.2";"14.4";"289";"289";"275";"14";"0";"456894";"390932"
"V4mis2";"SILVA (only NR);Bacteria;Cloacimonadota;Cloacimonadia;Cloacimonadales;CW-1 termite group;";"100.0";"14.4";"9";"9";"9";"0";"0";"457174";"391198"
"V4mis2";"SILVA (only NR);Bacteria;Cloacimonadota;Cloacimonadia;Cloacimonadales;Cloacimonadaceae;";"93.9";"14.4";"165";"165";"155";"10";"0";"457018";"391052"
"V4mis2";"SILVA (only NR);Bacteria;Cloacimonadota;Cloacimonadia;Cloacimonadales;Cloacimonadaceae;C-2;";"66.7";"14.4";"3";"3";"2";"1";"0";"457180";"391205"
"V4mis2";"SILVA (only NR);Bacteria;Cloacimonadota;Cloacimonadia;Cloacimonadales;Cloacimonadaceae;Candidatus Cloacimonas;";"96.7";"14.4";"90";"90";"87";"3";"0";"457093";"391120"
"V4mis2";"SILVA (only NR);Bacteria;Cloacimonadota;Cloacimonadia;Cloacimonadales;Cloacimonadaceae;LNR A2-18;";"100.0";"14.4";"11";"11";"11";"0";"0";"457172";"391196"
"V4mis2";"SILVA (only NR);Bacteria;Cloacimonadota;Cloacimonadia;Cloacimonadales;Cloacimonadaceae;W5;";"88.7";"14.4";"53";"53";"47";"6";"0";"457130";"391160"
"V4mis2";"SILVA (only NR);Bacteria;Cloacimonadota;Cloacimonadia;Cloacimonadales;GZKB75;";"88.9";"14.4";"9";"9";"8";"1";"0";"457174";"391199"
"V4mis2";"SILVA (only NR);Bacteria;Cloacimonadota;Cloacimonadia;Cloacimonadales;LK-44f;";"100.0";"14.4";"13";"13";"13";"0";"0";"457170";"391194"
"V4mis2";"SILVA (only NR);Bacteria;Cloacimonadota;Cloacimonadia;Cloacimonadales;MSBL8;";"100.0";"14.4";"26";"26";"26";"0";"0";"457157";"391181"
"V4mis2";"SILVA (only NR);Bacteria;Cloacimonadota;Cloacimonadia;Cloacimonadales;NK-L14;";"100.0";"14.4";"4";"4";"4";"0";"0";"457179";"391203"
"V4mis2";"SILVA (only NR);Bacteria;Cloacimonadota;Cloacimonadia;Cloacimonadales;PBS-18;";"87.5";"14.4";"16";"16";"14";"2";"0";"457167";"391193"
"V4mis2";"SILVA (only NR);Bacteria;Cloacimonadota;Cloacimonadia;Cloacimonadales;SHA-41;";"80.0";"14.4";"5";"5";"4";"1";"0";"457178";"391203"
"V4mis2";"SILVA (only NR);Bacteria;Cloacimonadota;Cloacimonadia;Cloacimonadales;SHA-4;";"100.0";"14.4";"5";"5";"5";"0";"0";"457178";"391202"
"V4mis2";"SILVA (only NR);Bacteria;Cloacimonadota;Cloacimonadia;Cloacimonadales;W27;";"100.0";"14.4";"31";"31";"31";"0";"0";"457152";"391176"
"V4mis2";"SILVA (only NR);Bacteria;Cloacimonadota;Cloacimonadia;MSBL2;";"100.0";"14.4";"10";"10";"10";"0";"0";"457173";"391197"
"V4mis2";"SILVA (only NR);Bacteria;Coprothermobacterota;";"86.7";"14.4";"98";"98";"85";"13";"0";"457085";"391122"
"V4mis2";"SILVA (only NR);Bacteria;Coprothermobacterota;Coprothermobacteria;";"86.7";"14.4";"98";"98";"85";"13";"0";"457085";"391122"
"V4mis2";"SILVA (only NR);Bacteria;Coprothermobacterota;Coprothermobacteria;Coprothermobacterales;";"86.7";"14.4";"98";"98";"85";"13";"0";"457085";"391122"
"V4mis2";"SILVA (only NR);Bacteria;Coprothermobacterota;Coprothermobacteria;Coprothermobacterales;Coprothermobacteraceae;";"86.7";"14.4";"98";"98";"85";"13";"0";"457085";"391122"
"V4mis2";"SILVA (only NR);Bacteria;Coprothermobacterota;Coprothermobacteria;Coprothermobacterales;Coprothermobacteraceae;Coprothermobacter;";"86.7";"14.4";"98";"98";"85";"13";"0";"457085";"391122"
"V4mis2";"SILVA (only NR);Bacteria;Cyanobacteria;";"92.4";"14.6";"9718";"9717";"8982";"735";"1";"447466";"382225"
"V4mis2";"SILVA (only NR);Bacteria;Cyanobacteria;Cyanobacteriia;";"92.2";"14.6";"9141";"9140";"8426";"714";"1";"448043";"382781"
"V4mis2";"SILVA (only NR);Bacteria;Cyanobacteria;Cyanobacteriia;Chloroplast;";"89.0";"14.5";"4441";"4440";"3952";"488";"1";"452743";"387255"
"V4mis2";"SILVA (only NR);Bacteria;Cyanobacteria;Cyanobacteriia;Cyanobacteriales;";"95.4";"14.5";"2985";"2985";"2849";"136";"0";"454198";"388358"
"V4mis2";"SILVA (only NR);Bacteria;Cyanobacteria;Cyanobacteriia;Cyanobacteriales;Chamaesiphonaceae;";"100.0";"14.4";"4";"4";"4";"0";"0";"457179";"391203"
"V4mis2";"SILVA (only NR);Bacteria;Cyanobacteria;Cyanobacteriia;Cyanobacteriales;Chamaesiphonaceae;Chamaesiphon PCC-6605;";"100.0";"14.4";"4";"4";"4";"0";"0";"457179";"391203"
"V4mis2";"SILVA (only NR);Bacteria;Cyanobacteria;Cyanobacteriia;Cyanobacteriales;Chroococcidiopsaceae;";"97.0";"14.4";"298";"298";"289";"9";"0";"456885";"390918"
"V4mis2";"SILVA (only NR);Bacteria;Cyanobacteria;Cyanobacteriia;Cyanobacteriales;Chroococcidiopsaceae;Aliterella;";"97.3";"14.4";"37";"37";"36";"1";"0";"457146";"391171"
"V4mis2";"SILVA (only NR);Bacteria;Cyanobacteria;Cyanobacteriia;Cyanobacteriales;Chroococcidiopsaceae;Chlorogloea SAG 10.99;";"100.0";"14.4";"3";"3";"3";"0";"0";"457180";"391204"
"V4mis2";"SILVA (only NR);Bacteria;Cyanobacteria;Cyanobacteriia;Cyanobacteriales;Chroococcidiopsaceae;Chroococcidiopsis CC1;";"100.0";"14.4";"8";"8";"8";"0";"0";"457175";"391199"
"V4mis2";"SILVA (only NR);Bacteria;Cyanobacteria;Cyanobacteriia;Cyanobacteriales;Chroococcidiopsaceae;Chroococcidiopsis PCC 7203;";"100.0";"14.4";"19";"19";"19";"0";"0";"457164";"391188"
"V4mis2";"SILVA (only NR);Bacteria;Cyanobacteria;Cyanobacteriia;Cyanobacteriales;Chroococcidiopsaceae;Chroococcidiopsis SAG 2023;";"100.0";"14.4";"29";"29";"29";"0";"0";"457154";"391178"
"V4mis2";"SILVA (only NR);Bacteria;Cyanobacteria;Cyanobacteriia;Cyanobacteriales;Chroococcidiopsaceae;Crinalium SAG 22.89;";"100.0";"14.4";"10";"10";"10";"0";"0";"457173";"391197"
"V4mis2";"SILVA (only NR);Bacteria;Cyanobacteria;Cyanobacteriia;Cyanobacteriales;Chroococcidiopsaceae;Dapisostemonum CCIBt 3536;";"100.0";"14.4";"10";"10";"10";"0";"0";"457173";"391197"
"V4mis2";"SILVA (only NR);Bacteria;Cyanobacteria;Cyanobacteriia;Cyanobacteriales;Chroococcidiopsaceae;Gloeocapsa PCC-7428;";"100.0";"14.4";"8";"8";"8";"0";"0";"457175";"391199"
"V4mis2";"SILVA (only NR);Bacteria;Cyanobacteria;Cyanobacteriia;Cyanobacteriales;Chroococcidiopsaceae;Myxosarcina SAG 30.84;";"100.0";"14.4";"10";"10";"10";"0";"0";"457173";"391197"
"V4mis2";"SILVA (only NR);Bacteria;Cyanobacteria;Cyanobacteriia;Cyanobacteriales;Chroococcidiopsaceae;uncultured;";"95.0";"14.4";"161";"161";"153";"8";"0";"457022";"391054"
"V4mis2";"SILVA (only NR);Bacteria;Cyanobacteria;Cyanobacteriia;Cyanobacteriales;Coleofasciculaceae;";"89.8";"14.4";"402";"402";"361";"41";"0";"456781";"390846"
"V4mis2";"SILVA (only NR);Bacteria;Cyanobacteria;Cyanobacteriia;Cyanobacteriales;Coleofasciculaceae;Caldora VP642b;";"100.0";"14.4";"6";"6";"6";"0";"0";"457177";"391201"
"V4mis2";"SILVA (only NR);Bacteria;Cyanobacteria;Cyanobacteriia;Cyanobacteriales;Coleofasciculaceae;Coleofasciculus PCC-7420;";"86.3";"14.4";"291";"291";"251";"40";"0";"456892";"390956"
"V4mis2";"SILVA (only NR);Bacteria;Cyanobacteria;Cyanobacteriia;Cyanobacteriales;Coleofasciculaceae;Microcoleus CENA344;";"100.0";"14.4";"2";"2";"2";"0";"0";"457181";"391205"
"V4mis2";"SILVA (only NR);Bacteria;Cyanobacteria;Cyanobacteriia;Cyanobacteriales;Coleofasciculaceae;Microcoleus Es-Yyy1400;";"100.0";"14.4";"7";"7";"7";"0";"0";"457176";"391200"
"V4mis2";"SILVA (only NR);Bacteria;Cyanobacteria;Cyanobacteriia;Cyanobacteriales;Coleofasciculaceae;Microcoleus PCC-7113;";"100.0";"14.4";"4";"4";"4";"0";"0";"457179";"391203"
"V4mis2";"SILVA (only NR);Bacteria;Cyanobacteria;Cyanobacteriia;Cyanobacteriales;Coleofasciculaceae;Microcoleus SAG 1449-1a;";"100.0";"14.4";"20";"20";"20";"0";"0";"457163";"391187"
"V4mis2";"SILVA (only NR);Bacteria;Cyanobacteria;Cyanobacteriia;Cyanobacteriales;Coleofasciculaceae;Moorea;";"100.0";"14.4";"9";"9";"9";"0";"0";"457174";"391198"
"V4mis2";"SILVA (only NR);Bacteria;Cyanobacteria;Cyanobacteriia;Cyanobacteriales;Coleofasciculaceae;Potamolinea 1PC;";"100.0";"14.4";"6";"6";"6";"0";"0";"457177";"391201"
"V4mis2";"SILVA (only NR);Bacteria;Cyanobacteria;Cyanobacteriia;Cyanobacteriales;Coleofasciculaceae;Symploca PCC-8002;";"100.0";"14.4";"5";"5";"5";"0";"0";"457178";"391202"
"V4mis2";"SILVA (only NR);Bacteria;Cyanobacteria;Cyanobacteriia;Cyanobacteriales;Coleofasciculaceae;Symplocastrum CPER-KK1;";"100.0";"14.4";"4";"4";"4";"0";"0";"457179";"391203"
"V4mis2";"SILVA (only NR);Bacteria;Cyanobacteria;Cyanobacteriia;Cyanobacteriales;Coleofasciculaceae;Wilmottia Ant-Ph58;";"96.2";"14.4";"26";"26";"25";"1";"0";"457157";"391182"
"V4mis2";"SILVA (only NR);Bacteria;Cyanobacteria;Cyanobacteriia;Cyanobacteriales;Coleofasciculaceae;uncultured;";"100.0";"14.4";"17";"17";"17";"0";"0";"457166";"391190"
"V4mis2";"SILVA (only NR);Bacteria;Cyanobacteria;Cyanobacteriia;Cyanobacteriales;Cyanobacteriaceae;";"96.0";"14.4";"125";"125";"120";"5";"0";"457058";"391087"
"V4mis2";"SILVA (only NR);Bacteria;Cyanobacteria;Cyanobacteriia;Cyanobacteriales;Cyanobacteriaceae;Annamia HOs24;";"90.0";"14.4";"10";"10";"9";"1";"0";"457173";"391198"
"V4mis2";"SILVA (only NR);Bacteria;Cyanobacteria;Cyanobacteriia;Cyanobacteriales;Cyanobacteriaceae;Chroococcus HUW 799;";"100.0";"14.4";"2";"2";"2";"0";"0";"457181";"391205"
"V4mis2";"SILVA (only NR);Bacteria;Cyanobacteria;Cyanobacteriia;Cyanobacteriales;Cyanobacteriaceae;Cyanobacterium PCC-10605;";"100.0";"14.4";"7";"7";"7";"0";"0";"457176";"391200"
"V4mis2";"SILVA (only NR);Bacteria;Cyanobacteria;Cyanobacteriia;Cyanobacteriales;Cyanobacteriaceae;Cyanobacterium PCC-7202;";"88.9";"14.4";"9";"9";"8";"1";"0";"457174";"391199"
"V4mis2";"SILVA (only NR);Bacteria;Cyanobacteria;Cyanobacteriia;Cyanobacteriales;Cyanobacteriaceae;Geitlerinema LD9;";"100.0";"14.4";"3";"3";"3";"0";"0";"457180";"391204"
"V4mis2";"SILVA (only NR);Bacteria;Cyanobacteria;Cyanobacteriia;Cyanobacteriales;Cyanobacteriaceae;Geminobacterium;";"100.0";"14.4";"17";"17";"17";"0";"0";"457166";"391190"
"V4mis2";"SILVA (only NR);Bacteria;Cyanobacteria;Cyanobacteriia;Cyanobacteriales;Cyanobacteriaceae;Geminocystis PCC-6308;";"94.1";"14.4";"17";"17";"16";"1";"0";"457166";"391191"
"V4mis2";"SILVA (only NR);Bacteria;Cyanobacteria;Cyanobacteriia;Cyanobacteriales;Cyanobacteriaceae;Merismopedia AICB1015;";"100.0";"14.4";"2";"2";"2";"0";"0";"457181";"391205"
"V4mis2";"SILVA (only NR);Bacteria;Cyanobacteria;Cyanobacteriia;Cyanobacteriales;Cyanobacteriaceae;Symphothece PCC-7002;";"100.0";"14.4";"29";"29";"29";"0";"0";"457154";"391178"
"V4mis2";"SILVA (only NR);Bacteria;Cyanobacteria;Cyanobacteriia;Cyanobacteriales;Cyanobacteriaceae;Synechocystis SAG 90.79;";"100.0";"14.4";"3";"3";"3";"0";"0";"457180";"391204"
"V4mis2";"SILVA (only NR);Bacteria;Cyanobacteria;Cyanobacteriia;Cyanobacteriales;Cyanobacteriaceae;uncultured;";"91.3";"14.4";"23";"23";"21";"2";"0";"457160";"391186"
"V4mis2";"SILVA (only NR);Bacteria;Cyanobacteria;Cyanobacteriia;Cyanobacteriales;Cyanobacteriales Incertae Sedis;";"100.0";"14.4";"17";"17";"17";"0";"0";"457166";"391190"
"V4mis2";"SILVA (only NR);Bacteria;Cyanobacteria;Cyanobacteriia;Cyanobacteriales;Cyanobacteriales Incertae Sedis;Microseira Carmichael-Alabama;";"100.0";"14.4";"11";"11";"11";"0";"0";"457172";"391196"
"V4mis2";"SILVA (only NR);Bacteria;Cyanobacteria;Cyanobacteriia;Cyanobacteriales;Cyanobacteriales Incertae Sedis;Phormidium SAG 81.79;";"100.0";"14.4";"2";"2";"2";"0";"0";"457181";"391205"
"V4mis2";"SILVA (only NR);Bacteria;Cyanobacteria;Cyanobacteriia;Cyanobacteriales;Cyanobacteriales Incertae Sedis;uncultured;";"100.0";"14.4";"2";"2";"2";"0";"0";"457181";"391205"
"V4mis2";"SILVA (only NR);Bacteria;Cyanobacteria;Cyanobacteriia;Cyanobacteriales;Desertifilaceae;";"96.8";"14.4";"31";"31";"30";"1";"0";"457152";"391177"
"V4mis2";"SILVA (only NR);Bacteria;Cyanobacteria;Cyanobacteriia;Cyanobacteriales;Desertifilaceae;CENA533;";"100.0";"14.4";"2";"2";"2";"0";"0";"457181";"391205"
"V4mis2";"SILVA (only NR);Bacteria;Cyanobacteria;Cyanobacteriia;Cyanobacteriales;Desertifilaceae;Desertifilum KR2012-2;";"100.0";"14.4";"3";"3";"3";"0";"0";"457180";"391204"
"V4mis2";"SILVA (only NR);Bacteria;Cyanobacteria;Cyanobacteriia;Cyanobacteriales;Desertifilaceae;Hormoscilla SI04-45;";"91.7";"14.4";"12";"12";"11";"1";"0";"457171";"391196"
"V4mis2";"SILVA (only NR);Bacteria;Cyanobacteria;Cyanobacteriia;Cyanobacteriales;Desertifilaceae;Oscillatoria SAG8.92;";"100.0";"14.4";"2";"2";"2";"0";"0";"457181";"391205"
"V4mis2";"SILVA (only NR);Bacteria;Cyanobacteria;Cyanobacteriia;Cyanobacteriales;Desertifilaceae;Oscillatoria;";"100.0";"14.4";"1";"1";"1";"0";"0";"457182";"391206"
"V4mis2";"SILVA (only NR);Bacteria;Cyanobacteria;Cyanobacteriia;Cyanobacteriales;Desertifilaceae;Roseofilum AO1-A;";"100.0";"14.4";"9";"9";"9";"0";"0";"457174";"391198"
"V4mis2";"SILVA (only NR);Bacteria;Cyanobacteria;Cyanobacteriia;Cyanobacteriales;Geitlerinemaceae;";"92.6";"14.4";"27";"27";"25";"2";"0";"457156";"391182"
"V4mis2";"SILVA (only NR);Bacteria;Cyanobacteria;Cyanobacteriia;Cyanobacteriales;Geitlerinemaceae;Geitlerinema PCC-7105;";"90.9";"14.4";"22";"22";"20";"2";"0";"457161";"391187"
"V4mis2";"SILVA (only NR);Bacteria;Cyanobacteria;Cyanobacteriia;Cyanobacteriales;Geitlerinemaceae;Geitlerinema PCC-9228;";"100.0";"14.4";"4";"4";"4";"0";"0";"457179";"391203"
"V4mis2";"SILVA (only NR);Bacteria;Cyanobacteria;Cyanobacteriia;Cyanobacteriales;Gloeocapsaceae;";"100.0";"14.4";"18";"18";"18";"0";"0";"457165";"391189"
"V4mis2";"SILVA (only NR);Bacteria;Cyanobacteria;Cyanobacteriia;Cyanobacteriales;Gloeocapsaceae;Gloeocapsa;";"100.0";"14.4";"18";"18";"18";"0";"0";"457165";"391189"
"V4mis2";"SILVA (only NR);Bacteria;Cyanobacteria;Cyanobacteriia;Cyanobacteriales;Microcystaceae;";"94.5";"14.4";"182";"182";"172";"10";"0";"457001";"391035"
"V4mis2";"SILVA (only NR);Bacteria;Cyanobacteria;Cyanobacteriia;Cyanobacteriales;Microcystaceae;Aphanotece;";"100.0";"14.4";"1";"1";"1";"0";"0";"457182";"391206"
"V4mis2";"SILVA (only NR);Bacteria;Cyanobacteria;Cyanobacteriia;Cyanobacteriales;Microcystaceae;Atelocyanobacterium (UCYN-A);";"100.0";"14.4";"3";"3";"3";"0";"0";"457180";"391204"
"V4mis2";"SILVA (only NR);Bacteria;Cyanobacteria;Cyanobacteriia;Cyanobacteriales;Microcystaceae;Chalicogloea CCALA 975;";"100.0";"14.4";"11";"11";"11";"0";"0";"457172";"391196"
"V4mis2";"SILVA (only NR);Bacteria;Cyanobacteria;Cyanobacteriia;Cyanobacteriales;Microcystaceae;Crocosphaera;";"100.0";"14.4";"1";"1";"1";"0";"0";"457182";"391206"
"V4mis2";"SILVA (only NR);Bacteria;Cyanobacteria;Cyanobacteriia;Cyanobacteriales;Microcystaceae;Cyanothece ATCC 51142 (UCYN-C);";"100.0";"14.4";"3";"3";"3";"0";"0";"457180";"391204"
"V4mis2";"SILVA (only NR);Bacteria;Cyanobacteria;Cyanobacteriia;Cyanobacteriales;Microcystaceae;Cyanothece PCC-7424;";"100.0";"14.4";"6";"6";"6";"0";"0";"457177";"391201"
"V4mis2";"SILVA (only NR);Bacteria;Cyanobacteria;Cyanobacteriia;Cyanobacteriales;Microcystaceae;Cyanothece PCC-8801;";"100.0";"14.4";"4";"4";"4";"0";"0";"457179";"391203"
"V4mis2";"SILVA (only NR);Bacteria;Cyanobacteria;Cyanobacteriia;Cyanobacteriales;Microcystaceae;Gloeothece PCC-6501;";"100.0";"14.4";"3";"3";"3";"0";"0";"457180";"391204"
"V4mis2";"SILVA (only NR);Bacteria;Cyanobacteria;Cyanobacteriia;Cyanobacteriales;Microcystaceae;Merismopedia 0BB39S01;";"66.7";"14.4";"3";"3";"2";"1";"0";"457180";"391205"
"V4mis2";"SILVA (only NR);Bacteria;Cyanobacteria;Cyanobacteriia;Cyanobacteriales;Microcystaceae;Microcystis PCC-7914;";"90.4";"14.4";"73";"73";"66";"7";"0";"457110";"391141"
"V4mis2";"SILVA (only NR);Bacteria;Cyanobacteria;Cyanobacteriia;Cyanobacteriales;Microcystaceae;Pleurocapsa PCC-7327;";"100.0";"14.4";"5";"5";"5";"0";"0";"457178";"391202"
"V4mis2";"SILVA (only NR);Bacteria;Cyanobacteria;Cyanobacteriia;Cyanobacteriales;Microcystaceae;SU2 symbiont group;";"100.0";"14.4";"7";"7";"7";"0";"0";"457176";"391200"
"V4mis2";"SILVA (only NR);Bacteria;Cyanobacteria;Cyanobacteriia;Cyanobacteriales;Microcystaceae;Snowella 0TU37S04;";"100.0";"14.4";"12";"12";"12";"0";"0";"457171";"391195"
"V4mis2";"SILVA (only NR);Bacteria;Cyanobacteria;Cyanobacteriia;Cyanobacteriales;Microcystaceae;Synechocystis BDHKU-20401;";"83.3";"14.4";"12";"12";"10";"2";"0";"457171";"391197"
"V4mis2";"SILVA (only NR);Bacteria;Cyanobacteria;Cyanobacteriia;Cyanobacteriales;Microcystaceae;Synechocystis CCALA 700;";"100.0";"14.4";"4";"4";"4";"0";"0";"457179";"391203"
"V4mis2";"SILVA (only NR);Bacteria;Cyanobacteria;Cyanobacteriia;Cyanobacteriales;Microcystaceae;Synechocystis PCC-6803;";"100.0";"14.4";"27";"27";"27";"0";"0";"457156";"391180"
"V4mis2";"SILVA (only NR);Bacteria;Cyanobacteria;Cyanobacteriia;Cyanobacteriales;Microcystaceae;UCYN-C;";"100.0";"14.4";"2";"2";"2";"0";"0";"457181";"391205"
"V4mis2";"SILVA (only NR);Bacteria;Cyanobacteria;Cyanobacteriia;Cyanobacteriales;Microcystaceae;uncultured;";"100.0";"14.4";"2";"2";"2";"0";"0";"457181";"391205"
"V4mis2";"SILVA (only NR);Bacteria;Cyanobacteria;Cyanobacteriia;Cyanobacteriales;Nostocaceae;";"97.2";"14.5";"1092";"1092";"1061";"31";"0";"456091";"390146"
"V4mis2";"SILVA (only NR);Bacteria;Cyanobacteria;Cyanobacteriia;Cyanobacteriales;Nostocaceae;Aetokthonos AEL04;";"100.0";"14.4";"2";"2";"2";"0";"0";"457181";"391205"
"V4mis2";"SILVA (only NR);Bacteria;Cyanobacteria;Cyanobacteriia;Cyanobacteriales;Nostocaceae;Anabaena BECID22;";"100.0";"14.4";"3";"3";"3";"0";"0";"457180";"391204"
"V4mis2";"SILVA (only NR);Bacteria;Cyanobacteria;Cyanobacteriia;Cyanobacteriales;Nostocaceae;Anabaena HBU1;";"100.0";"14.4";"2";"2";"2";"0";"0";"457181";"391205"
"V4mis2";"SILVA (only NR);Bacteria;Cyanobacteria;Cyanobacteriia;Cyanobacteriales;Nostocaceae;Anabaena PCC-7108;";"100.0";"14.4";"5";"5";"5";"0";"0";"457178";"391202"
"V4mis2";"SILVA (only NR);Bacteria;Cyanobacteria;Cyanobacteriia;Cyanobacteriales;Nostocaceae;Anabaena PCC-7122;";"100.0";"14.4";"23";"23";"23";"0";"0";"457160";"391184"
"V4mis2";"SILVA (only NR);Bacteria;Cyanobacteria;Cyanobacteriia;Cyanobacteriales;Nostocaceae;Anabaena XPORK15F;";"100.0";"14.4";"5";"5";"5";"0";"0";"457178";"391202"
"V4mis2";"SILVA (only NR);Bacteria;Cyanobacteria;Cyanobacteriia;Cyanobacteriales;Nostocaceae;Anabaenopsis;";"100.0";"14.4";"1";"1";"1";"0";"0";"457182";"391206"
"V4mis2";"SILVA (only NR);Bacteria;Cyanobacteria;Cyanobacteriia;Cyanobacteriales;Nostocaceae;Ancylothrix 8PC;";"100.0";"14.4";"4";"4";"4";"0";"0";"457179";"391203"
"V4mis2";"SILVA (only NR);Bacteria;Cyanobacteria;Cyanobacteriia;Cyanobacteriales;Nostocaceae;Aphanizomenon MDT14a;";"90.9";"14.4";"11";"11";"10";"1";"0";"457172";"391197"
"V4mis2";"SILVA (only NR);Bacteria;Cyanobacteria;Cyanobacteriia;Cyanobacteriales;Nostocaceae;Aphanizomenon NIES81;";"96.3";"14.4";"27";"27";"26";"1";"0";"457156";"391181"
"V4mis2";"SILVA (only NR);Bacteria;Cyanobacteria;Cyanobacteriia;Cyanobacteriales;Nostocaceae;Calothrix NIES-2100;";"100.0";"14.4";"2";"2";"2";"0";"0";"457181";"391205"
"V4mis2";"SILVA (only NR);Bacteria;Cyanobacteria;Cyanobacteriia;Cyanobacteriales;Nostocaceae;Calothrix PCC-6303;";"94.4";"14.4";"89";"89";"84";"5";"0";"457094";"391123"
"V4mis2";"SILVA (only NR);Bacteria;Cyanobacteria;Cyanobacteriia;Cyanobacteriales;Nostocaceae;Calothrix PCC-7507;";"100.0";"14.4";"3";"3";"3";"0";"0";"457180";"391204"
"V4mis2";"SILVA (only NR);Bacteria;Cyanobacteria;Cyanobacteriia;Cyanobacteriales;Nostocaceae;Calothrix PMC232.04;";"100.0";"14.4";"3";"3";"3";"0";"0";"457180";"391204"
"V4mis2";"SILVA (only NR);Bacteria;Cyanobacteria;Cyanobacteriia;Cyanobacteriales;Nostocaceae;Calothrix UAM 374;";"100.0";"14.4";"11";"11";"11";"0";"0";"457172";"391196"
"V4mis2";"SILVA (only NR);Bacteria;Cyanobacteria;Cyanobacteriia;Cyanobacteriales;Nostocaceae;Chlorogloeopsis PCC-7518;";"100.0";"14.4";"8";"8";"8";"0";"0";"457175";"391199"
"V4mis2";"SILVA (only NR);Bacteria;Cyanobacteria;Cyanobacteriia;Cyanobacteriales;Nostocaceae;Cuspidothrix LMECYA 163;";"100.0";"14.4";"10";"10";"10";"0";"0";"457173";"391197"
"V4mis2";"SILVA (only NR);Bacteria;Cyanobacteria;Cyanobacteriia;Cyanobacteriales;Nostocaceae;Cylindrospermopsis CRJ1;";"94.1";"14.4";"17";"17";"16";"1";"0";"457166";"391191"
"V4mis2";"SILVA (only NR);Bacteria;Cyanobacteria;Cyanobacteriia;Cyanobacteriales;Nostocaceae;Cylindrospermum CENA33;";"100.0";"14.4";"2";"2";"2";"0";"0";"457181";"391205"
"V4mis2";"SILVA (only NR);Bacteria;Cyanobacteria;Cyanobacteriia;Cyanobacteriales;Nostocaceae;Cylindrospermum NQAIF308;";"100.0";"14.4";"2";"2";"2";"0";"0";"457181";"391205"
"V4mis2";"SILVA (only NR);Bacteria;Cyanobacteria;Cyanobacteriia;Cyanobacteriales;Nostocaceae;Cylindrospermum PCC-7417;";"100.0";"14.4";"9";"9";"9";"0";"0";"457174";"391198"
"V4mis2";"SILVA (only NR);Bacteria;Cyanobacteria;Cyanobacteriia;Cyanobacteriales;Nostocaceae;Cylindrospermum PMC238.04;";"100.0";"14.4";"2";"2";"2";"0";"0";"457181";"391205"
"V4mis2";"SILVA (only NR);Bacteria;Cyanobacteria;Cyanobacteriia;Cyanobacteriales;Nostocaceae;Cylindrospermum SAG 11.82;";"100.0";"14.4";"2";"2";"2";"0";"0";"457181";"391205"
"V4mis2";"SILVA (only NR);Bacteria;Cyanobacteria;Cyanobacteriia;Cyanobacteriales;Nostocaceae;Desmonostoc PCC-6302;";"100.0";"14.4";"3";"3";"3";"0";"0";"457180";"391204"
"V4mis2";"SILVA (only NR);Bacteria;Cyanobacteria;Cyanobacteriia;Cyanobacteriales;Nostocaceae;Desmonostoc PCC-7422;";"94.7";"14.4";"38";"38";"36";"2";"0";"457145";"391171"
"V4mis2";"SILVA (only NR);Bacteria;Cyanobacteria;Cyanobacteriia;Cyanobacteriales;Nostocaceae;Dolichospermum NIES41;";"100.0";"14.4";"52";"52";"52";"0";"0";"457131";"391155"
"V4mis2";"SILVA (only NR);Bacteria;Cyanobacteria;Cyanobacteriia;Cyanobacteriales;Nostocaceae;Ewamiania TS0513;";"50.0";"14.4";"2";"2";"1";"1";"0";"457181";"391206"
"V4mis2";"SILVA (only NR);Bacteria;Cyanobacteria;Cyanobacteriia;Cyanobacteriales;Nostocaceae;Fischerella CENA298;";"100.0";"14.4";"2";"2";"2";"0";"0";"457181";"391205"
"V4mis2";"SILVA (only NR);Bacteria;Cyanobacteria;Cyanobacteriia;Cyanobacteriales;Nostocaceae;Fischerella PCC-9339;";"98.1";"14.4";"54";"54";"53";"1";"0";"457129";"391154"
"V4mis2";"SILVA (only NR);Bacteria;Cyanobacteria;Cyanobacteriia;Cyanobacteriales;Nostocaceae;Fortiea PCC-7126;";"100.0";"14.4";"1";"1";"1";"0";"0";"457182";"391206"
"V4mis2";"SILVA (only NR);Bacteria;Cyanobacteria;Cyanobacteriia;Cyanobacteriales;Nostocaceae;Gloeotrichia PYH6;";"100.0";"14.4";"2";"2";"2";"0";"0";"457181";"391205"
"V4mis2";"SILVA (only NR);Bacteria;Cyanobacteria;Cyanobacteriia;Cyanobacteriales;Nostocaceae;Gloeotrichia SAG 32.84;";"66.7";"14.4";"3";"3";"2";"1";"0";"457180";"391205"
"V4mis2";"SILVA (only NR);Bacteria;Cyanobacteria;Cyanobacteriia;Cyanobacteriales;Nostocaceae;Halotia CENA158;";"100.0";"14.4";"3";"3";"3";"0";"0";"457180";"391204"
"V4mis2";"SILVA (only NR);Bacteria;Cyanobacteria;Cyanobacteriia;Cyanobacteriales;Nostocaceae;Iphinoe LOS-B1;";"100.0";"14.4";"4";"4";"4";"0";"0";"457179";"391203"
"V4mis2";"SILVA (only NR);Bacteria;Cyanobacteria;Cyanobacteriia;Cyanobacteriales;Nostocaceae;Mastigocladopsis PCC-10914;";"94.4";"14.4";"18";"18";"17";"1";"0";"457165";"391190"
"V4mis2";"SILVA (only NR);Bacteria;Cyanobacteria;Cyanobacteriia;Cyanobacteriales;Nostocaceae;Mastigocoleus BC008;";"100.0";"14.4";"2";"2";"2";"0";"0";"457181";"391205"
"V4mis2";"SILVA (only NR);Bacteria;Cyanobacteria;Cyanobacteriia;Cyanobacteriales;Nostocaceae;Nodularia PCC-9350;";"100.0";"14.4";"41";"41";"41";"0";"0";"457142";"391166"
"V4mis2";"SILVA (only NR);Bacteria;Cyanobacteria;Cyanobacteriia;Cyanobacteriales;Nostocaceae;Nostoc 0708;";"100.0";"14.4";"1";"1";"1";"0";"0";"457182";"391206"
"V4mis2";"SILVA (only NR);Bacteria;Cyanobacteria;Cyanobacteriia;Cyanobacteriales;Nostocaceae;Nostoc BDU-40302;";"85.7";"14.4";"7";"7";"6";"1";"0";"457176";"391201"
"V4mis2";"SILVA (only NR);Bacteria;Cyanobacteria;Cyanobacteriia;Cyanobacteriales;Nostocaceae;Nostoc PCC-7107;";"95.8";"14.4";"48";"48";"46";"2";"0";"457135";"391161"
"V4mis2";"SILVA (only NR);Bacteria;Cyanobacteria;Cyanobacteriia;Cyanobacteriales;Nostocaceae;Nostoc PCC-73102;";"98.6";"14.4";"145";"145";"143";"2";"0";"457038";"391064"
"V4mis2";"SILVA (only NR);Bacteria;Cyanobacteria;Cyanobacteriia;Cyanobacteriales;Nostocaceae;Nostoc PCC-7524;";"92.7";"14.4";"55";"55";"51";"4";"0";"457128";"391156"
"V4mis2";"SILVA (only NR);Bacteria;Cyanobacteria;Cyanobacteriia;Cyanobacteriales;Nostocaceae;Nostoc PCC-8976;";"96.8";"14.4";"31";"31";"30";"1";"0";"457152";"391177"
"V4mis2";"SILVA (only NR);Bacteria;Cyanobacteria;Cyanobacteriia;Cyanobacteriales;Nostocaceae;Nostoc SAG 60.79;";"100.0";"14.4";"6";"6";"6";"0";"0";"457177";"391201"
"V4mis2";"SILVA (only NR);Bacteria;Cyanobacteria;Cyanobacteriia;Cyanobacteriales;Nostocaceae;Nostoc;";"100.0";"14.4";"1";"1";"1";"0";"0";"457182";"391206"
"V4mis2";"SILVA (only NR);Bacteria;Cyanobacteria;Cyanobacteriia;Cyanobacteriales;Nostocaceae;Petalonema ANT.LG2.8;";"100.0";"14.4";"8";"8";"8";"0";"0";"457175";"391199"
"V4mis2";"SILVA (only NR);Bacteria;Cyanobacteria;Cyanobacteriia;Cyanobacteriales;Nostocaceae;Phyllonema CENA325;";"100.0";"14.4";"2";"2";"2";"0";"0";"457181";"391205"
"V4mis2";"SILVA (only NR);Bacteria;Cyanobacteria;Cyanobacteriia;Cyanobacteriales;Nostocaceae;Richelia HH01;";"100.0";"14.4";"5";"5";"5";"0";"0";"457178";"391202"
"V4mis2";"SILVA (only NR);Bacteria;Cyanobacteria;Cyanobacteriia;Cyanobacteriales;Nostocaceae;Rivularia PCC-7116;";"90.5";"14.4";"42";"42";"38";"4";"0";"457141";"391169"
"V4mis2";"SILVA (only NR);Bacteria;Cyanobacteria;Cyanobacteriia;Cyanobacteriales;Nostocaceae;Scytonema PCC-7110;";"94.7";"14.4";"19";"19";"18";"1";"0";"457164";"391189"
"V4mis2";"SILVA (only NR);Bacteria;Cyanobacteria;Cyanobacteriia;Cyanobacteriales;Nostocaceae;Scytonema UCFS19;";"100.0";"14.4";"4";"4";"4";"0";"0";"457179";"391203"
"V4mis2";"SILVA (only NR);Bacteria;Cyanobacteria;Cyanobacteriia;Cyanobacteriales;Nostocaceae;Scytonema UTEX 2349;";"97.3";"14.4";"37";"37";"36";"1";"0";"457146";"391171"
"V4mis2";"SILVA (only NR);Bacteria;Cyanobacteria;Cyanobacteriia;Cyanobacteriales;Nostocaceae;Scytonema VB-61278;";"100.0";"14.4";"25";"25";"25";"0";"0";"457158";"391182"
"V4mis2";"SILVA (only NR);Bacteria;Cyanobacteria;Cyanobacteriia;Cyanobacteriales;Nostocaceae;Sphaerospermopsis BCCUSP55;";"100.0";"14.4";"26";"26";"26";"0";"0";"457157";"391181"
"V4mis2";"SILVA (only NR);Bacteria;Cyanobacteria;Cyanobacteriia;Cyanobacteriales;Nostocaceae;Stigonema SAG 48.90;";"100.0";"14.4";"31";"31";"31";"0";"0";"457152";"391176"
"V4mis2";"SILVA (only NR);Bacteria;Cyanobacteria;Cyanobacteriia;Cyanobacteriales;Nostocaceae;Synechococcus PCC-7902;";"100.0";"14.4";"2";"2";"2";"0";"0";"457181";"391205"
"V4mis2";"SILVA (only NR);Bacteria;Cyanobacteria;Cyanobacteriia;Cyanobacteriales;Nostocaceae;Tolypothrix;";"98.4";"14.4";"63";"63";"62";"1";"0";"457120";"391145"
"V4mis2";"SILVA (only NR);Bacteria;Cyanobacteria;Cyanobacteriia;Cyanobacteriales;Nostocaceae;Trichormus HINDAK 2001-4;";"100.0";"14.4";"5";"5";"5";"0";"0";"457178";"391202"
"V4mis2";"SILVA (only NR);Bacteria;Cyanobacteria;Cyanobacteriia;Cyanobacteriales;Nostocaceae;uncultured;";"100.0";"14.4";"30";"30";"30";"0";"0";"457153";"391177"
"V4mis2";"SILVA (only NR);Bacteria;Cyanobacteria;Cyanobacteriia;Cyanobacteriales;Oscillatoriaceae;";"96.9";"14.4";"65";"65";"63";"2";"0";"457118";"391144"
"V4mis2";"SILVA (only NR);Bacteria;Cyanobacteria;Cyanobacteriia;Cyanobacteriales;Oscillatoriaceae;Oscillatoria PCC-10802;";"100.0";"14.4";"21";"21";"21";"0";"0";"457162";"391186"
"V4mis2";"SILVA (only NR);Bacteria;Cyanobacteria;Cyanobacteriia;Cyanobacteriales;Oscillatoriaceae;Oscillatoria PCC-6304;";"100.0";"14.4";"19";"19";"19";"0";"0";"457164";"391188"
"V4mis2";"SILVA (only NR);Bacteria;Cyanobacteria;Cyanobacteriia;Cyanobacteriales;Oscillatoriaceae;Oxynema BDU 92071;";"80.0";"14.4";"5";"5";"4";"1";"0";"457178";"391203"
"V4mis2";"SILVA (only NR);Bacteria;Cyanobacteria;Cyanobacteriia;Cyanobacteriales;Oscillatoriaceae;Phormidium ETS-05;";"100.0";"14.4";"5";"5";"5";"0";"0";"457178";"391202"
"V4mis2";"SILVA (only NR);Bacteria;Cyanobacteria;Cyanobacteriia;Cyanobacteriales;Oscillatoriaceae;Planktothricoides SR001;";"88.9";"14.4";"9";"9";"8";"1";"0";"457174";"391199"
"V4mis2";"SILVA (only NR);Bacteria;Cyanobacteria;Cyanobacteriia;Cyanobacteriales;Oscillatoriaceae;uncultured;";"100.0";"14.4";"6";"6";"6";"0";"0";"457177";"391201"
"V4mis2";"SILVA (only NR);Bacteria;Cyanobacteria;Cyanobacteriia;Cyanobacteriales;Paraspirulinaceae;";"93.5";"14.4";"62";"62";"58";"4";"0";"457121";"391149"
"V4mis2";"SILVA (only NR);Bacteria;Cyanobacteria;Cyanobacteriia;Cyanobacteriales;Paraspirulinaceae;ESFC-1;";"69.2";"14.4";"13";"13";"9";"4";"0";"457170";"391198"
"V4mis2";"SILVA (only NR);Bacteria;Cyanobacteria;Cyanobacteriia;Cyanobacteriales;Paraspirulinaceae;Halospirulina CCC Baja-95 Cl.2;";"100.0";"14.4";"10";"10";"10";"0";"0";"457173";"391197"
"V4mis2";"SILVA (only NR);Bacteria;Cyanobacteria;Cyanobacteriia;Cyanobacteriales;Paraspirulinaceae;Spirulina CCC Snake P-Y-85;";"100.0";"14.4";"12";"12";"12";"0";"0";"457171";"391195"
"V4mis2";"SILVA (only NR);Bacteria;Cyanobacteria;Cyanobacteriia;Cyanobacteriales;Paraspirulinaceae;Spirulina DRTO-55.2;";"100.0";"14.4";"4";"4";"4";"0";"0";"457179";"391203"
"V4mis2";"SILVA (only NR);Bacteria;Cyanobacteria;Cyanobacteriia;Cyanobacteriales;Paraspirulinaceae;Spirulina P7;";"100.0";"14.4";"4";"4";"4";"0";"0";"457179";"391203"
"V4mis2";"SILVA (only NR);Bacteria;Cyanobacteria;Cyanobacteriia;Cyanobacteriales;Paraspirulinaceae;Spirulina PCC-6313;";"100.0";"14.4";"6";"6";"6";"0";"0";"457177";"391201"
"V4mis2";"SILVA (only NR);Bacteria;Cyanobacteria;Cyanobacteriia;Cyanobacteriales;Paraspirulinaceae;Spirulina PCC-9445;";"100.0";"14.4";"5";"5";"5";"0";"0";"457178";"391202"
"V4mis2";"SILVA (only NR);Bacteria;Cyanobacteria;Cyanobacteriia;Cyanobacteriales;Paraspirulinaceae;uncultured;";"100.0";"14.4";"5";"5";"5";"0";"0";"457178";"391202"
"V4mis2";"SILVA (only NR);Bacteria;Cyanobacteria;Cyanobacteriia;Cyanobacteriales;Phormidiaceae;";"95.8";"14.4";"307";"307";"294";"13";"0";"456876";"390913"
"V4mis2";"SILVA (only NR);Bacteria;Cyanobacteria;Cyanobacteriia;Cyanobacteriales;Phormidiaceae;Aerosakkonema Lao26;";"100.0";"14.4";"2";"2";"2";"0";"0";"457181";"391205"
"V4mis2";"SILVA (only NR);Bacteria;Cyanobacteria;Cyanobacteriia;Cyanobacteriales;Phormidiaceae;Arthrospira PCC-7345;";"92.1";"14.4";"38";"38";"35";"3";"0";"457145";"391172"
"V4mis2";"SILVA (only NR);Bacteria;Cyanobacteria;Cyanobacteriia;Cyanobacteriales;Phormidiaceae;Cephalothrix SAG 75.79;";"100.0";"14.4";"14";"14";"14";"0";"0";"457169";"391193"
"V4mis2";"SILVA (only NR);Bacteria;Cyanobacteria;Cyanobacteriia;Cyanobacteriales;Phormidiaceae;Kamptonema PCC-6407;";"100.0";"14.4";"10";"10";"10";"0";"0";"457173";"391197"
"V4mis2";"SILVA (only NR);Bacteria;Cyanobacteria;Cyanobacteriia;Cyanobacteriales;Phormidiaceae;Lyngbya PCC-7419;";"84.1";"14.4";"44";"44";"37";"7";"0";"457139";"391170"
"V4mis2";"SILVA (only NR);Bacteria;Cyanobacteria;Cyanobacteriia;Cyanobacteriales;Phormidiaceae;Phormidium IAM M-71;";"94.1";"14.4";"17";"17";"16";"1";"0";"457166";"391191"
"V4mis2";"SILVA (only NR);Bacteria;Cyanobacteria;Cyanobacteriia;Cyanobacteriales;Phormidiaceae;Planktothrix NIVA-CYA 15;";"100.0";"14.4";"61";"61";"61";"0";"0";"457122";"391146"
"V4mis2";"SILVA (only NR);Bacteria;Cyanobacteria;Cyanobacteriia;Cyanobacteriales;Phormidiaceae;Trichocoleus SAG 26.92;";"100.0";"14.4";"6";"6";"6";"0";"0";"457177";"391201"
"V4mis2";"SILVA (only NR);Bacteria;Cyanobacteria;Cyanobacteriia;Cyanobacteriales;Phormidiaceae;Trichodesmium IMS101;";"100.0";"14.4";"40";"40";"40";"0";"0";"457143";"391167"
"V4mis2";"SILVA (only NR);Bacteria;Cyanobacteria;Cyanobacteriia;Cyanobacteriales;Phormidiaceae;Tychonema CCAP 1459-11B;";"96.5";"14.4";"57";"57";"55";"2";"0";"457126";"391152"
"V4mis2";"SILVA (only NR);Bacteria;Cyanobacteria;Cyanobacteriia;Cyanobacteriales;Phormidiaceae;uncultured;";"100.0";"14.4";"13";"13";"13";"0";"0";"457170";"391194"
"V4mis2";"SILVA (only NR);Bacteria;Cyanobacteria;Cyanobacteriia;Cyanobacteriales;Prochloraceae;";"100.0";"14.4";"14";"14";"14";"0";"0";"457169";"391193"
"V4mis2";"SILVA (only NR);Bacteria;Cyanobacteria;Cyanobacteriia;Cyanobacteriales;Prochloraceae;Prochloron P1-Palau;";"100.0";"14.4";"14";"14";"14";"0";"0";"457169";"391193"
"V4mis2";"SILVA (only NR);Bacteria;Cyanobacteria;Cyanobacteriia;Cyanobacteriales;Rubidibacteraceae;";"93.3";"14.4";"89";"89";"83";"6";"0";"457094";"391124"
"V4mis2";"SILVA (only NR);Bacteria;Cyanobacteria;Cyanobacteriia;Cyanobacteriales;Rubidibacteraceae;Dactylococcopsis PCC-8305;";"92.7";"14.4";"82";"82";"76";"6";"0";"457101";"391131"
"V4mis2";"SILVA (only NR);Bacteria;Cyanobacteria;Cyanobacteriia;Cyanobacteriales;Rubidibacteraceae;Rubidibacter KORDI 51-2;";"100.0";"14.4";"2";"2";"2";"0";"0";"457181";"391205"
"V4mis2";"SILVA (only NR);Bacteria;Cyanobacteria;Cyanobacteriia;Cyanobacteriales;Rubidibacteraceae;uncultured;";"100.0";"14.4";"5";"5";"5";"0";"0";"457178";"391202"
"V4mis2";"SILVA (only NR);Bacteria;Cyanobacteria;Cyanobacteriia;Cyanobacteriales;Xenococcaceae;";"94.3";"14.4";"123";"123";"116";"7";"0";"457060";"391091"
"V4mis2";"SILVA (only NR);Bacteria;Cyanobacteria;Cyanobacteriia;Cyanobacteriales;Xenococcaceae;Chroococcidiopsis PCC-6712;";"100.0";"14.4";"6";"6";"6";"0";"0";"457177";"391201"
"V4mis2";"SILVA (only NR);Bacteria;Cyanobacteria;Cyanobacteriia;Cyanobacteriales;Xenococcaceae;Chroococcopsis;";"100.0";"14.4";"1";"1";"1";"0";"0";"457182";"391206"
"V4mis2";"SILVA (only NR);Bacteria;Cyanobacteria;Cyanobacteriia;Cyanobacteriales;Xenococcaceae;Foliisarcina;";"100.0";"14.4";"1";"1";"1";"0";"0";"457182";"391206"
"V4mis2";"SILVA (only NR);Bacteria;Cyanobacteria;Cyanobacteriia;Cyanobacteriales;Xenococcaceae;Gloeocapsopsis BDHKU 35101;";"100.0";"14.4";"2";"2";"2";"0";"0";"457181";"391205"
"V4mis2";"SILVA (only NR);Bacteria;Cyanobacteria;Cyanobacteriia;Cyanobacteriales;Xenococcaceae;Myxosarcina GI1;";"100.0";"14.4";"2";"2";"2";"0";"0";"457181";"391205"
"V4mis2";"SILVA (only NR);Bacteria;Cyanobacteria;Cyanobacteriia;Cyanobacteriales;Xenococcaceae;Pleurocapsa PCC-7319;";"96.6";"14.4";"58";"58";"56";"2";"0";"457125";"391151"
"V4mis2";"SILVA (only NR);Bacteria;Cyanobacteria;Cyanobacteriia;Cyanobacteriales;Xenococcaceae;Stanieria PCC-7437;";"100.0";"14.4";"4";"4";"4";"0";"0";"457179";"391203"
"V4mis2";"SILVA (only NR);Bacteria;Cyanobacteria;Cyanobacteriia;Cyanobacteriales;Xenococcaceae;Xenococcus CRM;";"100.0";"14.4";"7";"7";"7";"0";"0";"457176";"391200"
"V4mis2";"SILVA (only NR);Bacteria;Cyanobacteria;Cyanobacteriia;Cyanobacteriales;Xenococcaceae;Xenococcus PCC-7305;";"94.4";"14.4";"18";"18";"17";"1";"0";"457165";"391190"
"V4mis2";"SILVA (only NR);Bacteria;Cyanobacteria;Cyanobacteriia;Cyanobacteriales;Xenococcaceae;uncultured;";"82.6";"14.4";"23";"23";"19";"4";"0";"457160";"391188"
"V4mis2";"SILVA (only NR);Bacteria;Cyanobacteria;Cyanobacteriia;Cyanobacteriales;uncultured;";"96.1";"14.4";"128";"128";"123";"5";"0";"457055";"391084"
"V4mis2";"SILVA (only NR);Bacteria;Cyanobacteria;Cyanobacteriia;Eurycoccales;";"100.0";"14.4";"41";"41";"41";"0";"0";"457142";"391166"
"V4mis2";"SILVA (only NR);Bacteria;Cyanobacteria;Cyanobacteriia;Eurycoccales;Eurycoccales Incertae Sedis;";"100.0";"14.4";"20";"20";"20";"0";"0";"457163";"391187"
"V4mis2";"SILVA (only NR);Bacteria;Cyanobacteria;Cyanobacteriia;Eurycoccales;Eurycoccales Incertae Sedis;Candidatus Gloeomargarita;";"100.0";"14.4";"12";"12";"12";"0";"0";"457171";"391195"
"V4mis2";"SILVA (only NR);Bacteria;Cyanobacteria;Cyanobacteriia;Eurycoccales;Eurycoccales Incertae Sedis;Synechococcus PCC-7336;";"100.0";"14.4";"8";"8";"8";"0";"0";"457175";"391199"
"V4mis2";"SILVA (only NR);Bacteria;Cyanobacteria;Cyanobacteriia;Eurycoccales;Leptococcaceae;";"100.0";"14.4";"11";"11";"11";"0";"0";"457172";"391196"
"V4mis2";"SILVA (only NR);Bacteria;Cyanobacteria;Cyanobacteriia;Eurycoccales;Leptococcaceae;Leptococcus JA-3-3Ab;";"100.0";"14.4";"11";"11";"11";"0";"0";"457172";"391196"
"V4mis2";"SILVA (only NR);Bacteria;Cyanobacteria;Cyanobacteriia;Eurycoccales;uncultured;";"100.0";"14.4";"10";"10";"10";"0";"0";"457173";"391197"
"V4mis2";"SILVA (only NR);Bacteria;Cyanobacteria;Cyanobacteriia;Geitlerinematales;";"100.0";"14.4";"1";"1";"1";"0";"0";"457182";"391206"
"V4mis2";"SILVA (only NR);Bacteria;Cyanobacteria;Cyanobacteriia;Geitlerinematales;Geitlerinemataceae;";"100.0";"14.4";"1";"1";"1";"0";"0";"457182";"391206"
"V4mis2";"SILVA (only NR);Bacteria;Cyanobacteria;Cyanobacteriia;Geitlerinematales;Geitlerinemataceae;Geitlerinema;";"100.0";"14.4";"1";"1";"1";"0";"0";"457182";"391206"
"V4mis2";"SILVA (only NR);Bacteria;Cyanobacteria;Cyanobacteriia;Gloeobacterales;";"100.0";"14.4";"6";"6";"6";"0";"0";"457177";"391201"
"V4mis2";"SILVA (only NR);Bacteria;Cyanobacteria;Cyanobacteriia;Gloeobacterales;Gloeobacteraceae;";"100.0";"14.4";"6";"6";"6";"0";"0";"457177";"391201"
"V4mis2";"SILVA (only NR);Bacteria;Cyanobacteria;Cyanobacteriia;Gloeobacterales;Gloeobacteraceae;Gloeobacter PCC-7421;";"100.0";"14.4";"6";"6";"6";"0";"0";"457177";"391201"
"V4mis2";"SILVA (only NR);Bacteria;Cyanobacteria;Cyanobacteriia;Leptolyngbyales;";"94.8";"14.4";"617";"617";"585";"32";"0";"456566";"390622"
"V4mis2";"SILVA (only NR);Bacteria;Cyanobacteria;Cyanobacteriia;Leptolyngbyales;Leptolyngbyaceae;";"94.8";"14.4";"617";"617";"585";"32";"0";"456566";"390622"
"V4mis2";"SILVA (only NR);Bacteria;Cyanobacteria;Cyanobacteriia;Leptolyngbyales;Leptolyngbyaceae;Alkalinema CENA528;";"100.0";"14.4";"2";"2";"2";"0";"0";"457181";"391205"
"V4mis2";"SILVA (only NR);Bacteria;Cyanobacteria;Cyanobacteriia;Leptolyngbyales;Leptolyngbyaceae;Arthronema SAG 12.89;";"100.0";"14.4";"4";"4";"4";"0";"0";"457179";"391203"
"V4mis2";"SILVA (only NR);Bacteria;Cyanobacteria;Cyanobacteriia;Leptolyngbyales;Leptolyngbyaceae;BMM02;";"100.0";"14.4";"3";"3";"3";"0";"0";"457180";"391204"
"V4mis2";"SILVA (only NR);Bacteria;Cyanobacteria;Cyanobacteriia;Leptolyngbyales;Leptolyngbyaceae;CENA359;";"100.0";"14.4";"13";"13";"13";"0";"0";"457170";"391194"
"V4mis2";"SILVA (only NR);Bacteria;Cyanobacteria;Cyanobacteriia;Leptolyngbyales;Leptolyngbyaceae;CENA384;";"100.0";"14.4";"2";"2";"2";"0";"0";"457181";"391205"
"V4mis2";"SILVA (only NR);Bacteria;Cyanobacteria;Cyanobacteriia;Leptolyngbyales;Leptolyngbyaceae;CENA518;";"100.0";"14.4";"3";"3";"3";"0";"0";"457180";"391204"
"V4mis2";"SILVA (only NR);Bacteria;Cyanobacteria;Cyanobacteriia;Leptolyngbyales;Leptolyngbyaceae;Calenema;";"100.0";"14.4";"7";"7";"7";"0";"0";"457176";"391200"
"V4mis2";"SILVA (only NR);Bacteria;Cyanobacteria;Cyanobacteriia;Leptolyngbyales;Leptolyngbyaceae;Calothrix KVSF5;";"100.0";"14.4";"14";"14";"14";"0";"0";"457169";"391193"
"V4mis2";"SILVA (only NR);Bacteria;Cyanobacteria;Cyanobacteriia;Leptolyngbyales;Leptolyngbyaceae;Chamaesiphon PCC-7430;";"100.0";"14.4";"19";"19";"19";"0";"0";"457164";"391188"
"V4mis2";"SILVA (only NR);Bacteria;Cyanobacteria;Cyanobacteriia;Leptolyngbyales;Leptolyngbyaceae;EcFYyy-200;";"100.0";"14.4";"6";"6";"6";"0";"0";"457177";"391201"
"V4mis2";"SILVA (only NR);Bacteria;Cyanobacteria;Cyanobacteriia;Leptolyngbyales;Leptolyngbyaceae;Fr127;";"100.0";"14.4";"5";"5";"5";"0";"0";"457178";"391202"
"V4mis2";"SILVA (only NR);Bacteria;Cyanobacteria;Cyanobacteriia;Leptolyngbyales;Leptolyngbyaceae;Geitlerinema PCC-8501;";"88.9";"14.4";"18";"18";"16";"2";"0";"457165";"391191"
"V4mis2";"SILVA (only NR);Bacteria;Cyanobacteria;Cyanobacteriia;Leptolyngbyales;Leptolyngbyaceae;Greenland-10;";"100.0";"14.4";"2";"2";"2";"0";"0";"457181";"391205"
"V4mis2";"SILVA (only NR);Bacteria;Cyanobacteria;Cyanobacteriia;Leptolyngbyales;Leptolyngbyaceae;HAVOmat113;";"100.0";"14.4";"8";"8";"8";"0";"0";"457175";"391199"
"V4mis2";"SILVA (only NR);Bacteria;Cyanobacteria;Cyanobacteriia;Leptolyngbyales;Leptolyngbyaceae;JSC-12;";"100.0";"14.4";"9";"9";"9";"0";"0";"457174";"391198"
"V4mis2";"SILVA (only NR);Bacteria;Cyanobacteria;Cyanobacteriia;Leptolyngbyales;Leptolyngbyaceae;LB3-76;";"100.0";"14.4";"9";"9";"9";"0";"0";"457174";"391198"
"V4mis2";"SILVA (only NR);Bacteria;Cyanobacteria;Cyanobacteriia;Leptolyngbyales;Leptolyngbyaceae;Leptolyngbya ANT.L52.2;";"97.6";"14.4";"41";"41";"40";"1";"0";"457142";"391167"
"V4mis2";"SILVA (only NR);Bacteria;Cyanobacteria;Cyanobacteriia;Leptolyngbyales;Leptolyngbyaceae;Leptolyngbya ANT.L67.1;";"100.0";"14.4";"11";"11";"11";"0";"0";"457172";"391196"
"V4mis2";"SILVA (only NR);Bacteria;Cyanobacteria;Cyanobacteriia;Leptolyngbyales;Leptolyngbyaceae;Leptolyngbya BN43;";"100.0";"14.4";"3";"3";"3";"0";"0";"457180";"391204"
"V4mis2";"SILVA (only NR);Bacteria;Cyanobacteria;Cyanobacteriia;Leptolyngbyales;Leptolyngbyaceae;Leptolyngbya Es-Yyy1000;";"80.0";"14.4";"5";"5";"4";"1";"0";"457178";"391203"
"V4mis2";"SILVA (only NR);Bacteria;Cyanobacteria;Cyanobacteriia;Leptolyngbyales;Leptolyngbyaceae;Leptolyngbya FYG;";"100.0";"14.4";"8";"8";"8";"0";"0";"457175";"391199"
"V4mis2";"SILVA (only NR);Bacteria;Cyanobacteria;Cyanobacteriia;Leptolyngbyales;Leptolyngbyaceae;Leptolyngbya PCC-6306;";"97.1";"14.4";"35";"35";"34";"1";"0";"457148";"391173"
"V4mis2";"SILVA (only NR);Bacteria;Cyanobacteria;Cyanobacteriia;Leptolyngbyales;Leptolyngbyaceae;Leptolyngbya RV74;";"100.0";"14.4";"5";"5";"5";"0";"0";"457178";"391202"
"V4mis2";"SILVA (only NR);Bacteria;Cyanobacteria;Cyanobacteriia;Leptolyngbyales;Leptolyngbyaceae;Leptolyngbya SAG 2411;";"100.0";"14.4";"3";"3";"3";"0";"0";"457180";"391204"
"V4mis2";"SILVA (only NR);Bacteria;Cyanobacteria;Cyanobacteriia;Leptolyngbyales;Leptolyngbyaceae;Leptolyngbya VRUC 135;";"92.9";"14.4";"28";"28";"26";"2";"0";"457155";"391181"
"V4mis2";"SILVA (only NR);Bacteria;Cyanobacteria;Cyanobacteriia;Leptolyngbyales;Leptolyngbyaceae;Limnolyngbya CHAB4449;";"100.0";"14.4";"4";"4";"4";"0";"0";"457179";"391203"
"V4mis2";"SILVA (only NR);Bacteria;Cyanobacteria;Cyanobacteriia;Leptolyngbyales;Leptolyngbyaceae;MIZ36;";"100.0";"14.4";"7";"7";"7";"0";"0";"457176";"391200"
"V4mis2";"SILVA (only NR);Bacteria;Cyanobacteria;Cyanobacteriia;Leptolyngbyales;Leptolyngbyaceae;MTP1;";"100.0";"14.4";"3";"3";"3";"0";"0";"457180";"391204"
"V4mis2";"SILVA (only NR);Bacteria;Cyanobacteria;Cyanobacteriia;Leptolyngbyales;Leptolyngbyaceae;Oscillatoria SAG 1459-8;";"100.0";"14.4";"6";"6";"6";"0";"0";"457177";"391201"
"V4mis2";"SILVA (only NR);Bacteria;Cyanobacteria;Cyanobacteriia;Leptolyngbyales;Leptolyngbyaceae;Pantalinema;";"75.0";"14.4";"4";"4";"3";"1";"0";"457179";"391204"
"V4mis2";"SILVA (only NR);Bacteria;Cyanobacteria;Cyanobacteriia;Leptolyngbyales;Leptolyngbyaceae;Phormidesmis ANT.L52.6;";"100.0";"14.4";"26";"26";"26";"0";"0";"457157";"391181"
"V4mis2";"SILVA (only NR);Bacteria;Cyanobacteria;Cyanobacteriia;Leptolyngbyales;Leptolyngbyaceae;Phormidium CYN64;";"100.0";"14.4";"13";"13";"13";"0";"0";"457170";"391194"
"V4mis2";"SILVA (only NR);Bacteria;Cyanobacteria;Cyanobacteriia;Leptolyngbyales;Leptolyngbyaceae;Phormidium SAG 37.90;";"93.8";"14.4";"16";"16";"15";"1";"0";"457167";"391192"
"V4mis2";"SILVA (only NR);Bacteria;Cyanobacteria;Cyanobacteriia;Leptolyngbyales;Leptolyngbyaceae;RD011;";"85.7";"14.4";"7";"7";"6";"1";"0";"457176";"391201"
"V4mis2";"SILVA (only NR);Bacteria;Cyanobacteria;Cyanobacteriia;Leptolyngbyales;Leptolyngbyaceae;Scytolyngbya XSP1;";"100.0";"14.4";"2";"2";"2";"0";"0";"457181";"391205"
"V4mis2";"SILVA (only NR);Bacteria;Cyanobacteria;Cyanobacteriia;Leptolyngbyales;Leptolyngbyaceae;TG-45;";"100.0";"14.4";"2";"2";"2";"0";"0";"457181";"391205"
"V4mis2";"SILVA (only NR);Bacteria;Cyanobacteria;Cyanobacteriia;Leptolyngbyales;Leptolyngbyaceae;YB-42;";"60.0";"14.4";"5";"5";"3";"2";"0";"457178";"391204"
"V4mis2";"SILVA (only NR);Bacteria;Cyanobacteria;Cyanobacteriia;Leptolyngbyales;Leptolyngbyaceae;YT-3;";"100.0";"14.4";"2";"2";"2";"0";"0";"457181";"391205"
"V4mis2";"SILVA (only NR);Bacteria;Cyanobacteria;Cyanobacteriia;Leptolyngbyales;Leptolyngbyaceae;uncultured;";"91.6";"14.4";"239";"239";"219";"20";"0";"456944";"390988"
"V4mis2";"SILVA (only NR);Bacteria;Cyanobacteria;Cyanobacteriia;Limnotrichales;";"97.0";"14.4";"33";"33";"32";"1";"0";"457150";"391175"
"V4mis2";"SILVA (only NR);Bacteria;Cyanobacteria;Cyanobacteriia;Limnotrichales;Limnotrichaceae;";"97.0";"14.4";"33";"33";"32";"1";"0";"457150";"391175"
"V4mis2";"SILVA (only NR);Bacteria;Cyanobacteria;Cyanobacteriia;Limnotrichales;Limnotrichaceae;Limnothrix;";"97.0";"14.4";"33";"33";"32";"1";"0";"457150";"391175"
"V4mis2";"SILVA (only NR);Bacteria;Cyanobacteria;Cyanobacteriia;Neosynechococcales;";"100.0";"14.4";"1";"1";"1";"0";"0";"457182";"391206"
"V4mis2";"SILVA (only NR);Bacteria;Cyanobacteria;Cyanobacteriia;Neosynechococcales;Neosynechococcaceae;";"100.0";"14.4";"1";"1";"1";"0";"0";"457182";"391206"
"V4mis2";"SILVA (only NR);Bacteria;Cyanobacteria;Cyanobacteriia;Neosynechococcales;Neosynechococcaceae;Neosynechococcus;";"100.0";"14.4";"1";"1";"1";"0";"0";"457182";"391206"
"V4mis2";"SILVA (only NR);Bacteria;Cyanobacteria;Cyanobacteriia;Oxyphotobacteria Incertae Sedis;";"97.0";"14.4";"33";"33";"32";"1";"0";"457150";"391175"
"V4mis2";"SILVA (only NR);Bacteria;Cyanobacteria;Cyanobacteriia;Oxyphotobacteria Incertae Sedis;Unknown Family;";"97.0";"14.4";"33";"33";"32";"1";"0";"457150";"391175"
"V4mis2";"SILVA (only NR);Bacteria;Cyanobacteria;Cyanobacteriia;Oxyphotobacteria Incertae Sedis;Unknown Family;Leptolyngbya EcFYyyy-00;";"100.0";"14.4";"12";"12";"12";"0";"0";"457171";"391195"
"V4mis2";"SILVA (only NR);Bacteria;Cyanobacteria;Cyanobacteriia;Oxyphotobacteria Incertae Sedis;Unknown Family;Leptolyngbya LEGE-06070;";"66.7";"14.4";"3";"3";"2";"1";"0";"457180";"391205"
"V4mis2";"SILVA (only NR);Bacteria;Cyanobacteria;Cyanobacteriia;Oxyphotobacteria Incertae Sedis;Unknown Family;Pseudanabaena NgrPSln22;";"100.0";"14.4";"3";"3";"3";"0";"0";"457180";"391204"
"V4mis2";"SILVA (only NR);Bacteria;Cyanobacteria;Cyanobacteriia;Oxyphotobacteria Incertae Sedis;Unknown Family;uncultured;";"100.0";"14.4";"12";"12";"12";"0";"0";"457171";"391195"
"V4mis2";"SILVA (only NR);Bacteria;Cyanobacteria;Cyanobacteriia;Phormidesmiales;";"97.6";"14.4";"248";"248";"242";"6";"0";"456935";"390965"
"V4mis2";"SILVA (only NR);Bacteria;Cyanobacteria;Cyanobacteriia;Phormidesmiales;Nodosilineaceae;";"97.7";"14.4";"129";"129";"126";"3";"0";"457054";"391081"
"V4mis2";"SILVA (only NR);Bacteria;Cyanobacteria;Cyanobacteriia;Phormidesmiales;Nodosilineaceae;Halomicronema C2206;";"100.0";"14.4";"2";"2";"2";"0";"0";"457181";"391205"
"V4mis2";"SILVA (only NR);Bacteria;Cyanobacteria;Cyanobacteriia;Phormidesmiales;Nodosilineaceae;Halomicronema TFEP1;";"100.0";"14.4";"6";"6";"6";"0";"0";"457177";"391201"
"V4mis2";"SILVA (only NR);Bacteria;Cyanobacteria;Cyanobacteriia;Phormidesmiales;Nodosilineaceae;Halomicronema;";"100.0";"14.4";"1";"1";"1";"0";"0";"457182";"391206"
"V4mis2";"SILVA (only NR);Bacteria;Cyanobacteria;Cyanobacteriia;Phormidesmiales;Nodosilineaceae;Leptolyngbya PCC-6406;";"100.0";"14.4";"5";"5";"5";"0";"0";"457178";"391202"
"V4mis2";"SILVA (only NR);Bacteria;Cyanobacteria;Cyanobacteriia;Phormidesmiales;Nodosilineaceae;MBIC10086;";"100.0";"14.4";"5";"5";"5";"0";"0";"457178";"391202"
"V4mis2";"SILVA (only NR);Bacteria;Cyanobacteria;Cyanobacteriia;Phormidesmiales;Nodosilineaceae;Nodosilinea PCC-7104;";"97.7";"14.4";"88";"88";"86";"2";"0";"457095";"391121"
"V4mis2";"SILVA (only NR);Bacteria;Cyanobacteria;Cyanobacteriia;Phormidesmiales;Nodosilineaceae;uncultured;";"94.4";"14.4";"18";"18";"17";"1";"0";"457165";"391190"
"V4mis2";"SILVA (only NR);Bacteria;Cyanobacteria;Cyanobacteriia;Phormidesmiales;Phormidesmiaceae;";"97.4";"14.4";"117";"117";"114";"3";"0";"457066";"391093"
"V4mis2";"SILVA (only NR);Bacteria;Cyanobacteria;Cyanobacteriia;Phormidesmiales;Phormidesmiaceae;Acrophormium PCC-7375;";"100.0";"14.4";"24";"24";"24";"0";"0";"457159";"391183"
"V4mis2";"SILVA (only NR);Bacteria;Cyanobacteria;Cyanobacteriia;Phormidesmiales;Phormidesmiaceae;Phormidesmis ANT.LACV5.1;";"100.0";"14.4";"37";"37";"37";"0";"0";"457146";"391170"
"V4mis2";"SILVA (only NR);Bacteria;Cyanobacteria;Cyanobacteriia;Phormidesmiales;Phormidesmiaceae;Phormidium MBIC10002;";"100.0";"14.4";"3";"3";"3";"0";"0";"457180";"391204"
"V4mis2";"SILVA (only NR);Bacteria;Cyanobacteria;Cyanobacteriia;Phormidesmiales;Phormidesmiaceae;Phormidium MBIC10003;";"100.0";"14.4";"42";"42";"42";"0";"0";"457141";"391165"
"V4mis2";"SILVA (only NR);Bacteria;Cyanobacteria;Cyanobacteriia;Phormidesmiales;Phormidesmiaceae;uncultured;";"66.7";"14.4";"9";"9";"6";"3";"0";"457174";"391201"
"V4mis2";"SILVA (only NR);Bacteria;Cyanobacteria;Cyanobacteriia;Phormidesmiales;uncultured;";"100.0";"14.4";"2";"2";"2";"0";"0";"457181";"391205"
"V4mis2";"SILVA (only NR);Bacteria;Cyanobacteria;Cyanobacteriia;Pseudanabaenales;";"100.0";"14.4";"96";"96";"96";"0";"0";"457087";"391111"
"V4mis2";"SILVA (only NR);Bacteria;Cyanobacteria;Cyanobacteriia;Pseudanabaenales;Pseudanabaenaceae;";"100.0";"14.4";"96";"96";"96";"0";"0";"457087";"391111"
"V4mis2";"SILVA (only NR);Bacteria;Cyanobacteria;Cyanobacteriia;Pseudanabaenales;Pseudanabaenaceae;Pseudanabaena PCC-6802;";"100.0";"14.4";"4";"4";"4";"0";"0";"457179";"391203"
"V4mis2";"SILVA (only NR);Bacteria;Cyanobacteria;Cyanobacteriia;Pseudanabaenales;Pseudanabaenaceae;Pseudanabaena PCC-7367;";"100.0";"14.4";"9";"9";"9";"0";"0";"457174";"391198"
"V4mis2";"SILVA (only NR);Bacteria;Cyanobacteria;Cyanobacteriia;Pseudanabaenales;Pseudanabaenaceae;Pseudanabaena PCC-7403;";"100.0";"14.4";"2";"2";"2";"0";"0";"457181";"391205"
"V4mis2";"SILVA (only NR);Bacteria;Cyanobacteria;Cyanobacteriia;Pseudanabaenales;Pseudanabaenaceae;Pseudanabaena PCC-7429;";"100.0";"14.4";"36";"36";"36";"0";"0";"457147";"391171"
"V4mis2";"SILVA (only NR);Bacteria;Cyanobacteria;Cyanobacteriia;Pseudanabaenales;Pseudanabaenaceae;Synechococcus PCC-7502;";"100.0";"14.4";"12";"12";"12";"0";"0";"457171";"391195"
"V4mis2";"SILVA (only NR);Bacteria;Cyanobacteria;Cyanobacteriia;Pseudanabaenales;Pseudanabaenaceae;uncultured;";"100.0";"14.4";"30";"30";"30";"0";"0";"457153";"391177"
"V4mis2";"SILVA (only NR);Bacteria;Cyanobacteria;Cyanobacteriia;RD017;";"92.3";"14.4";"13";"13";"12";"1";"0";"457170";"391195"
"V4mis2";"SILVA (only NR);Bacteria;Cyanobacteria;Cyanobacteriia;SepB-3;";"100.0";"14.4";"8";"8";"8";"0";"0";"457175";"391199"
"V4mis2";"SILVA (only NR);Bacteria;Cyanobacteria;Cyanobacteriia;Synechococcales;";"91.5";"14.4";"563";"563";"515";"48";"0";"456620";"390692"
"V4mis2";"SILVA (only NR);Bacteria;Cyanobacteria;Cyanobacteriia;Synechococcales;Cyanobiaceae;";"91.1";"14.4";"529";"529";"482";"47";"0";"456654";"390725"
"V4mis2";"SILVA (only NR);Bacteria;Cyanobacteria;Cyanobacteriia;Synechococcales;Cyanobiaceae;Cyanobium PCC-6307;";"96.1";"14.4";"204";"204";"196";"8";"0";"456979";"391011"
"V4mis2";"SILVA (only NR);Bacteria;Cyanobacteria;Cyanobacteriia;Synechococcales;Cyanobiaceae;Prochlorococcus MIT9313;";"81.6";"14.4";"136";"136";"111";"25";"0";"457047";"391096"
"V4mis2";"SILVA (only NR);Bacteria;Cyanobacteria;Cyanobacteriia;Synechococcales;Cyanobiaceae;Synechococcus CC9902;";"92.3";"14.4";"168";"168";"155";"13";"0";"457015";"391052"
"V4mis2";"SILVA (only NR);Bacteria;Cyanobacteria;Cyanobacteriia;Synechococcales;Cyanobiaceae;Synechococcus MBIC10613;";"100.0";"14.4";"4";"4";"4";"0";"0";"457179";"391203"
"V4mis2";"SILVA (only NR);Bacteria;Cyanobacteria;Cyanobacteriia;Synechococcales;Cyanobiaceae;[Synechococcus] spongiarum group;";"100.0";"14.4";"14";"14";"14";"0";"0";"457169";"391193"
"V4mis2";"SILVA (only NR);Bacteria;Cyanobacteria;Cyanobacteriia;Synechococcales;Prochlorotrichaceae;";"100.0";"14.4";"9";"9";"9";"0";"0";"457174";"391198"
"V4mis2";"SILVA (only NR);Bacteria;Cyanobacteria;Cyanobacteriia;Synechococcales;Prochlorotrichaceae;Prochlorothrix PCC-9006;";"100.0";"14.4";"9";"9";"9";"0";"0";"457174";"391198"
"V4mis2";"SILVA (only NR);Bacteria;Cyanobacteria;Cyanobacteriia;Synechococcales;Synechococcaceae;";"93.3";"14.4";"15";"15";"14";"1";"0";"457168";"391193"
"V4mis2";"SILVA (only NR);Bacteria;Cyanobacteria;Cyanobacteriia;Synechococcales;Synechococcaceae;Microcystis NIES42;";"100.0";"14.4";"2";"2";"2";"0";"0";"457181";"391205"
"V4mis2";"SILVA (only NR);Bacteria;Cyanobacteria;Cyanobacteriia;Synechococcales;Synechococcaceae;Synechococcus PCC-7942;";"100.0";"14.4";"10";"10";"10";"0";"0";"457173";"391197"
"V4mis2";"SILVA (only NR);Bacteria;Cyanobacteria;Cyanobacteriia;Synechococcales;Synechococcaceae;uncultured;";"66.7";"14.4";"3";"3";"2";"1";"0";"457180";"391205"
"V4mis2";"SILVA (only NR);Bacteria;Cyanobacteria;Cyanobacteriia;Synechococcales;Synechococcales Incertae Sedis;";"100.0";"14.4";"10";"10";"10";"0";"0";"457173";"391197"
"V4mis2";"SILVA (only NR);Bacteria;Cyanobacteria;Cyanobacteriia;Synechococcales;Synechococcales Incertae Sedis;Schizothrix LEGE 07164;";"100.0";"14.4";"10";"10";"10";"0";"0";"457173";"391197"
"V4mis2";"SILVA (only NR);Bacteria;Cyanobacteria;Cyanobacteriia;Thermosynechococcales;";"97.9";"14.4";"48";"48";"47";"1";"0";"457135";"391160"
"V4mis2";"SILVA (only NR);Bacteria;Cyanobacteria;Cyanobacteriia;Thermosynechococcales;Acaryochloridaceae;";"100.0";"14.4";"12";"12";"12";"0";"0";"457171";"391195"
"V4mis2";"SILVA (only NR);Bacteria;Cyanobacteria;Cyanobacteriia;Thermosynechococcales;Acaryochloridaceae;Acaryochloris MBIC11017;";"100.0";"14.4";"12";"12";"12";"0";"0";"457171";"391195"
"V4mis2";"SILVA (only NR);Bacteria;Cyanobacteria;Cyanobacteriia;Thermosynechococcales;Thermosynechococcaceae;";"97.2";"14.4";"36";"36";"35";"1";"0";"457147";"391172"
"V4mis2";"SILVA (only NR);Bacteria;Cyanobacteria;Cyanobacteriia;Thermosynechococcales;Thermosynechococcaceae;Cyanothece PCC 7425;";"100.0";"14.4";"9";"9";"9";"0";"0";"457174";"391198"
"V4mis2";"SILVA (only NR);Bacteria;Cyanobacteria;Cyanobacteriia;Thermosynechococcales;Thermosynechococcaceae;Loriellopsis LF-B5;";"83.3";"14.4";"6";"6";"5";"1";"0";"457177";"391202"
"V4mis2";"SILVA (only NR);Bacteria;Cyanobacteria;Cyanobacteriia;Thermosynechococcales;Thermosynechococcaceae;Synechococcus IR11;";"100.0";"14.4";"6";"6";"6";"0";"0";"457177";"391201"
"V4mis2";"SILVA (only NR);Bacteria;Cyanobacteria;Cyanobacteriia;Thermosynechococcales;Thermosynechococcaceae;Synechococcus PCC-6312;";"100.0";"14.4";"2";"2";"2";"0";"0";"457181";"391205"
"V4mis2";"SILVA (only NR);Bacteria;Cyanobacteria;Cyanobacteriia;Thermosynechococcales;Thermosynechococcaceae;Synechococcus;";"100.0";"14.4";"1";"1";"1";"0";"0";"457182";"391206"
"V4mis2";"SILVA (only NR);Bacteria;Cyanobacteria;Cyanobacteriia;Thermosynechococcales;Thermosynechococcaceae;Thermosynechococcus BP-1;";"100.0";"14.4";"9";"9";"9";"0";"0";"457174";"391198"
"V4mis2";"SILVA (only NR);Bacteria;Cyanobacteria;Cyanobacteriia;Thermosynechococcales;Thermosynechococcaceae;uncultured;";"100.0";"14.4";"3";"3";"3";"0";"0";"457180";"391204"
"V4mis2";"SILVA (only NR);Bacteria;Cyanobacteria;Cyanobacteriia;uncultured;";"100.0";"14.4";"5";"5";"5";"0";"0";"457178";"391202"
"V4mis2";"SILVA (only NR);Bacteria;Cyanobacteria;Sericytochromatia;";"96.4";"14.4";"83";"83";"80";"3";"0";"457100";"391127"
"V4mis2";"SILVA (only NR);Bacteria;Cyanobacteria;Vampirivibrionia;";"96.4";"14.4";"494";"494";"476";"18";"0";"456689";"390731"
"V4mis2";"SILVA (only NR);Bacteria;Cyanobacteria;Vampirivibrionia;Caenarcaniphilales;";"100.0";"14.4";"19";"19";"19";"0";"0";"457164";"391188"
"V4mis2";"SILVA (only NR);Bacteria;Cyanobacteria;Vampirivibrionia;Gastranaerophilales;";"96.0";"14.4";"324";"324";"311";"13";"0";"456859";"390896"
"V4mis2";"SILVA (only NR);Bacteria;Cyanobacteria;Vampirivibrionia;Obscuribacterales;";"97.4";"14.4";"77";"77";"75";"2";"0";"457106";"391132"
"V4mis2";"SILVA (only NR);Bacteria;Cyanobacteria;Vampirivibrionia;Obscuribacterales;Obscuribacteraceae;";"97.4";"14.4";"77";"77";"75";"2";"0";"457106";"391132"
"V4mis2";"SILVA (only NR);Bacteria;Cyanobacteria;Vampirivibrionia;Obscuribacterales;Obscuribacteraceae;Candidatus Obscuribacter;";"100.0";"14.4";"13";"13";"13";"0";"0";"457170";"391194"
"V4mis2";"SILVA (only NR);Bacteria;Cyanobacteria;Vampirivibrionia;Vampirovibrionales;";"95.9";"14.4";"74";"74";"71";"3";"0";"457109";"391136"
"V4mis2";"SILVA (only NR);Bacteria;Cyanobacteria;Vampirivibrionia;Vampirovibrionales;Vampirovibrionaceae;";"91.4";"14.4";"35";"35";"32";"3";"0";"457148";"391175"
"V4mis2";"SILVA (only NR);Bacteria;Cyanobacteria;Vampirivibrionia;Vampirovibrionales;Vampirovibrionaceae;Vampirovibrio;";"90.5";"14.4";"21";"21";"19";"2";"0";"457162";"391188"
"V4mis2";"SILVA (only NR);Bacteria;DTB120;";"97.4";"14.4";"78";"78";"76";"2";"0";"457105";"391131"
"V4mis2";"SILVA (only NR);Bacteria;Dadabacteria;";"96.5";"14.4";"172";"172";"166";"6";"0";"457011";"391041"
"V4mis2";"SILVA (only NR);Bacteria;Dadabacteria;Dadabacteriia;";"96.5";"14.4";"172";"172";"166";"6";"0";"457011";"391041"
"V4mis2";"SILVA (only NR);Bacteria;Dadabacteria;Dadabacteriia;Dadabacteriales;";"96.5";"14.4";"172";"172";"166";"6";"0";"457011";"391041"
"V4mis2";"SILVA (only NR);Bacteria;Deferribacterota;";"95.8";"14.4";"118";"118";"113";"5";"0";"457065";"391094"
"V4mis2";"SILVA (only NR);Bacteria;Deferribacterota;Deferribacteres;";"95.8";"14.4";"118";"118";"113";"5";"0";"457065";"391094"
"V4mis2";"SILVA (only NR);Bacteria;Deferribacterota;Deferribacteres;Deferribacterales;";"95.8";"14.4";"118";"118";"113";"5";"0";"457065";"391094"
"V4mis2";"SILVA (only NR);Bacteria;Deferribacterota;Deferribacteres;Deferribacterales;Deferribacteraceae;";"95.8";"14.4";"118";"118";"113";"5";"0";"457065";"391094"
"V4mis2";"SILVA (only NR);Bacteria;Deferribacterota;Deferribacteres;Deferribacterales;Deferribacteraceae;Calditerrivibrio;";"100.0";"14.4";"11";"11";"11";"0";"0";"457172";"391196"
"V4mis2";"SILVA (only NR);Bacteria;Deferribacterota;Deferribacteres;Deferribacterales;Deferribacteraceae;Deferribacter;";"100.0";"14.4";"10";"10";"10";"0";"0";"457173";"391197"
"V4mis2";"SILVA (only NR);Bacteria;Deferribacterota;Deferribacteres;Deferribacterales;Deferribacteraceae;Denitrovibrio;";"100.0";"14.4";"4";"4";"4";"0";"0";"457179";"391203"
"V4mis2";"SILVA (only NR);Bacteria;Deferribacterota;Deferribacteres;Deferribacterales;Deferribacteraceae;Flexistipes;";"80.0";"14.4";"5";"5";"4";"1";"0";"457178";"391203"
"V4mis2";"SILVA (only NR);Bacteria;Deferribacterota;Deferribacteres;Deferribacterales;Deferribacteraceae;Geovibrio;";"75.0";"14.4";"8";"8";"6";"2";"0";"457175";"391201"
"V4mis2";"SILVA (only NR);Bacteria;Deferribacterota;Deferribacteres;Deferribacterales;Deferribacteraceae;Mucispirillum;";"92.3";"14.4";"26";"26";"24";"2";"0";"457157";"391183"
"V4mis2";"SILVA (only NR);Bacteria;Deferribacterota;Deferribacteres;Deferribacterales;Deferribacteraceae;Seleniivibrio;";"100.0";"14.4";"3";"3";"3";"0";"0";"457180";"391204"
"V4mis2";"SILVA (only NR);Bacteria;Deferribacterota;Deferribacteres;Deferribacterales;Deferribacteraceae;uncultured;";"100.0";"14.4";"50";"50";"50";"0";"0";"457133";"391157"
"V4mis2";"SILVA (only NR);Bacteria;Deferrisomatota;";"96.2";"14.4";"26";"26";"25";"1";"0";"457157";"391182"
"V4mis2";"SILVA (only NR);Bacteria;Deferrisomatota;Defferrisomatia;";"96.2";"14.4";"26";"26";"25";"1";"0";"457157";"391182"
"V4mis2";"SILVA (only NR);Bacteria;Deferrisomatota;Defferrisomatia;Defferrisomatales;";"96.2";"14.4";"26";"26";"25";"1";"0";"457157";"391182"
"V4mis2";"SILVA (only NR);Bacteria;Deferrisomatota;Defferrisomatia;Defferrisomatales;Defferrisomataceae;";"96.2";"14.4";"26";"26";"25";"1";"0";"457157";"391182"
"V4mis2";"SILVA (only NR);Bacteria;Deferrisomatota;Defferrisomatia;Defferrisomatales;Defferrisomataceae;Deferrisoma;";"96.2";"14.4";"26";"26";"25";"1";"0";"457157";"391182"
"V4mis2";"SILVA (only NR);Bacteria;Deinococcota;";"97.0";"14.5";"832";"832";"807";"25";"0";"456351";"390400"
"V4mis2";"SILVA (only NR);Bacteria;Deinococcota;Deinococci;";"97.0";"14.5";"832";"832";"807";"25";"0";"456351";"390400"
"V4mis2";"SILVA (only NR);Bacteria;Deinococcota;Deinococci;Deinococcales;";"97.1";"14.4";"557";"557";"541";"16";"0";"456626";"390666"
"V4mis2";"SILVA (only NR);Bacteria;Deinococcota;Deinococci;Deinococcales;Deinococcaceae;";"97.9";"14.4";"328";"328";"321";"7";"0";"456855";"390886"
"V4mis2";"SILVA (only NR);Bacteria;Deinococcota;Deinococci;Deinococcales;Deinococcaceae;Deinobacterium;";"100.0";"14.4";"2";"2";"2";"0";"0";"457181";"391205"
"V4mis2";"SILVA (only NR);Bacteria;Deinococcota;Deinococci;Deinococcales;Deinococcaceae;Deinococcus;";"97.7";"14.4";"302";"302";"295";"7";"0";"456881";"390912"
"V4mis2";"SILVA (only NR);Bacteria;Deinococcota;Deinococci;Deinococcales;Deinococcaceae;uncultured;";"100.0";"14.4";"23";"23";"23";"0";"0";"457160";"391184"
"V4mis2";"SILVA (only NR);Bacteria;Deinococcota;Deinococci;Deinococcales;Trueperaceae;";"96.1";"14.4";"229";"229";"220";"9";"0";"456954";"390987"
"V4mis2";"SILVA (only NR);Bacteria;Deinococcota;Deinococci;Deinococcales;Trueperaceae;Truepera;";"96.1";"14.4";"229";"229";"220";"9";"0";"456954";"390987"
"V4mis2";"SILVA (only NR);Bacteria;Deinococcota;Deinococci;Thermales;";"96.7";"14.4";"275";"275";"266";"9";"0";"456908";"390941"
"V4mis2";"SILVA (only NR);Bacteria;Deinococcota;Deinococci;Thermales;Thermaceae;";"96.7";"14.4";"275";"275";"266";"9";"0";"456908";"390941"
"V4mis2";"SILVA (only NR);Bacteria;Deinococcota;Deinococci;Thermales;Thermaceae;Marinithermus;";"100.0";"14.4";"2";"2";"2";"0";"0";"457181";"391205"
"V4mis2";"SILVA (only NR);Bacteria;Deinococcota;Deinococci;Thermales;Thermaceae;Meiothermus;";"96.5";"14.4";"86";"86";"83";"3";"0";"457097";"391124"
"V4mis2";"SILVA (only NR);Bacteria;Deinococcota;Deinococci;Thermales;Thermaceae;Oceanithermus;";"100.0";"14.4";"7";"7";"7";"0";"0";"457176";"391200"
"V4mis2";"SILVA (only NR);Bacteria;Deinococcota;Deinococci;Thermales;Thermaceae;Rhabdothermus;";"100.0";"14.4";"2";"2";"2";"0";"0";"457181";"391205"
"V4mis2";"SILVA (only NR);Bacteria;Deinococcota;Deinococci;Thermales;Thermaceae;Thermus;";"96.6";"14.4";"175";"175";"169";"6";"0";"457008";"391038"
"V4mis2";"SILVA (only NR);Bacteria;Deinococcota;Deinococci;Thermales;Thermaceae;Vulcanithermus;";"100.0";"14.4";"1";"1";"1";"0";"0";"457182";"391206"
"V4mis2";"SILVA (only NR);Bacteria;Dependentiae;";"97.1";"14.4";"583";"583";"566";"17";"0";"456600";"390641"
"V4mis2";"SILVA (only NR);Bacteria;Dependentiae;Babeliae;";"97.1";"14.4";"583";"583";"566";"17";"0";"456600";"390641"
"V4mis2";"SILVA (only NR);Bacteria;Dependentiae;Babeliae;Babeliales;";"97.1";"14.4";"583";"583";"566";"17";"0";"456600";"390641"
"V4mis2";"SILVA (only NR);Bacteria;Dependentiae;Babeliae;Babeliales;Babeliaceae;";"95.6";"14.4";"68";"68";"65";"3";"0";"457115";"391142"
"V4mis2";"SILVA (only NR);Bacteria;Dependentiae;Babeliae;Babeliales;Babeliaceae;Candidatus Babela;";"100.0";"14.4";"3";"3";"3";"0";"0";"457180";"391204"
"V4mis2";"SILVA (only NR);Bacteria;Dependentiae;Babeliae;Babeliales;UBA12409;";"98.5";"14.4";"68";"68";"67";"1";"0";"457115";"391140"
"V4mis2";"SILVA (only NR);Bacteria;Dependentiae;Babeliae;Babeliales;UBA12411;";"94.1";"14.4";"17";"17";"16";"1";"0";"457166";"391191"
"V4mis2";"SILVA (only NR);Bacteria;Dependentiae;Babeliae;Babeliales;Vermiphilaceae;";"98.1";"14.4";"211";"211";"207";"4";"0";"456972";"391000"
"V4mis2";"SILVA (only NR);Bacteria;Desantisbacteria;";"100.0";"14.4";"2";"2";"2";"0";"0";"457181";"391205"
"V4mis2";"SILVA (only NR);Bacteria;Desulfobacterota;";"95.8";"14.6";"7818";"7818";"7493";"325";"0";"449365";"383714"
"V4mis2";"SILVA (only NR);Bacteria;Desulfobacterota;Desulfarculia;";"96.6";"14.4";"29";"29";"28";"1";"0";"457154";"391179"
"V4mis2";"SILVA (only NR);Bacteria;Desulfobacterota;Desulfarculia;Desulfarculales;";"96.6";"14.4";"29";"29";"28";"1";"0";"457154";"391179"
"V4mis2";"SILVA (only NR);Bacteria;Desulfobacterota;Desulfarculia;Desulfarculales;Desulfarculaceae;";"96.4";"14.4";"28";"28";"27";"1";"0";"457155";"391180"
"V4mis2";"SILVA (only NR);Bacteria;Desulfobacterota;Desulfarculia;Desulfarculales;Desulfarculaceae;Desulfarculus;";"100.0";"14.4";"4";"4";"4";"0";"0";"457179";"391203"
"V4mis2";"SILVA (only NR);Bacteria;Desulfobacterota;Desulfarculia;Desulfarculales;Desulfarculaceae;Desulfocarbo;";"100.0";"14.4";"13";"13";"13";"0";"0";"457170";"391194"
"V4mis2";"SILVA (only NR);Bacteria;Desulfobacterota;Desulfarculia;Desulfarculales;Desulfarculaceae;Dethiosulfatarculus;";"100.0";"14.4";"1";"1";"1";"0";"0";"457182";"391206"
"V4mis2";"SILVA (only NR);Bacteria;Desulfobacterota;Desulfarculia;Desulfarculales;Desulfarculaceae;uncultured;";"90.0";"14.4";"10";"10";"9";"1";"0";"457173";"391198"
"V4mis2";"SILVA (only NR);Bacteria;Desulfobacterota;Desulfobaccia;";"94.6";"14.4";"74";"74";"70";"4";"0";"457109";"391137"
"V4mis2";"SILVA (only NR);Bacteria;Desulfobacterota;Desulfobaccia;Desulfobaccales;";"94.6";"14.4";"74";"74";"70";"4";"0";"457109";"391137"
"V4mis2";"SILVA (only NR);Bacteria;Desulfobacterota;Desulfobaccia;Desulfobaccales;Desulfobaccaceae;";"94.6";"14.4";"74";"74";"70";"4";"0";"457109";"391137"
"V4mis2";"SILVA (only NR);Bacteria;Desulfobacterota;Desulfobaccia;Desulfobaccales;Desulfobaccaceae;Desulfobacca;";"94.6";"14.4";"74";"74";"70";"4";"0";"457109";"391137"
"V4mis2";"SILVA (only NR);Bacteria;Desulfobacterota;Desulfobacteria;";"94.8";"14.5";"2521";"2521";"2389";"132";"0";"454662";"388818"
"V4mis2";"SILVA (only NR);Bacteria;Desulfobacterota;Desulfobacteria;Desulfatiglandales;";"94.9";"14.4";"447";"447";"424";"23";"0";"456736";"390783"
"V4mis2";"SILVA (only NR);Bacteria;Desulfobacterota;Desulfobacteria;Desulfatiglandales;Desulfatiglandaceae;";"94.9";"14.4";"447";"447";"424";"23";"0";"456736";"390783"
"V4mis2";"SILVA (only NR);Bacteria;Desulfobacterota;Desulfobacteria;Desulfatiglandales;Desulfatiglandaceae;Desulfatiglans;";"94.9";"14.4";"447";"447";"424";"23";"0";"456736";"390783"
"V4mis2";"SILVA (only NR);Bacteria;Desulfobacterota;Desulfobacteria;Desulfobacterales;";"94.7";"14.5";"2074";"2074";"1965";"109";"0";"455109";"389242"
"V4mis2";"SILVA (only NR);Bacteria;Desulfobacterota;Desulfobacteria;Desulfobacterales;Desulfatiferula;";"100.0";"14.4";"13";"13";"13";"0";"0";"457170";"391194"
"V4mis2";"SILVA (only NR);Bacteria;Desulfobacterota;Desulfobacteria;Desulfobacterales;Desulfobacteraceae;";"97.6";"14.4";"415";"415";"405";"10";"0";"456768";"390802"
"V4mis2";"SILVA (only NR);Bacteria;Desulfobacterota;Desulfobacteria;Desulfobacterales;Desulfobacteraceae;Candidatus Desulfamplus;";"100.0";"14.4";"2";"2";"2";"0";"0";"457181";"391205"
"V4mis2";"SILVA (only NR);Bacteria;Desulfobacterota;Desulfobacteria;Desulfobacterales;Desulfobacteraceae;Desulfobacter;";"97.7";"14.4";"87";"87";"85";"2";"0";"457096";"391122"
"V4mis2";"SILVA (only NR);Bacteria;Desulfobacterota;Desulfobacteria;Desulfobacterales;Desulfobacteraceae;Desulfobacterium;";"94.6";"14.4";"37";"37";"35";"2";"0";"457146";"391172"
"V4mis2";"SILVA (only NR);Bacteria;Desulfobacterota;Desulfobacteria;Desulfobacterales;Desulfobacteraceae;Desulfobacula;";"100.0";"14.4";"17";"17";"17";"0";"0";"457166";"391190"
"V4mis2";"SILVA (only NR);Bacteria;Desulfobacterota;Desulfobacteria;Desulfobacterales;Desulfobacteraceae;Desulfobotulus;";"100.0";"14.4";"10";"10";"10";"0";"0";"457173";"391197"
"V4mis2";"SILVA (only NR);Bacteria;Desulfobacterota;Desulfobacteria;Desulfobacterales;Desulfobacteraceae;Desulfocella;";"100.0";"14.4";"15";"15";"15";"0";"0";"457168";"391192"
"V4mis2";"SILVA (only NR);Bacteria;Desulfobacterota;Desulfobacteria;Desulfobacterales;Desulfobacteraceae;Desulfoconvexum;";"93.3";"14.4";"30";"30";"28";"2";"0";"457153";"391179"
"V4mis2";"SILVA (only NR);Bacteria;Desulfobacterota;Desulfobacteria;Desulfobacterales;Desulfobacteraceae;Desulfospira;";"100.0";"14.4";"2";"2";"2";"0";"0";"457181";"391205"
"V4mis2";"SILVA (only NR);Bacteria;Desulfobacterota;Desulfobacteria;Desulfobacterales;Desulfobacteraceae;Desulfotignum;";"95.5";"14.4";"44";"44";"42";"2";"0";"457139";"391165"
"V4mis2";"SILVA (only NR);Bacteria;Desulfobacterota;Desulfobacteria;Desulfobacterales;Desulfobacteraceae;uncultured;";"98.8";"14.4";"165";"165";"163";"2";"0";"457018";"391044"
"V4mis2";"SILVA (only NR);Bacteria;Desulfobacterota;Desulfobacteria;Desulfobacterales;Desulfococcaceae;";"89.2";"14.4";"483";"483";"431";"52";"0";"456700";"390776"
"V4mis2";"SILVA (only NR);Bacteria;Desulfobacterota;Desulfobacteria;Desulfobacterales;Desulfococcaceae;Desulfococcus;";"100.0";"14.4";"8";"8";"8";"0";"0";"457175";"391199"
"V4mis2";"SILVA (only NR);Bacteria;Desulfobacterota;Desulfobacteria;Desulfobacterales;Desulfococcaceae;Desulfonema;";"87.2";"14.4";"234";"234";"204";"30";"0";"456949";"391003"
"V4mis2";"SILVA (only NR);Bacteria;Desulfobacterota;Desulfobacteria;Desulfobacterales;Desulfococcaceae;uncultured;";"90.8";"14.4";"240";"240";"218";"22";"0";"456943";"390989"
"V4mis2";"SILVA (only NR);Bacteria;Desulfobacterota;Desulfobacteria;Desulfobacterales;Desulfolunaceae;";"92.3";"14.4";"39";"39";"36";"3";"0";"457144";"391171"
"V4mis2";"SILVA (only NR);Bacteria;Desulfobacterota;Desulfobacteria;Desulfobacterales;Desulfolunaceae;Desulfofaba;";"90.9";"14.4";"11";"11";"10";"1";"0";"457172";"391197"
"V4mis2";"SILVA (only NR);Bacteria;Desulfobacterota;Desulfobacteria;Desulfobacterales;Desulfolunaceae;Desulfofrigus;";"91.7";"14.4";"12";"12";"11";"1";"0";"457171";"391196"
"V4mis2";"SILVA (only NR);Bacteria;Desulfobacterota;Desulfobacteria;Desulfobacterales;Desulfolunaceae;Desulfoluna;";"100.0";"14.4";"3";"3";"3";"0";"0";"457180";"391204"
"V4mis2";"SILVA (only NR);Bacteria;Desulfobacterota;Desulfobacteria;Desulfobacterales;Desulfolunaceae;uncultured;";"91.7";"14.4";"12";"12";"11";"1";"0";"457171";"391196"
"V4mis2";"SILVA (only NR);Bacteria;Desulfobacterota;Desulfobacteria;Desulfobacterales;Desulforegulaceae;";"100.0";"14.4";"4";"4";"4";"0";"0";"457179";"391203"
"V4mis2";"SILVA (only NR);Bacteria;Desulfobacterota;Desulfobacteria;Desulfobacterales;Desulforegulaceae;Desulforegula;";"100.0";"14.4";"4";"4";"4";"0";"0";"457179";"391203"
"V4mis2";"SILVA (only NR);Bacteria;Desulfobacterota;Desulfobacteria;Desulfobacterales;Desulfosarcinaceae;";"96.1";"14.5";"1073";"1073";"1031";"42";"0";"456110";"390176"
"V4mis2";"SILVA (only NR);Bacteria;Desulfobacterota;Desulfobacteria;Desulfobacterales;Desulfosarcinaceae;Algorimarina;";"100.0";"14.4";"1";"1";"1";"0";"0";"457182";"391206"
"V4mis2";"SILVA (only NR);Bacteria;Desulfobacterota;Desulfobacteria;Desulfobacterales;Desulfosarcinaceae;Candidatus Magnetananas;";"100.0";"14.4";"14";"14";"14";"0";"0";"457169";"391193"
"V4mis2";"SILVA (only NR);Bacteria;Desulfobacterota;Desulfobacteria;Desulfobacterales;Desulfosarcinaceae;Candidatus Magnetoglobus;";"100.0";"14.4";"14";"14";"14";"0";"0";"457169";"391193"
"V4mis2";"SILVA (only NR);Bacteria;Desulfobacterota;Desulfobacteria;Desulfobacterales;Desulfosarcinaceae;Candidatus Magnetomorum;";"100.0";"14.4";"1";"1";"1";"0";"0";"457182";"391206"
"V4mis2";"SILVA (only NR);Bacteria;Desulfobacterota;Desulfobacteria;Desulfobacterales;Desulfosarcinaceae;Desulfatibacillum;";"92.9";"14.4";"14";"14";"13";"1";"0";"457169";"391194"
"V4mis2";"SILVA (only NR);Bacteria;Desulfobacterota;Desulfobacteria;Desulfobacterales;Desulfosarcinaceae;Desulfatirhabdium;";"85.3";"14.4";"34";"34";"29";"5";"0";"457149";"391178"
"V4mis2";"SILVA (only NR);Bacteria;Desulfobacterota;Desulfobacteria;Desulfobacterales;Desulfosarcinaceae;Desulfatitalea;";"95.5";"14.4";"22";"22";"21";"1";"0";"457161";"391186"
"V4mis2";"SILVA (only NR);Bacteria;Desulfobacterota;Desulfobacteria;Desulfobacterales;Desulfosarcinaceae;Desulfonatronobacter;";"100.0";"14.4";"10";"10";"10";"0";"0";"457173";"391197"
"V4mis2";"SILVA (only NR);Bacteria;Desulfobacterota;Desulfobacteria;Desulfobacterales;Desulfosarcinaceae;Desulfosalsimonas;";"100.0";"14.4";"10";"10";"10";"0";"0";"457173";"391197"
"V4mis2";"SILVA (only NR);Bacteria;Desulfobacterota;Desulfobacteria;Desulfobacterales;Desulfosarcinaceae;Desulfosarcina;";"95.6";"14.4";"45";"45";"43";"2";"0";"457138";"391164"
"V4mis2";"SILVA (only NR);Bacteria;Desulfobacterota;Desulfobacteria;Desulfobacterales;Desulfosarcinaceae;Incertae Sedis;";"94.3";"14.4";"35";"35";"33";"2";"0";"457148";"391174"
"V4mis2";"SILVA (only NR);Bacteria;Desulfobacterota;Desulfobacteria;Desulfobacterales;Desulfosarcinaceae;LCP-80;";"98.0";"14.4";"51";"51";"50";"1";"0";"457132";"391157"
"V4mis2";"SILVA (only NR);Bacteria;Desulfobacterota;Desulfobacteria;Desulfobacterales;Desulfosarcinaceae;SEEP-SRB1;";"96.4";"14.4";"304";"304";"293";"11";"0";"456879";"390914"
"V4mis2";"SILVA (only NR);Bacteria;Desulfobacterota;Desulfobacteria;Desulfobacterales;Desulfosarcinaceae;Sva0081 sediment group;";"96.1";"14.4";"206";"206";"198";"8";"0";"456977";"391009"
"V4mis2";"SILVA (only NR);Bacteria;Desulfobacterota;Desulfobacteria;Desulfobacterales;Desulfosarcinaceae;uncultured;";"96.3";"14.4";"301";"301";"290";"11";"0";"456882";"390917"
"V4mis2";"SILVA (only NR);Bacteria;Desulfobacterota;Desulfobacteria;Desulfobacterales;uncultured;";"95.7";"14.4";"46";"46";"44";"2";"0";"457137";"391163"
"V4mis2";"SILVA (only NR);Bacteria;Desulfobacterota;Desulfobulbia;";"96.5";"14.5";"1427";"1427";"1377";"50";"0";"455756";"389830"
"V4mis2";"SILVA (only NR);Bacteria;Desulfobacterota;Desulfobulbia;Desulfobulbales;";"96.5";"14.5";"1427";"1427";"1377";"50";"0";"455756";"389830"
"V4mis2";"SILVA (only NR);Bacteria;Desulfobacterota;Desulfobulbia;Desulfobulbales;Desulfobulbaceae;";"97.1";"14.4";"410";"410";"398";"12";"0";"456773";"390809"
"V4mis2";"SILVA (only NR);Bacteria;Desulfobacterota;Desulfobulbia;Desulfobulbales;Desulfobulbaceae;Candidatus Electronema;";"100.0";"14.4";"11";"11";"11";"0";"0";"457172";"391196"
"V4mis2";"SILVA (only NR);Bacteria;Desulfobacterota;Desulfobulbia;Desulfobulbales;Desulfobulbaceae;Candidatus Electrothrix;";"100.0";"14.4";"13";"13";"13";"0";"0";"457170";"391194"
"V4mis2";"SILVA (only NR);Bacteria;Desulfobacterota;Desulfobulbia;Desulfobulbales;Desulfobulbaceae;Desulfobulbus;";"97.1";"14.4";"210";"210";"204";"6";"0";"456973";"391003"
"V4mis2";"SILVA (only NR);Bacteria;Desulfobacterota;Desulfobulbia;Desulfobulbales;Desulfobulbaceae;uncultured;";"96.5";"14.4";"173";"173";"167";"6";"0";"457010";"391040"
"V4mis2";"SILVA (only NR);Bacteria;Desulfobacterota;Desulfobulbia;Desulfobulbales;Desulfocapsaceae;";"96.4";"14.5";"878";"878";"846";"32";"0";"456305";"390361"
"V4mis2";"SILVA (only NR);Bacteria;Desulfobacterota;Desulfobulbia;Desulfobulbales;Desulfocapsaceae;Desulfocapsa;";"93.4";"14.4";"213";"213";"199";"14";"0";"456970";"391008"
"V4mis2";"SILVA (only NR);Bacteria;Desulfobacterota;Desulfobulbia;Desulfobulbales;Desulfocapsaceae;Desulfofustis;";"97.1";"14.4";"35";"35";"34";"1";"0";"457148";"391173"
"V4mis2";"SILVA (only NR);Bacteria;Desulfobacterota;Desulfobulbia;Desulfobulbales;Desulfocapsaceae;Desulfopila;";"98.1";"14.4";"54";"54";"53";"1";"0";"457129";"391154"
"V4mis2";"SILVA (only NR);Bacteria;Desulfobacterota;Desulfobulbia;Desulfobulbales;Desulfocapsaceae;Desulfoprunum;";"100.0";"14.4";"13";"13";"13";"0";"0";"457170";"391194"
"V4mis2";"SILVA (only NR);Bacteria;Desulfobacterota;Desulfobulbia;Desulfobulbales;Desulfocapsaceae;Desulforhopalus;";"94.7";"14.4";"113";"113";"107";"6";"0";"457070";"391100"
"V4mis2";"SILVA (only NR);Bacteria;Desulfobacterota;Desulfobulbia;Desulfobulbales;Desulfocapsaceae;Desulfotalea;";"95.0";"14.4";"20";"20";"19";"1";"0";"457163";"391188"
"V4mis2";"SILVA (only NR);Bacteria;Desulfobacterota;Desulfobulbia;Desulfobulbales;Desulfocapsaceae;SEEP-SRB4;";"100.0";"14.4";"47";"47";"47";"0";"0";"457136";"391160"
"V4mis2";"SILVA (only NR);Bacteria;Desulfobacterota;Desulfobulbia;Desulfobulbales;Desulfocapsaceae;[Desulfobacterium] catecholicum group;";"96.1";"14.4";"128";"128";"123";"5";"0";"457055";"391084"
"V4mis2";"SILVA (only NR);Bacteria;Desulfobacterota;Desulfobulbia;Desulfobulbales;Desulfocapsaceae;uncultured;";"98.8";"14.4";"251";"251";"248";"3";"0";"456932";"390959"
"V4mis2";"SILVA (only NR);Bacteria;Desulfobacterota;Desulfobulbia;Desulfobulbales;Desulfurivibrionaceae;";"95.8";"14.4";"96";"96";"92";"4";"0";"457087";"391115"
"V4mis2";"SILVA (only NR);Bacteria;Desulfobacterota;Desulfobulbia;Desulfobulbales;Desulfurivibrionaceae;Desulfurivibrio;";"100.0";"14.4";"43";"43";"43";"0";"0";"457140";"391164"
"V4mis2";"SILVA (only NR);Bacteria;Desulfobacterota;Desulfobulbia;Desulfobulbales;Desulfurivibrionaceae;MSBL7;";"92.2";"14.4";"51";"51";"47";"4";"0";"457132";"391160"
"V4mis2";"SILVA (only NR);Bacteria;Desulfobacterota;Desulfobulbia;Desulfobulbales;Desulfurivibrionaceae;uncultured;";"100.0";"14.4";"2";"2";"2";"0";"0";"457181";"391205"
"V4mis2";"SILVA (only NR);Bacteria;Desulfobacterota;Desulfobulbia;Desulfobulbales;uncultured;";"95.3";"14.4";"43";"43";"41";"2";"0";"457140";"391166"
"V4mis2";"SILVA (only NR);Bacteria;Desulfobacterota;Desulfofervidia;";"88.9";"14.4";"9";"9";"8";"1";"0";"457174";"391199"
"V4mis2";"SILVA (only NR);Bacteria;Desulfobacterota;Desulfofervidia;Desulfofervidales;";"88.9";"14.4";"9";"9";"8";"1";"0";"457174";"391199"
"V4mis2";"SILVA (only NR);Bacteria;Desulfobacterota;Desulfofervidia;Desulfofervidales;Desulfofervidaceae;";"88.9";"14.4";"9";"9";"8";"1";"0";"457174";"391199"
"V4mis2";"SILVA (only NR);Bacteria;Desulfobacterota;Desulfofervidia;Desulfofervidales;Desulfofervidaceae;Candidatus Desulfofervidus;";"88.9";"14.4";"9";"9";"8";"1";"0";"457174";"391199"
"V4mis2";"SILVA (only NR);Bacteria;Desulfobacterota;Desulfomonilia;";"91.8";"14.4";"61";"61";"56";"5";"0";"457122";"391151"
"V4mis2";"SILVA (only NR);Bacteria;Desulfobacterota;Desulfomonilia;Desulfomonilales;";"91.8";"14.4";"61";"61";"56";"5";"0";"457122";"391151"
"V4mis2";"SILVA (only NR);Bacteria;Desulfobacterota;Desulfomonilia;Desulfomonilales;Desulfomonilaceae;";"91.8";"14.4";"61";"61";"56";"5";"0";"457122";"391151"
"V4mis2";"SILVA (only NR);Bacteria;Desulfobacterota;Desulfomonilia;Desulfomonilales;Desulfomonilaceae;Desulfomonile;";"91.8";"14.4";"61";"61";"56";"5";"0";"457122";"391151"
"V4mis2";"SILVA (only NR);Bacteria;Desulfobacterota;Desulfovibrionia;";"94.4";"14.5";"1124";"1124";"1061";"63";"0";"456059";"390146"
"V4mis2";"SILVA (only NR);Bacteria;Desulfobacterota;Desulfovibrionia;Desulfovibrionales;";"94.4";"14.5";"1124";"1124";"1061";"63";"0";"456059";"390146"
"V4mis2";"SILVA (only NR);Bacteria;Desulfobacterota;Desulfovibrionia;Desulfovibrionales;Desulfohalobiaceae;";"87.3";"14.4";"134";"134";"117";"17";"0";"457049";"391090"
"V4mis2";"SILVA (only NR);Bacteria;Desulfobacterota;Desulfovibrionia;Desulfovibrionales;Desulfohalobiaceae;Desulfohalobium;";"100.0";"14.4";"3";"3";"3";"0";"0";"457180";"391204"
"V4mis2";"SILVA (only NR);Bacteria;Desulfobacterota;Desulfovibrionia;Desulfovibrionales;Desulfohalobiaceae;Desulfovermiculus;";"87.0";"14.4";"131";"131";"114";"17";"0";"457052";"391093"
"V4mis2";"SILVA (only NR);Bacteria;Desulfobacterota;Desulfovibrionia;Desulfovibrionales;Desulfomicrobiaceae;";"95.7";"14.4";"94";"94";"90";"4";"0";"457089";"391117"
"V4mis2";"SILVA (only NR);Bacteria;Desulfobacterota;Desulfovibrionia;Desulfovibrionales;Desulfomicrobiaceae;Desulfomicrobium;";"95.7";"14.4";"94";"94";"90";"4";"0";"457089";"391117"
"V4mis2";"SILVA (only NR);Bacteria;Desulfobacterota;Desulfovibrionia;Desulfovibrionales;Desulfonatronaceae;";"100.0";"14.4";"19";"19";"19";"0";"0";"457164";"391188"
"V4mis2";"SILVA (only NR);Bacteria;Desulfobacterota;Desulfovibrionia;Desulfovibrionales;Desulfonatronaceae;Desulfonatronum;";"100.0";"14.4";"19";"19";"19";"0";"0";"457164";"391188"
"V4mis2";"SILVA (only NR);Bacteria;Desulfobacterota;Desulfovibrionia;Desulfovibrionales;Desulfonatronovibrionaceae;";"95.0";"14.4";"20";"20";"19";"1";"0";"457163";"391188"
"V4mis2";"SILVA (only NR);Bacteria;Desulfobacterota;Desulfovibrionia;Desulfovibrionales;Desulfonatronovibrionaceae;Desulfonatronospira;";"100.0";"14.4";"10";"10";"10";"0";"0";"457173";"391197"
"V4mis2";"SILVA (only NR);Bacteria;Desulfobacterota;Desulfovibrionia;Desulfovibrionales;Desulfonatronovibrionaceae;Desulfonatronovibrio;";"88.9";"14.4";"9";"9";"8";"1";"0";"457174";"391199"
"V4mis2";"SILVA (only NR);Bacteria;Desulfobacterota;Desulfovibrionia;Desulfovibrionales;Desulfonauticaceae;";"100.0";"14.4";"8";"8";"8";"0";"0";"457175";"391199"
"V4mis2";"SILVA (only NR);Bacteria;Desulfobacterota;Desulfovibrionia;Desulfovibrionales;Desulfonauticaceae;Desulfonauticus;";"100.0";"14.4";"4";"4";"4";"0";"0";"457179";"391203"
"V4mis2";"SILVA (only NR);Bacteria;Desulfobacterota;Desulfovibrionia;Desulfovibrionales;Desulfonauticaceae;Desulfothermus;";"100.0";"14.4";"3";"3";"3";"0";"0";"457180";"391204"
"V4mis2";"SILVA (only NR);Bacteria;Desulfobacterota;Desulfovibrionia;Desulfovibrionales;Desulfoplanaceae;";"92.0";"14.4";"25";"25";"23";"2";"0";"457158";"391184"
"V4mis2";"SILVA (only NR);Bacteria;Desulfobacterota;Desulfovibrionia;Desulfovibrionales;Desulfoplanaceae;Desulfoplanes;";"92.0";"14.4";"25";"25";"23";"2";"0";"457158";"391184"
"V4mis2";"SILVA (only NR);Bacteria;Desulfobacterota;Desulfovibrionia;Desulfovibrionales;Desulfovibrionaceae;";"95.3";"14.4";"824";"824";"785";"39";"0";"456359";"390422"
"V4mis2";"SILVA (only NR);Bacteria;Desulfobacterota;Desulfovibrionia;Desulfovibrionales;Desulfovibrionaceae;Bilophila;";"100.0";"14.4";"24";"24";"24";"0";"0";"457159";"391183"
"V4mis2";"SILVA (only NR);Bacteria;Desulfobacterota;Desulfovibrionia;Desulfovibrionales;Desulfovibrionaceae;Desulfobaculum;";"100.0";"14.4";"1";"1";"1";"0";"0";"457182";"391206"
"V4mis2";"SILVA (only NR);Bacteria;Desulfobacterota;Desulfovibrionia;Desulfovibrionales;Desulfovibrionaceae;Desulfocurvus;";"100.0";"14.4";"8";"8";"8";"0";"0";"457175";"391199"
"V4mis2";"SILVA (only NR);Bacteria;Desulfobacterota;Desulfovibrionia;Desulfovibrionales;Desulfovibrionaceae;Desulfovibrio;";"94.8";"14.4";"616";"616";"584";"32";"0";"456567";"390623"
"V4mis2";"SILVA (only NR);Bacteria;Desulfobacterota;Desulfovibrionia;Desulfovibrionales;Desulfovibrionaceae;Halodesulfovibrio;";"94.6";"14.4";"37";"37";"35";"2";"0";"457146";"391172"
"V4mis2";"SILVA (only NR);Bacteria;Desulfobacterota;Desulfovibrionia;Desulfovibrionales;Desulfovibrionaceae;Lawsonia;";"100.0";"14.4";"7";"7";"7";"0";"0";"457176";"391200"
"V4mis2";"SILVA (only NR);Bacteria;Desulfobacterota;Desulfovibrionia;Desulfovibrionales;Desulfovibrionaceae;Mailhella;";"90.0";"14.4";"10";"10";"9";"1";"0";"457173";"391198"
"V4mis2";"SILVA (only NR);Bacteria;Desulfobacterota;Desulfovibrionia;Desulfovibrionales;Desulfovibrionaceae;uncultured;";"96.6";"14.4";"117";"117";"113";"4";"0";"457066";"391094"
"V4mis2";"SILVA (only NR);Bacteria;Desulfobacterota;Desulfuromonadia;";"97.8";"14.5";"1402";"1402";"1371";"31";"0";"455781";"389836"
"V4mis2";"SILVA (only NR);Bacteria;Desulfobacterota;Desulfuromonadia;Bradymonadales;";"98.3";"14.4";"235";"235";"231";"4";"0";"456948";"390976"
"V4mis2";"SILVA (only NR);Bacteria;Desulfobacterota;Desulfuromonadia;Bradymonadales;Bradymonadaceae;";"100.0";"14.4";"97";"97";"97";"0";"0";"457086";"391110"
"V4mis2";"SILVA (only NR);Bacteria;Desulfobacterota;Desulfuromonadia;Bradymonadales;Bradymonadaceae;Bradymonas;";"100.0";"14.4";"4";"4";"4";"0";"0";"457179";"391203"
"V4mis2";"SILVA (only NR);Bacteria;Desulfobacterota;Desulfuromonadia;Desulfuromonadales;";"97.1";"14.4";"417";"417";"405";"12";"0";"456766";"390802"
"V4mis2";"SILVA (only NR);Bacteria;Desulfobacterota;Desulfuromonadia;Desulfuromonadales;C8S-102;";"100.0";"14.4";"5";"5";"5";"0";"0";"457178";"391202"
"V4mis2";"SILVA (only NR);Bacteria;Desulfobacterota;Desulfuromonadia;Desulfuromonadales;Desulfuromonadaceae;";"98.6";"14.4";"145";"145";"143";"2";"0";"457038";"391064"
"V4mis2";"SILVA (only NR);Bacteria;Desulfobacterota;Desulfuromonadia;Desulfuromonadales;Desulfuromonadaceae;Candidatus Deferrimonas;";"100.0";"14.4";"3";"3";"3";"0";"0";"457180";"391204"
"V4mis2";"SILVA (only NR);Bacteria;Desulfobacterota;Desulfuromonadia;Desulfuromonadales;Desulfuromonadaceae;Desulfuromonas;";"99.0";"14.4";"103";"103";"102";"1";"0";"457080";"391105"
"V4mis2";"SILVA (only NR);Bacteria;Desulfobacterota;Desulfuromonadia;Desulfuromonadales;Desulfuromonadaceae;Trichloromonas;";"91.7";"14.4";"12";"12";"11";"1";"0";"457171";"391196"
"V4mis2";"SILVA (only NR);Bacteria;Desulfobacterota;Desulfuromonadia;Desulfuromonadales;Geoalkalibacteraceae;";"100.0";"14.4";"20";"20";"20";"0";"0";"457163";"391187"
"V4mis2";"SILVA (only NR);Bacteria;Desulfobacterota;Desulfuromonadia;Desulfuromonadales;Geoalkalibacteraceae;Geoalkalibacter;";"100.0";"14.4";"20";"20";"20";"0";"0";"457163";"391187"
"V4mis2";"SILVA (only NR);Bacteria;Desulfobacterota;Desulfuromonadia;Desulfuromonadales;Geopsychrobacteraceae;";"96.8";"14.4";"93";"93";"90";"3";"0";"457090";"391117"
"V4mis2";"SILVA (only NR);Bacteria;Desulfobacterota;Desulfuromonadia;Desulfuromonadales;Geopsychrobacteraceae;Desulfuromusa;";"96.8";"14.4";"63";"63";"61";"2";"0";"457120";"391146"
"V4mis2";"SILVA (only NR);Bacteria;Desulfobacterota;Desulfuromonadia;Desulfuromonadales;Geopsychrobacteraceae;Geopsychrobacter;";"100.0";"14.4";"16";"16";"16";"0";"0";"457167";"391191"
"V4mis2";"SILVA (only NR);Bacteria;Desulfobacterota;Desulfuromonadia;Desulfuromonadales;Geopsychrobacteraceae;Malonomonas;";"87.5";"14.4";"8";"8";"7";"1";"0";"457175";"391200"
"V4mis2";"SILVA (only NR);Bacteria;Desulfobacterota;Desulfuromonadia;Desulfuromonadales;Geopsychrobacteraceae;Pelobacter;";"100.0";"14.4";"5";"5";"5";"0";"0";"457178";"391202"
"V4mis2";"SILVA (only NR);Bacteria;Desulfobacterota;Desulfuromonadia;Desulfuromonadales;Geothermobacteraceae;";"97.7";"14.4";"44";"44";"43";"1";"0";"457139";"391164"
"V4mis2";"SILVA (only NR);Bacteria;Desulfobacterota;Desulfuromonadia;Desulfuromonadales;Geothermobacteraceae;Geothermobacter;";"97.7";"14.4";"44";"44";"43";"1";"0";"457139";"391164"
"V4mis2";"SILVA (only NR);Bacteria;Desulfobacterota;Desulfuromonadia;Desulfuromonadales;MA-28-I98C;";"100.0";"14.4";"7";"7";"7";"0";"0";"457176";"391200"
"V4mis2";"SILVA (only NR);Bacteria;Desulfobacterota;Desulfuromonadia;Desulfuromonadales;Sva1033;";"92.1";"14.4";"63";"63";"58";"5";"0";"457120";"391149"
"V4mis2";"SILVA (only NR);Bacteria;Desulfobacterota;Desulfuromonadia;Desulfuromonadales;Syntrophotaleaceae;";"97.1";"14.4";"35";"35";"34";"1";"0";"457148";"391173"
"V4mis2";"SILVA (only NR);Bacteria;Desulfobacterota;Desulfuromonadia;Desulfuromonadales;Syntrophotaleaceae;Syntrophotalea;";"97.1";"14.4";"35";"35";"34";"1";"0";"457148";"391173"
"V4mis2";"SILVA (only NR);Bacteria;Desulfobacterota;Desulfuromonadia;Desulfuromonadales;uncultured;";"100.0";"14.4";"2";"2";"2";"0";"0";"457181";"391205"
"V4mis2";"SILVA (only NR);Bacteria;Desulfobacterota;Desulfuromonadia;Geobacterales;";"97.7";"14.4";"575";"575";"562";"13";"0";"456608";"390645"
"V4mis2";"SILVA (only NR);Bacteria;Desulfobacterota;Desulfuromonadia;Geobacterales;Geobacteraceae;";"97.7";"14.4";"571";"571";"558";"13";"0";"456612";"390649"
"V4mis2";"SILVA (only NR);Bacteria;Desulfobacterota;Desulfuromonadia;Geobacterales;Geobacteraceae;Citrifermentans;";"99.2";"14.4";"121";"121";"120";"1";"0";"457062";"391087"
"V4mis2";"SILVA (only NR);Bacteria;Desulfobacterota;Desulfuromonadia;Geobacterales;Geobacteraceae;Geobacter;";"97.3";"14.4";"219";"219";"213";"6";"0";"456964";"390994"
"V4mis2";"SILVA (only NR);Bacteria;Desulfobacterota;Desulfuromonadia;Geobacterales;Geobacteraceae;Geotalea;";"100.0";"14.4";"14";"14";"14";"0";"0";"457169";"391193"
"V4mis2";"SILVA (only NR);Bacteria;Desulfobacterota;Desulfuromonadia;Geobacterales;Geobacteraceae;Trichlorobacter;";"100.0";"14.4";"33";"33";"33";"0";"0";"457150";"391174"
"V4mis2";"SILVA (only NR);Bacteria;Desulfobacterota;Desulfuromonadia;Geobacterales;Geobacteraceae;uncultured;";"96.9";"14.4";"162";"162";"157";"5";"0";"457021";"391050"
"V4mis2";"SILVA (only NR);Bacteria;Desulfobacterota;Desulfuromonadia;Geobacterales;Pseudopelobacteraceae;";"100.0";"14.4";"4";"4";"4";"0";"0";"457179";"391203"
"V4mis2";"SILVA (only NR);Bacteria;Desulfobacterota;Desulfuromonadia;Geobacterales;Pseudopelobacteraceae;Pseudopelobacter;";"100.0";"14.4";"4";"4";"4";"0";"0";"457179";"391203"
"V4mis2";"SILVA (only NR);Bacteria;Desulfobacterota;Desulfuromonadia;PB19;";"98.8";"14.4";"171";"171";"169";"2";"0";"457012";"391038"
"V4mis2";"SILVA (only NR);Bacteria;Desulfobacterota;Desulfuromonadia;uncultured;";"100.0";"14.4";"2";"2";"2";"0";"0";"457181";"391205"
"V4mis2";"SILVA (only NR);Bacteria;Desulfobacterota;Dissulfuribacteria;";"93.8";"14.4";"80";"80";"75";"5";"0";"457103";"391132"
"V4mis2";"SILVA (only NR);Bacteria;Desulfobacterota;Dissulfuribacteria;Dissulfuribacterales;";"93.8";"14.4";"80";"80";"75";"5";"0";"457103";"391132"
"V4mis2";"SILVA (only NR);Bacteria;Desulfobacterota;Dissulfuribacteria;Dissulfuribacterales;Dissulfuribacteraceae;";"93.8";"14.4";"80";"80";"75";"5";"0";"457103";"391132"
"V4mis2";"SILVA (only NR);Bacteria;Desulfobacterota;Dissulfuribacteria;Dissulfuribacterales;Dissulfuribacteraceae;Dissulfuribacter;";"100.0";"14.4";"3";"3";"3";"0";"0";"457180";"391204"
"V4mis2";"SILVA (only NR);Bacteria;Desulfobacterota;Dissulfuribacteria;Dissulfuribacterales;Dissulfuribacteraceae;Dissulfurimicrobium;";"100.0";"14.4";"12";"12";"12";"0";"0";"457171";"391195"
"V4mis2";"SILVA (only NR);Bacteria;Desulfobacterota;Dissulfuribacteria;Dissulfuribacterales;Dissulfuribacteraceae;Dissulfurirhabdus;";"100.0";"14.4";"2";"2";"2";"0";"0";"457181";"391205"
"V4mis2";"SILVA (only NR);Bacteria;Desulfobacterota;Dissulfuribacteria;Dissulfuribacterales;Dissulfuribacteraceae;SEEP-SRB2;";"88.9";"14.4";"36";"36";"32";"4";"0";"457147";"391175"
"V4mis2";"SILVA (only NR);Bacteria;Desulfobacterota;Dissulfuribacteria;Dissulfuribacterales;Dissulfuribacteraceae;uncultured;";"95.8";"14.4";"24";"24";"23";"1";"0";"457159";"391184"
"V4mis2";"SILVA (only NR);Bacteria;Desulfobacterota;Incertae Sedis;";"88.9";"14.4";"9";"9";"8";"1";"0";"457174";"391199"
"V4mis2";"SILVA (only NR);Bacteria;Desulfobacterota;Syntrophia;";"97.3";"14.4";"451";"451";"439";"12";"0";"456732";"390768"
"V4mis2";"SILVA (only NR);Bacteria;Desulfobacterota;Syntrophia;Syntrophales;";"97.3";"14.4";"451";"451";"439";"12";"0";"456732";"390768"
"V4mis2";"SILVA (only NR);Bacteria;Desulfobacterota;Syntrophia;Syntrophales;Smithellaceae;";"96.6";"14.4";"119";"119";"115";"4";"0";"457064";"391092"
"V4mis2";"SILVA (only NR);Bacteria;Desulfobacterota;Syntrophia;Syntrophales;Smithellaceae;Smithella;";"96.6";"14.4";"119";"119";"115";"4";"0";"457064";"391092"
"V4mis2";"SILVA (only NR);Bacteria;Desulfobacterota;Syntrophia;Syntrophales;Syntrophaceae;";"97.3";"14.4";"221";"221";"215";"6";"0";"456962";"390992"
"V4mis2";"SILVA (only NR);Bacteria;Desulfobacterota;Syntrophia;Syntrophales;Syntrophaceae;Syntrophus;";"97.3";"14.4";"221";"221";"215";"6";"0";"456962";"390992"
"V4mis2";"SILVA (only NR);Bacteria;Desulfobacterota;Syntrophia;Syntrophales;uncultured;";"98.2";"14.4";"109";"109";"107";"2";"0";"457074";"391100"
"V4mis2";"SILVA (only NR);Bacteria;Desulfobacterota;Syntrophobacteria;";"95.6";"14.4";"228";"228";"218";"10";"0";"456955";"390989"
"V4mis2";"SILVA (only NR);Bacteria;Desulfobacterota;Syntrophobacteria;Syntrophobacterales;";"95.6";"14.4";"228";"228";"218";"10";"0";"456955";"390989"
"V4mis2";"SILVA (only NR);Bacteria;Desulfobacterota;Syntrophobacteria;Syntrophobacterales;Syntrophobacteraceae;";"95.7";"14.4";"161";"161";"154";"7";"0";"457022";"391053"
"V4mis2";"SILVA (only NR);Bacteria;Desulfobacterota;Syntrophobacteria;Syntrophobacterales;Syntrophobacteraceae;Desulfacinum;";"100.0";"14.4";"4";"4";"4";"0";"0";"457179";"391203"
"V4mis2";"SILVA (only NR);Bacteria;Desulfobacterota;Syntrophobacteria;Syntrophobacterales;Syntrophobacteraceae;Desulfoglaeba;";"100.0";"14.4";"1";"1";"1";"0";"0";"457182";"391206"
"V4mis2";"SILVA (only NR);Bacteria;Desulfobacterota;Syntrophobacteria;Syntrophobacterales;Syntrophobacteraceae;Desulforhabdus;";"100.0";"14.4";"11";"11";"11";"0";"0";"457172";"391196"
"V4mis2";"SILVA (only NR);Bacteria;Desulfobacterota;Syntrophobacteria;Syntrophobacterales;Syntrophobacteraceae;Desulfosoma;";"100.0";"14.4";"2";"2";"2";"0";"0";"457181";"391205"
"V4mis2";"SILVA (only NR);Bacteria;Desulfobacterota;Syntrophobacteria;Syntrophobacterales;Syntrophobacteraceae;Desulfovirga;";"100.0";"14.4";"12";"12";"12";"0";"0";"457171";"391195"
"V4mis2";"SILVA (only NR);Bacteria;Desulfobacterota;Syntrophobacteria;Syntrophobacterales;Syntrophobacteraceae;Syntrophobacter;";"95.7";"14.4";"94";"94";"90";"4";"0";"457089";"391117"
"V4mis2";"SILVA (only NR);Bacteria;Desulfobacterota;Syntrophobacteria;Syntrophobacterales;Syntrophobacteraceae;uncultured;";"91.4";"14.4";"35";"35";"32";"3";"0";"457148";"391175"
"V4mis2";"SILVA (only NR);Bacteria;Desulfobacterota;Syntrophobacteria;Syntrophobacterales;Thermodesulforhabdaceae;";"100.0";"14.4";"6";"6";"6";"0";"0";"457177";"391201"
"V4mis2";"SILVA (only NR);Bacteria;Desulfobacterota;Syntrophobacteria;Syntrophobacterales;Thermodesulforhabdaceae;Thermodesulforhabdus;";"100.0";"14.4";"6";"6";"6";"0";"0";"457177";"391201"
"V4mis2";"SILVA (only NR);Bacteria;Desulfobacterota;Syntrophobacteria;Syntrophobacterales;uncultured;";"95.1";"14.4";"61";"61";"58";"3";"0";"457122";"391149"
"V4mis2";"SILVA (only NR);Bacteria;Desulfobacterota;Syntrophorhabdia;";"98.2";"14.4";"168";"168";"165";"3";"0";"457015";"391042"
"V4mis2";"SILVA (only NR);Bacteria;Desulfobacterota;Syntrophorhabdia;Syntrophorhabdales;";"98.2";"14.4";"168";"168";"165";"3";"0";"457015";"391042"
"V4mis2";"SILVA (only NR);Bacteria;Desulfobacterota;Syntrophorhabdia;Syntrophorhabdales;Syntrophorhabdaceae;";"98.2";"14.4";"168";"168";"165";"3";"0";"457015";"391042"
"V4mis2";"SILVA (only NR);Bacteria;Desulfobacterota;Syntrophorhabdia;Syntrophorhabdales;Syntrophorhabdaceae;Syntrophorhabdus;";"98.2";"14.4";"168";"168";"165";"3";"0";"457015";"391042"
"V4mis2";"SILVA (only NR);Bacteria;Desulfobacterota;Thermodesulfobacteria;";"100.0";"14.4";"62";"62";"62";"0";"0";"457121";"391145"
"V4mis2";"SILVA (only NR);Bacteria;Desulfobacterota;Thermodesulfobacteria;Thermodesulfobacteriales;";"100.0";"14.4";"62";"62";"62";"0";"0";"457121";"391145"
"V4mis2";"SILVA (only NR);Bacteria;Desulfobacterota;Thermodesulfobacteria;Thermodesulfobacteriales;Thermodesulfobacteriaceae;";"100.0";"14.4";"62";"62";"62";"0";"0";"457121";"391145"
"V4mis2";"SILVA (only NR);Bacteria;Desulfobacterota;Thermodesulfobacteria;Thermodesulfobacteriales;Thermodesulfobacteriaceae;Caldimicrobium;";"100.0";"14.4";"28";"28";"28";"0";"0";"457155";"391179"
"V4mis2";"SILVA (only NR);Bacteria;Desulfobacterota;Thermodesulfobacteria;Thermodesulfobacteriales;Thermodesulfobacteriaceae;Geothermobacterium;";"100.0";"14.4";"4";"4";"4";"0";"0";"457179";"391203"
"V4mis2";"SILVA (only NR);Bacteria;Desulfobacterota;Thermodesulfobacteria;Thermodesulfobacteriales;Thermodesulfobacteriaceae;Thermodesulfatator;";"100.0";"14.4";"5";"5";"5";"0";"0";"457178";"391202"
"V4mis2";"SILVA (only NR);Bacteria;Desulfobacterota;Thermodesulfobacteria;Thermodesulfobacteriales;Thermodesulfobacteriaceae;Thermodesulfobacterium;";"100.0";"14.4";"10";"10";"10";"0";"0";"457173";"391197"
"V4mis2";"SILVA (only NR);Bacteria;Desulfobacterota;Thermodesulfobacteria;Thermodesulfobacteriales;Thermodesulfobacteriaceae;Thermosulfurimonas;";"100.0";"14.4";"2";"2";"2";"0";"0";"457181";"391205"
"V4mis2";"SILVA (only NR);Bacteria;Desulfobacterota;Thermodesulfobacteria;Thermodesulfobacteriales;Thermodesulfobacteriaceae;Thermosulfuriphilus;";"100.0";"14.4";"1";"1";"1";"0";"0";"457182";"391206"
"V4mis2";"SILVA (only NR);Bacteria;Desulfobacterota;Thermodesulfobacteria;Thermodesulfobacteriales;Thermodesulfobacteriaceae;uncultured;";"100.0";"14.4";"10";"10";"10";"0";"0";"457173";"391197"
"V4mis2";"SILVA (only NR);Bacteria;Desulfobacterota;uncultured;";"96.0";"14.4";"173";"173";"166";"7";"0";"457010";"391041"
"V4mis2";"SILVA (only NR);Bacteria;Dictyoglomota;";"100.0";"14.4";"8";"8";"8";"0";"0";"457175";"391199"
"V4mis2";"SILVA (only NR);Bacteria;Dictyoglomota;Dictyoglomia;";"100.0";"14.4";"8";"8";"8";"0";"0";"457175";"391199"
"V4mis2";"SILVA (only NR);Bacteria;Dictyoglomota;Dictyoglomia;Dictyoglomales;";"100.0";"14.4";"8";"8";"8";"0";"0";"457175";"391199"
"V4mis2";"SILVA (only NR);Bacteria;Dictyoglomota;Dictyoglomia;Dictyoglomales;Dictyoglomaceae;";"100.0";"14.4";"8";"8";"8";"0";"0";"457175";"391199"
"V4mis2";"SILVA (only NR);Bacteria;Dictyoglomota;Dictyoglomia;Dictyoglomales;Dictyoglomaceae;Dictyoglomus;";"100.0";"14.4";"8";"8";"8";"0";"0";"457175";"391199"
"V4mis2";"SILVA (only NR);Bacteria;Edwardsbacteria;";"100.0";"14.4";"4";"4";"4";"0";"0";"457179";"391203"
"V4mis2";"SILVA (only NR);Bacteria;Elusimicrobiota;";"96.2";"14.4";"418";"418";"402";"16";"0";"456765";"390805"
"V4mis2";"SILVA (only NR);Bacteria;Elusimicrobiota;4-29;";"100.0";"14.4";"25";"25";"25";"0";"0";"457158";"391182"
"V4mis2";"SILVA (only NR);Bacteria;Elusimicrobiota;Elusimicrobia;";"94.7";"14.4";"114";"114";"108";"6";"0";"457069";"391099"
"V4mis2";"SILVA (only NR);Bacteria;Elusimicrobiota;Elusimicrobia;Elusimicrobiales;";"100.0";"14.4";"17";"17";"17";"0";"0";"457166";"391190"
"V4mis2";"SILVA (only NR);Bacteria;Elusimicrobiota;Elusimicrobia;Elusimicrobiales;Elusimicrobiaceae;";"100.0";"14.4";"17";"17";"17";"0";"0";"457166";"391190"
"V4mis2";"SILVA (only NR);Bacteria;Elusimicrobiota;Elusimicrobia;Elusimicrobiales;Elusimicrobiaceae;Elusimicrobium;";"100.0";"14.4";"17";"17";"17";"0";"0";"457166";"391190"
"V4mis2";"SILVA (only NR);Bacteria;Elusimicrobiota;Elusimicrobia;FCPU453;";"100.0";"14.4";"2";"2";"2";"0";"0";"457181";"391205"
"V4mis2";"SILVA (only NR);Bacteria;Elusimicrobiota;Elusimicrobia;Lineage IV;";"97.1";"14.4";"68";"68";"66";"2";"0";"457115";"391141"
"V4mis2";"SILVA (only NR);Bacteria;Elusimicrobiota;Elusimicrobia;MD2894-B20;";"100.0";"14.4";"6";"6";"6";"0";"0";"457177";"391201"
"V4mis2";"SILVA (only NR);Bacteria;Elusimicrobiota;Elusimicrobia;MVP-88;";"81.0";"14.4";"21";"21";"17";"4";"0";"457162";"391190"
"V4mis2";"SILVA (only NR);Bacteria;Elusimicrobiota;Endomicrobia;";"97.5";"14.4";"158";"158";"154";"4";"0";"457025";"391053"
"V4mis2";"SILVA (only NR);Bacteria;Elusimicrobiota;Endomicrobia;Endomicrobiales;";"97.5";"14.4";"158";"158";"154";"4";"0";"457025";"391053"
"V4mis2";"SILVA (only NR);Bacteria;Elusimicrobiota;Endomicrobia;Endomicrobiales;Endomicrobiaceae;";"97.5";"14.4";"158";"158";"154";"4";"0";"457025";"391053"
"V4mis2";"SILVA (only NR);Bacteria;Elusimicrobiota;Endomicrobia;Endomicrobiales;Endomicrobiaceae;Endomicrobium;";"97.5";"14.4";"158";"158";"154";"4";"0";"457025";"391053"
"V4mis2";"SILVA (only NR);Bacteria;Elusimicrobiota;Lineage IIa;";"92.3";"14.4";"52";"52";"48";"4";"0";"457131";"391159"
"V4mis2";"SILVA (only NR);Bacteria;Elusimicrobiota;Lineage IIb;";"93.8";"14.4";"32";"32";"30";"2";"0";"457151";"391177"
"V4mis2";"SILVA (only NR);Bacteria;Elusimicrobiota;Lineage IIc;";"100.0";"14.4";"21";"21";"21";"0";"0";"457162";"391186"
"V4mis2";"SILVA (only NR);Bacteria;Elusimicrobiota;Rs-M47;";"100.0";"14.4";"13";"13";"13";"0";"0";"457170";"391194"
"V4mis2";"SILVA (only NR);Bacteria;Entotheonellaeota;";"96.7";"14.4";"152";"152";"147";"5";"0";"457031";"391060"
"V4mis2";"SILVA (only NR);Bacteria;Entotheonellaeota;Entotheonellia;";"96.7";"14.4";"152";"152";"147";"5";"0";"457031";"391060"
"V4mis2";"SILVA (only NR);Bacteria;Entotheonellaeota;Entotheonellia;Entotheonellales;";"96.7";"14.4";"152";"152";"147";"5";"0";"457031";"391060"
"V4mis2";"SILVA (only NR);Bacteria;Entotheonellaeota;Entotheonellia;Entotheonellales;Entotheonellaceae;";"96.7";"14.4";"152";"152";"147";"5";"0";"457031";"391060"
"V4mis2";"SILVA (only NR);Bacteria;Entotheonellaeota;Entotheonellia;Entotheonellales;Entotheonellaceae;Candidatus Entotheonella;";"87.1";"14.4";"31";"31";"27";"4";"0";"457152";"391180"
"V4mis2";"SILVA (only NR);Bacteria;FCPU426;";"92.1";"14.4";"38";"38";"35";"3";"0";"457145";"391172"
"V4mis2";"SILVA (only NR);Bacteria;FW113;";"100.0";"14.4";"19";"19";"19";"0";"0";"457164";"391188"
"V4mis2";"SILVA (only NR);Bacteria;Fermentibacterota;";"92.6";"14.4";"54";"54";"50";"4";"0";"457129";"391157"
"V4mis2";"SILVA (only NR);Bacteria;Fermentibacterota;Fermentibacteria;";"92.6";"14.4";"54";"54";"50";"4";"0";"457129";"391157"
"V4mis2";"SILVA (only NR);Bacteria;Fermentibacterota;Fermentibacteria;Fermentibacterales;";"92.6";"14.4";"54";"54";"50";"4";"0";"457129";"391157"
"V4mis2";"SILVA (only NR);Bacteria;Fermentibacterota;Fermentibacteria;Fermentibacterales;Fermentibacteraceae;";"92.6";"14.4";"54";"54";"50";"4";"0";"457129";"391157"
"V4mis2";"SILVA (only NR);Bacteria;Fervidibacteria;";"100.0";"14.4";"4";"4";"4";"0";"0";"457179";"391203"
"V4mis2";"SILVA (only NR);Bacteria;Fibrobacterota;";"94.3";"14.4";"739";"739";"697";"42";"0";"456444";"390510"
"V4mis2";"SILVA (only NR);Bacteria;Fibrobacterota;Chitinivibrionia;";"100.0";"14.4";"55";"55";"55";"0";"0";"457128";"391152"
"V4mis2";"SILVA (only NR);Bacteria;Fibrobacterota;Chitinivibrionia;Chitinivibrionales;";"100.0";"14.4";"10";"10";"10";"0";"0";"457173";"391197"
"V4mis2";"SILVA (only NR);Bacteria;Fibrobacterota;Chitinivibrionia;Chitinivibrionales;Chitinivibrionaceae;";"100.0";"14.4";"10";"10";"10";"0";"0";"457173";"391197"
"V4mis2";"SILVA (only NR);Bacteria;Fibrobacterota;Chitinivibrionia;Chitinivibrionales;Chitinivibrionaceae;Chitinivibrio;";"100.0";"14.4";"2";"2";"2";"0";"0";"457181";"391205"
"V4mis2";"SILVA (only NR);Bacteria;Fibrobacterota;Chitinivibrionia;Chitinivibrionales;Chitinivibrionaceae;possible genus 03;";"100.0";"14.4";"8";"8";"8";"0";"0";"457175";"391199"
"V4mis2";"SILVA (only NR);Bacteria;Fibrobacterota;Chitinivibrionia;Chitinivibrionia Incertae Sedis;";"100.0";"14.4";"13";"13";"13";"0";"0";"457170";"391194"
"V4mis2";"SILVA (only NR);Bacteria;Fibrobacterota;Chitinivibrionia;Chitinivibrionia Incertae Sedis;Unknown Family;";"100.0";"14.4";"13";"13";"13";"0";"0";"457170";"391194"
"V4mis2";"SILVA (only NR);Bacteria;Fibrobacterota;Chitinivibrionia;Chitinivibrionia Incertae Sedis;Unknown Family;possible genus 02;";"100.0";"14.4";"13";"13";"13";"0";"0";"457170";"391194"
"V4mis2";"SILVA (only NR);Bacteria;Fibrobacterota;Chitinivibrionia;uncultured;";"100.0";"14.4";"32";"32";"32";"0";"0";"457151";"391175"
"V4mis2";"SILVA (only NR);Bacteria;Fibrobacterota;Fibrobacteria;";"93.9";"14.4";"684";"684";"642";"42";"0";"456499";"390565"
"V4mis2";"SILVA (only NR);Bacteria;Fibrobacterota;Fibrobacteria;Fibrobacterales;";"93.9";"14.4";"684";"684";"642";"42";"0";"456499";"390565"
"V4mis2";"SILVA (only NR);Bacteria;Fibrobacterota;Fibrobacteria;Fibrobacterales;09D2Z48;";"75.6";"14.4";"41";"41";"31";"10";"0";"457142";"391176"
"V4mis2";"SILVA (only NR);Bacteria;Fibrobacterota;Fibrobacteria;Fibrobacterales;B122;";"100.0";"14.4";"10";"10";"10";"0";"0";"457173";"391197"
"V4mis2";"SILVA (only NR);Bacteria;Fibrobacterota;Fibrobacteria;Fibrobacterales;B18;";"100.0";"14.4";"6";"6";"6";"0";"0";"457177";"391201"
"V4mis2";"SILVA (only NR);Bacteria;Fibrobacterota;Fibrobacteria;Fibrobacterales;B5-096;";"100.0";"14.4";"2";"2";"2";"0";"0";"457181";"391205"
"V4mis2";"SILVA (only NR);Bacteria;Fibrobacterota;Fibrobacteria;Fibrobacterales;BBMC-4;";"92.1";"14.4";"38";"38";"35";"3";"0";"457145";"391172"
"V4mis2";"SILVA (only NR);Bacteria;Fibrobacterota;Fibrobacteria;Fibrobacterales;Candidatus Raymondbacteria;";"61.5";"14.4";"13";"13";"8";"5";"0";"457170";"391199"
"V4mis2";"SILVA (only NR);Bacteria;Fibrobacterota;Fibrobacteria;Fibrobacterales;Chitinispirillum;";"100.0";"14.4";"1";"1";"1";"0";"0";"457182";"391206"
"V4mis2";"SILVA (only NR);Bacteria;Fibrobacterota;Fibrobacteria;Fibrobacterales;Fibrobacteraceae;";"97.5";"14.4";"324";"324";"316";"8";"0";"456859";"390891"
"V4mis2";"SILVA (only NR);Bacteria;Fibrobacterota;Fibrobacteria;Fibrobacterales;Fibrobacteraceae;Fibrobacter;";"98.3";"14.4";"177";"177";"174";"3";"0";"457006";"391033"
"V4mis2";"SILVA (only NR);Bacteria;Fibrobacterota;Fibrobacteria;Fibrobacterales;Fibrobacteraceae;possible genus 04;";"90.0";"14.4";"20";"20";"18";"2";"0";"457163";"391189"
"V4mis2";"SILVA (only NR);Bacteria;Fibrobacterota;Fibrobacteria;Fibrobacterales;Fibrobacteraceae;possible genus 05;";"100.0";"14.4";"51";"51";"51";"0";"0";"457132";"391156"
"V4mis2";"SILVA (only NR);Bacteria;Fibrobacterota;Fibrobacteria;Fibrobacterales;Fibrobacteraceae;possible genus 06;";"100.0";"14.4";"2";"2";"2";"0";"0";"457181";"391205"
"V4mis2";"SILVA (only NR);Bacteria;Fibrobacterota;Fibrobacteria;Fibrobacterales;Fibrobacteraceae;uncultured;";"95.8";"14.4";"72";"72";"69";"3";"0";"457111";"391138"
"V4mis2";"SILVA (only NR);Bacteria;Fibrobacterota;Fibrobacteria;Fibrobacterales;MAT-CR-H6-H10;";"90.3";"14.4";"72";"72";"65";"7";"0";"457111";"391142"
"V4mis2";"SILVA (only NR);Bacteria;Fibrobacterota;Fibrobacteria;Fibrobacterales;SBXY-748;";"90.9";"14.4";"11";"11";"10";"1";"0";"457172";"391197"
"V4mis2";"SILVA (only NR);Bacteria;Fibrobacterota;Fibrobacteria;Fibrobacterales;SBYC;";"95.0";"14.4";"20";"20";"19";"1";"0";"457163";"391188"
"V4mis2";"SILVA (only NR);Bacteria;Fibrobacterota;Fibrobacteria;Fibrobacterales;SBYS-2995;";"100.0";"14.4";"4";"4";"4";"0";"0";"457179";"391203"
"V4mis2";"SILVA (only NR);Bacteria;Fibrobacterota;Fibrobacteria;Fibrobacterales;SBYZ-1017;";"90.9";"14.4";"11";"11";"10";"1";"0";"457172";"391197"
"V4mis2";"SILVA (only NR);Bacteria;Fibrobacterota;Fibrobacteria;Fibrobacterales;TG3;";"95.0";"14.4";"40";"40";"38";"2";"0";"457143";"391169"
"V4mis2";"SILVA (only NR);Bacteria;Fibrobacterota;Fibrobacteria;Fibrobacterales;uncultured;";"95.6";"14.4";"90";"90";"86";"4";"0";"457093";"391121"
"V4mis2";"SILVA (only NR);Bacteria;Firestonebacteria;";"100.0";"14.4";"4";"4";"4";"0";"0";"457179";"391203"
"V4mis2";"SILVA (only NR);Bacteria;Firmicutes;";"94.4";"16.9";"100538";"100538";"94888";"5650";"0";"356645";"296319"
"V4mis2";"SILVA (only NR);Bacteria;Firmicutes;BRH-c20a;";"96.9";"14.4";"32";"32";"31";"1";"0";"457151";"391176"
"V4mis2";"SILVA (only NR);Bacteria;Firmicutes;Bacilli;";"92.1";"15.1";"42707";"42707";"39330";"3377";"0";"414476";"351877"
"V4mis2";"SILVA (only NR);Bacteria;Firmicutes;Bacilli;Acholeplasmatales;";"95.7";"14.4";"752";"752";"720";"32";"0";"456431";"390487"
"V4mis2";"SILVA (only NR);Bacteria;Firmicutes;Bacilli;Acholeplasmatales;Acholeplasmataceae;";"95.7";"14.4";"752";"752";"720";"32";"0";"456431";"390487"
"V4mis2";"SILVA (only NR);Bacteria;Firmicutes;Bacilli;Acholeplasmatales;Acholeplasmataceae;Acholeplasma;";"96.1";"14.4";"203";"203";"195";"8";"0";"456980";"391012"
"V4mis2";"SILVA (only NR);Bacteria;Firmicutes;Bacilli;Acholeplasmatales;Acholeplasmataceae;Anaeroplasma;";"100.0";"14.4";"63";"63";"63";"0";"0";"457120";"391144"
"V4mis2";"SILVA (only NR);Bacteria;Firmicutes;Bacilli;Acholeplasmatales;Acholeplasmataceae;Candidatus Phytoplasma;";"94.9";"14.4";"468";"468";"444";"24";"0";"456715";"390763"
"V4mis2";"SILVA (only NR);Bacteria;Firmicutes;Bacilli;Acholeplasmatales;Acholeplasmataceae;DMI;";"100.0";"14.4";"4";"4";"4";"0";"0";"457179";"391203"
"V4mis2";"SILVA (only NR);Bacteria;Firmicutes;Bacilli;Acholeplasmatales;Acholeplasmataceae;EMP-G18;";"100.0";"14.4";"4";"4";"4";"0";"0";"457179";"391203"
"V4mis2";"SILVA (only NR);Bacteria;Firmicutes;Bacilli;Acholeplasmatales;Acholeplasmataceae;EUB33-2;";"100.0";"14.4";"5";"5";"5";"0";"0";"457178";"391202"
"V4mis2";"SILVA (only NR);Bacteria;Firmicutes;Bacilli;Acholeplasmatales;Acholeplasmataceae;NED5E9;";"100.0";"14.4";"3";"3";"3";"0";"0";"457180";"391204"
"V4mis2";"SILVA (only NR);Bacteria;Firmicutes;Bacilli;Acholeplasmatales;Acholeplasmataceae;T2WK15B57;";"100.0";"14.4";"2";"2";"2";"0";"0";"457181";"391205"
"V4mis2";"SILVA (only NR);Bacteria;Firmicutes;Bacilli;Alicyclobacillales;";"95.1";"14.4";"327";"327";"311";"16";"0";"456856";"390896"
"V4mis2";"SILVA (only NR);Bacteria;Firmicutes;Bacilli;Alicyclobacillales;Alicyclobacillaceae;";"95.1";"14.4";"327";"327";"311";"16";"0";"456856";"390896"
"V4mis2";"SILVA (only NR);Bacteria;Firmicutes;Bacilli;Alicyclobacillales;Alicyclobacillaceae;Acidibacillus;";"94.4";"14.4";"36";"36";"34";"2";"0";"457147";"391173"
"V4mis2";"SILVA (only NR);Bacteria;Firmicutes;Bacilli;Alicyclobacillales;Alicyclobacillaceae;Alicyclobacillus;";"97.5";"14.4";"161";"161";"157";"4";"0";"457022";"391050"
"V4mis2";"SILVA (only NR);Bacteria;Firmicutes;Bacilli;Alicyclobacillales;Alicyclobacillaceae;Effusibacillus;";"100.0";"14.4";"23";"23";"23";"0";"0";"457160";"391184"
"V4mis2";"SILVA (only NR);Bacteria;Firmicutes;Bacilli;Alicyclobacillales;Alicyclobacillaceae;Tumebacillus;";"90.7";"14.4";"107";"107";"97";"10";"0";"457076";"391110"
"V4mis2";"SILVA (only NR);Bacteria;Firmicutes;Bacilli;Aneurinibacillales;";"94.0";"14.4";"67";"67";"63";"4";"0";"457116";"391144"
"V4mis2";"SILVA (only NR);Bacteria;Firmicutes;Bacilli;Aneurinibacillales;Aneurinibacillaceae;";"94.0";"14.4";"67";"67";"63";"4";"0";"457116";"391144"
"V4mis2";"SILVA (only NR);Bacteria;Firmicutes;Bacilli;Aneurinibacillales;Aneurinibacillaceae;Aneurinibacillus;";"94.0";"14.4";"67";"67";"63";"4";"0";"457116";"391144"
"V4mis2";"SILVA (only NR);Bacteria;Firmicutes;Bacilli;Bacillales;";"91.6";"14.6";"15844";"15844";"14512";"1332";"0";"441339";"376695"
"V4mis2";"SILVA (only NR);Bacteria;Firmicutes;Bacilli;Bacillales;Bacillaceae;";"91.1";"14.6";"13753";"13753";"12528";"1225";"0";"443430";"378679"
"V4mis2";"SILVA (only NR);Bacteria;Firmicutes;Bacilli;Bacillales;Bacillaceae;Aeribacillus;";"94.1";"14.4";"51";"51";"48";"3";"0";"457132";"391159"
"V4mis2";"SILVA (only NR);Bacteria;Firmicutes;Bacilli;Bacillales;Bacillaceae;Alkalibacillus;";"94.1";"14.4";"17";"17";"16";"1";"0";"457166";"391191"
"V4mis2";"SILVA (only NR);Bacteria;Firmicutes;Bacilli;Bacillales;Bacillaceae;Allobacillus;";"85.7";"14.4";"7";"7";"6";"1";"0";"457176";"391201"
"V4mis2";"SILVA (only NR);Bacteria;Firmicutes;Bacilli;Bacillales;Bacillaceae;Amphibacillus;";"95.5";"14.4";"22";"22";"21";"1";"0";"457161";"391186"
"V4mis2";"SILVA (only NR);Bacteria;Firmicutes;Bacilli;Bacillales;Bacillaceae;Anaerobacillus;";"81.4";"14.4";"43";"43";"35";"8";"0";"457140";"391172"
"V4mis2";"SILVA (only NR);Bacteria;Firmicutes;Bacilli;Bacillales;Bacillaceae;Anoxybacillus;";"89.1";"14.4";"753";"753";"671";"82";"0";"456430";"390536"
"V4mis2";"SILVA (only NR);Bacteria;Firmicutes;Bacilli;Bacillales;Bacillaceae;Aquibacillus;";"75.0";"14.4";"8";"8";"6";"2";"0";"457175";"391201"
"V4mis2";"SILVA (only NR);Bacteria;Firmicutes;Bacilli;Bacillales;Bacillaceae;Aquisalibacillus;";"66.7";"14.4";"3";"3";"2";"1";"0";"457180";"391205"
"V4mis2";"SILVA (only NR);Bacteria;Firmicutes;Bacilli;Bacillales;Bacillaceae;Aureibacillus;";"100.0";"14.4";"4";"4";"4";"0";"0";"457179";"391203"
"V4mis2";"SILVA (only NR);Bacteria;Firmicutes;Bacilli;Bacillales;Bacillaceae;Bacillus;";"90.8";"14.6";"11146";"11146";"10125";"1021";"0";"446037";"381082"
"V4mis2";"SILVA (only NR);Bacteria;Firmicutes;Bacilli;Bacillales;Bacillaceae;Caldibacillus;";"100.0";"14.4";"15";"15";"15";"0";"0";"457168";"391192"
"V4mis2";"SILVA (only NR);Bacteria;Firmicutes;Bacilli;Bacillales;Bacillaceae;Calditerricola;";"100.0";"14.4";"4";"4";"4";"0";"0";"457179";"391203"
"V4mis2";"SILVA (only NR);Bacteria;Firmicutes;Bacilli;Bacillales;Bacillaceae;Cerasibacillus;";"75.0";"14.4";"8";"8";"6";"2";"0";"457175";"391201"
"V4mis2";"SILVA (only NR);Bacteria;Firmicutes;Bacilli;Bacillales;Bacillaceae;Falsibacillus;";"100.0";"14.4";"2";"2";"2";"0";"0";"457181";"391205"
"V4mis2";"SILVA (only NR);Bacteria;Firmicutes;Bacilli;Bacillales;Bacillaceae;Fictibacillus;";"91.9";"14.4";"86";"86";"79";"7";"0";"457097";"391128"
"V4mis2";"SILVA (only NR);Bacteria;Firmicutes;Bacilli;Bacillales;Bacillaceae;Filobacillus;";"100.0";"14.4";"2";"2";"2";"0";"0";"457181";"391205"
"V4mis2";"SILVA (only NR);Bacteria;Firmicutes;Bacilli;Bacillales;Bacillaceae;Geobacillus;";"90.9";"14.4";"595";"595";"541";"54";"0";"456588";"390666"
"V4mis2";"SILVA (only NR);Bacteria;Firmicutes;Bacilli;Bacillales;Bacillaceae;Gracilibacillus;";"89.6";"14.4";"48";"48";"43";"5";"0";"457135";"391164"
"V4mis2";"SILVA (only NR);Bacteria;Firmicutes;Bacilli;Bacillales;Bacillaceae;Halalkalibacillus;";"100.0";"14.4";"3";"3";"3";"0";"0";"457180";"391204"
"V4mis2";"SILVA (only NR);Bacteria;Firmicutes;Bacilli;Bacillales;Bacillaceae;Halobacillus;";"95.7";"14.4";"164";"164";"157";"7";"0";"457019";"391050"
"V4mis2";"SILVA (only NR);Bacteria;Firmicutes;Bacilli;Bacillales;Bacillaceae;Halolactibacillus;";"100.0";"14.4";"33";"33";"33";"0";"0";"457150";"391174"
"V4mis2";"SILVA (only NR);Bacteria;Firmicutes;Bacilli;Bacillales;Bacillaceae;Lentibacillus;";"100.0";"14.4";"21";"21";"21";"0";"0";"457162";"391186"
"V4mis2";"SILVA (only NR);Bacteria;Firmicutes;Bacilli;Bacillales;Bacillaceae;Microaerobacter;";"100.0";"14.4";"1";"1";"1";"0";"0";"457182";"391206"
"V4mis2";"SILVA (only NR);Bacteria;Firmicutes;Bacilli;Bacillales;Bacillaceae;Natronobacillus;";"100.0";"14.4";"1";"1";"1";"0";"0";"457182";"391206"
"V4mis2";"SILVA (only NR);Bacteria;Firmicutes;Bacilli;Bacillales;Bacillaceae;Oceanobacillus;";"93.4";"14.4";"198";"198";"185";"13";"0";"456985";"391022"
"V4mis2";"SILVA (only NR);Bacteria;Firmicutes;Bacilli;Bacillales;Bacillaceae;Ornithinibacillus;";"100.0";"14.4";"23";"23";"23";"0";"0";"457160";"391184"
"V4mis2";"SILVA (only NR);Bacteria;Firmicutes;Bacilli;Bacillales;Bacillaceae;Paraliobacillus;";"100.0";"14.4";"18";"18";"18";"0";"0";"457165";"391189"
"V4mis2";"SILVA (only NR);Bacteria;Firmicutes;Bacilli;Bacillales;Bacillaceae;Paucisalibacillus;";"90.0";"14.4";"10";"10";"9";"1";"0";"457173";"391198"
"V4mis2";"SILVA (only NR);Bacteria;Firmicutes;Bacilli;Bacillales;Bacillaceae;Pelagirhabdus;";"100.0";"14.4";"3";"3";"3";"0";"0";"457180";"391204"
"V4mis2";"SILVA (only NR);Bacteria;Firmicutes;Bacilli;Bacillales;Bacillaceae;Piscibacillus;";"100.0";"14.4";"11";"11";"11";"0";"0";"457172";"391196"
"V4mis2";"SILVA (only NR);Bacteria;Firmicutes;Bacilli;Bacillales;Bacillaceae;Pontibacillus;";"96.3";"14.4";"27";"27";"26";"1";"0";"457156";"391181"
"V4mis2";"SILVA (only NR);Bacteria;Firmicutes;Bacilli;Bacillales;Bacillaceae;Pseudogracilibacillus;";"100.0";"14.4";"18";"18";"18";"0";"0";"457165";"391189"
"V4mis2";"SILVA (only NR);Bacteria;Firmicutes;Bacilli;Bacillales;Bacillaceae;Saccharococcus;";"100.0";"14.4";"2";"2";"2";"0";"0";"457181";"391205"
"V4mis2";"SILVA (only NR);Bacteria;Firmicutes;Bacilli;Bacillales;Bacillaceae;Salimicrobium;";"96.2";"14.4";"26";"26";"25";"1";"0";"457157";"391182"
"V4mis2";"SILVA (only NR);Bacteria;Firmicutes;Bacilli;Bacillales;Bacillaceae;Salinibacillus;";"100.0";"14.4";"4";"4";"4";"0";"0";"457179";"391203"
"V4mis2";"SILVA (only NR);Bacteria;Firmicutes;Bacilli;Bacillales;Bacillaceae;Salirhabdus;";"83.3";"14.4";"6";"6";"5";"1";"0";"457177";"391202"
"V4mis2";"SILVA (only NR);Bacteria;Firmicutes;Bacilli;Bacillales;Bacillaceae;Saliterribacillus;";"100.0";"14.4";"3";"3";"3";"0";"0";"457180";"391204"
"V4mis2";"SILVA (only NR);Bacteria;Firmicutes;Bacilli;Bacillales;Bacillaceae;Sediminibacillus;";"100.0";"14.4";"7";"7";"7";"0";"0";"457176";"391200"
"V4mis2";"SILVA (only NR);Bacteria;Firmicutes;Bacilli;Bacillales;Bacillaceae;Sinibacillus;";"100.0";"14.4";"4";"4";"4";"0";"0";"457179";"391203"
"V4mis2";"SILVA (only NR);Bacteria;Firmicutes;Bacilli;Bacillales;Bacillaceae;Streptohalobacillus;";"100.0";"14.4";"1";"1";"1";"0";"0";"457182";"391206"
"V4mis2";"SILVA (only NR);Bacteria;Firmicutes;Bacilli;Bacillales;Bacillaceae;Tenuibacillus;";"100.0";"14.4";"3";"3";"3";"0";"0";"457180";"391204"
"V4mis2";"SILVA (only NR);Bacteria;Firmicutes;Bacilli;Bacillales;Bacillaceae;Tepidibacillus;";"100.0";"14.4";"6";"6";"6";"0";"0";"457177";"391201"
"V4mis2";"SILVA (only NR);Bacteria;Firmicutes;Bacilli;Bacillales;Bacillaceae;Terribacillus;";"95.5";"14.4";"22";"22";"21";"1";"0";"457161";"391186"
"V4mis2";"SILVA (only NR);Bacteria;Firmicutes;Bacilli;Bacillales;Bacillaceae;Thalassobacillus;";"94.7";"14.4";"19";"19";"18";"1";"0";"457164";"391189"
"V4mis2";"SILVA (only NR);Bacteria;Firmicutes;Bacilli;Bacillales;Bacillaceae;Thermolongibacillus;";"50.0";"14.4";"2";"2";"1";"1";"0";"457181";"391206"
"V4mis2";"SILVA (only NR);Bacteria;Firmicutes;Bacilli;Bacillales;Bacillaceae;Ureibacillus;";"92.9";"14.4";"28";"28";"26";"2";"0";"457155";"391181"
"V4mis2";"SILVA (only NR);Bacteria;Firmicutes;Bacilli;Bacillales;Bacillaceae;Virgibacillus;";"96.5";"14.4";"172";"172";"166";"6";"0";"457011";"391041"
"V4mis2";"SILVA (only NR);Bacteria;Firmicutes;Bacilli;Bacillales;Bacillaceae;Vulcanibacillus;";"100.0";"14.4";"16";"16";"16";"0";"0";"457167";"391191"
"V4mis2";"SILVA (only NR);Bacteria;Firmicutes;Bacilli;Bacillales;Bacillaceae;uncultured;";"96.8";"14.4";"62";"62";"60";"2";"0";"457121";"391147"
"V4mis2";"SILVA (only NR);Bacteria;Firmicutes;Bacilli;Bacillales;Marinococcaceae;";"92.4";"14.4";"105";"105";"97";"8";"0";"457078";"391110"
"V4mis2";"SILVA (only NR);Bacteria;Firmicutes;Bacilli;Bacillales;Marinococcaceae;Alteribacillus;";"95.0";"14.4";"20";"20";"19";"1";"0";"457163";"391188"
"V4mis2";"SILVA (only NR);Bacteria;Firmicutes;Bacilli;Bacillales;Marinococcaceae;Geomicrobium;";"88.9";"14.4";"9";"9";"8";"1";"0";"457174";"391199"
"V4mis2";"SILVA (only NR);Bacteria;Firmicutes;Bacilli;Bacillales;Marinococcaceae;Marinococcus;";"89.4";"14.4";"47";"47";"42";"5";"0";"457136";"391165"
"V4mis2";"SILVA (only NR);Bacteria;Firmicutes;Bacilli;Bacillales;Marinococcaceae;Natribacillus;";"100.0";"14.4";"5";"5";"5";"0";"0";"457178";"391202"
"V4mis2";"SILVA (only NR);Bacteria;Firmicutes;Bacilli;Bacillales;Marinococcaceae;Salibacterium;";"100.0";"14.4";"11";"11";"11";"0";"0";"457172";"391196"
"V4mis2";"SILVA (only NR);Bacteria;Firmicutes;Bacilli;Bacillales;Marinococcaceae;Salsuginibacillus;";"100.0";"14.4";"5";"5";"5";"0";"0";"457178";"391202"
"V4mis2";"SILVA (only NR);Bacteria;Firmicutes;Bacilli;Bacillales;Marinococcaceae;Sinobaca;";"100.0";"14.4";"4";"4";"4";"0";"0";"457179";"391203"
"V4mis2";"SILVA (only NR);Bacteria;Firmicutes;Bacilli;Bacillales;Planococcaceae;";"95.0";"14.5";"1802";"1802";"1711";"91";"0";"455381";"389496"
"V4mis2";"SILVA (only NR);Bacteria;Firmicutes;Bacilli;Bacillales;Planococcaceae;Bhargavaea;";"96.7";"14.4";"30";"30";"29";"1";"0";"457153";"391178"
"V4mis2";"SILVA (only NR);Bacteria;Firmicutes;Bacilli;Bacillales;Planococcaceae;Caryophanon;";"100.0";"14.4";"9";"9";"9";"0";"0";"457174";"391198"
"V4mis2";"SILVA (only NR);Bacteria;Firmicutes;Bacilli;Bacillales;Planococcaceae;Chryseomicrobium;";"88.9";"14.4";"27";"27";"24";"3";"0";"457156";"391183"
"V4mis2";"SILVA (only NR);Bacteria;Firmicutes;Bacilli;Bacillales;Planococcaceae;Chungangia;";"100.0";"14.4";"6";"6";"6";"0";"0";"457177";"391201"
"V4mis2";"SILVA (only NR);Bacteria;Firmicutes;Bacilli;Bacillales;Planococcaceae;Domibacillus;";"100.0";"14.4";"42";"42";"42";"0";"0";"457141";"391165"
"V4mis2";"SILVA (only NR);Bacteria;Firmicutes;Bacilli;Bacillales;Planococcaceae;Filibacter;";"100.0";"14.4";"3";"3";"3";"0";"0";"457180";"391204"
"V4mis2";"SILVA (only NR);Bacteria;Firmicutes;Bacilli;Bacillales;Planococcaceae;Jeotgalibacillus;";"100.0";"14.4";"31";"31";"31";"0";"0";"457152";"391176"
"V4mis2";"SILVA (only NR);Bacteria;Firmicutes;Bacilli;Bacillales;Planococcaceae;Kurthia;";"100.0";"14.4";"55";"55";"55";"0";"0";"457128";"391152"
"V4mis2";"SILVA (only NR);Bacteria;Firmicutes;Bacilli;Bacillales;Planococcaceae;Lysinibacillus;";"92.2";"14.4";"709";"709";"654";"55";"0";"456474";"390553"
"V4mis2";"SILVA (only NR);Bacteria;Firmicutes;Bacilli;Bacillales;Planococcaceae;Paenisporosarcina;";"97.9";"14.4";"47";"47";"46";"1";"0";"457136";"391161"
"V4mis2";"SILVA (only NR);Bacteria;Firmicutes;Bacilli;Bacillales;Planococcaceae;Planococcus;";"93.0";"14.4";"199";"199";"185";"14";"0";"456984";"391022"
"V4mis2";"SILVA (only NR);Bacteria;Firmicutes;Bacilli;Bacillales;Planococcaceae;Planomicrobium;";"95.3";"14.4";"128";"128";"122";"6";"0";"457055";"391085"
"V4mis2";"SILVA (only NR);Bacteria;Firmicutes;Bacilli;Bacillales;Planococcaceae;Psychrobacillus;";"92.2";"14.4";"64";"64";"59";"5";"0";"457119";"391148"
"V4mis2";"SILVA (only NR);Bacteria;Firmicutes;Bacilli;Bacillales;Planococcaceae;Rummeliibacillus;";"96.8";"14.4";"31";"31";"30";"1";"0";"457152";"391177"
"V4mis2";"SILVA (only NR);Bacteria;Firmicutes;Bacilli;Bacillales;Planococcaceae;Savagea;";"100.0";"14.4";"3";"3";"3";"0";"0";"457180";"391204"
"V4mis2";"SILVA (only NR);Bacteria;Firmicutes;Bacilli;Bacillales;Planococcaceae;Solibacillus;";"98.5";"14.4";"132";"132";"130";"2";"0";"457051";"391077"
"V4mis2";"SILVA (only NR);Bacteria;Firmicutes;Bacilli;Bacillales;Planococcaceae;Sporosarcina;";"98.5";"14.4";"204";"204";"201";"3";"0";"456979";"391006"
"V4mis2";"SILVA (only NR);Bacteria;Firmicutes;Bacilli;Bacillales;Planococcaceae;Viridibacillus;";"100.0";"14.4";"9";"9";"9";"0";"0";"457174";"391198"
"V4mis2";"SILVA (only NR);Bacteria;Firmicutes;Bacilli;Bacillales;Planococcaceae;[Renibacterium] salmoninarum group;";"100.0";"14.4";"2";"2";"2";"0";"0";"457181";"391205"
"V4mis2";"SILVA (only NR);Bacteria;Firmicutes;Bacilli;Bacillales;Planococcaceae;uncultured;";"100.0";"14.4";"62";"62";"62";"0";"0";"457121";"391145"
"V4mis2";"SILVA (only NR);Bacteria;Firmicutes;Bacilli;Bacillales;Salisediminibacteriaceae;";"94.5";"14.4";"91";"91";"86";"5";"0";"457092";"391121"
"V4mis2";"SILVA (only NR);Bacteria;Firmicutes;Bacilli;Bacillales;Salisediminibacteriaceae;Alkalicoccus;";"100.0";"14.4";"13";"13";"13";"0";"0";"457170";"391194"
"V4mis2";"SILVA (only NR);Bacteria;Firmicutes;Bacilli;Bacillales;Salisediminibacteriaceae;Salipaludibacillus;";"92.8";"14.4";"69";"69";"64";"5";"0";"457114";"391143"
"V4mis2";"SILVA (only NR);Bacteria;Firmicutes;Bacilli;Bacillales;Salisediminibacteriaceae;Salisediminibacterium;";"100.0";"14.4";"7";"7";"7";"0";"0";"457176";"391200"
"V4mis2";"SILVA (only NR);Bacteria;Firmicutes;Bacilli;Bacillales;Salisediminibacteriaceae;Texcoconibacillus;";"100.0";"14.4";"2";"2";"2";"0";"0";"457181";"391205"
"V4mis2";"SILVA (only NR);Bacteria;Firmicutes;Bacilli;Bacillales;Sporolactobacillaceae;";"96.8";"14.4";"93";"93";"90";"3";"0";"457090";"391117"
"V4mis2";"SILVA (only NR);Bacteria;Firmicutes;Bacilli;Bacillales;Sporolactobacillaceae;Pullulanibacillus;";"100.0";"14.4";"12";"12";"12";"0";"0";"457171";"391195"
"V4mis2";"SILVA (only NR);Bacteria;Firmicutes;Bacilli;Bacillales;Sporolactobacillaceae;Scopulibacillus;";"100.0";"14.4";"4";"4";"4";"0";"0";"457179";"391203"
"V4mis2";"SILVA (only NR);Bacteria;Firmicutes;Bacilli;Bacillales;Sporolactobacillaceae;Sporolactobacillus;";"95.5";"14.4";"67";"67";"64";"3";"0";"457116";"391143"
"V4mis2";"SILVA (only NR);Bacteria;Firmicutes;Bacilli;Bacillales;Sporolactobacillaceae;Terrilactibacillus;";"100.0";"14.4";"3";"3";"3";"0";"0";"457180";"391204"
"V4mis2";"SILVA (only NR);Bacteria;Firmicutes;Bacilli;Bacillales;Sporolactobacillaceae;Tuberibacillus;";"100.0";"14.4";"5";"5";"5";"0";"0";"457178";"391202"
"V4mis2";"SILVA (only NR);Bacteria;Firmicutes;Bacilli;Bacillales;Sporolactobacillaceae;uncultured;";"100.0";"14.4";"2";"2";"2";"0";"0";"457181";"391205"
"V4mis2";"SILVA (only NR);Bacteria;Firmicutes;Bacilli;Brevibacillales;";"93.6";"14.4";"405";"405";"379";"26";"0";"456778";"390828"
"V4mis2";"SILVA (only NR);Bacteria;Firmicutes;Bacilli;Brevibacillales;Brevibacillaceae;";"93.6";"14.4";"405";"405";"379";"26";"0";"456778";"390828"
"V4mis2";"SILVA (only NR);Bacteria;Firmicutes;Bacilli;Brevibacillales;Brevibacillaceae;Brevibacillus;";"93.6";"14.4";"405";"405";"379";"26";"0";"456778";"390828"
"V4mis2";"SILVA (only NR);Bacteria;Firmicutes;Bacilli;Caldalkalibacillales;";"100.0";"14.4";"7";"7";"7";"0";"0";"457176";"391200"
"V4mis2";"SILVA (only NR);Bacteria;Firmicutes;Bacilli;Caldalkalibacillales;Caldalkalibacillaceae;";"100.0";"14.4";"7";"7";"7";"0";"0";"457176";"391200"
"V4mis2";"SILVA (only NR);Bacteria;Firmicutes;Bacilli;Caldalkalibacillales;Caldalkalibacillaceae;Caldalkalibacillus;";"100.0";"14.4";"7";"7";"7";"0";"0";"457176";"391200"
"V4mis2";"SILVA (only NR);Bacteria;Firmicutes;Bacilli;Desulfuribacillales;";"100.0";"14.4";"11";"11";"11";"0";"0";"457172";"391196"
"V4mis2";"SILVA (only NR);Bacteria;Firmicutes;Bacilli;Desulfuribacillales;Desulfuribacillaceae;";"100.0";"14.4";"11";"11";"11";"0";"0";"457172";"391196"
"V4mis2";"SILVA (only NR);Bacteria;Firmicutes;Bacilli;Desulfuribacillales;Desulfuribacillaceae;Desulfuribacillus;";"100.0";"14.4";"11";"11";"11";"0";"0";"457172";"391196"
"V4mis2";"SILVA (only NR);Bacteria;Firmicutes;Bacilli;Entomoplasmatales;";"98.7";"14.4";"307";"307";"303";"4";"0";"456876";"390904"
"V4mis2";"SILVA (only NR);Bacteria;Firmicutes;Bacilli;Entomoplasmatales;Candidatus Spiroplasma;";"100.0";"14.4";"7";"7";"7";"0";"0";"457176";"391200"
"V4mis2";"SILVA (only NR);Bacteria;Firmicutes;Bacilli;Entomoplasmatales;Entomoplasmataceae;";"99.0";"14.4";"101";"101";"100";"1";"0";"457082";"391107"
"V4mis2";"SILVA (only NR);Bacteria;Firmicutes;Bacilli;Entomoplasmatales;Entomoplasmataceae;Entomoplasma;";"100.0";"14.4";"11";"11";"11";"0";"0";"457172";"391196"
"V4mis2";"SILVA (only NR);Bacteria;Firmicutes;Bacilli;Entomoplasmatales;Entomoplasmataceae;Mesoplasma;";"97.9";"14.4";"48";"48";"47";"1";"0";"457135";"391160"
"V4mis2";"SILVA (only NR);Bacteria;Firmicutes;Bacilli;Entomoplasmatales;Entomoplasmataceae;[Mycoplasma] group;";"100.0";"14.4";"42";"42";"42";"0";"0";"457141";"391165"
"V4mis2";"SILVA (only NR);Bacteria;Firmicutes;Bacilli;Entomoplasmatales;Entomoplasmatales Incertae Sedis;";"100.0";"14.4";"34";"34";"34";"0";"0";"457149";"391173"
"V4mis2";"SILVA (only NR);Bacteria;Firmicutes;Bacilli;Entomoplasmatales;Entomoplasmatales Incertae Sedis;Candidatus Hepatoplasma;";"100.0";"14.4";"34";"34";"34";"0";"0";"457149";"391173"
"V4mis2";"SILVA (only NR);Bacteria;Firmicutes;Bacilli;Entomoplasmatales;Spiroplasmataceae;";"98.1";"14.4";"154";"154";"151";"3";"0";"457029";"391056"
"V4mis2";"SILVA (only NR);Bacteria;Firmicutes;Bacilli;Entomoplasmatales;Spiroplasmataceae;Spiroplasma;";"98.1";"14.4";"154";"154";"151";"3";"0";"457029";"391056"
"V4mis2";"SILVA (only NR);Bacteria;Firmicutes;Bacilli;Entomoplasmatales;type III;";"100.0";"14.4";"11";"11";"11";"0";"0";"457172";"391196"
"V4mis2";"SILVA (only NR);Bacteria;Firmicutes;Bacilli;Erysipelotrichales;";"95.0";"14.5";"2343";"2343";"2227";"116";"0";"454840";"388980"
"V4mis2";"SILVA (only NR);Bacteria;Firmicutes;Bacilli;Erysipelotrichales;Erysipelatoclostridiaceae;";"95.7";"14.4";"743";"743";"711";"32";"0";"456440";"390496"
"V4mis2";"SILVA (only NR);Bacteria;Firmicutes;Bacilli;Erysipelotrichales;Erysipelatoclostridiaceae;Asteroleplasma;";"88.9";"14.4";"18";"18";"16";"2";"0";"457165";"391191"
"V4mis2";"SILVA (only NR);Bacteria;Firmicutes;Bacilli;Erysipelotrichales;Erysipelatoclostridiaceae;Candidatus Stoquefichus;";"95.0";"14.4";"40";"40";"38";"2";"0";"457143";"391169"
"V4mis2";"SILVA (only NR);Bacteria;Firmicutes;Bacilli;Erysipelotrichales;Erysipelatoclostridiaceae;Catenibacterium;";"95.4";"14.4";"130";"130";"124";"6";"0";"457053";"391083"
"V4mis2";"SILVA (only NR);Bacteria;Firmicutes;Bacilli;Erysipelotrichales;Erysipelatoclostridiaceae;Coprobacillus;";"100.0";"14.4";"10";"10";"10";"0";"0";"457173";"391197"
"V4mis2";"SILVA (only NR);Bacteria;Firmicutes;Bacilli;Erysipelotrichales;Erysipelatoclostridiaceae;Eggerthia;";"100.0";"14.4";"10";"10";"10";"0";"0";"457173";"391197"
"V4mis2";"SILVA (only NR);Bacteria;Firmicutes;Bacilli;Erysipelotrichales;Erysipelatoclostridiaceae;Erysipelatoclostridium;";"94.3";"14.4";"158";"158";"149";"9";"0";"457025";"391058"
"V4mis2";"SILVA (only NR);Bacteria;Firmicutes;Bacilli;Erysipelotrichales;Erysipelatoclostridiaceae;Erysipelotrichaceae UCG-002;";"95.0";"14.4";"40";"40";"38";"2";"0";"457143";"391169"
"V4mis2";"SILVA (only NR);Bacteria;Firmicutes;Bacilli;Erysipelotrichales;Erysipelatoclostridiaceae;Erysipelotrichaceae UCG-003;";"94.9";"14.4";"118";"118";"112";"6";"0";"457065";"391095"
"V4mis2";"SILVA (only NR);Bacteria;Firmicutes;Bacilli;Erysipelotrichales;Erysipelatoclostridiaceae;Kandleria;";"100.0";"14.4";"2";"2";"2";"0";"0";"457181";"391205"
"V4mis2";"SILVA (only NR);Bacteria;Firmicutes;Bacilli;Erysipelotrichales;Erysipelatoclostridiaceae;Sharpea;";"100.0";"14.4";"7";"7";"7";"0";"0";"457176";"391200"
"V4mis2";"SILVA (only NR);Bacteria;Firmicutes;Bacilli;Erysipelotrichales;Erysipelatoclostridiaceae;UCG-004;";"97.3";"14.4";"187";"187";"182";"5";"0";"456996";"391025"
"V4mis2";"SILVA (only NR);Bacteria;Firmicutes;Bacilli;Erysipelotrichales;Erysipelatoclostridiaceae;uncultured;";"100.0";"14.4";"17";"17";"17";"0";"0";"457166";"391190"
"V4mis2";"SILVA (only NR);Bacteria;Firmicutes;Bacilli;Erysipelotrichales;Erysipelotrichaceae;";"94.8";"14.5";"1589";"1589";"1506";"83";"0";"455594";"389701"
"V4mis2";"SILVA (only NR);Bacteria;Firmicutes;Bacilli;Erysipelotrichales;Erysipelotrichaceae;Allobaculum;";"100.0";"14.4";"16";"16";"16";"0";"0";"457167";"391191"
"V4mis2";"SILVA (only NR);Bacteria;Firmicutes;Bacilli;Erysipelotrichales;Erysipelotrichaceae;Breznakia;";"100.0";"14.4";"10";"10";"10";"0";"0";"457173";"391197"
"V4mis2";"SILVA (only NR);Bacteria;Firmicutes;Bacilli;Erysipelotrichales;Erysipelotrichaceae;Bulleidia;";"100.0";"14.4";"4";"4";"4";"0";"0";"457179";"391203"
"V4mis2";"SILVA (only NR);Bacteria;Firmicutes;Bacilli;Erysipelotrichales;Erysipelotrichaceae;Catenisphaera;";"100.0";"14.4";"21";"21";"21";"0";"0";"457162";"391186"
"V4mis2";"SILVA (only NR);Bacteria;Firmicutes;Bacilli;Erysipelotrichales;Erysipelotrichaceae;Dielma;";"96.2";"14.4";"26";"26";"25";"1";"0";"457157";"391182"
"V4mis2";"SILVA (only NR);Bacteria;Firmicutes;Bacilli;Erysipelotrichales;Erysipelotrichaceae;Dubosiella;";"97.3";"14.4";"73";"73";"71";"2";"0";"457110";"391136"
"V4mis2";"SILVA (only NR);Bacteria;Firmicutes;Bacilli;Erysipelotrichales;Erysipelotrichaceae;Erysipelothrix;";"96.8";"14.4";"190";"190";"184";"6";"0";"456993";"391023"
"V4mis2";"SILVA (only NR);Bacteria;Firmicutes;Bacilli;Erysipelotrichales;Erysipelotrichaceae;Erysipelotrichaceae UCG-006;";"94.1";"14.4";"17";"17";"16";"1";"0";"457166";"391191"
"V4mis2";"SILVA (only NR);Bacteria;Firmicutes;Bacilli;Erysipelotrichales;Erysipelotrichaceae;Erysipelotrichaceae UCG-007;";"55.6";"14.4";"18";"18";"10";"8";"0";"457165";"391197"
"V4mis2";"SILVA (only NR);Bacteria;Firmicutes;Bacilli;Erysipelotrichales;Erysipelotrichaceae;Erysipelotrichaceae UCG-008;";"100.0";"14.4";"2";"2";"2";"0";"0";"457181";"391205"
"V4mis2";"SILVA (only NR);Bacteria;Firmicutes;Bacilli;Erysipelotrichales;Erysipelotrichaceae;Erysipelotrichaceae UCG-009;";"100.0";"14.4";"14";"14";"14";"0";"0";"457169";"391193"
"V4mis2";"SILVA (only NR);Bacteria;Firmicutes;Bacilli;Erysipelotrichales;Erysipelotrichaceae;Faecalibaculum;";"96.2";"14.4";"424";"424";"408";"16";"0";"456759";"390799"
"V4mis2";"SILVA (only NR);Bacteria;Firmicutes;Bacilli;Erysipelotrichales;Erysipelotrichaceae;Faecalicoccus;";"100.0";"14.4";"5";"5";"5";"0";"0";"457178";"391202"
"V4mis2";"SILVA (only NR);Bacteria;Firmicutes;Bacilli;Erysipelotrichales;Erysipelotrichaceae;Faecalitalea;";"100.0";"14.4";"48";"48";"48";"0";"0";"457135";"391159"
"V4mis2";"SILVA (only NR);Bacteria;Firmicutes;Bacilli;Erysipelotrichales;Erysipelotrichaceae;Holdemanella;";"94.5";"14.4";"182";"182";"172";"10";"0";"457001";"391035"
"V4mis2";"SILVA (only NR);Bacteria;Firmicutes;Bacilli;Erysipelotrichales;Erysipelotrichaceae;Holdemania;";"85.7";"14.4";"7";"7";"6";"1";"0";"457176";"391201"
"V4mis2";"SILVA (only NR);Bacteria;Firmicutes;Bacilli;Erysipelotrichales;Erysipelotrichaceae;Ileibacterium;";"100.0";"14.4";"7";"7";"7";"0";"0";"457176";"391200"
"V4mis2";"SILVA (only NR);Bacteria;Firmicutes;Bacilli;Erysipelotrichales;Erysipelotrichaceae;Merdibacter;";"100.0";"14.4";"5";"5";"5";"0";"0";"457178";"391202"
"V4mis2";"SILVA (only NR);Bacteria;Firmicutes;Bacilli;Erysipelotrichales;Erysipelotrichaceae;Solobacterium;";"98.9";"14.4";"89";"89";"88";"1";"0";"457094";"391119"
"V4mis2";"SILVA (only NR);Bacteria;Firmicutes;Bacilli;Erysipelotrichales;Erysipelotrichaceae;Turicibacter;";"91.7";"14.4";"144";"144";"132";"12";"0";"457039";"391075"
"V4mis2";"SILVA (only NR);Bacteria;Firmicutes;Bacilli;Erysipelotrichales;Erysipelotrichaceae;ZOR0006;";"100.0";"14.4";"40";"40";"40";"0";"0";"457143";"391167"
"V4mis2";"SILVA (only NR);Bacteria;Firmicutes;Bacilli;Erysipelotrichales;Erysipelotrichaceae;[Anaerorhabdus] furcosa group;";"97.7";"14.4";"44";"44";"43";"1";"0";"457139";"391164"
"V4mis2";"SILVA (only NR);Bacteria;Firmicutes;Bacilli;Erysipelotrichales;Erysipelotrichaceae;[Clostridium] innocuum group;";"81.9";"14.4";"105";"105";"86";"19";"0";"457078";"391121"
"V4mis2";"SILVA (only NR);Bacteria;Firmicutes;Bacilli;Erysipelotrichales;Erysipelotrichaceae;uncultured;";"95.8";"14.4";"95";"95";"91";"4";"0";"457088";"391116"
"V4mis2";"SILVA (only NR);Bacteria;Firmicutes;Bacilli;Erysipelotrichales;uncultured;";"90.9";"14.4";"11";"11";"10";"1";"0";"457172";"391197"
"V4mis2";"SILVA (only NR);Bacteria;Firmicutes;Bacilli;Exiguobacterales;";"87.7";"14.4";"317";"317";"278";"39";"0";"456866";"390929"
"V4mis2";"SILVA (only NR);Bacteria;Firmicutes;Bacilli;Exiguobacterales;Exiguobacteraceae;";"87.7";"14.4";"317";"317";"278";"39";"0";"456866";"390929"
"V4mis2";"SILVA (only NR);Bacteria;Firmicutes;Bacilli;Exiguobacterales;Exiguobacteraceae;Exiguobacterium;";"87.7";"14.4";"317";"317";"278";"39";"0";"456866";"390929"
"V4mis2";"SILVA (only NR);Bacteria;Firmicutes;Bacilli;Haloplasmatales;";"92.9";"14.4";"28";"28";"26";"2";"0";"457155";"391181"
"V4mis2";"SILVA (only NR);Bacteria;Firmicutes;Bacilli;Haloplasmatales;Haloplasmataceae;";"92.9";"14.4";"28";"28";"26";"2";"0";"457155";"391181"
"V4mis2";"SILVA (only NR);Bacteria;Firmicutes;Bacilli;Haloplasmatales;Haloplasmataceae;Haloplasma;";"92.9";"14.4";"28";"28";"26";"2";"0";"457155";"391181"
"V4mis2";"SILVA (only NR);Bacteria;Firmicutes;Bacilli;Izemoplasmatales;";"92.5";"14.4";"107";"107";"99";"8";"0";"457076";"391108"
"V4mis2";"SILVA (only NR);Bacteria;Firmicutes;Bacilli;Izemoplasmatales;Izemoplasmataceae;";"89.5";"14.4";"38";"38";"34";"4";"0";"457145";"391173"
"V4mis2";"SILVA (only NR);Bacteria;Firmicutes;Bacilli;Izemoplasmatales;Izemoplasmataceae;Izimaplasma;";"91.3";"14.4";"23";"23";"21";"2";"0";"457160";"391186"
"V4mis2";"SILVA (only NR);Bacteria;Firmicutes;Bacilli;Kyrpidiales;";"95.0";"14.4";"20";"20";"19";"1";"0";"457163";"391188"
"V4mis2";"SILVA (only NR);Bacteria;Firmicutes;Bacilli;Kyrpidiales;Kyrpidiaceae;";"95.0";"14.4";"20";"20";"19";"1";"0";"457163";"391188"
"V4mis2";"SILVA (only NR);Bacteria;Firmicutes;Bacilli;Kyrpidiales;Kyrpidiaceae;Kyrpidia;";"95.0";"14.4";"20";"20";"19";"1";"0";"457163";"391188"
"V4mis2";"SILVA (only NR);Bacteria;Firmicutes;Bacilli;Lactobacillales;";"92.5";"14.6";"13176";"13176";"12186";"990";"0";"444007";"379021"
"V4mis2";"SILVA (only NR);Bacteria;Firmicutes;Bacilli;Lactobacillales;Aerococcaceae;";"92.4";"14.4";"264";"264";"244";"20";"0";"456919";"390963"
"V4mis2";"SILVA (only NR);Bacteria;Firmicutes;Bacilli;Lactobacillales;Aerococcaceae;Abiotrophia;";"95.3";"14.4";"43";"43";"41";"2";"0";"457140";"391166"
"V4mis2";"SILVA (only NR);Bacteria;Firmicutes;Bacilli;Lactobacillales;Aerococcaceae;Aerococcus;";"86.7";"14.4";"113";"113";"98";"15";"0";"457070";"391109"
"V4mis2";"SILVA (only NR);Bacteria;Firmicutes;Bacilli;Lactobacillales;Aerococcaceae;Aerosphaera;";"100.0";"14.4";"11";"11";"11";"0";"0";"457172";"391196"
"V4mis2";"SILVA (only NR);Bacteria;Firmicutes;Bacilli;Lactobacillales;Aerococcaceae;Atopobacter;";"100.0";"14.4";"1";"1";"1";"0";"0";"457182";"391206"
"V4mis2";"SILVA (only NR);Bacteria;Firmicutes;Bacilli;Lactobacillales;Aerococcaceae;Bavariicoccus;";"100.0";"14.4";"3";"3";"3";"0";"0";"457180";"391204"
"V4mis2";"SILVA (only NR);Bacteria;Firmicutes;Bacilli;Lactobacillales;Aerococcaceae;Dolosicoccus;";"100.0";"14.4";"2";"2";"2";"0";"0";"457181";"391205"
"V4mis2";"SILVA (only NR);Bacteria;Firmicutes;Bacilli;Lactobacillales;Aerococcaceae;Eremococcus;";"85.7";"14.4";"7";"7";"6";"1";"0";"457176";"391201"
"V4mis2";"SILVA (only NR);Bacteria;Firmicutes;Bacilli;Lactobacillales;Aerococcaceae;Facklamia;";"97.6";"14.4";"41";"41";"40";"1";"0";"457142";"391167"
"V4mis2";"SILVA (only NR);Bacteria;Firmicutes;Bacilli;Lactobacillales;Aerococcaceae;Globicatella;";"100.0";"14.4";"14";"14";"14";"0";"0";"457169";"391193"
"V4mis2";"SILVA (only NR);Bacteria;Firmicutes;Bacilli;Lactobacillales;Aerococcaceae;Ignavigranum;";"100.0";"14.4";"17";"17";"17";"0";"0";"457166";"391190"
"V4mis2";"SILVA (only NR);Bacteria;Firmicutes;Bacilli;Lactobacillales;Aerococcaceae;uncultured;";"88.9";"14.4";"9";"9";"8";"1";"0";"457174";"391199"
"V4mis2";"SILVA (only NR);Bacteria;Firmicutes;Bacilli;Lactobacillales;Carnobacteriaceae;";"92.6";"14.4";"772";"772";"715";"57";"0";"456411";"390492"
"V4mis2";"SILVA (only NR);Bacteria;Firmicutes;Bacilli;Lactobacillales;Carnobacteriaceae;Alkalibacterium;";"97.5";"14.4";"40";"40";"39";"1";"0";"457143";"391168"
"V4mis2";"SILVA (only NR);Bacteria;Firmicutes;Bacilli;Lactobacillales;Carnobacteriaceae;Allofustis;";"100.0";"14.4";"4";"4";"4";"0";"0";"457179";"391203"
"V4mis2";"SILVA (only NR);Bacteria;Firmicutes;Bacilli;Lactobacillales;Carnobacteriaceae;Alloiococcus;";"88.5";"14.4";"26";"26";"23";"3";"0";"457157";"391184"
"V4mis2";"SILVA (only NR);Bacteria;Firmicutes;Bacilli;Lactobacillales;Carnobacteriaceae;Atopococcus;";"87.5";"14.4";"8";"8";"7";"1";"0";"457175";"391200"
"V4mis2";"SILVA (only NR);Bacteria;Firmicutes;Bacilli;Lactobacillales;Carnobacteriaceae;Atopostipes;";"96.7";"14.4";"60";"60";"58";"2";"0";"457123";"391149"
"V4mis2";"SILVA (only NR);Bacteria;Firmicutes;Bacilli;Lactobacillales;Carnobacteriaceae;Carnobacterium;";"98.5";"14.4";"68";"68";"67";"1";"0";"457115";"391140"
"V4mis2";"SILVA (only NR);Bacteria;Firmicutes;Bacilli;Lactobacillales;Carnobacteriaceae;Desemzia;";"96.3";"14.4";"27";"27";"26";"1";"0";"457156";"391181"
"V4mis2";"SILVA (only NR);Bacteria;Firmicutes;Bacilli;Lactobacillales;Carnobacteriaceae;Dolosigranulum;";"87.2";"14.4";"125";"125";"109";"16";"0";"457058";"391098"
"V4mis2";"SILVA (only NR);Bacteria;Firmicutes;Bacilli;Lactobacillales;Carnobacteriaceae;Granulicatella;";"86.7";"14.4";"225";"225";"195";"30";"0";"456958";"391012"
"V4mis2";"SILVA (only NR);Bacteria;Firmicutes;Bacilli;Lactobacillales;Carnobacteriaceae;Isobaculum;";"100.0";"14.4";"1";"1";"1";"0";"0";"457182";"391206"
"V4mis2";"SILVA (only NR);Bacteria;Firmicutes;Bacilli;Lactobacillales;Carnobacteriaceae;Jeotgalibaca;";"100.0";"14.4";"44";"44";"44";"0";"0";"457139";"391163"
"V4mis2";"SILVA (only NR);Bacteria;Firmicutes;Bacilli;Lactobacillales;Carnobacteriaceae;Lacticigenium;";"100.0";"14.4";"5";"5";"5";"0";"0";"457178";"391202"
"V4mis2";"SILVA (only NR);Bacteria;Firmicutes;Bacilli;Lactobacillales;Carnobacteriaceae;Marinilactibacillus;";"100.0";"14.4";"33";"33";"33";"0";"0";"457150";"391174"
"V4mis2";"SILVA (only NR);Bacteria;Firmicutes;Bacilli;Lactobacillales;Carnobacteriaceae;Nostocoida;";"100.0";"14.4";"1";"1";"1";"0";"0";"457182";"391206"
"V4mis2";"SILVA (only NR);Bacteria;Firmicutes;Bacilli;Lactobacillales;Carnobacteriaceae;Pisciglobus;";"100.0";"14.4";"3";"3";"3";"0";"0";"457180";"391204"
"V4mis2";"SILVA (only NR);Bacteria;Firmicutes;Bacilli;Lactobacillales;Carnobacteriaceae;Trichococcus;";"100.0";"14.4";"75";"75";"75";"0";"0";"457108";"391132"
"V4mis2";"SILVA (only NR);Bacteria;Firmicutes;Bacilli;Lactobacillales;Carnobacteriaceae;uncultured;";"100.0";"14.4";"22";"22";"22";"0";"0";"457161";"391185"
"V4mis2";"SILVA (only NR);Bacteria;Firmicutes;Bacilli;Lactobacillales;Catellicoccaceae;";"100.0";"14.4";"7";"7";"7";"0";"0";"457176";"391200"
"V4mis2";"SILVA (only NR);Bacteria;Firmicutes;Bacilli;Lactobacillales;Catellicoccaceae;Catellicoccus;";"100.0";"14.4";"7";"7";"7";"0";"0";"457176";"391200"
"V4mis2";"SILVA (only NR);Bacteria;Firmicutes;Bacilli;Lactobacillales;Enterococcaceae;";"94.0";"14.5";"1600";"1600";"1504";"96";"0";"455583";"389703"
"V4mis2";"SILVA (only NR);Bacteria;Firmicutes;Bacilli;Lactobacillales;Enterococcaceae;Enterococcus;";"93.9";"14.5";"1551";"1551";"1456";"95";"0";"455632";"389751"
"V4mis2";"SILVA (only NR);Bacteria;Firmicutes;Bacilli;Lactobacillales;Enterococcaceae;Melissococcus;";"100.0";"14.4";"9";"9";"9";"0";"0";"457174";"391198"
"V4mis2";"SILVA (only NR);Bacteria;Firmicutes;Bacilli;Lactobacillales;Enterococcaceae;Tetragenococcus;";"97.4";"14.4";"39";"39";"38";"1";"0";"457144";"391169"
"V4mis2";"SILVA (only NR);Bacteria;Firmicutes;Bacilli;Lactobacillales;Lactobacillaceae;";"92.7";"14.5";"4739";"4739";"4391";"348";"0";"452444";"386816"
"V4mis2";"SILVA (only NR);Bacteria;Firmicutes;Bacilli;Lactobacillales;Lactobacillaceae;Agrilactobacillus;";"100.0";"14.4";"3";"3";"3";"0";"0";"457180";"391204"
"V4mis2";"SILVA (only NR);Bacteria;Firmicutes;Bacilli;Lactobacillales;Lactobacillaceae;Amylolactobacillus;";"100.0";"14.4";"10";"10";"10";"0";"0";"457173";"391197"
"V4mis2";"SILVA (only NR);Bacteria;Firmicutes;Bacilli;Lactobacillales;Lactobacillaceae;Apilactobacillus;";"100.0";"14.4";"42";"42";"42";"0";"0";"457141";"391165"
"V4mis2";"SILVA (only NR);Bacteria;Firmicutes;Bacilli;Lactobacillales;Lactobacillaceae;Bombilactobacillus;";"100.0";"14.4";"19";"19";"19";"0";"0";"457164";"391188"
"V4mis2";"SILVA (only NR);Bacteria;Firmicutes;Bacilli;Lactobacillales;Lactobacillaceae;Companilactobacillus;";"98.6";"14.4";"73";"73";"72";"1";"0";"457110";"391135"
"V4mis2";"SILVA (only NR);Bacteria;Firmicutes;Bacilli;Lactobacillales;Lactobacillaceae;Dellaglioa;";"100.0";"14.4";"2";"2";"2";"0";"0";"457181";"391205"
"V4mis2";"SILVA (only NR);Bacteria;Firmicutes;Bacilli;Lactobacillales;Lactobacillaceae;Fructilactobacillus;";"96.8";"14.4";"31";"31";"30";"1";"0";"457152";"391177"
"V4mis2";"SILVA (only NR);Bacteria;Firmicutes;Bacilli;Lactobacillales;Lactobacillaceae;Fructobacillus;";"91.3";"14.4";"23";"23";"21";"2";"0";"457160";"391186"
"V4mis2";"SILVA (only NR);Bacteria;Firmicutes;Bacilli;Lactobacillales;Lactobacillaceae;Furfurilactobacillus;";"100.0";"14.4";"12";"12";"12";"0";"0";"457171";"391195"
"V4mis2";"SILVA (only NR);Bacteria;Firmicutes;Bacilli;Lactobacillales;Lactobacillaceae;HT002;";"100.0";"14.4";"12";"12";"12";"0";"0";"457171";"391195"
"V4mis2";"SILVA (only NR);Bacteria;Firmicutes;Bacilli;Lactobacillales;Lactobacillaceae;Holzapfelia;";"100.0";"14.4";"1";"1";"1";"0";"0";"457182";"391206"
"V4mis2";"SILVA (only NR);Bacteria;Firmicutes;Bacilli;Lactobacillales;Lactobacillaceae;Lacticaseibacillus;";"92.5";"14.4";"411";"411";"380";"31";"0";"456772";"390827"
"V4mis2";"SILVA (only NR);Bacteria;Firmicutes;Bacilli;Lactobacillales;Lactobacillaceae;Lactiplantibacillus;";"90.8";"14.4";"671";"671";"609";"62";"0";"456512";"390598"
"V4mis2";"SILVA (only NR);Bacteria;Firmicutes;Bacilli;Lactobacillales;Lactobacillaceae;Lactobacillus;";"93.1";"14.4";"1068";"1068";"994";"74";"0";"456115";"390213"
"V4mis2";"SILVA (only NR);Bacteria;Firmicutes;Bacilli;Lactobacillales;Lactobacillaceae;Lapidilactobacillus;";"100.0";"14.4";"4";"4";"4";"0";"0";"457179";"391203"
"V4mis2";"SILVA (only NR);Bacteria;Firmicutes;Bacilli;Lactobacillales;Lactobacillaceae;Latilactobacillus;";"96.9";"14.4";"130";"130";"126";"4";"0";"457053";"391081"
"V4mis2";"SILVA (only NR);Bacteria;Firmicutes;Bacilli;Lactobacillales;Lactobacillaceae;Lentilactobacillus;";"94.2";"14.4";"120";"120";"113";"7";"0";"457063";"391094"
"V4mis2";"SILVA (only NR);Bacteria;Firmicutes;Bacilli;Lactobacillales;Lactobacillaceae;Leuconostoc;";"89.0";"14.4";"336";"336";"299";"37";"0";"456847";"390908"
"V4mis2";"SILVA (only NR);Bacteria;Firmicutes;Bacilli;Lactobacillales;Lactobacillaceae;Levilactobacillus;";"92.4";"14.4";"158";"158";"146";"12";"0";"457025";"391061"
"V4mis2";"SILVA (only NR);Bacteria;Firmicutes;Bacilli;Lactobacillales;Lactobacillaceae;Ligilactobacillus;";"90.5";"14.4";"328";"328";"297";"31";"0";"456855";"390910"
"V4mis2";"SILVA (only NR);Bacteria;Firmicutes;Bacilli;Lactobacillales;Lactobacillaceae;Limosilactobacillus;";"93.8";"14.4";"616";"616";"578";"38";"0";"456567";"390629"
"V4mis2";"SILVA (only NR);Bacteria;Firmicutes;Bacilli;Lactobacillales;Lactobacillaceae;Liquorilactobacillus;";"89.2";"14.4";"37";"37";"33";"4";"0";"457146";"391174"
"V4mis2";"SILVA (only NR);Bacteria;Firmicutes;Bacilli;Lactobacillales;Lactobacillaceae;Loigolactobacillus;";"100.0";"14.4";"45";"45";"45";"0";"0";"457138";"391162"
"V4mis2";"SILVA (only NR);Bacteria;Firmicutes;Bacilli;Lactobacillales;Lactobacillaceae;Oenococcus;";"100.0";"14.4";"16";"16";"16";"0";"0";"457167";"391191"
"V4mis2";"SILVA (only NR);Bacteria;Firmicutes;Bacilli;Lactobacillales;Lactobacillaceae;Paralactobacillus;";"100.0";"14.4";"3";"3";"3";"0";"0";"457180";"391204"
"V4mis2";"SILVA (only NR);Bacteria;Firmicutes;Bacilli;Lactobacillales;Lactobacillaceae;Paucilactobacillus;";"88.0";"14.4";"25";"25";"22";"3";"0";"457158";"391185"
"V4mis2";"SILVA (only NR);Bacteria;Firmicutes;Bacilli;Lactobacillales;Lactobacillaceae;Pediococcus;";"94.3";"14.4";"229";"229";"216";"13";"0";"456954";"390991"
"V4mis2";"SILVA (only NR);Bacteria;Firmicutes;Bacilli;Lactobacillales;Lactobacillaceae;Schleiferilactobacillus;";"92.9";"14.4";"14";"14";"13";"1";"0";"457169";"391194"
"V4mis2";"SILVA (only NR);Bacteria;Firmicutes;Bacilli;Lactobacillales;Lactobacillaceae;Secundilactobacillus;";"100.0";"14.4";"30";"30";"30";"0";"0";"457153";"391177"
"V4mis2";"SILVA (only NR);Bacteria;Firmicutes;Bacilli;Lactobacillales;Lactobacillaceae;Weissella;";"89.8";"14.4";"256";"256";"230";"26";"0";"456927";"390977"
"V4mis2";"SILVA (only NR);Bacteria;Firmicutes;Bacilli;Lactobacillales;Lactobacillaceae;uncultured;";"91.7";"14.4";"12";"12";"11";"1";"0";"457171";"391196"
"V4mis2";"SILVA (only NR);Bacteria;Firmicutes;Bacilli;Lactobacillales;Listeriaceae;";"97.3";"14.4";"337";"337";"328";"9";"0";"456846";"390879"
"V4mis2";"SILVA (only NR);Bacteria;Firmicutes;Bacilli;Lactobacillales;Listeriaceae;Brochothrix;";"93.3";"14.4";"30";"30";"28";"2";"0";"457153";"391179"
"V4mis2";"SILVA (only NR);Bacteria;Firmicutes;Bacilli;Lactobacillales;Listeriaceae;Listeria;";"97.7";"14.4";"307";"307";"300";"7";"0";"456876";"390907"
"V4mis2";"SILVA (only NR);Bacteria;Firmicutes;Bacilli;Lactobacillales;P5D1-392;";"95.5";"14.4";"22";"22";"21";"1";"0";"457161";"391186"
"V4mis2";"SILVA (only NR);Bacteria;Firmicutes;Bacilli;Lactobacillales;Streptococcaceae;";"91.5";"14.5";"5371";"5371";"4915";"456";"0";"451812";"386292"
"V4mis2";"SILVA (only NR);Bacteria;Firmicutes;Bacilli;Lactobacillales;Streptococcaceae;Floricoccus;";"100.0";"14.4";"5";"5";"5";"0";"0";"457178";"391202"
"V4mis2";"SILVA (only NR);Bacteria;Firmicutes;Bacilli;Lactobacillales;Streptococcaceae;Lactococcus;";"93.8";"14.4";"420";"420";"394";"26";"0";"456763";"390813"
"V4mis2";"SILVA (only NR);Bacteria;Firmicutes;Bacilli;Lactobacillales;Streptococcaceae;Lactovum;";"100.0";"14.4";"15";"15";"15";"0";"0";"457168";"391192"
"V4mis2";"SILVA (only NR);Bacteria;Firmicutes;Bacilli;Lactobacillales;Streptococcaceae;Pilibacter;";"100.0";"14.4";"7";"7";"7";"0";"0";"457176";"391200"
"V4mis2";"SILVA (only NR);Bacteria;Firmicutes;Bacilli;Lactobacillales;Streptococcaceae;Streptococcus;";"91.3";"14.5";"4924";"4924";"4494";"430";"0";"452259";"386713"
"V4mis2";"SILVA (only NR);Bacteria;Firmicutes;Bacilli;Lactobacillales;Vagococcaceae;";"95.7";"14.4";"46";"46";"44";"2";"0";"457137";"391163"
"V4mis2";"SILVA (only NR);Bacteria;Firmicutes;Bacilli;Lactobacillales;Vagococcaceae;Vagococcus;";"95.7";"14.4";"46";"46";"44";"2";"0";"457137";"391163"
"V4mis2";"SILVA (only NR);Bacteria;Firmicutes;Bacilli;Lactobacillales;uncultured;";"93.3";"14.4";"15";"15";"14";"1";"0";"457168";"391193"
"V4mis2";"SILVA (only NR);Bacteria;Firmicutes;Bacilli;Mycoplasmatales;";"99.2";"14.5";"743";"743";"737";"6";"0";"456440";"390470"
"V4mis2";"SILVA (only NR);Bacteria;Firmicutes;Bacilli;Mycoplasmatales;Mycoplasmataceae;";"99.2";"14.5";"743";"743";"737";"6";"0";"456440";"390470"
"V4mis2";"SILVA (only NR);Bacteria;Firmicutes;Bacilli;Mycoplasmatales;Mycoplasmataceae;Candidatus Bacilloplasma;";"100.0";"14.4";"13";"13";"13";"0";"0";"457170";"391194"
"V4mis2";"SILVA (only NR);Bacteria;Firmicutes;Bacilli;Mycoplasmatales;Mycoplasmataceae;Candidatus Lumbricincola;";"100.0";"14.4";"5";"5";"5";"0";"0";"457178";"391202"
"V4mis2";"SILVA (only NR);Bacteria;Firmicutes;Bacilli;Mycoplasmatales;Mycoplasmataceae;Mycoplasma;";"99.2";"14.4";"607";"607";"602";"5";"0";"456576";"390605"
"V4mis2";"SILVA (only NR);Bacteria;Firmicutes;Bacilli;Mycoplasmatales;Mycoplasmataceae;Ureaplasma;";"99.1";"14.4";"107";"107";"106";"1";"0";"457076";"391101"
"V4mis2";"SILVA (only NR);Bacteria;Firmicutes;Bacilli;Mycoplasmatales;Mycoplasmataceae;uncultured;";"100.0";"14.4";"11";"11";"11";"0";"0";"457172";"391196"
"V4mis2";"SILVA (only NR);Bacteria;Firmicutes;Bacilli;Paenibacillales;";"96.6";"14.5";"2551";"2551";"2464";"87";"0";"454632";"388743"
"V4mis2";"SILVA (only NR);Bacteria;Firmicutes;Bacilli;Paenibacillales;Paenibacillaceae;";"96.6";"14.5";"2551";"2551";"2464";"87";"0";"454632";"388743"
"V4mis2";"SILVA (only NR);Bacteria;Firmicutes;Bacilli;Paenibacillales;Paenibacillaceae;Ammoniibacillus;";"100.0";"14.4";"4";"4";"4";"0";"0";"457179";"391203"
"V4mis2";"SILVA (only NR);Bacteria;Firmicutes;Bacilli;Paenibacillales;Paenibacillaceae;Ammoniphilus;";"100.0";"14.4";"24";"24";"24";"0";"0";"457159";"391183"
"V4mis2";"SILVA (only NR);Bacteria;Firmicutes;Bacilli;Paenibacillales;Paenibacillaceae;Cohnella;";"94.2";"14.4";"154";"154";"145";"9";"0";"457029";"391062"
"V4mis2";"SILVA (only NR);Bacteria;Firmicutes;Bacilli;Paenibacillales;Paenibacillaceae;Fontibacillus;";"100.0";"14.4";"9";"9";"9";"0";"0";"457174";"391198"
"V4mis2";"SILVA (only NR);Bacteria;Firmicutes;Bacilli;Paenibacillales;Paenibacillaceae;Oxalophagus;";"100.0";"14.4";"3";"3";"3";"0";"0";"457180";"391204"
"V4mis2";"SILVA (only NR);Bacteria;Firmicutes;Bacilli;Paenibacillales;Paenibacillaceae;Paenibacillus;";"96.6";"14.5";"2264";"2264";"2186";"78";"0";"454919";"389021"
"V4mis2";"SILVA (only NR);Bacteria;Firmicutes;Bacilli;Paenibacillales;Paenibacillaceae;Saccharibacillus;";"100.0";"14.4";"18";"18";"18";"0";"0";"457165";"391189"
"V4mis2";"SILVA (only NR);Bacteria;Firmicutes;Bacilli;Paenibacillales;Paenibacillaceae;Thermobacillus;";"100.0";"14.4";"32";"32";"32";"0";"0";"457151";"391175"
"V4mis2";"SILVA (only NR);Bacteria;Firmicutes;Bacilli;Paenibacillales;Paenibacillaceae;Xylanibacillus;";"100.0";"14.4";"5";"5";"5";"0";"0";"457178";"391202"
"V4mis2";"SILVA (only NR);Bacteria;Firmicutes;Bacilli;Paenibacillales;Paenibacillaceae;uncultured;";"100.0";"14.4";"28";"28";"28";"0";"0";"457155";"391179"
"V4mis2";"SILVA (only NR);Bacteria;Firmicutes;Bacilli;RF39;";"98.0";"14.4";"635";"635";"622";"13";"0";"456548";"390585"
"V4mis2";"SILVA (only NR);Bacteria;Firmicutes;Bacilli;RsaHf231;";"100.0";"14.4";"8";"8";"8";"0";"0";"457175";"391199"
"V4mis2";"SILVA (only NR);Bacteria;Firmicutes;Bacilli;Staphylococcales;";"85.8";"14.4";"4825";"4825";"4141";"684";"0";"452358";"387066"
"V4mis2";"SILVA (only NR);Bacteria;Firmicutes;Bacilli;Staphylococcales;Gemellaceae;";"91.3";"14.4";"355";"355";"324";"31";"0";"456828";"390883"
"V4mis2";"SILVA (only NR);Bacteria;Firmicutes;Bacilli;Staphylococcales;Gemellaceae;Gemella;";"91.3";"14.4";"355";"355";"324";"31";"0";"456828";"390883"
"V4mis2";"SILVA (only NR);Bacteria;Firmicutes;Bacilli;Staphylococcales;Staphylococcaceae;";"85.4";"14.4";"4470";"4470";"3817";"653";"0";"452713";"387390"
"V4mis2";"SILVA (only NR);Bacteria;Firmicutes;Bacilli;Staphylococcales;Staphylococcaceae;Aliicoccus;";"100.0";"14.4";"4";"4";"4";"0";"0";"457179";"391203"
"V4mis2";"SILVA (only NR);Bacteria;Firmicutes;Bacilli;Staphylococcales;Staphylococcaceae;Auricoccus-Abyssicoccus;";"100.0";"14.4";"5";"5";"5";"0";"0";"457178";"391202"
"V4mis2";"SILVA (only NR);Bacteria;Firmicutes;Bacilli;Staphylococcales;Staphylococcaceae;Corticicoccus;";"100.0";"14.4";"2";"2";"2";"0";"0";"457181";"391205"
"V4mis2";"SILVA (only NR);Bacteria;Firmicutes;Bacilli;Staphylococcales;Staphylococcaceae;Jeotgalicoccus;";"95.0";"14.4";"60";"60";"57";"3";"0";"457123";"391150"
"V4mis2";"SILVA (only NR);Bacteria;Firmicutes;Bacilli;Staphylococcales;Staphylococcaceae;Macrococcus;";"94.4";"14.4";"36";"36";"34";"2";"0";"457147";"391173"
"V4mis2";"SILVA (only NR);Bacteria;Firmicutes;Bacilli;Staphylococcales;Staphylococcaceae;Nosocomiicoccus;";"77.8";"14.4";"18";"18";"14";"4";"0";"457165";"391193"
"V4mis2";"SILVA (only NR);Bacteria;Firmicutes;Bacilli;Staphylococcales;Staphylococcaceae;Salinicoccus;";"94.2";"14.4";"69";"69";"65";"4";"0";"457114";"391142"
"V4mis2";"SILVA (only NR);Bacteria;Firmicutes;Bacilli;Staphylococcales;Staphylococcaceae;Staphylococcus;";"85.0";"14.4";"4274";"4274";"3634";"640";"0";"452909";"387573"
"V4mis2";"SILVA (only NR);Bacteria;Firmicutes;Bacilli;Thermicanales;";"70.7";"14.4";"41";"41";"29";"12";"0";"457142";"391178"
"V4mis2";"SILVA (only NR);Bacteria;Firmicutes;Bacilli;Thermicanales;Thermicanaceae;";"70.7";"14.4";"41";"41";"29";"12";"0";"457142";"391178"
"V4mis2";"SILVA (only NR);Bacteria;Firmicutes;Bacilli;Thermicanales;Thermicanaceae;Hydrogenibacillus;";"100.0";"14.4";"5";"5";"5";"0";"0";"457178";"391202"
"V4mis2";"SILVA (only NR);Bacteria;Firmicutes;Bacilli;Thermicanales;Thermicanaceae;Thermicanus;";"66.7";"14.4";"36";"36";"24";"12";"0";"457147";"391183"
"V4mis2";"SILVA (only NR);Bacteria;Firmicutes;Bacilli;Thermoactinomycetales;";"97.8";"14.4";"183";"183";"179";"4";"0";"457000";"391028"
"V4mis2";"SILVA (only NR);Bacteria;Firmicutes;Bacilli;Thermoactinomycetales;Thermoactinomycetaceae;";"97.8";"14.4";"183";"183";"179";"4";"0";"457000";"391028"
"V4mis2";"SILVA (only NR);Bacteria;Firmicutes;Bacilli;Thermoactinomycetales;Thermoactinomycetaceae;Baia;";"100.0";"14.4";"5";"5";"5";"0";"0";"457178";"391202"
"V4mis2";"SILVA (only NR);Bacteria;Firmicutes;Bacilli;Thermoactinomycetales;Thermoactinomycetaceae;Desmospora;";"100.0";"14.4";"2";"2";"2";"0";"0";"457181";"391205"
"V4mis2";"SILVA (only NR);Bacteria;Firmicutes;Bacilli;Thermoactinomycetales;Thermoactinomycetaceae;Geothermomicrobium;";"100.0";"14.4";"4";"4";"4";"0";"0";"457179";"391203"
"V4mis2";"SILVA (only NR);Bacteria;Firmicutes;Bacilli;Thermoactinomycetales;Thermoactinomycetaceae;Hazenella;";"100.0";"14.4";"3";"3";"3";"0";"0";"457180";"391204"
"V4mis2";"SILVA (only NR);Bacteria;Firmicutes;Bacilli;Thermoactinomycetales;Thermoactinomycetaceae;Kroppenstedtia;";"100.0";"14.4";"11";"11";"11";"0";"0";"457172";"391196"
"V4mis2";"SILVA (only NR);Bacteria;Firmicutes;Bacilli;Thermoactinomycetales;Thermoactinomycetaceae;Laceyella;";"94.1";"14.4";"17";"17";"16";"1";"0";"457166";"391191"
"V4mis2";"SILVA (only NR);Bacteria;Firmicutes;Bacilli;Thermoactinomycetales;Thermoactinomycetaceae;Lihuaxuella;";"100.0";"14.4";"3";"3";"3";"0";"0";"457180";"391204"
"V4mis2";"SILVA (only NR);Bacteria;Firmicutes;Bacilli;Thermoactinomycetales;Thermoactinomycetaceae;Marininema;";"100.0";"14.4";"2";"2";"2";"0";"0";"457181";"391205"
"V4mis2";"SILVA (only NR);Bacteria;Firmicutes;Bacilli;Thermoactinomycetales;Thermoactinomycetaceae;Mechercharimyces;";"100.0";"14.4";"4";"4";"4";"0";"0";"457179";"391203"
"V4mis2";"SILVA (only NR);Bacteria;Firmicutes;Bacilli;Thermoactinomycetales;Thermoactinomycetaceae;Melghirimyces;";"100.0";"14.4";"7";"7";"7";"0";"0";"457176";"391200"
"V4mis2";"SILVA (only NR);Bacteria;Firmicutes;Bacilli;Thermoactinomycetales;Thermoactinomycetaceae;Novibacillus;";"100.0";"14.4";"7";"7";"7";"0";"0";"457176";"391200"
"V4mis2";"SILVA (only NR);Bacteria;Firmicutes;Bacilli;Thermoactinomycetales;Thermoactinomycetaceae;Pasteuria;";"95.7";"14.4";"23";"23";"22";"1";"0";"457160";"391185"
"V4mis2";"SILVA (only NR);Bacteria;Firmicutes;Bacilli;Thermoactinomycetales;Thermoactinomycetaceae;Planifilum;";"92.9";"14.4";"14";"14";"13";"1";"0";"457169";"391194"
"V4mis2";"SILVA (only NR);Bacteria;Firmicutes;Bacilli;Thermoactinomycetales;Thermoactinomycetaceae;Polycladomyces;";"100.0";"14.4";"3";"3";"3";"0";"0";"457180";"391204"
"V4mis2";"SILVA (only NR);Bacteria;Firmicutes;Bacilli;Thermoactinomycetales;Thermoactinomycetaceae;Risungbinella;";"100.0";"14.4";"4";"4";"4";"0";"0";"457179";"391203"
"V4mis2";"SILVA (only NR);Bacteria;Firmicutes;Bacilli;Thermoactinomycetales;Thermoactinomycetaceae;Salinithrix;";"100.0";"14.4";"1";"1";"1";"0";"0";"457182";"391206"
"V4mis2";"SILVA (only NR);Bacteria;Firmicutes;Bacilli;Thermoactinomycetales;Thermoactinomycetaceae;Seinonella;";"100.0";"14.4";"2";"2";"2";"0";"0";"457181";"391205"
"V4mis2";"SILVA (only NR);Bacteria;Firmicutes;Bacilli;Thermoactinomycetales;Thermoactinomycetaceae;Shimazuella;";"100.0";"14.4";"18";"18";"18";"0";"0";"457165";"391189"
"V4mis2";"SILVA (only NR);Bacteria;Firmicutes;Bacilli;Thermoactinomycetales;Thermoactinomycetaceae;Thermoactinomyces;";"100.0";"14.4";"20";"20";"20";"0";"0";"457163";"391187"
"V4mis2";"SILVA (only NR);Bacteria;Firmicutes;Bacilli;Thermoactinomycetales;Thermoactinomycetaceae;Thermoflavimicrobium;";"100.0";"14.4";"7";"7";"7";"0";"0";"457176";"391200"
"V4mis2";"SILVA (only NR);Bacteria;Firmicutes;Bacilli;Thermoactinomycetales;Thermoactinomycetaceae;uncultured;";"100.0";"14.4";"21";"21";"21";"0";"0";"457162";"391186"
"V4mis2";"SILVA (only NR);Bacteria;Firmicutes;Bacilli;uncultured;";"100.0";"14.4";"7";"7";"7";"0";"0";"457176";"391200"
"V4mis2";"SILVA (only NR);Bacteria;Firmicutes;Clostridia;";"96.1";"15.7";"50639";"50639";"48670";"1969";"0";"406544";"342537"
"V4mis2";"SILVA (only NR);Bacteria;Firmicutes;Clostridia;Caldicoprobacterales;";"95.9";"14.4";"121";"121";"116";"5";"0";"457062";"391091"
"V4mis2";"SILVA (only NR);Bacteria;Firmicutes;Clostridia;Caldicoprobacterales;Caldicoprobacteraceae;";"95.9";"14.4";"121";"121";"116";"5";"0";"457062";"391091"
"V4mis2";"SILVA (only NR);Bacteria;Firmicutes;Clostridia;Caldicoprobacterales;Caldicoprobacteraceae;Caldicoprobacter;";"95.9";"14.4";"121";"121";"116";"5";"0";"457062";"391091"
"V4mis2";"SILVA (only NR);Bacteria;Firmicutes;Clostridia;Christensenellales;";"97.4";"14.5";"2472";"2472";"2407";"65";"0";"454711";"388800"
"V4mis2";"SILVA (only NR);Bacteria;Firmicutes;Clostridia;Christensenellales;Christensenellaceae;";"97.4";"14.5";"2472";"2472";"2407";"65";"0";"454711";"388800"
"V4mis2";"SILVA (only NR);Bacteria;Firmicutes;Clostridia;Christensenellales;Christensenellaceae;Catabacter;";"100.0";"14.4";"3";"3";"3";"0";"0";"457180";"391204"
"V4mis2";"SILVA (only NR);Bacteria;Firmicutes;Clostridia;Christensenellales;Christensenellaceae;Christensenella;";"100.0";"14.4";"5";"5";"5";"0";"0";"457178";"391202"
"V4mis2";"SILVA (only NR);Bacteria;Firmicutes;Clostridia;Christensenellales;Christensenellaceae;Christensenellaceae R-7 group;";"97.2";"14.5";"2301";"2301";"2237";"64";"0";"454882";"388970"
"V4mis2";"SILVA (only NR);Bacteria;Firmicutes;Clostridia;Christensenellales;Christensenellaceae;uncultured;";"99.4";"14.4";"157";"157";"156";"1";"0";"457026";"391051"
"V4mis2";"SILVA (only NR);Bacteria;Firmicutes;Clostridia;Clostridia UCG-014;";"97.5";"14.5";"1146";"1146";"1117";"29";"0";"456037";"390090"
"V4mis2";"SILVA (only NR);Bacteria;Firmicutes;Clostridia;Clostridia vadinBB60 group;";"98.1";"14.4";"432";"432";"424";"8";"0";"456751";"390783"
"V4mis2";"SILVA (only NR);Bacteria;Firmicutes;Clostridia;Clostridiales;";"95.6";"14.5";"2914";"2914";"2787";"127";"0";"454269";"388420"
"V4mis2";"SILVA (only NR);Bacteria;Firmicutes;Clostridia;Clostridiales;Caloramatoraceae;";"91.9";"14.4";"247";"247";"227";"20";"0";"456936";"390980"
"V4mis2";"SILVA (only NR);Bacteria;Firmicutes;Clostridia;Clostridiales;Caloramatoraceae;Caloramator;";"94.6";"14.4";"92";"92";"87";"5";"0";"457091";"391120"
"V4mis2";"SILVA (only NR);Bacteria;Firmicutes;Clostridia;Clostridiales;Caloramatoraceae;Clostridium;";"100.0";"14.4";"1";"1";"1";"0";"0";"457182";"391206"
"V4mis2";"SILVA (only NR);Bacteria;Firmicutes;Clostridia;Clostridiales;Caloramatoraceae;Fervidicella;";"100.0";"14.4";"2";"2";"2";"0";"0";"457181";"391205"
"V4mis2";"SILVA (only NR);Bacteria;Firmicutes;Clostridia;Clostridiales;Caloramatoraceae;Fonticella;";"97.0";"14.4";"66";"66";"64";"2";"0";"457117";"391143"
"V4mis2";"SILVA (only NR);Bacteria;Firmicutes;Clostridia;Clostridiales;Caloramatoraceae;Thermobrachium;";"81.4";"14.4";"43";"43";"35";"8";"0";"457140";"391172"
"V4mis2";"SILVA (only NR);Bacteria;Firmicutes;Clostridia;Clostridiales;Caloramatoraceae;uncultured;";"86.8";"14.4";"38";"38";"33";"5";"0";"457145";"391174"
"V4mis2";"SILVA (only NR);Bacteria;Firmicutes;Clostridia;Clostridiales;Clostridiaceae;";"95.9";"14.5";"2571";"2571";"2465";"106";"0";"454612";"388742"
"V4mis2";"SILVA (only NR);Bacteria;Firmicutes;Clostridia;Clostridiales;Clostridiaceae;Anaerobacter;";"100.0";"14.4";"3";"3";"3";"0";"0";"457180";"391204"
"V4mis2";"SILVA (only NR);Bacteria;Firmicutes;Clostridia;Clostridiales;Clostridiaceae;Candidatus Arthromitus;";"82.4";"14.4";"34";"34";"28";"6";"0";"457149";"391179"
"V4mis2";"SILVA (only NR);Bacteria;Firmicutes;Clostridia;Clostridiales;Clostridiaceae;Clostridium sensu stricto 10;";"100.0";"14.4";"35";"35";"35";"0";"0";"457148";"391172"
"V4mis2";"SILVA (only NR);Bacteria;Firmicutes;Clostridia;Clostridiales;Clostridiaceae;Clostridium sensu stricto 11;";"98.1";"14.4";"53";"53";"52";"1";"0";"457130";"391155"
"V4mis2";"SILVA (only NR);Bacteria;Firmicutes;Clostridia;Clostridiales;Clostridiaceae;Clostridium sensu stricto 12;";"95.3";"14.4";"172";"172";"164";"8";"0";"457011";"391043"
"V4mis2";"SILVA (only NR);Bacteria;Firmicutes;Clostridia;Clostridiales;Clostridiaceae;Clostridium sensu stricto 13;";"95.3";"14.4";"150";"150";"143";"7";"0";"457033";"391064"
"V4mis2";"SILVA (only NR);Bacteria;Firmicutes;Clostridia;Clostridiales;Clostridiaceae;Clostridium sensu stricto 14;";"100.0";"14.4";"12";"12";"12";"0";"0";"457171";"391195"
"V4mis2";"SILVA (only NR);Bacteria;Firmicutes;Clostridia;Clostridiales;Clostridiaceae;Clostridium sensu stricto 15;";"100.0";"14.4";"13";"13";"13";"0";"0";"457170";"391194"
"V4mis2";"SILVA (only NR);Bacteria;Firmicutes;Clostridia;Clostridiales;Clostridiaceae;Clostridium sensu stricto 16;";"100.0";"14.4";"10";"10";"10";"0";"0";"457173";"391197"
"V4mis2";"SILVA (only NR);Bacteria;Firmicutes;Clostridia;Clostridiales;Clostridiaceae;Clostridium sensu stricto 17;";"100.0";"14.4";"2";"2";"2";"0";"0";"457181";"391205"
"V4mis2";"SILVA (only NR);Bacteria;Firmicutes;Clostridia;Clostridiales;Clostridiaceae;Clostridium sensu stricto 18;";"98.0";"14.4";"101";"101";"99";"2";"0";"457082";"391108"
"V4mis2";"SILVA (only NR);Bacteria;Firmicutes;Clostridia;Clostridiales;Clostridiaceae;Clostridium sensu stricto 19;";"100.0";"14.4";"4";"4";"4";"0";"0";"457179";"391203"
"V4mis2";"SILVA (only NR);Bacteria;Firmicutes;Clostridia;Clostridiales;Clostridiaceae;Clostridium sensu stricto 1;";"95.5";"14.5";"1447";"1447";"1382";"65";"0";"455736";"389825"
"V4mis2";"SILVA (only NR);Bacteria;Firmicutes;Clostridia;Clostridiales;Clostridiaceae;Clostridium sensu stricto 2;";"90.9";"14.4";"11";"11";"10";"1";"0";"457172";"391197"
"V4mis2";"SILVA (only NR);Bacteria;Firmicutes;Clostridia;Clostridiales;Clostridiaceae;Clostridium sensu stricto 3;";"96.9";"14.4";"32";"32";"31";"1";"0";"457151";"391176"
"V4mis2";"SILVA (only NR);Bacteria;Firmicutes;Clostridia;Clostridiales;Clostridiaceae;Clostridium sensu stricto 4;";"100.0";"14.4";"4";"4";"4";"0";"0";"457179";"391203"
"V4mis2";"SILVA (only NR);Bacteria;Firmicutes;Clostridia;Clostridiales;Clostridiaceae;Clostridium sensu stricto 5;";"95.5";"14.4";"22";"22";"21";"1";"0";"457161";"391186"
"V4mis2";"SILVA (only NR);Bacteria;Firmicutes;Clostridia;Clostridiales;Clostridiaceae;Clostridium sensu stricto 6;";"93.8";"14.4";"16";"16";"15";"1";"0";"457167";"391192"
"V4mis2";"SILVA (only NR);Bacteria;Firmicutes;Clostridia;Clostridiales;Clostridiaceae;Clostridium sensu stricto 7;";"94.7";"14.4";"57";"57";"54";"3";"0";"457126";"391153"
"V4mis2";"SILVA (only NR);Bacteria;Firmicutes;Clostridia;Clostridiales;Clostridiaceae;Clostridium sensu stricto 8;";"98.0";"14.4";"50";"50";"49";"1";"0";"457133";"391158"
"V4mis2";"SILVA (only NR);Bacteria;Firmicutes;Clostridia;Clostridiales;Clostridiaceae;Clostridium sensu stricto 9;";"100.0";"14.4";"29";"29";"29";"0";"0";"457154";"391178"
"V4mis2";"SILVA (only NR);Bacteria;Firmicutes;Clostridia;Clostridiales;Clostridiaceae;Haloimpatiens;";"100.0";"14.4";"20";"20";"20";"0";"0";"457163";"391187"
"V4mis2";"SILVA (only NR);Bacteria;Firmicutes;Clostridia;Clostridiales;Clostridiaceae;Hathewaya;";"100.0";"14.4";"10";"10";"10";"0";"0";"457173";"391197"
"V4mis2";"SILVA (only NR);Bacteria;Firmicutes;Clostridia;Clostridiales;Clostridiaceae;Oceanirhabdus;";"100.0";"14.4";"3";"3";"3";"0";"0";"457180";"391204"
"V4mis2";"SILVA (only NR);Bacteria;Firmicutes;Clostridia;Clostridiales;Clostridiaceae;Proteiniclasticum;";"96.8";"14.4";"63";"63";"61";"2";"0";"457120";"391146"
"V4mis2";"SILVA (only NR);Bacteria;Firmicutes;Clostridia;Clostridiales;Clostridiaceae;Sarcina;";"95.9";"14.4";"169";"169";"162";"7";"0";"457014";"391045"
"V4mis2";"SILVA (only NR);Bacteria;Firmicutes;Clostridia;Clostridiales;Clostridiaceae;Youngiibacter;";"100.0";"14.4";"9";"9";"9";"0";"0";"457174";"391198"
"V4mis2";"SILVA (only NR);Bacteria;Firmicutes;Clostridia;Clostridiales;Clostridiaceae;uncultured;";"100.0";"14.4";"36";"36";"36";"0";"0";"457147";"391171"
"V4mis2";"SILVA (only NR);Bacteria;Firmicutes;Clostridia;Clostridiales;Oxobacteraceae;";"98.4";"14.4";"62";"62";"61";"1";"0";"457121";"391146"
"V4mis2";"SILVA (only NR);Bacteria;Firmicutes;Clostridia;Clostridiales;Oxobacteraceae;Oxobacter;";"98.4";"14.4";"62";"62";"61";"1";"0";"457121";"391146"
"V4mis2";"SILVA (only NR);Bacteria;Firmicutes;Clostridia;Clostridiales;uncultured;";"100.0";"14.4";"34";"34";"34";"0";"0";"457149";"391173"
"V4mis2";"SILVA (only NR);Bacteria;Firmicutes;Clostridia;Eubacteriales;";"96.4";"14.4";"247";"247";"238";"9";"0";"456936";"390969"
"V4mis2";"SILVA (only NR);Bacteria;Firmicutes;Clostridia;Eubacteriales;Alkalibacteraceae;";"100.0";"14.4";"10";"10";"10";"0";"0";"457173";"391197"
"V4mis2";"SILVA (only NR);Bacteria;Firmicutes;Clostridia;Eubacteriales;Alkalibacteraceae;Alkalibacter;";"100.0";"14.4";"10";"10";"10";"0";"0";"457173";"391197"
"V4mis2";"SILVA (only NR);Bacteria;Firmicutes;Clostridia;Eubacteriales;Alkalibaculum;";"100.0";"14.4";"5";"5";"5";"0";"0";"457178";"391202"
"V4mis2";"SILVA (only NR);Bacteria;Firmicutes;Clostridia;Eubacteriales;Anaerofustaceae;";"100.0";"14.4";"37";"37";"37";"0";"0";"457146";"391170"
"V4mis2";"SILVA (only NR);Bacteria;Firmicutes;Clostridia;Eubacteriales;Anaerofustaceae;Anaerofustis;";"100.0";"14.4";"37";"37";"37";"0";"0";"457146";"391170"
"V4mis2";"SILVA (only NR);Bacteria;Firmicutes;Clostridia;Eubacteriales;Eubacteriaceae;";"94.9";"14.4";"177";"177";"168";"9";"0";"457006";"391039"
"V4mis2";"SILVA (only NR);Bacteria;Firmicutes;Clostridia;Eubacteriales;Eubacteriaceae;Acetobacterium;";"96.7";"14.4";"92";"92";"89";"3";"0";"457091";"391118"
"V4mis2";"SILVA (only NR);Bacteria;Firmicutes;Clostridia;Eubacteriales;Eubacteriaceae;Eubacterium;";"89.3";"14.4";"56";"56";"50";"6";"0";"457127";"391157"
"V4mis2";"SILVA (only NR);Bacteria;Firmicutes;Clostridia;Eubacteriales;Eubacteriaceae;Pseudoramibacter;";"100.0";"14.4";"14";"14";"14";"0";"0";"457169";"391193"
"V4mis2";"SILVA (only NR);Bacteria;Firmicutes;Clostridia;Eubacteriales;Eubacteriaceae;uncultured;";"100.0";"14.4";"14";"14";"14";"0";"0";"457169";"391193"
"V4mis2";"SILVA (only NR);Bacteria;Firmicutes;Clostridia;Eubacteriales;Garciellaceae;";"100.0";"14.4";"18";"18";"18";"0";"0";"457165";"391189"
"V4mis2";"SILVA (only NR);Bacteria;Firmicutes;Clostridia;Eubacteriales;Garciellaceae;Garciella;";"100.0";"14.4";"8";"8";"8";"0";"0";"457175";"391199"
"V4mis2";"SILVA (only NR);Bacteria;Firmicutes;Clostridia;Eubacteriales;Garciellaceae;Irregularibacter;";"100.0";"14.4";"9";"9";"9";"0";"0";"457174";"391198"
"V4mis2";"SILVA (only NR);Bacteria;Firmicutes;Clostridia;Eubacteriales;Garciellaceae;Rhabdanaerobium;";"100.0";"14.4";"1";"1";"1";"0";"0";"457182";"391206"
"V4mis2";"SILVA (only NR);Bacteria;Firmicutes;Clostridia;Gracilibacteraceae;";"94.5";"14.4";"201";"201";"190";"11";"0";"456982";"391017"
"V4mis2";"SILVA (only NR);Bacteria;Firmicutes;Clostridia;Gracilibacteraceae;Gracilibacter;";"88.5";"14.4";"52";"52";"46";"6";"0";"457131";"391161"
"V4mis2";"SILVA (only NR);Bacteria;Firmicutes;Clostridia;Gracilibacteraceae;Lutispora;";"96.9";"14.4";"96";"96";"93";"3";"0";"457087";"391114"
"V4mis2";"SILVA (only NR);Bacteria;Firmicutes;Clostridia;Gracilibacteraceae;uncultured;";"96.2";"14.4";"52";"52";"50";"2";"0";"457131";"391157"
"V4mis2";"SILVA (only NR);Bacteria;Firmicutes;Clostridia;Lachnospirales;";"95.8";"15";"23121";"23121";"22157";"964";"0";"434062";"369050"
"V4mis2";"SILVA (only NR);Bacteria;Firmicutes;Clostridia;Lachnospirales;Defluviitaleaceae;";"97.8";"14.4";"136";"136";"133";"3";"0";"457047";"391074"
"V4mis2";"SILVA (only NR);Bacteria;Firmicutes;Clostridia;Lachnospirales;Defluviitaleaceae;Defluviitalea;";"97.0";"14.4";"33";"33";"32";"1";"0";"457150";"391175"
"V4mis2";"SILVA (only NR);Bacteria;Firmicutes;Clostridia;Lachnospirales;Defluviitaleaceae;Defluviitaleaceae UCG-011;";"98.1";"14.4";"103";"103";"101";"2";"0";"457080";"391106"
"V4mis2";"SILVA (only NR);Bacteria;Firmicutes;Clostridia;Lachnospirales;Lachnospiraceae;";"95.8";"15";"22974";"22974";"22014";"960";"0";"434209";"369193"
"V4mis2";"SILVA (only NR);Bacteria;Firmicutes;Clostridia;Lachnospirales;Lachnospiraceae;28-4;";"100.0";"14.4";"3";"3";"3";"0";"0";"457180";"391204"
"V4mis2";"SILVA (only NR);Bacteria;Firmicutes;Clostridia;Lachnospirales;Lachnospiraceae;A2;";"89.7";"14.4";"175";"175";"157";"18";"0";"457008";"391050"
"V4mis2";"SILVA (only NR);Bacteria;Firmicutes;Clostridia;Lachnospirales;Lachnospiraceae;ASF356;";"96.7";"14.4";"30";"30";"29";"1";"0";"457153";"391178"
"V4mis2";"SILVA (only NR);Bacteria;Firmicutes;Clostridia;Lachnospirales;Lachnospiraceae;Abyssivirga;";"100.0";"14.4";"4";"4";"4";"0";"0";"457179";"391203"
"V4mis2";"SILVA (only NR);Bacteria;Firmicutes;Clostridia;Lachnospirales;Lachnospiraceae;Acetatifactor;";"100.0";"14.4";"25";"25";"25";"0";"0";"457158";"391182"
"V4mis2";"SILVA (only NR);Bacteria;Firmicutes;Clostridia;Lachnospirales;Lachnospiraceae;Acetitomaculum;";"96.2";"14.4";"182";"182";"175";"7";"0";"457001";"391032"
"V4mis2";"SILVA (only NR);Bacteria;Firmicutes;Clostridia;Lachnospirales;Lachnospiraceae;Agathobacter;";"95.6";"14.4";"769";"769";"735";"34";"0";"456414";"390472"
"V4mis2";"SILVA (only NR);Bacteria;Firmicutes;Clostridia;Lachnospirales;Lachnospiraceae;Anaerobium;";"100.0";"14.4";"3";"3";"3";"0";"0";"457180";"391204"
"V4mis2";"SILVA (only NR);Bacteria;Firmicutes;Clostridia;Lachnospirales;Lachnospiraceae;Anaerocolumna;";"93.5";"14.4";"46";"46";"43";"3";"0";"457137";"391164"
"V4mis2";"SILVA (only NR);Bacteria;Firmicutes;Clostridia;Lachnospirales;Lachnospiraceae;Anaerosporobacter;";"94.0";"14.4";"83";"83";"78";"5";"0";"457100";"391129"
"V4mis2";"SILVA (only NR);Bacteria;Firmicutes;Clostridia;Lachnospirales;Lachnospiraceae;Anaerostignum;";"94.6";"14.4";"37";"37";"35";"2";"0";"457146";"391172"
"V4mis2";"SILVA (only NR);Bacteria;Firmicutes;Clostridia;Lachnospirales;Lachnospiraceae;Anaerostipes;";"93.8";"14.4";"483";"483";"453";"30";"0";"456700";"390754"
"V4mis2";"SILVA (only NR);Bacteria;Firmicutes;Clostridia;Lachnospirales;Lachnospiraceae;Blautia;";"96.7";"14.5";"3075";"3075";"2975";"100";"0";"454108";"388232"
"V4mis2";"SILVA (only NR);Bacteria;Firmicutes;Clostridia;Lachnospirales;Lachnospiraceae;Butyrivibrio;";"98.0";"14.4";"303";"303";"297";"6";"0";"456880";"390910"
"V4mis2";"SILVA (only NR);Bacteria;Firmicutes;Clostridia;Lachnospirales;Lachnospiraceae;CAG-56;";"93.3";"14.4";"30";"30";"28";"2";"0";"457153";"391179"
"V4mis2";"SILVA (only NR);Bacteria;Firmicutes;Clostridia;Lachnospirales;Lachnospiraceae;CHKCI001;";"100.0";"14.4";"5";"5";"5";"0";"0";"457178";"391202"
"V4mis2";"SILVA (only NR);Bacteria;Firmicutes;Clostridia;Lachnospirales;Lachnospiraceae;Catenibacillus;";"100.0";"14.4";"8";"8";"8";"0";"0";"457175";"391199"
"V4mis2";"SILVA (only NR);Bacteria;Firmicutes;Clostridia;Lachnospirales;Lachnospiraceae;Catonella;";"96.1";"14.4";"51";"51";"49";"2";"0";"457132";"391158"
"V4mis2";"SILVA (only NR);Bacteria;Firmicutes;Clostridia;Lachnospirales;Lachnospiraceae;Cellulosilyticum;";"100.0";"14.4";"41";"41";"41";"0";"0";"457142";"391166"
"V4mis2";"SILVA (only NR);Bacteria;Firmicutes;Clostridia;Lachnospirales;Lachnospiraceae;Coprococcus;";"96.0";"14.4";"372";"372";"357";"15";"0";"456811";"390850"
"V4mis2";"SILVA (only NR);Bacteria;Firmicutes;Clostridia;Lachnospirales;Lachnospiraceae;Cuneatibacter;";"100.0";"14.4";"1";"1";"1";"0";"0";"457182";"391206"
"V4mis2";"SILVA (only NR);Bacteria;Firmicutes;Clostridia;Lachnospirales;Lachnospiraceae;Dorea;";"94.6";"14.4";"409";"409";"387";"22";"0";"456774";"390820"
"V4mis2";"SILVA (only NR);Bacteria;Firmicutes;Clostridia;Lachnospirales;Lachnospiraceae;Eisenbergiella;";"93.2";"14.4";"74";"74";"69";"5";"0";"457109";"391138"
"V4mis2";"SILVA (only NR);Bacteria;Firmicutes;Clostridia;Lachnospirales;Lachnospiraceae;Epulopiscium;";"94.8";"14.4";"193";"193";"183";"10";"0";"456990";"391024"
"V4mis2";"SILVA (only NR);Bacteria;Firmicutes;Clostridia;Lachnospirales;Lachnospiraceae;FD2005;";"95.5";"14.4";"22";"22";"21";"1";"0";"457161";"391186"
"V4mis2";"SILVA (only NR);Bacteria;Firmicutes;Clostridia;Lachnospirales;Lachnospiraceae;Frisingicoccus;";"93.9";"14.4";"33";"33";"31";"2";"0";"457150";"391176"
"V4mis2";"SILVA (only NR);Bacteria;Firmicutes;Clostridia;Lachnospirales;Lachnospiraceae;Fusicatenibacter;";"96.0";"14.4";"403";"403";"387";"16";"0";"456780";"390820"
"V4mis2";"SILVA (only NR);Bacteria;Firmicutes;Clostridia;Lachnospirales;Lachnospiraceae;GCA-900066575;";"97.2";"14.4";"107";"107";"104";"3";"0";"457076";"391103"
"V4mis2";"SILVA (only NR);Bacteria;Firmicutes;Clostridia;Lachnospirales;Lachnospiraceae;GCA-900066755;";"100.0";"14.4";"6";"6";"6";"0";"0";"457177";"391201"
"V4mis2";"SILVA (only NR);Bacteria;Firmicutes;Clostridia;Lachnospirales;Lachnospiraceae;Herbinix;";"97.8";"14.4";"46";"46";"45";"1";"0";"457137";"391162"
"V4mis2";"SILVA (only NR);Bacteria;Firmicutes;Clostridia;Lachnospirales;Lachnospiraceae;Hespellia;";"100.0";"14.4";"6";"6";"6";"0";"0";"457177";"391201"
"V4mis2";"SILVA (only NR);Bacteria;Firmicutes;Clostridia;Lachnospirales;Lachnospiraceae;Howardella;";"93.3";"14.4";"30";"30";"28";"2";"0";"457153";"391179"
"V4mis2";"SILVA (only NR);Bacteria;Firmicutes;Clostridia;Lachnospirales;Lachnospiraceae;Hungatella;";"87.9";"14.4";"132";"132";"116";"16";"0";"457051";"391091"
"V4mis2";"SILVA (only NR);Bacteria;Firmicutes;Clostridia;Lachnospirales;Lachnospiraceae;Incertae Sedis;";"100.0";"14.4";"12";"12";"12";"0";"0";"457171";"391195"
"V4mis2";"SILVA (only NR);Bacteria;Firmicutes;Clostridia;Lachnospirales;Lachnospiraceae;Johnsonella;";"91.7";"14.4";"36";"36";"33";"3";"0";"457147";"391174"
"V4mis2";"SILVA (only NR);Bacteria;Firmicutes;Clostridia;Lachnospirales;Lachnospiraceae;Lachnoanaerobaculum;";"94.4";"14.4";"54";"54";"51";"3";"0";"457129";"391156"
"V4mis2";"SILVA (only NR);Bacteria;Firmicutes;Clostridia;Lachnospirales;Lachnospiraceae;Lachnobacterium;";"50.0";"14.4";"2";"2";"1";"1";"0";"457181";"391206"
"V4mis2";"SILVA (only NR);Bacteria;Firmicutes;Clostridia;Lachnospirales;Lachnospiraceae;Lachnoclostridium;";"94.4";"14.5";"1418";"1418";"1338";"80";"0";"455765";"389869"
"V4mis2";"SILVA (only NR);Bacteria;Firmicutes;Clostridia;Lachnospirales;Lachnospiraceae;Lachnospira;";"97.9";"14.4";"141";"141";"138";"3";"0";"457042";"391069"
"V4mis2";"SILVA (only NR);Bacteria;Firmicutes;Clostridia;Lachnospirales;Lachnospiraceae;Lachnospiraceae AC2044 group;";"98.1";"14.4";"209";"209";"205";"4";"0";"456974";"391002"
"V4mis2";"SILVA (only NR);Bacteria;Firmicutes;Clostridia;Lachnospirales;Lachnospiraceae;Lachnospiraceae FCS020 group;";"97.5";"14.4";"157";"157";"153";"4";"0";"457026";"391054"
"V4mis2";"SILVA (only NR);Bacteria;Firmicutes;Clostridia;Lachnospirales;Lachnospiraceae;Lachnospiraceae FE2018 group;";"93.3";"14.4";"15";"15";"14";"1";"0";"457168";"391193"
"V4mis2";"SILVA (only NR);Bacteria;Firmicutes;Clostridia;Lachnospirales;Lachnospiraceae;Lachnospiraceae NC2004 group;";"97.7";"14.4";"171";"171";"167";"4";"0";"457012";"391040"
"V4mis2";"SILVA (only NR);Bacteria;Firmicutes;Clostridia;Lachnospirales;Lachnospiraceae;Lachnospiraceae ND3007 group;";"97.9";"14.4";"239";"239";"234";"5";"0";"456944";"390973"
"V4mis2";"SILVA (only NR);Bacteria;Firmicutes;Clostridia;Lachnospirales;Lachnospiraceae;Lachnospiraceae NK3A20 group;";"95.8";"14.4";"359";"359";"344";"15";"0";"456824";"390863"
"V4mis2";"SILVA (only NR);Bacteria;Firmicutes;Clostridia;Lachnospirales;Lachnospiraceae;Lachnospiraceae NK4A136 group;";"95.2";"14.5";"2259";"2259";"2150";"109";"0";"454924";"389057"
"V4mis2";"SILVA (only NR);Bacteria;Firmicutes;Clostridia;Lachnospirales;Lachnospiraceae;Lachnospiraceae NK4B4 group;";"100.0";"14.4";"18";"18";"18";"0";"0";"457165";"391189"
"V4mis2";"SILVA (only NR);Bacteria;Firmicutes;Clostridia;Lachnospirales;Lachnospiraceae;Lachnospiraceae UCG-001;";"95.5";"14.4";"376";"376";"359";"17";"0";"456807";"390848"
"V4mis2";"SILVA (only NR);Bacteria;Firmicutes;Clostridia;Lachnospirales;Lachnospiraceae;Lachnospiraceae UCG-002;";"95.7";"14.4";"23";"23";"22";"1";"0";"457160";"391185"
"V4mis2";"SILVA (only NR);Bacteria;Firmicutes;Clostridia;Lachnospirales;Lachnospiraceae;Lachnospiraceae UCG-003;";"100.0";"14.4";"23";"23";"23";"0";"0";"457160";"391184"
"V4mis2";"SILVA (only NR);Bacteria;Firmicutes;Clostridia;Lachnospirales;Lachnospiraceae;Lachnospiraceae UCG-004;";"98.4";"14.4";"191";"191";"188";"3";"0";"456992";"391019"
"V4mis2";"SILVA (only NR);Bacteria;Firmicutes;Clostridia;Lachnospirales;Lachnospiraceae;Lachnospiraceae UCG-006;";"95.7";"14.4";"188";"188";"180";"8";"0";"456995";"391027"
"V4mis2";"SILVA (only NR);Bacteria;Firmicutes;Clostridia;Lachnospirales;Lachnospiraceae;Lachnospiraceae UCG-007;";"85.7";"14.4";"7";"7";"6";"1";"0";"457176";"391201"
"V4mis2";"SILVA (only NR);Bacteria;Firmicutes;Clostridia;Lachnospirales;Lachnospiraceae;Lachnospiraceae UCG-008;";"97.7";"14.4";"692";"692";"676";"16";"0";"456491";"390531"
"V4mis2";"SILVA (only NR);Bacteria;Firmicutes;Clostridia;Lachnospirales;Lachnospiraceae;Lachnospiraceae UCG-009;";"100.0";"14.4";"27";"27";"27";"0";"0";"457156";"391180"
"V4mis2";"SILVA (only NR);Bacteria;Firmicutes;Clostridia;Lachnospirales;Lachnospiraceae;Lachnospiraceae UCG-010;";"95.0";"14.4";"20";"20";"19";"1";"0";"457163";"391188"
"V4mis2";"SILVA (only NR);Bacteria;Firmicutes;Clostridia;Lachnospirales;Lachnospiraceae;Lachnospiraceae XPB1014 group;";"98.5";"14.4";"204";"204";"201";"3";"0";"456979";"391006"
"V4mis2";"SILVA (only NR);Bacteria;Firmicutes;Clostridia;Lachnospirales;Lachnospiraceae;Lachnotalea;";"83.3";"14.4";"6";"6";"5";"1";"0";"457177";"391202"
"V4mis2";"SILVA (only NR);Bacteria;Firmicutes;Clostridia;Lachnospirales;Lachnospiraceae;Lactonifactor;";"100.0";"14.4";"6";"6";"6";"0";"0";"457177";"391201"
"V4mis2";"SILVA (only NR);Bacteria;Firmicutes;Clostridia;Lachnospirales;Lachnospiraceae;Marvinbryantia;";"98.8";"14.4";"250";"250";"247";"3";"0";"456933";"390960"
"V4mis2";"SILVA (only NR);Bacteria;Firmicutes;Clostridia;Lachnospirales;Lachnospiraceae;Mobilisporobacter;";"100.0";"14.4";"1";"1";"1";"0";"0";"457182";"391206"
"V4mis2";"SILVA (only NR);Bacteria;Firmicutes;Clostridia;Lachnospirales;Lachnospiraceae;Mobilitalea;";"100.0";"14.4";"11";"11";"11";"0";"0";"457172";"391196"
"V4mis2";"SILVA (only NR);Bacteria;Firmicutes;Clostridia;Lachnospirales;Lachnospiraceae;Moryella;";"96.4";"14.4";"56";"56";"54";"2";"0";"457127";"391153"
"V4mis2";"SILVA (only NR);Bacteria;Firmicutes;Clostridia;Lachnospirales;Lachnospiraceae;Murimonas;";"100.0";"14.4";"2";"2";"2";"0";"0";"457181";"391205"
"V4mis2";"SILVA (only NR);Bacteria;Firmicutes;Clostridia;Lachnospirales;Lachnospiraceae;Natranaerovirga;";"100.0";"14.4";"5";"5";"5";"0";"0";"457178";"391202"
"V4mis2";"SILVA (only NR);Bacteria;Firmicutes;Clostridia;Lachnospirales;Lachnospiraceae;Oribacterium;";"97.4";"14.4";"154";"154";"150";"4";"0";"457029";"391057"
"V4mis2";"SILVA (only NR);Bacteria;Firmicutes;Clostridia;Lachnospirales;Lachnospiraceae;Parasporobacterium;";"100.0";"14.4";"1";"1";"1";"0";"0";"457182";"391206"
"V4mis2";"SILVA (only NR);Bacteria;Firmicutes;Clostridia;Lachnospirales;Lachnospiraceae;Pseudobutyrivibrio;";"98.3";"14.4";"116";"116";"114";"2";"0";"457067";"391093"
"V4mis2";"SILVA (only NR);Bacteria;Firmicutes;Clostridia;Lachnospirales;Lachnospiraceae;Robinsoniella;";"100.0";"14.4";"19";"19";"19";"0";"0";"457164";"391188"
"V4mis2";"SILVA (only NR);Bacteria;Firmicutes;Clostridia;Lachnospirales;Lachnospiraceae;Roseburia;";"94.3";"14.5";"1592";"1592";"1501";"91";"0";"455591";"389706"
"V4mis2";"SILVA (only NR);Bacteria;Firmicutes;Clostridia;Lachnospirales;Lachnospiraceae;Sellimonas;";"96.7";"14.4";"30";"30";"29";"1";"0";"457153";"391178"
"V4mis2";"SILVA (only NR);Bacteria;Firmicutes;Clostridia;Lachnospirales;Lachnospiraceae;Shuttleworthia;";"98.7";"14.4";"78";"78";"77";"1";"0";"457105";"391130"
"V4mis2";"SILVA (only NR);Bacteria;Firmicutes;Clostridia;Lachnospirales;Lachnospiraceae;Sporobacterium;";"100.0";"14.4";"1";"1";"1";"0";"0";"457182";"391206"
"V4mis2";"SILVA (only NR);Bacteria;Firmicutes;Clostridia;Lachnospirales;Lachnospiraceae;Stomatobaculum;";"100.0";"14.4";"12";"12";"12";"0";"0";"457171";"391195"
"V4mis2";"SILVA (only NR);Bacteria;Firmicutes;Clostridia;Lachnospirales;Lachnospiraceae;Syntrophococcus;";"94.4";"14.4";"54";"54";"51";"3";"0";"457129";"391156"
"V4mis2";"SILVA (only NR);Bacteria;Firmicutes;Clostridia;Lachnospirales;Lachnospiraceae;Tuzzerella;";"93.9";"14.4";"33";"33";"31";"2";"0";"457150";"391176"
"V4mis2";"SILVA (only NR);Bacteria;Firmicutes;Clostridia;Lachnospirales;Lachnospiraceae;Tyzzerella;";"96.4";"14.4";"389";"389";"375";"14";"0";"456794";"390832"
"V4mis2";"SILVA (only NR);Bacteria;Firmicutes;Clostridia;Lachnospirales;Lachnospiraceae;UC5-1-2E3;";"75.0";"14.4";"4";"4";"3";"1";"0";"457179";"391204"
"V4mis2";"SILVA (only NR);Bacteria;Firmicutes;Clostridia;Lachnospirales;Lachnospiraceae;Vallitalea;";"100.0";"14.4";"13";"13";"13";"0";"0";"457170";"391194"
"V4mis2";"SILVA (only NR);Bacteria;Firmicutes;Clostridia;Lachnospirales;Lachnospiraceae;XBB1006;";"100.0";"14.4";"17";"17";"17";"0";"0";"457166";"391190"
"V4mis2";"SILVA (only NR);Bacteria;Firmicutes;Clostridia;Lachnospirales;Lachnospiraceae;[Acetivibrio] ethanolgignens group;";"100.0";"14.4";"3";"3";"3";"0";"0";"457180";"391204"
"V4mis2";"SILVA (only NR);Bacteria;Firmicutes;Clostridia;Lachnospirales;Lachnospiraceae;[Bacteroides] pectinophilus group;";"100.0";"14.4";"16";"16";"16";"0";"0";"457167";"391191"
"V4mis2";"SILVA (only NR);Bacteria;Firmicutes;Clostridia;Lachnospirales;Lachnospiraceae;[Eubacterium] cellulosolvens group;";"100.0";"14.4";"6";"6";"6";"0";"0";"457177";"391201"
"V4mis2";"SILVA (only NR);Bacteria;Firmicutes;Clostridia;Lachnospirales;Lachnospiraceae;[Eubacterium] eligens group;";"96.1";"14.4";"76";"76";"73";"3";"0";"457107";"391134"
"V4mis2";"SILVA (only NR);Bacteria;Firmicutes;Clostridia;Lachnospirales;Lachnospiraceae;[Eubacterium] fissicatena group;";"95.3";"14.4";"43";"43";"41";"2";"0";"457140";"391166"
"V4mis2";"SILVA (only NR);Bacteria;Firmicutes;Clostridia;Lachnospirales;Lachnospiraceae;[Eubacterium] hallii group;";"97.8";"14.4";"448";"448";"438";"10";"0";"456735";"390769"
"V4mis2";"SILVA (only NR);Bacteria;Firmicutes;Clostridia;Lachnospirales;Lachnospiraceae;[Eubacterium] oxidoreducens group;";"98.4";"14.4";"124";"124";"122";"2";"0";"457059";"391085"
"V4mis2";"SILVA (only NR);Bacteria;Firmicutes;Clostridia;Lachnospirales;Lachnospiraceae;[Eubacterium] ruminantium group;";"99.4";"14.4";"160";"160";"159";"1";"0";"457023";"391048"
"V4mis2";"SILVA (only NR);Bacteria;Firmicutes;Clostridia;Lachnospirales;Lachnospiraceae;[Eubacterium] ventriosum group;";"94.7";"14.4";"113";"113";"107";"6";"0";"457070";"391100"
"V4mis2";"SILVA (only NR);Bacteria;Firmicutes;Clostridia;Lachnospirales;Lachnospiraceae;[Eubacterium] xylanophilum group;";"96.3";"14.4";"164";"164";"158";"6";"0";"457019";"391049"
"V4mis2";"SILVA (only NR);Bacteria;Firmicutes;Clostridia;Lachnospirales;Lachnospiraceae;[Ruminococcus] gauvreauii group;";"96.1";"14.4";"331";"331";"318";"13";"0";"456852";"390889"
"V4mis2";"SILVA (only NR);Bacteria;Firmicutes;Clostridia;Lachnospirales;Lachnospiraceae;[Ruminococcus] gnavus group;";"93.2";"14.4";"250";"250";"233";"17";"0";"456933";"390974"
"V4mis2";"SILVA (only NR);Bacteria;Firmicutes;Clostridia;Lachnospirales;Lachnospiraceae;[Ruminococcus] torques group;";"96.2";"14.5";"848";"848";"816";"32";"0";"456335";"390391"
"V4mis2";"SILVA (only NR);Bacteria;Firmicutes;Clostridia;Lachnospirales;Lachnospiraceae;possible genus Sk003-Sk004;";"77.8";"14.4";"9";"9";"7";"2";"0";"457174";"391200"
"V4mis2";"SILVA (only NR);Bacteria;Firmicutes;Clostridia;Lachnospirales;Lachnospiraceae;possible genus Sk018;";"100.0";"14.4";"4";"4";"4";"0";"0";"457179";"391203"
"V4mis2";"SILVA (only NR);Bacteria;Firmicutes;Clostridia;Lachnospirales;Lachnospiraceae;probable genus 10;";"100.0";"14.4";"36";"36";"36";"0";"0";"457147";"391171"
"V4mis2";"SILVA (only NR);Bacteria;Firmicutes;Clostridia;Lachnospirales;Lachnospiraceae;uncultured;";"95.5";"14.5";"3415";"3415";"3261";"154";"0";"453768";"387946"
"V4mis2";"SILVA (only NR);Bacteria;Firmicutes;Clostridia;Lachnospirales;uncultured;";"100.0";"14.4";"9";"9";"9";"0";"0";"457174";"391198"
"V4mis2";"SILVA (only NR);Bacteria;Firmicutes;Clostridia;MAT-CR-H4-C10;";"100.0";"14.4";"4";"4";"4";"0";"0";"457179";"391203"
"V4mis2";"SILVA (only NR);Bacteria;Firmicutes;Clostridia;Monoglobales;";"98.3";"14.4";"351";"351";"345";"6";"0";"456832";"390862"
"V4mis2";"SILVA (only NR);Bacteria;Firmicutes;Clostridia;Monoglobales;Monoglobaceae;";"98.3";"14.4";"351";"351";"345";"6";"0";"456832";"390862"
"V4mis2";"SILVA (only NR);Bacteria;Firmicutes;Clostridia;Monoglobales;Monoglobaceae;Monoglobus;";"98.3";"14.4";"351";"351";"345";"6";"0";"456832";"390862"
"V4mis2";"SILVA (only NR);Bacteria;Firmicutes;Clostridia;Oscillospirales;";"96.5";"14.8";"14250";"14250";"13752";"498";"0";"442933";"377455"
"V4mis2";"SILVA (only NR);Bacteria;Firmicutes;Clostridia;Oscillospirales;Butyricicoccaceae;";"93.4";"14.4";"316";"316";"295";"21";"0";"456867";"390912"
"V4mis2";"SILVA (only NR);Bacteria;Firmicutes;Clostridia;Oscillospirales;Butyricicoccaceae;Butyricicoccus;";"91.7";"14.4";"180";"180";"165";"15";"0";"457003";"391042"
"V4mis2";"SILVA (only NR);Bacteria;Firmicutes;Clostridia;Oscillospirales;Butyricicoccaceae;UCG-008;";"100.0";"14.4";"31";"31";"31";"0";"0";"457152";"391176"
"V4mis2";"SILVA (only NR);Bacteria;Firmicutes;Clostridia;Oscillospirales;Butyricicoccaceae;UCG-009;";"93.8";"14.4";"97";"97";"91";"6";"0";"457086";"391116"
"V4mis2";"SILVA (only NR);Bacteria;Firmicutes;Clostridia;Oscillospirales;Butyricicoccaceae;uncultured;";"100.0";"14.4";"8";"8";"8";"0";"0";"457175";"391199"
"V4mis2";"SILVA (only NR);Bacteria;Firmicutes;Clostridia;Oscillospirales;Ethanoligenenaceae;";"95.7";"14.4";"47";"47";"45";"2";"0";"457136";"391162"
"V4mis2";"SILVA (only NR);Bacteria;Firmicutes;Clostridia;Oscillospirales;Ethanoligenenaceae;Acetanaerobacterium;";"90.0";"14.4";"10";"10";"9";"1";"0";"457173";"391198"
"V4mis2";"SILVA (only NR);Bacteria;Firmicutes;Clostridia;Oscillospirales;Ethanoligenenaceae;Ethanoligenens;";"100.0";"14.4";"11";"11";"11";"0";"0";"457172";"391196"
"V4mis2";"SILVA (only NR);Bacteria;Firmicutes;Clostridia;Oscillospirales;Ethanoligenenaceae;Incertae Sedis;";"95.7";"14.4";"23";"23";"22";"1";"0";"457160";"391185"
"V4mis2";"SILVA (only NR);Bacteria;Firmicutes;Clostridia;Oscillospirales;Ethanoligenenaceae;uncultured;";"100.0";"14.4";"2";"2";"2";"0";"0";"457181";"391205"
"V4mis2";"SILVA (only NR);Bacteria;Firmicutes;Clostridia;Oscillospirales;Hungateiclostridiaceae;";"96.6";"14.5";"1418";"1418";"1370";"48";"0";"455765";"389837"
"V4mis2";"SILVA (only NR);Bacteria;Firmicutes;Clostridia;Oscillospirales;Hungateiclostridiaceae;Acetivibrio;";"100.0";"14.4";"28";"28";"28";"0";"0";"457155";"391179"
"V4mis2";"SILVA (only NR);Bacteria;Firmicutes;Clostridia;Oscillospirales;Hungateiclostridiaceae;Anaerobacterium;";"100.0";"14.4";"13";"13";"13";"0";"0";"457170";"391194"
"V4mis2";"SILVA (only NR);Bacteria;Firmicutes;Clostridia;Oscillospirales;Hungateiclostridiaceae;Cellulosibacter;";"100.0";"14.4";"2";"2";"2";"0";"0";"457181";"391205"
"V4mis2";"SILVA (only NR);Bacteria;Firmicutes;Clostridia;Oscillospirales;Hungateiclostridiaceae;Ercella;";"100.0";"14.4";"35";"35";"35";"0";"0";"457148";"391172"
"V4mis2";"SILVA (only NR);Bacteria;Firmicutes;Clostridia;Oscillospirales;Hungateiclostridiaceae;Fastidiosipila;";"96.2";"14.4";"290";"290";"279";"11";"0";"456893";"390928"
"V4mis2";"SILVA (only NR);Bacteria;Firmicutes;Clostridia;Oscillospirales;Hungateiclostridiaceae;HN-HF0106;";"98.8";"14.4";"80";"80";"79";"1";"0";"457103";"391128"
"V4mis2";"SILVA (only NR);Bacteria;Firmicutes;Clostridia;Oscillospirales;Hungateiclostridiaceae;Hungateiclostridium;";"92.0";"14.4";"25";"25";"23";"2";"0";"457158";"391184"
"V4mis2";"SILVA (only NR);Bacteria;Firmicutes;Clostridia;Oscillospirales;Hungateiclostridiaceae;Mageeibacillus;";"100.0";"14.4";"9";"9";"9";"0";"0";"457174";"391198"
"V4mis2";"SILVA (only NR);Bacteria;Firmicutes;Clostridia;Oscillospirales;Hungateiclostridiaceae;Pseudobacteroides;";"100.0";"14.4";"9";"9";"9";"0";"0";"457174";"391198"
"V4mis2";"SILVA (only NR);Bacteria;Firmicutes;Clostridia;Oscillospirales;Hungateiclostridiaceae;Pseudoclostridium;";"92.9";"14.4";"14";"14";"13";"1";"0";"457169";"391194"
"V4mis2";"SILVA (only NR);Bacteria;Firmicutes;Clostridia;Oscillospirales;Hungateiclostridiaceae;Ruminiclostridium;";"98.5";"14.4";"263";"263";"259";"4";"0";"456920";"390948"
"V4mis2";"SILVA (only NR);Bacteria;Firmicutes;Clostridia;Oscillospirales;Hungateiclostridiaceae;Saccharofermentans;";"94.5";"14.4";"201";"201";"190";"11";"0";"456982";"391017"
"V4mis2";"SILVA (only NR);Bacteria;Firmicutes;Clostridia;Oscillospirales;Hungateiclostridiaceae;Thermoclostridium;";"95.7";"14.4";"23";"23";"22";"1";"0";"457160";"391185"
"V4mis2";"SILVA (only NR);Bacteria;Firmicutes;Clostridia;Oscillospirales;Hungateiclostridiaceae;UCG-012;";"89.6";"14.4";"77";"77";"69";"8";"0";"457106";"391138"
"V4mis2";"SILVA (only NR);Bacteria;Firmicutes;Clostridia;Oscillospirales;Hungateiclostridiaceae;uncultured;";"97.4";"14.4";"344";"344";"335";"9";"0";"456839";"390872"
"V4mis2";"SILVA (only NR);Bacteria;Firmicutes;Clostridia;Oscillospirales;Hydrogenoanaerobacterium;";"100.0";"14.4";"27";"27";"27";"0";"0";"457156";"391180"
"V4mis2";"SILVA (only NR);Bacteria;Firmicutes;Clostridia;Oscillospirales;Oscillospiraceae;";"96.8";"14.5";"4400";"4400";"4259";"141";"0";"452783";"386948"
"V4mis2";"SILVA (only NR);Bacteria;Firmicutes;Clostridia;Oscillospirales;Oscillospiraceae;Colidextribacter;";"96.4";"14.4";"384";"384";"370";"14";"0";"456799";"390837"
"V4mis2";"SILVA (only NR);Bacteria;Firmicutes;Clostridia;Oscillospirales;Oscillospiraceae;Flavonifractor;";"97.9";"14.4";"48";"48";"47";"1";"0";"457135";"391160"
"V4mis2";"SILVA (only NR);Bacteria;Firmicutes;Clostridia;Oscillospirales;Oscillospiraceae;Intestinimonas;";"100.0";"14.4";"43";"43";"43";"0";"0";"457140";"391164"
"V4mis2";"SILVA (only NR);Bacteria;Firmicutes;Clostridia;Oscillospirales;Oscillospiraceae;NK4A214 group;";"96.7";"14.4";"687";"687";"664";"23";"0";"456496";"390543"
"V4mis2";"SILVA (only NR);Bacteria;Firmicutes;Clostridia;Oscillospirales;Oscillospiraceae;Oscillibacter;";"94.0";"14.4";"268";"268";"252";"16";"0";"456915";"390955"
"V4mis2";"SILVA (only NR);Bacteria;Firmicutes;Clostridia;Oscillospirales;Oscillospiraceae;Oscillospira;";"100.0";"14.4";"29";"29";"29";"0";"0";"457154";"391178"
"V4mis2";"SILVA (only NR);Bacteria;Firmicutes;Clostridia;Oscillospirales;Oscillospiraceae;Papillibacter;";"100.0";"14.4";"73";"73";"73";"0";"0";"457110";"391134"
"V4mis2";"SILVA (only NR);Bacteria;Firmicutes;Clostridia;Oscillospirales;Oscillospiraceae;Pseudoflavonifractor;";"100.0";"14.4";"4";"4";"4";"0";"0";"457179";"391203"
"V4mis2";"SILVA (only NR);Bacteria;Firmicutes;Clostridia;Oscillospirales;Oscillospiraceae;Sporobacter;";"100.0";"14.4";"14";"14";"14";"0";"0";"457169";"391193"
"V4mis2";"SILVA (only NR);Bacteria;Firmicutes;Clostridia;Oscillospirales;Oscillospiraceae;UCG-002;";"96.5";"14.4";"511";"511";"493";"18";"0";"456672";"390714"
"V4mis2";"SILVA (only NR);Bacteria;Firmicutes;Clostridia;Oscillospirales;Oscillospiraceae;UCG-003;";"94.4";"14.4";"71";"71";"67";"4";"0";"457112";"391140"
"V4mis2";"SILVA (only NR);Bacteria;Firmicutes;Clostridia;Oscillospirales;Oscillospiraceae;UCG-005;";"97.1";"14.5";"1479";"1479";"1436";"43";"0";"455704";"389771"
"V4mis2";"SILVA (only NR);Bacteria;Firmicutes;Clostridia;Oscillospirales;Oscillospiraceae;UCG-007;";"100.0";"14.4";"8";"8";"8";"0";"0";"457175";"391199"
"V4mis2";"SILVA (only NR);Bacteria;Firmicutes;Clostridia;Oscillospirales;Oscillospiraceae;V9D2013 group;";"96.8";"14.4";"31";"31";"30";"1";"0";"457152";"391177"
"V4mis2";"SILVA (only NR);Bacteria;Firmicutes;Clostridia;Oscillospirales;Oscillospiraceae;uncultured;";"97.2";"14.4";"741";"741";"720";"21";"0";"456442";"390487"
"V4mis2";"SILVA (only NR);Bacteria;Firmicutes;Clostridia;Oscillospirales;Ruminococcaceae;";"96.1";"14.6";"5875";"5875";"5646";"229";"0";"451308";"385561"
"V4mis2";"SILVA (only NR);Bacteria;Firmicutes;Clostridia;Oscillospirales;Ruminococcaceae;Anaerofilum;";"100.0";"14.4";"20";"20";"20";"0";"0";"457163";"391187"
"V4mis2";"SILVA (only NR);Bacteria;Firmicutes;Clostridia;Oscillospirales;Ruminococcaceae;Anaerotruncus;";"94.1";"14.4";"51";"51";"48";"3";"0";"457132";"391159"
"V4mis2";"SILVA (only NR);Bacteria;Firmicutes;Clostridia;Oscillospirales;Ruminococcaceae;Angelakisella;";"100.0";"14.4";"4";"4";"4";"0";"0";"457179";"391203"
"V4mis2";"SILVA (only NR);Bacteria;Firmicutes;Clostridia;Oscillospirales;Ruminococcaceae;CAG-352;";"90.4";"14.4";"73";"73";"66";"7";"0";"457110";"391141"
"V4mis2";"SILVA (only NR);Bacteria;Firmicutes;Clostridia;Oscillospirales;Ruminococcaceae;Candidatus Soleaferrea;";"98.6";"14.4";"146";"146";"144";"2";"0";"457037";"391063"
"V4mis2";"SILVA (only NR);Bacteria;Firmicutes;Clostridia;Oscillospirales;Ruminococcaceae;Caproiciproducens;";"93.6";"14.4";"109";"109";"102";"7";"0";"457074";"391105"
"V4mis2";"SILVA (only NR);Bacteria;Firmicutes;Clostridia;Oscillospirales;Ruminococcaceae;DTU089;";"100.0";"14.4";"10";"10";"10";"0";"0";"457173";"391197"
"V4mis2";"SILVA (only NR);Bacteria;Firmicutes;Clostridia;Oscillospirales;Ruminococcaceae;Faecalibacterium;";"95.2";"14.5";"1930";"1930";"1838";"92";"0";"455253";"389369"
"V4mis2";"SILVA (only NR);Bacteria;Firmicutes;Clostridia;Oscillospirales;Ruminococcaceae;Fournierella;";"96.8";"14.4";"31";"31";"30";"1";"0";"457152";"391177"
"V4mis2";"SILVA (only NR);Bacteria;Firmicutes;Clostridia;Oscillospirales;Ruminococcaceae;Harryflintia;";"90.9";"14.4";"11";"11";"10";"1";"0";"457172";"391197"
"V4mis2";"SILVA (only NR);Bacteria;Firmicutes;Clostridia;Oscillospirales;Ruminococcaceae;Incertae Sedis;";"96.4";"14.4";"335";"335";"323";"12";"0";"456848";"390884"
"V4mis2";"SILVA (only NR);Bacteria;Firmicutes;Clostridia;Oscillospirales;Ruminococcaceae;Negativibacillus;";"100.0";"14.4";"62";"62";"62";"0";"0";"457121";"391145"
"V4mis2";"SILVA (only NR);Bacteria;Firmicutes;Clostridia;Oscillospirales;Ruminococcaceae;Paludicola;";"100.0";"14.4";"29";"29";"29";"0";"0";"457154";"391178"
"V4mis2";"SILVA (only NR);Bacteria;Firmicutes;Clostridia;Oscillospirales;Ruminococcaceae;Phocea;";"100.0";"14.4";"4";"4";"4";"0";"0";"457179";"391203"
"V4mis2";"SILVA (only NR);Bacteria;Firmicutes;Clostridia;Oscillospirales;Ruminococcaceae;Pygmaiobacter;";"100.0";"14.4";"13";"13";"13";"0";"0";"457170";"391194"
"V4mis2";"SILVA (only NR);Bacteria;Firmicutes;Clostridia;Oscillospirales;Ruminococcaceae;Ruminococcus;";"96.1";"14.5";"1437";"1437";"1381";"56";"0";"455746";"389826"
"V4mis2";"SILVA (only NR);Bacteria;Firmicutes;Clostridia;Oscillospirales;Ruminococcaceae;Subdoligranulum;";"97.8";"14.5";"741";"741";"725";"16";"0";"456442";"390482"
"V4mis2";"SILVA (only NR);Bacteria;Firmicutes;Clostridia;Oscillospirales;Ruminococcaceae;UBA1819;";"97.5";"14.4";"40";"40";"39";"1";"0";"457143";"391168"
"V4mis2";"SILVA (only NR);Bacteria;Firmicutes;Clostridia;Oscillospirales;Ruminococcaceae;UCG-001;";"93.8";"14.4";"16";"16";"15";"1";"0";"457167";"391192"
"V4mis2";"SILVA (only NR);Bacteria;Firmicutes;Clostridia;Oscillospirales;Ruminococcaceae;[Eubacterium] siraeum group;";"91.8";"14.4";"73";"73";"67";"6";"0";"457110";"391140"
"V4mis2";"SILVA (only NR);Bacteria;Firmicutes;Clostridia;Oscillospirales;Ruminococcaceae;uncultured;";"96.9";"14.4";"649";"649";"629";"20";"0";"456534";"390578"
"V4mis2";"SILVA (only NR);Bacteria;Firmicutes;Clostridia;Oscillospirales;UCG-010;";"97.4";"14.5";"838";"838";"816";"22";"0";"456345";"390391"
"V4mis2";"SILVA (only NR);Bacteria;Firmicutes;Clostridia;Oscillospirales;UCG-011;";"100.0";"14.4";"79";"79";"79";"0";"0";"457104";"391128"
"V4mis2";"SILVA (only NR);Bacteria;Firmicutes;Clostridia;Oscillospirales;[Clostridium] methylpentosum group;";"100.0";"14.4";"23";"23";"23";"0";"0";"457160";"391184"
"V4mis2";"SILVA (only NR);Bacteria;Firmicutes;Clostridia;Oscillospirales;[Eubacterium] coprostanoligenes group;";"97.4";"14.5";"1058";"1058";"1030";"28";"0";"456125";"390177"
"V4mis2";"SILVA (only NR);Bacteria;Firmicutes;Clostridia;Oscillospirales;uncultured;";"95.8";"14.4";"167";"167";"160";"7";"0";"457016";"391047"
"V4mis2";"SILVA (only NR);Bacteria;Firmicutes;Clostridia;Peptococcales;";"95.2";"14.4";"229";"229";"218";"11";"0";"456954";"390989"
"V4mis2";"SILVA (only NR);Bacteria;Firmicutes;Clostridia;Peptococcales;Peptococcaceae;";"95.2";"14.4";"229";"229";"218";"11";"0";"456954";"390989"
"V4mis2";"SILVA (only NR);Bacteria;Firmicutes;Clostridia;Peptococcales;Peptococcaceae;Dehalobacterium;";"100.0";"14.4";"9";"9";"9";"0";"0";"457174";"391198"
"V4mis2";"SILVA (only NR);Bacteria;Firmicutes;Clostridia;Peptococcales;Peptococcaceae;Desulfitispora;";"100.0";"14.4";"4";"4";"4";"0";"0";"457179";"391203"
"V4mis2";"SILVA (only NR);Bacteria;Firmicutes;Clostridia;Peptococcales;Peptococcaceae;Desulfonispora;";"100.0";"14.4";"2";"2";"2";"0";"0";"457181";"391205"
"V4mis2";"SILVA (only NR);Bacteria;Firmicutes;Clostridia;Peptococcales;Peptococcaceae;Peptococcus;";"98.0";"14.4";"51";"51";"50";"1";"0";"457132";"391157"
"V4mis2";"SILVA (only NR);Bacteria;Firmicutes;Clostridia;Peptococcales;Peptococcaceae;uncultured;";"93.8";"14.4";"162";"162";"152";"10";"0";"457021";"391055"
"V4mis2";"SILVA (only NR);Bacteria;Firmicutes;Clostridia;Peptostreptococcales-Tissierellales;";"95.5";"14.5";"4931";"4931";"4707";"224";"0";"452252";"386500"
"V4mis2";"SILVA (only NR);Bacteria;Firmicutes;Clostridia;Peptostreptococcales-Tissierellales;Acidaminobacteraceae;";"100.0";"14.4";"49";"49";"49";"0";"0";"457134";"391158"
"V4mis2";"SILVA (only NR);Bacteria;Firmicutes;Clostridia;Peptostreptococcales-Tissierellales;Acidaminobacteraceae;Acidaminobacter;";"100.0";"14.4";"49";"49";"49";"0";"0";"457134";"391158"
"V4mis2";"SILVA (only NR);Bacteria;Firmicutes;Clostridia;Peptostreptococcales-Tissierellales;Alkaliphilus;";"94.3";"14.4";"70";"70";"66";"4";"0";"457113";"391141"
"V4mis2";"SILVA (only NR);Bacteria;Firmicutes;Clostridia;Peptostreptococcales-Tissierellales;Anaeromicrobium;";"100.0";"14.4";"8";"8";"8";"0";"0";"457175";"391199"
"V4mis2";"SILVA (only NR);Bacteria;Firmicutes;Clostridia;Peptostreptococcales-Tissierellales;Anaerovirgula;";"100.0";"14.4";"2";"2";"2";"0";"0";"457181";"391205"
"V4mis2";"SILVA (only NR);Bacteria;Firmicutes;Clostridia;Peptostreptococcales-Tissierellales;Anaerovoracaceae;";"97.0";"14.5";"1018";"1018";"987";"31";"0";"456165";"390220"
"V4mis2";"SILVA (only NR);Bacteria;Firmicutes;Clostridia;Peptostreptococcales-Tissierellales;Anaerovoracaceae;Amnipila;";"100.0";"14.4";"20";"20";"20";"0";"0";"457163";"391187"
"V4mis2";"SILVA (only NR);Bacteria;Firmicutes;Clostridia;Peptostreptococcales-Tissierellales;Anaerovoracaceae;Anaerovorax;";"97.2";"14.4";"217";"217";"211";"6";"0";"456966";"390996"
"V4mis2";"SILVA (only NR);Bacteria;Firmicutes;Clostridia;Peptostreptococcales-Tissierellales;Anaerovoracaceae;Family XIII AD3011 group;";"96.2";"14.4";"183";"183";"176";"7";"0";"457000";"391031"
"V4mis2";"SILVA (only NR);Bacteria;Firmicutes;Clostridia;Peptostreptococcales-Tissierellales;Anaerovoracaceae;Family XIII UCG-001;";"100.0";"14.4";"37";"37";"37";"0";"0";"457146";"391170"
"V4mis2";"SILVA (only NR);Bacteria;Firmicutes;Clostridia;Peptostreptococcales-Tissierellales;Anaerovoracaceae;Mogibacterium;";"97.2";"14.4";"178";"178";"173";"5";"0";"457005";"391034"
"V4mis2";"SILVA (only NR);Bacteria;Firmicutes;Clostridia;Peptostreptococcales-Tissierellales;Anaerovoracaceae;S5-A14a;";"96.0";"14.4";"25";"25";"24";"1";"0";"457158";"391183"
"V4mis2";"SILVA (only NR);Bacteria;Firmicutes;Clostridia;Peptostreptococcales-Tissierellales;Anaerovoracaceae;[Eubacterium] brachy group;";"97.3";"14.4";"74";"74";"72";"2";"0";"457109";"391135"
"V4mis2";"SILVA (only NR);Bacteria;Firmicutes;Clostridia;Peptostreptococcales-Tissierellales;Anaerovoracaceae;[Eubacterium] nodatum group;";"95.8";"14.4";"167";"167";"160";"7";"0";"457016";"391047"
"V4mis2";"SILVA (only NR);Bacteria;Firmicutes;Clostridia;Peptostreptococcales-Tissierellales;Anaerovoracaceae;[Eubacterium] saphenum group;";"100.0";"14.4";"9";"9";"9";"0";"0";"457174";"391198"
"V4mis2";"SILVA (only NR);Bacteria;Firmicutes;Clostridia;Peptostreptococcales-Tissierellales;Anaerovoracaceae;uncultured;";"97.1";"14.4";"104";"104";"101";"3";"0";"457079";"391106"
"V4mis2";"SILVA (only NR);Bacteria;Firmicutes;Clostridia;Peptostreptococcales-Tissierellales;Anoxynatronum;";"100.0";"14.4";"16";"16";"16";"0";"0";"457167";"391191"
"V4mis2";"SILVA (only NR);Bacteria;Firmicutes;Clostridia;Peptostreptococcales-Tissierellales;Brassicibacter;";"93.3";"14.4";"15";"15";"14";"1";"0";"457168";"391193"
"V4mis2";"SILVA (only NR);Bacteria;Firmicutes;Clostridia;Peptostreptococcales-Tissierellales;Caldisalinibacter;";"100.0";"14.4";"1";"1";"1";"0";"0";"457182";"391206"
"V4mis2";"SILVA (only NR);Bacteria;Firmicutes;Clostridia;Peptostreptococcales-Tissierellales;Caloranaerobacter;";"100.0";"14.4";"17";"17";"17";"0";"0";"457166";"391190"
"V4mis2";"SILVA (only NR);Bacteria;Firmicutes;Clostridia;Peptostreptococcales-Tissierellales;Caminicellaceae;";"88.1";"14.4";"59";"59";"52";"7";"0";"457124";"391155"
"V4mis2";"SILVA (only NR);Bacteria;Firmicutes;Clostridia;Peptostreptococcales-Tissierellales;Caminicellaceae;Caminicella;";"84.6";"14.4";"39";"39";"33";"6";"0";"457144";"391174"
"V4mis2";"SILVA (only NR);Bacteria;Firmicutes;Clostridia;Peptostreptococcales-Tissierellales;Caminicellaceae;Paramaledivibacter;";"95.0";"14.4";"20";"20";"19";"1";"0";"457163";"391188"
"V4mis2";"SILVA (only NR);Bacteria;Firmicutes;Clostridia;Peptostreptococcales-Tissierellales;Clostridiisalibacter;";"100.0";"14.4";"30";"30";"30";"0";"0";"457153";"391177"
"V4mis2";"SILVA (only NR);Bacteria;Firmicutes;Clostridia;Peptostreptococcales-Tissierellales;Clostridium sensu stricto;";"92.3";"14.4";"13";"13";"12";"1";"0";"457170";"391195"
"V4mis2";"SILVA (only NR);Bacteria;Firmicutes;Clostridia;Peptostreptococcales-Tissierellales;Dethiosulfatibacteraceae;";"100.0";"14.4";"37";"37";"37";"0";"0";"457146";"391170"
"V4mis2";"SILVA (only NR);Bacteria;Firmicutes;Clostridia;Peptostreptococcales-Tissierellales;Dethiosulfatibacteraceae;Dethiosulfatibacter;";"100.0";"14.4";"37";"37";"37";"0";"0";"457146";"391170"
"V4mis2";"SILVA (only NR);Bacteria;Firmicutes;Clostridia;Peptostreptococcales-Tissierellales;Family XI;";"94.8";"14.5";"1632";"1632";"1547";"85";"0";"455551";"389660"
"V4mis2";"SILVA (only NR);Bacteria;Firmicutes;Clostridia;Peptostreptococcales-Tissierellales;Family XI;Anaerococcus;";"95.6";"14.4";"496";"496";"474";"22";"0";"456687";"390733"
"V4mis2";"SILVA (only NR);Bacteria;Firmicutes;Clostridia;Peptostreptococcales-Tissierellales;Family XI;Anaerosalibacter;";"84.2";"14.4";"19";"19";"16";"3";"0";"457164";"391191"
"V4mis2";"SILVA (only NR);Bacteria;Firmicutes;Clostridia;Peptostreptococcales-Tissierellales;Family XI;Anaerosphaera;";"100.0";"14.4";"3";"3";"3";"0";"0";"457180";"391204"
"V4mis2";"SILVA (only NR);Bacteria;Firmicutes;Clostridia;Peptostreptococcales-Tissierellales;Family XI;Ezakiella;";"86.1";"14.4";"36";"36";"31";"5";"0";"457147";"391176"
"V4mis2";"SILVA (only NR);Bacteria;Firmicutes;Clostridia;Peptostreptococcales-Tissierellales;Family XI;Fenollaria;";"92.6";"14.4";"54";"54";"50";"4";"0";"457129";"391157"
"V4mis2";"SILVA (only NR);Bacteria;Firmicutes;Clostridia;Peptostreptococcales-Tissierellales;Family XI;Finegoldia;";"90.1";"14.4";"161";"161";"145";"16";"0";"457022";"391062"
"V4mis2";"SILVA (only NR);Bacteria;Firmicutes;Clostridia;Peptostreptococcales-Tissierellales;Family XI;Gallicola;";"92.9";"14.4";"28";"28";"26";"2";"0";"457155";"391181"
"V4mis2";"SILVA (only NR);Bacteria;Firmicutes;Clostridia;Peptostreptococcales-Tissierellales;Family XI;Helcococcus;";"97.1";"14.4";"68";"68";"66";"2";"0";"457115";"391141"
"V4mis2";"SILVA (only NR);Bacteria;Firmicutes;Clostridia;Peptostreptococcales-Tissierellales;Family XI;Keratinibaculum;";"75.0";"14.4";"8";"8";"6";"2";"0";"457175";"391201"
"V4mis2";"SILVA (only NR);Bacteria;Firmicutes;Clostridia;Peptostreptococcales-Tissierellales;Family XI;Murdochiella;";"95.2";"14.4";"21";"21";"20";"1";"0";"457162";"391187"
"V4mis2";"SILVA (only NR);Bacteria;Firmicutes;Clostridia;Peptostreptococcales-Tissierellales;Family XI;Parvimonas;";"95.7";"14.4";"94";"94";"90";"4";"0";"457089";"391117"
"V4mis2";"SILVA (only NR);Bacteria;Firmicutes;Clostridia;Peptostreptococcales-Tissierellales;Family XI;Peptoniphilus;";"95.6";"14.4";"203";"203";"194";"9";"0";"456980";"391013"
"V4mis2";"SILVA (only NR);Bacteria;Firmicutes;Clostridia;Peptostreptococcales-Tissierellales;Family XI;Soehngenia;";"90.9";"14.4";"33";"33";"30";"3";"0";"457150";"391177"
"V4mis2";"SILVA (only NR);Bacteria;Firmicutes;Clostridia;Peptostreptococcales-Tissierellales;Family XI;Sporanaerobacter;";"88.9";"14.4";"27";"27";"24";"3";"0";"457156";"391183"
"V4mis2";"SILVA (only NR);Bacteria;Firmicutes;Clostridia;Peptostreptococcales-Tissierellales;Family XI;Tepidimicrobium;";"98.7";"14.4";"75";"75";"74";"1";"0";"457108";"391133"
"V4mis2";"SILVA (only NR);Bacteria;Firmicutes;Clostridia;Peptostreptococcales-Tissierellales;Family XI;Tissierella;";"95.1";"14.4";"162";"162";"154";"8";"0";"457021";"391053"
"V4mis2";"SILVA (only NR);Bacteria;Firmicutes;Clostridia;Peptostreptococcales-Tissierellales;Family XI;W5053;";"100.0";"14.4";"86";"86";"86";"0";"0";"457097";"391121"
"V4mis2";"SILVA (only NR);Bacteria;Firmicutes;Clostridia;Peptostreptococcales-Tissierellales;Family XI;uncultured;";"100.0";"14.4";"50";"50";"50";"0";"0";"457133";"391157"
"V4mis2";"SILVA (only NR);Bacteria;Firmicutes;Clostridia;Peptostreptococcales-Tissierellales;Fusibacteraceae;";"96.1";"14.4";"331";"331";"318";"13";"0";"456852";"390889"
"V4mis2";"SILVA (only NR);Bacteria;Firmicutes;Clostridia;Peptostreptococcales-Tissierellales;Fusibacteraceae;Fusibacter;";"96.1";"14.4";"331";"331";"318";"13";"0";"456852";"390889"
"V4mis2";"SILVA (only NR);Bacteria;Firmicutes;Clostridia;Peptostreptococcales-Tissierellales;GoM-GC232-4463-Bac1;";"71.4";"14.4";"7";"7";"5";"2";"0";"457176";"391202"
"V4mis2";"SILVA (only NR);Bacteria;Firmicutes;Clostridia;Peptostreptococcales-Tissierellales;Gottschalkia;";"100.0";"14.4";"13";"13";"13";"0";"0";"457170";"391194"
"V4mis2";"SILVA (only NR);Bacteria;Firmicutes;Clostridia;Peptostreptococcales-Tissierellales;Guggenheimella;";"96.8";"14.4";"63";"63";"61";"2";"0";"457120";"391146"
"V4mis2";"SILVA (only NR);Bacteria;Firmicutes;Clostridia;Peptostreptococcales-Tissierellales;JTB215;";"100.0";"14.4";"12";"12";"12";"0";"0";"457171";"391195"
"V4mis2";"SILVA (only NR);Bacteria;Firmicutes;Clostridia;Peptostreptococcales-Tissierellales;MCWD3;";"100.0";"14.4";"3";"3";"3";"0";"0";"457180";"391204"
"V4mis2";"SILVA (only NR);Bacteria;Firmicutes;Clostridia;Peptostreptococcales-Tissierellales;Natronincola;";"88.9";"14.4";"9";"9";"8";"1";"0";"457174";"391199"
"V4mis2";"SILVA (only NR);Bacteria;Firmicutes;Clostridia;Peptostreptococcales-Tissierellales;Peptostreptococcaceae;";"95.2";"14.5";"1217";"1217";"1159";"58";"0";"455966";"390048"
"V4mis2";"SILVA (only NR);Bacteria;Firmicutes;Clostridia;Peptostreptococcales-Tissierellales;Peptostreptococcaceae;Acetoanaerobium;";"93.3";"14.4";"30";"30";"28";"2";"0";"457153";"391179"
"V4mis2";"SILVA (only NR);Bacteria;Firmicutes;Clostridia;Peptostreptococcales-Tissierellales;Peptostreptococcaceae;Asaccharospora;";"100.0";"14.4";"2";"2";"2";"0";"0";"457181";"391205"
"V4mis2";"SILVA (only NR);Bacteria;Firmicutes;Clostridia;Peptostreptococcales-Tissierellales;Peptostreptococcaceae;Clostridioides;";"99.0";"14.4";"100";"100";"99";"1";"0";"457083";"391108"
"V4mis2";"SILVA (only NR);Bacteria;Firmicutes;Clostridia;Peptostreptococcales-Tissierellales;Peptostreptococcaceae;Criibacterium;";"100.0";"14.4";"1";"1";"1";"0";"0";"457182";"391206"
"V4mis2";"SILVA (only NR);Bacteria;Firmicutes;Clostridia;Peptostreptococcales-Tissierellales;Peptostreptococcaceae;Filifactor;";"100.0";"14.4";"15";"15";"15";"0";"0";"457168";"391192"
"V4mis2";"SILVA (only NR);Bacteria;Firmicutes;Clostridia;Peptostreptococcales-Tissierellales;Peptostreptococcaceae;Intestinibacter;";"93.1";"14.4";"58";"58";"54";"4";"0";"457125";"391153"
"V4mis2";"SILVA (only NR);Bacteria;Firmicutes;Clostridia;Peptostreptococcales-Tissierellales;Peptostreptococcaceae;Paeniclostridium;";"97.7";"14.4";"44";"44";"43";"1";"0";"457139";"391164"
"V4mis2";"SILVA (only NR);Bacteria;Firmicutes;Clostridia;Peptostreptococcales-Tissierellales;Peptostreptococcaceae;Paraclostridium;";"88.9";"14.4";"108";"108";"96";"12";"0";"457075";"391111"
"V4mis2";"SILVA (only NR);Bacteria;Firmicutes;Clostridia;Peptostreptococcales-Tissierellales;Peptostreptococcaceae;Peptoanaerobacter;";"100.0";"14.4";"2";"2";"2";"0";"0";"457181";"391205"
"V4mis2";"SILVA (only NR);Bacteria;Firmicutes;Clostridia;Peptostreptococcales-Tissierellales;Peptostreptococcaceae;Peptoclostridium;";"96.2";"14.4";"159";"159";"153";"6";"0";"457024";"391054"
"V4mis2";"SILVA (only NR);Bacteria;Firmicutes;Clostridia;Peptostreptococcales-Tissierellales;Peptostreptococcaceae;Peptostreptococcus;";"86.2";"14.4";"58";"58";"50";"8";"0";"457125";"391157"
"V4mis2";"SILVA (only NR);Bacteria;Firmicutes;Clostridia;Peptostreptococcales-Tissierellales;Peptostreptococcaceae;Proteocatella;";"88.9";"14.4";"18";"18";"16";"2";"0";"457165";"391191"
"V4mis2";"SILVA (only NR);Bacteria;Firmicutes;Clostridia;Peptostreptococcales-Tissierellales;Peptostreptococcaceae;Romboutsia;";"94.2";"14.4";"311";"311";"293";"18";"0";"456872";"390914"
"V4mis2";"SILVA (only NR);Bacteria;Firmicutes;Clostridia;Peptostreptococcales-Tissierellales;Peptostreptococcaceae;Sporacetigenium;";"100.0";"14.4";"11";"11";"11";"0";"0";"457172";"391196"
"V4mis2";"SILVA (only NR);Bacteria;Firmicutes;Clostridia;Peptostreptococcales-Tissierellales;Peptostreptococcaceae;Tepidibacter;";"93.8";"14.4";"16";"16";"15";"1";"0";"457167";"391192"
"V4mis2";"SILVA (only NR);Bacteria;Firmicutes;Clostridia;Peptostreptococcales-Tissierellales;Peptostreptococcaceae;Terrisporobacter;";"98.2";"14.4";"110";"110";"108";"2";"0";"457073";"391099"
"V4mis2";"SILVA (only NR);Bacteria;Firmicutes;Clostridia;Peptostreptococcales-Tissierellales;Peptostreptococcaceae;[Eubacterium] tenue group;";"100.0";"14.4";"3";"3";"3";"0";"0";"457180";"391204"
"V4mis2";"SILVA (only NR);Bacteria;Firmicutes;Clostridia;Peptostreptococcales-Tissierellales;Peptostreptococcaceae;[Eubacterium] yurii group;";"97.0";"14.4";"33";"33";"32";"1";"0";"457150";"391175"
"V4mis2";"SILVA (only NR);Bacteria;Firmicutes;Clostridia;Peptostreptococcales-Tissierellales;Peptostreptococcaceae;uncultured;";"100.0";"14.4";"128";"128";"128";"0";"0";"457055";"391079"
"V4mis2";"SILVA (only NR);Bacteria;Firmicutes;Clostridia;Peptostreptococcales-Tissierellales;Proteiniboraceae;";"100.0";"14.4";"11";"11";"11";"0";"0";"457172";"391196"
"V4mis2";"SILVA (only NR);Bacteria;Firmicutes;Clostridia;Peptostreptococcales-Tissierellales;Proteiniboraceae;Proteiniborus;";"100.0";"14.4";"11";"11";"11";"0";"0";"457172";"391196"
"V4mis2";"SILVA (only NR);Bacteria;Firmicutes;Clostridia;Peptostreptococcales-Tissierellales;Sedimentibacteraceae;";"91.9";"14.4";"186";"186";"171";"15";"0";"456997";"391036"
"V4mis2";"SILVA (only NR);Bacteria;Firmicutes;Clostridia;Peptostreptococcales-Tissierellales;Sedimentibacteraceae;Sedimentibacter;";"91.9";"14.4";"186";"186";"171";"15";"0";"456997";"391036"
"V4mis2";"SILVA (only NR);Bacteria;Firmicutes;Clostridia;Peptostreptococcales-Tissierellales;Serpentinicella;";"93.3";"14.4";"15";"15";"14";"1";"0";"457168";"391193"
"V4mis2";"SILVA (only NR);Bacteria;Firmicutes;Clostridia;Peptostreptococcales-Tissierellales;Sporosalibacterium;";"100.0";"14.4";"8";"8";"8";"0";"0";"457175";"391199"
"V4mis2";"SILVA (only NR);Bacteria;Firmicutes;Clostridia;Peptostreptococcales-Tissierellales;Thermohalobacter;";"100.0";"14.4";"2";"2";"2";"0";"0";"457181";"391205"
"V4mis2";"SILVA (only NR);Bacteria;Firmicutes;Clostridia;Peptostreptococcales-Tissierellales;Thermotaleaceae;";"93.3";"14.4";"30";"30";"28";"2";"0";"457153";"391179"
"V4mis2";"SILVA (only NR);Bacteria;Firmicutes;Clostridia;Peptostreptococcales-Tissierellales;Thermotaleaceae;Anaerosolibacter;";"100.0";"14.4";"7";"7";"7";"0";"0";"457176";"391200"
"V4mis2";"SILVA (only NR);Bacteria;Firmicutes;Clostridia;Peptostreptococcales-Tissierellales;Thermotaleaceae;Crassaminicella;";"80.0";"14.4";"10";"10";"8";"2";"0";"457173";"391199"
"V4mis2";"SILVA (only NR);Bacteria;Firmicutes;Clostridia;Peptostreptococcales-Tissierellales;Thermotaleaceae;Geosporobacter;";"100.0";"14.4";"4";"4";"4";"0";"0";"457179";"391203"
"V4mis2";"SILVA (only NR);Bacteria;Firmicutes;Clostridia;Peptostreptococcales-Tissierellales;Thermotaleaceae;Salimesophilobacter;";"100.0";"14.4";"3";"3";"3";"0";"0";"457180";"391204"
"V4mis2";"SILVA (only NR);Bacteria;Firmicutes;Clostridia;Peptostreptococcales-Tissierellales;Thermotaleaceae;Thermotalea;";"100.0";"14.4";"3";"3";"3";"0";"0";"457180";"391204"
"V4mis2";"SILVA (only NR);Bacteria;Firmicutes;Clostridia;Peptostreptococcales-Tissierellales;Thermotaleaceae;uncultured;";"100.0";"14.4";"3";"3";"3";"0";"0";"457180";"391204"
"V4mis2";"SILVA (only NR);Bacteria;Firmicutes;Clostridia;Peptostreptococcales-Tissierellales;Tindallia;";"100.0";"14.4";"11";"11";"11";"0";"0";"457172";"391196"
"V4mis2";"SILVA (only NR);Bacteria;Firmicutes;Clostridia;Peptostreptococcales-Tissierellales;livecontrolB21;";"100.0";"14.4";"4";"4";"4";"0";"0";"457179";"391203"
"V4mis2";"SILVA (only NR);Bacteria;Firmicutes;Clostridia;Peptostreptococcales-Tissierellales;uncultured;";"97.2";"14.4";"36";"36";"35";"1";"0";"457147";"391172"
"V4mis2";"SILVA (only NR);Bacteria;Firmicutes;Clostridia;Proteinivoracales;";"94.7";"14.4";"95";"95";"90";"5";"0";"457088";"391117"
"V4mis2";"SILVA (only NR);Bacteria;Firmicutes;Clostridia;Proteinivoracales;Anaerobranca;";"90.5";"14.4";"21";"21";"19";"2";"0";"457162";"391188"
"V4mis2";"SILVA (only NR);Bacteria;Firmicutes;Clostridia;Proteinivoracales;Proteinivorax;";"100.0";"14.4";"3";"3";"3";"0";"0";"457180";"391204"
"V4mis2";"SILVA (only NR);Bacteria;Firmicutes;Clostridia;Proteinivoracales;uncultured;";"95.7";"14.4";"69";"69";"66";"3";"0";"457114";"391141"
"V4mis2";"SILVA (only NR);Bacteria;Firmicutes;Clostridia;Thermincolales;";"92.5";"14.4";"80";"80";"74";"6";"0";"457103";"391133"
"V4mis2";"SILVA (only NR);Bacteria;Firmicutes;Clostridia;Thermincolales;Thermincolaceae;";"92.5";"14.4";"80";"80";"74";"6";"0";"457103";"391133"
"V4mis2";"SILVA (only NR);Bacteria;Firmicutes;Clostridia;Thermincolales;Thermincolaceae;Thermincola;";"92.5";"14.4";"80";"80";"74";"6";"0";"457103";"391133"
"V4mis2";"SILVA (only NR);Bacteria;Firmicutes;Clostridia;uncultured;";"97.7";"14.4";"44";"44";"43";"1";"0";"457139";"391164"
"V4mis2";"SILVA (only NR);Bacteria;Firmicutes;D8A-2;";"94.5";"14.4";"165";"165";"156";"9";"0";"457018";"391051"
"V4mis2";"SILVA (only NR);Bacteria;Firmicutes;Desulfitobacteriia;";"97.6";"14.4";"539";"539";"526";"13";"0";"456644";"390681"
"V4mis2";"SILVA (only NR);Bacteria;Firmicutes;Desulfitobacteriia;Desulfitobacteriales;";"97.6";"14.4";"539";"539";"526";"13";"0";"456644";"390681"
"V4mis2";"SILVA (only NR);Bacteria;Firmicutes;Desulfitobacteriia;Desulfitobacteriales;Desulfitobacteriaceae;";"97.5";"14.4";"354";"354";"345";"9";"0";"456829";"390862"
"V4mis2";"SILVA (only NR);Bacteria;Firmicutes;Desulfitobacteriia;Desulfitobacteriales;Desulfitobacteriaceae;Desulfitobacterium;";"98.5";"14.4";"68";"68";"67";"1";"0";"457115";"391140"
"V4mis2";"SILVA (only NR);Bacteria;Firmicutes;Desulfitobacteriia;Desulfitobacteriales;Desulfitobacteriaceae;Desulfosporosinus;";"97.2";"14.4";"286";"286";"278";"8";"0";"456897";"390929"
"V4mis2";"SILVA (only NR);Bacteria;Firmicutes;Desulfitobacteriia;Desulfitobacteriales;Heliobacteriaceae;";"96.2";"14.4";"52";"52";"50";"2";"0";"457131";"391157"
"V4mis2";"SILVA (only NR);Bacteria;Firmicutes;Desulfitobacteriia;Desulfitobacteriales;Heliobacteriaceae;Candidatus Heliomonas;";"100.0";"14.4";"1";"1";"1";"0";"0";"457182";"391206"
"V4mis2";"SILVA (only NR);Bacteria;Firmicutes;Desulfitobacteriia;Desulfitobacteriales;Heliobacteriaceae;Heliobacillus;";"100.0";"14.4";"7";"7";"7";"0";"0";"457176";"391200"
"V4mis2";"SILVA (only NR);Bacteria;Firmicutes;Desulfitobacteriia;Desulfitobacteriales;Heliobacteriaceae;Heliobacterium;";"90.0";"14.4";"10";"10";"9";"1";"0";"457173";"391198"
"V4mis2";"SILVA (only NR);Bacteria;Firmicutes;Desulfitobacteriia;Desulfitobacteriales;Heliobacteriaceae;Heliophilum;";"100.0";"14.4";"3";"3";"3";"0";"0";"457180";"391204"
"V4mis2";"SILVA (only NR);Bacteria;Firmicutes;Desulfitobacteriia;Desulfitobacteriales;Heliobacteriaceae;Heliorestis;";"100.0";"14.4";"5";"5";"5";"0";"0";"457178";"391202"
"V4mis2";"SILVA (only NR);Bacteria;Firmicutes;Desulfitobacteriia;Desulfitobacteriales;Heliobacteriaceae;uncultured;";"95.7";"14.4";"23";"23";"22";"1";"0";"457160";"391185"
"V4mis2";"SILVA (only NR);Bacteria;Firmicutes;Desulfitobacteriia;Desulfitobacteriales;Syntrophobotulaceae;";"97.0";"14.4";"33";"33";"32";"1";"0";"457150";"391175"
"V4mis2";"SILVA (only NR);Bacteria;Firmicutes;Desulfitobacteriia;Desulfitobacteriales;Syntrophobotulaceae;Candidatus Dichloromethanomonas;";"100.0";"14.4";"6";"6";"6";"0";"0";"457177";"391201"
"V4mis2";"SILVA (only NR);Bacteria;Firmicutes;Desulfitobacteriia;Desulfitobacteriales;Syntrophobotulaceae;Dehalobacter;";"96.2";"14.4";"26";"26";"25";"1";"0";"457157";"391182"
"V4mis2";"SILVA (only NR);Bacteria;Firmicutes;Desulfitobacteriia;Desulfitobacteriales;Syntrophobotulaceae;Syntrophobotulus;";"100.0";"14.4";"1";"1";"1";"0";"0";"457182";"391206"
"V4mis2";"SILVA (only NR);Bacteria;Firmicutes;Desulfitobacteriia;Desulfitobacteriales;TC1;";"100.0";"14.4";"10";"10";"10";"0";"0";"457173";"391197"
"V4mis2";"SILVA (only NR);Bacteria;Firmicutes;Desulfitobacteriia;Desulfitobacteriales;uncultured;";"98.9";"14.4";"89";"89";"88";"1";"0";"457094";"391119"
"V4mis2";"SILVA (only NR);Bacteria;Firmicutes;Desulfotomaculia;";"95.5";"14.4";"691";"691";"660";"31";"0";"456492";"390547"
"V4mis2";"SILVA (only NR);Bacteria;Firmicutes;Desulfotomaculia;Ammonifexales;";"93.2";"14.4";"44";"44";"41";"3";"0";"457139";"391166"
"V4mis2";"SILVA (only NR);Bacteria;Firmicutes;Desulfotomaculia;Ammonifexales;Ammonificaceae;";"100.0";"14.4";"20";"20";"20";"0";"0";"457163";"391187"
"V4mis2";"SILVA (only NR);Bacteria;Firmicutes;Desulfotomaculia;Ammonifexales;Ammonificaceae;Ammonifex;";"100.0";"14.4";"2";"2";"2";"0";"0";"457181";"391205"
"V4mis2";"SILVA (only NR);Bacteria;Firmicutes;Desulfotomaculia;Ammonifexales;Ammonificaceae;Desulfothermobacter;";"100.0";"14.4";"2";"2";"2";"0";"0";"457181";"391205"
"V4mis2";"SILVA (only NR);Bacteria;Firmicutes;Desulfotomaculia;Ammonifexales;Ammonificaceae;Thermodesulfitimonas;";"100.0";"14.4";"7";"7";"7";"0";"0";"457176";"391200"
"V4mis2";"SILVA (only NR);Bacteria;Firmicutes;Desulfotomaculia;Ammonifexales;Ammonificaceae;uncultured;";"100.0";"14.4";"6";"6";"6";"0";"0";"457177";"391201"
"V4mis2";"SILVA (only NR);Bacteria;Firmicutes;Desulfotomaculia;Ammonifexales;Desulforudaceae;";"87.0";"14.4";"23";"23";"20";"3";"0";"457160";"391187"
"V4mis2";"SILVA (only NR);Bacteria;Firmicutes;Desulfotomaculia;Ammonifexales;Desulforudaceae;Candidatus Desulforudis;";"87.0";"14.4";"23";"23";"20";"3";"0";"457160";"391187"
"V4mis2";"SILVA (only NR);Bacteria;Firmicutes;Desulfotomaculia;Carboxydothermales;";"100.0";"14.4";"11";"11";"11";"0";"0";"457172";"391196"
"V4mis2";"SILVA (only NR);Bacteria;Firmicutes;Desulfotomaculia;Carboxydothermales;Carboxydothermaceae;";"100.0";"14.4";"11";"11";"11";"0";"0";"457172";"391196"
"V4mis2";"SILVA (only NR);Bacteria;Firmicutes;Desulfotomaculia;Carboxydothermales;Carboxydothermaceae;Carboxydothermus;";"100.0";"14.4";"11";"11";"11";"0";"0";"457172";"391196"
"V4mis2";"SILVA (only NR);Bacteria;Firmicutes;Desulfotomaculia;Desulfotomaculales;";"95.6";"14.4";"636";"636";"608";"28";"0";"456547";"390599"
"V4mis2";"SILVA (only NR);Bacteria;Firmicutes;Desulfotomaculia;Desulfotomaculales;Desulfotomaculaceae;";"94.0";"14.4";"333";"333";"313";"20";"0";"456850";"390894"
"V4mis2";"SILVA (only NR);Bacteria;Firmicutes;Desulfotomaculia;Desulfotomaculales;Desulfotomaculaceae;Desulfofarcimen;";"92.2";"14.4";"244";"244";"225";"19";"0";"456939";"390982"
"V4mis2";"SILVA (only NR);Bacteria;Firmicutes;Desulfotomaculia;Desulfotomaculales;Desulfotomaculaceae;Desulfohalotomaculum;";"97.6";"14.4";"42";"42";"41";"1";"0";"457141";"391166"
"V4mis2";"SILVA (only NR);Bacteria;Firmicutes;Desulfotomaculia;Desulfotomaculales;Desulfotomaculaceae;Desulfotomaculum;";"100.0";"14.4";"47";"47";"47";"0";"0";"457136";"391160"
"V4mis2";"SILVA (only NR);Bacteria;Firmicutes;Desulfotomaculia;Desulfotomaculales;Desulfotomaculales Incertae Sedis;";"97.2";"14.4";"71";"71";"69";"2";"0";"457112";"391138"
"V4mis2";"SILVA (only NR);Bacteria;Firmicutes;Desulfotomaculia;Desulfotomaculales;Desulfotomaculales Incertae Sedis;Desulfallas-Sporotomaculum;";"96.7";"14.4";"61";"61";"59";"2";"0";"457122";"391148"
"V4mis2";"SILVA (only NR);Bacteria;Firmicutes;Desulfotomaculia;Desulfotomaculales;Desulfotomaculales Incertae Sedis;uncultured;";"100.0";"14.4";"10";"10";"10";"0";"0";"457173";"391197"
"V4mis2";"SILVA (only NR);Bacteria;Firmicutes;Desulfotomaculia;Desulfotomaculales;Desulfurisporaceae;";"98.3";"14.4";"118";"118";"116";"2";"0";"457065";"391091"
"V4mis2";"SILVA (only NR);Bacteria;Firmicutes;Desulfotomaculia;Desulfotomaculales;Desulfurisporaceae;Desulfofundulus;";"100.0";"14.4";"37";"37";"37";"0";"0";"457146";"391170"
"V4mis2";"SILVA (only NR);Bacteria;Firmicutes;Desulfotomaculia;Desulfotomaculales;Desulfurisporaceae;Desulfurispora;";"98.1";"14.4";"52";"52";"51";"1";"0";"457131";"391156"
"V4mis2";"SILVA (only NR);Bacteria;Firmicutes;Desulfotomaculia;Desulfotomaculales;Desulfurisporaceae;SCADC1-2-3;";"96.6";"14.4";"29";"29";"28";"1";"0";"457154";"391179"
"V4mis2";"SILVA (only NR);Bacteria;Firmicutes;Desulfotomaculia;Desulfotomaculales;Pelotomaculaceae;";"96.5";"14.4";"114";"114";"110";"4";"0";"457069";"391097"
"V4mis2";"SILVA (only NR);Bacteria;Firmicutes;Desulfotomaculia;Desulfotomaculales;Pelotomaculaceae;Cryptanaerobacter;";"97.1";"14.4";"34";"34";"33";"1";"0";"457149";"391174"
"V4mis2";"SILVA (only NR);Bacteria;Firmicutes;Desulfotomaculia;Desulfotomaculales;Pelotomaculaceae;Pelotomaculum;";"95.5";"14.4";"66";"66";"63";"3";"0";"457117";"391144"
"V4mis2";"SILVA (only NR);Bacteria;Firmicutes;Desulfotomaculia;Desulfotomaculales;Pelotomaculaceae;uncultured;";"100.0";"14.4";"14";"14";"14";"0";"0";"457169";"391193"
"V4mis2";"SILVA (only NR);Bacteria;Firmicutes;Dethiobacteria;";"96.4";"14.4";"137";"137";"132";"5";"0";"457046";"391075"
"V4mis2";"SILVA (only NR);Bacteria;Firmicutes;Dethiobacteria;Dethiobacterales;";"96.4";"14.4";"137";"137";"132";"5";"0";"457046";"391075"
"V4mis2";"SILVA (only NR);Bacteria;Firmicutes;Dethiobacteria;Dethiobacterales;Dethiobacteraceae;";"96.4";"14.4";"137";"137";"132";"5";"0";"457046";"391075"
"V4mis2";"SILVA (only NR);Bacteria;Firmicutes;Dethiobacteria;Dethiobacterales;Dethiobacteraceae;Candidatus Contubernalis;";"100.0";"14.4";"8";"8";"8";"0";"0";"457175";"391199"
"V4mis2";"SILVA (only NR);Bacteria;Firmicutes;Dethiobacteria;Dethiobacterales;Dethiobacteraceae;Dethiobacter;";"96.7";"14.4";"61";"61";"59";"2";"0";"457122";"391148"
"V4mis2";"SILVA (only NR);Bacteria;Firmicutes;Dethiobacteria;Dethiobacterales;Dethiobacteraceae;uncultured;";"95.5";"14.4";"67";"67";"64";"3";"0";"457116";"391143"
"V4mis2";"SILVA (only NR);Bacteria;Firmicutes;Incertae Sedis;";"98.0";"14.4";"250";"250";"245";"5";"0";"456933";"390962"
"V4mis2";"SILVA (only NR);Bacteria;Firmicutes;Incertae Sedis;DTU014;";"97.8";"14.4";"223";"223";"218";"5";"0";"456960";"390989"
"V4mis2";"SILVA (only NR);Bacteria;Firmicutes;Incertae Sedis;Gelria;";"100.0";"14.4";"14";"14";"14";"0";"0";"457169";"391193"
"V4mis2";"SILVA (only NR);Bacteria;Firmicutes;Incertae Sedis;Thermolithobacterales;";"100.0";"14.4";"13";"13";"13";"0";"0";"457170";"391194"
"V4mis2";"SILVA (only NR);Bacteria;Firmicutes;Incertae Sedis;Thermolithobacterales;Thermolithobacteraceae;";"100.0";"14.4";"13";"13";"13";"0";"0";"457170";"391194"
"V4mis2";"SILVA (only NR);Bacteria;Firmicutes;Incertae Sedis;Thermolithobacterales;Thermolithobacteraceae;Thermolithobacter;";"100.0";"14.4";"13";"13";"13";"0";"0";"457170";"391194"
"V4mis2";"SILVA (only NR);Bacteria;Firmicutes;Limnochordia;";"96.7";"14.4";"460";"460";"445";"15";"0";"456723";"390762"
"V4mis2";"SILVA (only NR);Bacteria;Firmicutes;Limnochordia;B55-F-B-G02;";"100.0";"14.4";"7";"7";"7";"0";"0";"457176";"391200"
"V4mis2";"SILVA (only NR);Bacteria;Firmicutes;Limnochordia;Hydrogenispora;";"95.9";"14.4";"146";"146";"140";"6";"0";"457037";"391067"
"V4mis2";"SILVA (only NR);Bacteria;Firmicutes;Limnochordia;Limnochordales;";"96.7";"14.4";"92";"92";"89";"3";"0";"457091";"391118"
"V4mis2";"SILVA (only NR);Bacteria;Firmicutes;Limnochordia;Limnochordales;Limnochordaceae;";"98.5";"14.4";"65";"65";"64";"1";"0";"457118";"391143"
"V4mis2";"SILVA (only NR);Bacteria;Firmicutes;Limnochordia;Limnochordales;Limnochordaceae;Limnochorda;";"100.0";"14.4";"6";"6";"6";"0";"0";"457177";"391201"
"V4mis2";"SILVA (only NR);Bacteria;Firmicutes;Limnochordia;Limnochordales;uncultured;";"92.6";"14.4";"27";"27";"25";"2";"0";"457156";"391182"
"V4mis2";"SILVA (only NR);Bacteria;Firmicutes;Limnochordia;M55-D21;";"100.0";"14.4";"23";"23";"23";"0";"0";"457160";"391184"
"V4mis2";"SILVA (only NR);Bacteria;Firmicutes;Limnochordia;MBA03;";"96.8";"14.4";"157";"157";"152";"5";"0";"457026";"391055"
"V4mis2";"SILVA (only NR);Bacteria;Firmicutes;Limnochordia;uncultured;";"94.4";"14.4";"18";"18";"17";"1";"0";"457165";"391190"
"V4mis2";"SILVA (only NR);Bacteria;Firmicutes;Moorellia;";"97.7";"14.4";"87";"87";"85";"2";"0";"457096";"391122"
"V4mis2";"SILVA (only NR);Bacteria;Firmicutes;Moorellia;Calderihabitantales;";"50.0";"14.4";"2";"2";"1";"1";"0";"457181";"391206"
"V4mis2";"SILVA (only NR);Bacteria;Firmicutes;Moorellia;Calderihabitantales;Calderihabitantaceae;";"50.0";"14.4";"2";"2";"1";"1";"0";"457181";"391206"
"V4mis2";"SILVA (only NR);Bacteria;Firmicutes;Moorellia;Calderihabitantales;Calderihabitantaceae;Calderihabitans;";"0.0";"0";"1";"1";"0";"1";"0";"457182";"391207"
"V4mis2";"SILVA (only NR);Bacteria;Firmicutes;Moorellia;Desulfitibacterales;";"97.6";"14.4";"41";"41";"40";"1";"0";"457142";"391167"
"V4mis2";"SILVA (only NR);Bacteria;Firmicutes;Moorellia;Desulfitibacterales;Desulfitibacteraceae;";"97.6";"14.4";"41";"41";"40";"1";"0";"457142";"391167"
"V4mis2";"SILVA (only NR);Bacteria;Firmicutes;Moorellia;Desulfitibacterales;Desulfitibacteraceae;Desulfitibacter;";"97.6";"14.4";"41";"41";"40";"1";"0";"457142";"391167"
"V4mis2";"SILVA (only NR);Bacteria;Firmicutes;Moorellia;Moorellales;";"100.0";"14.4";"38";"38";"38";"0";"0";"457145";"391169"
"V4mis2";"SILVA (only NR);Bacteria;Firmicutes;Moorellia;Moorellales;Moorellaceae;";"100.0";"14.4";"38";"38";"38";"0";"0";"457145";"391169"
"V4mis2";"SILVA (only NR);Bacteria;Firmicutes;Moorellia;Moorellales;Moorellaceae;Moorella;";"100.0";"14.4";"38";"38";"38";"0";"0";"457145";"391169"
"V4mis2";"SILVA (only NR);Bacteria;Firmicutes;Moorellia;NRB23;";"100.0";"14.4";"6";"6";"6";"0";"0";"457177";"391201"
"V4mis2";"SILVA (only NR);Bacteria;Firmicutes;Natranaerobiia;";"100.0";"14.4";"26";"26";"26";"0";"0";"457157";"391181"
"V4mis2";"SILVA (only NR);Bacteria;Firmicutes;Natranaerobiia;Natranaerobiales;";"100.0";"14.4";"26";"26";"26";"0";"0";"457157";"391181"
"V4mis2";"SILVA (only NR);Bacteria;Firmicutes;Natranaerobiia;Natranaerobiales;Natranaerobiaceae;";"100.0";"14.4";"26";"26";"26";"0";"0";"457157";"391181"
"V4mis2";"SILVA (only NR);Bacteria;Firmicutes;Natranaerobiia;Natranaerobiales;Natranaerobiaceae;Natranaerobius;";"100.0";"14.4";"14";"14";"14";"0";"0";"457169";"391193"
"V4mis2";"SILVA (only NR);Bacteria;Firmicutes;Natranaerobiia;Natranaerobiales;Natranaerobiaceae;Natronovirga;";"100.0";"14.4";"5";"5";"5";"0";"0";"457178";"391202"
"V4mis2";"SILVA (only NR);Bacteria;Firmicutes;Natranaerobiia;Natranaerobiales;Natranaerobiaceae;uncultured;";"100.0";"14.4";"6";"6";"6";"0";"0";"457177";"391201"
"V4mis2";"SILVA (only NR);Bacteria;Firmicutes;Negativicutes;";"95.1";"14.5";"3241";"3241";"3082";"159";"0";"453942";"388125"
"V4mis2";"SILVA (only NR);Bacteria;Firmicutes;Negativicutes;Acidaminococcales;";"94.0";"14.4";"464";"464";"436";"28";"0";"456719";"390771"
"V4mis2";"SILVA (only NR);Bacteria;Firmicutes;Negativicutes;Acidaminococcales;Acidaminococcaceae;";"94.0";"14.4";"464";"464";"436";"28";"0";"456719";"390771"
"V4mis2";"SILVA (only NR);Bacteria;Firmicutes;Negativicutes;Acidaminococcales;Acidaminococcaceae;Acidaminococcus;";"83.9";"14.4";"31";"31";"26";"5";"0";"457152";"391181"
"V4mis2";"SILVA (only NR);Bacteria;Firmicutes;Negativicutes;Acidaminococcales;Acidaminococcaceae;Phascolarctobacterium;";"96.1";"14.4";"205";"205";"197";"8";"0";"456978";"391010"
"V4mis2";"SILVA (only NR);Bacteria;Firmicutes;Negativicutes;Acidaminococcales;Acidaminococcaceae;Succiniclasticum;";"91.5";"14.4";"165";"165";"151";"14";"0";"457018";"391056"
"V4mis2";"SILVA (only NR);Bacteria;Firmicutes;Negativicutes;Acidaminococcales;Acidaminococcaceae;Succinispira;";"100.0";"14.4";"5";"5";"5";"0";"0";"457178";"391202"
"V4mis2";"SILVA (only NR);Bacteria;Firmicutes;Negativicutes;Acidaminococcales;Acidaminococcaceae;uncultured;";"98.3";"14.4";"58";"58";"57";"1";"0";"457125";"391150"
"V4mis2";"SILVA (only NR);Bacteria;Firmicutes;Negativicutes;Veillonellales-Selenomonadales;";"95.2";"14.5";"2757";"2757";"2626";"131";"0";"454426";"388581"
"V4mis2";"SILVA (only NR);Bacteria;Firmicutes;Negativicutes;Veillonellales-Selenomonadales;Selenomonadaceae;";"97.6";"14.5";"945";"945";"922";"23";"0";"456238";"390285"
"V4mis2";"SILVA (only NR);Bacteria;Firmicutes;Negativicutes;Veillonellales-Selenomonadales;Selenomonadaceae;Anaerovibrio;";"98.6";"14.4";"73";"73";"72";"1";"0";"457110";"391135"
"V4mis2";"SILVA (only NR);Bacteria;Firmicutes;Negativicutes;Veillonellales-Selenomonadales;Selenomonadaceae;Centipeda;";"92.3";"14.4";"13";"13";"12";"1";"0";"457170";"391195"
"V4mis2";"SILVA (only NR);Bacteria;Firmicutes;Negativicutes;Veillonellales-Selenomonadales;Selenomonadaceae;Megamonas;";"97.0";"14.4";"67";"67";"65";"2";"0";"457116";"391142"
"V4mis2";"SILVA (only NR);Bacteria;Firmicutes;Negativicutes;Veillonellales-Selenomonadales;Selenomonadaceae;Mitsuokella;";"100.0";"14.4";"39";"39";"39";"0";"0";"457144";"391168"
"V4mis2";"SILVA (only NR);Bacteria;Firmicutes;Negativicutes;Veillonellales-Selenomonadales;Selenomonadaceae;Pectinatus;";"100.0";"14.4";"14";"14";"14";"0";"0";"457169";"391193"
"V4mis2";"SILVA (only NR);Bacteria;Firmicutes;Negativicutes;Veillonellales-Selenomonadales;Selenomonadaceae;Propionispira;";"100.0";"14.4";"4";"4";"4";"0";"0";"457179";"391203"
"V4mis2";"SILVA (only NR);Bacteria;Firmicutes;Negativicutes;Veillonellales-Selenomonadales;Selenomonadaceae;Quinella;";"100.0";"14.4";"48";"48";"48";"0";"0";"457135";"391159"
"V4mis2";"SILVA (only NR);Bacteria;Firmicutes;Negativicutes;Veillonellales-Selenomonadales;Selenomonadaceae;Schwartzia;";"88.9";"14.4";"9";"9";"8";"1";"0";"457174";"391199"
"V4mis2";"SILVA (only NR);Bacteria;Firmicutes;Negativicutes;Veillonellales-Selenomonadales;Selenomonadaceae;Selenomonas;";"98.4";"14.4";"506";"506";"498";"8";"0";"456677";"390709"
"V4mis2";"SILVA (only NR);Bacteria;Firmicutes;Negativicutes;Veillonellales-Selenomonadales;Selenomonadaceae;Veillonellaceae UCG-001;";"92.7";"14.4";"41";"41";"38";"3";"0";"457142";"391169"
"V4mis2";"SILVA (only NR);Bacteria;Firmicutes;Negativicutes;Veillonellales-Selenomonadales;Selenomonadaceae;Zymophilus;";"100.0";"14.4";"4";"4";"4";"0";"0";"457179";"391203"
"V4mis2";"SILVA (only NR);Bacteria;Firmicutes;Negativicutes;Veillonellales-Selenomonadales;Selenomonadaceae;uncultured;";"94.4";"14.4";"125";"125";"118";"7";"0";"457058";"391089"
"V4mis2";"SILVA (only NR);Bacteria;Firmicutes;Negativicutes;Veillonellales-Selenomonadales;Sporomusaceae;";"96.0";"14.4";"402";"402";"386";"16";"0";"456781";"390821"
"V4mis2";"SILVA (only NR);Bacteria;Firmicutes;Negativicutes;Veillonellales-Selenomonadales;Sporomusaceae;Acetonema;";"100.0";"14.4";"5";"5";"5";"0";"0";"457178";"391202"
"V4mis2";"SILVA (only NR);Bacteria;Firmicutes;Negativicutes;Veillonellales-Selenomonadales;Sporomusaceae;Anaeromusa-Anaeroarcus;";"95.2";"14.4";"21";"21";"20";"1";"0";"457162";"391187"
"V4mis2";"SILVA (only NR);Bacteria;Firmicutes;Negativicutes;Veillonellales-Selenomonadales;Sporomusaceae;Anaerosinus;";"100.0";"14.4";"12";"12";"12";"0";"0";"457171";"391195"
"V4mis2";"SILVA (only NR);Bacteria;Firmicutes;Negativicutes;Veillonellales-Selenomonadales;Sporomusaceae;Anaerospora;";"88.2";"14.4";"34";"34";"30";"4";"0";"457149";"391177"
"V4mis2";"SILVA (only NR);Bacteria;Firmicutes;Negativicutes;Veillonellales-Selenomonadales;Sporomusaceae;Anaerosporomusa;";"100.0";"14.4";"17";"17";"17";"0";"0";"457166";"391190"
"V4mis2";"SILVA (only NR);Bacteria;Firmicutes;Negativicutes;Veillonellales-Selenomonadales;Sporomusaceae;Dendrosporobacter;";"100.0";"14.4";"7";"7";"7";"0";"0";"457176";"391200"
"V4mis2";"SILVA (only NR);Bacteria;Firmicutes;Negativicutes;Veillonellales-Selenomonadales;Sporomusaceae;Methylomusa;";"100.0";"14.4";"2";"2";"2";"0";"0";"457181";"391205"
"V4mis2";"SILVA (only NR);Bacteria;Firmicutes;Negativicutes;Veillonellales-Selenomonadales;Sporomusaceae;Pelosinus;";"94.6";"14.4";"92";"92";"87";"5";"0";"457091";"391120"
"V4mis2";"SILVA (only NR);Bacteria;Firmicutes;Negativicutes;Veillonellales-Selenomonadales;Sporomusaceae;Propionispora;";"100.0";"14.4";"7";"7";"7";"0";"0";"457176";"391200"
"V4mis2";"SILVA (only NR);Bacteria;Firmicutes;Negativicutes;Veillonellales-Selenomonadales;Sporomusaceae;Sporolituus;";"100.0";"14.4";"2";"2";"2";"0";"0";"457181";"391205"
"V4mis2";"SILVA (only NR);Bacteria;Firmicutes;Negativicutes;Veillonellales-Selenomonadales;Sporomusaceae;Sporomusa;";"99.0";"14.4";"97";"97";"96";"1";"0";"457086";"391111"
"V4mis2";"SILVA (only NR);Bacteria;Firmicutes;Negativicutes;Veillonellales-Selenomonadales;Sporomusaceae;Thermosinus;";"96.8";"14.4";"31";"31";"30";"1";"0";"457152";"391177"
"V4mis2";"SILVA (only NR);Bacteria;Firmicutes;Negativicutes;Veillonellales-Selenomonadales;Sporomusaceae;uncultured;";"94.4";"14.4";"72";"72";"68";"4";"0";"457111";"391139"
"V4mis2";"SILVA (only NR);Bacteria;Firmicutes;Negativicutes;Veillonellales-Selenomonadales;Veillonellaceae;";"93.3";"14.5";"1376";"1376";"1284";"92";"0";"455807";"389923"
"V4mis2";"SILVA (only NR);Bacteria;Firmicutes;Negativicutes;Veillonellales-Selenomonadales;Veillonellaceae;Allisonella;";"100.0";"14.4";"7";"7";"7";"0";"0";"457176";"391200"
"V4mis2";"SILVA (only NR);Bacteria;Firmicutes;Negativicutes;Veillonellales-Selenomonadales;Veillonellaceae;Anaeroglobus;";"100.0";"14.4";"5";"5";"5";"0";"0";"457178";"391202"
"V4mis2";"SILVA (only NR);Bacteria;Firmicutes;Negativicutes;Veillonellales-Selenomonadales;Veillonellaceae;Dialister;";"89.3";"14.4";"401";"401";"358";"43";"0";"456782";"390849"
"V4mis2";"SILVA (only NR);Bacteria;Firmicutes;Negativicutes;Veillonellales-Selenomonadales;Veillonellaceae;Megasphaera;";"95.6";"14.4";"135";"135";"129";"6";"0";"457048";"391078"
"V4mis2";"SILVA (only NR);Bacteria;Firmicutes;Negativicutes;Veillonellales-Selenomonadales;Veillonellaceae;Negativicoccus;";"90.9";"14.4";"11";"11";"10";"1";"0";"457172";"391197"
"V4mis2";"SILVA (only NR);Bacteria;Firmicutes;Negativicutes;Veillonellales-Selenomonadales;Veillonellaceae;Veillonella;";"94.8";"14.4";"805";"805";"763";"42";"0";"456378";"390444"
"V4mis2";"SILVA (only NR);Bacteria;Firmicutes;Negativicutes;Veillonellales-Selenomonadales;Veillonellaceae;uncultured;";"100.0";"14.4";"8";"8";"8";"0";"0";"457175";"391199"
"V4mis2";"SILVA (only NR);Bacteria;Firmicutes;Negativicutes;Veillonellales-Selenomonadales;uncultured;";"100.0";"14.4";"33";"33";"33";"0";"0";"457150";"391174"
"V4mis2";"SILVA (only NR);Bacteria;Firmicutes;Negativicutes;uncultured;";"100.0";"14.4";"20";"20";"20";"0";"0";"457163";"391187"
"V4mis2";"SILVA (only NR);Bacteria;Firmicutes;Sulfobacillia;";"95.2";"14.4";"105";"105";"100";"5";"0";"457078";"391107"
"V4mis2";"SILVA (only NR);Bacteria;Firmicutes;Sulfobacillia;Sulfobacillales;";"95.2";"14.4";"105";"105";"100";"5";"0";"457078";"391107"
"V4mis2";"SILVA (only NR);Bacteria;Firmicutes;Sulfobacillia;Sulfobacillales;Sulfobacillaceae;";"95.2";"14.4";"105";"105";"100";"5";"0";"457078";"391107"
"V4mis2";"SILVA (only NR);Bacteria;Firmicutes;Sulfobacillia;Sulfobacillales;Sulfobacillaceae;Sulfobacillus;";"94.4";"14.4";"72";"72";"68";"4";"0";"457111";"391139"
"V4mis2";"SILVA (only NR);Bacteria;Firmicutes;Sulfobacillia;Sulfobacillales;Sulfobacillaceae;uncultured;";"97.0";"14.4";"33";"33";"32";"1";"0";"457150";"391175"
"V4mis2";"SILVA (only NR);Bacteria;Firmicutes;Symbiobacteriia;";"98.2";"14.4";"452";"452";"444";"8";"0";"456731";"390763"
"V4mis2";"SILVA (only NR);Bacteria;Firmicutes;Symbiobacteriia;Symbiobacteriales;";"98.2";"14.4";"452";"452";"444";"8";"0";"456731";"390763"
"V4mis2";"SILVA (only NR);Bacteria;Firmicutes;Symbiobacteriia;Symbiobacteriales;Caldinitratiruptor;";"100.0";"14.4";"3";"3";"3";"0";"0";"457180";"391204"
"V4mis2";"SILVA (only NR);Bacteria;Firmicutes;Symbiobacteriia;Symbiobacteriales;Symbiobacteraceae;";"98.1";"14.4";"428";"428";"420";"8";"0";"456755";"390787"
"V4mis2";"SILVA (only NR);Bacteria;Firmicutes;Symbiobacteriia;Symbiobacteriales;Symbiobacteraceae;Symbiobacterium;";"100.0";"14.4";"19";"19";"19";"0";"0";"457164";"391188"
"V4mis2";"SILVA (only NR);Bacteria;Firmicutes;Symbiobacteriia;Symbiobacteriales;Symbiobacteraceae;uncultured;";"98.0";"14.4";"409";"409";"401";"8";"0";"456774";"390806"
"V4mis2";"SILVA (only NR);Bacteria;Firmicutes;Symbiobacteriia;Symbiobacteriales;uncultured;";"100.0";"14.4";"20";"20";"20";"0";"0";"457163";"391187"
"V4mis2";"SILVA (only NR);Bacteria;Firmicutes;Syntrophomonadia;";"96.1";"14.4";"309";"309";"297";"12";"0";"456874";"390910"
"V4mis2";"SILVA (only NR);Bacteria;Firmicutes;Syntrophomonadia;Syntrophomonadales;";"96.1";"14.4";"309";"309";"297";"12";"0";"456874";"390910"
"V4mis2";"SILVA (only NR);Bacteria;Firmicutes;Syntrophomonadia;Syntrophomonadales;Syntrophomonadaceae;";"96.1";"14.4";"309";"309";"297";"12";"0";"456874";"390910"
"V4mis2";"SILVA (only NR);Bacteria;Firmicutes;Syntrophomonadia;Syntrophomonadales;Syntrophomonadaceae;Pelospora;";"100.0";"14.4";"22";"22";"22";"0";"0";"457161";"391185"
"V4mis2";"SILVA (only NR);Bacteria;Firmicutes;Syntrophomonadia;Syntrophomonadales;Syntrophomonadaceae;Syntrophomonas;";"95.5";"14.4";"177";"177";"169";"8";"0";"457006";"391038"
"V4mis2";"SILVA (only NR);Bacteria;Firmicutes;Syntrophomonadia;Syntrophomonadales;Syntrophomonadaceae;Syntrophothermus;";"100.0";"14.4";"6";"6";"6";"0";"0";"457177";"391201"
"V4mis2";"SILVA (only NR);Bacteria;Firmicutes;Syntrophomonadia;Syntrophomonadales;Syntrophomonadaceae;Thermosyntropha;";"100.0";"14.4";"9";"9";"9";"0";"0";"457174";"391198"
"V4mis2";"SILVA (only NR);Bacteria;Firmicutes;Syntrophomonadia;Syntrophomonadales;Syntrophomonadaceae;uncultured;";"96.7";"14.4";"91";"91";"88";"3";"0";"457092";"391119"
"V4mis2";"SILVA (only NR);Bacteria;Firmicutes;TSAC18;";"89.2";"14.4";"37";"37";"33";"4";"0";"457146";"391174"
"V4mis2";"SILVA (only NR);Bacteria;Firmicutes;TTA-B61;";"100.0";"14.4";"9";"9";"9";"0";"0";"457174";"391198"
"V4mis2";"SILVA (only NR);Bacteria;Firmicutes;Thermacetogenia;";"96.6";"14.4";"59";"59";"57";"2";"0";"457124";"391150"
"V4mis2";"SILVA (only NR);Bacteria;Firmicutes;Thermacetogenia;Thermacetogeniales;";"96.6";"14.4";"59";"59";"57";"2";"0";"457124";"391150"
"V4mis2";"SILVA (only NR);Bacteria;Firmicutes;Thermacetogenia;Thermacetogeniales;Thermacetogeniaceae;";"96.6";"14.4";"59";"59";"57";"2";"0";"457124";"391150"
"V4mis2";"SILVA (only NR);Bacteria;Firmicutes;Thermacetogenia;Thermacetogeniales;Thermacetogeniaceae;Syntrophaceticus;";"100.0";"14.4";"20";"20";"20";"0";"0";"457163";"391187"
"V4mis2";"SILVA (only NR);Bacteria;Firmicutes;Thermacetogenia;Thermacetogeniales;Thermacetogeniaceae;Thermacetogenium;";"100.0";"14.4";"13";"13";"13";"0";"0";"457170";"391194"
"V4mis2";"SILVA (only NR);Bacteria;Firmicutes;Thermacetogenia;Thermacetogeniales;Thermacetogeniaceae;uncultured;";"92.0";"14.4";"25";"25";"23";"2";"0";"457158";"391184"
"V4mis2";"SILVA (only NR);Bacteria;Firmicutes;Thermaerobacteria;";"100.0";"14.4";"10";"10";"10";"0";"0";"457173";"391197"
"V4mis2";"SILVA (only NR);Bacteria;Firmicutes;Thermaerobacteria;Thermaerobacterales;";"100.0";"14.4";"10";"10";"10";"0";"0";"457173";"391197"
"V4mis2";"SILVA (only NR);Bacteria;Firmicutes;Thermaerobacteria;Thermaerobacterales;Thermaerobacteraceae;";"100.0";"14.4";"10";"10";"10";"0";"0";"457173";"391197"
"V4mis2";"SILVA (only NR);Bacteria;Firmicutes;Thermaerobacteria;Thermaerobacterales;Thermaerobacteraceae;Thermaerobacter;";"100.0";"14.4";"10";"10";"10";"0";"0";"457173";"391197"
"V4mis2";"SILVA (only NR);Bacteria;Firmicutes;Thermincolia;";"87.5";"14.4";"8";"8";"7";"1";"0";"457175";"391200"
"V4mis2";"SILVA (only NR);Bacteria;Firmicutes;Thermincolia;Carboxydocellales;";"87.5";"14.4";"8";"8";"7";"1";"0";"457175";"391200"
"V4mis2";"SILVA (only NR);Bacteria;Firmicutes;Thermincolia;Carboxydocellales;Carboxydocellaceae;";"87.5";"14.4";"8";"8";"7";"1";"0";"457175";"391200"
"V4mis2";"SILVA (only NR);Bacteria;Firmicutes;Thermincolia;Carboxydocellales;Carboxydocellaceae;Carboxydocella;";"87.5";"14.4";"8";"8";"7";"1";"0";"457175";"391200"
"V4mis2";"SILVA (only NR);Bacteria;Firmicutes;Thermoanaerobacteria;";"93.5";"14.4";"431";"431";"403";"28";"0";"456752";"390804"
"V4mis2";"SILVA (only NR);Bacteria;Firmicutes;Thermoanaerobacteria;Caldicellulosiruptorales;";"89.7";"14.4";"174";"174";"156";"18";"0";"457009";"391051"
"V4mis2";"SILVA (only NR);Bacteria;Firmicutes;Thermoanaerobacteria;Caldicellulosiruptorales;Caldicellulosiraptoraceae;";"88.9";"14.4";"153";"153";"136";"17";"0";"457030";"391071"
"V4mis2";"SILVA (only NR);Bacteria;Firmicutes;Thermoanaerobacteria;Caldicellulosiruptorales;Caldicellulosiraptoraceae;Caldicellulosiruptor;";"88.9";"14.4";"153";"153";"136";"17";"0";"457030";"391071"
"V4mis2";"SILVA (only NR);Bacteria;Firmicutes;Thermoanaerobacteria;Caldicellulosiruptorales;uncultured;";"95.2";"14.4";"21";"21";"20";"1";"0";"457162";"391187"
"V4mis2";"SILVA (only NR);Bacteria;Firmicutes;Thermoanaerobacteria;Thermoanaerobacterales;";"96.1";"14.4";"257";"257";"247";"10";"0";"456926";"390960"
"V4mis2";"SILVA (only NR);Bacteria;Firmicutes;Thermoanaerobacteria;Thermoanaerobacterales;Family III;";"95.7";"14.4";"47";"47";"45";"2";"0";"457136";"391162"
"V4mis2";"SILVA (only NR);Bacteria;Firmicutes;Thermoanaerobacteria;Thermoanaerobacterales;Family III;Thermoanaerobacterium;";"95.7";"14.4";"47";"47";"45";"2";"0";"457136";"391162"
"V4mis2";"SILVA (only NR);Bacteria;Firmicutes;Thermoanaerobacteria;Thermoanaerobacterales;Family IV;";"100.0";"14.4";"6";"6";"6";"0";"0";"457177";"391201"
"V4mis2";"SILVA (only NR);Bacteria;Firmicutes;Thermoanaerobacteria;Thermoanaerobacterales;Family IV;Mahella;";"100.0";"14.4";"6";"6";"6";"0";"0";"457177";"391201"
"V4mis2";"SILVA (only NR);Bacteria;Firmicutes;Thermoanaerobacteria;Thermoanaerobacterales;SRB2;";"96.9";"14.4";"32";"32";"31";"1";"0";"457151";"391176"
"V4mis2";"SILVA (only NR);Bacteria;Firmicutes;Thermoanaerobacteria;Thermoanaerobacterales;Thermoanaerobacteraceae;";"95.9";"14.4";"172";"172";"165";"7";"0";"457011";"391042"
"V4mis2";"SILVA (only NR);Bacteria;Firmicutes;Thermoanaerobacteria;Thermoanaerobacterales;Thermoanaerobacteraceae;Brockia;";"100.0";"14.4";"3";"3";"3";"0";"0";"457180";"391204"
"V4mis2";"SILVA (only NR);Bacteria;Firmicutes;Thermoanaerobacteria;Thermoanaerobacterales;Thermoanaerobacteraceae;Caldanaerobacter;";"98.1";"14.4";"53";"53";"52";"1";"0";"457130";"391155"
"V4mis2";"SILVA (only NR);Bacteria;Firmicutes;Thermoanaerobacteria;Thermoanaerobacterales;Thermoanaerobacteraceae;Caldanaerobius;";"87.5";"14.4";"8";"8";"7";"1";"0";"457175";"391200"
"V4mis2";"SILVA (only NR);Bacteria;Firmicutes;Thermoanaerobacteria;Thermoanaerobacterales;Thermoanaerobacteraceae;Caloribacterium;";"100.0";"14.4";"5";"5";"5";"0";"0";"457178";"391202"
"V4mis2";"SILVA (only NR);Bacteria;Firmicutes;Thermoanaerobacteria;Thermoanaerobacterales;Thermoanaerobacteraceae;Desulfovirgula;";"100.0";"14.4";"1";"1";"1";"0";"0";"457182";"391206"
"V4mis2";"SILVA (only NR);Bacteria;Firmicutes;Thermoanaerobacteria;Thermoanaerobacterales;Thermoanaerobacteraceae;Thermanaeromonas;";"92.3";"14.4";"13";"13";"12";"1";"0";"457170";"391195"
"V4mis2";"SILVA (only NR);Bacteria;Firmicutes;Thermoanaerobacteria;Thermoanaerobacterales;Thermoanaerobacteraceae;Thermoanaerobacter;";"95.5";"14.4";"89";"89";"85";"4";"0";"457094";"391122"
"V4mis2";"SILVA (only NR);Bacteria;Firmicutes;Thermovenabulia;";"95.2";"14.4";"63";"63";"60";"3";"0";"457120";"391147"
"V4mis2";"SILVA (only NR);Bacteria;Firmicutes;Thermovenabulia;Thermovenabulales;";"95.2";"14.4";"63";"63";"60";"3";"0";"457120";"391147"
"V4mis2";"SILVA (only NR);Bacteria;Firmicutes;Thermovenabulia;Thermovenabulales;Caldanaerovirga;";"100.0";"14.4";"1";"1";"1";"0";"0";"457182";"391206"
"V4mis2";"SILVA (only NR);Bacteria;Firmicutes;Thermovenabulia;Thermovenabulales;Fervidicola;";"100.0";"14.4";"1";"1";"1";"0";"0";"457182";"391206"
"V4mis2";"SILVA (only NR);Bacteria;Firmicutes;Thermovenabulia;Thermovenabulales;Tepidanaerobacter;";"95.0";"14.4";"40";"40";"38";"2";"0";"457143";"391169"
"V4mis2";"SILVA (only NR);Bacteria;Firmicutes;Thermovenabulia;Thermovenabulales;Thermosediminibacter;";"100.0";"14.4";"4";"4";"4";"0";"0";"457179";"391203"
"V4mis2";"SILVA (only NR);Bacteria;Firmicutes;Thermovenabulia;Thermovenabulales;Thermovenabulum;";"83.3";"14.4";"6";"6";"5";"1";"0";"457177";"391202"
"V4mis2";"SILVA (only NR);Bacteria;Firmicutes;Thermovenabulia;Thermovenabulales;Thermovorax;";"100.0";"14.4";"1";"1";"1";"0";"0";"457182";"391206"
"V4mis2";"SILVA (only NR);Bacteria;Firmicutes;Thermovenabulia;Thermovenabulales;uncultured;";"100.0";"14.4";"8";"8";"8";"0";"0";"457175";"391199"
"V4mis2";"SILVA (only NR);Bacteria;Firmicutes;YNPFFP2;";"100.0";"14.4";"3";"3";"3";"0";"0";"457180";"391204"
"V4mis2";"SILVA (only NR);Bacteria;Firmicutes;uncultured;";"98.7";"14.4";"77";"77";"76";"1";"0";"457106";"391131"
"V4mis2";"SILVA (only NR);Bacteria;Fusobacteriota;";"93.2";"14.5";"1628";"1628";"1518";"110";"0";"455555";"389689"
"V4mis2";"SILVA (only NR);Bacteria;Fusobacteriota;Fusobacteriia;";"93.2";"14.5";"1628";"1628";"1518";"110";"0";"455555";"389689"
"V4mis2";"SILVA (only NR);Bacteria;Fusobacteriota;Fusobacteriia;Fusobacteriales;";"93.2";"14.5";"1628";"1628";"1518";"110";"0";"455555";"389689"
"V4mis2";"SILVA (only NR);Bacteria;Fusobacteriota;Fusobacteriia;Fusobacteriales;Fusobacteriaceae;";"92.2";"14.4";"1166";"1166";"1075";"91";"0";"456017";"390132"
"V4mis2";"SILVA (only NR);Bacteria;Fusobacteriota;Fusobacteriia;Fusobacteriales;Fusobacteriaceae;Cetobacterium;";"93.4";"14.4";"136";"136";"127";"9";"0";"457047";"391080"
"V4mis2";"SILVA (only NR);Bacteria;Fusobacteriota;Fusobacteriia;Fusobacteriales;Fusobacteriaceae;Fusobacterium;";"92.0";"14.4";"988";"988";"909";"79";"0";"456195";"390298"
"V4mis2";"SILVA (only NR);Bacteria;Fusobacteriota;Fusobacteriia;Fusobacteriales;Fusobacteriaceae;Ilyobacter;";"100.0";"14.4";"6";"6";"6";"0";"0";"457177";"391201"
"V4mis2";"SILVA (only NR);Bacteria;Fusobacteriota;Fusobacteriia;Fusobacteriales;Fusobacteriaceae;Propionigenium;";"86.7";"14.4";"15";"15";"13";"2";"0";"457168";"391194"
"V4mis2";"SILVA (only NR);Bacteria;Fusobacteriota;Fusobacteriia;Fusobacteriales;Fusobacteriaceae;Psychrilyobacter;";"95.0";"14.4";"20";"20";"19";"1";"0";"457163";"391188"
"V4mis2";"SILVA (only NR);Bacteria;Fusobacteriota;Fusobacteriia;Fusobacteriales;Leptotrichiaceae;";"95.9";"14.4";"462";"462";"443";"19";"0";"456721";"390764"
"V4mis2";"SILVA (only NR);Bacteria;Fusobacteriota;Fusobacteriia;Fusobacteriales;Leptotrichiaceae;Caviibacter;";"100.0";"14.4";"3";"3";"3";"0";"0";"457180";"391204"
"V4mis2";"SILVA (only NR);Bacteria;Fusobacteriota;Fusobacteriia;Fusobacteriales;Leptotrichiaceae;Hypnocyclicus;";"94.4";"14.4";"18";"18";"17";"1";"0";"457165";"391190"
"V4mis2";"SILVA (only NR);Bacteria;Fusobacteriota;Fusobacteriia;Fusobacteriales;Leptotrichiaceae;Leptotrichia;";"95.8";"14.4";"334";"334";"320";"14";"0";"456849";"390887"
"V4mis2";"SILVA (only NR);Bacteria;Fusobacteriota;Fusobacteriia;Fusobacteriales;Leptotrichiaceae;Oceanivirga;";"100.0";"14.4";"40";"40";"40";"0";"0";"457143";"391167"
"V4mis2";"SILVA (only NR);Bacteria;Fusobacteriota;Fusobacteriia;Fusobacteriales;Leptotrichiaceae;Sebaldella;";"100.0";"14.4";"4";"4";"4";"0";"0";"457179";"391203"
"V4mis2";"SILVA (only NR);Bacteria;Fusobacteriota;Fusobacteriia;Fusobacteriales;Leptotrichiaceae;Sneathia;";"88.9";"14.4";"9";"9";"8";"1";"0";"457174";"391199"
"V4mis2";"SILVA (only NR);Bacteria;Fusobacteriota;Fusobacteriia;Fusobacteriales;Leptotrichiaceae;Streptobacillus;";"90.9";"14.4";"22";"22";"20";"2";"0";"457161";"391187"
"V4mis2";"SILVA (only NR);Bacteria;Fusobacteriota;Fusobacteriia;Fusobacteriales;Leptotrichiaceae;uncultured;";"96.9";"14.4";"32";"32";"31";"1";"0";"457151";"391176"
"V4mis2";"SILVA (only NR);Bacteria;GAL15;";"93.5";"14.4";"46";"46";"43";"3";"0";"457137";"391164"
"V4mis2";"SILVA (only NR);Bacteria;GN01;";"88.2";"14.4";"136";"136";"120";"16";"0";"457047";"391087"
"V4mis2";"SILVA (only NR);Bacteria;Gemmatimonadota;";"94.3";"14.5";"2119";"2119";"1999";"120";"0";"455064";"389208"
"V4mis2";"SILVA (only NR);Bacteria;Gemmatimonadota;AKAU4049;";"100.0";"14.4";"9";"9";"9";"0";"0";"457174";"391198"
"V4mis2";"SILVA (only NR);Bacteria;Gemmatimonadota;BD2-11 terrestrial group;";"95.1";"14.4";"386";"386";"367";"19";"0";"456797";"390840"
"V4mis2";"SILVA (only NR);Bacteria;Gemmatimonadota;Gemmatimonadetes;";"95.4";"14.5";"1196";"1196";"1141";"55";"0";"455987";"390066"
"V4mis2";"SILVA (only NR);Bacteria;Gemmatimonadota;Gemmatimonadetes;Gemmatimonadales;";"95.4";"14.5";"1196";"1196";"1141";"55";"0";"455987";"390066"
"V4mis2";"SILVA (only NR);Bacteria;Gemmatimonadota;Gemmatimonadetes;Gemmatimonadales;Gemmatimonadaceae;";"95.4";"14.5";"1196";"1196";"1141";"55";"0";"455987";"390066"
"V4mis2";"SILVA (only NR);Bacteria;Gemmatimonadota;Gemmatimonadetes;Gemmatimonadales;Gemmatimonadaceae;Gemmatimonas;";"96.5";"14.4";"259";"259";"250";"9";"0";"456924";"390957"
"V4mis2";"SILVA (only NR);Bacteria;Gemmatimonadota;Gemmatimonadetes;Gemmatimonadales;Gemmatimonadaceae;Gemmatirosa;";"85.7";"14.4";"7";"7";"6";"1";"0";"457176";"391201"
"V4mis2";"SILVA (only NR);Bacteria;Gemmatimonadota;Gemmatimonadetes;Gemmatimonadales;Gemmatimonadaceae;Roseisolibacter;";"100.0";"14.4";"8";"8";"8";"0";"0";"457175";"391199"
"V4mis2";"SILVA (only NR);Bacteria;Gemmatimonadota;Gemmatimonadetes;Gemmatimonadales;Gemmatimonadaceae;uncultured;";"95.2";"14.5";"916";"916";"872";"44";"0";"456267";"390335"
"V4mis2";"SILVA (only NR);Bacteria;Gemmatimonadota;Longimicrobia;";"84.5";"14.4";"219";"219";"185";"34";"0";"456964";"391022"
"V4mis2";"SILVA (only NR);Bacteria;Gemmatimonadota;Longimicrobia;Longimicrobiales;";"84.5";"14.4";"219";"219";"185";"34";"0";"456964";"391022"
"V4mis2";"SILVA (only NR);Bacteria;Gemmatimonadota;Longimicrobia;Longimicrobiales;Longimicrobiaceae;";"84.5";"14.4";"219";"219";"185";"34";"0";"456964";"391022"
"V4mis2";"SILVA (only NR);Bacteria;Gemmatimonadota;Longimicrobia;Longimicrobiales;Longimicrobiaceae;Longimicrobium;";"93.3";"14.4";"15";"15";"14";"1";"0";"457168";"391193"
"V4mis2";"SILVA (only NR);Bacteria;Gemmatimonadota;Longimicrobia;Longimicrobiales;Longimicrobiaceae;YC-ZSS-LKJ147;";"89.5";"14.4";"38";"38";"34";"4";"0";"457145";"391173"
"V4mis2";"SILVA (only NR);Bacteria;Gemmatimonadota;MD2902-B12;";"78.9";"14.4";"19";"19";"15";"4";"0";"457164";"391192"
"V4mis2";"SILVA (only NR);Bacteria;Gemmatimonadota;PAUC43f marine benthic group;";"99.0";"14.4";"98";"98";"97";"1";"0";"457085";"391110"
"V4mis2";"SILVA (only NR);Bacteria;Gemmatimonadota;S0134 terrestrial group;";"96.4";"14.4";"192";"192";"185";"7";"0";"456991";"391022"
"V4mis2";"SILVA (only NR);Bacteria;Halanaerobiaeota;";"94.7";"14.4";"244";"244";"231";"13";"0";"456939";"390976"
"V4mis2";"SILVA (only NR);Bacteria;Halanaerobiaeota;Halanaerobiia;";"94.7";"14.4";"244";"244";"231";"13";"0";"456939";"390976"
"V4mis2";"SILVA (only NR);Bacteria;Halanaerobiaeota;Halanaerobiia;Halanaerobiales;";"94.7";"14.4";"244";"244";"231";"13";"0";"456939";"390976"
"V4mis2";"SILVA (only NR);Bacteria;Halanaerobiaeota;Halanaerobiia;Halanaerobiales;Halanaerobiaceae;";"95.3";"14.4";"169";"169";"161";"8";"0";"457014";"391046"
"V4mis2";"SILVA (only NR);Bacteria;Halanaerobiaeota;Halanaerobiia;Halanaerobiales;Halanaerobiaceae;Halanaerobium;";"94.7";"14.4";"131";"131";"124";"7";"0";"457052";"391083"
"V4mis2";"SILVA (only NR);Bacteria;Halanaerobiaeota;Halanaerobiia;Halanaerobiales;Halanaerobiaceae;Halarsenatibacter;";"91.7";"14.4";"12";"12";"11";"1";"0";"457171";"391196"
"V4mis2";"SILVA (only NR);Bacteria;Halanaerobiaeota;Halanaerobiia;Halanaerobiales;Halanaerobiaceae;Halocella;";"100.0";"14.4";"23";"23";"23";"0";"0";"457160";"391184"
"V4mis2";"SILVA (only NR);Bacteria;Halanaerobiaeota;Halanaerobiia;Halanaerobiales;Halanaerobiaceae;Halothermothrix;";"100.0";"14.4";"3";"3";"3";"0";"0";"457180";"391204"
"V4mis2";"SILVA (only NR);Bacteria;Halanaerobiaeota;Halanaerobiia;Halanaerobiales;Halobacteroidaceae;";"93.3";"14.4";"75";"75";"70";"5";"0";"457108";"391137"
"V4mis2";"SILVA (only NR);Bacteria;Halanaerobiaeota;Halanaerobiia;Halanaerobiales;Halobacteroidaceae;Acetohalobium;";"100.0";"14.4";"3";"3";"3";"0";"0";"457180";"391204"
"V4mis2";"SILVA (only NR);Bacteria;Halanaerobiaeota;Halanaerobiia;Halanaerobiales;Halobacteroidaceae;Fuchsiella;";"100.0";"14.4";"3";"3";"3";"0";"0";"457180";"391204"
"V4mis2";"SILVA (only NR);Bacteria;Halanaerobiaeota;Halanaerobiia;Halanaerobiales;Halobacteroidaceae;Halanaerobacter;";"100.0";"14.4";"10";"10";"10";"0";"0";"457173";"391197"
"V4mis2";"SILVA (only NR);Bacteria;Halanaerobiaeota;Halanaerobiia;Halanaerobiales;Halobacteroidaceae;Halanaerobaculum;";"100.0";"14.4";"2";"2";"2";"0";"0";"457181";"391205"
"V4mis2";"SILVA (only NR);Bacteria;Halanaerobiaeota;Halanaerobiia;Halanaerobiales;Halobacteroidaceae;Halobacteroides;";"100.0";"14.4";"5";"5";"5";"0";"0";"457178";"391202"
"V4mis2";"SILVA (only NR);Bacteria;Halanaerobiaeota;Halanaerobiia;Halanaerobiales;Halobacteroidaceae;Halonatronum;";"66.7";"14.4";"3";"3";"2";"1";"0";"457180";"391205"
"V4mis2";"SILVA (only NR);Bacteria;Halanaerobiaeota;Halanaerobiia;Halanaerobiales;Halobacteroidaceae;Natroniella;";"100.0";"14.4";"4";"4";"4";"0";"0";"457179";"391203"
"V4mis2";"SILVA (only NR);Bacteria;Halanaerobiaeota;Halanaerobiia;Halanaerobiales;Halobacteroidaceae;Orenia;";"89.5";"14.4";"19";"19";"17";"2";"0";"457164";"391190"
"V4mis2";"SILVA (only NR);Bacteria;Halanaerobiaeota;Halanaerobiia;Halanaerobiales;Halobacteroidaceae;Selenihalanaerobacter;";"100.0";"14.4";"1";"1";"1";"0";"0";"457182";"391206"
"V4mis2";"SILVA (only NR);Bacteria;Halanaerobiaeota;Halanaerobiia;Halanaerobiales;Halobacteroidaceae;Sporohalobacter;";"100.0";"14.4";"4";"4";"4";"0";"0";"457179";"391203"
"V4mis2";"SILVA (only NR);Bacteria;Halanaerobiaeota;Halanaerobiia;Halanaerobiales;Halobacteroidaceae;uncultured;";"89.5";"14.4";"19";"19";"17";"2";"0";"457164";"391190"
"V4mis2";"SILVA (only NR);Bacteria;Hydrogenedentes;";"94.7";"14.4";"263";"263";"249";"14";"0";"456920";"390958"
"V4mis2";"SILVA (only NR);Bacteria;Hydrogenedentes;Hydrogenedentia;";"94.7";"14.4";"263";"263";"249";"14";"0";"456920";"390958"
"V4mis2";"SILVA (only NR);Bacteria;Hydrogenedentes;Hydrogenedentia;Hydrogenedentiales;";"94.7";"14.4";"263";"263";"249";"14";"0";"456920";"390958"
"V4mis2";"SILVA (only NR);Bacteria;Hydrogenedentes;Hydrogenedentia;Hydrogenedentiales;Hydrogenedensaceae;";"94.7";"14.4";"263";"263";"249";"14";"0";"456920";"390958"
"V4mis2";"SILVA (only NR);Bacteria;Hydrogenedentes;Hydrogenedentia;Hydrogenedentiales;Hydrogenedensaceae;Candidatus Hydrogenedens;";"100.0";"14.4";"3";"3";"3";"0";"0";"457180";"391204"
"V4mis2";"SILVA (only NR);Bacteria;Hydrogenedentes;Hydrogenedentia;Hydrogenedentiales;Hydrogenedensaceae;YC-ZSS-LKJ63;";"91.7";"14.4";"24";"24";"22";"2";"0";"457159";"391185"
"V4mis2";"SILVA (only NR);Bacteria;Hydrothermae;";"97.4";"14.4";"39";"39";"38";"1";"0";"457144";"391169"
"V4mis2";"SILVA (only NR);Bacteria;LCP-89;";"97.9";"14.4";"48";"48";"47";"1";"0";"457135";"391160"
"V4mis2";"SILVA (only NR);Bacteria;Latescibacterota;";"96.0";"14.4";"505";"505";"485";"20";"0";"456678";"390722"
"V4mis2";"SILVA (only NR);Bacteria;Latescibacterota;Latescibacteria;";"97.8";"14.4";"184";"184";"180";"4";"0";"456999";"391027"
"V4mis2";"SILVA (only NR);Bacteria;Latescibacterota;Latescibacteria;Latescibacterales;";"97.8";"14.4";"184";"184";"180";"4";"0";"456999";"391027"
"V4mis2";"SILVA (only NR);Bacteria;Latescibacterota;Latescibacteria;Latescibacterales;Latescibacteraceae;";"97.8";"14.4";"184";"184";"180";"4";"0";"456999";"391027"
"V4mis2";"SILVA (only NR);Bacteria;Latescibacterota;Latescibacteria;Latescibacterales;Latescibacteraceae;Candidatus Latescibacter;";"98.2";"14.4";"55";"55";"54";"1";"0";"457128";"391153"
"V4mis2";"SILVA (only NR);Bacteria;MAT-CR-M4-B07;";"100.0";"14.4";"28";"28";"28";"0";"0";"457155";"391179"
"V4mis2";"SILVA (only NR);Bacteria;MBNT15;";"97.5";"14.4";"160";"160";"156";"4";"0";"457023";"391051"
"V4mis2";"SILVA (only NR);Bacteria;Margulisbacteria;";"98.9";"14.4";"87";"87";"86";"1";"0";"457096";"391121"
"V4mis2";"SILVA (only NR);Bacteria;Marinimicrobia (SAR406 clade);";"96.7";"14.4";"664";"664";"642";"22";"0";"456519";"390565"
"V4mis2";"SILVA (only NR);Bacteria;Methylomirabilota;";"94.1";"14.4";"370";"370";"348";"22";"0";"456813";"390859"
"V4mis2";"SILVA (only NR);Bacteria;Methylomirabilota;Methylomirabilia;";"94.1";"14.4";"370";"370";"348";"22";"0";"456813";"390859"
"V4mis2";"SILVA (only NR);Bacteria;Methylomirabilota;Methylomirabilia;Methylomirabilales;";"98.1";"14.4";"108";"108";"106";"2";"0";"457075";"391101"
"V4mis2";"SILVA (only NR);Bacteria;Methylomirabilota;Methylomirabilia;Methylomirabilales;Methylomirabilaceae;";"98.1";"14.4";"108";"108";"106";"2";"0";"457075";"391101"
"V4mis2";"SILVA (only NR);Bacteria;Methylomirabilota;Methylomirabilia;Methylomirabilales;Methylomirabilaceae;Candidatus Methylomirabilis;";"100.0";"14.4";"25";"25";"25";"0";"0";"457158";"391182"
"V4mis2";"SILVA (only NR);Bacteria;Methylomirabilota;Methylomirabilia;Methylomirabilales;Methylomirabilaceae;MIZ14;";"100.0";"14.4";"2";"2";"2";"0";"0";"457181";"391205"
"V4mis2";"SILVA (only NR);Bacteria;Methylomirabilota;Methylomirabilia;Methylomirabilales;Methylomirabilaceae;MIZ17;";"100.0";"14.4";"7";"7";"7";"0";"0";"457176";"391200"
"V4mis2";"SILVA (only NR);Bacteria;Methylomirabilota;Methylomirabilia;Methylomirabilales;Methylomirabilaceae;Sh765B-TzT-35;";"100.0";"14.4";"32";"32";"32";"0";"0";"457151";"391175"
"V4mis2";"SILVA (only NR);Bacteria;Methylomirabilota;Methylomirabilia;Methylomirabilales;Methylomirabilaceae;Z114MB74;";"100.0";"14.4";"5";"5";"5";"0";"0";"457178";"391202"
"V4mis2";"SILVA (only NR);Bacteria;Methylomirabilota;Methylomirabilia;Methylomirabilales;Methylomirabilaceae;wb1-A12;";"94.6";"14.4";"37";"37";"35";"2";"0";"457146";"391172"
"V4mis2";"SILVA (only NR);Bacteria;Methylomirabilota;Methylomirabilia;Rokubacteriales;";"92.4";"14.4";"262";"262";"242";"20";"0";"456921";"390965"
"V4mis2";"SILVA (only NR);Bacteria;Methylomirabilota;Methylomirabilia;Rokubacteriales;WX65;";"85.7";"14.4";"21";"21";"18";"3";"0";"457162";"391189"
"V4mis2";"SILVA (only NR);Bacteria;Modulibacteria;";"89.1";"14.4";"248";"248";"221";"27";"0";"456935";"390986"
"V4mis2";"SILVA (only NR);Bacteria;Modulibacteria;Moduliflexia;";"89.1";"14.4";"248";"248";"221";"27";"0";"456935";"390986"
"V4mis2";"SILVA (only NR);Bacteria;Modulibacteria;Moduliflexia;Moduliflexales;";"89.1";"14.4";"248";"248";"221";"27";"0";"456935";"390986"
"V4mis2";"SILVA (only NR);Bacteria;Modulibacteria;Moduliflexia;Moduliflexales;Moduliflexaceae;";"89.1";"14.4";"248";"248";"221";"27";"0";"456935";"390986"
"V4mis2";"SILVA (only NR);Bacteria;Modulibacteria;Moduliflexia;Moduliflexales;Moduliflexaceae;Candidatus Moduliflexus;";"100.0";"14.4";"3";"3";"3";"0";"0";"457180";"391204"
"V4mis2";"SILVA (only NR);Bacteria;Myxococcota;";"96.5";"14.5";"3013";"3013";"2907";"106";"0";"454170";"388300"
"V4mis2";"SILVA (only NR);Bacteria;Myxococcota;Myxococcia;";"96.0";"14.4";"731";"731";"702";"29";"0";"456452";"390505"
"V4mis2";"SILVA (only NR);Bacteria;Myxococcota;Myxococcia;Myxococcales;";"96.0";"14.4";"731";"731";"702";"29";"0";"456452";"390505"
"V4mis2";"SILVA (only NR);Bacteria;Myxococcota;Myxococcia;Myxococcales;27F-1492R;";"72.7";"14.4";"11";"11";"8";"3";"0";"457172";"391199"
"V4mis2";"SILVA (only NR);Bacteria;Myxococcota;Myxococcia;Myxococcales;Anaeromyxobacteraceae;";"97.3";"14.4";"110";"110";"107";"3";"0";"457073";"391100"
"V4mis2";"SILVA (only NR);Bacteria;Myxococcota;Myxococcia;Myxococcales;Anaeromyxobacteraceae;Anaeromyxobacter;";"97.3";"14.4";"110";"110";"107";"3";"0";"457073";"391100"
"V4mis2";"SILVA (only NR);Bacteria;Myxococcota;Myxococcia;Myxococcales;Myxococcaceae;";"96.1";"14.4";"591";"591";"568";"23";"0";"456592";"390639"
"V4mis2";"SILVA (only NR);Bacteria;Myxococcota;Myxococcia;Myxococcales;Myxococcaceae;Aggregicoccus;";"100.0";"14.4";"2";"2";"2";"0";"0";"457181";"391205"
"V4mis2";"SILVA (only NR);Bacteria;Myxococcota;Myxococcia;Myxococcales;Myxococcaceae;Angiococcus;";"80.0";"14.4";"5";"5";"4";"1";"0";"457178";"391203"
"V4mis2";"SILVA (only NR);Bacteria;Myxococcota;Myxococcia;Myxococcales;Myxococcaceae;Archangium;";"94.4";"14.4";"18";"18";"17";"1";"0";"457165";"391190"
"V4mis2";"SILVA (only NR);Bacteria;Myxococcota;Myxococcia;Myxococcales;Myxococcaceae;Corallococcus;";"93.9";"14.4";"66";"66";"62";"4";"0";"457117";"391145"
"V4mis2";"SILVA (only NR);Bacteria;Myxococcota;Myxococcia;Myxococcales;Myxococcaceae;Cystobacter;";"94.4";"14.4";"18";"18";"17";"1";"0";"457165";"391190"
"V4mis2";"SILVA (only NR);Bacteria;Myxococcota;Myxococcia;Myxococcales;Myxococcaceae;Hyalangium;";"100.0";"14.4";"1";"1";"1";"0";"0";"457182";"391206"
"V4mis2";"SILVA (only NR);Bacteria;Myxococcota;Myxococcia;Myxococcales;Myxococcaceae;KD3-10;";"100.0";"14.4";"23";"23";"23";"0";"0";"457160";"391184"
"V4mis2";"SILVA (only NR);Bacteria;Myxococcota;Myxococcia;Myxococcales;Myxococcaceae;Melittangium;";"85.7";"14.4";"7";"7";"6";"1";"0";"457176";"391201"
"V4mis2";"SILVA (only NR);Bacteria;Myxococcota;Myxococcia;Myxococcales;Myxococcaceae;Myxococcus;";"97.0";"14.4";"101";"101";"98";"3";"0";"457082";"391109"
"V4mis2";"SILVA (only NR);Bacteria;Myxococcota;Myxococcia;Myxococcales;Myxococcaceae;P3OB-42;";"97.0";"14.4";"268";"268";"260";"8";"0";"456915";"390947"
"V4mis2";"SILVA (only NR);Bacteria;Myxococcota;Myxococcia;Myxococcales;Myxococcaceae;Pyxidicoccus;";"100.0";"14.4";"4";"4";"4";"0";"0";"457179";"391203"
"V4mis2";"SILVA (only NR);Bacteria;Myxococcota;Myxococcia;Myxococcales;Myxococcaceae;Stigmatella;";"100.0";"14.4";"13";"13";"13";"0";"0";"457170";"391194"
"V4mis2";"SILVA (only NR);Bacteria;Myxococcota;Myxococcia;Myxococcales;Myxococcaceae;Vitiosangium;";"100.0";"14.4";"2";"2";"2";"0";"0";"457181";"391205"
"V4mis2";"SILVA (only NR);Bacteria;Myxococcota;Myxococcia;Myxococcales;Myxococcaceae;uncultured;";"92.3";"14.4";"52";"52";"48";"4";"0";"457131";"391159"
"V4mis2";"SILVA (only NR);Bacteria;Myxococcota;Myxococcia;Myxococcales;Vulgatibacteraceae;";"100.0";"14.4";"19";"19";"19";"0";"0";"457164";"391188"
"V4mis2";"SILVA (only NR);Bacteria;Myxococcota;Myxococcia;Myxococcales;Vulgatibacteraceae;Vulgatibacter;";"100.0";"14.4";"19";"19";"19";"0";"0";"457164";"391188"
"V4mis2";"SILVA (only NR);Bacteria;Myxococcota;Polyangia;";"96.7";"14.5";"1911";"1911";"1847";"64";"0";"455272";"389360"
"V4mis2";"SILVA (only NR);Bacteria;Myxococcota;Polyangia;Blfdi19;";"98.4";"14.4";"63";"63";"62";"1";"0";"457120";"391145"
"V4mis2";"SILVA (only NR);Bacteria;Myxococcota;Polyangia;FFCH16767;";"66.7";"14.4";"3";"3";"2";"1";"0";"457180";"391205"
"V4mis2";"SILVA (only NR);Bacteria;Myxococcota;Polyangia;Haliangiales;";"97.7";"14.4";"560";"560";"547";"13";"0";"456623";"390660"
"V4mis2";"SILVA (only NR);Bacteria;Myxococcota;Polyangia;Haliangiales;Haliangiaceae;";"97.7";"14.4";"560";"560";"547";"13";"0";"456623";"390660"
"V4mis2";"SILVA (only NR);Bacteria;Myxococcota;Polyangia;Haliangiales;Haliangiaceae;Haliangium;";"97.7";"14.4";"560";"560";"547";"13";"0";"456623";"390660"
"V4mis2";"SILVA (only NR);Bacteria;Myxococcota;Polyangia;MSB-4B10;";"100.0";"14.4";"15";"15";"15";"0";"0";"457168";"391192"
"V4mis2";"SILVA (only NR);Bacteria;Myxococcota;Polyangia;MidBa8;";"87.3";"14.4";"63";"63";"55";"8";"0";"457120";"391152"
"V4mis2";"SILVA (only NR);Bacteria;Myxococcota;Polyangia;Nannocystales;";"94.3";"14.4";"123";"123";"116";"7";"0";"457060";"391091"
"V4mis2";"SILVA (only NR);Bacteria;Myxococcota;Polyangia;Nannocystales;Nannocystaceae;";"94.3";"14.4";"123";"123";"116";"7";"0";"457060";"391091"
"V4mis2";"SILVA (only NR);Bacteria;Myxococcota;Polyangia;Nannocystales;Nannocystaceae;Enhygromyxa;";"85.7";"14.4";"7";"7";"6";"1";"0";"457176";"391201"
"V4mis2";"SILVA (only NR);Bacteria;Myxococcota;Polyangia;Nannocystales;Nannocystaceae;Nannocystis;";"93.1";"14.4";"58";"58";"54";"4";"0";"457125";"391153"
"V4mis2";"SILVA (only NR);Bacteria;Myxococcota;Polyangia;Nannocystales;Nannocystaceae;Plesiocystis;";"100.0";"14.4";"5";"5";"5";"0";"0";"457178";"391202"
"V4mis2";"SILVA (only NR);Bacteria;Myxococcota;Polyangia;Nannocystales;Nannocystaceae;Pseudenhygromyxa;";"100.0";"14.4";"7";"7";"7";"0";"0";"457176";"391200"
"V4mis2";"SILVA (only NR);Bacteria;Myxococcota;Polyangia;Nannocystales;Nannocystaceae;uncultured;";"94.6";"14.4";"37";"37";"35";"2";"0";"457146";"391172"
"V4mis2";"SILVA (only NR);Bacteria;Myxococcota;Polyangia;PS-B29;";"100.0";"14.4";"25";"25";"25";"0";"0";"457158";"391182"
"V4mis2";"SILVA (only NR);Bacteria;Myxococcota;Polyangia;Polyangiales;";"96.6";"14.5";"907";"907";"876";"31";"0";"456276";"390331"
"V4mis2";"SILVA (only NR);Bacteria;Myxococcota;Polyangia;Polyangiales;Amb-16S-1034;";"100.0";"14.4";"3";"3";"3";"0";"0";"457180";"391204"
"V4mis2";"SILVA (only NR);Bacteria;Myxococcota;Polyangia;Polyangiales;BIrii41;";"95.3";"14.4";"171";"171";"163";"8";"0";"457012";"391044"
"V4mis2";"SILVA (only NR);Bacteria;Myxococcota;Polyangia;Polyangiales;Eel-36e1D6;";"100.0";"14.4";"17";"17";"17";"0";"0";"457166";"391190"
"V4mis2";"SILVA (only NR);Bacteria;Myxococcota;Polyangia;Polyangiales;Phaselicystidaceae;";"99.0";"14.4";"102";"102";"101";"1";"0";"457081";"391106"
"V4mis2";"SILVA (only NR);Bacteria;Myxococcota;Polyangia;Polyangiales;Phaselicystidaceae;Phaselicystis;";"99.0";"14.4";"102";"102";"101";"1";"0";"457081";"391106"
"V4mis2";"SILVA (only NR);Bacteria;Myxococcota;Polyangia;Polyangiales;Polyangiaceae;";"96.6";"14.4";"293";"293";"283";"10";"0";"456890";"390924"
"V4mis2";"SILVA (only NR);Bacteria;Myxococcota;Polyangia;Polyangiales;Polyangiaceae;Aetherobacter;";"100.0";"14.4";"8";"8";"8";"0";"0";"457175";"391199"
"V4mis2";"SILVA (only NR);Bacteria;Myxococcota;Polyangia;Polyangiales;Polyangiaceae;Byssovorax;";"100.0";"14.4";"2";"2";"2";"0";"0";"457181";"391205"
"V4mis2";"SILVA (only NR);Bacteria;Myxococcota;Polyangia;Polyangiales;Polyangiaceae;Chondromyces;";"100.0";"14.4";"7";"7";"7";"0";"0";"457176";"391200"
"V4mis2";"SILVA (only NR);Bacteria;Myxococcota;Polyangia;Polyangiales;Polyangiaceae;Jahnella;";"66.7";"14.4";"3";"3";"2";"1";"0";"457180";"391205"
"V4mis2";"SILVA (only NR);Bacteria;Myxococcota;Polyangia;Polyangiales;Polyangiaceae;Labilithrix;";"100.0";"14.4";"7";"7";"7";"0";"0";"457176";"391200"
"V4mis2";"SILVA (only NR);Bacteria;Myxococcota;Polyangia;Polyangiales;Polyangiaceae;Minicystis;";"90.0";"14.4";"10";"10";"9";"1";"0";"457173";"391198"
"V4mis2";"SILVA (only NR);Bacteria;Myxococcota;Polyangia;Polyangiales;Polyangiaceae;Pajaroellobacter;";"96.9";"14.4";"128";"128";"124";"4";"0";"457055";"391083"
"V4mis2";"SILVA (only NR);Bacteria;Myxococcota;Polyangia;Polyangiales;Polyangiaceae;Polyangium;";"100.0";"14.4";"24";"24";"24";"0";"0";"457159";"391183"
"V4mis2";"SILVA (only NR);Bacteria;Myxococcota;Polyangia;Polyangiales;Polyangiaceae;Sorangium;";"94.1";"14.4";"68";"68";"64";"4";"0";"457115";"391143"
"V4mis2";"SILVA (only NR);Bacteria;Myxococcota;Polyangia;Polyangiales;Polyangiaceae;uncultured;";"100.0";"14.4";"31";"31";"31";"0";"0";"457152";"391176"
"V4mis2";"SILVA (only NR);Bacteria;Myxococcota;Polyangia;Polyangiales;Sandaracinaceae;";"96.2";"14.4";"318";"318";"306";"12";"0";"456865";"390901"
"V4mis2";"SILVA (only NR);Bacteria;Myxococcota;Polyangia;Polyangiales;Sandaracinaceae;Sandaracinus;";"97.8";"14.4";"45";"45";"44";"1";"0";"457138";"391163"
"V4mis2";"SILVA (only NR);Bacteria;Myxococcota;Polyangia;Polyangiales;Sandaracinaceae;uncultured;";"96.0";"14.4";"273";"273";"262";"11";"0";"456910";"390945"
"V4mis2";"SILVA (only NR);Bacteria;Myxococcota;Polyangia;Polyangiales;uncultured;";"100.0";"14.4";"3";"3";"3";"0";"0";"457180";"391204"
"V4mis2";"SILVA (only NR);Bacteria;Myxococcota;Polyangia;UASB-TL25;";"95.9";"14.4";"49";"49";"47";"2";"0";"457134";"391160"
"V4mis2";"SILVA (only NR);Bacteria;Myxococcota;Polyangia;VHS-B3-70;";"100.0";"14.4";"29";"29";"29";"0";"0";"457154";"391178"
"V4mis2";"SILVA (only NR);Bacteria;Myxococcota;Polyangia;VHS-B4-70;";"100.0";"14.4";"12";"12";"12";"0";"0";"457171";"391195"
"V4mis2";"SILVA (only NR);Bacteria;Myxococcota;Polyangia;mle1-27;";"98.3";"14.4";"60";"60";"59";"1";"0";"457123";"391148"
"V4mis2";"SILVA (only NR);Bacteria;Myxococcota;bacteriap25;";"96.5";"14.4";"371";"371";"358";"13";"0";"456812";"390849"
"V4mis2";"SILVA (only NR);Bacteria;NB1-j;";"97.9";"14.4";"484";"484";"474";"10";"0";"456699";"390733"
"V4mis2";"SILVA (only NR);Bacteria;NKB15;";"92.2";"14.4";"51";"51";"47";"4";"0";"457132";"391160"
"V4mis2";"SILVA (only NR);Bacteria;Nitrospinota;";"96.5";"14.4";"311";"311";"300";"11";"0";"456872";"390907"
"V4mis2";"SILVA (only NR);Bacteria;Nitrospinota;MT5B39;";"85.7";"14.4";"7";"7";"6";"1";"0";"457176";"391201"
"V4mis2";"SILVA (only NR);Bacteria;Nitrospinota;Nitrospinia;";"95.7";"14.4";"235";"235";"225";"10";"0";"456948";"390982"
"V4mis2";"SILVA (only NR);Bacteria;Nitrospinota;Nitrospinia;Nitrospinales;";"95.7";"14.4";"235";"235";"225";"10";"0";"456948";"390982"
"V4mis2";"SILVA (only NR);Bacteria;Nitrospinota;Nitrospinia;Nitrospinales;Nitrospinaceae;";"95.7";"14.4";"235";"235";"225";"10";"0";"456948";"390982"
"V4mis2";"SILVA (only NR);Bacteria;Nitrospinota;Nitrospinia;Nitrospinales;Nitrospinaceae;LS-NOB;";"94.0";"14.4";"84";"84";"79";"5";"0";"457099";"391128"
"V4mis2";"SILVA (only NR);Bacteria;Nitrospinota;Nitrospinia;Nitrospinales;Nitrospinaceae;Nitrospina;";"96.4";"14.4";"139";"139";"134";"5";"0";"457044";"391073"
"V4mis2";"SILVA (only NR);Bacteria;Nitrospinota;Nitrospinia;Nitrospinales;Nitrospinaceae;uncultured;";"100.0";"14.4";"12";"12";"12";"0";"0";"457171";"391195"
"V4mis2";"SILVA (only NR);Bacteria;Nitrospinota;P9X2b3D02;";"100.0";"14.4";"68";"68";"68";"0";"0";"457115";"391139"
"V4mis2";"SILVA (only NR);Bacteria;Nitrospirota;";"95.9";"14.5";"1246";"1246";"1195";"51";"0";"455937";"390012"
"V4mis2";"SILVA (only NR);Bacteria;Nitrospirota;4-29-1;";"93.8";"14.4";"65";"65";"61";"4";"0";"457118";"391146"
"V4mis2";"SILVA (only NR);Bacteria;Nitrospirota;661256;";"100.0";"14.4";"2";"2";"2";"0";"0";"457181";"391205"
"V4mis2";"SILVA (only NR);Bacteria;Nitrospirota;BMS9AB35;";"100.0";"14.4";"26";"26";"26";"0";"0";"457157";"391181"
"V4mis2";"SILVA (only NR);Bacteria;Nitrospirota;HDB-SIOI1093;";"100.0";"14.4";"4";"4";"4";"0";"0";"457179";"391203"
"V4mis2";"SILVA (only NR);Bacteria;Nitrospirota;Leptospirillia;";"93.8";"14.4";"177";"177";"166";"11";"0";"457006";"391041"
"V4mis2";"SILVA (only NR);Bacteria;Nitrospirota;Leptospirillia;Leptospirillales;";"93.8";"14.4";"177";"177";"166";"11";"0";"457006";"391041"
"V4mis2";"SILVA (only NR);Bacteria;Nitrospirota;Leptospirillia;Leptospirillales;Leptospirillaceae;";"93.8";"14.4";"177";"177";"166";"11";"0";"457006";"391041"
"V4mis2";"SILVA (only NR);Bacteria;Nitrospirota;Leptospirillia;Leptospirillales;Leptospirillaceae;Leptospirillum;";"93.8";"14.4";"177";"177";"166";"11";"0";"457006";"391041"
"V4mis2";"SILVA (only NR);Bacteria;Nitrospirota;Nitrospiria;";"95.4";"14.4";"539";"539";"514";"25";"0";"456644";"390693"
"V4mis2";"SILVA (only NR);Bacteria;Nitrospirota;Nitrospiria;Nitrospirales;";"95.4";"14.4";"539";"539";"514";"25";"0";"456644";"390693"
"V4mis2";"SILVA (only NR);Bacteria;Nitrospirota;Nitrospiria;Nitrospirales;Nitrospiraceae;";"95.4";"14.4";"539";"539";"514";"25";"0";"456644";"390693"
"V4mis2";"SILVA (only NR);Bacteria;Nitrospirota;Nitrospiria;Nitrospirales;Nitrospiraceae;Nitrospira;";"95.4";"14.4";"539";"539";"514";"25";"0";"456644";"390693"
"V4mis2";"SILVA (only NR);Bacteria;Nitrospirota;Thermodesulfovibrionia;";"97.5";"14.4";"433";"433";"422";"11";"0";"456750";"390785"
"V4mis2";"SILVA (only NR);Bacteria;Nitrospirota;Thermodesulfovibrionia;Magnetobacteriales;";"100.0";"14.4";"11";"11";"11";"0";"0";"457172";"391196"
"V4mis2";"SILVA (only NR);Bacteria;Nitrospirota;Thermodesulfovibrionia;Magnetobacteriales;Magnetobacteriaceae;";"100.0";"14.4";"11";"11";"11";"0";"0";"457172";"391196"
"V4mis2";"SILVA (only NR);Bacteria;Nitrospirota;Thermodesulfovibrionia;Magnetobacteriales;Magnetobacteriaceae;Candidatus Magnetobacterium;";"100.0";"14.4";"6";"6";"6";"0";"0";"457177";"391201"
"V4mis2";"SILVA (only NR);Bacteria;Nitrospirota;Thermodesulfovibrionia;Magnetobacteriales;Magnetobacteriaceae;Candidatus Magnetoovum;";"100.0";"14.4";"5";"5";"5";"0";"0";"457178";"391202"
"V4mis2";"SILVA (only NR);Bacteria;Nitrospirota;Thermodesulfovibrionia;Thermodesulfovibrionales;";"91.5";"14.4";"59";"59";"54";"5";"0";"457124";"391153"
"V4mis2";"SILVA (only NR);Bacteria;Nitrospirota;Thermodesulfovibrionia;Thermodesulfovibrionales;Thermodesulfovibrionaceae;";"91.5";"14.4";"59";"59";"54";"5";"0";"457124";"391153"
"V4mis2";"SILVA (only NR);Bacteria;Nitrospirota;Thermodesulfovibrionia;Thermodesulfovibrionales;Thermodesulfovibrionaceae;Thermodesulfovibrio;";"91.5";"14.4";"59";"59";"54";"5";"0";"457124";"391153"
"V4mis2";"SILVA (only NR);Bacteria;Nitrospirota;Thermodesulfovibrionia;uncultured;";"98.3";"14.4";"363";"363";"357";"6";"0";"456820";"390850"
"V4mis2";"SILVA (only NR);Bacteria;PAUC34f;";"97.8";"14.4";"93";"93";"91";"2";"0";"457090";"391116"
"V4mis2";"SILVA (only NR);Bacteria;Patescibacteria;";"86.8";"14.4";"4543";"4543";"3943";"600";"0";"452640";"387264"
"V4mis2";"SILVA (only NR);Bacteria;Patescibacteria;ABY1;";"98.0";"14.4";"402";"402";"394";"8";"0";"456781";"390813"
"V4mis2";"SILVA (only NR);Bacteria;Patescibacteria;ABY1;Candidatus Buchananbacteria;";"100.0";"14.4";"15";"15";"15";"0";"0";"457168";"391192"
"V4mis2";"SILVA (only NR);Bacteria;Patescibacteria;ABY1;Candidatus Falkowbacteria;";"98.8";"14.4";"84";"84";"83";"1";"0";"457099";"391124"
"V4mis2";"SILVA (only NR);Bacteria;Patescibacteria;ABY1;Candidatus Jacksonbacteria;";"100.0";"14.4";"6";"6";"6";"0";"0";"457177";"391201"
"V4mis2";"SILVA (only NR);Bacteria;Patescibacteria;ABY1;Candidatus Kerfeldbacteria;";"100.0";"14.4";"71";"71";"71";"0";"0";"457112";"391136"
"V4mis2";"SILVA (only NR);Bacteria;Patescibacteria;ABY1;Candidatus Komeilibacteria;";"100.0";"14.4";"29";"29";"29";"0";"0";"457154";"391178"
"V4mis2";"SILVA (only NR);Bacteria;Patescibacteria;ABY1;Candidatus Kuenenbacteria;";"100.0";"14.4";"35";"35";"35";"0";"0";"457148";"391172"
"V4mis2";"SILVA (only NR);Bacteria;Patescibacteria;ABY1;Candidatus Magasanikbacteria;";"95.3";"14.4";"107";"107";"102";"5";"0";"457076";"391105"
"V4mis2";"SILVA (only NR);Bacteria;Patescibacteria;ABY1;Candidatus Uhrbacteria;";"96.4";"14.4";"55";"55";"53";"2";"0";"457128";"391154"
"V4mis2";"SILVA (only NR);Bacteria;Patescibacteria;Berkelbacteria;";"86.4";"14.4";"59";"59";"51";"8";"0";"457124";"391156"
"V4mis2";"SILVA (only NR);Bacteria;Patescibacteria;CPR2;";"94.7";"14.4";"19";"19";"18";"1";"0";"457164";"391189"
"V4mis2";"SILVA (only NR);Bacteria;Patescibacteria;Dojkabacteria;";"4.2";"14.4";"166";"166";"7";"159";"0";"457017";"391200"
"V4mis2";"SILVA (only NR);Bacteria;Patescibacteria;Gracilibacteria;";"97.4";"14.5";"876";"876";"853";"23";"0";"456307";"390354"
"V4mis2";"SILVA (only NR);Bacteria;Patescibacteria;Gracilibacteria;Absconditabacteriales (SR1);";"96.3";"14.4";"217";"217";"209";"8";"0";"456966";"390998"
"V4mis2";"SILVA (only NR);Bacteria;Patescibacteria;Gracilibacteria;Candidatus Abawacabacteria;";"93.3";"14.4";"15";"15";"14";"1";"0";"457168";"391193"
"V4mis2";"SILVA (only NR);Bacteria;Patescibacteria;Gracilibacteria;Candidatus Peregrinibacteria;";"98.5";"14.4";"132";"132";"130";"2";"0";"457051";"391077"
"V4mis2";"SILVA (only NR);Bacteria;Patescibacteria;Gracilibacteria;Candidatus Peribacteria;";"100.0";"14.4";"93";"93";"93";"0";"0";"457090";"391114"
"V4mis2";"SILVA (only NR);Bacteria;Patescibacteria;Gracilibacteria;JGI 0000069-P22;";"97.5";"14.4";"163";"163";"159";"4";"0";"457020";"391048"
"V4mis2";"SILVA (only NR);Bacteria;Patescibacteria;Kazania;";"93.8";"14.4";"16";"16";"15";"1";"0";"457167";"391192"
"V4mis2";"SILVA (only NR);Bacteria;Patescibacteria;MD2896-B216;";"100.0";"14.4";"4";"4";"4";"0";"0";"457179";"391203"
"V4mis2";"SILVA (only NR);Bacteria;Patescibacteria;Microgenomatia;";"61.9";"14.4";"832";"832";"515";"317";"0";"456351";"390692"
"V4mis2";"SILVA (only NR);Bacteria;Patescibacteria;Microgenomatia;Candidatus Amesbacteria;";"100.0";"14.4";"11";"11";"11";"0";"0";"457172";"391196"
"V4mis2";"SILVA (only NR);Bacteria;Patescibacteria;Microgenomatia;Candidatus Beckwithbacteria;";"20.0";"14.4";"20";"20";"4";"16";"0";"457163";"391203"
"V4mis2";"SILVA (only NR);Bacteria;Patescibacteria;Microgenomatia;Candidatus Chisholmbacteria;";"93.8";"14.4";"16";"16";"15";"1";"0";"457167";"391192"
"V4mis2";"SILVA (only NR);Bacteria;Patescibacteria;Microgenomatia;Candidatus Collierbacteria;";"96.0";"14.4";"50";"50";"48";"2";"0";"457133";"391159"
"V4mis2";"SILVA (only NR);Bacteria;Patescibacteria;Microgenomatia;Candidatus Curtissbacteria;";"100.0";"14.4";"20";"20";"20";"0";"0";"457163";"391187"
"V4mis2";"SILVA (only NR);Bacteria;Patescibacteria;Microgenomatia;Candidatus Daviesbacteria;";"89.1";"14.4";"46";"46";"41";"5";"0";"457137";"391166"
"V4mis2";"SILVA (only NR);Bacteria;Patescibacteria;Microgenomatia;Candidatus Gottesmanbacteria;";"89.1";"14.4";"46";"46";"41";"5";"0";"457137";"391166"
"V4mis2";"SILVA (only NR);Bacteria;Patescibacteria;Microgenomatia;Candidatus Levybacteria;";"1.4";"14.4";"72";"72";"1";"71";"0";"457111";"391206"
"V4mis2";"SILVA (only NR);Bacteria;Patescibacteria;Microgenomatia;Candidatus Pacebacteria;";"62.7";"14.4";"134";"134";"84";"50";"0";"457049";"391123"
"V4mis2";"SILVA (only NR);Bacteria;Patescibacteria;Microgenomatia;Candidatus Roizmanbacteria;";"5.0";"14.4";"161";"161";"8";"153";"0";"457022";"391199"
"V4mis2";"SILVA (only NR);Bacteria;Patescibacteria;Microgenomatia;Candidatus Shapirobacteria;";"95.4";"14.4";"65";"65";"62";"3";"0";"457118";"391145"
"V4mis2";"SILVA (only NR);Bacteria;Patescibacteria;Microgenomatia;Candidatus Woesebacteria;";"93.2";"14.4";"133";"133";"124";"9";"0";"457050";"391083"
"V4mis2";"SILVA (only NR);Bacteria;Patescibacteria;Microgenomatia;Candidatus Woykebacteria;";"96.3";"14.4";"27";"27";"26";"1";"0";"457156";"391181"
"V4mis2";"SILVA (only NR);Bacteria;Patescibacteria;Parcubacteria;";"94.6";"14.4";"853";"853";"807";"46";"0";"456330";"390400"
"V4mis2";"SILVA (only NR);Bacteria;Patescibacteria;Parcubacteria;32-520;";"95.7";"14.4";"23";"23";"22";"1";"0";"457160";"391185"
"V4mis2";"SILVA (only NR);Bacteria;Patescibacteria;Parcubacteria;CG1-02-40-25;";"100.0";"14.4";"4";"4";"4";"0";"0";"457179";"391203"
"V4mis2";"SILVA (only NR);Bacteria;Patescibacteria;Parcubacteria;CG1-02-42-13;";"100.0";"14.4";"12";"12";"12";"0";"0";"457171";"391195"
"V4mis2";"SILVA (only NR);Bacteria;Patescibacteria;Parcubacteria;Candidatus Adlerbacteria;";"100.0";"14.4";"35";"35";"35";"0";"0";"457148";"391172"
"V4mis2";"SILVA (only NR);Bacteria;Patescibacteria;Parcubacteria;Candidatus Azambacteria;";"100.0";"14.4";"26";"26";"26";"0";"0";"457157";"391181"
"V4mis2";"SILVA (only NR);Bacteria;Patescibacteria;Parcubacteria;Candidatus Brennerbacteria;";"100.0";"14.4";"4";"4";"4";"0";"0";"457179";"391203"
"V4mis2";"SILVA (only NR);Bacteria;Patescibacteria;Parcubacteria;Candidatus Campbellbacteria;";"100.0";"14.4";"30";"30";"30";"0";"0";"457153";"391177"
"V4mis2";"SILVA (only NR);Bacteria;Patescibacteria;Parcubacteria;Candidatus Colwellbacteria;";"100.0";"14.4";"6";"6";"6";"0";"0";"457177";"391201"
"V4mis2";"SILVA (only NR);Bacteria;Patescibacteria;Parcubacteria;Candidatus Doudnabacteria;";"100.0";"14.4";"2";"2";"2";"0";"0";"457181";"391205"
"V4mis2";"SILVA (only NR);Bacteria;Patescibacteria;Parcubacteria;Candidatus Giovannonibacteria;";"100.0";"14.4";"4";"4";"4";"0";"0";"457179";"391203"
"V4mis2";"SILVA (only NR);Bacteria;Patescibacteria;Parcubacteria;Candidatus Jorgensenbacteria;";"90.0";"14.4";"10";"10";"9";"1";"0";"457173";"391198"
"V4mis2";"SILVA (only NR);Bacteria;Patescibacteria;Parcubacteria;Candidatus Kaiserbacteria;";"91.1";"14.4";"192";"192";"175";"17";"0";"456991";"391032"
"V4mis2";"SILVA (only NR);Bacteria;Patescibacteria;Parcubacteria;Candidatus Liptonbacteria;";"100.0";"14.4";"3";"3";"3";"0";"0";"457180";"391204"
"V4mis2";"SILVA (only NR);Bacteria;Patescibacteria;Parcubacteria;Candidatus Lloydbacteria;";"87.5";"14.4";"8";"8";"7";"1";"0";"457175";"391200"
"V4mis2";"SILVA (only NR);Bacteria;Patescibacteria;Parcubacteria;Candidatus Moranbacteria;";"93.3";"14.4";"45";"45";"42";"3";"0";"457138";"391165"
"V4mis2";"SILVA (only NR);Bacteria;Patescibacteria;Parcubacteria;Candidatus Nealsonbacteria;";"100.0";"14.4";"6";"6";"6";"0";"0";"457177";"391201"
"V4mis2";"SILVA (only NR);Bacteria;Patescibacteria;Parcubacteria;Candidatus Nomurabacteria;";"94.5";"14.4";"55";"55";"52";"3";"0";"457128";"391155"
"V4mis2";"SILVA (only NR);Bacteria;Patescibacteria;Parcubacteria;Candidatus Portnoybacteria;";"87.5";"14.4";"16";"16";"14";"2";"0";"457167";"391193"
"V4mis2";"SILVA (only NR);Bacteria;Patescibacteria;Parcubacteria;Candidatus Ryanbacteria;";"100.0";"14.4";"3";"3";"3";"0";"0";"457180";"391204"
"V4mis2";"SILVA (only NR);Bacteria;Patescibacteria;Parcubacteria;Candidatus Spechtbacteria;";"100.0";"14.4";"5";"5";"5";"0";"0";"457178";"391202"
"V4mis2";"SILVA (only NR);Bacteria;Patescibacteria;Parcubacteria;Candidatus Staskawiczbacteria;";"100.0";"14.4";"11";"11";"11";"0";"0";"457172";"391196"
"V4mis2";"SILVA (only NR);Bacteria;Patescibacteria;Parcubacteria;Candidatus Terrybacteria;";"80.0";"14.4";"5";"5";"4";"1";"0";"457178";"391203"
"V4mis2";"SILVA (only NR);Bacteria;Patescibacteria;Parcubacteria;Candidatus Vogelbacteria;";"87.5";"14.4";"16";"16";"14";"2";"0";"457167";"391193"
"V4mis2";"SILVA (only NR);Bacteria;Patescibacteria;Parcubacteria;Candidatus Wolfebacteria;";"93.3";"14.4";"15";"15";"14";"1";"0";"457168";"391193"
"V4mis2";"SILVA (only NR);Bacteria;Patescibacteria;Parcubacteria;Candidatus Yanofskybacteria;";"97.6";"14.4";"42";"42";"41";"1";"0";"457141";"391166"
"V4mis2";"SILVA (only NR);Bacteria;Patescibacteria;Parcubacteria;Candidatus Yonathbacteria;";"75.0";"14.4";"4";"4";"3";"1";"0";"457179";"391204"
"V4mis2";"SILVA (only NR);Bacteria;Patescibacteria;Parcubacteria;Candidatus Zambryskibacteria;";"90.9";"14.4";"11";"11";"10";"1";"0";"457172";"391197"
"V4mis2";"SILVA (only NR);Bacteria;Patescibacteria;Parcubacteria;GW2011-GWA2-46-7;";"93.1";"14.4";"29";"29";"27";"2";"0";"457154";"391180"
"V4mis2";"SILVA (only NR);Bacteria;Patescibacteria;Parcubacteria;GWA2-38-13b;";"93.3";"14.4";"45";"45";"42";"3";"0";"457138";"391165"
"V4mis2";"SILVA (only NR);Bacteria;Patescibacteria;Parcubacteria;GWB1-42-6;";"75.0";"14.4";"8";"8";"6";"2";"0";"457175";"391201"
"V4mis2";"SILVA (only NR);Bacteria;Patescibacteria;Parcubacteria;Paceibacterales;";"100.0";"14.4";"11";"11";"11";"0";"0";"457172";"391196"
"V4mis2";"SILVA (only NR);Bacteria;Patescibacteria;Parcubacteria;Paceibacterales;Paceibacteraceae;";"100.0";"14.4";"11";"11";"11";"0";"0";"457172";"391196"
"V4mis2";"SILVA (only NR);Bacteria;Patescibacteria;Parcubacteria;Paceibacterales;Paceibacteraceae;Candidatus Paceibacter;";"100.0";"14.4";"11";"11";"11";"0";"0";"457172";"391196"
"V4mis2";"SILVA (only NR);Bacteria;Patescibacteria;Parcubacteria;UBA9983;";"100.0";"14.4";"8";"8";"8";"0";"0";"457175";"391199"
"V4mis2";"SILVA (only NR);Bacteria;Patescibacteria;Saccharimonadia;";"97.5";"14.5";"1217";"1217";"1186";"31";"0";"455966";"390021"
"V4mis2";"SILVA (only NR);Bacteria;Patescibacteria;Saccharimonadia;Saccharimonadales;";"97.5";"14.5";"1217";"1217";"1186";"31";"0";"455966";"390021"
"V4mis2";"SILVA (only NR);Bacteria;Patescibacteria;Saccharimonadia;Saccharimonadales;LWQ8;";"97.5";"14.4";"81";"81";"79";"2";"0";"457102";"391128"
"V4mis2";"SILVA (only NR);Bacteria;Patescibacteria;Saccharimonadia;Saccharimonadales;Saccharimonadaceae;";"96.8";"14.4";"310";"310";"300";"10";"0";"456873";"390907"
"V4mis2";"SILVA (only NR);Bacteria;Patescibacteria;Saccharimonadia;Saccharimonadales;Saccharimonadaceae;Candidatus Saccharimonas;";"96.4";"14.4";"110";"110";"106";"4";"0";"457073";"391101"
"V4mis2";"SILVA (only NR);Bacteria;Patescibacteria;Saccharimonadia;Saccharimonadales;Saccharimonadaceae;GTL1;";"100.0";"14.4";"1";"1";"1";"0";"0";"457182";"391206"
"V4mis2";"SILVA (only NR);Bacteria;Patescibacteria;Saccharimonadia;Saccharimonadales;Saccharimonadaceae;TM7a;";"97.5";"14.4";"79";"79";"77";"2";"0";"457104";"391130"
"V4mis2";"SILVA (only NR);Bacteria;Patescibacteria;Saccharimonadia;Saccharimonadales;Saccharimonadaceae;TM7x;";"95.2";"14.4";"62";"62";"59";"3";"0";"457121";"391148"
"V4mis2";"SILVA (only NR);Bacteria;Patescibacteria;Saccharimonadia;Saccharimonadales;WWH38;";"100.0";"14.4";"33";"33";"33";"0";"0";"457150";"391174"
"V4mis2";"SILVA (only NR);Bacteria;Patescibacteria;Saccharimonadia;Saccharimonadales;YM_S32_TM7_50_20;";"100.0";"14.4";"21";"21";"21";"0";"0";"457162";"391186"
"V4mis2";"SILVA (only NR);Bacteria;Patescibacteria;WWE3;";"93.1";"14.4";"87";"87";"81";"6";"0";"457096";"391126"
"V4mis2";"SILVA (only NR);Bacteria;Patescibacteria;uncultured;";"100.0";"14.4";"12";"12";"12";"0";"0";"457171";"391195"
"V4mis2";"SILVA (only NR);Bacteria;Planctomycetota;";"95.0";"14.6";"8657";"8657";"8224";"433";"0";"448526";"382983"
"V4mis2";"SILVA (only NR);Bacteria;Planctomycetota;028H05-P-BN-P5;";"100.0";"14.4";"9";"9";"9";"0";"0";"457174";"391198"
"V4mis2";"SILVA (only NR);Bacteria;Planctomycetota;BD7-11;";"100.0";"14.4";"79";"79";"79";"0";"0";"457104";"391128"
"V4mis2";"SILVA (only NR);Bacteria;Planctomycetota;Brocadiae;";"90.9";"14.4";"143";"143";"130";"13";"0";"457040";"391077"
"V4mis2";"SILVA (only NR);Bacteria;Planctomycetota;Brocadiae;Brocadiales;";"90.7";"14.4";"140";"140";"127";"13";"0";"457043";"391080"
"V4mis2";"SILVA (only NR);Bacteria;Planctomycetota;Brocadiae;Brocadiales;Brocadiaceae;";"85.1";"14.4";"74";"74";"63";"11";"0";"457109";"391144"
"V4mis2";"SILVA (only NR);Bacteria;Planctomycetota;Brocadiae;Brocadiales;Brocadiaceae;Candidatus Anammoxoglobus;";"66.7";"14.4";"3";"3";"2";"1";"0";"457180";"391205"
"V4mis2";"SILVA (only NR);Bacteria;Planctomycetota;Brocadiae;Brocadiales;Brocadiaceae;Candidatus Brocadia;";"90.6";"14.4";"32";"32";"29";"3";"0";"457151";"391178"
"V4mis2";"SILVA (only NR);Bacteria;Planctomycetota;Brocadiae;Brocadiales;Brocadiaceae;Candidatus Jettenia;";"93.8";"14.4";"16";"16";"15";"1";"0";"457167";"391192"
"V4mis2";"SILVA (only NR);Bacteria;Planctomycetota;Brocadiae;Brocadiales;Brocadiaceae;Candidatus Kuenenia;";"86.7";"14.4";"15";"15";"13";"2";"0";"457168";"391194"
"V4mis2";"SILVA (only NR);Bacteria;Planctomycetota;Brocadiae;Brocadiales;Brocadiaceae;uncultured;";"42.9";"14.4";"7";"7";"3";"4";"0";"457176";"391204"
"V4mis2";"SILVA (only NR);Bacteria;Planctomycetota;Brocadiae;Brocadiales;GWA2-50-13;";"100.0";"14.4";"11";"11";"11";"0";"0";"457172";"391196"
"V4mis2";"SILVA (only NR);Bacteria;Planctomycetota;Brocadiae;Brocadiales;Scalinduaceae;";"98.1";"14.4";"54";"54";"53";"1";"0";"457129";"391154"
"V4mis2";"SILVA (only NR);Bacteria;Planctomycetota;Brocadiae;Brocadiales;Scalinduaceae;Candidatus Scalindua;";"98.1";"14.4";"54";"54";"53";"1";"0";"457129";"391154"
"V4mis2";"SILVA (only NR);Bacteria;Planctomycetota;Brocadiae;SM23-32;";"100.0";"14.4";"3";"3";"3";"0";"0";"457180";"391204"
"V4mis2";"SILVA (only NR);Bacteria;Planctomycetota;ODP123;";"95.0";"14.4";"20";"20";"19";"1";"0";"457163";"391188"
"V4mis2";"SILVA (only NR);Bacteria;Planctomycetota;OM190;";"93.8";"14.4";"418";"418";"392";"26";"0";"456765";"390815"
"V4mis2";"SILVA (only NR);Bacteria;Planctomycetota;Phycisphaerae;";"96.4";"14.5";"2484";"2484";"2395";"89";"0";"454699";"388812"
"V4mis2";"SILVA (only NR);Bacteria;Planctomycetota;Phycisphaerae;Amsterdam-1B-07;";"100.0";"14.4";"5";"5";"5";"0";"0";"457178";"391202"
"V4mis2";"SILVA (only NR);Bacteria;Planctomycetota;Phycisphaerae;B103G10;";"100.0";"14.4";"2";"2";"2";"0";"0";"457181";"391205"
"V4mis2";"SILVA (only NR);Bacteria;Planctomycetota;Phycisphaerae;C86;";"93.3";"14.4";"15";"15";"14";"1";"0";"457168";"391193"
"V4mis2";"SILVA (only NR);Bacteria;Planctomycetota;Phycisphaerae;CCM11a;";"98.2";"14.4";"112";"112";"110";"2";"0";"457071";"391097"
"V4mis2";"SILVA (only NR);Bacteria;Planctomycetota;Phycisphaerae;DG-20;";"100.0";"14.4";"16";"16";"16";"0";"0";"457167";"391191"
"V4mis2";"SILVA (only NR);Bacteria;Planctomycetota;Phycisphaerae;MSBL9;";"97.3";"14.5";"823";"823";"801";"22";"0";"456360";"390406"
"V4mis2";"SILVA (only NR);Bacteria;Planctomycetota;Phycisphaerae;MSBL9;4572-13;";"100.0";"14.4";"18";"18";"18";"0";"0";"457165";"391189"
"V4mis2";"SILVA (only NR);Bacteria;Planctomycetota;Phycisphaerae;MSBL9;GWC2-45-44;";"100.0";"14.4";"9";"9";"9";"0";"0";"457174";"391198"
"V4mis2";"SILVA (only NR);Bacteria;Planctomycetota;Phycisphaerae;MSBL9;KCLunmb-38-53;";"100.0";"14.4";"18";"18";"18";"0";"0";"457165";"391189"
"V4mis2";"SILVA (only NR);Bacteria;Planctomycetota;Phycisphaerae;MSBL9;L21-RPul-D3;";"100.0";"14.4";"20";"20";"20";"0";"0";"457163";"391187"
"V4mis2";"SILVA (only NR);Bacteria;Planctomycetota;Phycisphaerae;MSBL9;SG8-4;";"97.0";"14.4";"668";"668";"648";"20";"0";"456515";"390559"
"V4mis2";"SILVA (only NR);Bacteria;Planctomycetota;Phycisphaerae;MSBL9;SM23-30;";"97.6";"14.4";"41";"41";"40";"1";"0";"457142";"391167"
"V4mis2";"SILVA (only NR);Bacteria;Planctomycetota;Phycisphaerae;MSBL9;ST-NAGAB-D1;";"97.8";"14.4";"45";"45";"44";"1";"0";"457138";"391163"
"V4mis2";"SILVA (only NR);Bacteria;Planctomycetota;Phycisphaerae;Phycisphaerales;";"96.3";"14.5";"971";"971";"935";"36";"0";"456212";"390272"
"V4mis2";"SILVA (only NR);Bacteria;Planctomycetota;Phycisphaerae;Phycisphaerales;AKAU3564 sediment group;";"96.0";"14.4";"274";"274";"263";"11";"0";"456909";"390944"
"V4mis2";"SILVA (only NR);Bacteria;Planctomycetota;Phycisphaerae;Phycisphaerales;Phycisphaeraceae;";"96.4";"14.4";"697";"697";"672";"25";"0";"456486";"390535"
"V4mis2";"SILVA (only NR);Bacteria;Planctomycetota;Phycisphaerae;Phycisphaerales;Phycisphaeraceae;AKYG587;";"92.9";"14.4";"42";"42";"39";"3";"0";"457141";"391168"
"V4mis2";"SILVA (only NR);Bacteria;Planctomycetota;Phycisphaerae;Phycisphaerales;Phycisphaeraceae;Algisphaera;";"100.0";"14.4";"8";"8";"8";"0";"0";"457175";"391199"
"V4mis2";"SILVA (only NR);Bacteria;Planctomycetota;Phycisphaerae;Phycisphaerales;Phycisphaeraceae;CL500-3;";"95.7";"14.4";"47";"47";"45";"2";"0";"457136";"391162"
"V4mis2";"SILVA (only NR);Bacteria;Planctomycetota;Phycisphaerae;Phycisphaerales;Phycisphaeraceae;FS140-16B-02 marine group;";"100.0";"14.4";"17";"17";"17";"0";"0";"457166";"391190"
"V4mis2";"SILVA (only NR);Bacteria;Planctomycetota;Phycisphaerae;Phycisphaerales;Phycisphaeraceae;I-8;";"100.0";"14.4";"12";"12";"12";"0";"0";"457171";"391195"
"V4mis2";"SILVA (only NR);Bacteria;Planctomycetota;Phycisphaerae;Phycisphaerales;Phycisphaeraceae;JL-ETNP-F27;";"100.0";"14.4";"28";"28";"28";"0";"0";"457155";"391179"
"V4mis2";"SILVA (only NR);Bacteria;Planctomycetota;Phycisphaerae;Phycisphaerales;Phycisphaeraceae;Phycisphaera;";"94.7";"14.4";"19";"19";"18";"1";"0";"457164";"391189"
"V4mis2";"SILVA (only NR);Bacteria;Planctomycetota;Phycisphaerae;Phycisphaerales;Phycisphaeraceae;SM1A02;";"96.5";"14.4";"283";"283";"273";"10";"0";"456900";"390934"
"V4mis2";"SILVA (only NR);Bacteria;Planctomycetota;Phycisphaerae;Phycisphaerales;Phycisphaeraceae;Urania-1B-19 marine sediment group;";"95.4";"14.4";"65";"65";"62";"3";"0";"457118";"391145"
"V4mis2";"SILVA (only NR);Bacteria;Planctomycetota;Phycisphaerae;Phycisphaerales;Phycisphaeraceae;Z195MB87;";"100.0";"14.4";"4";"4";"4";"0";"0";"457179";"391203"
"V4mis2";"SILVA (only NR);Bacteria;Planctomycetota;Phycisphaerae;Phycisphaerales;Phycisphaeraceae;uncultured;";"97.0";"14.4";"168";"168";"163";"5";"0";"457015";"391044"
"V4mis2";"SILVA (only NR);Bacteria;Planctomycetota;Phycisphaerae;Pla1 lineage;";"95.7";"14.4";"70";"70";"67";"3";"0";"457113";"391140"
"V4mis2";"SILVA (only NR);Bacteria;Planctomycetota;Phycisphaerae;S-70;";"100.0";"14.4";"30";"30";"30";"0";"0";"457153";"391177"
"V4mis2";"SILVA (only NR);Bacteria;Planctomycetota;Phycisphaerae;Tepidisphaerales;";"94.0";"14.4";"333";"333";"313";"20";"0";"456850";"390894"
"V4mis2";"SILVA (only NR);Bacteria;Planctomycetota;Phycisphaerae;Tepidisphaerales;CPla-3 termite group;";"100.0";"14.4";"16";"16";"16";"0";"0";"457167";"391191"
"V4mis2";"SILVA (only NR);Bacteria;Planctomycetota;Phycisphaerae;Tepidisphaerales;Tepidisphaeraceae;";"83.3";"14.4";"24";"24";"20";"4";"0";"457159";"391187"
"V4mis2";"SILVA (only NR);Bacteria;Planctomycetota;Phycisphaerae;Tepidisphaerales;Tepidisphaeraceae;Tepidisphaera;";"85.7";"14.4";"7";"7";"6";"1";"0";"457176";"391201"
"V4mis2";"SILVA (only NR);Bacteria;Planctomycetota;Phycisphaerae;Tepidisphaerales;WD2101 soil group;";"94.8";"14.4";"290";"290";"275";"15";"0";"456893";"390932"
"V4mis2";"SILVA (only NR);Bacteria;Planctomycetota;Phycisphaerae;mle1-8;";"95.3";"14.4";"107";"107";"102";"5";"0";"457076";"391105"
"V4mis2";"SILVA (only NR);Bacteria;Planctomycetota;Pla3 lineage;";"93.0";"14.4";"129";"129";"120";"9";"0";"457054";"391087"
"V4mis2";"SILVA (only NR);Bacteria;Planctomycetota;Pla4 lineage;";"94.9";"14.4";"158";"158";"150";"8";"0";"457025";"391057"
"V4mis2";"SILVA (only NR);Bacteria;Planctomycetota;Planctomycetes;";"94.3";"14.5";"4871";"4871";"4593";"278";"0";"452312";"386614"
"V4mis2";"SILVA (only NR);Bacteria;Planctomycetota;Planctomycetes;Gemmatales;";"96.5";"14.5";"931";"931";"898";"33";"0";"456252";"390309"
"V4mis2";"SILVA (only NR);Bacteria;Planctomycetota;Planctomycetes;Gemmatales;Gemmataceae;";"96.5";"14.5";"931";"931";"898";"33";"0";"456252";"390309"
"V4mis2";"SILVA (only NR);Bacteria;Planctomycetota;Planctomycetes;Gemmatales;Gemmataceae;Fimbriiglobus;";"97.4";"14.4";"76";"76";"74";"2";"0";"457107";"391133"
"V4mis2";"SILVA (only NR);Bacteria;Planctomycetota;Planctomycetes;Gemmatales;Gemmataceae;Gemmata;";"97.3";"14.4";"185";"185";"180";"5";"0";"456998";"391027"
"V4mis2";"SILVA (only NR);Bacteria;Planctomycetota;Planctomycetes;Gemmatales;Gemmataceae;Telmatocola;";"100.0";"14.4";"5";"5";"5";"0";"0";"457178";"391202"
"V4mis2";"SILVA (only NR);Bacteria;Planctomycetota;Planctomycetes;Gemmatales;Gemmataceae;Tuwongella;";"100.0";"14.4";"7";"7";"7";"0";"0";"457176";"391200"
"V4mis2";"SILVA (only NR);Bacteria;Planctomycetota;Planctomycetes;Gemmatales;Gemmataceae;Zavarzinella;";"100.0";"14.4";"8";"8";"8";"0";"0";"457175";"391199"
"V4mis2";"SILVA (only NR);Bacteria;Planctomycetota;Planctomycetes;Gemmatales;Gemmataceae;uncultured;";"96.0";"14.4";"642";"642";"616";"26";"0";"456541";"390591"
"V4mis2";"SILVA (only NR);Bacteria;Planctomycetota;Planctomycetes;Isosphaerales;";"95.8";"14.4";"431";"431";"413";"18";"0";"456752";"390794"
"V4mis2";"SILVA (only NR);Bacteria;Planctomycetota;Planctomycetes;Isosphaerales;Isosphaeraceae;";"95.8";"14.4";"431";"431";"413";"18";"0";"456752";"390794"
"V4mis2";"SILVA (only NR);Bacteria;Planctomycetota;Planctomycetes;Isosphaerales;Isosphaeraceae;Aquisphaera;";"98.0";"14.4";"51";"51";"50";"1";"0";"457132";"391157"
"V4mis2";"SILVA (only NR);Bacteria;Planctomycetota;Planctomycetes;Isosphaerales;Isosphaeraceae;Candidatus Nostocoida;";"84.6";"14.4";"13";"13";"11";"2";"0";"457170";"391196"
"V4mis2";"SILVA (only NR);Bacteria;Planctomycetota;Planctomycetes;Isosphaerales;Isosphaeraceae;Isosphaera;";"100.0";"14.4";"16";"16";"16";"0";"0";"457167";"391191"
"V4mis2";"SILVA (only NR);Bacteria;Planctomycetota;Planctomycetes;Isosphaerales;Isosphaeraceae;Paludisphaera;";"100.0";"14.4";"20";"20";"20";"0";"0";"457163";"391187"
"V4mis2";"SILVA (only NR);Bacteria;Planctomycetota;Planctomycetes;Isosphaerales;Isosphaeraceae;Singulisphaera;";"97.3";"14.4";"73";"73";"71";"2";"0";"457110";"391136"
"V4mis2";"SILVA (only NR);Bacteria;Planctomycetota;Planctomycetes;Isosphaerales;Isosphaeraceae;Tundrisphaera;";"95.4";"14.4";"65";"65";"62";"3";"0";"457118";"391145"
"V4mis2";"SILVA (only NR);Bacteria;Planctomycetota;Planctomycetes;Isosphaerales;Isosphaeraceae;uncultured;";"95.3";"14.4";"192";"192";"183";"9";"0";"456991";"391024"
"V4mis2";"SILVA (only NR);Bacteria;Planctomycetota;Planctomycetes;Pirellulales;";"93.5";"14.5";"2487";"2487";"2325";"162";"0";"454696";"388882"
"V4mis2";"SILVA (only NR);Bacteria;Planctomycetota;Planctomycetes;Pirellulales;Pirellulaceae;";"93.5";"14.5";"2487";"2487";"2325";"162";"0";"454696";"388882"
"V4mis2";"SILVA (only NR);Bacteria;Planctomycetota;Planctomycetes;Pirellulales;Pirellulaceae;Blastopirellula;";"92.3";"14.4";"324";"324";"299";"25";"0";"456859";"390908"
"V4mis2";"SILVA (only NR);Bacteria;Planctomycetota;Planctomycetes;Pirellulales;Pirellulaceae;Bythopirellula;";"95.8";"14.4";"24";"24";"23";"1";"0";"457159";"391184"
"V4mis2";"SILVA (only NR);Bacteria;Planctomycetota;Planctomycetes;Pirellulales;Pirellulaceae;CPla-4 termite group;";"100.0";"14.4";"10";"10";"10";"0";"0";"457173";"391197"
"V4mis2";"SILVA (only NR);Bacteria;Planctomycetota;Planctomycetes;Pirellulales;Pirellulaceae;Candidatus Anammoximicrobium;";"100.0";"14.4";"12";"12";"12";"0";"0";"457171";"391195"
"V4mis2";"SILVA (only NR);Bacteria;Planctomycetota;Planctomycetes;Pirellulales;Pirellulaceae;Pir1 lineage;";"100.0";"14.4";"7";"7";"7";"0";"0";"457176";"391200"
"V4mis2";"SILVA (only NR);Bacteria;Planctomycetota;Planctomycetes;Pirellulales;Pirellulaceae;Pir2 lineage;";"100.0";"14.4";"10";"10";"10";"0";"0";"457173";"391197"
"V4mis2";"SILVA (only NR);Bacteria;Planctomycetota;Planctomycetes;Pirellulales;Pirellulaceae;Pir3 lineage;";"100.0";"14.4";"7";"7";"7";"0";"0";"457176";"391200"
"V4mis2";"SILVA (only NR);Bacteria;Planctomycetota;Planctomycetes;Pirellulales;Pirellulaceae;Pir4 lineage;";"93.2";"14.4";"546";"546";"509";"37";"0";"456637";"390698"
"V4mis2";"SILVA (only NR);Bacteria;Planctomycetota;Planctomycetes;Pirellulales;Pirellulaceae;Pirellula;";"95.1";"14.4";"412";"412";"392";"20";"0";"456771";"390815"
"V4mis2";"SILVA (only NR);Bacteria;Planctomycetota;Planctomycetes;Pirellulales;Pirellulaceae;Rhodopirellula;";"94.5";"14.4";"292";"292";"276";"16";"0";"456891";"390931"
"V4mis2";"SILVA (only NR);Bacteria;Planctomycetota;Planctomycetes;Pirellulales;Pirellulaceae;Roseimaritima;";"88.9";"14.4";"9";"9";"8";"1";"0";"457174";"391199"
"V4mis2";"SILVA (only NR);Bacteria;Planctomycetota;Planctomycetes;Pirellulales;Pirellulaceae;Rubripirellula;";"77.8";"14.4";"54";"54";"42";"12";"0";"457129";"391165"
"V4mis2";"SILVA (only NR);Bacteria;Planctomycetota;Planctomycetes;Pirellulales;Pirellulaceae;Termite planctomycete cluster;";"93.7";"14.4";"63";"63";"59";"4";"0";"457120";"391148"
"V4mis2";"SILVA (only NR);Bacteria;Planctomycetota;Planctomycetes;Pirellulales;Pirellulaceae;Thermogutta;";"100.0";"14.4";"17";"17";"17";"0";"0";"457166";"391190"
"V4mis2";"SILVA (only NR);Bacteria;Planctomycetota;Planctomycetes;Pirellulales;Pirellulaceae;Thermostilla;";"100.0";"14.4";"1";"1";"1";"0";"0";"457182";"391206"
"V4mis2";"SILVA (only NR);Bacteria;Planctomycetota;Planctomycetes;Pirellulales;Pirellulaceae;p-1088-a5 gut group;";"100.0";"14.4";"41";"41";"41";"0";"0";"457142";"391166"
"V4mis2";"SILVA (only NR);Bacteria;Planctomycetota;Planctomycetes;Pirellulales;Pirellulaceae;uncultured;";"93.0";"14.4";"654";"654";"608";"46";"0";"456529";"390599"
"V4mis2";"SILVA (only NR);Bacteria;Planctomycetota;Planctomycetes;Planctomycetales;";"93.3";"14.4";"956";"956";"892";"64";"0";"456227";"390315"
"V4mis2";"SILVA (only NR);Bacteria;Planctomycetota;Planctomycetes;Planctomycetales;Gimesiaceae;";"90.9";"14.4";"121";"121";"110";"11";"0";"457062";"391097"
"V4mis2";"SILVA (only NR);Bacteria;Planctomycetota;Planctomycetes;Planctomycetales;Gimesiaceae;Gimesia;";"83.3";"14.4";"12";"12";"10";"2";"0";"457171";"391197"
"V4mis2";"SILVA (only NR);Bacteria;Planctomycetota;Planctomycetes;Planctomycetales;Gimesiaceae;uncultured;";"91.7";"14.4";"109";"109";"100";"9";"0";"457074";"391107"
"V4mis2";"SILVA (only NR);Bacteria;Planctomycetota;Planctomycetes;Planctomycetales;Rubinisphaeraceae;";"93.2";"14.4";"385";"385";"359";"26";"0";"456798";"390848"
"V4mis2";"SILVA (only NR);Bacteria;Planctomycetota;Planctomycetes;Planctomycetales;Rubinisphaeraceae;Fuerstia;";"100.0";"14.4";"18";"18";"18";"0";"0";"457165";"391189"
"V4mis2";"SILVA (only NR);Bacteria;Planctomycetota;Planctomycetes;Planctomycetales;Rubinisphaeraceae;Planctomicrobium;";"93.5";"14.4";"77";"77";"72";"5";"0";"457106";"391135"
"V4mis2";"SILVA (only NR);Bacteria;Planctomycetota;Planctomycetes;Planctomycetales;Rubinisphaeraceae;Rubinisphaera;";"96.2";"14.4";"26";"26";"25";"1";"0";"457157";"391182"
"V4mis2";"SILVA (only NR);Bacteria;Planctomycetota;Planctomycetes;Planctomycetales;Rubinisphaeraceae;SH-PL14;";"92.9";"14.4";"98";"98";"91";"7";"0";"457085";"391116"
"V4mis2";"SILVA (only NR);Bacteria;Planctomycetota;Planctomycetes;Planctomycetales;Rubinisphaeraceae;uncultured;";"92.1";"14.4";"165";"165";"152";"13";"0";"457018";"391055"
"V4mis2";"SILVA (only NR);Bacteria;Planctomycetota;Planctomycetes;Planctomycetales;Schlesneriaceae;";"98.3";"14.4";"116";"116";"114";"2";"0";"457067";"391093"
"V4mis2";"SILVA (only NR);Bacteria;Planctomycetota;Planctomycetes;Planctomycetales;Schlesneriaceae;Planctopirus;";"98.6";"14.4";"69";"69";"68";"1";"0";"457114";"391139"
"V4mis2";"SILVA (only NR);Bacteria;Planctomycetota;Planctomycetes;Planctomycetales;Schlesneriaceae;Schlesneria;";"97.8";"14.4";"46";"46";"45";"1";"0";"457137";"391162"
"V4mis2";"SILVA (only NR);Bacteria;Planctomycetota;Planctomycetes;Planctomycetales;uncultured;";"92.7";"14.4";"331";"331";"307";"24";"0";"456852";"390900"
"V4mis2";"SILVA (only NR);Bacteria;Planctomycetota;Planctomycetes;uncultured;";"98.5";"14.4";"66";"66";"65";"1";"0";"457117";"391142"
"V4mis2";"SILVA (only NR);Bacteria;Planctomycetota;SGST604;";"100.0";"14.4";"9";"9";"9";"0";"0";"457174";"391198"
"V4mis2";"SILVA (only NR);Bacteria;Planctomycetota;SPG12-343-353-B69;";"100.0";"14.4";"7";"7";"7";"0";"0";"457176";"391200"
"V4mis2";"SILVA (only NR);Bacteria;Planctomycetota;vadinHA49;";"97.3";"14.4";"330";"330";"321";"9";"0";"456853";"390886"
"V4mis2";"SILVA (only NR);Bacteria;Poribacteria;";"92.3";"14.4";"52";"52";"48";"4";"0";"457131";"391159"
"V4mis2";"SILVA (only NR);Bacteria;Proteobacteria;";"95.0";"17.4";"109146";"109140";"103632";"5508";"6";"348043";"287575"
"V4mis2";"SILVA (only NR);Bacteria;Proteobacteria;Alphaproteobacteria;";"96.0";"15.3";"33787";"33781";"32442";"1339";"6";"423402";"358765"
"V4mis2";"SILVA (only NR);Bacteria;Proteobacteria;Alphaproteobacteria;AT-s3-44;";"96.3";"14.4";"82";"82";"79";"3";"0";"457101";"391128"
"V4mis2";"SILVA (only NR);Bacteria;Proteobacteria;Alphaproteobacteria;Acetobacterales;";"97.8";"14.5";"1558";"1558";"1523";"35";"0";"455625";"389684"
"V4mis2";"SILVA (only NR);Bacteria;Proteobacteria;Alphaproteobacteria;Acetobacterales;Acetobacteraceae;";"97.7";"14.5";"1548";"1548";"1513";"35";"0";"455635";"389694"
"V4mis2";"SILVA (only NR);Bacteria;Proteobacteria;Alphaproteobacteria;Acetobacterales;Acetobacteraceae;Acetobacter;";"97.2";"14.4";"246";"246";"239";"7";"0";"456937";"390968"
"V4mis2";"SILVA (only NR);Bacteria;Proteobacteria;Alphaproteobacteria;Acetobacterales;Acetobacteraceae;Acidicaldus;";"100.0";"14.4";"25";"25";"25";"0";"0";"457158";"391182"
"V4mis2";"SILVA (only NR);Bacteria;Proteobacteria;Alphaproteobacteria;Acetobacterales;Acetobacteraceae;Acidiphilium;";"98.0";"14.4";"151";"151";"148";"3";"0";"457032";"391059"
"V4mis2";"SILVA (only NR);Bacteria;Proteobacteria;Alphaproteobacteria;Acetobacterales;Acetobacteraceae;Acidisoma;";"100.0";"14.4";"15";"15";"15";"0";"0";"457168";"391192"
"V4mis2";"SILVA (only NR);Bacteria;Proteobacteria;Alphaproteobacteria;Acetobacterales;Acetobacteraceae;Acidisphaera;";"100.0";"14.4";"12";"12";"12";"0";"0";"457171";"391195"
"V4mis2";"SILVA (only NR);Bacteria;Proteobacteria;Alphaproteobacteria;Acetobacterales;Acetobacteraceae;Acidocella;";"100.0";"14.4";"32";"32";"32";"0";"0";"457151";"391175"
"V4mis2";"SILVA (only NR);Bacteria;Proteobacteria;Alphaproteobacteria;Acetobacterales;Acetobacteraceae;Acidomonas;";"100.0";"14.4";"8";"8";"8";"0";"0";"457175";"391199"
"V4mis2";"SILVA (only NR);Bacteria;Proteobacteria;Alphaproteobacteria;Acetobacterales;Acetobacteraceae;Ameyamaea;";"100.0";"14.4";"5";"5";"5";"0";"0";"457178";"391202"
"V4mis2";"SILVA (only NR);Bacteria;Proteobacteria;Alphaproteobacteria;Acetobacterales;Acetobacteraceae;Asaia;";"94.0";"14.4";"50";"50";"47";"3";"0";"457133";"391160"
"V4mis2";"SILVA (only NR);Bacteria;Proteobacteria;Alphaproteobacteria;Acetobacterales;Acetobacteraceae;Belnapia;";"91.7";"14.4";"12";"12";"11";"1";"0";"457171";"391196"
"V4mis2";"SILVA (only NR);Bacteria;Proteobacteria;Alphaproteobacteria;Acetobacterales;Acetobacteraceae;Bombella;";"100.0";"14.4";"11";"11";"11";"0";"0";"457172";"391196"
"V4mis2";"SILVA (only NR);Bacteria;Proteobacteria;Alphaproteobacteria;Acetobacterales;Acetobacteraceae;Commensalibacter;";"94.1";"14.4";"17";"17";"16";"1";"0";"457166";"391191"
"V4mis2";"SILVA (only NR);Bacteria;Proteobacteria;Alphaproteobacteria;Acetobacterales;Acetobacteraceae;Craurococcus-Caldovatus;";"97.1";"14.4";"35";"35";"34";"1";"0";"457148";"391173"
"V4mis2";"SILVA (only NR);Bacteria;Proteobacteria;Alphaproteobacteria;Acetobacterales;Acetobacteraceae;Crenalkalicoccus;";"100.0";"14.4";"1";"1";"1";"0";"0";"457182";"391206"
"V4mis2";"SILVA (only NR);Bacteria;Proteobacteria;Alphaproteobacteria;Acetobacterales;Acetobacteraceae;Endobacter;";"100.0";"14.4";"13";"13";"13";"0";"0";"457170";"391194"
"V4mis2";"SILVA (only NR);Bacteria;Proteobacteria;Alphaproteobacteria;Acetobacterales;Acetobacteraceae;Gluconacetobacter;";"96.9";"14.4";"64";"64";"62";"2";"0";"457119";"391145"
"V4mis2";"SILVA (only NR);Bacteria;Proteobacteria;Alphaproteobacteria;Acetobacterales;Acetobacteraceae;Gluconobacter;";"100.0";"14.4";"125";"125";"125";"0";"0";"457058";"391082"
"V4mis2";"SILVA (only NR);Bacteria;Proteobacteria;Alphaproteobacteria;Acetobacterales;Acetobacteraceae;Granulibacter;";"100.0";"14.4";"12";"12";"12";"0";"0";"457171";"391195"
"V4mis2";"SILVA (only NR);Bacteria;Proteobacteria;Alphaproteobacteria;Acetobacterales;Acetobacteraceae;Humitalea;";"100.0";"14.4";"1";"1";"1";"0";"0";"457182";"391206"
"V4mis2";"SILVA (only NR);Bacteria;Proteobacteria;Alphaproteobacteria;Acetobacterales;Acetobacteraceae;Komagataeibacter;";"100.0";"14.4";"152";"152";"152";"0";"0";"457031";"391055"
"V4mis2";"SILVA (only NR);Bacteria;Proteobacteria;Alphaproteobacteria;Acetobacterales;Acetobacteraceae;Kozakia;";"90.9";"14.4";"11";"11";"10";"1";"0";"457172";"391197"
"V4mis2";"SILVA (only NR);Bacteria;Proteobacteria;Alphaproteobacteria;Acetobacterales;Acetobacteraceae;Muricoccus;";"50.0";"14.4";"2";"2";"1";"1";"0";"457181";"391206"
"V4mis2";"SILVA (only NR);Bacteria;Proteobacteria;Alphaproteobacteria;Acetobacterales;Acetobacteraceae;Neoasaia;";"100.0";"14.4";"4";"4";"4";"0";"0";"457179";"391203"
"V4mis2";"SILVA (only NR);Bacteria;Proteobacteria;Alphaproteobacteria;Acetobacterales;Acetobacteraceae;Neokomagataea;";"100.0";"14.4";"3";"3";"3";"0";"0";"457180";"391204"
"V4mis2";"SILVA (only NR);Bacteria;Proteobacteria;Alphaproteobacteria;Acetobacterales;Acetobacteraceae;Nguyenibacter;";"100.0";"14.4";"2";"2";"2";"0";"0";"457181";"391205"
"V4mis2";"SILVA (only NR);Bacteria;Proteobacteria;Alphaproteobacteria;Acetobacterales;Acetobacteraceae;Paracraurococcus;";"100.0";"14.4";"2";"2";"2";"0";"0";"457181";"391205"
"V4mis2";"SILVA (only NR);Bacteria;Proteobacteria;Alphaproteobacteria;Acetobacterales;Acetobacteraceae;Rhodopila;";"100.0";"14.4";"9";"9";"9";"0";"0";"457174";"391198"
"V4mis2";"SILVA (only NR);Bacteria;Proteobacteria;Alphaproteobacteria;Acetobacterales;Acetobacteraceae;Rhodovarius;";"100.0";"14.4";"19";"19";"19";"0";"0";"457164";"391188"
"V4mis2";"SILVA (only NR);Bacteria;Proteobacteria;Alphaproteobacteria;Acetobacterales;Acetobacteraceae;Rhodovastum;";"95.2";"14.4";"21";"21";"20";"1";"0";"457162";"391187"
"V4mis2";"SILVA (only NR);Bacteria;Proteobacteria;Alphaproteobacteria;Acetobacterales;Acetobacteraceae;Roseococcus;";"90.5";"14.4";"21";"21";"19";"2";"0";"457162";"391188"
"V4mis2";"SILVA (only NR);Bacteria;Proteobacteria;Alphaproteobacteria;Acetobacterales;Acetobacteraceae;Roseomonas;";"95.9";"14.4";"193";"193";"185";"8";"0";"456990";"391022"
"V4mis2";"SILVA (only NR);Bacteria;Proteobacteria;Alphaproteobacteria;Acetobacterales;Acetobacteraceae;Rubritepida;";"100.0";"14.4";"13";"13";"13";"0";"0";"457170";"391194"
"V4mis2";"SILVA (only NR);Bacteria;Proteobacteria;Alphaproteobacteria;Acetobacterales;Acetobacteraceae;Saccharibacter;";"100.0";"14.4";"5";"5";"5";"0";"0";"457178";"391202"
"V4mis2";"SILVA (only NR);Bacteria;Proteobacteria;Alphaproteobacteria;Acetobacterales;Acetobacteraceae;Siccirubricoccus;";"100.0";"14.4";"1";"1";"1";"0";"0";"457182";"391206"
"V4mis2";"SILVA (only NR);Bacteria;Proteobacteria;Alphaproteobacteria;Acetobacterales;Acetobacteraceae;Swaminathania;";"100.0";"14.4";"4";"4";"4";"0";"0";"457179";"391203"
"V4mis2";"SILVA (only NR);Bacteria;Proteobacteria;Alphaproteobacteria;Acetobacterales;Acetobacteraceae;Tanticharoenia;";"100.0";"14.4";"5";"5";"5";"0";"0";"457178";"391202"
"V4mis2";"SILVA (only NR);Bacteria;Proteobacteria;Alphaproteobacteria;Acetobacterales;Acetobacteraceae;uncultured;";"98.3";"14.4";"234";"234";"230";"4";"0";"456949";"390977"
"V4mis2";"SILVA (only NR);Bacteria;Proteobacteria;Alphaproteobacteria;Acetobacterales;Elioraeaceae;";"100.0";"14.4";"6";"6";"6";"0";"0";"457177";"391201"
"V4mis2";"SILVA (only NR);Bacteria;Proteobacteria;Alphaproteobacteria;Acetobacterales;Elioraeaceae;Elioraea;";"100.0";"14.4";"6";"6";"6";"0";"0";"457177";"391201"
"V4mis2";"SILVA (only NR);Bacteria;Proteobacteria;Alphaproteobacteria;Alphaproteobacteria Incertae Sedis;";"94.2";"14.4";"52";"52";"49";"3";"0";"457131";"391158"
"V4mis2";"SILVA (only NR);Bacteria;Proteobacteria;Alphaproteobacteria;Alphaproteobacteria Incertae Sedis;Unknown Family;";"94.2";"14.4";"52";"52";"49";"3";"0";"457131";"391158"
"V4mis2";"SILVA (only NR);Bacteria;Proteobacteria;Alphaproteobacteria;Alphaproteobacteria Incertae Sedis;Unknown Family;Acuticoccus;";"100.0";"14.4";"15";"15";"15";"0";"0";"457168";"391192"
"V4mis2";"SILVA (only NR);Bacteria;Proteobacteria;Alphaproteobacteria;Alphaproteobacteria Incertae Sedis;Unknown Family;Neomegalonema;";"88.9";"14.4";"9";"9";"8";"1";"0";"457174";"391199"
"V4mis2";"SILVA (only NR);Bacteria;Proteobacteria;Alphaproteobacteria;Alphaproteobacteria Incertae Sedis;Unknown Family;uncultured;";"92.3";"14.4";"26";"26";"24";"2";"0";"457157";"391183"
"V4mis2";"SILVA (only NR);Bacteria;Proteobacteria;Alphaproteobacteria;Azospirillales;";"93.4";"14.4";"499";"499";"466";"33";"0";"456684";"390741"
"V4mis2";"SILVA (only NR);Bacteria;Proteobacteria;Alphaproteobacteria;Azospirillales;Azospirillaceae;";"92.8";"14.4";"430";"430";"399";"31";"0";"456753";"390808"
"V4mis2";"SILVA (only NR);Bacteria;Proteobacteria;Alphaproteobacteria;Azospirillales;Azospirillaceae;Azospirillum;";"94.1";"14.4";"286";"286";"269";"17";"0";"456897";"390938"
"V4mis2";"SILVA (only NR);Bacteria;Proteobacteria;Alphaproteobacteria;Azospirillales;Azospirillaceae;Desertibacter;";"100.0";"14.4";"3";"3";"3";"0";"0";"457180";"391204"
"V4mis2";"SILVA (only NR);Bacteria;Proteobacteria;Alphaproteobacteria;Azospirillales;Azospirillaceae;Nitrospirillum;";"100.0";"14.4";"17";"17";"17";"0";"0";"457166";"391190"
"V4mis2";"SILVA (only NR);Bacteria;Proteobacteria;Alphaproteobacteria;Azospirillales;Azospirillaceae;Niveispirillum;";"88.2";"14.4";"34";"34";"30";"4";"0";"457149";"391177"
"V4mis2";"SILVA (only NR);Bacteria;Proteobacteria;Alphaproteobacteria;Azospirillales;Azospirillaceae;Rhodocista;";"100.0";"14.4";"5";"5";"5";"0";"0";"457178";"391202"
"V4mis2";"SILVA (only NR);Bacteria;Proteobacteria;Alphaproteobacteria;Azospirillales;Azospirillaceae;Skermanella;";"90.9";"14.4";"66";"66";"60";"6";"0";"457117";"391147"
"V4mis2";"SILVA (only NR);Bacteria;Proteobacteria;Alphaproteobacteria;Azospirillales;Azospirillaceae;uncultured;";"75.0";"14.4";"16";"16";"12";"4";"0";"457167";"391195"
"V4mis2";"SILVA (only NR);Bacteria;Proteobacteria;Alphaproteobacteria;Azospirillales;Azospirillales Incertae Sedis;";"100.0";"14.4";"12";"12";"12";"0";"0";"457171";"391195"
"V4mis2";"SILVA (only NR);Bacteria;Proteobacteria;Alphaproteobacteria;Azospirillales;Azospirillales Incertae Sedis;Stella;";"100.0";"14.4";"12";"12";"12";"0";"0";"457171";"391195"
"V4mis2";"SILVA (only NR);Bacteria;Proteobacteria;Alphaproteobacteria;Azospirillales;Inquilinaceae;";"97.1";"14.4";"35";"35";"34";"1";"0";"457148";"391173"
"V4mis2";"SILVA (only NR);Bacteria;Proteobacteria;Alphaproteobacteria;Azospirillales;Inquilinaceae;Inquilinus;";"97.1";"14.4";"35";"35";"34";"1";"0";"457148";"391173"
"V4mis2";"SILVA (only NR);Bacteria;Proteobacteria;Alphaproteobacteria;Azospirillales;uncultured;";"95.5";"14.4";"22";"22";"21";"1";"0";"457161";"391186"
"V4mis2";"SILVA (only NR);Bacteria;Proteobacteria;Alphaproteobacteria;Caedibacterales;";"90.9";"14.4";"22";"22";"20";"2";"0";"457161";"391187"
"V4mis2";"SILVA (only NR);Bacteria;Proteobacteria;Alphaproteobacteria;Caedibacterales;Caedibacteraceae;";"90.9";"14.4";"22";"22";"20";"2";"0";"457161";"391187"
"V4mis2";"SILVA (only NR);Bacteria;Proteobacteria;Alphaproteobacteria;Caedibacterales;Caedibacteraceae;Caedibacter;";"91.7";"14.4";"12";"12";"11";"1";"0";"457171";"391196"
"V4mis2";"SILVA (only NR);Bacteria;Proteobacteria;Alphaproteobacteria;Caedibacterales;Caedibacteraceae;Candidatus Nucleicultrix;";"80.0";"14.4";"5";"5";"4";"1";"0";"457178";"391203"
"V4mis2";"SILVA (only NR);Bacteria;Proteobacteria;Alphaproteobacteria;Caedibacterales;Caedibacteraceae;uncultured;";"100.0";"14.4";"5";"5";"5";"0";"0";"457178";"391202"
"V4mis2";"SILVA (only NR);Bacteria;Proteobacteria;Alphaproteobacteria;Caulobacterales;";"96.1";"14.5";"1775";"1775";"1706";"69";"0";"455408";"389501"
"V4mis2";"SILVA (only NR);Bacteria;Proteobacteria;Alphaproteobacteria;Caulobacterales;Caulobacteraceae;";"95.4";"14.5";"1097";"1097";"1047";"50";"0";"456086";"390160"
"V4mis2";"SILVA (only NR);Bacteria;Proteobacteria;Alphaproteobacteria;Caulobacterales;Caulobacteraceae;Asticcacaulis;";"93.3";"14.4";"45";"45";"42";"3";"0";"457138";"391165"
"V4mis2";"SILVA (only NR);Bacteria;Proteobacteria;Alphaproteobacteria;Caulobacterales;Caulobacteraceae;Brevundimonas;";"93.5";"14.4";"541";"541";"506";"35";"0";"456642";"390701"
"V4mis2";"SILVA (only NR);Bacteria;Proteobacteria;Alphaproteobacteria;Caulobacterales;Caulobacteraceae;Caulobacter;";"99.4";"14.4";"177";"177";"176";"1";"0";"457006";"391031"
"V4mis2";"SILVA (only NR);Bacteria;Proteobacteria;Alphaproteobacteria;Caulobacterales;Caulobacteraceae;PMMR1;";"100.0";"14.4";"22";"22";"22";"0";"0";"457161";"391185"
"V4mis2";"SILVA (only NR);Bacteria;Proteobacteria;Alphaproteobacteria;Caulobacterales;Caulobacteraceae;Phenylobacterium;";"95.4";"14.4";"173";"173";"165";"8";"0";"457010";"391042"
"V4mis2";"SILVA (only NR);Bacteria;Proteobacteria;Alphaproteobacteria;Caulobacterales;Caulobacteraceae;uncultured;";"97.8";"14.4";"136";"136";"133";"3";"0";"457047";"391074"
"V4mis2";"SILVA (only NR);Bacteria;Proteobacteria;Alphaproteobacteria;Caulobacterales;Hyphomonadaceae;";"97.9";"14.4";"569";"569";"557";"12";"0";"456614";"390650"
"V4mis2";"SILVA (only NR);Bacteria;Proteobacteria;Alphaproteobacteria;Caulobacterales;Hyphomonadaceae;Algimonas;";"100.0";"14.4";"11";"11";"11";"0";"0";"457172";"391196"
"V4mis2";"SILVA (only NR);Bacteria;Proteobacteria;Alphaproteobacteria;Caulobacterales;Hyphomonadaceae;Euryhalocaulis;";"100.0";"14.4";"8";"8";"8";"0";"0";"457175";"391199"
"V4mis2";"SILVA (only NR);Bacteria;Proteobacteria;Alphaproteobacteria;Caulobacterales;Hyphomonadaceae;Fretibacter;";"100.0";"14.4";"2";"2";"2";"0";"0";"457181";"391205"
"V4mis2";"SILVA (only NR);Bacteria;Proteobacteria;Alphaproteobacteria;Caulobacterales;Hyphomonadaceae;Glycocaulis;";"100.0";"14.4";"3";"3";"3";"0";"0";"457180";"391204"
"V4mis2";"SILVA (only NR);Bacteria;Proteobacteria;Alphaproteobacteria;Caulobacterales;Hyphomonadaceae;Hellea;";"100.0";"14.4";"9";"9";"9";"0";"0";"457174";"391198"
"V4mis2";"SILVA (only NR);Bacteria;Proteobacteria;Alphaproteobacteria;Caulobacterales;Hyphomonadaceae;Henriciella;";"100.0";"14.4";"15";"15";"15";"0";"0";"457168";"391192"
"V4mis2";"SILVA (only NR);Bacteria;Proteobacteria;Alphaproteobacteria;Caulobacterales;Hyphomonadaceae;Hirschia;";"96.7";"14.4";"60";"60";"58";"2";"0";"457123";"391149"
"V4mis2";"SILVA (only NR);Bacteria;Proteobacteria;Alphaproteobacteria;Caulobacterales;Hyphomonadaceae;Hyphobacterium;";"90.0";"14.4";"10";"10";"9";"1";"0";"457173";"391198"
"V4mis2";"SILVA (only NR);Bacteria;Proteobacteria;Alphaproteobacteria;Caulobacterales;Hyphomonadaceae;Hyphomonas;";"97.2";"14.4";"106";"106";"103";"3";"0";"457077";"391104"
"V4mis2";"SILVA (only NR);Bacteria;Proteobacteria;Alphaproteobacteria;Caulobacterales;Hyphomonadaceae;Litorimonas;";"100.0";"14.4";"12";"12";"12";"0";"0";"457171";"391195"
"V4mis2";"SILVA (only NR);Bacteria;Proteobacteria;Alphaproteobacteria;Caulobacterales;Hyphomonadaceae;Maricaulis;";"100.0";"14.4";"30";"30";"30";"0";"0";"457153";"391177"
"V4mis2";"SILVA (only NR);Bacteria;Proteobacteria;Alphaproteobacteria;Caulobacterales;Hyphomonadaceae;Oceanicaulis;";"98.0";"14.4";"51";"51";"50";"1";"0";"457132";"391157"
"V4mis2";"SILVA (only NR);Bacteria;Proteobacteria;Alphaproteobacteria;Caulobacterales;Hyphomonadaceae;Ponticaulis;";"100.0";"14.4";"9";"9";"9";"0";"0";"457174";"391198"
"V4mis2";"SILVA (only NR);Bacteria;Proteobacteria;Alphaproteobacteria;Caulobacterales;Hyphomonadaceae;Robiginitomaculum;";"100.0";"14.4";"27";"27";"27";"0";"0";"457156";"391180"
"V4mis2";"SILVA (only NR);Bacteria;Proteobacteria;Alphaproteobacteria;Caulobacterales;Hyphomonadaceae;SWB02;";"99.0";"14.4";"99";"99";"98";"1";"0";"457084";"391109"
"V4mis2";"SILVA (only NR);Bacteria;Proteobacteria;Alphaproteobacteria;Caulobacterales;Hyphomonadaceae;UKL13-1;";"100.0";"14.4";"9";"9";"9";"0";"0";"457174";"391198"
"V4mis2";"SILVA (only NR);Bacteria;Proteobacteria;Alphaproteobacteria;Caulobacterales;Hyphomonadaceae;Woodsholea;";"100.0";"14.4";"2";"2";"2";"0";"0";"457181";"391205"
"V4mis2";"SILVA (only NR);Bacteria;Proteobacteria;Alphaproteobacteria;Caulobacterales;Hyphomonadaceae;uncultured;";"96.1";"14.4";"103";"103";"99";"4";"0";"457080";"391108"
"V4mis2";"SILVA (only NR);Bacteria;Proteobacteria;Alphaproteobacteria;Caulobacterales;Parvularculaceae;";"93.3";"14.4";"104";"104";"97";"7";"0";"457079";"391110"
"V4mis2";"SILVA (only NR);Bacteria;Proteobacteria;Alphaproteobacteria;Caulobacterales;Parvularculaceae;Amphiplicatus;";"89.7";"14.4";"39";"39";"35";"4";"0";"457144";"391172"
"V4mis2";"SILVA (only NR);Bacteria;Proteobacteria;Alphaproteobacteria;Caulobacterales;Parvularculaceae;Hyphococcus;";"100.0";"14.4";"10";"10";"10";"0";"0";"457173";"391197"
"V4mis2";"SILVA (only NR);Bacteria;Proteobacteria;Alphaproteobacteria;Caulobacterales;Parvularculaceae;Marinicaulis;";"95.0";"14.4";"20";"20";"19";"1";"0";"457163";"391188"
"V4mis2";"SILVA (only NR);Bacteria;Proteobacteria;Alphaproteobacteria;Caulobacterales;Parvularculaceae;Parvularcula;";"95.7";"14.4";"23";"23";"22";"1";"0";"457160";"391185"
"V4mis2";"SILVA (only NR);Bacteria;Proteobacteria;Alphaproteobacteria;Caulobacterales;Parvularculaceae;uncultured;";"91.7";"14.4";"12";"12";"11";"1";"0";"457171";"391196"
"V4mis2";"SILVA (only NR);Bacteria;Proteobacteria;Alphaproteobacteria;Caulobacterales;uncultured;";"100.0";"14.4";"5";"5";"5";"0";"0";"457178";"391202"
"V4mis2";"SILVA (only NR);Bacteria;Proteobacteria;Alphaproteobacteria;Defluviicoccales;";"96.7";"14.4";"334";"334";"323";"11";"0";"456849";"390884"
"V4mis2";"SILVA (only NR);Bacteria;Proteobacteria;Alphaproteobacteria;Defluviicoccales;Defluviicoccaceae;";"98.7";"14.4";"75";"75";"74";"1";"0";"457108";"391133"
"V4mis2";"SILVA (only NR);Bacteria;Proteobacteria;Alphaproteobacteria;Defluviicoccales;Defluviicoccaceae;Defluviicoccus;";"98.7";"14.4";"75";"75";"74";"1";"0";"457108";"391133"
"V4mis2";"SILVA (only NR);Bacteria;Proteobacteria;Alphaproteobacteria;Defluviicoccales;uncultured;";"96.1";"14.4";"259";"259";"249";"10";"0";"456924";"390958"
"V4mis2";"SILVA (only NR);Bacteria;Proteobacteria;Alphaproteobacteria;Dongiales;";"91.0";"14.4";"134";"134";"122";"12";"0";"457049";"391085"
"V4mis2";"SILVA (only NR);Bacteria;Proteobacteria;Alphaproteobacteria;Dongiales;Dongiaceae;";"91.0";"14.4";"134";"134";"122";"12";"0";"457049";"391085"
"V4mis2";"SILVA (only NR);Bacteria;Proteobacteria;Alphaproteobacteria;Dongiales;Dongiaceae;Dongia;";"91.0";"14.4";"134";"134";"122";"12";"0";"457049";"391085"
"V4mis2";"SILVA (only NR);Bacteria;Proteobacteria;Alphaproteobacteria;Dstr-E11;";"75.0";"14.4";"12";"12";"9";"3";"0";"457171";"391198"
"V4mis2";"SILVA (only NR);Bacteria;Proteobacteria;Alphaproteobacteria;Elsterales;";"96.3";"14.4";"300";"300";"289";"11";"0";"456883";"390918"
"V4mis2";"SILVA (only NR);Bacteria;Proteobacteria;Alphaproteobacteria;Elsterales;Elsteraceae;";"96.0";"14.4";"50";"50";"48";"2";"0";"457133";"391159"
"V4mis2";"SILVA (only NR);Bacteria;Proteobacteria;Alphaproteobacteria;Elsterales;Elsteraceae;Aliidongia;";"100.0";"14.4";"2";"2";"2";"0";"0";"457181";"391205"
"V4mis2";"SILVA (only NR);Bacteria;Proteobacteria;Alphaproteobacteria;Elsterales;Elsteraceae;Elstera;";"83.3";"14.4";"6";"6";"5";"1";"0";"457177";"391202"
"V4mis2";"SILVA (only NR);Bacteria;Proteobacteria;Alphaproteobacteria;Elsterales;Elsteraceae;Lacibacterium;";"100.0";"14.4";"1";"1";"1";"0";"0";"457182";"391206"
"V4mis2";"SILVA (only NR);Bacteria;Proteobacteria;Alphaproteobacteria;Elsterales;Elsteraceae;uncultured;";"97.5";"14.4";"40";"40";"39";"1";"0";"457143";"391168"
"V4mis2";"SILVA (only NR);Bacteria;Proteobacteria;Alphaproteobacteria;Elsterales;URHD0088;";"100.0";"14.4";"9";"9";"9";"0";"0";"457174";"391198"
"V4mis2";"SILVA (only NR);Bacteria;Proteobacteria;Alphaproteobacteria;Elsterales;uncultured;";"96.3";"14.4";"241";"241";"232";"9";"0";"456942";"390975"
"V4mis2";"SILVA (only NR);Bacteria;Proteobacteria;Alphaproteobacteria;Emcibacterales;";"100.0";"14.4";"3";"3";"3";"0";"0";"457180";"391204"
"V4mis2";"SILVA (only NR);Bacteria;Proteobacteria;Alphaproteobacteria;Emcibacterales;Emcibacteraceae;";"100.0";"14.4";"3";"3";"3";"0";"0";"457180";"391204"
"V4mis2";"SILVA (only NR);Bacteria;Proteobacteria;Alphaproteobacteria;Emcibacterales;Emcibacteraceae;Emcibacter;";"100.0";"14.4";"3";"3";"3";"0";"0";"457180";"391204"
"V4mis2";"SILVA (only NR);Bacteria;Proteobacteria;Alphaproteobacteria;Ferrovibrionales;";"100.0";"14.4";"30";"30";"30";"0";"0";"457153";"391177"
"V4mis2";"SILVA (only NR);Bacteria;Proteobacteria;Alphaproteobacteria;Ferrovibrionales;Ferrovibrionaceae;";"100.0";"14.4";"16";"16";"16";"0";"0";"457167";"391191"
"V4mis2";"SILVA (only NR);Bacteria;Proteobacteria;Alphaproteobacteria;Ferrovibrionales;Ferrovibrionaceae;Ferrovibrio;";"100.0";"14.4";"16";"16";"16";"0";"0";"457167";"391191"
"V4mis2";"SILVA (only NR);Bacteria;Proteobacteria;Alphaproteobacteria;Ferrovibrionales;Marinibaculum;";"100.0";"14.4";"1";"1";"1";"0";"0";"457182";"391206"
"V4mis2";"SILVA (only NR);Bacteria;Proteobacteria;Alphaproteobacteria;Ferrovibrionales;Taonella;";"100.0";"14.4";"6";"6";"6";"0";"0";"457177";"391201"
"V4mis2";"SILVA (only NR);Bacteria;Proteobacteria;Alphaproteobacteria;Ferrovibrionales;uncultured;";"100.0";"14.4";"7";"7";"7";"0";"0";"457176";"391200"
"V4mis2";"SILVA (only NR);Bacteria;Proteobacteria;Alphaproteobacteria;Holosporales;";"97.2";"14.4";"72";"72";"70";"2";"0";"457111";"391137"
"V4mis2";"SILVA (only NR);Bacteria;Proteobacteria;Alphaproteobacteria;Holosporales;Holosporaceae;";"97.2";"14.4";"72";"72";"70";"2";"0";"457111";"391137"
"V4mis2";"SILVA (only NR);Bacteria;Proteobacteria;Alphaproteobacteria;Holosporales;Holosporaceae;Candidatus Bealeia;";"87.5";"14.4";"8";"8";"7";"1";"0";"457175";"391200"
"V4mis2";"SILVA (only NR);Bacteria;Proteobacteria;Alphaproteobacteria;Holosporales;Holosporaceae;Candidatus Gortzia;";"100.0";"14.4";"4";"4";"4";"0";"0";"457179";"391203"
"V4mis2";"SILVA (only NR);Bacteria;Proteobacteria;Alphaproteobacteria;Holosporales;Holosporaceae;Candidatus Paraholospora;";"100.0";"14.4";"2";"2";"2";"0";"0";"457181";"391205"
"V4mis2";"SILVA (only NR);Bacteria;Proteobacteria;Alphaproteobacteria;Holosporales;Holosporaceae;Holospora;";"100.0";"14.4";"9";"9";"9";"0";"0";"457174";"391198"
"V4mis2";"SILVA (only NR);Bacteria;Proteobacteria;Alphaproteobacteria;Holosporales;Holosporaceae;uncultured;";"97.8";"14.4";"46";"46";"45";"1";"0";"457137";"391162"
"V4mis2";"SILVA (only NR);Bacteria;Proteobacteria;Alphaproteobacteria;Kiloniellales;";"97.2";"14.4";"361";"361";"351";"10";"0";"456822";"390856"
"V4mis2";"SILVA (only NR);Bacteria;Proteobacteria;Alphaproteobacteria;Kiloniellales;Fodinicurvataceae;";"94.7";"14.4";"75";"75";"71";"4";"0";"457108";"391136"
"V4mis2";"SILVA (only NR);Bacteria;Proteobacteria;Alphaproteobacteria;Kiloniellales;Fodinicurvataceae;Fodinicurvata;";"100.0";"14.4";"9";"9";"9";"0";"0";"457174";"391198"
"V4mis2";"SILVA (only NR);Bacteria;Proteobacteria;Alphaproteobacteria;Kiloniellales;Fodinicurvataceae;Limimonas;";"90.9";"14.4";"11";"11";"10";"1";"0";"457172";"391197"
"V4mis2";"SILVA (only NR);Bacteria;Proteobacteria;Alphaproteobacteria;Kiloniellales;Fodinicurvataceae;Rhodovibrio;";"93.3";"14.4";"30";"30";"28";"2";"0";"457153";"391179"
"V4mis2";"SILVA (only NR);Bacteria;Proteobacteria;Alphaproteobacteria;Kiloniellales;Fodinicurvataceae;uncultured;";"96.0";"14.4";"25";"25";"24";"1";"0";"457158";"391183"
"V4mis2";"SILVA (only NR);Bacteria;Proteobacteria;Alphaproteobacteria;Kiloniellales;Kiloniellaceae;";"97.9";"14.4";"286";"286";"280";"6";"0";"456897";"390927"
"V4mis2";"SILVA (only NR);Bacteria;Proteobacteria;Alphaproteobacteria;Kiloniellales;Kiloniellaceae;Kiloniella;";"100.0";"14.4";"7";"7";"7";"0";"0";"457176";"391200"
"V4mis2";"SILVA (only NR);Bacteria;Proteobacteria;Alphaproteobacteria;Kiloniellales;Kiloniellaceae;Limibacillus;";"100.0";"14.4";"11";"11";"11";"0";"0";"457172";"391196"
"V4mis2";"SILVA (only NR);Bacteria;Proteobacteria;Alphaproteobacteria;Kiloniellales;Kiloniellaceae;Pelagibius;";"100.0";"14.4";"44";"44";"44";"0";"0";"457139";"391163"
"V4mis2";"SILVA (only NR);Bacteria;Proteobacteria;Alphaproteobacteria;Kiloniellales;Kiloniellaceae;Tagaea;";"100.0";"14.4";"5";"5";"5";"0";"0";"457178";"391202"
"V4mis2";"SILVA (only NR);Bacteria;Proteobacteria;Alphaproteobacteria;Kiloniellales;Kiloniellaceae;Tistlia;";"96.7";"14.4";"30";"30";"29";"1";"0";"457153";"391178"
"V4mis2";"SILVA (only NR);Bacteria;Proteobacteria;Alphaproteobacteria;Kiloniellales;Kiloniellaceae;uncultured;";"97.4";"14.4";"189";"189";"184";"5";"0";"456994";"391023"
"V4mis2";"SILVA (only NR);Bacteria;Proteobacteria;Alphaproteobacteria;Kordiimonadales;";"95.3";"14.4";"127";"127";"121";"6";"0";"457056";"391086"
"V4mis2";"SILVA (only NR);Bacteria;Proteobacteria;Alphaproteobacteria;Kordiimonadales;Iodidimonadaceae;";"100.0";"14.4";"10";"10";"10";"0";"0";"457173";"391197"
"V4mis2";"SILVA (only NR);Bacteria;Proteobacteria;Alphaproteobacteria;Kordiimonadales;Iodidimonadaceae;Iodidimonas;";"100.0";"14.4";"10";"10";"10";"0";"0";"457173";"391197"
"V4mis2";"SILVA (only NR);Bacteria;Proteobacteria;Alphaproteobacteria;Kordiimonadales;Kordiimonadaceae;";"97.4";"14.4";"78";"78";"76";"2";"0";"457105";"391131"
"V4mis2";"SILVA (only NR);Bacteria;Proteobacteria;Alphaproteobacteria;Kordiimonadales;Kordiimonadaceae;Kordiimonas;";"97.4";"14.4";"78";"78";"76";"2";"0";"457105";"391131"
"V4mis2";"SILVA (only NR);Bacteria;Proteobacteria;Alphaproteobacteria;Kordiimonadales;Kordiimonadales Incertae Sedis;";"100.0";"14.4";"2";"2";"2";"0";"0";"457181";"391205"
"V4mis2";"SILVA (only NR);Bacteria;Proteobacteria;Alphaproteobacteria;Kordiimonadales;Kordiimonadales Incertae Sedis;Eilatimonas;";"100.0";"14.4";"2";"2";"2";"0";"0";"457181";"391205"
"V4mis2";"SILVA (only NR);Bacteria;Proteobacteria;Alphaproteobacteria;Kordiimonadales;Temperatibacteraceae;";"100.0";"14.4";"2";"2";"2";"0";"0";"457181";"391205"
"V4mis2";"SILVA (only NR);Bacteria;Proteobacteria;Alphaproteobacteria;Kordiimonadales;Temperatibacteraceae;Temperatibacter;";"100.0";"14.4";"2";"2";"2";"0";"0";"457181";"391205"
"V4mis2";"SILVA (only NR);Bacteria;Proteobacteria;Alphaproteobacteria;Kordiimonadales;uncultured;";"88.6";"14.4";"35";"35";"31";"4";"0";"457148";"391176"
"V4mis2";"SILVA (only NR);Bacteria;Proteobacteria;Alphaproteobacteria;Micavibrionales;";"97.7";"14.4";"303";"303";"296";"7";"0";"456880";"390911"
"V4mis2";"SILVA (only NR);Bacteria;Proteobacteria;Alphaproteobacteria;Micavibrionales;Micavibrionaceae;";"98.0";"14.4";"153";"153";"150";"3";"0";"457030";"391057"
"V4mis2";"SILVA (only NR);Bacteria;Proteobacteria;Alphaproteobacteria;Micavibrionales;Micavibrionaceae;Micavibrio;";"100.0";"14.4";"3";"3";"3";"0";"0";"457180";"391204"
"V4mis2";"SILVA (only NR);Bacteria;Proteobacteria;Alphaproteobacteria;Micavibrionales;Micavibrionaceae;uncultured;";"98.0";"14.4";"150";"150";"147";"3";"0";"457033";"391060"
"V4mis2";"SILVA (only NR);Bacteria;Proteobacteria;Alphaproteobacteria;Micavibrionales;uncultured;";"97.3";"14.4";"148";"148";"144";"4";"0";"457035";"391063"
"V4mis2";"SILVA (only NR);Bacteria;Proteobacteria;Alphaproteobacteria;Micropepsales;";"97.9";"14.4";"146";"146";"143";"3";"0";"457037";"391064"
"V4mis2";"SILVA (only NR);Bacteria;Proteobacteria;Alphaproteobacteria;Micropepsales;Micropepsaceae;";"97.9";"14.4";"146";"146";"143";"3";"0";"457037";"391064"
"V4mis2";"SILVA (only NR);Bacteria;Proteobacteria;Alphaproteobacteria;Micropepsales;Micropepsaceae;Micropepsis;";"100.0";"14.4";"7";"7";"7";"0";"0";"457176";"391200"
"V4mis2";"SILVA (only NR);Bacteria;Proteobacteria;Alphaproteobacteria;Micropepsales;Micropepsaceae;Rhizomicrobium;";"100.0";"14.4";"6";"6";"6";"0";"0";"457177";"391201"
"V4mis2";"SILVA (only NR);Bacteria;Proteobacteria;Alphaproteobacteria;Micropepsales;Micropepsaceae;uncultured;";"97.7";"14.4";"128";"128";"125";"3";"0";"457055";"391082"
"V4mis2";"SILVA (only NR);Bacteria;Proteobacteria;Alphaproteobacteria;NRL2;";"96.0";"14.4";"25";"25";"24";"1";"0";"457158";"391183"
"V4mis2";"SILVA (only NR);Bacteria;Proteobacteria;Alphaproteobacteria;Paracaedibacterales;";"95.9";"14.4";"146";"146";"140";"6";"0";"457037";"391067"
"V4mis2";"SILVA (only NR);Bacteria;Proteobacteria;Alphaproteobacteria;Paracaedibacterales;Paracaedibacteraceae;";"95.9";"14.4";"146";"146";"140";"6";"0";"457037";"391067"
"V4mis2";"SILVA (only NR);Bacteria;Proteobacteria;Alphaproteobacteria;Paracaedibacterales;Paracaedibacteraceae;Candidatus Captivus;";"100.0";"14.4";"20";"20";"20";"0";"0";"457163";"391187"
"V4mis2";"SILVA (only NR);Bacteria;Proteobacteria;Alphaproteobacteria;Paracaedibacterales;Paracaedibacteraceae;Candidatus Finniella;";"90.9";"14.4";"11";"11";"10";"1";"0";"457172";"391197"
"V4mis2";"SILVA (only NR);Bacteria;Proteobacteria;Alphaproteobacteria;Paracaedibacterales;Paracaedibacteraceae;Candidatus Odyssella;";"100.0";"14.4";"2";"2";"2";"0";"0";"457181";"391205"
"V4mis2";"SILVA (only NR);Bacteria;Proteobacteria;Alphaproteobacteria;Paracaedibacterales;Paracaedibacteraceae;Candidatus Paracaedibacter;";"100.0";"14.4";"34";"34";"34";"0";"0";"457149";"391173"
"V4mis2";"SILVA (only NR);Bacteria;Proteobacteria;Alphaproteobacteria;Paracaedibacterales;Paracaedibacteraceae;uncultured;";"94.7";"14.4";"76";"76";"72";"4";"0";"457107";"391135"
"V4mis2";"SILVA (only NR);Bacteria;Proteobacteria;Alphaproteobacteria;Parvibaculales;";"94.9";"14.4";"215";"215";"204";"11";"0";"456968";"391003"
"V4mis2";"SILVA (only NR);Bacteria;Proteobacteria;Alphaproteobacteria;Parvibaculales;OCS116 clade;";"93.5";"14.4";"46";"46";"43";"3";"0";"457137";"391164"
"V4mis2";"SILVA (only NR);Bacteria;Proteobacteria;Alphaproteobacteria;Parvibaculales;PS1 clade;";"93.2";"14.4";"73";"73";"68";"5";"0";"457110";"391139"
"V4mis2";"SILVA (only NR);Bacteria;Proteobacteria;Alphaproteobacteria;Parvibaculales;Parvibaculaceae;";"96.7";"14.4";"91";"91";"88";"3";"0";"457092";"391119"
"V4mis2";"SILVA (only NR);Bacteria;Proteobacteria;Alphaproteobacteria;Parvibaculales;Parvibaculaceae;Candidatus Phaeomarinobacter;";"100.0";"14.4";"1";"1";"1";"0";"0";"457182";"391206"
"V4mis2";"SILVA (only NR);Bacteria;Proteobacteria;Alphaproteobacteria;Parvibaculales;Parvibaculaceae;Mf105b01;";"100.0";"14.4";"14";"14";"14";"0";"0";"457169";"391193"
"V4mis2";"SILVA (only NR);Bacteria;Proteobacteria;Alphaproteobacteria;Parvibaculales;Parvibaculaceae;Parvibaculum;";"95.9";"14.4";"49";"49";"47";"2";"0";"457134";"391160"
"V4mis2";"SILVA (only NR);Bacteria;Proteobacteria;Alphaproteobacteria;Parvibaculales;Parvibaculaceae;Pyruvatibacter;";"100.0";"14.4";"1";"1";"1";"0";"0";"457182";"391206"
"V4mis2";"SILVA (only NR);Bacteria;Proteobacteria;Alphaproteobacteria;Parvibaculales;Parvibaculaceae;Rhodoligotrophos;";"100.0";"14.4";"5";"5";"5";"0";"0";"457178";"391202"
"V4mis2";"SILVA (only NR);Bacteria;Proteobacteria;Alphaproteobacteria;Parvibaculales;Parvibaculaceae;Tepidicaulis;";"75.0";"14.4";"4";"4";"3";"1";"0";"457179";"391204"
"V4mis2";"SILVA (only NR);Bacteria;Proteobacteria;Alphaproteobacteria;Parvibaculales;Parvibaculaceae;uncultured;";"100.0";"14.4";"12";"12";"12";"0";"0";"457171";"391195"
"V4mis2";"SILVA (only NR);Bacteria;Proteobacteria;Alphaproteobacteria;Parvibaculales;uncultured;";"100.0";"14.4";"4";"4";"4";"0";"0";"457179";"391203"
"V4mis2";"SILVA (only NR);Bacteria;Proteobacteria;Alphaproteobacteria;Puniceispirillales;";"96.1";"14.4";"307";"307";"295";"12";"0";"456876";"390912"
"V4mis2";"SILVA (only NR);Bacteria;Proteobacteria;Alphaproteobacteria;Puniceispirillales;EF100-94H03;";"92.0";"14.4";"25";"25";"23";"2";"0";"457158";"391184"
"V4mis2";"SILVA (only NR);Bacteria;Proteobacteria;Alphaproteobacteria;Puniceispirillales;Puniceispirillales Incertae Sedis;";"81.8";"14.4";"22";"22";"18";"4";"0";"457161";"391189"
"V4mis2";"SILVA (only NR);Bacteria;Proteobacteria;Alphaproteobacteria;Puniceispirillales;Puniceispirillales Incertae Sedis;Constrictibacter;";"81.8";"14.4";"22";"22";"18";"4";"0";"457161";"391189"
"V4mis2";"SILVA (only NR);Bacteria;Proteobacteria;Alphaproteobacteria;Puniceispirillales;SAR116 clade;";"97.3";"14.4";"226";"226";"220";"6";"0";"456957";"390987"
"V4mis2";"SILVA (only NR);Bacteria;Proteobacteria;Alphaproteobacteria;Puniceispirillales;SAR116 clade;Candidatus Puniceispirillum;";"93.8";"14.4";"16";"16";"15";"1";"0";"457167";"391192"
"V4mis2";"SILVA (only NR);Bacteria;Proteobacteria;Alphaproteobacteria;Puniceispirillales;uncultured;";"100.0";"14.4";"32";"32";"32";"0";"0";"457151";"391175"
"V4mis2";"SILVA (only NR);Bacteria;Proteobacteria;Alphaproteobacteria;Reyranellales;";"97.8";"14.4";"179";"179";"175";"4";"0";"457004";"391032"
"V4mis2";"SILVA (only NR);Bacteria;Proteobacteria;Alphaproteobacteria;Reyranellales;Reyranellaceae;";"97.8";"14.4";"179";"179";"175";"4";"0";"457004";"391032"
"V4mis2";"SILVA (only NR);Bacteria;Proteobacteria;Alphaproteobacteria;Reyranellales;Reyranellaceae;Reyranella;";"96.8";"14.4";"124";"124";"120";"4";"0";"457059";"391087"
"V4mis2";"SILVA (only NR);Bacteria;Proteobacteria;Alphaproteobacteria;Reyranellales;Reyranellaceae;uncultured;";"100.0";"14.4";"55";"55";"55";"0";"0";"457128";"391152"
"V4mis2";"SILVA (only NR);Bacteria;Proteobacteria;Alphaproteobacteria;Rhizobiales;";"95.8";"14.7";"10862";"10862";"10409";"453";"0";"446321";"380798"
"V4mis2";"SILVA (only NR);Bacteria;Proteobacteria;Alphaproteobacteria;Rhizobiales;A0839;";"97.3";"14.4";"112";"112";"109";"3";"0";"457071";"391098"
"V4mis2";"SILVA (only NR);Bacteria;Proteobacteria;Alphaproteobacteria;Rhizobiales;Amb-16S-1323;";"88.9";"14.4";"18";"18";"16";"2";"0";"457165";"391191"
"V4mis2";"SILVA (only NR);Bacteria;Proteobacteria;Alphaproteobacteria;Rhizobiales;Ancalomicrobiaceae;";"100.0";"14.4";"4";"4";"4";"0";"0";"457179";"391203"
"V4mis2";"SILVA (only NR);Bacteria;Proteobacteria;Alphaproteobacteria;Rhizobiales;Ancalomicrobiaceae;Ancalomicrobium;";"100.0";"14.4";"4";"4";"4";"0";"0";"457179";"391203"
"V4mis2";"SILVA (only NR);Bacteria;Proteobacteria;Alphaproteobacteria;Rhizobiales;Beijerinckiaceae;";"94.5";"14.5";"1477";"1477";"1396";"81";"0";"455706";"389811"
"V4mis2";"SILVA (only NR);Bacteria;Proteobacteria;Alphaproteobacteria;Rhizobiales;Beijerinckiaceae;1174-901-12;";"96.8";"14.4";"62";"62";"60";"2";"0";"457121";"391147"
"V4mis2";"SILVA (only NR);Bacteria;Proteobacteria;Alphaproteobacteria;Rhizobiales;Beijerinckiaceae;28-YEA-48;";"100.0";"14.4";"2";"2";"2";"0";"0";"457181";"391205"
"V4mis2";"SILVA (only NR);Bacteria;Proteobacteria;Alphaproteobacteria;Rhizobiales;Beijerinckiaceae;Beijerinckia;";"91.3";"14.4";"23";"23";"21";"2";"0";"457160";"391186"
"V4mis2";"SILVA (only NR);Bacteria;Proteobacteria;Alphaproteobacteria;Rhizobiales;Beijerinckiaceae;Bosea;";"96.0";"14.4";"124";"124";"119";"5";"0";"457059";"391088"
"V4mis2";"SILVA (only NR);Bacteria;Proteobacteria;Alphaproteobacteria;Rhizobiales;Beijerinckiaceae;Camelimonas;";"100.0";"14.4";"9";"9";"9";"0";"0";"457174";"391198"
"V4mis2";"SILVA (only NR);Bacteria;Proteobacteria;Alphaproteobacteria;Rhizobiales;Beijerinckiaceae;Chelatococcus;";"100.0";"14.4";"21";"21";"21";"0";"0";"457162";"391186"
"V4mis2";"SILVA (only NR);Bacteria;Proteobacteria;Alphaproteobacteria;Rhizobiales;Beijerinckiaceae;FFCH5858;";"83.3";"14.4";"6";"6";"5";"1";"0";"457177";"391202"
"V4mis2";"SILVA (only NR);Bacteria;Proteobacteria;Alphaproteobacteria;Rhizobiales;Beijerinckiaceae;FukuN57;";"93.3";"14.4";"15";"15";"14";"1";"0";"457168";"391193"
"V4mis2";"SILVA (only NR);Bacteria;Proteobacteria;Alphaproteobacteria;Rhizobiales;Beijerinckiaceae;Methylobacterium-Methylorubrum;";"91.7";"14.4";"551";"551";"505";"46";"0";"456632";"390702"
"V4mis2";"SILVA (only NR);Bacteria;Proteobacteria;Alphaproteobacteria;Rhizobiales;Beijerinckiaceae;Methylocapsa;";"100.0";"14.4";"10";"10";"10";"0";"0";"457173";"391197"
"V4mis2";"SILVA (only NR);Bacteria;Proteobacteria;Alphaproteobacteria;Rhizobiales;Beijerinckiaceae;Methylocella;";"100.0";"14.4";"20";"20";"20";"0";"0";"457163";"391187"
"V4mis2";"SILVA (only NR);Bacteria;Proteobacteria;Alphaproteobacteria;Rhizobiales;Beijerinckiaceae;Methylocystis;";"96.4";"14.4";"56";"56";"54";"2";"0";"457127";"391153"
"V4mis2";"SILVA (only NR);Bacteria;Proteobacteria;Alphaproteobacteria;Rhizobiales;Beijerinckiaceae;Methyloferula;";"100.0";"14.4";"5";"5";"5";"0";"0";"457178";"391202"
"V4mis2";"SILVA (only NR);Bacteria;Proteobacteria;Alphaproteobacteria;Rhizobiales;Beijerinckiaceae;Methylorosula;";"87.5";"14.4";"24";"24";"21";"3";"0";"457159";"391186"
"V4mis2";"SILVA (only NR);Bacteria;Proteobacteria;Alphaproteobacteria;Rhizobiales;Beijerinckiaceae;Methylosinus;";"100.0";"14.4";"18";"18";"18";"0";"0";"457165";"391189"
"V4mis2";"SILVA (only NR);Bacteria;Proteobacteria;Alphaproteobacteria;Rhizobiales;Beijerinckiaceae;Methylovirgula;";"100.0";"14.4";"15";"15";"15";"0";"0";"457168";"391192"
"V4mis2";"SILVA (only NR);Bacteria;Proteobacteria;Alphaproteobacteria;Rhizobiales;Beijerinckiaceae;Microvirga;";"94.1";"14.4";"170";"170";"160";"10";"0";"457013";"391047"
"V4mis2";"SILVA (only NR);Bacteria;Proteobacteria;Alphaproteobacteria;Rhizobiales;Beijerinckiaceae;Neo-b11;";"100.0";"14.4";"3";"3";"3";"0";"0";"457180";"391204"
"V4mis2";"SILVA (only NR);Bacteria;Proteobacteria;Alphaproteobacteria;Rhizobiales;Beijerinckiaceae;Pseudochelatococcus;";"92.9";"14.4";"14";"14";"13";"1";"0";"457169";"391194"
"V4mis2";"SILVA (only NR);Bacteria;Proteobacteria;Alphaproteobacteria;Rhizobiales;Beijerinckiaceae;Psychroglaciecola;";"100.0";"14.4";"16";"16";"16";"0";"0";"457167";"391191"
"V4mis2";"SILVA (only NR);Bacteria;Proteobacteria;Alphaproteobacteria;Rhizobiales;Beijerinckiaceae;Qingshengfania;";"100.0";"14.4";"2";"2";"2";"0";"0";"457181";"391205"
"V4mis2";"SILVA (only NR);Bacteria;Proteobacteria;Alphaproteobacteria;Rhizobiales;Beijerinckiaceae;Rhodoblastus;";"100.0";"14.4";"15";"15";"15";"0";"0";"457168";"391192"
"V4mis2";"SILVA (only NR);Bacteria;Proteobacteria;Alphaproteobacteria;Rhizobiales;Beijerinckiaceae;Roseiarcus;";"95.8";"14.4";"48";"48";"46";"2";"0";"457135";"391161"
"V4mis2";"SILVA (only NR);Bacteria;Proteobacteria;Alphaproteobacteria;Rhizobiales;Beijerinckiaceae;Salinarimonas;";"100.0";"14.4";"14";"14";"14";"0";"0";"457169";"391193"
"V4mis2";"SILVA (only NR);Bacteria;Proteobacteria;Alphaproteobacteria;Rhizobiales;Beijerinckiaceae;alphaI cluster;";"100.0";"14.4";"50";"50";"50";"0";"0";"457133";"391157"
"V4mis2";"SILVA (only NR);Bacteria;Proteobacteria;Alphaproteobacteria;Rhizobiales;Beijerinckiaceae;uncultured;";"96.5";"14.4";"172";"172";"166";"6";"0";"457011";"391041"
"V4mis2";"SILVA (only NR);Bacteria;Proteobacteria;Alphaproteobacteria;Rhizobiales;C2U;";"95.0";"14.4";"20";"20";"19";"1";"0";"457163";"391188"
"V4mis2";"SILVA (only NR);Bacteria;Proteobacteria;Alphaproteobacteria;Rhizobiales;D05-2;";"100.0";"14.4";"41";"41";"41";"0";"0";"457142";"391166"
"V4mis2";"SILVA (only NR);Bacteria;Proteobacteria;Alphaproteobacteria;Rhizobiales;Devosiaceae;";"95.9";"14.4";"536";"536";"514";"22";"0";"456647";"390693"
"V4mis2";"SILVA (only NR);Bacteria;Proteobacteria;Alphaproteobacteria;Rhizobiales;Devosiaceae;Arsenicitalea;";"100.0";"14.4";"17";"17";"17";"0";"0";"457166";"391190"
"V4mis2";"SILVA (only NR);Bacteria;Proteobacteria;Alphaproteobacteria;Rhizobiales;Devosiaceae;Cucumibacter;";"100.0";"14.4";"4";"4";"4";"0";"0";"457179";"391203"
"V4mis2";"SILVA (only NR);Bacteria;Proteobacteria;Alphaproteobacteria;Rhizobiales;Devosiaceae;Devosia;";"96.6";"14.4";"384";"384";"371";"13";"0";"456799";"390836"
"V4mis2";"SILVA (only NR);Bacteria;Proteobacteria;Alphaproteobacteria;Rhizobiales;Devosiaceae;Maritalea;";"100.0";"14.4";"13";"13";"13";"0";"0";"457170";"391194"
"V4mis2";"SILVA (only NR);Bacteria;Proteobacteria;Alphaproteobacteria;Rhizobiales;Devosiaceae;Methyloterrigena;";"100.0";"14.4";"2";"2";"2";"0";"0";"457181";"391205"
"V4mis2";"SILVA (only NR);Bacteria;Proteobacteria;Alphaproteobacteria;Rhizobiales;Devosiaceae;Paradevosia;";"50.0";"14.4";"2";"2";"1";"1";"0";"457181";"391206"
"V4mis2";"SILVA (only NR);Bacteria;Proteobacteria;Alphaproteobacteria;Rhizobiales;Devosiaceae;Pelagibacterium;";"90.7";"14.4";"43";"43";"39";"4";"0";"457140";"391168"
"V4mis2";"SILVA (only NR);Bacteria;Proteobacteria;Alphaproteobacteria;Rhizobiales;Devosiaceae;Youhaiella;";"100.0";"14.4";"2";"2";"2";"0";"0";"457181";"391205"
"V4mis2";"SILVA (only NR);Bacteria;Proteobacteria;Alphaproteobacteria;Rhizobiales;Devosiaceae;uncultured;";"95.4";"14.4";"65";"65";"62";"3";"0";"457118";"391145"
"V4mis2";"SILVA (only NR);Bacteria;Proteobacteria;Alphaproteobacteria;Rhizobiales;Hyphomicrobiaceae;";"96.9";"14.4";"583";"583";"565";"18";"0";"456600";"390642"
"V4mis2";"SILVA (only NR);Bacteria;Proteobacteria;Alphaproteobacteria;Rhizobiales;Hyphomicrobiaceae;Filomicrobium;";"94.4";"14.4";"71";"71";"67";"4";"0";"457112";"391140"
"V4mis2";"SILVA (only NR);Bacteria;Proteobacteria;Alphaproteobacteria;Rhizobiales;Hyphomicrobiaceae;Hyphomicrobium;";"97.7";"14.4";"300";"300";"293";"7";"0";"456883";"390914"
"V4mis2";"SILVA (only NR);Bacteria;Proteobacteria;Alphaproteobacteria;Rhizobiales;Hyphomicrobiaceae;Pedomicrobium;";"95.7";"14.4";"163";"163";"156";"7";"0";"457020";"391051"
"V4mis2";"SILVA (only NR);Bacteria;Proteobacteria;Alphaproteobacteria;Rhizobiales;Hyphomicrobiaceae;uncultured;";"100.0";"14.4";"48";"48";"48";"0";"0";"457135";"391159"
"V4mis2";"SILVA (only NR);Bacteria;Proteobacteria;Alphaproteobacteria;Rhizobiales;KF-JG30-B3;";"98.4";"14.4";"64";"64";"63";"1";"0";"457119";"391144"
"V4mis2";"SILVA (only NR);Bacteria;Proteobacteria;Alphaproteobacteria;Rhizobiales;Kaistiaceae;";"100.0";"14.4";"25";"25";"25";"0";"0";"457158";"391182"
"V4mis2";"SILVA (only NR);Bacteria;Proteobacteria;Alphaproteobacteria;Rhizobiales;Kaistiaceae;Kaistia;";"100.0";"14.4";"25";"25";"25";"0";"0";"457158";"391182"
"V4mis2";"SILVA (only NR);Bacteria;Proteobacteria;Alphaproteobacteria;Rhizobiales;Labraceae;";"100.0";"14.4";"53";"53";"53";"0";"0";"457130";"391154"
"V4mis2";"SILVA (only NR);Bacteria;Proteobacteria;Alphaproteobacteria;Rhizobiales;Labraceae;Labrys;";"100.0";"14.4";"53";"53";"53";"0";"0";"457130";"391154"
"V4mis2";"SILVA (only NR);Bacteria;Proteobacteria;Alphaproteobacteria;Rhizobiales;Lutibaculaceae;";"100.0";"14.4";"3";"3";"3";"0";"0";"457180";"391204"
"V4mis2";"SILVA (only NR);Bacteria;Proteobacteria;Alphaproteobacteria;Rhizobiales;Lutibaculaceae;Lutibaculum;";"100.0";"14.4";"3";"3";"3";"0";"0";"457180";"391204"
"V4mis2";"SILVA (only NR);Bacteria;Proteobacteria;Alphaproteobacteria;Rhizobiales;Methyloligellaceae;";"95.6";"14.4";"226";"226";"216";"10";"0";"456957";"390991"
"V4mis2";"SILVA (only NR);Bacteria;Proteobacteria;Alphaproteobacteria;Rhizobiales;Methyloligellaceae;Methyloceanibacter;";"100.0";"14.4";"33";"33";"33";"0";"0";"457150";"391174"
"V4mis2";"SILVA (only NR);Bacteria;Proteobacteria;Alphaproteobacteria;Rhizobiales;Methyloligellaceae;Methyloligella;";"100.0";"14.4";"2";"2";"2";"0";"0";"457181";"391205"
"V4mis2";"SILVA (only NR);Bacteria;Proteobacteria;Alphaproteobacteria;Rhizobiales;Methyloligellaceae;Rhodobium;";"100.0";"14.4";"4";"4";"4";"0";"0";"457179";"391203"
"V4mis2";"SILVA (only NR);Bacteria;Proteobacteria;Alphaproteobacteria;Rhizobiales;Methyloligellaceae;uncultured;";"94.4";"14.4";"180";"180";"170";"10";"0";"457003";"391037"
"V4mis2";"SILVA (only NR);Bacteria;Proteobacteria;Alphaproteobacteria;Rhizobiales;Methylopilaceae;";"100.0";"14.4";"27";"27";"27";"0";"0";"457156";"391180"
"V4mis2";"SILVA (only NR);Bacteria;Proteobacteria;Alphaproteobacteria;Rhizobiales;Methylopilaceae;Albibacter;";"100.0";"14.4";"4";"4";"4";"0";"0";"457179";"391203"
"V4mis2";"SILVA (only NR);Bacteria;Proteobacteria;Alphaproteobacteria;Rhizobiales;Methylopilaceae;Hansschlegelia;";"100.0";"14.4";"10";"10";"10";"0";"0";"457173";"391197"
"V4mis2";"SILVA (only NR);Bacteria;Proteobacteria;Alphaproteobacteria;Rhizobiales;Methylopilaceae;Methylopila;";"100.0";"14.4";"9";"9";"9";"0";"0";"457174";"391198"
"V4mis2";"SILVA (only NR);Bacteria;Proteobacteria;Alphaproteobacteria;Rhizobiales;Methylopilaceae;uncultured;";"100.0";"14.4";"2";"2";"2";"0";"0";"457181";"391205"
"V4mis2";"SILVA (only NR);Bacteria;Proteobacteria;Alphaproteobacteria;Rhizobiales;Pleomorphomonadaceae;";"98.3";"14.4";"60";"60";"59";"1";"0";"457123";"391148"
"V4mis2";"SILVA (only NR);Bacteria;Proteobacteria;Alphaproteobacteria;Rhizobiales;Pleomorphomonadaceae;Chthonobacter;";"100.0";"14.4";"16";"16";"16";"0";"0";"457167";"391191"
"V4mis2";"SILVA (only NR);Bacteria;Proteobacteria;Alphaproteobacteria;Rhizobiales;Pleomorphomonadaceae;Hartmannibacter;";"100.0";"14.4";"2";"2";"2";"0";"0";"457181";"391205"
"V4mis2";"SILVA (only NR);Bacteria;Proteobacteria;Alphaproteobacteria;Rhizobiales;Pleomorphomonadaceae;Methylobrevis;";"100.0";"14.4";"1";"1";"1";"0";"0";"457182";"391206"
"V4mis2";"SILVA (only NR);Bacteria;Proteobacteria;Alphaproteobacteria;Rhizobiales;Pleomorphomonadaceae;Pleomorphomonas;";"93.3";"14.4";"15";"15";"14";"1";"0";"457168";"391193"
"V4mis2";"SILVA (only NR);Bacteria;Proteobacteria;Alphaproteobacteria;Rhizobiales;Pleomorphomonadaceae;Prosthecomicrobium;";"100.0";"14.4";"10";"10";"10";"0";"0";"457173";"391197"
"V4mis2";"SILVA (only NR);Bacteria;Proteobacteria;Alphaproteobacteria;Rhizobiales;Pleomorphomonadaceae;uncultured;";"100.0";"14.4";"16";"16";"16";"0";"0";"457167";"391191"
"V4mis2";"SILVA (only NR);Bacteria;Proteobacteria;Alphaproteobacteria;Rhizobiales;Rhizobiaceae;";"96.4";"14.5";"4735";"4735";"4566";"169";"0";"452448";"386641"
"V4mis2";"SILVA (only NR);Bacteria;Proteobacteria;Alphaproteobacteria;Rhizobiales;Rhizobiaceae;Ahrensia;";"90.0";"14.4";"10";"10";"9";"1";"0";"457173";"391198"
"V4mis2";"SILVA (only NR);Bacteria;Proteobacteria;Alphaproteobacteria;Rhizobiales;Rhizobiaceae;Aliihoeflea;";"100.0";"14.4";"10";"10";"10";"0";"0";"457173";"391197"
"V4mis2";"SILVA (only NR);Bacteria;Proteobacteria;Alphaproteobacteria;Rhizobiales;Rhizobiaceae;Allorhizobium-Neorhizobium-Pararhizobium-Rhizobium;";"96.4";"14.5";"1660";"1660";"1600";"60";"0";"455523";"389607"
"V4mis2";"SILVA (only NR);Bacteria;Proteobacteria;Alphaproteobacteria;Rhizobiales;Rhizobiaceae;Aminobacter;";"97.8";"14.4";"89";"89";"87";"2";"0";"457094";"391120"
"V4mis2";"SILVA (only NR);Bacteria;Proteobacteria;Alphaproteobacteria;Rhizobiales;Rhizobiaceae;Aquamicrobium;";"97.7";"14.4";"44";"44";"43";"1";"0";"457139";"391164"
"V4mis2";"SILVA (only NR);Bacteria;Proteobacteria;Alphaproteobacteria;Rhizobiales;Rhizobiaceae;Aurantimonas;";"92.3";"14.4";"13";"13";"12";"1";"0";"457170";"391195"
"V4mis2";"SILVA (only NR);Bacteria;Proteobacteria;Alphaproteobacteria;Rhizobiales;Rhizobiaceae;Aureimonas;";"95.2";"14.4";"62";"62";"59";"3";"0";"457121";"391148"
"V4mis2";"SILVA (only NR);Bacteria;Proteobacteria;Alphaproteobacteria;Rhizobiales;Rhizobiaceae;Bartonella;";"99.3";"14.4";"135";"135";"134";"1";"0";"457048";"391073"
"V4mis2";"SILVA (only NR);Bacteria;Proteobacteria;Alphaproteobacteria;Rhizobiales;Rhizobiaceae;Brucella;";"100.0";"14.4";"383";"383";"383";"0";"0";"456800";"390824"
"V4mis2";"SILVA (only NR);Bacteria;Proteobacteria;Alphaproteobacteria;Rhizobiales;Rhizobiaceae;Candidatus Hodgkinia;";"96.0";"14.4";"173";"173";"166";"7";"0";"457010";"391041"
"V4mis2";"SILVA (only NR);Bacteria;Proteobacteria;Alphaproteobacteria;Rhizobiales;Rhizobiaceae;Candidatus Liberibacter;";"95.2";"14.4";"21";"21";"20";"1";"0";"457162";"391187"
"V4mis2";"SILVA (only NR);Bacteria;Proteobacteria;Alphaproteobacteria;Rhizobiales;Rhizobiaceae;Candidatus Tokpelaia;";"100.0";"14.4";"1";"1";"1";"0";"0";"457182";"391206"
"V4mis2";"SILVA (only NR);Bacteria;Proteobacteria;Alphaproteobacteria;Rhizobiales;Rhizobiaceae;Chelativorans;";"90.0";"14.4";"20";"20";"18";"2";"0";"457163";"391189"
"V4mis2";"SILVA (only NR);Bacteria;Proteobacteria;Alphaproteobacteria;Rhizobiales;Rhizobiaceae;Ciceribacter;";"100.0";"14.4";"14";"14";"14";"0";"0";"457169";"391193"
"V4mis2";"SILVA (only NR);Bacteria;Proteobacteria;Alphaproteobacteria;Rhizobiales;Rhizobiaceae;Cohaesibacter;";"98.0";"14.4";"49";"49";"48";"1";"0";"457134";"391159"
"V4mis2";"SILVA (only NR);Bacteria;Proteobacteria;Alphaproteobacteria;Rhizobiales;Rhizobiaceae;Corticibacterium;";"100.0";"14.4";"3";"3";"3";"0";"0";"457180";"391204"
"V4mis2";"SILVA (only NR);Bacteria;Proteobacteria;Alphaproteobacteria;Rhizobiales;Rhizobiaceae;Daeguia;";"100.0";"14.4";"1";"1";"1";"0";"0";"457182";"391206"
"V4mis2";"SILVA (only NR);Bacteria;Proteobacteria;Alphaproteobacteria;Rhizobiales;Rhizobiaceae;Ensifer;";"95.6";"14.4";"409";"409";"391";"18";"0";"456774";"390816"
"V4mis2";"SILVA (only NR);Bacteria;Proteobacteria;Alphaproteobacteria;Rhizobiales;Rhizobiaceae;Falsochrobactrum;";"82.6";"14.4";"23";"23";"19";"4";"0";"457160";"391188"
"V4mis2";"SILVA (only NR);Bacteria;Proteobacteria;Alphaproteobacteria;Rhizobiales;Rhizobiaceae;Fulvimarina;";"100.0";"14.4";"8";"8";"8";"0";"0";"457175";"391199"
"V4mis2";"SILVA (only NR);Bacteria;Proteobacteria;Alphaproteobacteria;Rhizobiales;Rhizobiaceae;Hoeflea;";"96.3";"14.4";"27";"27";"26";"1";"0";"457156";"391181"
"V4mis2";"SILVA (only NR);Bacteria;Proteobacteria;Alphaproteobacteria;Rhizobiales;Rhizobiaceae;Jiella;";"100.0";"14.4";"4";"4";"4";"0";"0";"457179";"391203"
"V4mis2";"SILVA (only NR);Bacteria;Proteobacteria;Alphaproteobacteria;Rhizobiales;Rhizobiaceae;Lentilitoribacter;";"100.0";"14.4";"8";"8";"8";"0";"0";"457175";"391199"
"V4mis2";"SILVA (only NR);Bacteria;Proteobacteria;Alphaproteobacteria;Rhizobiales;Rhizobiaceae;Martelella;";"96.6";"14.4";"29";"29";"28";"1";"0";"457154";"391179"
"V4mis2";"SILVA (only NR);Bacteria;Proteobacteria;Alphaproteobacteria;Rhizobiales;Rhizobiaceae;Mesorhizobium;";"97.6";"14.4";"548";"548";"535";"13";"0";"456635";"390672"
"V4mis2";"SILVA (only NR);Bacteria;Proteobacteria;Alphaproteobacteria;Rhizobiales;Rhizobiaceae;Mycoplana;";"100.0";"14.4";"8";"8";"8";"0";"0";"457175";"391199"
"V4mis2";"SILVA (only NR);Bacteria;Proteobacteria;Alphaproteobacteria;Rhizobiales;Rhizobiaceae;Neorhizobium;";"94.7";"14.4";"19";"19";"18";"1";"0";"457164";"391189"
"V4mis2";"SILVA (only NR);Bacteria;Proteobacteria;Alphaproteobacteria;Rhizobiales;Rhizobiaceae;Nitratireductor;";"87.5";"14.4";"104";"104";"91";"13";"0";"457079";"391116"
"V4mis2";"SILVA (only NR);Bacteria;Proteobacteria;Alphaproteobacteria;Rhizobiales;Rhizobiaceae;Ochrobactrum;";"94.5";"14.4";"308";"308";"291";"17";"0";"456875";"390916"
"V4mis2";"SILVA (only NR);Bacteria;Proteobacteria;Alphaproteobacteria;Rhizobiales;Rhizobiaceae;Oricola;";"100.0";"14.4";"4";"4";"4";"0";"0";"457179";"391203"
"V4mis2";"SILVA (only NR);Bacteria;Proteobacteria;Alphaproteobacteria;Rhizobiales;Rhizobiaceae;Paenochrobactrum;";"100.0";"14.4";"14";"14";"14";"0";"0";"457169";"391193"
"V4mis2";"SILVA (only NR);Bacteria;Proteobacteria;Alphaproteobacteria;Rhizobiales;Rhizobiaceae;Paramesorhizobium;";"100.0";"14.4";"5";"5";"5";"0";"0";"457178";"391202"
"V4mis2";"SILVA (only NR);Bacteria;Proteobacteria;Alphaproteobacteria;Rhizobiales;Rhizobiaceae;Phyllobacterium;";"98.1";"14.4";"106";"106";"104";"2";"0";"457077";"391103"
"V4mis2";"SILVA (only NR);Bacteria;Proteobacteria;Alphaproteobacteria;Rhizobiales;Rhizobiaceae;Pseudahrensia;";"98.0";"14.4";"50";"50";"49";"1";"0";"457133";"391158"
"V4mis2";"SILVA (only NR);Bacteria;Proteobacteria;Alphaproteobacteria;Rhizobiales;Rhizobiaceae;Pseudaminobacter;";"96.1";"14.4";"51";"51";"49";"2";"0";"457132";"391158"
"V4mis2";"SILVA (only NR);Bacteria;Proteobacteria;Alphaproteobacteria;Rhizobiales;Rhizobiaceae;Pseudochrobactrum;";"90.0";"14.4";"40";"40";"36";"4";"0";"457143";"391171"
"V4mis2";"SILVA (only NR);Bacteria;Proteobacteria;Alphaproteobacteria;Rhizobiales;Rhizobiaceae;Pseudohoeflea;";"100.0";"14.4";"3";"3";"3";"0";"0";"457180";"391204"
"V4mis2";"SILVA (only NR);Bacteria;Proteobacteria;Alphaproteobacteria;Rhizobiales;Rhizobiaceae;Pseudorhizobium;";"100.0";"14.4";"5";"5";"5";"0";"0";"457178";"391202"
"V4mis2";"SILVA (only NR);Bacteria;Proteobacteria;Alphaproteobacteria;Rhizobiales;Rhizobiaceae;Roseitalea;";"100.0";"14.4";"10";"10";"10";"0";"0";"457173";"391197"
"V4mis2";"SILVA (only NR);Bacteria;Proteobacteria;Alphaproteobacteria;Rhizobiales;Rhizobiaceae;Shinella;";"96.8";"14.4";"63";"63";"61";"2";"0";"457120";"391146"
"V4mis2";"SILVA (only NR);Bacteria;Proteobacteria;Alphaproteobacteria;Rhizobiales;Rhizobiaceae;Tianweitania;";"100.0";"14.4";"6";"6";"6";"0";"0";"457177";"391201"
"V4mis2";"SILVA (only NR);Bacteria;Proteobacteria;Alphaproteobacteria;Rhizobiales;Rhizobiaceae;[Rhizobium] sphaerophysae group;";"100.0";"14.4";"5";"5";"5";"0";"0";"457178";"391202"
"V4mis2";"SILVA (only NR);Bacteria;Proteobacteria;Alphaproteobacteria;Rhizobiales;Rhizobiaceae;uncultured;";"94.1";"14.4";"152";"152";"143";"9";"0";"457031";"391064"
"V4mis2";"SILVA (only NR);Bacteria;Proteobacteria;Alphaproteobacteria;Rhizobiales;Rhizobiales Incertae Sedis;";"95.8";"14.4";"433";"433";"415";"18";"0";"456750";"390792"
"V4mis2";"SILVA (only NR);Bacteria;Proteobacteria;Alphaproteobacteria;Rhizobiales;Rhizobiales Incertae Sedis;Alsobacter;";"100.0";"14.4";"5";"5";"5";"0";"0";"457178";"391202"
"V4mis2";"SILVA (only NR);Bacteria;Proteobacteria;Alphaproteobacteria;Rhizobiales;Rhizobiales Incertae Sedis;Anderseniella;";"95.5";"14.4";"22";"22";"21";"1";"0";"457161";"391186"
"V4mis2";"SILVA (only NR);Bacteria;Proteobacteria;Alphaproteobacteria;Rhizobiales;Rhizobiales Incertae Sedis;Bauldia;";"98.1";"14.4";"103";"103";"101";"2";"0";"457080";"391106"
"V4mis2";"SILVA (only NR);Bacteria;Proteobacteria;Alphaproteobacteria;Rhizobiales;Rhizobiales Incertae Sedis;Dichotomicrobium;";"89.5";"14.4";"57";"57";"51";"6";"0";"457126";"391156"
"V4mis2";"SILVA (only NR);Bacteria;Proteobacteria;Alphaproteobacteria;Rhizobiales;Rhizobiales Incertae Sedis;Nordella;";"94.6";"14.4";"56";"56";"53";"3";"0";"457127";"391154"
"V4mis2";"SILVA (only NR);Bacteria;Proteobacteria;Alphaproteobacteria;Rhizobiales;Rhizobiales Incertae Sedis;Phreatobacter;";"95.9";"14.4";"49";"49";"47";"2";"0";"457134";"391160"
"V4mis2";"SILVA (only NR);Bacteria;Proteobacteria;Alphaproteobacteria;Rhizobiales;Rhizobiales Incertae Sedis;uncultured;";"97.1";"14.4";"140";"140";"136";"4";"0";"457043";"391071"
"V4mis2";"SILVA (only NR);Bacteria;Proteobacteria;Alphaproteobacteria;Rhizobiales;Rhodobiaceae;";"84.8";"14.4";"33";"33";"28";"5";"0";"457150";"391179"
"V4mis2";"SILVA (only NR);Bacteria;Proteobacteria;Alphaproteobacteria;Rhizobiales;Rhodobiaceae;Afifella;";"81.3";"14.4";"16";"16";"13";"3";"0";"457167";"391194"
"V4mis2";"SILVA (only NR);Bacteria;Proteobacteria;Alphaproteobacteria;Rhizobiales;Rhodobiaceae;Amorphus;";"100.0";"14.4";"6";"6";"6";"0";"0";"457177";"391201"
"V4mis2";"SILVA (only NR);Bacteria;Proteobacteria;Alphaproteobacteria;Rhizobiales;Rhodobiaceae;Tepidamorphus;";"81.8";"14.4";"11";"11";"9";"2";"0";"457172";"391198"
"V4mis2";"SILVA (only NR);Bacteria;Proteobacteria;Alphaproteobacteria;Rhizobiales;Rhodomicrobiaceae;";"95.3";"14.4";"64";"64";"61";"3";"0";"457119";"391146"
"V4mis2";"SILVA (only NR);Bacteria;Proteobacteria;Alphaproteobacteria;Rhizobiales;Rhodomicrobiaceae;Rhodomicrobium;";"95.3";"14.4";"64";"64";"61";"3";"0";"457119";"391146"
"V4mis2";"SILVA (only NR);Bacteria;Proteobacteria;Alphaproteobacteria;Rhizobiales;Stappiaceae;";"94.1";"14.4";"219";"219";"206";"13";"0";"456964";"391001"
"V4mis2";"SILVA (only NR);Bacteria;Proteobacteria;Alphaproteobacteria;Rhizobiales;Stappiaceae;Agaricicola;";"100.0";"14.4";"3";"3";"3";"0";"0";"457180";"391204"
"V4mis2";"SILVA (only NR);Bacteria;Proteobacteria;Alphaproteobacteria;Rhizobiales;Stappiaceae;Breoghania;";"100.0";"14.4";"6";"6";"6";"0";"0";"457177";"391201"
"V4mis2";"SILVA (only NR);Bacteria;Proteobacteria;Alphaproteobacteria;Rhizobiales;Stappiaceae;Labrenzia;";"93.8";"14.4";"81";"81";"76";"5";"0";"457102";"391131"
"V4mis2";"SILVA (only NR);Bacteria;Proteobacteria;Alphaproteobacteria;Rhizobiales;Stappiaceae;Nesiotobacter;";"100.0";"14.4";"2";"2";"2";"0";"0";"457181";"391205"
"V4mis2";"SILVA (only NR);Bacteria;Proteobacteria;Alphaproteobacteria;Rhizobiales;Stappiaceae;Pannonibacter;";"93.5";"14.4";"31";"31";"29";"2";"0";"457152";"391178"
"V4mis2";"SILVA (only NR);Bacteria;Proteobacteria;Alphaproteobacteria;Rhizobiales;Stappiaceae;Polymorphum;";"100.0";"14.4";"1";"1";"1";"0";"0";"457182";"391206"
"V4mis2";"SILVA (only NR);Bacteria;Proteobacteria;Alphaproteobacteria;Rhizobiales;Stappiaceae;Pseudovibrio;";"90.3";"14.4";"62";"62";"56";"6";"0";"457121";"391151"
"V4mis2";"SILVA (only NR);Bacteria;Proteobacteria;Alphaproteobacteria;Rhizobiales;Stappiaceae;Rhodothalassium;";"100.0";"14.4";"6";"6";"6";"0";"0";"457177";"391201"
"V4mis2";"SILVA (only NR);Bacteria;Proteobacteria;Alphaproteobacteria;Rhizobiales;Stappiaceae;Roseibium;";"100.0";"14.4";"6";"6";"6";"0";"0";"457177";"391201"
"V4mis2";"SILVA (only NR);Bacteria;Proteobacteria;Alphaproteobacteria;Rhizobiales;Stappiaceae;Stappia;";"100.0";"14.4";"17";"17";"17";"0";"0";"457166";"391190"
"V4mis2";"SILVA (only NR);Bacteria;Proteobacteria;Alphaproteobacteria;Rhizobiales;Thermopetrobacteraceae;";"90.0";"14.4";"10";"10";"9";"1";"0";"457173";"391198"
"V4mis2";"SILVA (only NR);Bacteria;Proteobacteria;Alphaproteobacteria;Rhizobiales;Thermopetrobacteraceae;Thermopetrobacter;";"90.0";"14.4";"10";"10";"9";"1";"0";"457173";"391198"
"V4mis2";"SILVA (only NR);Bacteria;Proteobacteria;Alphaproteobacteria;Rhizobiales;WC3-116;";"100.0";"14.4";"2";"2";"2";"0";"0";"457181";"391205"
"V4mis2";"SILVA (only NR);Bacteria;Proteobacteria;Alphaproteobacteria;Rhizobiales;Xanthobacteraceae;";"95.7";"14.5";"2003";"2003";"1917";"86";"0";"455180";"389290"
"V4mis2";"SILVA (only NR);Bacteria;Proteobacteria;Alphaproteobacteria;Rhizobiales;Xanthobacteraceae;Afipia;";"97.6";"14.4";"82";"82";"80";"2";"0";"457101";"391127"
"V4mis2";"SILVA (only NR);Bacteria;Proteobacteria;Alphaproteobacteria;Rhizobiales;Xanthobacteraceae;Ancylobacter;";"100.0";"14.4";"31";"31";"31";"0";"0";"457152";"391176"
"V4mis2";"SILVA (only NR);Bacteria;Proteobacteria;Alphaproteobacteria;Rhizobiales;Xanthobacteraceae;Angulomicrobium;";"100.0";"14.4";"2";"2";"2";"0";"0";"457181";"391205"
"V4mis2";"SILVA (only NR);Bacteria;Proteobacteria;Alphaproteobacteria;Rhizobiales;Xanthobacteraceae;Aquabacter;";"100.0";"14.4";"1";"1";"1";"0";"0";"457182";"391206"
"V4mis2";"SILVA (only NR);Bacteria;Proteobacteria;Alphaproteobacteria;Rhizobiales;Xanthobacteraceae;Azorhizobium;";"100.0";"14.4";"20";"20";"20";"0";"0";"457163";"391187"
"V4mis2";"SILVA (only NR);Bacteria;Proteobacteria;Alphaproteobacteria;Rhizobiales;Xanthobacteraceae;Blastochloris;";"82.4";"14.4";"17";"17";"14";"3";"0";"457166";"391193"
"V4mis2";"SILVA (only NR);Bacteria;Proteobacteria;Alphaproteobacteria;Rhizobiales;Xanthobacteraceae;Bradyrhizobium;";"94.2";"14.4";"804";"804";"757";"47";"0";"456379";"390450"
"V4mis2";"SILVA (only NR);Bacteria;Proteobacteria;Alphaproteobacteria;Rhizobiales;Xanthobacteraceae;Methylorhabdus;";"100.0";"14.4";"2";"2";"2";"0";"0";"457181";"391205"
"V4mis2";"SILVA (only NR);Bacteria;Proteobacteria;Alphaproteobacteria;Rhizobiales;Xanthobacteraceae;Nitrobacter;";"90.9";"14.4";"22";"22";"20";"2";"0";"457161";"391187"
"V4mis2";"SILVA (only NR);Bacteria;Proteobacteria;Alphaproteobacteria;Rhizobiales;Xanthobacteraceae;Oligotropha;";"100.0";"14.4";"6";"6";"6";"0";"0";"457177";"391201"
"V4mis2";"SILVA (only NR);Bacteria;Proteobacteria;Alphaproteobacteria;Rhizobiales;Xanthobacteraceae;Pseudolabrys;";"95.3";"14.4";"150";"150";"143";"7";"0";"457033";"391064"
"V4mis2";"SILVA (only NR);Bacteria;Proteobacteria;Alphaproteobacteria;Rhizobiales;Xanthobacteraceae;Pseudorhodoplanes;";"97.2";"14.4";"36";"36";"35";"1";"0";"457147";"391172"
"V4mis2";"SILVA (only NR);Bacteria;Proteobacteria;Alphaproteobacteria;Rhizobiales;Xanthobacteraceae;Pseudoxanthobacter;";"83.3";"14.4";"6";"6";"5";"1";"0";"457177";"391202"
"V4mis2";"SILVA (only NR);Bacteria;Proteobacteria;Alphaproteobacteria;Rhizobiales;Xanthobacteraceae;Rhodoplanes;";"96.2";"14.4";"105";"105";"101";"4";"0";"457078";"391106"
"V4mis2";"SILVA (only NR);Bacteria;Proteobacteria;Alphaproteobacteria;Rhizobiales;Xanthobacteraceae;Rhodopseudomonas;";"97.4";"14.4";"114";"114";"111";"3";"0";"457069";"391096"
"V4mis2";"SILVA (only NR);Bacteria;Proteobacteria;Alphaproteobacteria;Rhizobiales;Xanthobacteraceae;Starkeya;";"92.3";"14.4";"13";"13";"12";"1";"0";"457170";"391195"
"V4mis2";"SILVA (only NR);Bacteria;Proteobacteria;Alphaproteobacteria;Rhizobiales;Xanthobacteraceae;Tardiphaga;";"94.1";"14.4";"17";"17";"16";"1";"0";"457166";"391191"
"V4mis2";"SILVA (only NR);Bacteria;Proteobacteria;Alphaproteobacteria;Rhizobiales;Xanthobacteraceae;Variibacter;";"100.0";"14.4";"4";"4";"4";"0";"0";"457179";"391203"
"V4mis2";"SILVA (only NR);Bacteria;Proteobacteria;Alphaproteobacteria;Rhizobiales;Xanthobacteraceae;Xanthobacter;";"97.7";"14.4";"43";"43";"42";"1";"0";"457140";"391165"
"V4mis2";"SILVA (only NR);Bacteria;Proteobacteria;Alphaproteobacteria;Rhizobiales;Xanthobacteraceae;uncultured;";"97.4";"14.4";"503";"503";"490";"13";"0";"456680";"390717"
"V4mis2";"SILVA (only NR);Bacteria;Proteobacteria;Alphaproteobacteria;Rhizobiales;uncultured;";"82.7";"14.4";"110";"110";"91";"19";"0";"457073";"391116"
"V4mis2";"SILVA (only NR);Bacteria;Proteobacteria;Alphaproteobacteria;Rhodobacterales;";"97.1";"14.6";"5419";"5419";"5261";"158";"0";"451764";"385946"
"V4mis2";"SILVA (only NR);Bacteria;Proteobacteria;Alphaproteobacteria;Rhodobacterales;Rhodobacteraceae;";"97.1";"14.6";"5419";"5419";"5261";"158";"0";"451764";"385946"
"V4mis2";"SILVA (only NR);Bacteria;Proteobacteria;Alphaproteobacteria;Rhodobacterales;Rhodobacteraceae;Actibacterium;";"100.0";"14.4";"25";"25";"25";"0";"0";"457158";"391182"
"V4mis2";"SILVA (only NR);Bacteria;Proteobacteria;Alphaproteobacteria;Rhodobacterales;Rhodobacteraceae;Aestuariibius;";"100.0";"14.4";"2";"2";"2";"0";"0";"457181";"391205"
"V4mis2";"SILVA (only NR);Bacteria;Proteobacteria;Alphaproteobacteria;Rhodobacterales;Rhodobacteraceae;Aestuariicoccus;";"100.0";"14.4";"21";"21";"21";"0";"0";"457162";"391186"
"V4mis2";"SILVA (only NR);Bacteria;Proteobacteria;Alphaproteobacteria;Rhodobacterales;Rhodobacteraceae;Aestuariihabitans;";"100.0";"14.4";"2";"2";"2";"0";"0";"457181";"391205"
"V4mis2";"SILVA (only NR);Bacteria;Proteobacteria;Alphaproteobacteria;Rhodobacterales;Rhodobacteraceae;Aestuariivita;";"100.0";"14.4";"1";"1";"1";"0";"0";"457182";"391206"
"V4mis2";"SILVA (only NR);Bacteria;Proteobacteria;Alphaproteobacteria;Rhodobacterales;Rhodobacteraceae;Albidovulum;";"90.5";"14.4";"21";"21";"19";"2";"0";"457162";"391188"
"V4mis2";"SILVA (only NR);Bacteria;Proteobacteria;Alphaproteobacteria;Rhodobacterales;Rhodobacteraceae;Albimonas;";"100.0";"14.4";"12";"12";"12";"0";"0";"457171";"391195"
"V4mis2";"SILVA (only NR);Bacteria;Proteobacteria;Alphaproteobacteria;Rhodobacterales;Rhodobacteraceae;Albirhodobacter;";"100.0";"14.4";"12";"12";"12";"0";"0";"457171";"391195"
"V4mis2";"SILVA (only NR);Bacteria;Proteobacteria;Alphaproteobacteria;Rhodobacterales;Rhodobacteraceae;Aliiroseovarius;";"100.0";"14.4";"34";"34";"34";"0";"0";"457149";"391173"
"V4mis2";"SILVA (only NR);Bacteria;Proteobacteria;Alphaproteobacteria;Rhodobacterales;Rhodobacteraceae;Amaricoccus;";"97.9";"14.4";"47";"47";"46";"1";"0";"457136";"391161"
"V4mis2";"SILVA (only NR);Bacteria;Proteobacteria;Alphaproteobacteria;Rhodobacterales;Rhodobacteraceae;Amylibacter;";"93.5";"14.4";"62";"62";"58";"4";"0";"457121";"391149"
"V4mis2";"SILVA (only NR);Bacteria;Proteobacteria;Alphaproteobacteria;Rhodobacterales;Rhodobacteraceae;Antarctobacter;";"100.0";"14.4";"8";"8";"8";"0";"0";"457175";"391199"
"V4mis2";"SILVA (only NR);Bacteria;Proteobacteria;Alphaproteobacteria;Rhodobacterales;Rhodobacteraceae;Aquimixticola;";"100.0";"14.4";"4";"4";"4";"0";"0";"457179";"391203"
"V4mis2";"SILVA (only NR);Bacteria;Proteobacteria;Alphaproteobacteria;Rhodobacterales;Rhodobacteraceae;Ascidiaceihabitans;";"97.9";"14.4";"48";"48";"47";"1";"0";"457135";"391160"
"V4mis2";"SILVA (only NR);Bacteria;Proteobacteria;Alphaproteobacteria;Rhodobacterales;Rhodobacteraceae;Boseongicola;";"100.0";"14.4";"7";"7";"7";"0";"0";"457176";"391200"
"V4mis2";"SILVA (only NR);Bacteria;Proteobacteria;Alphaproteobacteria;Rhodobacterales;Rhodobacteraceae;Brevirhabdus;";"100.0";"14.4";"4";"4";"4";"0";"0";"457179";"391203"
"V4mis2";"SILVA (only NR);Bacteria;Proteobacteria;Alphaproteobacteria;Rhodobacterales;Rhodobacteraceae;Celeribacter;";"100.0";"14.4";"35";"35";"35";"0";"0";"457148";"391172"
"V4mis2";"SILVA (only NR);Bacteria;Proteobacteria;Alphaproteobacteria;Rhodobacterales;Rhodobacteraceae;Cereibacter;";"100.0";"14.4";"11";"11";"11";"0";"0";"457172";"391196"
"V4mis2";"SILVA (only NR);Bacteria;Proteobacteria;Alphaproteobacteria;Rhodobacterales;Rhodobacteraceae;Citreicella;";"100.0";"14.4";"12";"12";"12";"0";"0";"457171";"391195"
"V4mis2";"SILVA (only NR);Bacteria;Proteobacteria;Alphaproteobacteria;Rhodobacterales;Rhodobacteraceae;Citreimonas;";"100.0";"14.4";"3";"3";"3";"0";"0";"457180";"391204"
"V4mis2";"SILVA (only NR);Bacteria;Proteobacteria;Alphaproteobacteria;Rhodobacterales;Rhodobacteraceae;Cognatishimia;";"100.0";"14.4";"26";"26";"26";"0";"0";"457157";"391181"
"V4mis2";"SILVA (only NR);Bacteria;Proteobacteria;Alphaproteobacteria;Rhodobacterales;Rhodobacteraceae;Cognatiyoonia;";"100.0";"14.4";"8";"8";"8";"0";"0";"457175";"391199"
"V4mis2";"SILVA (only NR);Bacteria;Proteobacteria;Alphaproteobacteria;Rhodobacterales;Rhodobacteraceae;Confluentimicrobium;";"100.0";"14.4";"5";"5";"5";"0";"0";"457178";"391202"
"V4mis2";"SILVA (only NR);Bacteria;Proteobacteria;Alphaproteobacteria;Rhodobacterales;Rhodobacteraceae;Cribrihabitans;";"100.0";"14.4";"9";"9";"9";"0";"0";"457174";"391198"
"V4mis2";"SILVA (only NR);Bacteria;Proteobacteria;Alphaproteobacteria;Rhodobacterales;Rhodobacteraceae;Defluviimonas;";"98.1";"14.4";"54";"54";"53";"1";"0";"457129";"391154"
"V4mis2";"SILVA (only NR);Bacteria;Proteobacteria;Alphaproteobacteria;Rhodobacterales;Rhodobacteraceae;Dinoroseobacter;";"94.4";"14.4";"18";"18";"17";"1";"0";"457165";"391190"
"V4mis2";"SILVA (only NR);Bacteria;Proteobacteria;Alphaproteobacteria;Rhodobacterales;Rhodobacteraceae;Donghicola;";"90.0";"14.4";"20";"20";"18";"2";"0";"457163";"391189"
"V4mis2";"SILVA (only NR);Bacteria;Proteobacteria;Alphaproteobacteria;Rhodobacterales;Rhodobacteraceae;Epibacterium;";"100.0";"14.4";"46";"46";"46";"0";"0";"457137";"391161"
"V4mis2";"SILVA (only NR);Bacteria;Proteobacteria;Alphaproteobacteria;Rhodobacterales;Rhodobacteraceae;Falsirhodobacter;";"96.4";"14.4";"28";"28";"27";"1";"0";"457155";"391180"
"V4mis2";"SILVA (only NR);Bacteria;Proteobacteria;Alphaproteobacteria;Rhodobacterales;Rhodobacteraceae;Flavimaricola;";"100.0";"14.4";"13";"13";"13";"0";"0";"457170";"391194"
"V4mis2";"SILVA (only NR);Bacteria;Proteobacteria;Alphaproteobacteria;Rhodobacterales;Rhodobacteraceae;Frigidibacter;";"100.0";"14.4";"3";"3";"3";"0";"0";"457180";"391204"
"V4mis2";"SILVA (only NR);Bacteria;Proteobacteria;Alphaproteobacteria;Rhodobacterales;Rhodobacteraceae;Gemmobacter;";"98.3";"14.4";"58";"58";"57";"1";"0";"457125";"391150"
"V4mis2";"SILVA (only NR);Bacteria;Proteobacteria;Alphaproteobacteria;Rhodobacterales;Rhodobacteraceae;HIMB11;";"100.0";"14.4";"42";"42";"42";"0";"0";"457141";"391165"
"V4mis2";"SILVA (only NR);Bacteria;Proteobacteria;Alphaproteobacteria;Rhodobacterales;Rhodobacteraceae;Haematobacter;";"81.3";"14.4";"16";"16";"13";"3";"0";"457167";"391194"
"V4mis2";"SILVA (only NR);Bacteria;Proteobacteria;Alphaproteobacteria;Rhodobacterales;Rhodobacteraceae;Halocynthiibacter;";"91.7";"14.4";"12";"12";"11";"1";"0";"457171";"391196"
"V4mis2";"SILVA (only NR);Bacteria;Proteobacteria;Alphaproteobacteria;Rhodobacterales;Rhodobacteraceae;Halodurantibacterium;";"95.7";"14.4";"23";"23";"22";"1";"0";"457160";"391185"
"V4mis2";"SILVA (only NR);Bacteria;Proteobacteria;Alphaproteobacteria;Rhodobacterales;Rhodobacteraceae;Halovulum;";"100.0";"14.4";"12";"12";"12";"0";"0";"457171";"391195"
"V4mis2";"SILVA (only NR);Bacteria;Proteobacteria;Alphaproteobacteria;Rhodobacterales;Rhodobacteraceae;Hasllibacter;";"100.0";"14.4";"2";"2";"2";"0";"0";"457181";"391205"
"V4mis2";"SILVA (only NR);Bacteria;Proteobacteria;Alphaproteobacteria;Rhodobacterales;Rhodobacteraceae;Hwanghaeicola;";"100.0";"14.4";"2";"2";"2";"0";"0";"457181";"391205"
"V4mis2";"SILVA (only NR);Bacteria;Proteobacteria;Alphaproteobacteria;Rhodobacterales;Rhodobacteraceae;Jannaschia;";"100.0";"14.4";"49";"49";"49";"0";"0";"457134";"391158"
"V4mis2";"SILVA (only NR);Bacteria;Proteobacteria;Alphaproteobacteria;Rhodobacterales;Rhodobacteraceae;Jhaorihella;";"91.7";"14.4";"12";"12";"11";"1";"0";"457171";"391196"
"V4mis2";"SILVA (only NR);Bacteria;Proteobacteria;Alphaproteobacteria;Rhodobacterales;Rhodobacteraceae;Ketogulonicigenium;";"100.0";"14.4";"14";"14";"14";"0";"0";"457169";"391193"
"V4mis2";"SILVA (only NR);Bacteria;Proteobacteria;Alphaproteobacteria;Rhodobacterales;Rhodobacteraceae;Lacimonas;";"100.0";"14.4";"8";"8";"8";"0";"0";"457175";"391199"
"V4mis2";"SILVA (only NR);Bacteria;Proteobacteria;Alphaproteobacteria;Rhodobacterales;Rhodobacteraceae;Leisingera;";"96.0";"14.4";"25";"25";"24";"1";"0";"457158";"391183"
"V4mis2";"SILVA (only NR);Bacteria;Proteobacteria;Alphaproteobacteria;Rhodobacterales;Rhodobacteraceae;Lentibacter;";"100.0";"14.4";"25";"25";"25";"0";"0";"457158";"391182"
"V4mis2";"SILVA (only NR);Bacteria;Proteobacteria;Alphaproteobacteria;Rhodobacterales;Rhodobacteraceae;Limibaculum;";"93.6";"14.4";"94";"94";"88";"6";"0";"457089";"391119"
"V4mis2";"SILVA (only NR);Bacteria;Proteobacteria;Alphaproteobacteria;Rhodobacterales;Rhodobacteraceae;Limimaricola;";"100.0";"14.4";"21";"21";"21";"0";"0";"457162";"391186"
"V4mis2";"SILVA (only NR);Bacteria;Proteobacteria;Alphaproteobacteria;Rhodobacterales;Rhodobacteraceae;Litoreibacter;";"100.0";"14.4";"15";"15";"15";"0";"0";"457168";"391192"
"V4mis2";"SILVA (only NR);Bacteria;Proteobacteria;Alphaproteobacteria;Rhodobacterales;Rhodobacteraceae;Litorimicrobium;";"92.9";"14.4";"14";"14";"13";"1";"0";"457169";"391194"
"V4mis2";"SILVA (only NR);Bacteria;Proteobacteria;Alphaproteobacteria;Rhodobacterales;Rhodobacteraceae;Litorisediminicola;";"100.0";"14.4";"1";"1";"1";"0";"0";"457182";"391206"
"V4mis2";"SILVA (only NR);Bacteria;Proteobacteria;Alphaproteobacteria;Rhodobacterales;Rhodobacteraceae;Litorisediminivivens;";"100.0";"14.4";"2";"2";"2";"0";"0";"457181";"391205"
"V4mis2";"SILVA (only NR);Bacteria;Proteobacteria;Alphaproteobacteria;Rhodobacterales;Rhodobacteraceae;Loktanella;";"100.0";"14.4";"7";"7";"7";"0";"0";"457176";"391200"
"V4mis2";"SILVA (only NR);Bacteria;Proteobacteria;Alphaproteobacteria;Rhodobacterales;Rhodobacteraceae;Lutimaribacter;";"92.3";"14.4";"13";"13";"12";"1";"0";"457170";"391195"
"V4mis2";"SILVA (only NR);Bacteria;Proteobacteria;Alphaproteobacteria;Rhodobacterales;Rhodobacteraceae;Maliponia;";"100.0";"14.4";"1";"1";"1";"0";"0";"457182";"391206"
"V4mis2";"SILVA (only NR);Bacteria;Proteobacteria;Alphaproteobacteria;Rhodobacterales;Rhodobacteraceae;Mameliella;";"100.0";"14.4";"17";"17";"17";"0";"0";"457166";"391190"
"V4mis2";"SILVA (only NR);Bacteria;Proteobacteria;Alphaproteobacteria;Rhodobacterales;Rhodobacteraceae;Maribius;";"100.0";"14.4";"8";"8";"8";"0";"0";"457175";"391199"
"V4mis2";"SILVA (only NR);Bacteria;Proteobacteria;Alphaproteobacteria;Rhodobacterales;Rhodobacteraceae;Marinibacterium;";"100.0";"14.4";"18";"18";"18";"0";"0";"457165";"391189"
"V4mis2";"SILVA (only NR);Bacteria;Proteobacteria;Alphaproteobacteria;Rhodobacterales;Rhodobacteraceae;Marinosulfonomonas;";"100.0";"14.4";"1";"1";"1";"0";"0";"457182";"391206"
"V4mis2";"SILVA (only NR);Bacteria;Proteobacteria;Alphaproteobacteria;Rhodobacterales;Rhodobacteraceae;Marinovum;";"100.0";"14.4";"24";"24";"24";"0";"0";"457159";"391183"
"V4mis2";"SILVA (only NR);Bacteria;Proteobacteria;Alphaproteobacteria;Rhodobacterales;Rhodobacteraceae;Maritimibacter;";"94.7";"14.4";"19";"19";"18";"1";"0";"457164";"391189"
"V4mis2";"SILVA (only NR);Bacteria;Proteobacteria;Alphaproteobacteria;Rhodobacterales;Rhodobacteraceae;Marivita;";"94.9";"14.4";"39";"39";"37";"2";"0";"457144";"391170"
"V4mis2";"SILVA (only NR);Bacteria;Proteobacteria;Alphaproteobacteria;Rhodobacterales;Rhodobacteraceae;Marivivens;";"84.6";"14.4";"13";"13";"11";"2";"0";"457170";"391196"
"V4mis2";"SILVA (only NR);Bacteria;Proteobacteria;Alphaproteobacteria;Rhodobacterales;Rhodobacteraceae;Methylarcula;";"100.0";"14.4";"2";"2";"2";"0";"0";"457181";"391205"
"V4mis2";"SILVA (only NR);Bacteria;Proteobacteria;Alphaproteobacteria;Rhodobacterales;Rhodobacteraceae;Natronohydrobacter;";"100.0";"14.4";"2";"2";"2";"0";"0";"457181";"391205"
"V4mis2";"SILVA (only NR);Bacteria;Proteobacteria;Alphaproteobacteria;Rhodobacterales;Rhodobacteraceae;Nautella;";"100.0";"14.4";"28";"28";"28";"0";"0";"457155";"391179"
"V4mis2";"SILVA (only NR);Bacteria;Proteobacteria;Alphaproteobacteria;Rhodobacterales;Rhodobacteraceae;Nereida;";"100.0";"14.4";"8";"8";"8";"0";"0";"457175";"391199"
"V4mis2";"SILVA (only NR);Bacteria;Proteobacteria;Alphaproteobacteria;Rhodobacterales;Rhodobacteraceae;Nioella;";"100.0";"14.4";"21";"21";"21";"0";"0";"457162";"391186"
"V4mis2";"SILVA (only NR);Bacteria;Proteobacteria;Alphaproteobacteria;Rhodobacterales;Rhodobacteraceae;Oceanibulbus;";"80.0";"14.4";"5";"5";"4";"1";"0";"457178";"391203"
"V4mis2";"SILVA (only NR);Bacteria;Proteobacteria;Alphaproteobacteria;Rhodobacterales;Rhodobacteraceae;Oceanicella;";"90.9";"14.4";"11";"11";"10";"1";"0";"457172";"391197"
"V4mis2";"SILVA (only NR);Bacteria;Proteobacteria;Alphaproteobacteria;Rhodobacterales;Rhodobacteraceae;Oceanicola;";"100.0";"14.4";"10";"10";"10";"0";"0";"457173";"391197"
"V4mis2";"SILVA (only NR);Bacteria;Proteobacteria;Alphaproteobacteria;Rhodobacterales;Rhodobacteraceae;Oceaniovalibus;";"100.0";"14.4";"4";"4";"4";"0";"0";"457179";"391203"
"V4mis2";"SILVA (only NR);Bacteria;Proteobacteria;Alphaproteobacteria;Rhodobacterales;Rhodobacteraceae;Oceanobacterium;";"100.0";"14.4";"5";"5";"5";"0";"0";"457178";"391202"
"V4mis2";"SILVA (only NR);Bacteria;Proteobacteria;Alphaproteobacteria;Rhodobacterales;Rhodobacteraceae;Octadecabacter;";"100.0";"14.4";"42";"42";"42";"0";"0";"457141";"391165"
"V4mis2";"SILVA (only NR);Bacteria;Proteobacteria;Alphaproteobacteria;Rhodobacterales;Rhodobacteraceae;Pacificibacter;";"100.0";"14.4";"4";"4";"4";"0";"0";"457179";"391203"
"V4mis2";"SILVA (only NR);Bacteria;Proteobacteria;Alphaproteobacteria;Rhodobacterales;Rhodobacteraceae;Paenirhodobacter;";"88.9";"14.4";"9";"9";"8";"1";"0";"457174";"391199"
"V4mis2";"SILVA (only NR);Bacteria;Proteobacteria;Alphaproteobacteria;Rhodobacterales;Rhodobacteraceae;Palleronia-Pseudomaribius;";"100.0";"14.4";"11";"11";"11";"0";"0";"457172";"391196"
"V4mis2";"SILVA (only NR);Bacteria;Proteobacteria;Alphaproteobacteria;Rhodobacterales;Rhodobacteraceae;Paracoccus;";"96.3";"14.4";"542";"542";"522";"20";"0";"456641";"390685"
"V4mis2";"SILVA (only NR);Bacteria;Proteobacteria;Alphaproteobacteria;Rhodobacterales;Rhodobacteraceae;Pelagibaca;";"88.9";"14.4";"9";"9";"8";"1";"0";"457174";"391199"
"V4mis2";"SILVA (only NR);Bacteria;Proteobacteria;Alphaproteobacteria;Rhodobacterales;Rhodobacteraceae;Pelagicola;";"85.7";"14.4";"7";"7";"6";"1";"0";"457176";"391201"
"V4mis2";"SILVA (only NR);Bacteria;Proteobacteria;Alphaproteobacteria;Rhodobacterales;Rhodobacteraceae;Pelagimonas;";"100.0";"14.4";"6";"6";"6";"0";"0";"457177";"391201"
"V4mis2";"SILVA (only NR);Bacteria;Proteobacteria;Alphaproteobacteria;Rhodobacterales;Rhodobacteraceae;Phaeobacter;";"100.0";"14.4";"45";"45";"45";"0";"0";"457138";"391162"
"V4mis2";"SILVA (only NR);Bacteria;Proteobacteria;Alphaproteobacteria;Rhodobacterales;Rhodobacteraceae;Planktomarina;";"96.4";"14.4";"110";"110";"106";"4";"0";"457073";"391101"
"V4mis2";"SILVA (only NR);Bacteria;Proteobacteria;Alphaproteobacteria;Rhodobacterales;Rhodobacteraceae;Planktotalea;";"96.0";"14.4";"25";"25";"24";"1";"0";"457158";"391183"
"V4mis2";"SILVA (only NR);Bacteria;Proteobacteria;Alphaproteobacteria;Rhodobacterales;Rhodobacteraceae;Plastorhodobacter;";"100.0";"14.4";"4";"4";"4";"0";"0";"457179";"391203"
"V4mis2";"SILVA (only NR);Bacteria;Proteobacteria;Alphaproteobacteria;Rhodobacterales;Rhodobacteraceae;Pontibaca;";"100.0";"14.4";"4";"4";"4";"0";"0";"457179";"391203"
"V4mis2";"SILVA (only NR);Bacteria;Proteobacteria;Alphaproteobacteria;Rhodobacterales;Rhodobacteraceae;Ponticoccus;";"95.7";"14.4";"23";"23";"22";"1";"0";"457160";"391185"
"V4mis2";"SILVA (only NR);Bacteria;Proteobacteria;Alphaproteobacteria;Rhodobacterales;Rhodobacteraceae;Pontivivens;";"100.0";"14.4";"13";"13";"13";"0";"0";"457170";"391194"
"V4mis2";"SILVA (only NR);Bacteria;Proteobacteria;Alphaproteobacteria;Rhodobacterales;Rhodobacteraceae;Poseidonocella;";"100.0";"14.4";"2";"2";"2";"0";"0";"457181";"391205"
"V4mis2";"SILVA (only NR);Bacteria;Proteobacteria;Alphaproteobacteria;Rhodobacterales;Rhodobacteraceae;Primorskyibacter;";"100.0";"14.4";"5";"5";"5";"0";"0";"457178";"391202"
"V4mis2";"SILVA (only NR);Bacteria;Proteobacteria;Alphaproteobacteria;Rhodobacterales;Rhodobacteraceae;Profundibacterium;";"100.0";"14.4";"3";"3";"3";"0";"0";"457180";"391204"
"V4mis2";"SILVA (only NR);Bacteria;Proteobacteria;Alphaproteobacteria;Rhodobacterales;Rhodobacteraceae;Pseudaestuariivita;";"100.0";"14.4";"2";"2";"2";"0";"0";"457181";"391205"
"V4mis2";"SILVA (only NR);Bacteria;Proteobacteria;Alphaproteobacteria;Rhodobacterales;Rhodobacteraceae;Pseudodonghicola;";"100.0";"14.4";"2";"2";"2";"0";"0";"457181";"391205"
"V4mis2";"SILVA (only NR);Bacteria;Proteobacteria;Alphaproteobacteria;Rhodobacterales;Rhodobacteraceae;Pseudohalocynthiibacter;";"100.0";"14.4";"1";"1";"1";"0";"0";"457182";"391206"
"V4mis2";"SILVA (only NR);Bacteria;Proteobacteria;Alphaproteobacteria;Rhodobacterales;Rhodobacteraceae;Pseudooceanicola;";"97.4";"14.4";"38";"38";"37";"1";"0";"457145";"391170"
"V4mis2";"SILVA (only NR);Bacteria;Proteobacteria;Alphaproteobacteria;Rhodobacterales;Rhodobacteraceae;Pseudooctadecabacter;";"100.0";"14.4";"2";"2";"2";"0";"0";"457181";"391205"
"V4mis2";"SILVA (only NR);Bacteria;Proteobacteria;Alphaproteobacteria;Rhodobacterales;Rhodobacteraceae;Pseudopelagicola;";"100.0";"14.4";"1";"1";"1";"0";"0";"457182";"391206"
"V4mis2";"SILVA (only NR);Bacteria;Proteobacteria;Alphaproteobacteria;Rhodobacterales;Rhodobacteraceae;Pseudophaeobacter;";"97.1";"14.4";"34";"34";"33";"1";"0";"457149";"391174"
"V4mis2";"SILVA (only NR);Bacteria;Proteobacteria;Alphaproteobacteria;Rhodobacterales;Rhodobacteraceae;Pseudorhodobacter;";"98.6";"14.4";"74";"74";"73";"1";"0";"457109";"391134"
"V4mis2";"SILVA (only NR);Bacteria;Proteobacteria;Alphaproteobacteria;Rhodobacterales;Rhodobacteraceae;Pseudoroseicyclus;";"100.0";"14.4";"2";"2";"2";"0";"0";"457181";"391205"
"V4mis2";"SILVA (only NR);Bacteria;Proteobacteria;Alphaproteobacteria;Rhodobacterales;Rhodobacteraceae;Pseudoruegeria;";"100.0";"14.4";"24";"24";"24";"0";"0";"457159";"391183"
"V4mis2";"SILVA (only NR);Bacteria;Proteobacteria;Alphaproteobacteria;Rhodobacterales;Rhodobacteraceae;Puniceibacterium;";"100.0";"14.4";"6";"6";"6";"0";"0";"457177";"391201"
"V4mis2";"SILVA (only NR);Bacteria;Proteobacteria;Alphaproteobacteria;Rhodobacterales;Rhodobacteraceae;Rhodobaca;";"100.0";"14.4";"5";"5";"5";"0";"0";"457178";"391202"
"V4mis2";"SILVA (only NR);Bacteria;Proteobacteria;Alphaproteobacteria;Rhodobacterales;Rhodobacteraceae;Rhodobacter;";"98.4";"14.4";"256";"256";"252";"4";"0";"456927";"390955"
"V4mis2";"SILVA (only NR);Bacteria;Proteobacteria;Alphaproteobacteria;Rhodobacterales;Rhodobacteraceae;Rhodobaculum;";"97.5";"14.4";"40";"40";"39";"1";"0";"457143";"391168"
"V4mis2";"SILVA (only NR);Bacteria;Proteobacteria;Alphaproteobacteria;Rhodobacterales;Rhodobacteraceae;Rhodovulum;";"100.0";"14.4";"60";"60";"60";"0";"0";"457123";"391147"
"V4mis2";"SILVA (only NR);Bacteria;Proteobacteria;Alphaproteobacteria;Rhodobacterales;Rhodobacteraceae;Roseibaca;";"100.0";"14.4";"13";"13";"13";"0";"0";"457170";"391194"
"V4mis2";"SILVA (only NR);Bacteria;Proteobacteria;Alphaproteobacteria;Rhodobacterales;Rhodobacteraceae;Roseibacterium;";"97.1";"14.4";"34";"34";"33";"1";"0";"457149";"391174"
"V4mis2";"SILVA (only NR);Bacteria;Proteobacteria;Alphaproteobacteria;Rhodobacterales;Rhodobacteraceae;Roseicitreum;";"100.0";"14.4";"1";"1";"1";"0";"0";"457182";"391206"
"V4mis2";"SILVA (only NR);Bacteria;Proteobacteria;Alphaproteobacteria;Rhodobacterales;Rhodobacteraceae;Roseicyclus;";"100.0";"14.4";"12";"12";"12";"0";"0";"457171";"391195"
"V4mis2";"SILVA (only NR);Bacteria;Proteobacteria;Alphaproteobacteria;Rhodobacterales;Rhodobacteraceae;Roseinatronobacter;";"100.0";"14.4";"10";"10";"10";"0";"0";"457173";"391197"
"V4mis2";"SILVA (only NR);Bacteria;Proteobacteria;Alphaproteobacteria;Rhodobacterales;Rhodobacteraceae;Roseisalinus;";"100.0";"14.4";"3";"3";"3";"0";"0";"457180";"391204"
"V4mis2";"SILVA (only NR);Bacteria;Proteobacteria;Alphaproteobacteria;Rhodobacterales;Rhodobacteraceae;Roseivivax;";"95.6";"14.4";"114";"114";"109";"5";"0";"457069";"391098"
"V4mis2";"SILVA (only NR);Bacteria;Proteobacteria;Alphaproteobacteria;Rhodobacterales;Rhodobacteraceae;Roseobacter clade CHAB-I-5 lineage;";"96.3";"14.4";"27";"27";"26";"1";"0";"457156";"391181"
"V4mis2";"SILVA (only NR);Bacteria;Proteobacteria;Alphaproteobacteria;Rhodobacterales;Rhodobacteraceae;Roseobacter clade Marinomonas lineage;";"100.0";"14.4";"3";"3";"3";"0";"0";"457180";"391204"
"V4mis2";"SILVA (only NR);Bacteria;Proteobacteria;Alphaproteobacteria;Rhodobacterales;Rhodobacteraceae;Roseobacter clade NAC11-7 lineage;";"97.8";"14.4";"91";"91";"89";"2";"0";"457092";"391118"
"V4mis2";"SILVA (only NR);Bacteria;Proteobacteria;Alphaproteobacteria;Rhodobacterales;Rhodobacteraceae;Roseobacter;";"93.2";"14.4";"44";"44";"41";"3";"0";"457139";"391166"
"V4mis2";"SILVA (only NR);Bacteria;Proteobacteria;Alphaproteobacteria;Rhodobacterales;Rhodobacteraceae;Roseovarius;";"95.9";"14.4";"221";"221";"212";"9";"0";"456962";"390995"
"V4mis2";"SILVA (only NR);Bacteria;Proteobacteria;Alphaproteobacteria;Rhodobacterales;Rhodobacteraceae;Rubellimicrobium;";"98.9";"14.4";"94";"94";"93";"1";"0";"457089";"391114"
"V4mis2";"SILVA (only NR);Bacteria;Proteobacteria;Alphaproteobacteria;Rhodobacterales;Rhodobacteraceae;Rubribacterium;";"100.0";"14.4";"19";"19";"19";"0";"0";"457164";"391188"
"V4mis2";"SILVA (only NR);Bacteria;Proteobacteria;Alphaproteobacteria;Rhodobacterales;Rhodobacteraceae;Rubrimonas;";"100.0";"14.4";"10";"10";"10";"0";"0";"457173";"391197"
"V4mis2";"SILVA (only NR);Bacteria;Proteobacteria;Alphaproteobacteria;Rhodobacterales;Rhodobacteraceae;Ruegeria;";"96.6";"14.4";"145";"145";"140";"5";"0";"457038";"391067"
"V4mis2";"SILVA (only NR);Bacteria;Proteobacteria;Alphaproteobacteria;Rhodobacterales;Rhodobacteraceae;Sagittula;";"100.0";"14.4";"18";"18";"18";"0";"0";"457165";"391189"
"V4mis2";"SILVA (only NR);Bacteria;Proteobacteria;Alphaproteobacteria;Rhodobacterales;Rhodobacteraceae;Salinihabitans;";"100.0";"14.4";"3";"3";"3";"0";"0";"457180";"391204"
"V4mis2";"SILVA (only NR);Bacteria;Proteobacteria;Alphaproteobacteria;Rhodobacterales;Rhodobacteraceae;Salipiger;";"100.0";"14.4";"3";"3";"3";"0";"0";"457180";"391204"
"V4mis2";"SILVA (only NR);Bacteria;Proteobacteria;Alphaproteobacteria;Rhodobacterales;Rhodobacteraceae;Sedimentitalea;";"97.8";"14.4";"45";"45";"44";"1";"0";"457138";"391163"
"V4mis2";"SILVA (only NR);Bacteria;Proteobacteria;Alphaproteobacteria;Rhodobacterales;Rhodobacteraceae;Sediminimonas;";"95.0";"14.4";"20";"20";"19";"1";"0";"457163";"391188"
"V4mis2";"SILVA (only NR);Bacteria;Proteobacteria;Alphaproteobacteria;Rhodobacterales;Rhodobacteraceae;Seohaeicola;";"83.3";"14.4";"6";"6";"5";"1";"0";"457177";"391202"
"V4mis2";"SILVA (only NR);Bacteria;Proteobacteria;Alphaproteobacteria;Rhodobacterales;Rhodobacteraceae;Shimia;";"100.0";"14.4";"22";"22";"22";"0";"0";"457161";"391185"
"V4mis2";"SILVA (only NR);Bacteria;Proteobacteria;Alphaproteobacteria;Rhodobacterales;Rhodobacteraceae;Silicimonas;";"88.9";"14.4";"27";"27";"24";"3";"0";"457156";"391183"
"V4mis2";"SILVA (only NR);Bacteria;Proteobacteria;Alphaproteobacteria;Rhodobacterales;Rhodobacteraceae;Sulfitobacter;";"94.1";"14.4";"273";"273";"257";"16";"0";"456910";"390950"
"V4mis2";"SILVA (only NR);Bacteria;Proteobacteria;Alphaproteobacteria;Rhodobacterales;Rhodobacteraceae;Tabrizicola;";"100.0";"14.4";"53";"53";"53";"0";"0";"457130";"391154"
"V4mis2";"SILVA (only NR);Bacteria;Proteobacteria;Alphaproteobacteria;Rhodobacterales;Rhodobacteraceae;Tateyamaria;";"100.0";"14.4";"39";"39";"39";"0";"0";"457144";"391168"
"V4mis2";"SILVA (only NR);Bacteria;Proteobacteria;Alphaproteobacteria;Rhodobacterales;Rhodobacteraceae;Thalassobius;";"97.2";"14.4";"36";"36";"35";"1";"0";"457147";"391172"
"V4mis2";"SILVA (only NR);Bacteria;Proteobacteria;Alphaproteobacteria;Rhodobacterales;Rhodobacteraceae;Thalassococcus;";"100.0";"14.4";"8";"8";"8";"0";"0";"457175";"391199"
"V4mis2";"SILVA (only NR);Bacteria;Proteobacteria;Alphaproteobacteria;Rhodobacterales;Rhodobacteraceae;Thiobacimonas;";"100.0";"14.4";"3";"3";"3";"0";"0";"457180";"391204"
"V4mis2";"SILVA (only NR);Bacteria;Proteobacteria;Alphaproteobacteria;Rhodobacterales;Rhodobacteraceae;Thioclava;";"100.0";"14.4";"20";"20";"20";"0";"0";"457163";"391187"
"V4mis2";"SILVA (only NR);Bacteria;Proteobacteria;Alphaproteobacteria;Rhodobacterales;Rhodobacteraceae;Tranquillimonas;";"100.0";"14.4";"2";"2";"2";"0";"0";"457181";"391205"
"V4mis2";"SILVA (only NR);Bacteria;Proteobacteria;Alphaproteobacteria;Rhodobacterales;Rhodobacteraceae;Tropicibacter;";"100.0";"14.4";"34";"34";"34";"0";"0";"457149";"391173"
"V4mis2";"SILVA (only NR);Bacteria;Proteobacteria;Alphaproteobacteria;Rhodobacterales;Rhodobacteraceae;Tropicimonas;";"96.3";"14.4";"54";"54";"52";"2";"0";"457129";"391155"
"V4mis2";"SILVA (only NR);Bacteria;Proteobacteria;Alphaproteobacteria;Rhodobacterales;Rhodobacteraceae;Vadicella;";"100.0";"14.4";"3";"3";"3";"0";"0";"457180";"391204"
"V4mis2";"SILVA (only NR);Bacteria;Proteobacteria;Alphaproteobacteria;Rhodobacterales;Rhodobacteraceae;WDS1C4;";"100.0";"14.4";"11";"11";"11";"0";"0";"457172";"391196"
"V4mis2";"SILVA (only NR);Bacteria;Proteobacteria;Alphaproteobacteria;Rhodobacterales;Rhodobacteraceae;Wenxinia;";"85.7";"14.4";"7";"7";"6";"1";"0";"457176";"391201"
"V4mis2";"SILVA (only NR);Bacteria;Proteobacteria;Alphaproteobacteria;Rhodobacterales;Rhodobacteraceae;Yangia;";"100.0";"14.4";"16";"16";"16";"0";"0";"457167";"391191"
"V4mis2";"SILVA (only NR);Bacteria;Proteobacteria;Alphaproteobacteria;Rhodobacterales;Rhodobacteraceae;Yoonia-Loktanella;";"97.5";"14.4";"120";"120";"117";"3";"0";"457063";"391090"
"V4mis2";"SILVA (only NR);Bacteria;Proteobacteria;Alphaproteobacteria;Rhodobacterales;Rhodobacteraceae;Youngimonas;";"100.0";"14.4";"4";"4";"4";"0";"0";"457179";"391203"
"V4mis2";"SILVA (only NR);Bacteria;Proteobacteria;Alphaproteobacteria;Rhodobacterales;Rhodobacteraceae;uncultured;";"96.9";"14.5";"899";"899";"871";"28";"0";"456284";"390336"
"V4mis2";"SILVA (only NR);Bacteria;Proteobacteria;Alphaproteobacteria;Rhodospirillales;";"95.5";"14.5";"1257";"1257";"1201";"56";"0";"455926";"390006"
"V4mis2";"SILVA (only NR);Bacteria;Proteobacteria;Alphaproteobacteria;Rhodospirillales;AEGEAN-169 marine group;";"99.1";"14.4";"108";"108";"107";"1";"0";"457075";"391100"
"V4mis2";"SILVA (only NR);Bacteria;Proteobacteria;Alphaproteobacteria;Rhodospirillales;Magnetospiraceae;";"94.7";"14.4";"339";"339";"321";"18";"0";"456844";"390886"
"V4mis2";"SILVA (only NR);Bacteria;Proteobacteria;Alphaproteobacteria;Rhodospirillales;Magnetospiraceae;Magnetospira;";"98.2";"14.4";"57";"57";"56";"1";"0";"457126";"391151"
"V4mis2";"SILVA (only NR);Bacteria;Proteobacteria;Alphaproteobacteria;Rhodospirillales;Magnetospiraceae;Magnetovibrio;";"82.6";"14.4";"46";"46";"38";"8";"0";"457137";"391169"
"V4mis2";"SILVA (only NR);Bacteria;Proteobacteria;Alphaproteobacteria;Rhodospirillales;Magnetospiraceae;Varunaivibrio;";"100.0";"14.4";"3";"3";"3";"0";"0";"457180";"391204"
"V4mis2";"SILVA (only NR);Bacteria;Proteobacteria;Alphaproteobacteria;Rhodospirillales;Magnetospiraceae;uncultured;";"96.1";"14.4";"230";"230";"221";"9";"0";"456953";"390986"
"V4mis2";"SILVA (only NR);Bacteria;Proteobacteria;Alphaproteobacteria;Rhodospirillales;Magnetospirillaceae;";"100.0";"14.4";"110";"110";"110";"0";"0";"457073";"391097"
"V4mis2";"SILVA (only NR);Bacteria;Proteobacteria;Alphaproteobacteria;Rhodospirillales;Magnetospirillaceae;Magnetospirillum;";"100.0";"14.4";"48";"48";"48";"0";"0";"457135";"391159"
"V4mis2";"SILVA (only NR);Bacteria;Proteobacteria;Alphaproteobacteria;Rhodospirillales;Magnetospirillaceae;Phaeospirillum;";"100.0";"14.4";"11";"11";"11";"0";"0";"457172";"391196"
"V4mis2";"SILVA (only NR);Bacteria;Proteobacteria;Alphaproteobacteria;Rhodospirillales;Magnetospirillaceae;Telmatospirillum;";"100.0";"14.4";"19";"19";"19";"0";"0";"457164";"391188"
"V4mis2";"SILVA (only NR);Bacteria;Proteobacteria;Alphaproteobacteria;Rhodospirillales;Magnetospirillaceae;[Aquaspirillum] polymorphum group;";"100.0";"14.4";"2";"2";"2";"0";"0";"457181";"391205"
"V4mis2";"SILVA (only NR);Bacteria;Proteobacteria;Alphaproteobacteria;Rhodospirillales;Magnetospirillaceae;uncultured;";"100.0";"14.4";"18";"18";"18";"0";"0";"457165";"391189"
"V4mis2";"SILVA (only NR);Bacteria;Proteobacteria;Alphaproteobacteria;Rhodospirillales;Rhodospirillaceae;";"94.8";"14.4";"194";"194";"184";"10";"0";"456989";"391023"
"V4mis2";"SILVA (only NR);Bacteria;Proteobacteria;Alphaproteobacteria;Rhodospirillales;Rhodospirillaceae;BRH-c57;";"100.0";"14.4";"3";"3";"3";"0";"0";"457180";"391204"
"V4mis2";"SILVA (only NR);Bacteria;Proteobacteria;Alphaproteobacteria;Rhodospirillales;Rhodospirillaceae;Caenispirillum;";"100.0";"14.4";"9";"9";"9";"0";"0";"457174";"391198"
"V4mis2";"SILVA (only NR);Bacteria;Proteobacteria;Alphaproteobacteria;Rhodospirillales;Rhodospirillaceae;Candidatus Riegeria;";"96.2";"14.4";"26";"26";"25";"1";"0";"457157";"391182"
"V4mis2";"SILVA (only NR);Bacteria;Proteobacteria;Alphaproteobacteria;Rhodospirillales;Rhodospirillaceae;Haematospirillum;";"100.0";"14.4";"5";"5";"5";"0";"0";"457178";"391202"
"V4mis2";"SILVA (only NR);Bacteria;Proteobacteria;Alphaproteobacteria;Rhodospirillales;Rhodospirillaceae;Insolitispirillum;";"75.0";"14.4";"8";"8";"6";"2";"0";"457175";"391201"
"V4mis2";"SILVA (only NR);Bacteria;Proteobacteria;Alphaproteobacteria;Rhodospirillales;Rhodospirillaceae;Marispirillum;";"100.0";"14.4";"6";"6";"6";"0";"0";"457177";"391201"
"V4mis2";"SILVA (only NR);Bacteria;Proteobacteria;Alphaproteobacteria;Rhodospirillales;Rhodospirillaceae;Novispirillum;";"100.0";"14.4";"7";"7";"7";"0";"0";"457176";"391200"
"V4mis2";"SILVA (only NR);Bacteria;Proteobacteria;Alphaproteobacteria;Rhodospirillales;Rhodospirillaceae;Pararhodospirillum;";"100.0";"14.4";"5";"5";"5";"0";"0";"457178";"391202"
"V4mis2";"SILVA (only NR);Bacteria;Proteobacteria;Alphaproteobacteria;Rhodospirillales;Rhodospirillaceae;Phaeovibrio;";"0.0";"0";"1";"1";"0";"1";"0";"457182";"391207"
"V4mis2";"SILVA (only NR);Bacteria;Proteobacteria;Alphaproteobacteria;Rhodospirillales;Rhodospirillaceae;Rhodospirillum;";"100.0";"14.4";"4";"4";"4";"0";"0";"457179";"391203"
"V4mis2";"SILVA (only NR);Bacteria;Proteobacteria;Alphaproteobacteria;Rhodospirillales;Rhodospirillaceae;Roseospira;";"92.9";"14.4";"14";"14";"13";"1";"0";"457169";"391194"
"V4mis2";"SILVA (only NR);Bacteria;Proteobacteria;Alphaproteobacteria;Rhodospirillales;Rhodospirillaceae;Roseospirillum;";"100.0";"14.4";"6";"6";"6";"0";"0";"457177";"391201"
"V4mis2";"SILVA (only NR);Bacteria;Proteobacteria;Alphaproteobacteria;Rhodospirillales;Rhodospirillaceae;uncultured;";"95.9";"14.4";"97";"97";"93";"4";"0";"457086";"391114"
"V4mis2";"SILVA (only NR);Bacteria;Proteobacteria;Alphaproteobacteria;Rhodospirillales;Terasakiellaceae;";"89.4";"14.4";"113";"113";"101";"12";"0";"457070";"391106"
"V4mis2";"SILVA (only NR);Bacteria;Proteobacteria;Alphaproteobacteria;Rhodospirillales;Terasakiellaceae;Aestuariispira;";"100.0";"14.4";"5";"5";"5";"0";"0";"457178";"391202"
"V4mis2";"SILVA (only NR);Bacteria;Proteobacteria;Alphaproteobacteria;Rhodospirillales;Terasakiellaceae;Terasakiella;";"93.3";"14.4";"15";"15";"14";"1";"0";"457168";"391193"
"V4mis2";"SILVA (only NR);Bacteria;Proteobacteria;Alphaproteobacteria;Rhodospirillales;Terasakiellaceae;uncultured;";"88.0";"14.4";"92";"92";"81";"11";"0";"457091";"391126"
"V4mis2";"SILVA (only NR);Bacteria;Proteobacteria;Alphaproteobacteria;Rhodospirillales;Thalassospiraceae;";"94.8";"14.4";"96";"96";"91";"5";"0";"457087";"391116"
"V4mis2";"SILVA (only NR);Bacteria;Proteobacteria;Alphaproteobacteria;Rhodospirillales;Thalassospiraceae;Thalassospira;";"94.8";"14.4";"96";"96";"91";"5";"0";"457087";"391116"
"V4mis2";"SILVA (only NR);Bacteria;Proteobacteria;Alphaproteobacteria;Rhodospirillales;uncultured;";"96.6";"14.4";"296";"296";"286";"10";"0";"456887";"390921"
"V4mis2";"SILVA (only NR);Bacteria;Proteobacteria;Alphaproteobacteria;Rickettsiales;";"93.0";"14.5";"2242";"2236";"2080";"156";"6";"454947";"389127"
"V4mis2";"SILVA (only NR);Bacteria;Proteobacteria;Alphaproteobacteria;Rickettsiales;AB1;";"100.0";"14.4";"47";"47";"47";"0";"0";"457136";"391160"
"V4mis2";"SILVA (only NR);Bacteria;Proteobacteria;Alphaproteobacteria;Rickettsiales;Anaplasmataceae;";"96.8";"14.4";"247";"247";"239";"8";"0";"456936";"390968"
"V4mis2";"SILVA (only NR);Bacteria;Proteobacteria;Alphaproteobacteria;Rickettsiales;Anaplasmataceae;Anaplasma;";"100.0";"14.4";"57";"57";"57";"0";"0";"457126";"391150"
"V4mis2";"SILVA (only NR);Bacteria;Proteobacteria;Alphaproteobacteria;Rickettsiales;Anaplasmataceae;Candidatus Cryptoplasma;";"100.0";"14.4";"2";"2";"2";"0";"0";"457181";"391205"
"V4mis2";"SILVA (only NR);Bacteria;Proteobacteria;Alphaproteobacteria;Rickettsiales;Anaplasmataceae;Candidatus Neoehrlichia;";"100.0";"14.4";"4";"4";"4";"0";"0";"457179";"391203"
"V4mis2";"SILVA (only NR);Bacteria;Proteobacteria;Alphaproteobacteria;Rickettsiales;Anaplasmataceae;Candidatus Xenohaliotis;";"100.0";"14.4";"5";"5";"5";"0";"0";"457178";"391202"
"V4mis2";"SILVA (only NR);Bacteria;Proteobacteria;Alphaproteobacteria;Rickettsiales;Anaplasmataceae;Candidatus Xenolissoclinum;";"100.0";"14.4";"1";"1";"1";"0";"0";"457182";"391206"
"V4mis2";"SILVA (only NR);Bacteria;Proteobacteria;Alphaproteobacteria;Rickettsiales;Anaplasmataceae;Ehrlichia;";"100.0";"14.4";"35";"35";"35";"0";"0";"457148";"391172"
"V4mis2";"SILVA (only NR);Bacteria;Proteobacteria;Alphaproteobacteria;Rickettsiales;Anaplasmataceae;Neorickettsia;";"100.0";"14.4";"25";"25";"25";"0";"0";"457158";"391182"
"V4mis2";"SILVA (only NR);Bacteria;Proteobacteria;Alphaproteobacteria;Rickettsiales;Anaplasmataceae;Wolbachia;";"92.7";"14.4";"110";"110";"102";"8";"0";"457073";"391105"
"V4mis2";"SILVA (only NR);Bacteria;Proteobacteria;Alphaproteobacteria;Rickettsiales;Anaplasmataceae;uncultured;";"100.0";"14.4";"5";"5";"5";"0";"0";"457178";"391202"
"V4mis2";"SILVA (only NR);Bacteria;Proteobacteria;Alphaproteobacteria;Rickettsiales;Candidatus Hepatincola;";"87.5";"14.4";"8";"8";"7";"1";"0";"457175";"391200"
"V4mis2";"SILVA (only NR);Bacteria;Proteobacteria;Alphaproteobacteria;Rickettsiales;Candidatus Jidaibacter;";"100.0";"14.4";"12";"12";"12";"0";"0";"457171";"391195"
"V4mis2";"SILVA (only NR);Bacteria;Proteobacteria;Alphaproteobacteria;Rickettsiales;Fokiniaceae;";"97.7";"14.4";"44";"44";"43";"1";"0";"457139";"391164"
"V4mis2";"SILVA (only NR);Bacteria;Proteobacteria;Alphaproteobacteria;Rickettsiales;Fokiniaceae;Candidatus Anadelfobacter;";"100.0";"14.4";"2";"2";"2";"0";"0";"457181";"391205"
"V4mis2";"SILVA (only NR);Bacteria;Proteobacteria;Alphaproteobacteria;Rickettsiales;Fokiniaceae;Candidatus Cyrtobacter;";"100.0";"14.4";"2";"2";"2";"0";"0";"457181";"391205"
"V4mis2";"SILVA (only NR);Bacteria;Proteobacteria;Alphaproteobacteria;Rickettsiales;Fokiniaceae;Candidatus Defluviella;";"100.0";"14.4";"1";"1";"1";"0";"0";"457182";"391206"
"V4mis2";"SILVA (only NR);Bacteria;Proteobacteria;Alphaproteobacteria;Rickettsiales;Fokiniaceae;Candidatus Fokinia;";"100.0";"14.4";"3";"3";"3";"0";"0";"457180";"391204"
"V4mis2";"SILVA (only NR);Bacteria;Proteobacteria;Alphaproteobacteria;Rickettsiales;Fokiniaceae;Candidatus Lariskella;";"83.3";"14.4";"6";"6";"5";"1";"0";"457177";"391202"
"V4mis2";"SILVA (only NR);Bacteria;Proteobacteria;Alphaproteobacteria;Rickettsiales;Fokiniaceae;Lyticum;";"100.0";"14.4";"1";"1";"1";"0";"0";"457182";"391206"
"V4mis2";"SILVA (only NR);Bacteria;Proteobacteria;Alphaproteobacteria;Rickettsiales;Fokiniaceae;MD3-55;";"100.0";"14.4";"20";"20";"20";"0";"0";"457163";"391187"
"V4mis2";"SILVA (only NR);Bacteria;Proteobacteria;Alphaproteobacteria;Rickettsiales;Fokiniaceae;uncultured;";"100.0";"14.4";"7";"7";"7";"0";"0";"457176";"391200"
"V4mis2";"SILVA (only NR);Bacteria;Proteobacteria;Alphaproteobacteria;Rickettsiales;Midichloriaceae;";"100.0";"14.4";"7";"7";"7";"0";"0";"457176";"391200"
"V4mis2";"SILVA (only NR);Bacteria;Proteobacteria;Alphaproteobacteria;Rickettsiales;Midichloriaceae;Candidatus Midichloria;";"100.0";"14.4";"7";"7";"7";"0";"0";"457176";"391200"
"V4mis2";"SILVA (only NR);Bacteria;Proteobacteria;Alphaproteobacteria;Rickettsiales;Mitochondria;";"89.1";"14.4";"1227";"1221";"1088";"133";"6";"455962";"390119"
"V4mis2";"SILVA (only NR);Bacteria;Proteobacteria;Alphaproteobacteria;Rickettsiales;Rickettsiaceae;";"97.9";"14.4";"285";"285";"279";"6";"0";"456898";"390928"
"V4mis2";"SILVA (only NR);Bacteria;Proteobacteria;Alphaproteobacteria;Rickettsiales;Rickettsiaceae;Ac37b;";"100.0";"14.4";"2";"2";"2";"0";"0";"457181";"391205"
"V4mis2";"SILVA (only NR);Bacteria;Proteobacteria;Alphaproteobacteria;Rickettsiales;Rickettsiaceae;Candidatus Arcanobacter;";"100.0";"14.4";"1";"1";"1";"0";"0";"457182";"391206"
"V4mis2";"SILVA (only NR);Bacteria;Proteobacteria;Alphaproteobacteria;Rickettsiales;Rickettsiaceae;Candidatus Cryptoprodotis;";"100.0";"14.4";"5";"5";"5";"0";"0";"457178";"391202"
"V4mis2";"SILVA (only NR);Bacteria;Proteobacteria;Alphaproteobacteria;Rickettsiales;Rickettsiaceae;Candidatus Gigarickettsia;";"100.0";"14.4";"3";"3";"3";"0";"0";"457180";"391204"
"V4mis2";"SILVA (only NR);Bacteria;Proteobacteria;Alphaproteobacteria;Rickettsiales;Rickettsiaceae;Candidatus Hemipteriphilus;";"100.0";"14.4";"2";"2";"2";"0";"0";"457181";"391205"
"V4mis2";"SILVA (only NR);Bacteria;Proteobacteria;Alphaproteobacteria;Rickettsiales;Rickettsiaceae;Candidatus Megaira;";"100.0";"14.4";"26";"26";"26";"0";"0";"457157";"391181"
"V4mis2";"SILVA (only NR);Bacteria;Proteobacteria;Alphaproteobacteria;Rickettsiales;Rickettsiaceae;Candidatus Trichorickettsia;";"100.0";"14.4";"3";"3";"3";"0";"0";"457180";"391204"
"V4mis2";"SILVA (only NR);Bacteria;Proteobacteria;Alphaproteobacteria;Rickettsiales;Rickettsiaceae;Orientia;";"100.0";"14.4";"16";"16";"16";"0";"0";"457167";"391191"
"V4mis2";"SILVA (only NR);Bacteria;Proteobacteria;Alphaproteobacteria;Rickettsiales;Rickettsiaceae;Rickettsia;";"96.9";"14.4";"163";"163";"158";"5";"0";"457020";"391049"
"V4mis2";"SILVA (only NR);Bacteria;Proteobacteria;Alphaproteobacteria;Rickettsiales;Rickettsiaceae;uncultured;";"98.3";"14.4";"59";"59";"58";"1";"0";"457124";"391149"
"V4mis2";"SILVA (only NR);Bacteria;Proteobacteria;Alphaproteobacteria;Rickettsiales;S25-593;";"94.4";"14.4";"90";"90";"85";"5";"0";"457093";"391122"
"V4mis2";"SILVA (only NR);Bacteria;Proteobacteria;Alphaproteobacteria;Rickettsiales;SM1B06;";"100.0";"14.4";"4";"4";"4";"0";"0";"457179";"391203"
"V4mis2";"SILVA (only NR);Bacteria;Proteobacteria;Alphaproteobacteria;Rickettsiales;SM2D12;";"99.1";"14.4";"220";"220";"218";"2";"0";"456963";"390989"
"V4mis2";"SILVA (only NR);Bacteria;Proteobacteria;Alphaproteobacteria;Rickettsiales;bac2nit3;";"100.0";"14.4";"4";"4";"4";"0";"0";"457179";"391203"
"V4mis2";"SILVA (only NR);Bacteria;Proteobacteria;Alphaproteobacteria;Rickettsiales;uncultured;";"100.0";"14.4";"44";"44";"44";"0";"0";"457139";"391163"
"V4mis2";"SILVA (only NR);Bacteria;Proteobacteria;Alphaproteobacteria;SAR11 clade;";"98.2";"14.5";"2004";"2004";"1968";"36";"0";"455179";"389239"
"V4mis2";"SILVA (only NR);Bacteria;Proteobacteria;Alphaproteobacteria;SAR11 clade;Clade I;";"97.8";"14.5";"1091";"1091";"1067";"24";"0";"456092";"390140"
"V4mis2";"SILVA (only NR);Bacteria;Proteobacteria;Alphaproteobacteria;SAR11 clade;Clade I;Clade Ia;";"95.9";"14.4";"465";"465";"446";"19";"0";"456718";"390761"
"V4mis2";"SILVA (only NR);Bacteria;Proteobacteria;Alphaproteobacteria;SAR11 clade;Clade I;Clade Ib;";"99.2";"14.4";"238";"238";"236";"2";"0";"456945";"390971"
"V4mis2";"SILVA (only NR);Bacteria;Proteobacteria;Alphaproteobacteria;SAR11 clade;Clade I;uncultured;";"99.2";"14.4";"382";"382";"379";"3";"0";"456801";"390828"
"V4mis2";"SILVA (only NR);Bacteria;Proteobacteria;Alphaproteobacteria;SAR11 clade;Clade II;";"98.7";"14.5";"756";"756";"746";"10";"0";"456427";"390461"
"V4mis2";"SILVA (only NR);Bacteria;Proteobacteria;Alphaproteobacteria;SAR11 clade;Clade III;";"100.0";"14.4";"80";"80";"80";"0";"0";"457103";"391127"
"V4mis2";"SILVA (only NR);Bacteria;Proteobacteria;Alphaproteobacteria;SAR11 clade;Clade IV;";"96.8";"14.4";"31";"31";"30";"1";"0";"457152";"391177"
"V4mis2";"SILVA (only NR);Bacteria;Proteobacteria;Alphaproteobacteria;SAR11 clade;uncultured;";"97.6";"14.4";"42";"42";"41";"1";"0";"457141";"391166"
"V4mis2";"SILVA (only NR);Bacteria;Proteobacteria;Alphaproteobacteria;Sneathiellales;";"95.1";"14.4";"41";"41";"39";"2";"0";"457142";"391168"
"V4mis2";"SILVA (only NR);Bacteria;Proteobacteria;Alphaproteobacteria;Sneathiellales;Sneathiellaceae;";"95.1";"14.4";"41";"41";"39";"2";"0";"457142";"391168"
"V4mis2";"SILVA (only NR);Bacteria;Proteobacteria;Alphaproteobacteria;Sneathiellales;Sneathiellaceae;Oceanibacterium;";"100.0";"14.4";"1";"1";"1";"0";"0";"457182";"391206"
"V4mis2";"SILVA (only NR);Bacteria;Proteobacteria;Alphaproteobacteria;Sneathiellales;Sneathiellaceae;Sneathiella;";"93.5";"14.4";"31";"31";"29";"2";"0";"457152";"391178"
"V4mis2";"SILVA (only NR);Bacteria;Proteobacteria;Alphaproteobacteria;Sneathiellales;Sneathiellaceae;uncultured;";"100.0";"14.4";"9";"9";"9";"0";"0";"457174";"391198"
"V4mis2";"SILVA (only NR);Bacteria;Proteobacteria;Alphaproteobacteria;Sphingomonadales;";"95.4";"14.5";"4495";"4495";"4290";"205";"0";"452688";"386917"
"V4mis2";"SILVA (only NR);Bacteria;Proteobacteria;Alphaproteobacteria;Sphingomonadales;Sphingomonadaceae;";"95.4";"14.5";"4495";"4495";"4290";"205";"0";"452688";"386917"
"V4mis2";"SILVA (only NR);Bacteria;Proteobacteria;Alphaproteobacteria;Sphingomonadales;Sphingomonadaceae;Altererythrobacter;";"97.1";"14.4";"309";"309";"300";"9";"0";"456874";"390907"
"V4mis2";"SILVA (only NR);Bacteria;Proteobacteria;Alphaproteobacteria;Sphingomonadales;Sphingomonadaceae;Blastomonas;";"88.9";"14.4";"27";"27";"24";"3";"0";"457156";"391183"
"V4mis2";"SILVA (only NR);Bacteria;Proteobacteria;Alphaproteobacteria;Sphingomonadales;Sphingomonadaceae;Croceicoccus;";"90.9";"14.4";"11";"11";"10";"1";"0";"457172";"391197"
"V4mis2";"SILVA (only NR);Bacteria;Proteobacteria;Alphaproteobacteria;Sphingomonadales;Sphingomonadaceae;DSSF69;";"100.0";"14.4";"14";"14";"14";"0";"0";"457169";"391193"
"V4mis2";"SILVA (only NR);Bacteria;Proteobacteria;Alphaproteobacteria;Sphingomonadales;Sphingomonadaceae;Ellin6055;";"96.7";"14.4";"92";"92";"89";"3";"0";"457091";"391118"
"V4mis2";"SILVA (only NR);Bacteria;Proteobacteria;Alphaproteobacteria;Sphingomonadales;Sphingomonadaceae;Erythrobacter;";"96.1";"14.4";"259";"259";"249";"10";"0";"456924";"390958"
"V4mis2";"SILVA (only NR);Bacteria;Proteobacteria;Alphaproteobacteria;Sphingomonadales;Sphingomonadaceae;Hephaestia;";"85.7";"14.4";"7";"7";"6";"1";"0";"457176";"391201"
"V4mis2";"SILVA (only NR);Bacteria;Proteobacteria;Alphaproteobacteria;Sphingomonadales;Sphingomonadaceae;MN 122.2a;";"100.0";"14.4";"7";"7";"7";"0";"0";"457176";"391200"
"V4mis2";"SILVA (only NR);Bacteria;Proteobacteria;Alphaproteobacteria;Sphingomonadales;Sphingomonadaceae;Novosphingobium;";"94.6";"14.4";"552";"552";"522";"30";"0";"456631";"390685"
"V4mis2";"SILVA (only NR);Bacteria;Proteobacteria;Alphaproteobacteria;Sphingomonadales;Sphingomonadaceae;Parablastomonas;";"100.0";"14.4";"5";"5";"5";"0";"0";"457178";"391202"
"V4mis2";"SILVA (only NR);Bacteria;Proteobacteria;Alphaproteobacteria;Sphingomonadales;Sphingomonadaceae;Parasphingopyxis;";"100.0";"14.4";"8";"8";"8";"0";"0";"457175";"391199"
"V4mis2";"SILVA (only NR);Bacteria;Proteobacteria;Alphaproteobacteria;Sphingomonadales;Sphingomonadaceae;Plot4-2H12;";"100.0";"14.4";"3";"3";"3";"0";"0";"457180";"391204"
"V4mis2";"SILVA (only NR);Bacteria;Proteobacteria;Alphaproteobacteria;Sphingomonadales;Sphingomonadaceae;Polymorphobacter;";"100.0";"14.4";"30";"30";"30";"0";"0";"457153";"391177"
"V4mis2";"SILVA (only NR);Bacteria;Proteobacteria;Alphaproteobacteria;Sphingomonadales;Sphingomonadaceae;Porphyrobacter;";"95.8";"14.4";"96";"96";"92";"4";"0";"457087";"391115"
"V4mis2";"SILVA (only NR);Bacteria;Proteobacteria;Alphaproteobacteria;Sphingomonadales;Sphingomonadaceae;Qipengyuania;";"86.4";"14.4";"22";"22";"19";"3";"0";"457161";"391188"
"V4mis2";"SILVA (only NR);Bacteria;Proteobacteria;Alphaproteobacteria;Sphingomonadales;Sphingomonadaceae;Rhizorhapis;";"98.1";"14.4";"54";"54";"53";"1";"0";"457129";"391154"
"V4mis2";"SILVA (only NR);Bacteria;Proteobacteria;Alphaproteobacteria;Sphingomonadales;Sphingomonadaceae;SD04E11;";"91.7";"14.4";"12";"12";"11";"1";"0";"457171";"391196"
"V4mis2";"SILVA (only NR);Bacteria;Proteobacteria;Alphaproteobacteria;Sphingomonadales;Sphingomonadaceae;Sandaracinobacter;";"100.0";"14.4";"19";"19";"19";"0";"0";"457164";"391188"
"V4mis2";"SILVA (only NR);Bacteria;Proteobacteria;Alphaproteobacteria;Sphingomonadales;Sphingomonadaceae;Sandarakinorhabdus;";"100.0";"14.4";"9";"9";"9";"0";"0";"457174";"391198"
"V4mis2";"SILVA (only NR);Bacteria;Proteobacteria;Alphaproteobacteria;Sphingomonadales;Sphingomonadaceae;Sphingoaurantiacus;";"96.0";"14.4";"25";"25";"24";"1";"0";"457158";"391183"
"V4mis2";"SILVA (only NR);Bacteria;Proteobacteria;Alphaproteobacteria;Sphingomonadales;Sphingomonadaceae;Sphingobium;";"93.0";"14.4";"484";"484";"450";"34";"0";"456699";"390757"
"V4mis2";"SILVA (only NR);Bacteria;Proteobacteria;Alphaproteobacteria;Sphingomonadales;Sphingomonadaceae;Sphingomicrobium;";"88.9";"14.4";"9";"9";"8";"1";"0";"457174";"391199"
"V4mis2";"SILVA (only NR);Bacteria;Proteobacteria;Alphaproteobacteria;Sphingomonadales;Sphingomonadaceae;Sphingomonas;";"95.5";"14.5";"1787";"1787";"1707";"80";"0";"455396";"389500"
"V4mis2";"SILVA (only NR);Bacteria;Proteobacteria;Alphaproteobacteria;Sphingomonadales;Sphingomonadaceae;Sphingopyxis;";"98.6";"14.4";"214";"214";"211";"3";"0";"456969";"390996"
"V4mis2";"SILVA (only NR);Bacteria;Proteobacteria;Alphaproteobacteria;Sphingomonadales;Sphingomonadaceae;Sphingorhabdus;";"95.0";"14.4";"120";"120";"114";"6";"0";"457063";"391093"
"V4mis2";"SILVA (only NR);Bacteria;Proteobacteria;Alphaproteobacteria;Sphingomonadales;Sphingomonadaceae;Sphingosinicella;";"100.0";"14.4";"13";"13";"13";"0";"0";"457170";"391194"
"V4mis2";"SILVA (only NR);Bacteria;Proteobacteria;Alphaproteobacteria;Sphingomonadales;Sphingomonadaceae;Stakelama;";"100.0";"14.4";"6";"6";"6";"0";"0";"457177";"391201"
"V4mis2";"SILVA (only NR);Bacteria;Proteobacteria;Alphaproteobacteria;Sphingomonadales;Sphingomonadaceae;Zymomonas;";"97.0";"14.4";"33";"33";"32";"1";"0";"457150";"391175"
"V4mis2";"SILVA (only NR);Bacteria;Proteobacteria;Alphaproteobacteria;Sphingomonadales;Sphingomonadaceae;uncultured;";"94.9";"14.4";"256";"256";"243";"13";"0";"456927";"390964"
"V4mis2";"SILVA (only NR);Bacteria;Proteobacteria;Alphaproteobacteria;Thalassobaculales;";"96.7";"14.4";"152";"152";"147";"5";"0";"457031";"391060"
"V4mis2";"SILVA (only NR);Bacteria;Proteobacteria;Alphaproteobacteria;Thalassobaculales;Nisaeaceae;";"95.5";"14.4";"44";"44";"42";"2";"0";"457139";"391165"
"V4mis2";"SILVA (only NR);Bacteria;Proteobacteria;Alphaproteobacteria;Thalassobaculales;Nisaeaceae;Nisaea;";"100.0";"14.4";"12";"12";"12";"0";"0";"457171";"391195"
"V4mis2";"SILVA (only NR);Bacteria;Proteobacteria;Alphaproteobacteria;Thalassobaculales;Nisaeaceae;OM75 clade;";"93.8";"14.4";"32";"32";"30";"2";"0";"457151";"391177"
"V4mis2";"SILVA (only NR);Bacteria;Proteobacteria;Alphaproteobacteria;Thalassobaculales;Oceanibaculaceae;";"100.0";"14.4";"7";"7";"7";"0";"0";"457176";"391200"
"V4mis2";"SILVA (only NR);Bacteria;Proteobacteria;Alphaproteobacteria;Thalassobaculales;Oceanibaculaceae;Oceanibaculum;";"100.0";"14.4";"7";"7";"7";"0";"0";"457176";"391200"
"V4mis2";"SILVA (only NR);Bacteria;Proteobacteria;Alphaproteobacteria;Thalassobaculales;Thalassobaculaceae;";"93.3";"14.4";"15";"15";"14";"1";"0";"457168";"391193"
"V4mis2";"SILVA (only NR);Bacteria;Proteobacteria;Alphaproteobacteria;Thalassobaculales;Thalassobaculaceae;Candidatus Endolissoclinum;";"100.0";"14.4";"2";"2";"2";"0";"0";"457181";"391205"
"V4mis2";"SILVA (only NR);Bacteria;Proteobacteria;Alphaproteobacteria;Thalassobaculales;Thalassobaculaceae;Thalassobaculum;";"92.3";"14.4";"13";"13";"12";"1";"0";"457170";"391195"
"V4mis2";"SILVA (only NR);Bacteria;Proteobacteria;Alphaproteobacteria;Thalassobaculales;uncultured;";"97.7";"14.4";"86";"86";"84";"2";"0";"457097";"391123"
"V4mis2";"SILVA (only NR);Bacteria;Proteobacteria;Alphaproteobacteria;Tistrellales;";"93.7";"14.4";"126";"126";"118";"8";"0";"457057";"391089"
"V4mis2";"SILVA (only NR);Bacteria;Proteobacteria;Alphaproteobacteria;Tistrellales;Geminicoccaceae;";"95.1";"14.4";"103";"103";"98";"5";"0";"457080";"391109"
"V4mis2";"SILVA (only NR);Bacteria;Proteobacteria;Alphaproteobacteria;Tistrellales;Geminicoccaceae;Arboricoccus;";"100.0";"14.4";"4";"4";"4";"0";"0";"457179";"391203"
"V4mis2";"SILVA (only NR);Bacteria;Proteobacteria;Alphaproteobacteria;Tistrellales;Geminicoccaceae;Candidatus Alysiosphaera;";"96.3";"14.4";"54";"54";"52";"2";"0";"457129";"391155"
"V4mis2";"SILVA (only NR);Bacteria;Proteobacteria;Alphaproteobacteria;Tistrellales;Geminicoccaceae;Geminicoccus;";"100.0";"14.4";"9";"9";"9";"0";"0";"457174";"391198"
"V4mis2";"SILVA (only NR);Bacteria;Proteobacteria;Alphaproteobacteria;Tistrellales;Geminicoccaceae;uncultured;";"91.7";"14.4";"36";"36";"33";"3";"0";"457147";"391174"
"V4mis2";"SILVA (only NR);Bacteria;Proteobacteria;Alphaproteobacteria;Tistrellales;Tistrellaceae;";"87.0";"14.4";"23";"23";"20";"3";"0";"457160";"391187"
"V4mis2";"SILVA (only NR);Bacteria;Proteobacteria;Alphaproteobacteria;Tistrellales;Tistrellaceae;Tistrella;";"87.0";"14.4";"23";"23";"20";"3";"0";"457160";"391187"
"V4mis2";"SILVA (only NR);Bacteria;Proteobacteria;Alphaproteobacteria;Zavarziniales;";"95.8";"14.4";"24";"24";"23";"1";"0";"457159";"391184"
"V4mis2";"SILVA (only NR);Bacteria;Proteobacteria;Alphaproteobacteria;Zavarziniales;Zavarziniaceae;";"100.0";"14.4";"5";"5";"5";"0";"0";"457178";"391202"
"V4mis2";"SILVA (only NR);Bacteria;Proteobacteria;Alphaproteobacteria;Zavarziniales;Zavarziniaceae;Oleomonas;";"100.0";"14.4";"1";"1";"1";"0";"0";"457182";"391206"
"V4mis2";"SILVA (only NR);Bacteria;Proteobacteria;Alphaproteobacteria;Zavarziniales;Zavarziniaceae;Zavarzinia;";"100.0";"14.4";"2";"2";"2";"0";"0";"457181";"391205"
"V4mis2";"SILVA (only NR);Bacteria;Proteobacteria;Alphaproteobacteria;Zavarziniales;uncultured;";"94.7";"14.4";"19";"19";"18";"1";"0";"457164";"391189"
"V4mis2";"SILVA (only NR);Bacteria;Proteobacteria;Alphaproteobacteria;uncultured;";"96.9";"14.4";"481";"481";"466";"15";"0";"456702";"390741"
"V4mis2";"SILVA (only NR);Bacteria;Proteobacteria;Gammaproteobacteria;";"94.4";"16.2";"75026";"75026";"70862";"4164";"0";"382157";"320345"
"V4mis2";"SILVA (only NR);Bacteria;Proteobacteria;Gammaproteobacteria;1013-28-CG33;";"100.0";"14.4";"19";"19";"19";"0";"0";"457164";"391188"
"V4mis2";"SILVA (only NR);Bacteria;Proteobacteria;Gammaproteobacteria;AT-s16;";"100.0";"14.4";"6";"6";"6";"0";"0";"457177";"391201"
"V4mis2";"SILVA (only NR);Bacteria;Proteobacteria;Gammaproteobacteria;AT-s2-59;";"98.1";"14.4";"54";"54";"53";"1";"0";"457129";"391154"
"V4mis2";"SILVA (only NR);Bacteria;Proteobacteria;Gammaproteobacteria;Acidiferrobacterales;";"96.5";"14.4";"113";"113";"109";"4";"0";"457070";"391098"
"V4mis2";"SILVA (only NR);Bacteria;Proteobacteria;Gammaproteobacteria;Acidiferrobacterales;Acidiferrobacteraceae;";"96.5";"14.4";"113";"113";"109";"4";"0";"457070";"391098"
"V4mis2";"SILVA (only NR);Bacteria;Proteobacteria;Gammaproteobacteria;Acidiferrobacterales;Acidiferrobacteraceae;Acidiferrobacter;";"100.0";"14.4";"5";"5";"5";"0";"0";"457178";"391202"
"V4mis2";"SILVA (only NR);Bacteria;Proteobacteria;Gammaproteobacteria;Acidiferrobacterales;Acidiferrobacteraceae;Sulfurifustis;";"95.4";"14.4";"87";"87";"83";"4";"0";"457096";"391124"
"V4mis2";"SILVA (only NR);Bacteria;Proteobacteria;Gammaproteobacteria;Acidiferrobacterales;Acidiferrobacteraceae;uncultured;";"100.0";"14.4";"17";"17";"17";"0";"0";"457166";"391190"
"V4mis2";"SILVA (only NR);Bacteria;Proteobacteria;Gammaproteobacteria;Acidithiobacillales;";"95.1";"14.4";"344";"344";"327";"17";"0";"456839";"390880"
"V4mis2";"SILVA (only NR);Bacteria;Proteobacteria;Gammaproteobacteria;Acidithiobacillales;Acidithiobacillaceae;";"95.1";"14.4";"344";"344";"327";"17";"0";"456839";"390880"
"V4mis2";"SILVA (only NR);Bacteria;Proteobacteria;Gammaproteobacteria;Acidithiobacillales;Acidithiobacillaceae;9M32;";"100.0";"14.4";"25";"25";"25";"0";"0";"457158";"391182"
"V4mis2";"SILVA (only NR);Bacteria;Proteobacteria;Gammaproteobacteria;Acidithiobacillales;Acidithiobacillaceae;Acidithiobacillus;";"94.1";"14.4";"236";"236";"222";"14";"0";"456947";"390985"
"V4mis2";"SILVA (only NR);Bacteria;Proteobacteria;Gammaproteobacteria;Acidithiobacillales;Acidithiobacillaceae;KCM-B-112;";"94.7";"14.4";"57";"57";"54";"3";"0";"457126";"391153"
"V4mis2";"SILVA (only NR);Bacteria;Proteobacteria;Gammaproteobacteria;Acidithiobacillales;Acidithiobacillaceae;RCP1-48;";"100.0";"14.4";"14";"14";"14";"0";"0";"457169";"391193"
"V4mis2";"SILVA (only NR);Bacteria;Proteobacteria;Gammaproteobacteria;Acidithiobacillales;Acidithiobacillaceae;TX1A-55;";"100.0";"14.4";"5";"5";"5";"0";"0";"457178";"391202"
"V4mis2";"SILVA (only NR);Bacteria;Proteobacteria;Gammaproteobacteria;Acidithiobacillales;Acidithiobacillaceae;Thermithiobacillus;";"100.0";"14.4";"7";"7";"7";"0";"0";"457176";"391200"
"V4mis2";"SILVA (only NR);Bacteria;Proteobacteria;Gammaproteobacteria;Arenicellales;";"96.8";"14.4";"216";"216";"209";"7";"0";"456967";"390998"
"V4mis2";"SILVA (only NR);Bacteria;Proteobacteria;Gammaproteobacteria;Arenicellales;Arenicellaceae;";"96.8";"14.4";"216";"216";"209";"7";"0";"456967";"390998"
"V4mis2";"SILVA (only NR);Bacteria;Proteobacteria;Gammaproteobacteria;Arenicellales;Arenicellaceae;Arenicella;";"95.5";"14.4";"22";"22";"21";"1";"0";"457161";"391186"
"V4mis2";"SILVA (only NR);Bacteria;Proteobacteria;Gammaproteobacteria;Arenicellales;Arenicellaceae;Candidatus Thiosymbion;";"97.4";"14.4";"38";"38";"37";"1";"0";"457145";"391170"
"V4mis2";"SILVA (only NR);Bacteria;Proteobacteria;Gammaproteobacteria;Arenicellales;Arenicellaceae;HTCC5015;";"100.0";"14.4";"16";"16";"16";"0";"0";"457167";"391191"
"V4mis2";"SILVA (only NR);Bacteria;Proteobacteria;Gammaproteobacteria;Arenicellales;Arenicellaceae;Perspicuibacter;";"100.0";"14.4";"4";"4";"4";"0";"0";"457179";"391203"
"V4mis2";"SILVA (only NR);Bacteria;Proteobacteria;Gammaproteobacteria;Arenicellales;Arenicellaceae;Thiolapillus;";"100.0";"14.4";"8";"8";"8";"0";"0";"457175";"391199"
"V4mis2";"SILVA (only NR);Bacteria;Proteobacteria;Gammaproteobacteria;Arenicellales;Arenicellaceae;uncultured;";"96.0";"14.4";"125";"125";"120";"5";"0";"457058";"391087"
"V4mis2";"SILVA (only NR);Bacteria;Proteobacteria;Gammaproteobacteria;B108;";"100.0";"14.4";"2";"2";"2";"0";"0";"457181";"391205"
"V4mis2";"SILVA (only NR);Bacteria;Proteobacteria;Gammaproteobacteria;B2M28;";"94.5";"14.4";"165";"165";"156";"9";"0";"457018";"391051"
"V4mis2";"SILVA (only NR);Bacteria;Proteobacteria;Gammaproteobacteria;BD7-8;";"100.0";"14.4";"21";"21";"21";"0";"0";"457162";"391186"
"V4mis2";"SILVA (only NR);Bacteria;Proteobacteria;Gammaproteobacteria;BD72BR169;";"100.0";"14.4";"14";"14";"14";"0";"0";"457169";"391193"
"V4mis2";"SILVA (only NR);Bacteria;Proteobacteria;Gammaproteobacteria;Beggiatoales;";"97.1";"14.4";"137";"137";"133";"4";"0";"457046";"391074"
"V4mis2";"SILVA (only NR);Bacteria;Proteobacteria;Gammaproteobacteria;Beggiatoales;Beggiatoaceae;";"97.1";"14.4";"137";"137";"133";"4";"0";"457046";"391074"
"V4mis2";"SILVA (only NR);Bacteria;Proteobacteria;Gammaproteobacteria;Beggiatoales;Beggiatoaceae;Beggiatoa;";"96.4";"14.4";"28";"28";"27";"1";"0";"457155";"391180"
"V4mis2";"SILVA (only NR);Bacteria;Proteobacteria;Gammaproteobacteria;Beggiatoales;Beggiatoaceae;Candidatus Allobeggiatoa;";"100.0";"14.4";"1";"1";"1";"0";"0";"457182";"391206"
"V4mis2";"SILVA (only NR);Bacteria;Proteobacteria;Gammaproteobacteria;Beggiatoales;Beggiatoaceae;Candidatus Isobeggiatoa;";"100.0";"14.4";"7";"7";"7";"0";"0";"457176";"391200"
"V4mis2";"SILVA (only NR);Bacteria;Proteobacteria;Gammaproteobacteria;Beggiatoales;Beggiatoaceae;Candidatus Maribeggiatoa;";"100.0";"14.4";"2";"2";"2";"0";"0";"457181";"391205"
"V4mis2";"SILVA (only NR);Bacteria;Proteobacteria;Gammaproteobacteria;Beggiatoales;Beggiatoaceae;Candidatus Marithioploca;";"100.0";"14.4";"4";"4";"4";"0";"0";"457179";"391203"
"V4mis2";"SILVA (only NR);Bacteria;Proteobacteria;Gammaproteobacteria;Beggiatoales;Beggiatoaceae;Candidatus Marithrix;";"100.0";"14.4";"5";"5";"5";"0";"0";"457178";"391202"
"V4mis2";"SILVA (only NR);Bacteria;Proteobacteria;Gammaproteobacteria;Beggiatoales;Beggiatoaceae;Candidatus Parabeggiatoa;";"100.0";"14.4";"4";"4";"4";"0";"0";"457179";"391203"
"V4mis2";"SILVA (only NR);Bacteria;Proteobacteria;Gammaproteobacteria;Beggiatoales;Beggiatoaceae;Candidatus Thiophysa;";"100.0";"14.4";"1";"1";"1";"0";"0";"457182";"391206"
"V4mis2";"SILVA (only NR);Bacteria;Proteobacteria;Gammaproteobacteria;Beggiatoales;Beggiatoaceae;Candidatus Thiopilula;";"100.0";"14.4";"5";"5";"5";"0";"0";"457178";"391202"
"V4mis2";"SILVA (only NR);Bacteria;Proteobacteria;Gammaproteobacteria;Beggiatoales;Beggiatoaceae;Thioflexothrix;";"100.0";"14.4";"10";"10";"10";"0";"0";"457173";"391197"
"V4mis2";"SILVA (only NR);Bacteria;Proteobacteria;Gammaproteobacteria;Beggiatoales;Beggiatoaceae;Thiomargarita;";"100.0";"14.4";"10";"10";"10";"0";"0";"457173";"391197"
"V4mis2";"SILVA (only NR);Bacteria;Proteobacteria;Gammaproteobacteria;Beggiatoales;Beggiatoaceae;Thioploca;";"100.0";"14.4";"4";"4";"4";"0";"0";"457179";"391203"
"V4mis2";"SILVA (only NR);Bacteria;Proteobacteria;Gammaproteobacteria;Beggiatoales;Beggiatoaceae;uncultured;";"94.4";"14.4";"54";"54";"51";"3";"0";"457129";"391156"
"V4mis2";"SILVA (only NR);Bacteria;Proteobacteria;Gammaproteobacteria;Burkholderiales;";"94.9";"14.9";"20421";"20421";"19384";"1037";"0";"436762";"371823"
"V4mis2";"SILVA (only NR);Bacteria;Proteobacteria;Gammaproteobacteria;Burkholderiales;A21b;";"100.0";"14.4";"76";"76";"76";"0";"0";"457107";"391131"
"V4mis2";"SILVA (only NR);Bacteria;Proteobacteria;Gammaproteobacteria;Burkholderiales;Alcaligenaceae;";"95.2";"14.5";"1746";"1746";"1663";"83";"0";"455437";"389544"
"V4mis2";"SILVA (only NR);Bacteria;Proteobacteria;Gammaproteobacteria;Burkholderiales;Alcaligenaceae;Achromobacter;";"93.4";"14.4";"348";"348";"325";"23";"0";"456835";"390882"
"V4mis2";"SILVA (only NR);Bacteria;Proteobacteria;Gammaproteobacteria;Burkholderiales;Alcaligenaceae;Advenella;";"97.6";"14.4";"41";"41";"40";"1";"0";"457142";"391167"
"V4mis2";"SILVA (only NR);Bacteria;Proteobacteria;Gammaproteobacteria;Burkholderiales;Alcaligenaceae;Alcaligenes;";"88.8";"14.4";"269";"269";"239";"30";"0";"456914";"390968"
"V4mis2";"SILVA (only NR);Bacteria;Proteobacteria;Gammaproteobacteria;Burkholderiales;Alcaligenaceae;Ampullimonas;";"100.0";"14.4";"2";"2";"2";"0";"0";"457181";"391205"
"V4mis2";"SILVA (only NR);Bacteria;Proteobacteria;Gammaproteobacteria;Burkholderiales;Alcaligenaceae;Basilea;";"100.0";"14.4";"3";"3";"3";"0";"0";"457180";"391204"
"V4mis2";"SILVA (only NR);Bacteria;Proteobacteria;Gammaproteobacteria;Burkholderiales;Alcaligenaceae;Bordetella;";"98.7";"14.4";"532";"532";"525";"7";"0";"456651";"390682"
"V4mis2";"SILVA (only NR);Bacteria;Proteobacteria;Gammaproteobacteria;Burkholderiales;Alcaligenaceae;Brackiella;";"100.0";"14.4";"1";"1";"1";"0";"0";"457182";"391206"
"V4mis2";"SILVA (only NR);Bacteria;Proteobacteria;Gammaproteobacteria;Burkholderiales;Alcaligenaceae;Candidatus Kinetoplastibacterium;";"100.0";"14.4";"9";"9";"9";"0";"0";"457174";"391198"
"V4mis2";"SILVA (only NR);Bacteria;Proteobacteria;Gammaproteobacteria;Burkholderiales;Alcaligenaceae;Candidimonas;";"100.0";"14.4";"22";"22";"22";"0";"0";"457161";"391185"
"V4mis2";"SILVA (only NR);Bacteria;Proteobacteria;Gammaproteobacteria;Burkholderiales;Alcaligenaceae;Castellaniella;";"97.6";"14.4";"83";"83";"81";"2";"0";"457100";"391126"
"V4mis2";"SILVA (only NR);Bacteria;Proteobacteria;Gammaproteobacteria;Burkholderiales;Alcaligenaceae;Derxia;";"100.0";"14.4";"6";"6";"6";"0";"0";"457177";"391201"
"V4mis2";"SILVA (only NR);Bacteria;Proteobacteria;Gammaproteobacteria;Burkholderiales;Alcaligenaceae;Eoetvoesia;";"100.0";"14.4";"10";"10";"10";"0";"0";"457173";"391197"
"V4mis2";"SILVA (only NR);Bacteria;Proteobacteria;Gammaproteobacteria;Burkholderiales;Alcaligenaceae;GKS98 freshwater group;";"96.5";"14.4";"57";"57";"55";"2";"0";"457126";"391152"
"V4mis2";"SILVA (only NR);Bacteria;Proteobacteria;Gammaproteobacteria;Burkholderiales;Alcaligenaceae;Kerstersia;";"85.2";"14.4";"27";"27";"23";"4";"0";"457156";"391184"
"V4mis2";"SILVA (only NR);Bacteria;Proteobacteria;Gammaproteobacteria;Burkholderiales;Alcaligenaceae;Oligella;";"86.7";"14.4";"15";"15";"13";"2";"0";"457168";"391194"
"V4mis2";"SILVA (only NR);Bacteria;Proteobacteria;Gammaproteobacteria;Burkholderiales;Alcaligenaceae;Orrella;";"100.0";"14.4";"3";"3";"3";"0";"0";"457180";"391204"
"V4mis2";"SILVA (only NR);Bacteria;Proteobacteria;Gammaproteobacteria;Burkholderiales;Alcaligenaceae;Paenalcaligenes;";"95.0";"14.4";"20";"20";"19";"1";"0";"457163";"391188"
"V4mis2";"SILVA (only NR);Bacteria;Proteobacteria;Gammaproteobacteria;Burkholderiales;Alcaligenaceae;Paralcaligenes;";"100.0";"14.4";"4";"4";"4";"0";"0";"457179";"391203"
"V4mis2";"SILVA (only NR);Bacteria;Proteobacteria;Gammaproteobacteria;Burkholderiales;Alcaligenaceae;Parapusillimonas;";"96.3";"14.4";"54";"54";"52";"2";"0";"457129";"391155"
"V4mis2";"SILVA (only NR);Bacteria;Proteobacteria;Gammaproteobacteria;Burkholderiales;Alcaligenaceae;Parvibium;";"100.0";"14.4";"7";"7";"7";"0";"0";"457176";"391200"
"V4mis2";"SILVA (only NR);Bacteria;Proteobacteria;Gammaproteobacteria;Burkholderiales;Alcaligenaceae;Pelistega;";"100.0";"14.4";"10";"10";"10";"0";"0";"457173";"391197"
"V4mis2";"SILVA (only NR);Bacteria;Proteobacteria;Gammaproteobacteria;Burkholderiales;Alcaligenaceae;Pigmentiphaga;";"81.0";"14.4";"21";"21";"17";"4";"0";"457162";"391190"
"V4mis2";"SILVA (only NR);Bacteria;Proteobacteria;Gammaproteobacteria;Burkholderiales;Alcaligenaceae;Pusillimonas;";"95.2";"14.4";"63";"63";"60";"3";"0";"457120";"391147"
"V4mis2";"SILVA (only NR);Bacteria;Proteobacteria;Gammaproteobacteria;Burkholderiales;Alcaligenaceae;Taylorella;";"94.1";"14.4";"17";"17";"16";"1";"0";"457166";"391191"
"V4mis2";"SILVA (only NR);Bacteria;Proteobacteria;Gammaproteobacteria;Burkholderiales;Alcaligenaceae;Verticiella;";"97.4";"14.4";"39";"39";"38";"1";"0";"457144";"391169"
"V4mis2";"SILVA (only NR);Bacteria;Proteobacteria;Gammaproteobacteria;Burkholderiales;Alcaligenaceae;uncultured;";"100.0";"14.4";"54";"54";"54";"0";"0";"457129";"391153"
"V4mis2";"SILVA (only NR);Bacteria;Proteobacteria;Gammaproteobacteria;Burkholderiales;Aquaspirillaceae;";"93.8";"14.4";"48";"48";"45";"3";"0";"457135";"391162"
"V4mis2";"SILVA (only NR);Bacteria;Proteobacteria;Gammaproteobacteria;Burkholderiales;Aquaspirillaceae;Aquaspirillum;";"84.6";"14.4";"13";"13";"11";"2";"0";"457170";"391196"
"V4mis2";"SILVA (only NR);Bacteria;Proteobacteria;Gammaproteobacteria;Burkholderiales;Aquaspirillaceae;Laribacter;";"100.0";"14.4";"17";"17";"17";"0";"0";"457166";"391190"
"V4mis2";"SILVA (only NR);Bacteria;Proteobacteria;Gammaproteobacteria;Burkholderiales;Aquaspirillaceae;Microvirgula;";"100.0";"14.4";"11";"11";"11";"0";"0";"457172";"391196"
"V4mis2";"SILVA (only NR);Bacteria;Proteobacteria;Gammaproteobacteria;Burkholderiales;Aquaspirillaceae;Rivicola;";"83.3";"14.4";"6";"6";"5";"1";"0";"457177";"391202"
"V4mis2";"SILVA (only NR);Bacteria;Proteobacteria;Gammaproteobacteria;Burkholderiales;B1-7BS;";"95.1";"14.4";"81";"81";"77";"4";"0";"457102";"391130"
"V4mis2";"SILVA (only NR);Bacteria;Proteobacteria;Gammaproteobacteria;Burkholderiales;Burkholderiaceae;";"95.5";"14.5";"3609";"3609";"3445";"164";"0";"453574";"387762"
"V4mis2";"SILVA (only NR);Bacteria;Proteobacteria;Gammaproteobacteria;Burkholderiales;Burkholderiaceae;Burkholderia-Caballeronia-Paraburkholderia;";"95.8";"14.5";"2182";"2182";"2091";"91";"0";"455001";"389116"
"V4mis2";"SILVA (only NR);Bacteria;Proteobacteria;Gammaproteobacteria;Burkholderiales;Burkholderiaceae;Candidatus Glomeribacter;";"88.9";"14.4";"9";"9";"8";"1";"0";"457174";"391199"
"V4mis2";"SILVA (only NR);Bacteria;Proteobacteria;Gammaproteobacteria;Burkholderiales;Burkholderiaceae;Candidatus Tremblaya;";"100.0";"14.4";"37";"37";"37";"0";"0";"457146";"391170"
"V4mis2";"SILVA (only NR);Bacteria;Proteobacteria;Gammaproteobacteria;Burkholderiales;Burkholderiaceae;Cupriavidus;";"94.8";"14.4";"310";"310";"294";"16";"0";"456873";"390913"
"V4mis2";"SILVA (only NR);Bacteria;Proteobacteria;Gammaproteobacteria;Burkholderiales;Burkholderiaceae;Lautropia;";"94.3";"14.4";"194";"194";"183";"11";"0";"456989";"391024"
"V4mis2";"SILVA (only NR);Bacteria;Proteobacteria;Gammaproteobacteria;Burkholderiales;Burkholderiaceae;Limnobacter;";"94.1";"14.4";"202";"202";"190";"12";"0";"456981";"391017"
"V4mis2";"SILVA (only NR);Bacteria;Proteobacteria;Gammaproteobacteria;Burkholderiales;Burkholderiaceae;Mycoavidus;";"100.0";"14.4";"4";"4";"4";"0";"0";"457179";"391203"
"V4mis2";"SILVA (only NR);Bacteria;Proteobacteria;Gammaproteobacteria;Burkholderiales;Burkholderiaceae;Pandoraea;";"95.0";"14.4";"80";"80";"76";"4";"0";"457103";"391131"
"V4mis2";"SILVA (only NR);Bacteria;Proteobacteria;Gammaproteobacteria;Burkholderiales;Burkholderiaceae;Polynucleobacter;";"94.7";"14.4";"169";"169";"160";"9";"0";"457014";"391047"
"V4mis2";"SILVA (only NR);Bacteria;Proteobacteria;Gammaproteobacteria;Burkholderiales;Burkholderiaceae;Ralstonia;";"94.7";"14.4";"377";"377";"357";"20";"0";"456806";"390850"
"V4mis2";"SILVA (only NR);Bacteria;Proteobacteria;Gammaproteobacteria;Burkholderiales;Burkholderiaceae;Robbsia;";"100.0";"14.4";"15";"15";"15";"0";"0";"457168";"391192"
"V4mis2";"SILVA (only NR);Bacteria;Proteobacteria;Gammaproteobacteria;Burkholderiales;Burkholderiaceae;uncultured;";"100.0";"14.4";"29";"29";"29";"0";"0";"457154";"391178"
"V4mis2";"SILVA (only NR);Bacteria;Proteobacteria;Gammaproteobacteria;Burkholderiales;Burkholderiales Incertae Sedis;";"100.0";"14.4";"5";"5";"5";"0";"0";"457178";"391202"
"V4mis2";"SILVA (only NR);Bacteria;Proteobacteria;Gammaproteobacteria;Burkholderiales;Burkholderiales Incertae Sedis;2013Ark19i;";"100.0";"14.4";"3";"3";"3";"0";"0";"457180";"391204"
"V4mis2";"SILVA (only NR);Bacteria;Proteobacteria;Gammaproteobacteria;Burkholderiales;Burkholderiales Incertae Sedis;Candidatus Branchiomonas;";"100.0";"14.4";"2";"2";"2";"0";"0";"457181";"391205"
"V4mis2";"SILVA (only NR);Bacteria;Proteobacteria;Gammaproteobacteria;Burkholderiales;Candidatus Protistobacter;";"100.0";"14.4";"2";"2";"2";"0";"0";"457181";"391205"
"V4mis2";"SILVA (only NR);Bacteria;Proteobacteria;Gammaproteobacteria;Burkholderiales;Chitinibacteraceae;";"96.9";"14.4";"64";"64";"62";"2";"0";"457119";"391145"
"V4mis2";"SILVA (only NR);Bacteria;Proteobacteria;Gammaproteobacteria;Burkholderiales;Chitinibacteraceae;Amantichitinum;";"100.0";"14.4";"3";"3";"3";"0";"0";"457180";"391204"
"V4mis2";"SILVA (only NR);Bacteria;Proteobacteria;Gammaproteobacteria;Burkholderiales;Chitinibacteraceae;Andreprevotia;";"100.0";"14.4";"2";"2";"2";"0";"0";"457181";"391205"
"V4mis2";"SILVA (only NR);Bacteria;Proteobacteria;Gammaproteobacteria;Burkholderiales;Chitinibacteraceae;Chitinibacter;";"100.0";"14.4";"7";"7";"7";"0";"0";"457176";"391200"
"V4mis2";"SILVA (only NR);Bacteria;Proteobacteria;Gammaproteobacteria;Burkholderiales;Chitinibacteraceae;Chitinilyticum;";"100.0";"14.4";"2";"2";"2";"0";"0";"457181";"391205"
"V4mis2";"SILVA (only NR);Bacteria;Proteobacteria;Gammaproteobacteria;Burkholderiales;Chitinibacteraceae;Chitiniphilus;";"87.5";"14.4";"8";"8";"7";"1";"0";"457175";"391200"
"V4mis2";"SILVA (only NR);Bacteria;Proteobacteria;Gammaproteobacteria;Burkholderiales;Chitinibacteraceae;Deefgea;";"100.0";"14.4";"14";"14";"14";"0";"0";"457169";"391193"
"V4mis2";"SILVA (only NR);Bacteria;Proteobacteria;Gammaproteobacteria;Burkholderiales;Chitinibacteraceae;Formivibrio;";"100.0";"14.4";"4";"4";"4";"0";"0";"457179";"391203"
"V4mis2";"SILVA (only NR);Bacteria;Proteobacteria;Gammaproteobacteria;Burkholderiales;Chitinibacteraceae;Iodobacter;";"91.7";"14.4";"12";"12";"11";"1";"0";"457171";"391196"
"V4mis2";"SILVA (only NR);Bacteria;Proteobacteria;Gammaproteobacteria;Burkholderiales;Chitinibacteraceae;Jeongeupia;";"100.0";"14.4";"4";"4";"4";"0";"0";"457179";"391203"
"V4mis2";"SILVA (only NR);Bacteria;Proteobacteria;Gammaproteobacteria;Burkholderiales;Chitinibacteraceae;Silvimonas;";"100.0";"14.4";"6";"6";"6";"0";"0";"457177";"391201"
"V4mis2";"SILVA (only NR);Bacteria;Proteobacteria;Gammaproteobacteria;Burkholderiales;Chitinimonadaceae;";"100.0";"14.4";"34";"34";"34";"0";"0";"457149";"391173"
"V4mis2";"SILVA (only NR);Bacteria;Proteobacteria;Gammaproteobacteria;Burkholderiales;Chitinimonadaceae;Chitinimonas;";"100.0";"14.4";"25";"25";"25";"0";"0";"457158";"391182"
"V4mis2";"SILVA (only NR);Bacteria;Proteobacteria;Gammaproteobacteria;Burkholderiales;Chitinimonadaceae;Chitinivorax;";"100.0";"14.4";"9";"9";"9";"0";"0";"457174";"391198"
"V4mis2";"SILVA (only NR);Bacteria;Proteobacteria;Gammaproteobacteria;Burkholderiales;Chromobacteriaceae;";"90.8";"14.4";"185";"185";"168";"17";"0";"456998";"391039"
"V4mis2";"SILVA (only NR);Bacteria;Proteobacteria;Gammaproteobacteria;Burkholderiales;Chromobacteriaceae;Aquitalea;";"90.5";"14.4";"21";"21";"19";"2";"0";"457162";"391188"
"V4mis2";"SILVA (only NR);Bacteria;Proteobacteria;Gammaproteobacteria;Burkholderiales;Chromobacteriaceae;Chromobacterium;";"85.1";"14.4";"67";"67";"57";"10";"0";"457116";"391150"
"V4mis2";"SILVA (only NR);Bacteria;Proteobacteria;Gammaproteobacteria;Burkholderiales;Chromobacteriaceae;Crenobacter;";"100.0";"14.4";"11";"11";"11";"0";"0";"457172";"391196"
"V4mis2";"SILVA (only NR);Bacteria;Proteobacteria;Gammaproteobacteria;Burkholderiales;Chromobacteriaceae;Gulbenkiania;";"100.0";"14.4";"2";"2";"2";"0";"0";"457181";"391205"
"V4mis2";"SILVA (only NR);Bacteria;Proteobacteria;Gammaproteobacteria;Burkholderiales;Chromobacteriaceae;Paludibacterium;";"100.0";"14.4";"23";"23";"23";"0";"0";"457160";"391184"
"V4mis2";"SILVA (only NR);Bacteria;Proteobacteria;Gammaproteobacteria;Burkholderiales;Chromobacteriaceae;Pseudogulbenkiania;";"100.0";"14.4";"14";"14";"14";"0";"0";"457169";"391193"
"V4mis2";"SILVA (only NR);Bacteria;Proteobacteria;Gammaproteobacteria;Burkholderiales;Chromobacteriaceae;Vogesella;";"89.4";"14.4";"47";"47";"42";"5";"0";"457136";"391165"
"V4mis2";"SILVA (only NR);Bacteria;Proteobacteria;Gammaproteobacteria;Burkholderiales;Comamonadaceae;";"94.3";"14.5";"5187";"5187";"4892";"295";"0";"451996";"386315"
"V4mis2";"SILVA (only NR);Bacteria;Proteobacteria;Gammaproteobacteria;Burkholderiales;Comamonadaceae;Acidovorax;";"90.8";"14.4";"531";"531";"482";"49";"0";"456652";"390725"
"V4mis2";"SILVA (only NR);Bacteria;Proteobacteria;Gammaproteobacteria;Burkholderiales;Comamonadaceae;Alicycliphilus;";"100.0";"14.4";"43";"43";"43";"0";"0";"457140";"391164"
"V4mis2";"SILVA (only NR);Bacteria;Proteobacteria;Gammaproteobacteria;Burkholderiales;Comamonadaceae;Aquabacterium;";"86.4";"14.4";"287";"287";"248";"39";"0";"456896";"390959"
"V4mis2";"SILVA (only NR);Bacteria;Proteobacteria;Gammaproteobacteria;Burkholderiales;Comamonadaceae;Aquincola;";"100.0";"14.4";"1";"1";"1";"0";"0";"457182";"391206"
"V4mis2";"SILVA (only NR);Bacteria;Proteobacteria;Gammaproteobacteria;Burkholderiales;Comamonadaceae;Azohydromonas;";"100.0";"14.4";"20";"20";"20";"0";"0";"457163";"391187"
"V4mis2";"SILVA (only NR);Bacteria;Proteobacteria;Gammaproteobacteria;Burkholderiales;Comamonadaceae;Brachymonas;";"93.2";"14.4";"88";"88";"82";"6";"0";"457095";"391125"
"V4mis2";"SILVA (only NR);Bacteria;Proteobacteria;Gammaproteobacteria;Burkholderiales;Comamonadaceae;Caenimonas;";"100.0";"14.4";"63";"63";"63";"0";"0";"457120";"391144"
"V4mis2";"SILVA (only NR);Bacteria;Proteobacteria;Gammaproteobacteria;Burkholderiales;Comamonadaceae;Caldimonas;";"83.3";"14.4";"6";"6";"5";"1";"0";"457177";"391202"
"V4mis2";"SILVA (only NR);Bacteria;Proteobacteria;Gammaproteobacteria;Burkholderiales;Comamonadaceae;Candidatus Symbiobacter;";"93.6";"14.4";"47";"47";"44";"3";"0";"457136";"391163"
"V4mis2";"SILVA (only NR);Bacteria;Proteobacteria;Gammaproteobacteria;Burkholderiales;Comamonadaceae;Comamonas;";"94.2";"14.4";"483";"483";"455";"28";"0";"456700";"390752"
"V4mis2";"SILVA (only NR);Bacteria;Proteobacteria;Gammaproteobacteria;Burkholderiales;Comamonadaceae;Corticibacter;";"100.0";"14.4";"6";"6";"6";"0";"0";"457177";"391201"
"V4mis2";"SILVA (only NR);Bacteria;Proteobacteria;Gammaproteobacteria;Burkholderiales;Comamonadaceae;Curvibacter;";"97.7";"14.4";"88";"88";"86";"2";"0";"457095";"391121"
"V4mis2";"SILVA (only NR);Bacteria;Proteobacteria;Gammaproteobacteria;Burkholderiales;Comamonadaceae;Delftia;";"90.4";"14.4";"261";"261";"236";"25";"0";"456922";"390971"
"V4mis2";"SILVA (only NR);Bacteria;Proteobacteria;Gammaproteobacteria;Burkholderiales;Comamonadaceae;Diaphorobacter;";"91.9";"14.4";"186";"186";"171";"15";"0";"456997";"391036"
"V4mis2";"SILVA (only NR);Bacteria;Proteobacteria;Gammaproteobacteria;Burkholderiales;Comamonadaceae;Extensimonas;";"100.0";"14.4";"11";"11";"11";"0";"0";"457172";"391196"
"V4mis2";"SILVA (only NR);Bacteria;Proteobacteria;Gammaproteobacteria;Burkholderiales;Comamonadaceae;Giesbergeria;";"94.1";"14.4";"17";"17";"16";"1";"0";"457166";"391191"
"V4mis2";"SILVA (only NR);Bacteria;Proteobacteria;Gammaproteobacteria;Burkholderiales;Comamonadaceae;Hydrogenophaga;";"96.5";"14.4";"256";"256";"247";"9";"0";"456927";"390960"
"V4mis2";"SILVA (only NR);Bacteria;Proteobacteria;Gammaproteobacteria;Burkholderiales;Comamonadaceae;Hylemonella;";"100.0";"14.4";"12";"12";"12";"0";"0";"457171";"391195"
"V4mis2";"SILVA (only NR);Bacteria;Proteobacteria;Gammaproteobacteria;Burkholderiales;Comamonadaceae;Ideonella;";"91.1";"14.4";"56";"56";"51";"5";"0";"457127";"391156"
"V4mis2";"SILVA (only NR);Bacteria;Proteobacteria;Gammaproteobacteria;Burkholderiales;Comamonadaceae;Inhella;";"100.0";"14.4";"21";"21";"21";"0";"0";"457162";"391186"
"V4mis2";"SILVA (only NR);Bacteria;Proteobacteria;Gammaproteobacteria;Burkholderiales;Comamonadaceae;Kinneretia;";"100.0";"14.4";"6";"6";"6";"0";"0";"457177";"391201"
"V4mis2";"SILVA (only NR);Bacteria;Proteobacteria;Gammaproteobacteria;Burkholderiales;Comamonadaceae;Lampropedia;";"100.0";"14.4";"11";"11";"11";"0";"0";"457172";"391196"
"V4mis2";"SILVA (only NR);Bacteria;Proteobacteria;Gammaproteobacteria;Burkholderiales;Comamonadaceae;Leptothrix;";"98.9";"14.4";"90";"90";"89";"1";"0";"457093";"391118"
"V4mis2";"SILVA (only NR);Bacteria;Proteobacteria;Gammaproteobacteria;Burkholderiales;Comamonadaceae;Limnohabitans;";"97.9";"14.4";"234";"234";"229";"5";"0";"456949";"390978"
"V4mis2";"SILVA (only NR);Bacteria;Proteobacteria;Gammaproteobacteria;Burkholderiales;Comamonadaceae;Macromonas;";"75.0";"14.4";"4";"4";"3";"1";"0";"457179";"391204"
"V4mis2";"SILVA (only NR);Bacteria;Proteobacteria;Gammaproteobacteria;Burkholderiales;Comamonadaceae;Malikia;";"93.8";"14.4";"16";"16";"15";"1";"0";"457167";"391192"
"V4mis2";"SILVA (only NR);Bacteria;Proteobacteria;Gammaproteobacteria;Burkholderiales;Comamonadaceae;Methylibium;";"100.0";"14.4";"26";"26";"26";"0";"0";"457157";"391181"
"V4mis2";"SILVA (only NR);Bacteria;Proteobacteria;Gammaproteobacteria;Burkholderiales;Comamonadaceae;Mitsuaria;";"89.5";"14.4";"19";"19";"17";"2";"0";"457164";"391190"
"V4mis2";"SILVA (only NR);Bacteria;Proteobacteria;Gammaproteobacteria;Burkholderiales;Comamonadaceae;Ottowia;";"98.9";"14.4";"91";"91";"90";"1";"0";"457092";"391117"
"V4mis2";"SILVA (only NR);Bacteria;Proteobacteria;Gammaproteobacteria;Burkholderiales;Comamonadaceae;Paucibacter;";"100.0";"14.4";"49";"49";"49";"0";"0";"457134";"391158"
"V4mis2";"SILVA (only NR);Bacteria;Proteobacteria;Gammaproteobacteria;Burkholderiales;Comamonadaceae;Pelomonas;";"96.6";"14.4";"89";"89";"86";"3";"0";"457094";"391121"
"V4mis2";"SILVA (only NR);Bacteria;Proteobacteria;Gammaproteobacteria;Burkholderiales;Comamonadaceae;Piscinibacter;";"95.5";"14.4";"22";"22";"21";"1";"0";"457161";"391186"
"V4mis2";"SILVA (only NR);Bacteria;Proteobacteria;Gammaproteobacteria;Burkholderiales;Comamonadaceae;Polaromonas;";"94.2";"14.4";"191";"191";"180";"11";"0";"456992";"391027"
"V4mis2";"SILVA (only NR);Bacteria;Proteobacteria;Gammaproteobacteria;Burkholderiales;Comamonadaceae;Pseudacidovorax;";"100.0";"14.4";"3";"3";"3";"0";"0";"457180";"391204"
"V4mis2";"SILVA (only NR);Bacteria;Proteobacteria;Gammaproteobacteria;Burkholderiales;Comamonadaceae;Pseudorhodoferax;";"95.8";"14.4";"24";"24";"23";"1";"0";"457159";"391184"
"V4mis2";"SILVA (only NR);Bacteria;Proteobacteria;Gammaproteobacteria;Burkholderiales;Comamonadaceae;RS62 marine group;";"100.0";"14.4";"48";"48";"48";"0";"0";"457135";"391159"
"V4mis2";"SILVA (only NR);Bacteria;Proteobacteria;Gammaproteobacteria;Burkholderiales;Comamonadaceae;Ramlibacter;";"94.0";"14.4";"183";"183";"172";"11";"0";"457000";"391035"
"V4mis2";"SILVA (only NR);Bacteria;Proteobacteria;Gammaproteobacteria;Burkholderiales;Comamonadaceae;Rhizobacter;";"94.7";"14.4";"170";"170";"161";"9";"0";"457013";"391046"
"V4mis2";"SILVA (only NR);Bacteria;Proteobacteria;Gammaproteobacteria;Burkholderiales;Comamonadaceae;Rhodoferax;";"97.1";"14.4";"346";"346";"336";"10";"0";"456837";"390871"
"V4mis2";"SILVA (only NR);Bacteria;Proteobacteria;Gammaproteobacteria;Burkholderiales;Comamonadaceae;Rivibacter;";"100.0";"14.4";"13";"13";"13";"0";"0";"457170";"391194"
"V4mis2";"SILVA (only NR);Bacteria;Proteobacteria;Gammaproteobacteria;Burkholderiales;Comamonadaceae;Roseateles;";"95.7";"14.4";"23";"23";"22";"1";"0";"457160";"391185"
"V4mis2";"SILVA (only NR);Bacteria;Proteobacteria;Gammaproteobacteria;Burkholderiales;Comamonadaceae;Rubrivivax;";"96.3";"14.4";"27";"27";"26";"1";"0";"457156";"391181"
"V4mis2";"SILVA (only NR);Bacteria;Proteobacteria;Gammaproteobacteria;Burkholderiales;Comamonadaceae;Schlegelella;";"88.9";"14.4";"9";"9";"8";"1";"0";"457174";"391199"
"V4mis2";"SILVA (only NR);Bacteria;Proteobacteria;Gammaproteobacteria;Burkholderiales;Comamonadaceae;Simplicispira;";"96.7";"14.4";"60";"60";"58";"2";"0";"457123";"391149"
"V4mis2";"SILVA (only NR);Bacteria;Proteobacteria;Gammaproteobacteria;Burkholderiales;Comamonadaceae;Sphaerotilus;";"93.4";"14.4";"61";"61";"57";"4";"0";"457122";"391150"
"V4mis2";"SILVA (only NR);Bacteria;Proteobacteria;Gammaproteobacteria;Burkholderiales;Comamonadaceae;Tepidicella;";"66.7";"14.4";"3";"3";"2";"1";"0";"457180";"391205"
"V4mis2";"SILVA (only NR);Bacteria;Proteobacteria;Gammaproteobacteria;Burkholderiales;Comamonadaceae;Tepidimonas;";"100.0";"14.4";"29";"29";"29";"0";"0";"457154";"391178"
"V4mis2";"SILVA (only NR);Bacteria;Proteobacteria;Gammaproteobacteria;Burkholderiales;Comamonadaceae;Thiomonas;";"90.9";"14.4";"55";"55";"50";"5";"0";"457128";"391157"
"V4mis2";"SILVA (only NR);Bacteria;Proteobacteria;Gammaproteobacteria;Burkholderiales;Comamonadaceae;Tibeticola;";"100.0";"14.4";"5";"5";"5";"0";"0";"457178";"391202"
"V4mis2";"SILVA (only NR);Bacteria;Proteobacteria;Gammaproteobacteria;Burkholderiales;Comamonadaceae;Variovorax;";"95.0";"14.4";"222";"222";"211";"11";"0";"456961";"390996"
"V4mis2";"SILVA (only NR);Bacteria;Proteobacteria;Gammaproteobacteria;Burkholderiales;Comamonadaceae;Verminephrobacter;";"80.0";"14.4";"30";"30";"24";"6";"0";"457153";"391183"
"V4mis2";"SILVA (only NR);Bacteria;Proteobacteria;Gammaproteobacteria;Burkholderiales;Comamonadaceae;Xenophilus;";"77.8";"14.4";"9";"9";"7";"2";"0";"457174";"391200"
"V4mis2";"SILVA (only NR);Bacteria;Proteobacteria;Gammaproteobacteria;Burkholderiales;Comamonadaceae;Xylophilus;";"100.0";"14.4";"24";"24";"24";"0";"0";"457159";"391183"
"V4mis2";"SILVA (only NR);Bacteria;Proteobacteria;Gammaproteobacteria;Burkholderiales;Comamonadaceae;Zhizhongheella;";"100.0";"14.4";"4";"4";"4";"0";"0";"457179";"391203"
"V4mis2";"SILVA (only NR);Bacteria;Proteobacteria;Gammaproteobacteria;Burkholderiales;Comamonadaceae;[Polyangium] brachysporum group;";"100.0";"14.4";"9";"9";"9";"0";"0";"457174";"391198"
"V4mis2";"SILVA (only NR);Bacteria;Proteobacteria;Gammaproteobacteria;Burkholderiales;Comamonadaceae;uncultured;";"96.1";"14.4";"466";"466";"448";"18";"0";"456717";"390759"
"V4mis2";"SILVA (only NR);Bacteria;Proteobacteria;Gammaproteobacteria;Burkholderiales;EC94;";"55.0";"14.4";"20";"20";"11";"9";"0";"457163";"391196"
"V4mis2";"SILVA (only NR);Bacteria;Proteobacteria;Gammaproteobacteria;Burkholderiales;Ferrovaceae;";"77.4";"14.4";"31";"31";"24";"7";"0";"457152";"391183"
"V4mis2";"SILVA (only NR);Bacteria;Proteobacteria;Gammaproteobacteria;Burkholderiales;Ferrovaceae;Ferrovum;";"77.4";"14.4";"31";"31";"24";"7";"0";"457152";"391183"
"V4mis2";"SILVA (only NR);Bacteria;Proteobacteria;Gammaproteobacteria;Burkholderiales;Gallionellaceae;";"96.0";"14.4";"403";"403";"387";"16";"0";"456780";"390820"
"V4mis2";"SILVA (only NR);Bacteria;Proteobacteria;Gammaproteobacteria;Burkholderiales;Gallionellaceae;Candidatus Nitrotoga;";"95.7";"14.4";"47";"47";"45";"2";"0";"457136";"391162"
"V4mis2";"SILVA (only NR);Bacteria;Proteobacteria;Gammaproteobacteria;Burkholderiales;Gallionellaceae;Ferriphaselus;";"100.0";"14.4";"10";"10";"10";"0";"0";"457173";"391197"
"V4mis2";"SILVA (only NR);Bacteria;Proteobacteria;Gammaproteobacteria;Burkholderiales;Gallionellaceae;Gallionella;";"97.8";"14.4";"138";"138";"135";"3";"0";"457045";"391072"
"V4mis2";"SILVA (only NR);Bacteria;Proteobacteria;Gammaproteobacteria;Burkholderiales;Gallionellaceae;Sideroxydans;";"94.4";"14.4";"161";"161";"152";"9";"0";"457022";"391055"
"V4mis2";"SILVA (only NR);Bacteria;Proteobacteria;Gammaproteobacteria;Burkholderiales;Gallionellaceae;uncultured;";"95.5";"14.4";"44";"44";"42";"2";"0";"457139";"391165"
"V4mis2";"SILVA (only NR);Bacteria;Proteobacteria;Gammaproteobacteria;Burkholderiales;Hydrogenophilaceae;";"95.9";"14.4";"556";"556";"533";"23";"0";"456627";"390674"
"V4mis2";"SILVA (only NR);Bacteria;Proteobacteria;Gammaproteobacteria;Burkholderiales;Hydrogenophilaceae;Annwodia;";"100.0";"14.4";"4";"4";"4";"0";"0";"457179";"391203"
"V4mis2";"SILVA (only NR);Bacteria;Proteobacteria;Gammaproteobacteria;Burkholderiales;Hydrogenophilaceae;Hydrogenophilus;";"92.9";"14.4";"28";"28";"26";"2";"0";"457155";"391181"
"V4mis2";"SILVA (only NR);Bacteria;Proteobacteria;Gammaproteobacteria;Burkholderiales;Hydrogenophilaceae;Spirillum;";"100.0";"14.4";"4";"4";"4";"0";"0";"457179";"391203"
"V4mis2";"SILVA (only NR);Bacteria;Proteobacteria;Gammaproteobacteria;Burkholderiales;Hydrogenophilaceae;Sulfuritortus;";"100.0";"14.4";"5";"5";"5";"0";"0";"457178";"391202"
"V4mis2";"SILVA (only NR);Bacteria;Proteobacteria;Gammaproteobacteria;Burkholderiales;Hydrogenophilaceae;Tepidiphilus;";"82.6";"14.4";"23";"23";"19";"4";"0";"457160";"391188"
"V4mis2";"SILVA (only NR);Bacteria;Proteobacteria;Gammaproteobacteria;Burkholderiales;Hydrogenophilaceae;Thiobacillus;";"96.7";"14.4";"276";"276";"267";"9";"0";"456907";"390940"
"V4mis2";"SILVA (only NR);Bacteria;Proteobacteria;Gammaproteobacteria;Burkholderiales;Hydrogenophilaceae;Thiobacter;";"100.0";"14.4";"5";"5";"5";"0";"0";"457178";"391202"
"V4mis2";"SILVA (only NR);Bacteria;Proteobacteria;Gammaproteobacteria;Burkholderiales;Hydrogenophilaceae;uncultured;";"96.2";"14.4";"209";"209";"201";"8";"0";"456974";"391006"
"V4mis2";"SILVA (only NR);Bacteria;Proteobacteria;Gammaproteobacteria;Burkholderiales;Leeiaceae;";"93.3";"14.4";"15";"15";"14";"1";"0";"457168";"391193"
"V4mis2";"SILVA (only NR);Bacteria;Proteobacteria;Gammaproteobacteria;Burkholderiales;Leeiaceae;Leeia;";"93.3";"14.4";"15";"15";"14";"1";"0";"457168";"391193"
"V4mis2";"SILVA (only NR);Bacteria;Proteobacteria;Gammaproteobacteria;Burkholderiales;MWH-UniP1 aquatic group;";"95.7";"14.4";"70";"70";"67";"3";"0";"457113";"391140"
"V4mis2";"SILVA (only NR);Bacteria;Proteobacteria;Gammaproteobacteria;Burkholderiales;Methylophilaceae;";"96.0";"14.4";"553";"553";"531";"22";"0";"456630";"390676"
"V4mis2";"SILVA (only NR);Bacteria;Proteobacteria;Gammaproteobacteria;Burkholderiales;Methylophilaceae;Candidatus Methylopumilus;";"93.9";"14.4";"33";"33";"31";"2";"0";"457150";"391176"
"V4mis2";"SILVA (only NR);Bacteria;Proteobacteria;Gammaproteobacteria;Burkholderiales;Methylophilaceae;MM1;";"100.0";"14.4";"9";"9";"9";"0";"0";"457174";"391198"
"V4mis2";"SILVA (only NR);Bacteria;Proteobacteria;Gammaproteobacteria;Burkholderiales;Methylophilaceae;MM2;";"94.7";"14.4";"19";"19";"18";"1";"0";"457164";"391189"
"V4mis2";"SILVA (only NR);Bacteria;Proteobacteria;Gammaproteobacteria;Burkholderiales;Methylophilaceae;Methylobacillus;";"100.0";"14.4";"31";"31";"31";"0";"0";"457152";"391176"
"V4mis2";"SILVA (only NR);Bacteria;Proteobacteria;Gammaproteobacteria;Burkholderiales;Methylophilaceae;Methylophilus;";"92.9";"14.4";"112";"112";"104";"8";"0";"457071";"391103"
"V4mis2";"SILVA (only NR);Bacteria;Proteobacteria;Gammaproteobacteria;Burkholderiales;Methylophilaceae;Methylotenera;";"98.6";"14.4";"145";"145";"143";"2";"0";"457038";"391064"
"V4mis2";"SILVA (only NR);Bacteria;Proteobacteria;Gammaproteobacteria;Burkholderiales;Methylophilaceae;Methylovorus;";"100.0";"14.4";"7";"7";"7";"0";"0";"457176";"391200"
"V4mis2";"SILVA (only NR);Bacteria;Proteobacteria;Gammaproteobacteria;Burkholderiales;Methylophilaceae;OM43 clade;";"93.9";"14.4";"131";"131";"123";"8";"0";"457052";"391084"
"V4mis2";"SILVA (only NR);Bacteria;Proteobacteria;Gammaproteobacteria;Burkholderiales;Methylophilaceae;UBA6140;";"100.0";"14.4";"17";"17";"17";"0";"0";"457166";"391190"
"V4mis2";"SILVA (only NR);Bacteria;Proteobacteria;Gammaproteobacteria;Burkholderiales;Methylophilaceae;uncultured;";"97.9";"14.4";"47";"47";"46";"1";"0";"457136";"391161"
"V4mis2";"SILVA (only NR);Bacteria;Proteobacteria;Gammaproteobacteria;Burkholderiales;Neisseriaceae;";"94.0";"14.5";"1355";"1355";"1274";"81";"0";"455828";"389933"
"V4mis2";"SILVA (only NR);Bacteria;Proteobacteria;Gammaproteobacteria;Burkholderiales;Neisseriaceae;Alysiella;";"100.0";"14.4";"24";"24";"24";"0";"0";"457159";"391183"
"V4mis2";"SILVA (only NR);Bacteria;Proteobacteria;Gammaproteobacteria;Burkholderiales;Neisseriaceae;Bergeriella;";"50.0";"14.4";"4";"4";"2";"2";"0";"457179";"391205"
"V4mis2";"SILVA (only NR);Bacteria;Proteobacteria;Gammaproteobacteria;Burkholderiales;Neisseriaceae;Conchiformibius;";"97.6";"14.4";"42";"42";"41";"1";"0";"457141";"391166"
"V4mis2";"SILVA (only NR);Bacteria;Proteobacteria;Gammaproteobacteria;Burkholderiales;Neisseriaceae;Eikenella;";"100.0";"14.4";"20";"20";"20";"0";"0";"457163";"391187"
"V4mis2";"SILVA (only NR);Bacteria;Proteobacteria;Gammaproteobacteria;Burkholderiales;Neisseriaceae;Kingella;";"99.1";"14.4";"116";"116";"115";"1";"0";"457067";"391092"
"V4mis2";"SILVA (only NR);Bacteria;Proteobacteria;Gammaproteobacteria;Burkholderiales;Neisseriaceae;Neisseria;";"93.2";"14.4";"980";"980";"913";"67";"0";"456203";"390294"
"V4mis2";"SILVA (only NR);Bacteria;Proteobacteria;Gammaproteobacteria;Burkholderiales;Neisseriaceae;Simonsiella;";"91.7";"14.4";"12";"12";"11";"1";"0";"457171";"391196"
"V4mis2";"SILVA (only NR);Bacteria;Proteobacteria;Gammaproteobacteria;Burkholderiales;Neisseriaceae;Snodgrassella;";"100.0";"14.4";"22";"22";"22";"0";"0";"457161";"391185"
"V4mis2";"SILVA (only NR);Bacteria;Proteobacteria;Gammaproteobacteria;Burkholderiales;Neisseriaceae;Stenoxybacter;";"100.0";"14.4";"3";"3";"3";"0";"0";"457180";"391204"
"V4mis2";"SILVA (only NR);Bacteria;Proteobacteria;Gammaproteobacteria;Burkholderiales;Neisseriaceae;Uruburuella;";"100.0";"14.4";"4";"4";"4";"0";"0";"457179";"391203"
"V4mis2";"SILVA (only NR);Bacteria;Proteobacteria;Gammaproteobacteria;Burkholderiales;Neisseriaceae;Vitreoscilla;";"100.0";"14.4";"13";"13";"13";"0";"0";"457170";"391194"
"V4mis2";"SILVA (only NR);Bacteria;Proteobacteria;Gammaproteobacteria;Burkholderiales;Neisseriaceae;uncultured;";"92.0";"14.4";"113";"113";"104";"9";"0";"457070";"391103"
"V4mis2";"SILVA (only NR);Bacteria;Proteobacteria;Gammaproteobacteria;Burkholderiales;Nitrosomonadaceae;";"95.1";"14.5";"1071";"1071";"1019";"52";"0";"456112";"390188"
"V4mis2";"SILVA (only NR);Bacteria;Proteobacteria;Gammaproteobacteria;Burkholderiales;Nitrosomonadaceae;966-1;";"100.0";"14.4";"18";"18";"18";"0";"0";"457165";"391189"
"V4mis2";"SILVA (only NR);Bacteria;Proteobacteria;Gammaproteobacteria;Burkholderiales;Nitrosomonadaceae;DSSD61;";"100.0";"14.4";"9";"9";"9";"0";"0";"457174";"391198"
"V4mis2";"SILVA (only NR);Bacteria;Proteobacteria;Gammaproteobacteria;Burkholderiales;Nitrosomonadaceae;Ellin6067;";"95.6";"14.4";"250";"250";"239";"11";"0";"456933";"390968"
"V4mis2";"SILVA (only NR);Bacteria;Proteobacteria;Gammaproteobacteria;Burkholderiales;Nitrosomonadaceae;GOUTA6;";"100.0";"14.4";"40";"40";"40";"0";"0";"457143";"391167"
"V4mis2";"SILVA (only NR);Bacteria;Proteobacteria;Gammaproteobacteria;Burkholderiales;Nitrosomonadaceae;IS-44;";"98.7";"14.4";"77";"77";"76";"1";"0";"457106";"391131"
"V4mis2";"SILVA (only NR);Bacteria;Proteobacteria;Gammaproteobacteria;Burkholderiales;Nitrosomonadaceae;MND1;";"92.4";"14.4";"290";"290";"268";"22";"0";"456893";"390939"
"V4mis2";"SILVA (only NR);Bacteria;Proteobacteria;Gammaproteobacteria;Burkholderiales;Nitrosomonadaceae;Nitrosomonas;";"95.2";"14.4";"210";"210";"200";"10";"0";"456973";"391007"
"V4mis2";"SILVA (only NR);Bacteria;Proteobacteria;Gammaproteobacteria;Burkholderiales;Nitrosomonadaceae;Nitrosospira;";"91.8";"14.4";"49";"49";"45";"4";"0";"457134";"391162"
"V4mis2";"SILVA (only NR);Bacteria;Proteobacteria;Gammaproteobacteria;Burkholderiales;Nitrosomonadaceae;P3OB-51;";"100.0";"14.4";"3";"3";"3";"0";"0";"457180";"391204"
"V4mis2";"SILVA (only NR);Bacteria;Proteobacteria;Gammaproteobacteria;Burkholderiales;Nitrosomonadaceae;cr616;";"100.0";"14.4";"5";"5";"5";"0";"0";"457178";"391202"
"V4mis2";"SILVA (only NR);Bacteria;Proteobacteria;Gammaproteobacteria;Burkholderiales;Nitrosomonadaceae;mle1-7;";"95.7";"14.4";"69";"69";"66";"3";"0";"457114";"391141"
"V4mis2";"SILVA (only NR);Bacteria;Proteobacteria;Gammaproteobacteria;Burkholderiales;Nitrosomonadaceae;oc32;";"96.3";"14.4";"27";"27";"26";"1";"0";"457156";"391181"
"V4mis2";"SILVA (only NR);Bacteria;Proteobacteria;Gammaproteobacteria;Burkholderiales;Nitrosomonadaceae;uncultured;";"100.0";"14.4";"24";"24";"24";"0";"0";"457159";"391183"
"V4mis2";"SILVA (only NR);Bacteria;Proteobacteria;Gammaproteobacteria;Burkholderiales;Oxalobacteraceae;";"95.3";"14.5";"2275";"2275";"2169";"106";"0";"454908";"389038"
"V4mis2";"SILVA (only NR);Bacteria;Proteobacteria;Gammaproteobacteria;Burkholderiales;Oxalobacteraceae;Actimicrobium;";"100.0";"14.4";"12";"12";"12";"0";"0";"457171";"391195"
"V4mis2";"SILVA (only NR);Bacteria;Proteobacteria;Gammaproteobacteria;Burkholderiales;Oxalobacteraceae;CM1G08;";"100.0";"14.4";"7";"7";"7";"0";"0";"457176";"391200"
"V4mis2";"SILVA (only NR);Bacteria;Proteobacteria;Gammaproteobacteria;Burkholderiales;Oxalobacteraceae;Candidatus Nasuia;";"100.0";"14.4";"12";"12";"12";"0";"0";"457171";"391195"
"V4mis2";"SILVA (only NR);Bacteria;Proteobacteria;Gammaproteobacteria;Burkholderiales;Oxalobacteraceae;Candidatus Profftella;";"100.0";"14.4";"4";"4";"4";"0";"0";"457179";"391203"
"V4mis2";"SILVA (only NR);Bacteria;Proteobacteria;Gammaproteobacteria;Burkholderiales;Oxalobacteraceae;Candidatus Vidania;";"100.0";"14.4";"13";"13";"13";"0";"0";"457170";"391194"
"V4mis2";"SILVA (only NR);Bacteria;Proteobacteria;Gammaproteobacteria;Burkholderiales;Oxalobacteraceae;Candidatus Zinderia;";"100.0";"14.4";"21";"21";"21";"0";"0";"457162";"391186"
"V4mis2";"SILVA (only NR);Bacteria;Proteobacteria;Gammaproteobacteria;Burkholderiales;Oxalobacteraceae;Collimonas;";"100.0";"14.4";"31";"31";"31";"0";"0";"457152";"391176"
"V4mis2";"SILVA (only NR);Bacteria;Proteobacteria;Gammaproteobacteria;Burkholderiales;Oxalobacteraceae;Duganella;";"95.0";"14.4";"101";"101";"96";"5";"0";"457082";"391111"
"V4mis2";"SILVA (only NR);Bacteria;Proteobacteria;Gammaproteobacteria;Burkholderiales;Oxalobacteraceae;Glaciimonas;";"100.0";"14.4";"9";"9";"9";"0";"0";"457174";"391198"
"V4mis2";"SILVA (only NR);Bacteria;Proteobacteria;Gammaproteobacteria;Burkholderiales;Oxalobacteraceae;Herbaspirillum;";"95.1";"14.4";"144";"144";"137";"7";"0";"457039";"391070"
"V4mis2";"SILVA (only NR);Bacteria;Proteobacteria;Gammaproteobacteria;Burkholderiales;Oxalobacteraceae;Herminiimonas;";"96.8";"14.4";"93";"93";"90";"3";"0";"457090";"391117"
"V4mis2";"SILVA (only NR);Bacteria;Proteobacteria;Gammaproteobacteria;Burkholderiales;Oxalobacteraceae;Janthinobacterium;";"85.2";"14.4";"209";"209";"178";"31";"0";"456974";"391029"
"V4mis2";"SILVA (only NR);Bacteria;Proteobacteria;Gammaproteobacteria;Burkholderiales;Oxalobacteraceae;Massilia;";"96.3";"14.5";"1037";"1037";"999";"38";"0";"456146";"390208"
"V4mis2";"SILVA (only NR);Bacteria;Proteobacteria;Gammaproteobacteria;Burkholderiales;Oxalobacteraceae;Noviherbaspirillum;";"95.1";"14.4";"243";"243";"231";"12";"0";"456940";"390976"
"V4mis2";"SILVA (only NR);Bacteria;Proteobacteria;Gammaproteobacteria;Burkholderiales;Oxalobacteraceae;Oxalicibacterium;";"95.0";"14.4";"20";"20";"19";"1";"0";"457163";"391188"
"V4mis2";"SILVA (only NR);Bacteria;Proteobacteria;Gammaproteobacteria;Burkholderiales;Oxalobacteraceae;Oxalobacter;";"100.0";"14.4";"27";"27";"27";"0";"0";"457156";"391180"
"V4mis2";"SILVA (only NR);Bacteria;Proteobacteria;Gammaproteobacteria;Burkholderiales;Oxalobacteraceae;Paraherbaspirillum;";"100.0";"14.4";"2";"2";"2";"0";"0";"457181";"391205"
"V4mis2";"SILVA (only NR);Bacteria;Proteobacteria;Gammaproteobacteria;Burkholderiales;Oxalobacteraceae;Paucimonas;";"100.0";"14.4";"6";"6";"6";"0";"0";"457177";"391201"
"V4mis2";"SILVA (only NR);Bacteria;Proteobacteria;Gammaproteobacteria;Burkholderiales;Oxalobacteraceae;Pseudoduganella;";"87.5";"14.4";"8";"8";"7";"1";"0";"457175";"391200"
"V4mis2";"SILVA (only NR);Bacteria;Proteobacteria;Gammaproteobacteria;Burkholderiales;Oxalobacteraceae;Rugamonas;";"100.0";"14.4";"6";"6";"6";"0";"0";"457177";"391201"
"V4mis2";"SILVA (only NR);Bacteria;Proteobacteria;Gammaproteobacteria;Burkholderiales;Oxalobacteraceae;Telluria;";"100.0";"14.4";"2";"2";"2";"0";"0";"457181";"391205"
"V4mis2";"SILVA (only NR);Bacteria;Proteobacteria;Gammaproteobacteria;Burkholderiales;Oxalobacteraceae;Undibacterium;";"96.6";"14.4";"118";"118";"114";"4";"0";"457065";"391093"
"V4mis2";"SILVA (only NR);Bacteria;Proteobacteria;Gammaproteobacteria;Burkholderiales;Oxalobacteraceae;[Aquaspirillum] arcticum group;";"100.0";"14.4";"23";"23";"23";"0";"0";"457160";"391184"
"V4mis2";"SILVA (only NR);Bacteria;Proteobacteria;Gammaproteobacteria;Burkholderiales;Oxalobacteraceae;s3t2d-1089;";"75.0";"14.4";"4";"4";"3";"1";"0";"457179";"391204"
"V4mis2";"SILVA (only NR);Bacteria;Proteobacteria;Gammaproteobacteria;Burkholderiales;Oxalobacteraceae;uncultured;";"98.2";"14.4";"113";"113";"111";"2";"0";"457070";"391096"
"V4mis2";"SILVA (only NR);Bacteria;Proteobacteria;Gammaproteobacteria;Burkholderiales;Procabacteriaceae;";"90.0";"14.4";"10";"10";"9";"1";"0";"457173";"391198"
"V4mis2";"SILVA (only NR);Bacteria;Proteobacteria;Gammaproteobacteria;Burkholderiales;Procabacteriaceae;Procabacter;";"90.0";"14.4";"10";"10";"9";"1";"0";"457173";"391198"
"V4mis2";"SILVA (only NR);Bacteria;Proteobacteria;Gammaproteobacteria;Burkholderiales;Rhodocyclaceae;";"95.7";"14.5";"1708";"1708";"1635";"73";"0";"455475";"389572"
"V4mis2";"SILVA (only NR);Bacteria;Proteobacteria;Gammaproteobacteria;Burkholderiales;Rhodocyclaceae;Azoarcus;";"95.0";"14.4";"121";"121";"115";"6";"0";"457062";"391092"
"V4mis2";"SILVA (only NR);Bacteria;Proteobacteria;Gammaproteobacteria;Burkholderiales;Rhodocyclaceae;Azonexus;";"78.6";"14.4";"28";"28";"22";"6";"0";"457155";"391185"
"V4mis2";"SILVA (only NR);Bacteria;Proteobacteria;Gammaproteobacteria;Burkholderiales;Rhodocyclaceae;Azospira;";"100.0";"14.4";"52";"52";"52";"0";"0";"457131";"391155"
"V4mis2";"SILVA (only NR);Bacteria;Proteobacteria;Gammaproteobacteria;Burkholderiales;Rhodocyclaceae;Azovibrio;";"94.4";"14.4";"18";"18";"17";"1";"0";"457165";"391190"
"V4mis2";"SILVA (only NR);Bacteria;Proteobacteria;Gammaproteobacteria;Burkholderiales;Rhodocyclaceae;C39;";"96.8";"14.4";"31";"31";"30";"1";"0";"457152";"391177"
"V4mis2";"SILVA (only NR);Bacteria;Proteobacteria;Gammaproteobacteria;Burkholderiales;Rhodocyclaceae;Candidatus Accumulibacter;";"96.7";"14.4";"123";"123";"119";"4";"0";"457060";"391088"
"V4mis2";"SILVA (only NR);Bacteria;Proteobacteria;Gammaproteobacteria;Burkholderiales;Rhodocyclaceae;Dechlorobacter;";"100.0";"14.4";"27";"27";"27";"0";"0";"457156";"391180"
"V4mis2";"SILVA (only NR);Bacteria;Proteobacteria;Gammaproteobacteria;Burkholderiales;Rhodocyclaceae;Dechloromonas;";"92.8";"14.4";"181";"181";"168";"13";"0";"457002";"391039"
"V4mis2";"SILVA (only NR);Bacteria;Proteobacteria;Gammaproteobacteria;Burkholderiales;Rhodocyclaceae;Dechlorosoma;";"95.7";"14.4";"23";"23";"22";"1";"0";"457160";"391185"
"V4mis2";"SILVA (only NR);Bacteria;Proteobacteria;Gammaproteobacteria;Burkholderiales;Rhodocyclaceae;Denitratisoma;";"90.8";"14.4";"65";"65";"59";"6";"0";"457118";"391148"
"V4mis2";"SILVA (only NR);Bacteria;Proteobacteria;Gammaproteobacteria;Burkholderiales;Rhodocyclaceae;Denitromonas;";"100.0";"14.4";"16";"16";"16";"0";"0";"457167";"391191"
"V4mis2";"SILVA (only NR);Bacteria;Proteobacteria;Gammaproteobacteria;Burkholderiales;Rhodocyclaceae;Ferribacterium;";"97.0";"14.4";"33";"33";"32";"1";"0";"457150";"391175"
"V4mis2";"SILVA (only NR);Bacteria;Proteobacteria;Gammaproteobacteria;Burkholderiales;Rhodocyclaceae;Georgfuchsia;";"100.0";"14.4";"8";"8";"8";"0";"0";"457175";"391199"
"V4mis2";"SILVA (only NR);Bacteria;Proteobacteria;Gammaproteobacteria;Burkholderiales;Rhodocyclaceae;Methyloversatilis;";"95.2";"14.4";"42";"42";"40";"2";"0";"457141";"391167"
"V4mis2";"SILVA (only NR);Bacteria;Proteobacteria;Gammaproteobacteria;Burkholderiales;Rhodocyclaceae;Niveibacterium;";"100.0";"14.4";"4";"4";"4";"0";"0";"457179";"391203"
"V4mis2";"SILVA (only NR);Bacteria;Proteobacteria;Gammaproteobacteria;Burkholderiales;Rhodocyclaceae;Propionivibrio;";"93.4";"14.4";"76";"76";"71";"5";"0";"457107";"391136"
"V4mis2";"SILVA (only NR);Bacteria;Proteobacteria;Gammaproteobacteria;Burkholderiales;Rhodocyclaceae;Quatrionicoccus;";"100.0";"14.4";"3";"3";"3";"0";"0";"457180";"391204"
"V4mis2";"SILVA (only NR);Bacteria;Proteobacteria;Gammaproteobacteria;Burkholderiales;Rhodocyclaceae;Rhodocyclus;";"100.0";"14.4";"4";"4";"4";"0";"0";"457179";"391203"
"V4mis2";"SILVA (only NR);Bacteria;Proteobacteria;Gammaproteobacteria;Burkholderiales;Rhodocyclaceae;Sterolibacterium;";"100.0";"14.4";"28";"28";"28";"0";"0";"457155";"391179"
"V4mis2";"SILVA (only NR);Bacteria;Proteobacteria;Gammaproteobacteria;Burkholderiales;Rhodocyclaceae;Sulfurisoma;";"100.0";"14.4";"6";"6";"6";"0";"0";"457177";"391201"
"V4mis2";"SILVA (only NR);Bacteria;Proteobacteria;Gammaproteobacteria;Burkholderiales;Rhodocyclaceae;Sulfuritalea;";"95.0";"14.4";"159";"159";"151";"8";"0";"457024";"391056"
"V4mis2";"SILVA (only NR);Bacteria;Proteobacteria;Gammaproteobacteria;Burkholderiales;Rhodocyclaceae;Thauera;";"97.1";"14.4";"209";"209";"203";"6";"0";"456974";"391004"
"V4mis2";"SILVA (only NR);Bacteria;Proteobacteria;Gammaproteobacteria;Burkholderiales;Rhodocyclaceae;Uliginosibacterium;";"91.4";"14.4";"35";"35";"32";"3";"0";"457148";"391175"
"V4mis2";"SILVA (only NR);Bacteria;Proteobacteria;Gammaproteobacteria;Burkholderiales;Rhodocyclaceae;Z-35;";"100.0";"14.4";"20";"20";"20";"0";"0";"457163";"391187"
"V4mis2";"SILVA (only NR);Bacteria;Proteobacteria;Gammaproteobacteria;Burkholderiales;Rhodocyclaceae;Zoogloea;";"95.6";"14.4";"136";"136";"130";"6";"0";"457047";"391077"
"V4mis2";"SILVA (only NR);Bacteria;Proteobacteria;Gammaproteobacteria;Burkholderiales;Rhodocyclaceae;uncultured;";"98.4";"14.4";"245";"245";"241";"4";"0";"456938";"390966"
"V4mis2";"SILVA (only NR);Bacteria;Proteobacteria;Gammaproteobacteria;Burkholderiales;SC-I-84;";"95.9";"14.4";"367";"367";"352";"15";"0";"456816";"390855"
"V4mis2";"SILVA (only NR);Bacteria;Proteobacteria;Gammaproteobacteria;Burkholderiales;Sulfuricellaceae;";"91.7";"14.4";"157";"157";"144";"13";"0";"457026";"391063"
"V4mis2";"SILVA (only NR);Bacteria;Proteobacteria;Gammaproteobacteria;Burkholderiales;Sulfuricellaceae;Ferritrophicum;";"82.4";"14.4";"68";"68";"56";"12";"0";"457115";"391151"
"V4mis2";"SILVA (only NR);Bacteria;Proteobacteria;Gammaproteobacteria;Burkholderiales;Sulfuricellaceae;Sulfuricella;";"100.0";"14.4";"19";"19";"19";"0";"0";"457164";"391188"
"V4mis2";"SILVA (only NR);Bacteria;Proteobacteria;Gammaproteobacteria;Burkholderiales;Sulfuricellaceae;Sulfuriferula;";"98.1";"14.4";"52";"52";"51";"1";"0";"457131";"391156"
"V4mis2";"SILVA (only NR);Bacteria;Proteobacteria;Gammaproteobacteria;Burkholderiales;Sulfuricellaceae;Sulfurirhabdus;";"100.0";"14.4";"17";"17";"17";"0";"0";"457166";"391190"
"V4mis2";"SILVA (only NR);Bacteria;Proteobacteria;Gammaproteobacteria;Burkholderiales;Sutterellaceae;";"94.8";"14.4";"388";"388";"368";"20";"0";"456795";"390839"
"V4mis2";"SILVA (only NR);Bacteria;Proteobacteria;Gammaproteobacteria;Burkholderiales;Sutterellaceae;AAP99;";"96.9";"14.4";"32";"32";"31";"1";"0";"457151";"391176"
"V4mis2";"SILVA (only NR);Bacteria;Proteobacteria;Gammaproteobacteria;Burkholderiales;Sutterellaceae;Parasutterella;";"93.0";"14.4";"129";"129";"120";"9";"0";"457054";"391087"
"V4mis2";"SILVA (only NR);Bacteria;Proteobacteria;Gammaproteobacteria;Burkholderiales;Sutterellaceae;Sutterella;";"95.5";"14.4";"110";"110";"105";"5";"0";"457073";"391102"
"V4mis2";"SILVA (only NR);Bacteria;Proteobacteria;Gammaproteobacteria;Burkholderiales;Sutterellaceae;uncultured;";"95.7";"14.4";"116";"116";"111";"5";"0";"457067";"391096"
"V4mis2";"SILVA (only NR);Bacteria;Proteobacteria;Gammaproteobacteria;Burkholderiales;T34;";"91.3";"14.4";"23";"23";"21";"2";"0";"457160";"391186"
"V4mis2";"SILVA (only NR);Bacteria;Proteobacteria;Gammaproteobacteria;Burkholderiales;TRA3-20;";"93.5";"14.4";"355";"355";"332";"23";"0";"456828";"390875"
"V4mis2";"SILVA (only NR);Bacteria;Proteobacteria;Gammaproteobacteria;Burkholderiales;uncultured;";"95.5";"14.4";"22";"22";"21";"1";"0";"457161";"391186"
"V4mis2";"SILVA (only NR);Bacteria;Proteobacteria;Gammaproteobacteria;CCD24;";"94.2";"14.4";"69";"69";"65";"4";"0";"457114";"391142"
"V4mis2";"SILVA (only NR);Bacteria;Proteobacteria;Gammaproteobacteria;CCM19a;";"94.7";"14.4";"19";"19";"18";"1";"0";"457164";"391189"
"V4mis2";"SILVA (only NR);Bacteria;Proteobacteria;Gammaproteobacteria;CH2b56;";"85.7";"14.4";"7";"7";"6";"1";"0";"457176";"391201"
"V4mis2";"SILVA (only NR);Bacteria;Proteobacteria;Gammaproteobacteria;CHAB-XI-27;";"90.0";"14.4";"10";"10";"9";"1";"0";"457173";"391198"
"V4mis2";"SILVA (only NR);Bacteria;Proteobacteria;Gammaproteobacteria;Cardiobacteriales;";"97.0";"14.4";"438";"438";"425";"13";"0";"456745";"390782"
"V4mis2";"SILVA (only NR);Bacteria;Proteobacteria;Gammaproteobacteria;Cardiobacteriales;Cardiobacteriaceae;";"96.9";"14.4";"415";"415";"402";"13";"0";"456768";"390805"
"V4mis2";"SILVA (only NR);Bacteria;Proteobacteria;Gammaproteobacteria;Cardiobacteriales;Cardiobacteriaceae;Cardiobacterium;";"94.7";"14.4";"113";"113";"107";"6";"0";"457070";"391100"
"V4mis2";"SILVA (only NR);Bacteria;Proteobacteria;Gammaproteobacteria;Cardiobacteriales;Cardiobacteriaceae;Dichelobacter;";"100.0";"14.4";"4";"4";"4";"0";"0";"457179";"391203"
"V4mis2";"SILVA (only NR);Bacteria;Proteobacteria;Gammaproteobacteria;Cardiobacteriales;Cardiobacteriaceae;Suttonella;";"100.0";"14.4";"10";"10";"10";"0";"0";"457173";"391197"
"V4mis2";"SILVA (only NR);Bacteria;Proteobacteria;Gammaproteobacteria;Cardiobacteriales;Cardiobacteriaceae;uncultured;";"97.6";"14.4";"287";"287";"280";"7";"0";"456896";"390927"
"V4mis2";"SILVA (only NR);Bacteria;Proteobacteria;Gammaproteobacteria;Cardiobacteriales;Wohlfahrtiimonadaceae;";"100.0";"14.4";"22";"22";"22";"0";"0";"457161";"391185"
"V4mis2";"SILVA (only NR);Bacteria;Proteobacteria;Gammaproteobacteria;Cardiobacteriales;Wohlfahrtiimonadaceae;Ignatzschineria;";"100.0";"14.4";"13";"13";"13";"0";"0";"457170";"391194"
"V4mis2";"SILVA (only NR);Bacteria;Proteobacteria;Gammaproteobacteria;Cardiobacteriales;Wohlfahrtiimonadaceae;Koukoulia;";"100.0";"14.4";"2";"2";"2";"0";"0";"457181";"391205"
"V4mis2";"SILVA (only NR);Bacteria;Proteobacteria;Gammaproteobacteria;Cardiobacteriales;Wohlfahrtiimonadaceae;Wohlfahrtiimonas;";"100.0";"14.4";"6";"6";"6";"0";"0";"457177";"391201"
"V4mis2";"SILVA (only NR);Bacteria;Proteobacteria;Gammaproteobacteria;Chromatiales;";"95.1";"14.4";"494";"494";"470";"24";"0";"456689";"390737"
"V4mis2";"SILVA (only NR);Bacteria;Proteobacteria;Gammaproteobacteria;Chromatiales;Chromatiaceae;";"94.4";"14.4";"356";"356";"336";"20";"0";"456827";"390871"
"V4mis2";"SILVA (only NR);Bacteria;Proteobacteria;Gammaproteobacteria;Chromatiales;Chromatiaceae;Achromatium;";"100.0";"14.4";"16";"16";"16";"0";"0";"457167";"391191"
"V4mis2";"SILVA (only NR);Bacteria;Proteobacteria;Gammaproteobacteria;Chromatiales;Chromatiaceae;Allochromatium;";"95.2";"14.4";"21";"21";"20";"1";"0";"457162";"391187"
"V4mis2";"SILVA (only NR);Bacteria;Proteobacteria;Gammaproteobacteria;Chromatiales;Chromatiaceae;Candidatus Thiobios;";"100.0";"14.4";"33";"33";"33";"0";"0";"457150";"391174"
"V4mis2";"SILVA (only NR);Bacteria;Proteobacteria;Gammaproteobacteria;Chromatiales;Chromatiaceae;Chromatium;";"100.0";"14.4";"12";"12";"12";"0";"0";"457171";"391195"
"V4mis2";"SILVA (only NR);Bacteria;Proteobacteria;Gammaproteobacteria;Chromatiales;Chromatiaceae;Halochromatium;";"91.3";"14.4";"69";"69";"63";"6";"0";"457114";"391144"
"V4mis2";"SILVA (only NR);Bacteria;Proteobacteria;Gammaproteobacteria;Chromatiales;Chromatiaceae;Isochromatium;";"100.0";"14.4";"1";"1";"1";"0";"0";"457182";"391206"
"V4mis2";"SILVA (only NR);Bacteria;Proteobacteria;Gammaproteobacteria;Chromatiales;Chromatiaceae;Lamprocystis;";"100.0";"14.4";"13";"13";"13";"0";"0";"457170";"391194"
"V4mis2";"SILVA (only NR);Bacteria;Proteobacteria;Gammaproteobacteria;Chromatiales;Chromatiaceae;Marichromatium;";"81.3";"14.4";"16";"16";"13";"3";"0";"457167";"391194"
"V4mis2";"SILVA (only NR);Bacteria;Proteobacteria;Gammaproteobacteria;Chromatiales;Chromatiaceae;Phaeochromatium;";"50.0";"14.4";"2";"2";"1";"1";"0";"457181";"391206"
"V4mis2";"SILVA (only NR);Bacteria;Proteobacteria;Gammaproteobacteria;Chromatiales;Chromatiaceae;Rhabdochromatium;";"100.0";"14.4";"2";"2";"2";"0";"0";"457181";"391205"
"V4mis2";"SILVA (only NR);Bacteria;Proteobacteria;Gammaproteobacteria;Chromatiales;Chromatiaceae;Thioalkalicoccus;";"100.0";"14.4";"3";"3";"3";"0";"0";"457180";"391204"
"V4mis2";"SILVA (only NR);Bacteria;Proteobacteria;Gammaproteobacteria;Chromatiales;Chromatiaceae;Thiobaca;";"100.0";"14.4";"3";"3";"3";"0";"0";"457180";"391204"
"V4mis2";"SILVA (only NR);Bacteria;Proteobacteria;Gammaproteobacteria;Chromatiales;Chromatiaceae;Thiocapsa;";"100.0";"14.4";"24";"24";"24";"0";"0";"457159";"391183"
"V4mis2";"SILVA (only NR);Bacteria;Proteobacteria;Gammaproteobacteria;Chromatiales;Chromatiaceae;Thiococcus;";"100.0";"14.4";"3";"3";"3";"0";"0";"457180";"391204"
"V4mis2";"SILVA (only NR);Bacteria;Proteobacteria;Gammaproteobacteria;Chromatiales;Chromatiaceae;Thiocystis;";"94.1";"14.4";"17";"17";"16";"1";"0";"457166";"391191"
"V4mis2";"SILVA (only NR);Bacteria;Proteobacteria;Gammaproteobacteria;Chromatiales;Chromatiaceae;Thiodictyon;";"100.0";"14.4";"4";"4";"4";"0";"0";"457179";"391203"
"V4mis2";"SILVA (only NR);Bacteria;Proteobacteria;Gammaproteobacteria;Chromatiales;Chromatiaceae;Thioflavicoccus;";"100.0";"14.4";"4";"4";"4";"0";"0";"457179";"391203"
"V4mis2";"SILVA (only NR);Bacteria;Proteobacteria;Gammaproteobacteria;Chromatiales;Chromatiaceae;Thiohalobacter;";"100.0";"14.4";"3";"3";"3";"0";"0";"457180";"391204"
"V4mis2";"SILVA (only NR);Bacteria;Proteobacteria;Gammaproteobacteria;Chromatiales;Chromatiaceae;Thiohalocapsa;";"86.2";"14.4";"58";"58";"50";"8";"0";"457125";"391157"
"V4mis2";"SILVA (only NR);Bacteria;Proteobacteria;Gammaproteobacteria;Chromatiales;Chromatiaceae;Thiolamprovum;";"100.0";"14.4";"3";"3";"3";"0";"0";"457180";"391204"
"V4mis2";"SILVA (only NR);Bacteria;Proteobacteria;Gammaproteobacteria;Chromatiales;Chromatiaceae;Thiophaeococcus;";"100.0";"14.4";"6";"6";"6";"0";"0";"457177";"391201"
"V4mis2";"SILVA (only NR);Bacteria;Proteobacteria;Gammaproteobacteria;Chromatiales;Chromatiaceae;Thiorhodococcus;";"100.0";"14.4";"11";"11";"11";"0";"0";"457172";"391196"
"V4mis2";"SILVA (only NR);Bacteria;Proteobacteria;Gammaproteobacteria;Chromatiales;Chromatiaceae;Thiorhodovibrio;";"100.0";"14.4";"5";"5";"5";"0";"0";"457178";"391202"
"V4mis2";"SILVA (only NR);Bacteria;Proteobacteria;Gammaproteobacteria;Chromatiales;Chromatiaceae;uncultured;";"100.0";"14.4";"26";"26";"26";"0";"0";"457157";"391181"
"V4mis2";"SILVA (only NR);Bacteria;Proteobacteria;Gammaproteobacteria;Chromatiales;Sedimenticolaceae;";"97.1";"14.4";"138";"138";"134";"4";"0";"457045";"391073"
"V4mis2";"SILVA (only NR);Bacteria;Proteobacteria;Gammaproteobacteria;Chromatiales;Sedimenticolaceae;Candidatus Thiodiazotropha;";"94.4";"14.4";"18";"18";"17";"1";"0";"457165";"391190"
"V4mis2";"SILVA (only NR);Bacteria;Proteobacteria;Gammaproteobacteria;Chromatiales;Sedimenticolaceae;Sedimenticola;";"98.6";"14.4";"70";"70";"69";"1";"0";"457113";"391138"
"V4mis2";"SILVA (only NR);Bacteria;Proteobacteria;Gammaproteobacteria;Chromatiales;Sedimenticolaceae;uncultured;";"96.0";"14.4";"50";"50";"48";"2";"0";"457133";"391159"
"V4mis2";"SILVA (only NR);Bacteria;Proteobacteria;Gammaproteobacteria;Competibacterales;";"97.6";"14.4";"125";"125";"122";"3";"0";"457058";"391085"
"V4mis2";"SILVA (only NR);Bacteria;Proteobacteria;Gammaproteobacteria;Competibacterales;Competibacteraceae;";"97.6";"14.4";"125";"125";"122";"3";"0";"457058";"391085"
"V4mis2";"SILVA (only NR);Bacteria;Proteobacteria;Gammaproteobacteria;Competibacterales;Competibacteraceae;Candidatus Competibacter;";"96.8";"14.4";"95";"95";"92";"3";"0";"457088";"391115"
"V4mis2";"SILVA (only NR);Bacteria;Proteobacteria;Gammaproteobacteria;Competibacterales;Competibacteraceae;Candidatus Contendobacter;";"100.0";"14.4";"23";"23";"23";"0";"0";"457160";"391184"
"V4mis2";"SILVA (only NR);Bacteria;Proteobacteria;Gammaproteobacteria;Competibacterales;Competibacteraceae;Plasticicumulans;";"100.0";"14.4";"7";"7";"7";"0";"0";"457176";"391200"
"V4mis2";"SILVA (only NR);Bacteria;Proteobacteria;Gammaproteobacteria;Coxiellales;";"97.9";"14.4";"387";"387";"379";"8";"0";"456796";"390828"
"V4mis2";"SILVA (only NR);Bacteria;Proteobacteria;Gammaproteobacteria;Coxiellales;Coxiellaceae;";"97.9";"14.4";"387";"387";"379";"8";"0";"456796";"390828"
"V4mis2";"SILVA (only NR);Bacteria;Proteobacteria;Gammaproteobacteria;Coxiellales;Coxiellaceae;Coxiella;";"97.9";"14.4";"387";"387";"379";"8";"0";"456796";"390828"
"V4mis2";"SILVA (only NR);Bacteria;Proteobacteria;Gammaproteobacteria;D90;";"100.0";"14.4";"10";"10";"10";"0";"0";"457173";"391197"
"V4mis2";"SILVA (only NR);Bacteria;Proteobacteria;Gammaproteobacteria;Diplorickettsiales;";"96.2";"14.4";"446";"446";"429";"17";"0";"456737";"390778"
"V4mis2";"SILVA (only NR);Bacteria;Proteobacteria;Gammaproteobacteria;Diplorickettsiales;Diplorickettsiaceae;";"96.2";"14.4";"446";"446";"429";"17";"0";"456737";"390778"
"V4mis2";"SILVA (only NR);Bacteria;Proteobacteria;Gammaproteobacteria;Diplorickettsiales;Diplorickettsiaceae;Aquicella;";"95.8";"14.4";"167";"167";"160";"7";"0";"457016";"391047"
"V4mis2";"SILVA (only NR);Bacteria;Proteobacteria;Gammaproteobacteria;Diplorickettsiales;Diplorickettsiaceae;Diplorickettsia;";"85.7";"14.4";"7";"7";"6";"1";"0";"457176";"391201"
"V4mis2";"SILVA (only NR);Bacteria;Proteobacteria;Gammaproteobacteria;Diplorickettsiales;Diplorickettsiaceae;Rickettsiella;";"100.0";"14.4";"34";"34";"34";"0";"0";"457149";"391173"
"V4mis2";"SILVA (only NR);Bacteria;Proteobacteria;Gammaproteobacteria;Diplorickettsiales;Diplorickettsiaceae;uncultured;";"96.1";"14.4";"233";"233";"224";"9";"0";"456950";"390983"
"V4mis2";"SILVA (only NR);Bacteria;Proteobacteria;Gammaproteobacteria;EC3;";"98.2";"14.4";"55";"55";"54";"1";"0";"457128";"391153"
"V4mis2";"SILVA (only NR);Bacteria;Proteobacteria;Gammaproteobacteria;EPR3968-O8a-Bc78;";"89.3";"14.4";"56";"56";"50";"6";"0";"457127";"391157"
"V4mis2";"SILVA (only NR);Bacteria;Proteobacteria;Gammaproteobacteria;EV818SWSAP88;";"95.7";"14.4";"23";"23";"22";"1";"0";"457160";"391185"
"V4mis2";"SILVA (only NR);Bacteria;Proteobacteria;Gammaproteobacteria;Ectothiorhodospirales;";"94.9";"14.4";"473";"473";"449";"24";"0";"456710";"390758"
"V4mis2";"SILVA (only NR);Bacteria;Proteobacteria;Gammaproteobacteria;Ectothiorhodospirales;Acidihalobacteraceae;";"100.0";"14.4";"12";"12";"12";"0";"0";"457171";"391195"
"V4mis2";"SILVA (only NR);Bacteria;Proteobacteria;Gammaproteobacteria;Ectothiorhodospirales;Acidihalobacteraceae;Acidihalobacter;";"100.0";"14.4";"12";"12";"12";"0";"0";"457171";"391195"
"V4mis2";"SILVA (only NR);Bacteria;Proteobacteria;Gammaproteobacteria;Ectothiorhodospirales;Ectothiorhodospiraceae;";"93.9";"14.4";"311";"311";"292";"19";"0";"456872";"390915"
"V4mis2";"SILVA (only NR);Bacteria;Proteobacteria;Gammaproteobacteria;Ectothiorhodospirales;Ectothiorhodospiraceae;Ectothiorhodosinus;";"100.0";"14.4";"1";"1";"1";"0";"0";"457182";"391206"
"V4mis2";"SILVA (only NR);Bacteria;Proteobacteria;Gammaproteobacteria;Ectothiorhodospirales;Ectothiorhodospiraceae;Ectothiorhodospira;";"90.0";"14.4";"20";"20";"18";"2";"0";"457163";"391189"
"V4mis2";"SILVA (only NR);Bacteria;Proteobacteria;Gammaproteobacteria;Ectothiorhodospirales;Ectothiorhodospiraceae;Halofilum;";"95.5";"14.4";"22";"22";"21";"1";"0";"457161";"391186"
"V4mis2";"SILVA (only NR);Bacteria;Proteobacteria;Gammaproteobacteria;Ectothiorhodospirales;Ectothiorhodospiraceae;Thioalbus;";"100.0";"14.4";"5";"5";"5";"0";"0";"457178";"391202"
"V4mis2";"SILVA (only NR);Bacteria;Proteobacteria;Gammaproteobacteria;Ectothiorhodospirales;Ectothiorhodospiraceae;Thioalkalivibrio;";"95.1";"14.4";"41";"41";"39";"2";"0";"457142";"391168"
"V4mis2";"SILVA (only NR);Bacteria;Proteobacteria;Gammaproteobacteria;Ectothiorhodospirales;Ectothiorhodospiraceae;Thiogranum;";"87.9";"14.4";"66";"66";"58";"8";"0";"457117";"391149"
"V4mis2";"SILVA (only NR);Bacteria;Proteobacteria;Gammaproteobacteria;Ectothiorhodospirales;Ectothiorhodospiraceae;Thiohalomonas;";"100.0";"14.4";"10";"10";"10";"0";"0";"457173";"391197"
"V4mis2";"SILVA (only NR);Bacteria;Proteobacteria;Gammaproteobacteria;Ectothiorhodospirales;Ectothiorhodospiraceae;Thiohalospira;";"100.0";"14.4";"6";"6";"6";"0";"0";"457177";"391201"
"V4mis2";"SILVA (only NR);Bacteria;Proteobacteria;Gammaproteobacteria;Ectothiorhodospirales;Ectothiorhodospiraceae;Thiorhodospira;";"100.0";"14.4";"3";"3";"3";"0";"0";"457180";"391204"
"V4mis2";"SILVA (only NR);Bacteria;Proteobacteria;Gammaproteobacteria;Ectothiorhodospirales;Ectothiorhodospiraceae;uncultured;";"95.6";"14.4";"136";"136";"130";"6";"0";"457047";"391077"
"V4mis2";"SILVA (only NR);Bacteria;Proteobacteria;Gammaproteobacteria;Ectothiorhodospirales;Thioalkalispiraceae;";"96.7";"14.4";"150";"150";"145";"5";"0";"457033";"391062"
"V4mis2";"SILVA (only NR);Bacteria;Proteobacteria;Gammaproteobacteria;Ectothiorhodospirales;Thioalkalispiraceae;Thioalkalispira-Sulfurivermis;";"100.0";"14.4";"60";"60";"60";"0";"0";"457123";"391147"
"V4mis2";"SILVA (only NR);Bacteria;Proteobacteria;Gammaproteobacteria;Ectothiorhodospirales;Thioalkalispiraceae;Thiohalophilus;";"94.6";"14.4";"74";"74";"70";"4";"0";"457109";"391137"
"V4mis2";"SILVA (only NR);Bacteria;Proteobacteria;Gammaproteobacteria;Ectothiorhodospirales;Thioalkalispiraceae;uncultured;";"93.8";"14.4";"16";"16";"15";"1";"0";"457167";"391192"
"V4mis2";"SILVA (only NR);Bacteria;Proteobacteria;Gammaproteobacteria;Enterobacterales;";"94.2";"14.9";"23028";"23028";"21682";"1346";"0";"434155";"369525"
"V4mis2";"SILVA (only NR);Bacteria;Proteobacteria;Gammaproteobacteria;Enterobacterales;Aeromonadaceae;";"94.8";"14.5";"1135";"1135";"1076";"59";"0";"456048";"390131"
"V4mis2";"SILVA (only NR);Bacteria;Proteobacteria;Gammaproteobacteria;Enterobacterales;Aeromonadaceae;Aeromonas;";"94.7";"14.5";"1030";"1030";"975";"55";"0";"456153";"390232"
"V4mis2";"SILVA (only NR);Bacteria;Proteobacteria;Gammaproteobacteria;Enterobacterales;Aeromonadaceae;Oceanimonas;";"90.9";"14.4";"22";"22";"20";"2";"0";"457161";"391187"
"V4mis2";"SILVA (only NR);Bacteria;Proteobacteria;Gammaproteobacteria;Enterobacterales;Aeromonadaceae;Oceanisphaera;";"97.6";"14.4";"41";"41";"40";"1";"0";"457142";"391167"
"V4mis2";"SILVA (only NR);Bacteria;Proteobacteria;Gammaproteobacteria;Enterobacterales;Aeromonadaceae;Tolumonas;";"100.0";"14.4";"19";"19";"19";"0";"0";"457164";"391188"
"V4mis2";"SILVA (only NR);Bacteria;Proteobacteria;Gammaproteobacteria;Enterobacterales;Aeromonadaceae;Zobellella;";"93.8";"14.4";"16";"16";"15";"1";"0";"457167";"391192"
"V4mis2";"SILVA (only NR);Bacteria;Proteobacteria;Gammaproteobacteria;Enterobacterales;Alteromonadaceae;";"91.1";"14.4";"1053";"1053";"959";"94";"0";"456130";"390248"
"V4mis2";"SILVA (only NR);Bacteria;Proteobacteria;Gammaproteobacteria;Enterobacterales;Alteromonadaceae;Aestuariibacter;";"92.7";"14.4";"55";"55";"51";"4";"0";"457128";"391156"
"V4mis2";"SILVA (only NR);Bacteria;Proteobacteria;Gammaproteobacteria;Enterobacterales;Alteromonadaceae;Agaribacter;";"95.5";"14.4";"22";"22";"21";"1";"0";"457161";"391186"
"V4mis2";"SILVA (only NR);Bacteria;Proteobacteria;Gammaproteobacteria;Enterobacterales;Alteromonadaceae;Aliiglaciecola;";"100.0";"14.4";"14";"14";"14";"0";"0";"457169";"391193"
"V4mis2";"SILVA (only NR);Bacteria;Proteobacteria;Gammaproteobacteria;Enterobacterales;Alteromonadaceae;Alishewanella;";"89.2";"14.4";"37";"37";"33";"4";"0";"457146";"391174"
"V4mis2";"SILVA (only NR);Bacteria;Proteobacteria;Gammaproteobacteria;Enterobacterales;Alteromonadaceae;Alteromonas;";"85.1";"14.4";"456";"456";"388";"68";"0";"456727";"390819"
"V4mis2";"SILVA (only NR);Bacteria;Proteobacteria;Gammaproteobacteria;Enterobacterales;Alteromonadaceae;Bowmanella;";"100.0";"14.4";"4";"4";"4";"0";"0";"457179";"391203"
"V4mis2";"SILVA (only NR);Bacteria;Proteobacteria;Gammaproteobacteria;Enterobacterales;Alteromonadaceae;Catenovulum;";"100.0";"14.4";"12";"12";"12";"0";"0";"457171";"391195"
"V4mis2";"SILVA (only NR);Bacteria;Proteobacteria;Gammaproteobacteria;Enterobacterales;Alteromonadaceae;Gayadomonas;";"100.0";"14.4";"2";"2";"2";"0";"0";"457181";"391205"
"V4mis2";"SILVA (only NR);Bacteria;Proteobacteria;Gammaproteobacteria;Enterobacterales;Alteromonadaceae;Glaciecola;";"94.4";"14.4";"54";"54";"51";"3";"0";"457129";"391156"
"V4mis2";"SILVA (only NR);Bacteria;Proteobacteria;Gammaproteobacteria;Enterobacterales;Alteromonadaceae;Lacimicrobium;";"100.0";"14.4";"6";"6";"6";"0";"0";"457177";"391201"
"V4mis2";"SILVA (only NR);Bacteria;Proteobacteria;Gammaproteobacteria;Enterobacterales;Alteromonadaceae;Neiella;";"100.0";"14.4";"4";"4";"4";"0";"0";"457179";"391203"
"V4mis2";"SILVA (only NR);Bacteria;Proteobacteria;Gammaproteobacteria;Enterobacterales;Alteromonadaceae;Paraglaciecola;";"97.0";"14.4";"66";"66";"64";"2";"0";"457117";"391143"
"V4mis2";"SILVA (only NR);Bacteria;Proteobacteria;Gammaproteobacteria;Enterobacterales;Alteromonadaceae;Pseudobowmanella;";"100.0";"14.4";"3";"3";"3";"0";"0";"457180";"391204"
"V4mis2";"SILVA (only NR);Bacteria;Proteobacteria;Gammaproteobacteria;Enterobacterales;Alteromonadaceae;Rheinheimera;";"96.4";"14.4";"225";"225";"217";"8";"0";"456958";"390990"
"V4mis2";"SILVA (only NR);Bacteria;Proteobacteria;Gammaproteobacteria;Enterobacterales;Alteromonadaceae;Salinimonas;";"84.2";"14.4";"19";"19";"16";"3";"0";"457164";"391191"
"V4mis2";"SILVA (only NR);Bacteria;Proteobacteria;Gammaproteobacteria;Enterobacterales;Alteromonadaceae;XY-R5;";"100.0";"14.4";"2";"2";"2";"0";"0";"457181";"391205"
"V4mis2";"SILVA (only NR);Bacteria;Proteobacteria;Gammaproteobacteria;Enterobacterales;Alteromonadaceae;uncultured;";"98.4";"14.4";"61";"61";"60";"1";"0";"457122";"391147"
"V4mis2";"SILVA (only NR);Bacteria;Proteobacteria;Gammaproteobacteria;Enterobacterales;Budviciaceae;";"100.0";"14.4";"22";"22";"22";"0";"0";"457161";"391185"
"V4mis2";"SILVA (only NR);Bacteria;Proteobacteria;Gammaproteobacteria;Enterobacterales;Budviciaceae;Budvicia;";"100.0";"14.4";"6";"6";"6";"0";"0";"457177";"391201"
"V4mis2";"SILVA (only NR);Bacteria;Proteobacteria;Gammaproteobacteria;Enterobacterales;Budviciaceae;Leminorella;";"100.0";"14.4";"5";"5";"5";"0";"0";"457178";"391202"
"V4mis2";"SILVA (only NR);Bacteria;Proteobacteria;Gammaproteobacteria;Enterobacterales;Budviciaceae;Pragia;";"100.0";"14.4";"11";"11";"11";"0";"0";"457172";"391196"
"V4mis2";"SILVA (only NR);Bacteria;Proteobacteria;Gammaproteobacteria;Enterobacterales;Celerinatantimonadaceae;";"100.0";"14.4";"3";"3";"3";"0";"0";"457180";"391204"
"V4mis2";"SILVA (only NR);Bacteria;Proteobacteria;Gammaproteobacteria;Enterobacterales;Celerinatantimonadaceae;Celerinatantimonas;";"100.0";"14.4";"3";"3";"3";"0";"0";"457180";"391204"
"V4mis2";"SILVA (only NR);Bacteria;Proteobacteria;Gammaproteobacteria;Enterobacterales;Colwelliaceae;";"95.1";"14.4";"511";"511";"486";"25";"0";"456672";"390721"
"V4mis2";"SILVA (only NR);Bacteria;Proteobacteria;Gammaproteobacteria;Enterobacterales;Colwelliaceae;Colwellia;";"95.2";"14.4";"377";"377";"359";"18";"0";"456806";"390848"
"V4mis2";"SILVA (only NR);Bacteria;Proteobacteria;Gammaproteobacteria;Enterobacterales;Colwelliaceae;Litorilituus;";"100.0";"14.4";"1";"1";"1";"0";"0";"457182";"391206"
"V4mis2";"SILVA (only NR);Bacteria;Proteobacteria;Gammaproteobacteria;Enterobacterales;Colwelliaceae;Thalassomonas;";"100.0";"14.4";"6";"6";"6";"0";"0";"457177";"391201"
"V4mis2";"SILVA (only NR);Bacteria;Proteobacteria;Gammaproteobacteria;Enterobacterales;Colwelliaceae;Thalassotalea;";"94.1";"14.4";"101";"101";"95";"6";"0";"457082";"391112"
"V4mis2";"SILVA (only NR);Bacteria;Proteobacteria;Gammaproteobacteria;Enterobacterales;Colwelliaceae;uncultured;";"95.8";"14.4";"24";"24";"23";"1";"0";"457159";"391184"
"V4mis2";"SILVA (only NR);Bacteria;Proteobacteria;Gammaproteobacteria;Enterobacterales;Enterobacterales Incertae Sedis;";"100.0";"14.4";"14";"14";"14";"0";"0";"457169";"391193"
"V4mis2";"SILVA (only NR);Bacteria;Proteobacteria;Gammaproteobacteria;Enterobacterales;Enterobacterales Incertae Sedis;Alkalimonas;";"100.0";"14.4";"14";"14";"14";"0";"0";"457169";"391193"
"V4mis2";"SILVA (only NR);Bacteria;Proteobacteria;Gammaproteobacteria;Enterobacterales;Enterobacteriaceae;";"93.4";"14.6";"7969";"7969";"7440";"529";"0";"449214";"383767"
"V4mis2";"SILVA (only NR);Bacteria;Proteobacteria;Gammaproteobacteria;Enterobacterales;Enterobacteriaceae;Aquamonas;";"100.0";"14.4";"1";"1";"1";"0";"0";"457182";"391206"
"V4mis2";"SILVA (only NR);Bacteria;Proteobacteria;Gammaproteobacteria;Enterobacterales;Enterobacteriaceae;Atlantibacter;";"75.0";"14.4";"4";"4";"3";"1";"0";"457179";"391204"
"V4mis2";"SILVA (only NR);Bacteria;Proteobacteria;Gammaproteobacteria;Enterobacterales;Enterobacteriaceae;Buttiauxella;";"96.5";"14.4";"57";"57";"55";"2";"0";"457126";"391152"
"V4mis2";"SILVA (only NR);Bacteria;Proteobacteria;Gammaproteobacteria;Enterobacterales;Enterobacteriaceae;Cedecea;";"100.0";"14.4";"14";"14";"14";"0";"0";"457169";"391193"
"V4mis2";"SILVA (only NR);Bacteria;Proteobacteria;Gammaproteobacteria;Enterobacterales;Enterobacteriaceae;Citrobacter;";"94.2";"14.4";"516";"516";"486";"30";"0";"456667";"390721"
"V4mis2";"SILVA (only NR);Bacteria;Proteobacteria;Gammaproteobacteria;Enterobacterales;Enterobacteriaceae;Cronobacter;";"97.4";"14.4";"153";"153";"149";"4";"0";"457030";"391058"
"V4mis2";"SILVA (only NR);Bacteria;Proteobacteria;Gammaproteobacteria;Enterobacterales;Enterobacteriaceae;Enterobacillus;";"100.0";"14.4";"15";"15";"15";"0";"0";"457168";"391192"
"V4mis2";"SILVA (only NR);Bacteria;Proteobacteria;Gammaproteobacteria;Enterobacterales;Enterobacteriaceae;Enterobacter;";"91.9";"14.5";"1670";"1670";"1534";"136";"0";"455513";"389673"
"V4mis2";"SILVA (only NR);Bacteria;Proteobacteria;Gammaproteobacteria;Enterobacterales;Enterobacteriaceae;Escherichia-Shigella;";"92.3";"14.5";"2807";"2807";"2590";"217";"0";"454376";"388617"
"V4mis2";"SILVA (only NR);Bacteria;Proteobacteria;Gammaproteobacteria;Enterobacterales;Enterobacteriaceae;Franconibacter;";"91.7";"14.4";"12";"12";"11";"1";"0";"457171";"391196"
"V4mis2";"SILVA (only NR);Bacteria;Proteobacteria;Gammaproteobacteria;Enterobacterales;Enterobacteriaceae;Klebsiella;";"93.2";"14.5";"1177";"1177";"1097";"80";"0";"456006";"390110"
"V4mis2";"SILVA (only NR);Bacteria;Proteobacteria;Gammaproteobacteria;Enterobacterales;Enterobacteriaceae;Kluyvera;";"95.5";"14.4";"88";"88";"84";"4";"0";"457095";"391123"
"V4mis2";"SILVA (only NR);Bacteria;Proteobacteria;Gammaproteobacteria;Enterobacterales;Enterobacteriaceae;Kosakonia;";"91.1";"14.4";"157";"157";"143";"14";"0";"457026";"391064"
"V4mis2";"SILVA (only NR);Bacteria;Proteobacteria;Gammaproteobacteria;Enterobacterales;Enterobacteriaceae;Lelliottia;";"96.8";"14.4";"31";"31";"30";"1";"0";"457152";"391177"
"V4mis2";"SILVA (only NR);Bacteria;Proteobacteria;Gammaproteobacteria;Enterobacterales;Enterobacteriaceae;Mangrovibacter;";"100.0";"14.4";"11";"11";"11";"0";"0";"457172";"391196"
"V4mis2";"SILVA (only NR);Bacteria;Proteobacteria;Gammaproteobacteria;Enterobacterales;Enterobacteriaceae;Plesiomonas;";"93.5";"14.4";"107";"107";"100";"7";"0";"457076";"391107"
"V4mis2";"SILVA (only NR);Bacteria;Proteobacteria;Gammaproteobacteria;Enterobacterales;Enterobacteriaceae;Pluralibacter;";"87.5";"14.4";"8";"8";"7";"1";"0";"457175";"391200"
"V4mis2";"SILVA (only NR);Bacteria;Proteobacteria;Gammaproteobacteria;Enterobacterales;Enterobacteriaceae;Pseudocitrobacter;";"100.0";"14.4";"20";"20";"20";"0";"0";"457163";"391187"
"V4mis2";"SILVA (only NR);Bacteria;Proteobacteria;Gammaproteobacteria;Enterobacterales;Enterobacteriaceae;Raoultella;";"88.5";"14.4";"96";"96";"85";"11";"0";"457087";"391122"
"V4mis2";"SILVA (only NR);Bacteria;Proteobacteria;Gammaproteobacteria;Enterobacterales;Enterobacteriaceae;Salmonella;";"97.9";"14.5";"952";"952";"932";"20";"0";"456231";"390275"
"V4mis2";"SILVA (only NR);Bacteria;Proteobacteria;Gammaproteobacteria;Enterobacterales;Enterobacteriaceae;Shimwellia;";"100.0";"14.4";"25";"25";"25";"0";"0";"457158";"391182"
"V4mis2";"SILVA (only NR);Bacteria;Proteobacteria;Gammaproteobacteria;Enterobacterales;Enterobacteriaceae;Trabulsiella;";"100.0";"14.4";"23";"23";"23";"0";"0";"457160";"391184"
"V4mis2";"SILVA (only NR);Bacteria;Proteobacteria;Gammaproteobacteria;Enterobacterales;Enterobacteriaceae;Yokenella;";"100.0";"14.4";"11";"11";"11";"0";"0";"457172";"391196"
"V4mis2";"SILVA (only NR);Bacteria;Proteobacteria;Gammaproteobacteria;Enterobacterales;Erwiniaceae;";"92.6";"14.5";"1233";"1233";"1142";"91";"0";"455950";"390065"
"V4mis2";"SILVA (only NR);Bacteria;Proteobacteria;Gammaproteobacteria;Enterobacterales;Erwiniaceae;Candidatus Stammerula;";"100.0";"14.4";"8";"8";"8";"0";"0";"457175";"391199"
"V4mis2";"SILVA (only NR);Bacteria;Proteobacteria;Gammaproteobacteria;Enterobacterales;Erwiniaceae;Erwinia;";"96.0";"14.4";"200";"200";"192";"8";"0";"456983";"391015"
"V4mis2";"SILVA (only NR);Bacteria;Proteobacteria;Gammaproteobacteria;Enterobacterales;Erwiniaceae;Incertae Sedis;";"75.0";"14.4";"8";"8";"6";"2";"0";"457175";"391201"
"V4mis2";"SILVA (only NR);Bacteria;Proteobacteria;Gammaproteobacteria;Enterobacterales;Erwiniaceae;Izhakiella;";"96.0";"14.4";"25";"25";"24";"1";"0";"457158";"391183"
"V4mis2";"SILVA (only NR);Bacteria;Proteobacteria;Gammaproteobacteria;Enterobacterales;Erwiniaceae;Pantoea;";"92.8";"14.4";"861";"861";"799";"62";"0";"456322";"390408"
"V4mis2";"SILVA (only NR);Bacteria;Proteobacteria;Gammaproteobacteria;Enterobacterales;Erwiniaceae;Phaseolibacter;";"100.0";"14.4";"3";"3";"3";"0";"0";"457180";"391204"
"V4mis2";"SILVA (only NR);Bacteria;Proteobacteria;Gammaproteobacteria;Enterobacterales;Erwiniaceae;Rosenbergiella;";"76.3";"14.4";"38";"38";"29";"9";"0";"457145";"391178"
"V4mis2";"SILVA (only NR);Bacteria;Proteobacteria;Gammaproteobacteria;Enterobacterales;Erwiniaceae;Siccibacter;";"100.0";"14.4";"16";"16";"16";"0";"0";"457167";"391191"
"V4mis2";"SILVA (only NR);Bacteria;Proteobacteria;Gammaproteobacteria;Enterobacterales;Erwiniaceae;Tatumella;";"89.2";"14.4";"37";"37";"33";"4";"0";"457146";"391174"
"V4mis2";"SILVA (only NR);Bacteria;Proteobacteria;Gammaproteobacteria;Enterobacterales;Erwiniaceae;uncultured;";"82.6";"14.4";"23";"23";"19";"4";"0";"457160";"391188"
"V4mis2";"SILVA (only NR);Bacteria;Proteobacteria;Gammaproteobacteria;Enterobacterales;Gallaecimonadaceae;";"100.0";"14.4";"10";"10";"10";"0";"0";"457173";"391197"
"V4mis2";"SILVA (only NR);Bacteria;Proteobacteria;Gammaproteobacteria;Enterobacterales;Gallaecimonadaceae;Gallaecimonas;";"100.0";"14.4";"10";"10";"10";"0";"0";"457173";"391197"
"V4mis2";"SILVA (only NR);Bacteria;Proteobacteria;Gammaproteobacteria;Enterobacterales;Hafniaceae;";"96.5";"14.4";"142";"142";"137";"5";"0";"457041";"391070"
"V4mis2";"SILVA (only NR);Bacteria;Proteobacteria;Gammaproteobacteria;Enterobacterales;Hafniaceae;Edwardsiella;";"95.2";"14.4";"62";"62";"59";"3";"0";"457121";"391148"
"V4mis2";"SILVA (only NR);Bacteria;Proteobacteria;Gammaproteobacteria;Enterobacterales;Hafniaceae;Hafnia-Obesumbacterium;";"97.5";"14.4";"80";"80";"78";"2";"0";"457103";"391129"
"V4mis2";"SILVA (only NR);Bacteria;Proteobacteria;Gammaproteobacteria;Enterobacterales;Idiomarinaceae;";"95.8";"14.4";"240";"240";"230";"10";"0";"456943";"390977"
"V4mis2";"SILVA (only NR);Bacteria;Proteobacteria;Gammaproteobacteria;Enterobacterales;Idiomarinaceae;Aliidiomarina;";"94.3";"14.4";"53";"53";"50";"3";"0";"457130";"391157"
"V4mis2";"SILVA (only NR);Bacteria;Proteobacteria;Gammaproteobacteria;Enterobacterales;Idiomarinaceae;Idiomarina;";"96.2";"14.4";"186";"186";"179";"7";"0";"456997";"391028"
"V4mis2";"SILVA (only NR);Bacteria;Proteobacteria;Gammaproteobacteria;Enterobacterales;JI49D030;";"100.0";"14.4";"2";"2";"2";"0";"0";"457181";"391205"
"V4mis2";"SILVA (only NR);Bacteria;Proteobacteria;Gammaproteobacteria;Enterobacterales;Kangiellaceae;";"94.1";"14.4";"68";"68";"64";"4";"0";"457115";"391143"
"V4mis2";"SILVA (only NR);Bacteria;Proteobacteria;Gammaproteobacteria;Enterobacterales;Kangiellaceae;Aliikangiella;";"94.1";"14.4";"17";"17";"16";"1";"0";"457166";"391191"
"V4mis2";"SILVA (only NR);Bacteria;Proteobacteria;Gammaproteobacteria;Enterobacterales;Kangiellaceae;Kangiella;";"100.0";"14.4";"31";"31";"31";"0";"0";"457152";"391176"
"V4mis2";"SILVA (only NR);Bacteria;Proteobacteria;Gammaproteobacteria;Enterobacterales;Kangiellaceae;Pleionea;";"100.0";"14.4";"4";"4";"4";"0";"0";"457179";"391203"
"V4mis2";"SILVA (only NR);Bacteria;Proteobacteria;Gammaproteobacteria;Enterobacterales;Kangiellaceae;uncultured;";"81.3";"14.4";"16";"16";"13";"3";"0";"457167";"391194"
"V4mis2";"SILVA (only NR);Bacteria;Proteobacteria;Gammaproteobacteria;Enterobacterales;MB19;";"100.0";"14.4";"11";"11";"11";"0";"0";"457172";"391196"
"V4mis2";"SILVA (only NR);Bacteria;Proteobacteria;Gammaproteobacteria;Enterobacterales;Morganellaceae;";"96.0";"14.5";"1368";"1368";"1313";"55";"0";"455815";"389894"
"V4mis2";"SILVA (only NR);Bacteria;Proteobacteria;Gammaproteobacteria;Enterobacterales;Morganellaceae;Arsenophonus;";"99.0";"14.4";"98";"98";"97";"1";"0";"457085";"391110"
"V4mis2";"SILVA (only NR);Bacteria;Proteobacteria;Gammaproteobacteria;Enterobacterales;Morganellaceae;Buchnera;";"100.0";"14.4";"219";"219";"219";"0";"0";"456964";"390988"
"V4mis2";"SILVA (only NR);Bacteria;Proteobacteria;Gammaproteobacteria;Enterobacterales;Morganellaceae;Candidatus Annandia;";"100.0";"14.4";"2";"2";"2";"0";"0";"457181";"391205"
"V4mis2";"SILVA (only NR);Bacteria;Proteobacteria;Gammaproteobacteria;Enterobacterales;Morganellaceae;Candidatus Baumannia;";"95.2";"14.4";"21";"21";"20";"1";"0";"457162";"391187"
"V4mis2";"SILVA (only NR);Bacteria;Proteobacteria;Gammaproteobacteria;Enterobacterales;Morganellaceae;Candidatus Benitsuchiphilus;";"100.0";"14.4";"10";"10";"10";"0";"0";"457173";"391197"
"V4mis2";"SILVA (only NR);Bacteria;Proteobacteria;Gammaproteobacteria;Enterobacterales;Morganellaceae;Candidatus Blochmannia;";"100.0";"14.4";"36";"36";"36";"0";"0";"457147";"391171"
"V4mis2";"SILVA (only NR);Bacteria;Proteobacteria;Gammaproteobacteria;Enterobacterales;Morganellaceae;Candidatus Curculioniphilus;";"100.0";"14.4";"31";"31";"31";"0";"0";"457152";"391176"
"V4mis2";"SILVA (only NR);Bacteria;Proteobacteria;Gammaproteobacteria;Enterobacterales;Morganellaceae;Candidatus Ecksteinia;";"100.0";"14.4";"6";"6";"6";"0";"0";"457177";"391201"
"V4mis2";"SILVA (only NR);Bacteria;Proteobacteria;Gammaproteobacteria;Enterobacterales;Morganellaceae;Candidatus Hamiltonella;";"94.4";"14.4";"18";"18";"17";"1";"0";"457165";"391190"
"V4mis2";"SILVA (only NR);Bacteria;Proteobacteria;Gammaproteobacteria;Enterobacterales;Morganellaceae;Candidatus Hartigia;";"100.0";"14.4";"3";"3";"3";"0";"0";"457180";"391204"
"V4mis2";"SILVA (only NR);Bacteria;Proteobacteria;Gammaproteobacteria;Enterobacterales;Morganellaceae;Candidatus Ishikawaella;";"100.0";"14.4";"5";"5";"5";"0";"0";"457178";"391202"
"V4mis2";"SILVA (only NR);Bacteria;Proteobacteria;Gammaproteobacteria;Enterobacterales;Morganellaceae;Candidatus Kleidoceria;";"100.0";"14.4";"1";"1";"1";"0";"0";"457182";"391206"
"V4mis2";"SILVA (only NR);Bacteria;Proteobacteria;Gammaproteobacteria;Enterobacterales;Morganellaceae;Candidatus Moranella;";"100.0";"14.4";"4";"4";"4";"0";"0";"457179";"391203"
"V4mis2";"SILVA (only NR);Bacteria;Proteobacteria;Gammaproteobacteria;Enterobacterales;Morganellaceae;Candidatus Puchtella;";"100.0";"14.4";"4";"4";"4";"0";"0";"457179";"391203"
"V4mis2";"SILVA (only NR);Bacteria;Proteobacteria;Gammaproteobacteria;Enterobacterales;Morganellaceae;Candidatus Purcelliella;";"100.0";"14.4";"9";"9";"9";"0";"0";"457174";"391198"
"V4mis2";"SILVA (only NR);Bacteria;Proteobacteria;Gammaproteobacteria;Enterobacterales;Morganellaceae;Candidatus Regiella;";"100.0";"14.4";"11";"11";"11";"0";"0";"457172";"391196"
"V4mis2";"SILVA (only NR);Bacteria;Proteobacteria;Gammaproteobacteria;Enterobacterales;Morganellaceae;Candidatus Riesia;";"100.0";"14.4";"6";"6";"6";"0";"0";"457177";"391201"
"V4mis2";"SILVA (only NR);Bacteria;Proteobacteria;Gammaproteobacteria;Enterobacterales;Morganellaceae;Candidatus Rosenkranzia;";"100.0";"14.4";"8";"8";"8";"0";"0";"457175";"391199"
"V4mis2";"SILVA (only NR);Bacteria;Proteobacteria;Gammaproteobacteria;Enterobacterales;Morganellaceae;Candidatus Schneideria;";"100.0";"14.4";"5";"5";"5";"0";"0";"457178";"391202"
"V4mis2";"SILVA (only NR);Bacteria;Proteobacteria;Gammaproteobacteria;Enterobacterales;Morganellaceae;Candidatus Westeberhardia;";"100.0";"14.4";"1";"1";"1";"0";"0";"457182";"391206"
"V4mis2";"SILVA (only NR);Bacteria;Proteobacteria;Gammaproteobacteria;Enterobacterales;Morganellaceae;Cosenzaea;";"100.0";"14.4";"3";"3";"3";"0";"0";"457180";"391204"
"V4mis2";"SILVA (only NR);Bacteria;Proteobacteria;Gammaproteobacteria;Enterobacterales;Morganellaceae;Incertae Sedis;";"100.0";"14.4";"28";"28";"28";"0";"0";"457155";"391179"
"V4mis2";"SILVA (only NR);Bacteria;Proteobacteria;Gammaproteobacteria;Enterobacterales;Morganellaceae;Moellerella;";"100.0";"14.4";"3";"3";"3";"0";"0";"457180";"391204"
"V4mis2";"SILVA (only NR);Bacteria;Proteobacteria;Gammaproteobacteria;Enterobacterales;Morganellaceae;Morganella;";"95.1";"14.4";"123";"123";"117";"6";"0";"457060";"391090"
"V4mis2";"SILVA (only NR);Bacteria;Proteobacteria;Gammaproteobacteria;Enterobacterales;Morganellaceae;Photorhabdus;";"95.8";"14.4";"72";"72";"69";"3";"0";"457111";"391138"
"V4mis2";"SILVA (only NR);Bacteria;Proteobacteria;Gammaproteobacteria;Enterobacterales;Morganellaceae;Proteus;";"93.0";"14.4";"230";"230";"214";"16";"0";"456953";"390993"
"V4mis2";"SILVA (only NR);Bacteria;Proteobacteria;Gammaproteobacteria;Enterobacterales;Morganellaceae;Providencia;";"89.4";"14.4";"189";"189";"169";"20";"0";"456994";"391038"
"V4mis2";"SILVA (only NR);Bacteria;Proteobacteria;Gammaproteobacteria;Enterobacterales;Morganellaceae;Wigglesworthia;";"100.0";"14.4";"4";"4";"4";"0";"0";"457179";"391203"
"V4mis2";"SILVA (only NR);Bacteria;Proteobacteria;Gammaproteobacteria;Enterobacterales;Morganellaceae;Xenorhabdus;";"93.7";"14.4";"95";"95";"89";"6";"0";"457088";"391118"
"V4mis2";"SILVA (only NR);Bacteria;Proteobacteria;Gammaproteobacteria;Enterobacterales;Morganellaceae;endosymbionts;";"98.9";"14.4";"91";"91";"90";"1";"0";"457092";"391117"
"V4mis2";"SILVA (only NR);Bacteria;Proteobacteria;Gammaproteobacteria;Enterobacterales;Morganellaceae;uncultured;";"100.0";"14.4";"13";"13";"13";"0";"0";"457170";"391194"
"V4mis2";"SILVA (only NR);Bacteria;Proteobacteria;Gammaproteobacteria;Enterobacterales;Moritellaceae;";"94.8";"14.4";"58";"58";"55";"3";"0";"457125";"391152"
"V4mis2";"SILVA (only NR);Bacteria;Proteobacteria;Gammaproteobacteria;Enterobacterales;Moritellaceae;Moritella;";"95.5";"14.4";"44";"44";"42";"2";"0";"457139";"391165"
"V4mis2";"SILVA (only NR);Bacteria;Proteobacteria;Gammaproteobacteria;Enterobacterales;Moritellaceae;Paramoritella;";"85.7";"14.4";"7";"7";"6";"1";"0";"457176";"391201"
"V4mis2";"SILVA (only NR);Bacteria;Proteobacteria;Gammaproteobacteria;Enterobacterales;Moritellaceae;uncultured;";"100.0";"14.4";"7";"7";"7";"0";"0";"457176";"391200"
"V4mis2";"SILVA (only NR);Bacteria;Proteobacteria;Gammaproteobacteria;Enterobacterales;Orbaceae;";"90.1";"14.4";"91";"91";"82";"9";"0";"457092";"391125"
"V4mis2";"SILVA (only NR);Bacteria;Proteobacteria;Gammaproteobacteria;Enterobacterales;Orbaceae;Candidatus Schmidhempelia;";"100.0";"14.4";"4";"4";"4";"0";"0";"457179";"391203"
"V4mis2";"SILVA (only NR);Bacteria;Proteobacteria;Gammaproteobacteria;Enterobacterales;Orbaceae;Frischella;";"71.4";"14.4";"7";"7";"5";"2";"0";"457176";"391202"
"V4mis2";"SILVA (only NR);Bacteria;Proteobacteria;Gammaproteobacteria;Enterobacterales;Orbaceae;Gilliamella;";"90.9";"14.4";"66";"66";"60";"6";"0";"457117";"391147"
"V4mis2";"SILVA (only NR);Bacteria;Proteobacteria;Gammaproteobacteria;Enterobacterales;Orbaceae;Orbus;";"100.0";"14.4";"5";"5";"5";"0";"0";"457178";"391202"
"V4mis2";"SILVA (only NR);Bacteria;Proteobacteria;Gammaproteobacteria;Enterobacterales;Orbaceae;uncultured;";"100.0";"14.4";"5";"5";"5";"0";"0";"457178";"391202"
"V4mis2";"SILVA (only NR);Bacteria;Proteobacteria;Gammaproteobacteria;Enterobacterales;Pasteurellaceae;";"94.7";"14.5";"2549";"2549";"2414";"135";"0";"454634";"388793"
"V4mis2";"SILVA (only NR);Bacteria;Proteobacteria;Gammaproteobacteria;Enterobacterales;Pasteurellaceae;Actinobacillus;";"97.5";"14.4";"398";"398";"388";"10";"0";"456785";"390819"
"V4mis2";"SILVA (only NR);Bacteria;Proteobacteria;Gammaproteobacteria;Enterobacterales;Pasteurellaceae;Aggregatibacter;";"93.2";"14.4";"207";"207";"193";"14";"0";"456976";"391014"
"V4mis2";"SILVA (only NR);Bacteria;Proteobacteria;Gammaproteobacteria;Enterobacterales;Pasteurellaceae;Avibacterium;";"96.0";"14.4";"25";"25";"24";"1";"0";"457158";"391183"
"V4mis2";"SILVA (only NR);Bacteria;Proteobacteria;Gammaproteobacteria;Enterobacterales;Pasteurellaceae;Basfia;";"100.0";"14.4";"6";"6";"6";"0";"0";"457177";"391201"
"V4mis2";"SILVA (only NR);Bacteria;Proteobacteria;Gammaproteobacteria;Enterobacterales;Pasteurellaceae;Bibersteinia;";"100.0";"14.4";"21";"21";"21";"0";"0";"457162";"391186"
"V4mis2";"SILVA (only NR);Bacteria;Proteobacteria;Gammaproteobacteria;Enterobacterales;Pasteurellaceae;Bisgaardia;";"100.0";"14.4";"10";"10";"10";"0";"0";"457173";"391197"
"V4mis2";"SILVA (only NR);Bacteria;Proteobacteria;Gammaproteobacteria;Enterobacterales;Pasteurellaceae;Caviibacterium;";"100.0";"14.4";"4";"4";"4";"0";"0";"457179";"391203"
"V4mis2";"SILVA (only NR);Bacteria;Proteobacteria;Gammaproteobacteria;Enterobacterales;Pasteurellaceae;Chelonobacter;";"100.0";"14.4";"4";"4";"4";"0";"0";"457179";"391203"
"V4mis2";"SILVA (only NR);Bacteria;Proteobacteria;Gammaproteobacteria;Enterobacterales;Pasteurellaceae;Conservatibacter;";"100.0";"14.4";"2";"2";"2";"0";"0";"457181";"391205"
"V4mis2";"SILVA (only NR);Bacteria;Proteobacteria;Gammaproteobacteria;Enterobacterales;Pasteurellaceae;Cricetibacter;";"100.0";"14.4";"2";"2";"2";"0";"0";"457181";"391205"
"V4mis2";"SILVA (only NR);Bacteria;Proteobacteria;Gammaproteobacteria;Enterobacterales;Pasteurellaceae;Frederiksenia;";"100.0";"14.4";"11";"11";"11";"0";"0";"457172";"391196"
"V4mis2";"SILVA (only NR);Bacteria;Proteobacteria;Gammaproteobacteria;Enterobacterales;Pasteurellaceae;Gallibacterium;";"97.1";"14.4";"35";"35";"34";"1";"0";"457148";"391173"
"V4mis2";"SILVA (only NR);Bacteria;Proteobacteria;Gammaproteobacteria;Enterobacterales;Pasteurellaceae;Haemophilus;";"92.4";"14.4";"1110";"1110";"1026";"84";"0";"456073";"390181"
"V4mis2";"SILVA (only NR);Bacteria;Proteobacteria;Gammaproteobacteria;Enterobacterales;Pasteurellaceae;Histophilus;";"96.9";"14.4";"32";"32";"31";"1";"0";"457151";"391176"
"V4mis2";"SILVA (only NR);Bacteria;Proteobacteria;Gammaproteobacteria;Enterobacterales;Pasteurellaceae;Lonepinella;";"100.0";"14.4";"3";"3";"3";"0";"0";"457180";"391204"
"V4mis2";"SILVA (only NR);Bacteria;Proteobacteria;Gammaproteobacteria;Enterobacterales;Pasteurellaceae;Mannheimia;";"96.9";"14.4";"65";"65";"63";"2";"0";"457118";"391144"
"V4mis2";"SILVA (only NR);Bacteria;Proteobacteria;Gammaproteobacteria;Enterobacterales;Pasteurellaceae;Mesocricetibacter;";"100.0";"14.4";"4";"4";"4";"0";"0";"457179";"391203"
"V4mis2";"SILVA (only NR);Bacteria;Proteobacteria;Gammaproteobacteria;Enterobacterales;Pasteurellaceae;Muribacter;";"92.6";"14.4";"27";"27";"25";"2";"0";"457156";"391182"
"V4mis2";"SILVA (only NR);Bacteria;Proteobacteria;Gammaproteobacteria;Enterobacterales;Pasteurellaceae;Necropsobacter;";"100.0";"14.4";"4";"4";"4";"0";"0";"457179";"391203"
"V4mis2";"SILVA (only NR);Bacteria;Proteobacteria;Gammaproteobacteria;Enterobacterales;Pasteurellaceae;Nicoletella;";"100.0";"14.4";"17";"17";"17";"0";"0";"457166";"391190"
"V4mis2";"SILVA (only NR);Bacteria;Proteobacteria;Gammaproteobacteria;Enterobacterales;Pasteurellaceae;Otariodibacter;";"95.9";"14.4";"98";"98";"94";"4";"0";"457085";"391113"
"V4mis2";"SILVA (only NR);Bacteria;Proteobacteria;Gammaproteobacteria;Enterobacterales;Pasteurellaceae;Pasteurella;";"98.2";"14.4";"114";"114";"112";"2";"0";"457069";"391095"
"V4mis2";"SILVA (only NR);Bacteria;Proteobacteria;Gammaproteobacteria;Enterobacterales;Pasteurellaceae;Phocoenobacter;";"99.3";"14.4";"141";"141";"140";"1";"0";"457042";"391067"
"V4mis2";"SILVA (only NR);Bacteria;Proteobacteria;Gammaproteobacteria;Enterobacterales;Pasteurellaceae;Rodentibacter;";"91.5";"14.4";"117";"117";"107";"10";"0";"457066";"391100"
"V4mis2";"SILVA (only NR);Bacteria;Proteobacteria;Gammaproteobacteria;Enterobacterales;Pasteurellaceae;Seminibacterium;";"100.0";"14.4";"1";"1";"1";"0";"0";"457182";"391206"
"V4mis2";"SILVA (only NR);Bacteria;Proteobacteria;Gammaproteobacteria;Enterobacterales;Pasteurellaceae;Testudinibacter;";"100.0";"14.4";"3";"3";"3";"0";"0";"457180";"391204"
"V4mis2";"SILVA (only NR);Bacteria;Proteobacteria;Gammaproteobacteria;Enterobacterales;Pasteurellaceae;Ursidibacter;";"100.0";"14.4";"6";"6";"6";"0";"0";"457177";"391201"
"V4mis2";"SILVA (only NR);Bacteria;Proteobacteria;Gammaproteobacteria;Enterobacterales;Pasteurellaceae;Vespertiliibacter;";"100.0";"14.4";"2";"2";"2";"0";"0";"457181";"391205"
"V4mis2";"SILVA (only NR);Bacteria;Proteobacteria;Gammaproteobacteria;Enterobacterales;Pasteurellaceae;Volucribacter;";"100.0";"14.4";"5";"5";"5";"0";"0";"457178";"391202"
"V4mis2";"SILVA (only NR);Bacteria;Proteobacteria;Gammaproteobacteria;Enterobacterales;Pasteurellaceae;uncultured;";"95.2";"14.4";"62";"62";"59";"3";"0";"457121";"391148"
"V4mis2";"SILVA (only NR);Bacteria;Proteobacteria;Gammaproteobacteria;Enterobacterales;Pectobacteriaceae;";"97.2";"14.4";"433";"433";"421";"12";"0";"456750";"390786"
"V4mis2";"SILVA (only NR);Bacteria;Proteobacteria;Gammaproteobacteria;Enterobacterales;Pectobacteriaceae;Biostraticola;";"100.0";"14.4";"1";"1";"1";"0";"0";"457182";"391206"
"V4mis2";"SILVA (only NR);Bacteria;Proteobacteria;Gammaproteobacteria;Enterobacterales;Pectobacteriaceae;Brenneria;";"100.0";"14.4";"25";"25";"25";"0";"0";"457158";"391182"
"V4mis2";"SILVA (only NR);Bacteria;Proteobacteria;Gammaproteobacteria;Enterobacterales;Pectobacteriaceae;Dickeya;";"95.1";"14.4";"122";"122";"116";"6";"0";"457061";"391091"
"V4mis2";"SILVA (only NR);Bacteria;Proteobacteria;Gammaproteobacteria;Enterobacterales;Pectobacteriaceae;Lonsdalea;";"100.0";"14.4";"16";"16";"16";"0";"0";"457167";"391191"
"V4mis2";"SILVA (only NR);Bacteria;Proteobacteria;Gammaproteobacteria;Enterobacterales;Pectobacteriaceae;Nissabacter;";"100.0";"14.4";"2";"2";"2";"0";"0";"457181";"391205"
"V4mis2";"SILVA (only NR);Bacteria;Proteobacteria;Gammaproteobacteria;Enterobacterales;Pectobacteriaceae;Pectobacterium;";"97.3";"14.4";"183";"183";"178";"5";"0";"457000";"391029"
"V4mis2";"SILVA (only NR);Bacteria;Proteobacteria;Gammaproteobacteria;Enterobacterales;Pectobacteriaceae;Sodalis;";"98.7";"14.4";"79";"79";"78";"1";"0";"457104";"391129"
"V4mis2";"SILVA (only NR);Bacteria;Proteobacteria;Gammaproteobacteria;Enterobacterales;Pectobacteriaceae;uncultured;";"100.0";"14.4";"5";"5";"5";"0";"0";"457178";"391202"
"V4mis2";"SILVA (only NR);Bacteria;Proteobacteria;Gammaproteobacteria;Enterobacterales;Pseudoalteromonadaceae;";"94.4";"14.4";"892";"892";"842";"50";"0";"456291";"390365"
"V4mis2";"SILVA (only NR);Bacteria;Proteobacteria;Gammaproteobacteria;Enterobacterales;Pseudoalteromonadaceae;Algicola;";"92.9";"14.4";"14";"14";"13";"1";"0";"457169";"391194"
"V4mis2";"SILVA (only NR);Bacteria;Proteobacteria;Gammaproteobacteria;Enterobacterales;Pseudoalteromonadaceae;Pseudoalteromonas;";"94.3";"14.4";"861";"861";"812";"49";"0";"456322";"390395"
"V4mis2";"SILVA (only NR);Bacteria;Proteobacteria;Gammaproteobacteria;Enterobacterales;Pseudoalteromonadaceae;Psychrosphaera;";"100.0";"14.4";"8";"8";"8";"0";"0";"457175";"391199"
"V4mis2";"SILVA (only NR);Bacteria;Proteobacteria;Gammaproteobacteria;Enterobacterales;Pseudoalteromonadaceae;uncultured;";"100.0";"14.4";"8";"8";"8";"0";"0";"457175";"391199"
"V4mis2";"SILVA (only NR);Bacteria;Proteobacteria;Gammaproteobacteria;Enterobacterales;Psychromonadaceae;";"94.0";"14.4";"116";"116";"109";"7";"0";"457067";"391098"
"V4mis2";"SILVA (only NR);Bacteria;Proteobacteria;Gammaproteobacteria;Enterobacterales;Psychromonadaceae;Agarivorans;";"94.1";"14.4";"34";"34";"32";"2";"0";"457149";"391175"
"V4mis2";"SILVA (only NR);Bacteria;Proteobacteria;Gammaproteobacteria;Enterobacterales;Psychromonadaceae;Aliagarivorans;";"100.0";"14.4";"2";"2";"2";"0";"0";"457181";"391205"
"V4mis2";"SILVA (only NR);Bacteria;Proteobacteria;Gammaproteobacteria;Enterobacterales;Psychromonadaceae;Motilimonas;";"100.0";"14.4";"4";"4";"4";"0";"0";"457179";"391203"
"V4mis2";"SILVA (only NR);Bacteria;Proteobacteria;Gammaproteobacteria;Enterobacterales;Psychromonadaceae;Psychromonas;";"93.2";"14.4";"74";"74";"69";"5";"0";"457109";"391138"
"V4mis2";"SILVA (only NR);Bacteria;Proteobacteria;Gammaproteobacteria;Enterobacterales;Shewanellaceae;";"95.6";"14.4";"702";"702";"671";"31";"0";"456481";"390536"
"V4mis2";"SILVA (only NR);Bacteria;Proteobacteria;Gammaproteobacteria;Enterobacterales;Shewanellaceae;Ferrimonas;";"94.7";"14.4";"38";"38";"36";"2";"0";"457145";"391171"
"V4mis2";"SILVA (only NR);Bacteria;Proteobacteria;Gammaproteobacteria;Enterobacterales;Shewanellaceae;Psychrobium;";"90.9";"14.4";"11";"11";"10";"1";"0";"457172";"391197"
"V4mis2";"SILVA (only NR);Bacteria;Proteobacteria;Gammaproteobacteria;Enterobacterales;Shewanellaceae;Shewanella;";"95.7";"14.4";"653";"653";"625";"28";"0";"456530";"390582"
"V4mis2";"SILVA (only NR);Bacteria;Proteobacteria;Gammaproteobacteria;Enterobacterales;Succinivibrionaceae;";"90.4";"14.4";"281";"281";"254";"27";"0";"456902";"390953"
"V4mis2";"SILVA (only NR);Bacteria;Proteobacteria;Gammaproteobacteria;Enterobacterales;Succinivibrionaceae;Anaerobiospirillum;";"94.7";"14.4";"19";"19";"18";"1";"0";"457164";"391189"
"V4mis2";"SILVA (only NR);Bacteria;Proteobacteria;Gammaproteobacteria;Enterobacterales;Succinivibrionaceae;Ruminobacter;";"87.2";"14.4";"47";"47";"41";"6";"0";"457136";"391166"
"V4mis2";"SILVA (only NR);Bacteria;Proteobacteria;Gammaproteobacteria;Enterobacterales;Succinivibrionaceae;Succinatimonas;";"100.0";"14.4";"9";"9";"9";"0";"0";"457174";"391198"
"V4mis2";"SILVA (only NR);Bacteria;Proteobacteria;Gammaproteobacteria;Enterobacterales;Succinivibrionaceae;Succinimonas;";"91.7";"14.4";"12";"12";"11";"1";"0";"457171";"391196"
"V4mis2";"SILVA (only NR);Bacteria;Proteobacteria;Gammaproteobacteria;Enterobacterales;Succinivibrionaceae;Succinivibrio;";"91.5";"14.4";"141";"141";"129";"12";"0";"457042";"391078"
"V4mis2";"SILVA (only NR);Bacteria;Proteobacteria;Gammaproteobacteria;Enterobacterales;Succinivibrionaceae;Succinivibrionaceae UCG-001;";"81.3";"14.4";"32";"32";"26";"6";"0";"457151";"391181"
"V4mis2";"SILVA (only NR);Bacteria;Proteobacteria;Gammaproteobacteria;Enterobacterales;Succinivibrionaceae;Succinivibrionaceae UCG-002;";"90.9";"14.4";"11";"11";"10";"1";"0";"457172";"391197"
"V4mis2";"SILVA (only NR);Bacteria;Proteobacteria;Gammaproteobacteria;Enterobacterales;Succinivibrionaceae;uncultured;";"100.0";"14.4";"10";"10";"10";"0";"0";"457173";"391197"
"V4mis2";"SILVA (only NR);Bacteria;Proteobacteria;Gammaproteobacteria;Enterobacterales;Thorselliaceae;";"100.0";"14.4";"4";"4";"4";"0";"0";"457179";"391203"
"V4mis2";"SILVA (only NR);Bacteria;Proteobacteria;Gammaproteobacteria;Enterobacterales;Thorselliaceae;Coetzeea;";"100.0";"14.4";"1";"1";"1";"0";"0";"457182";"391206"
"V4mis2";"SILVA (only NR);Bacteria;Proteobacteria;Gammaproteobacteria;Enterobacterales;Thorselliaceae;Thorsellia;";"100.0";"14.4";"3";"3";"3";"0";"0";"457180";"391204"
"V4mis2";"SILVA (only NR);Bacteria;Proteobacteria;Gammaproteobacteria;Enterobacterales;Vibrionaceae;";"95.6";"14.5";"2885";"2885";"2757";"128";"0";"454298";"388450"
"V4mis2";"SILVA (only NR);Bacteria;Proteobacteria;Gammaproteobacteria;Enterobacterales;Vibrionaceae;Aliivibrio;";"98.8";"14.4";"81";"81";"80";"1";"0";"457102";"391127"
"V4mis2";"SILVA (only NR);Bacteria;Proteobacteria;Gammaproteobacteria;Enterobacterales;Vibrionaceae;Candidatus Photodesmus;";"100.0";"14.4";"3";"3";"3";"0";"0";"457180";"391204"
"V4mis2";"SILVA (only NR);Bacteria;Proteobacteria;Gammaproteobacteria;Enterobacterales;Vibrionaceae;Catenococcus;";"100.0";"14.4";"12";"12";"12";"0";"0";"457171";"391195"
"V4mis2";"SILVA (only NR);Bacteria;Proteobacteria;Gammaproteobacteria;Enterobacterales;Vibrionaceae;Enterovibrio;";"100.0";"14.4";"26";"26";"26";"0";"0";"457157";"391181"
"V4mis2";"SILVA (only NR);Bacteria;Proteobacteria;Gammaproteobacteria;Enterobacterales;Vibrionaceae;Grimontia;";"100.0";"14.4";"24";"24";"24";"0";"0";"457159";"391183"
"V4mis2";"SILVA (only NR);Bacteria;Proteobacteria;Gammaproteobacteria;Enterobacterales;Vibrionaceae;Photobacterium;";"96.6";"14.4";"320";"320";"309";"11";"0";"456863";"390898"
"V4mis2";"SILVA (only NR);Bacteria;Proteobacteria;Gammaproteobacteria;Enterobacterales;Vibrionaceae;Salinivibrio;";"92.9";"14.4";"98";"98";"91";"7";"0";"457085";"391116"
"V4mis2";"SILVA (only NR);Bacteria;Proteobacteria;Gammaproteobacteria;Enterobacterales;Vibrionaceae;Thaumasiovibrio;";"100.0";"14.4";"16";"16";"16";"0";"0";"457167";"391191"
"V4mis2";"SILVA (only NR);Bacteria;Proteobacteria;Gammaproteobacteria;Enterobacterales;Vibrionaceae;Vibrio;";"95.3";"14.5";"2295";"2295";"2187";"108";"0";"454888";"389020"
"V4mis2";"SILVA (only NR);Bacteria;Proteobacteria;Gammaproteobacteria;Enterobacterales;Vibrionaceae;uncultured;";"100.0";"14.4";"7";"7";"7";"0";"0";"457176";"391200"
"V4mis2";"SILVA (only NR);Bacteria;Proteobacteria;Gammaproteobacteria;Enterobacterales;Yersiniaceae;";"94.2";"14.5";"1212";"1212";"1142";"70";"0";"455971";"390065"
"V4mis2";"SILVA (only NR);Bacteria;Proteobacteria;Gammaproteobacteria;Enterobacterales;Yersiniaceae;Chania;";"100.0";"14.4";"1";"1";"1";"0";"0";"457182";"391206"
"V4mis2";"SILVA (only NR);Bacteria;Proteobacteria;Gammaproteobacteria;Enterobacterales;Yersiniaceae;Gibbsiella;";"92.3";"14.4";"13";"13";"12";"1";"0";"457170";"391195"
"V4mis2";"SILVA (only NR);Bacteria;Proteobacteria;Gammaproteobacteria;Enterobacterales;Yersiniaceae;Rahnella1;";"86.9";"14.4";"61";"61";"53";"8";"0";"457122";"391154"
"V4mis2";"SILVA (only NR);Bacteria;Proteobacteria;Gammaproteobacteria;Enterobacterales;Yersiniaceae;Rahnella;";"100.0";"14.4";"1";"1";"1";"0";"0";"457182";"391206"
"V4mis2";"SILVA (only NR);Bacteria;Proteobacteria;Gammaproteobacteria;Enterobacterales;Yersiniaceae;Samsonia;";"100.0";"14.4";"1";"1";"1";"0";"0";"457182";"391206"
"V4mis2";"SILVA (only NR);Bacteria;Proteobacteria;Gammaproteobacteria;Enterobacterales;Yersiniaceae;Serratia;";"93.6";"14.4";"935";"935";"875";"60";"0";"456248";"390332"
"V4mis2";"SILVA (only NR);Bacteria;Proteobacteria;Gammaproteobacteria;Enterobacterales;Yersiniaceae;Yersinia;";"99.5";"14.4";"200";"200";"199";"1";"0";"456983";"391008"
"V4mis2";"SILVA (only NR);Bacteria;Proteobacteria;Gammaproteobacteria;Enterobacterales;uncultured;";"93.3";"14.4";"15";"15";"14";"1";"0";"457168";"391193"
"V4mis2";"SILVA (only NR);Bacteria;Proteobacteria;Gammaproteobacteria;F9P41300-M23;";"100.0";"14.4";"3";"3";"3";"0";"0";"457180";"391204"
"V4mis2";"SILVA (only NR);Bacteria;Proteobacteria;Gammaproteobacteria;FGL7S;";"100.0";"14.4";"5";"5";"5";"0";"0";"457178";"391202"
"V4mis2";"SILVA (only NR);Bacteria;Proteobacteria;Gammaproteobacteria;Francisellales;";"97.3";"14.4";"149";"149";"145";"4";"0";"457034";"391062"
"V4mis2";"SILVA (only NR);Bacteria;Proteobacteria;Gammaproteobacteria;Francisellales;Francisellaceae;";"97.3";"14.4";"149";"149";"145";"4";"0";"457034";"391062"
"V4mis2";"SILVA (only NR);Bacteria;Proteobacteria;Gammaproteobacteria;Francisellales;Francisellaceae;Allofrancisella;";"100.0";"14.4";"5";"5";"5";"0";"0";"457178";"391202"
"V4mis2";"SILVA (only NR);Bacteria;Proteobacteria;Gammaproteobacteria;Francisellales;Francisellaceae;Fangia;";"100.0";"14.4";"2";"2";"2";"0";"0";"457181";"391205"
"V4mis2";"SILVA (only NR);Bacteria;Proteobacteria;Gammaproteobacteria;Francisellales;Francisellaceae;Francisella;";"99.1";"14.4";"112";"112";"111";"1";"0";"457071";"391096"
"V4mis2";"SILVA (only NR);Bacteria;Proteobacteria;Gammaproteobacteria;Francisellales;Francisellaceae;[Caedibacter] taeniospiralis group;";"80.0";"14.4";"10";"10";"8";"2";"0";"457173";"391199"
"V4mis2";"SILVA (only NR);Bacteria;Proteobacteria;Gammaproteobacteria;Francisellales;Francisellaceae;uncultured;";"94.7";"14.4";"19";"19";"18";"1";"0";"457164";"391189"
"V4mis2";"SILVA (only NR);Bacteria;Proteobacteria;Gammaproteobacteria;GB102;";"100.0";"14.4";"2";"2";"2";"0";"0";"457181";"391205"
"V4mis2";"SILVA (only NR);Bacteria;Proteobacteria;Gammaproteobacteria;Ga0077536;";"97.5";"14.4";"80";"80";"78";"2";"0";"457103";"391129"
"V4mis2";"SILVA (only NR);Bacteria;Proteobacteria;Gammaproteobacteria;Gammaproteobacteria Incertae Sedis;";"95.3";"14.4";"805";"805";"767";"38";"0";"456378";"390440"
"V4mis2";"SILVA (only NR);Bacteria;Proteobacteria;Gammaproteobacteria;Gammaproteobacteria Incertae Sedis;Unknown Family;";"95.3";"14.4";"805";"805";"767";"38";"0";"456378";"390440"
"V4mis2";"SILVA (only NR);Bacteria;Proteobacteria;Gammaproteobacteria;Gammaproteobacteria Incertae Sedis;Unknown Family;Acidibacter;";"93.6";"14.4";"188";"188";"176";"12";"0";"456995";"391031"
"V4mis2";"SILVA (only NR);Bacteria;Proteobacteria;Gammaproteobacteria;Gammaproteobacteria Incertae Sedis;Unknown Family;Candidatus Berkiella;";"100.0";"14.4";"52";"52";"52";"0";"0";"457131";"391155"
"V4mis2";"SILVA (only NR);Bacteria;Proteobacteria;Gammaproteobacteria;Gammaproteobacteria Incertae Sedis;Unknown Family;Candidatus Carsonella;";"97.0";"14.4";"33";"33";"32";"1";"0";"457150";"391175"
"V4mis2";"SILVA (only NR);Bacteria;Proteobacteria;Gammaproteobacteria;Gammaproteobacteria Incertae Sedis;Unknown Family;Candidatus Endonucleariobacter;";"100.0";"14.4";"3";"3";"3";"0";"0";"457180";"391204"
"V4mis2";"SILVA (only NR);Bacteria;Proteobacteria;Gammaproteobacteria;Gammaproteobacteria Incertae Sedis;Unknown Family;Candidatus Ovatusbacter;";"97.3";"14.4";"37";"37";"36";"1";"0";"457146";"391171"
"V4mis2";"SILVA (only NR);Bacteria;Proteobacteria;Gammaproteobacteria;Gammaproteobacteria Incertae Sedis;Unknown Family;Endothiovibrio;";"100.0";"14.4";"3";"3";"3";"0";"0";"457180";"391204"
"V4mis2";"SILVA (only NR);Bacteria;Proteobacteria;Gammaproteobacteria;Gammaproteobacteria Incertae Sedis;Unknown Family;Marinicella;";"94.5";"14.4";"55";"55";"52";"3";"0";"457128";"391155"
"V4mis2";"SILVA (only NR);Bacteria;Proteobacteria;Gammaproteobacteria;Gammaproteobacteria Incertae Sedis;Unknown Family;Sulfuriflexus;";"100.0";"14.4";"2";"2";"2";"0";"0";"457181";"391205"
"V4mis2";"SILVA (only NR);Bacteria;Proteobacteria;Gammaproteobacteria;Gammaproteobacteria Incertae Sedis;Unknown Family;Wenzhouxiangella;";"95.8";"14.4";"24";"24";"23";"1";"0";"457159";"391184"
"V4mis2";"SILVA (only NR);Bacteria;Proteobacteria;Gammaproteobacteria;Gammaproteobacteria Incertae Sedis;Unknown Family;uncultured;";"94.8";"14.4";"347";"347";"329";"18";"0";"456836";"390878"
"V4mis2";"SILVA (only NR);Bacteria;Proteobacteria;Gammaproteobacteria;Granulosicoccales;";"100.0";"14.4";"61";"61";"61";"0";"0";"457122";"391146"
"V4mis2";"SILVA (only NR);Bacteria;Proteobacteria;Gammaproteobacteria;Granulosicoccales;Granulosicoccaceae;";"100.0";"14.4";"39";"39";"39";"0";"0";"457144";"391168"
"V4mis2";"SILVA (only NR);Bacteria;Proteobacteria;Gammaproteobacteria;Granulosicoccales;Granulosicoccaceae;Granulosicoccus;";"100.0";"14.4";"39";"39";"39";"0";"0";"457144";"391168"
"V4mis2";"SILVA (only NR);Bacteria;Proteobacteria;Gammaproteobacteria;Granulosicoccales;Methylohalomonas;";"100.0";"14.4";"6";"6";"6";"0";"0";"457177";"391201"
"V4mis2";"SILVA (only NR);Bacteria;Proteobacteria;Gammaproteobacteria;Granulosicoccales;uncultured;";"100.0";"14.4";"16";"16";"16";"0";"0";"457167";"391191"
"V4mis2";"SILVA (only NR);Bacteria;Proteobacteria;Gammaproteobacteria;HOC36;";"87.1";"14.4";"147";"147";"128";"19";"0";"457036";"391079"
"V4mis2";"SILVA (only NR);Bacteria;Proteobacteria;Gammaproteobacteria;Halothiobacillales;";"91.5";"14.4";"165";"165";"151";"14";"0";"457018";"391056"
"V4mis2";"SILVA (only NR);Bacteria;Proteobacteria;Gammaproteobacteria;Halothiobacillales;Halothiobacillaceae;";"90.8";"14.4";"142";"142";"129";"13";"0";"457041";"391078"
"V4mis2";"SILVA (only NR);Bacteria;Proteobacteria;Gammaproteobacteria;Halothiobacillales;Halothiobacillaceae;Halothiobacillus;";"90.9";"14.4";"33";"33";"30";"3";"0";"457150";"391177"
"V4mis2";"SILVA (only NR);Bacteria;Proteobacteria;Gammaproteobacteria;Halothiobacillales;Halothiobacillaceae;Thiofaba;";"95.5";"14.4";"22";"22";"21";"1";"0";"457161";"391186"
"V4mis2";"SILVA (only NR);Bacteria;Proteobacteria;Gammaproteobacteria;Halothiobacillales;Halothiobacillaceae;Thiovirga;";"80.9";"14.4";"47";"47";"38";"9";"0";"457136";"391169"
"V4mis2";"SILVA (only NR);Bacteria;Proteobacteria;Gammaproteobacteria;Halothiobacillales;Halothiobacillaceae;uncultured;";"100.0";"14.4";"40";"40";"40";"0";"0";"457143";"391167"
"V4mis2";"SILVA (only NR);Bacteria;Proteobacteria;Gammaproteobacteria;Halothiobacillales;Thioalkalibacteraceae;";"95.7";"14.4";"23";"23";"22";"1";"0";"457160";"391185"
"V4mis2";"SILVA (only NR);Bacteria;Proteobacteria;Gammaproteobacteria;Halothiobacillales;Thioalkalibacteraceae;Guyparkeria;";"95.0";"14.4";"20";"20";"19";"1";"0";"457163";"391188"
"V4mis2";"SILVA (only NR);Bacteria;Proteobacteria;Gammaproteobacteria;Halothiobacillales;Thioalkalibacteraceae;Thioalkalibacter;";"100.0";"14.4";"3";"3";"3";"0";"0";"457180";"391204"
"V4mis2";"SILVA (only NR);Bacteria;Proteobacteria;Gammaproteobacteria;HgCo23;";"100.0";"14.4";"6";"6";"6";"0";"0";"457177";"391201"
"V4mis2";"SILVA (only NR);Bacteria;Proteobacteria;Gammaproteobacteria;HglApr721;";"100.0";"14.4";"5";"5";"5";"0";"0";"457178";"391202"
"V4mis2";"SILVA (only NR);Bacteria;Proteobacteria;Gammaproteobacteria;I3A;";"100.0";"14.4";"8";"8";"8";"0";"0";"457175";"391199"
"V4mis2";"SILVA (only NR);Bacteria;Proteobacteria;Gammaproteobacteria;Immundisolibacterales;";"95.7";"14.4";"70";"70";"67";"3";"0";"457113";"391140"
"V4mis2";"SILVA (only NR);Bacteria;Proteobacteria;Gammaproteobacteria;Immundisolibacterales;Immundisolibacteraceae;";"95.7";"14.4";"70";"70";"67";"3";"0";"457113";"391140"
"V4mis2";"SILVA (only NR);Bacteria;Proteobacteria;Gammaproteobacteria;Immundisolibacterales;Immundisolibacteraceae;Immundisolibacter;";"97.6";"14.4";"41";"41";"40";"1";"0";"457142";"391167"
"V4mis2";"SILVA (only NR);Bacteria;Proteobacteria;Gammaproteobacteria;Immundisolibacterales;Immundisolibacteraceae;uncultured;";"96.3";"14.4";"27";"27";"26";"1";"0";"457156";"391181"
"V4mis2";"SILVA (only NR);Bacteria;Proteobacteria;Gammaproteobacteria;JG36-GS-52;";"100.0";"14.4";"13";"13";"13";"0";"0";"457170";"391194"
"V4mis2";"SILVA (only NR);Bacteria;Proteobacteria;Gammaproteobacteria;JG36-TzT-191;";"96.0";"14.4";"25";"25";"24";"1";"0";"457158";"391183"
"V4mis2";"SILVA (only NR);Bacteria;Proteobacteria;Gammaproteobacteria;JTB23;";"96.5";"14.4";"86";"86";"83";"3";"0";"457097";"391124"
"V4mis2";"SILVA (only NR);Bacteria;Proteobacteria;Gammaproteobacteria;KF-JG30-C25;";"100.0";"14.4";"41";"41";"41";"0";"0";"457142";"391166"
"V4mis2";"SILVA (only NR);Bacteria;Proteobacteria;Gammaproteobacteria;Legionellales;";"97.1";"14.4";"628";"628";"610";"18";"0";"456555";"390597"
"V4mis2";"SILVA (only NR);Bacteria;Proteobacteria;Gammaproteobacteria;Legionellales;Legionellaceae;";"97.1";"14.4";"628";"628";"610";"18";"0";"456555";"390597"
"V4mis2";"SILVA (only NR);Bacteria;Proteobacteria;Gammaproteobacteria;Legionellales;Legionellaceae;Legionella;";"97.5";"14.4";"566";"566";"552";"14";"0";"456617";"390655"
"V4mis2";"SILVA (only NR);Bacteria;Proteobacteria;Gammaproteobacteria;Legionellales;Legionellaceae;uncultured;";"93.4";"14.4";"61";"61";"57";"4";"0";"457122";"391150"
"V4mis2";"SILVA (only NR);Bacteria;Proteobacteria;Gammaproteobacteria;MBMPE27;";"95.6";"14.4";"45";"45";"43";"2";"0";"457138";"391164"
"V4mis2";"SILVA (only NR);Bacteria;Proteobacteria;Gammaproteobacteria;MD2904-B13;";"100.0";"14.4";"8";"8";"8";"0";"0";"457175";"391199"
"V4mis2";"SILVA (only NR);Bacteria;Proteobacteria;Gammaproteobacteria;Methylococcales;";"95.6";"14.4";"675";"675";"645";"30";"0";"456508";"390562"
"V4mis2";"SILVA (only NR);Bacteria;Proteobacteria;Gammaproteobacteria;Methylococcales;Cycloclasticaceae;";"96.4";"14.4";"28";"28";"27";"1";"0";"457155";"391180"
"V4mis2";"SILVA (only NR);Bacteria;Proteobacteria;Gammaproteobacteria;Methylococcales;Cycloclasticaceae;Cycloclasticus;";"96.4";"14.4";"28";"28";"27";"1";"0";"457155";"391180"
"V4mis2";"SILVA (only NR);Bacteria;Proteobacteria;Gammaproteobacteria;Methylococcales;Methylococcaceae;";"94.4";"14.4";"107";"107";"101";"6";"0";"457076";"391106"
"V4mis2";"SILVA (only NR);Bacteria;Proteobacteria;Gammaproteobacteria;Methylococcales;Methylococcaceae;Candidatus Methylospira;";"100.0";"14.4";"6";"6";"6";"0";"0";"457177";"391201"
"V4mis2";"SILVA (only NR);Bacteria;Proteobacteria;Gammaproteobacteria;Methylococcales;Methylococcaceae;Methylocaldum;";"90.0";"14.4";"20";"20";"18";"2";"0";"457163";"391189"
"V4mis2";"SILVA (only NR);Bacteria;Proteobacteria;Gammaproteobacteria;Methylococcales;Methylococcaceae;Methylococcus;";"94.4";"14.4";"18";"18";"17";"1";"0";"457165";"391190"
"V4mis2";"SILVA (only NR);Bacteria;Proteobacteria;Gammaproteobacteria;Methylococcales;Methylococcaceae;Methylogaea;";"100.0";"14.4";"1";"1";"1";"0";"0";"457182";"391206"
"V4mis2";"SILVA (only NR);Bacteria;Proteobacteria;Gammaproteobacteria;Methylococcales;Methylococcaceae;Methylomagnum;";"100.0";"14.4";"4";"4";"4";"0";"0";"457179";"391203"
"V4mis2";"SILVA (only NR);Bacteria;Proteobacteria;Gammaproteobacteria;Methylococcales;Methylococcaceae;Methyloparacoccus;";"92.9";"14.4";"14";"14";"13";"1";"0";"457169";"391194"
"V4mis2";"SILVA (only NR);Bacteria;Proteobacteria;Gammaproteobacteria;Methylococcales;Methylococcaceae;Methyloterricola;";"100.0";"14.4";"1";"1";"1";"0";"0";"457182";"391206"
"V4mis2";"SILVA (only NR);Bacteria;Proteobacteria;Gammaproteobacteria;Methylococcales;Methylococcaceae;uncultured;";"97.1";"14.4";"35";"35";"34";"1";"0";"457148";"391173"
"V4mis2";"SILVA (only NR);Bacteria;Proteobacteria;Gammaproteobacteria;Methylococcales;Methylohalobiaceae;";"91.7";"14.4";"12";"12";"11";"1";"0";"457171";"391196"
"V4mis2";"SILVA (only NR);Bacteria;Proteobacteria;Gammaproteobacteria;Methylococcales;Methylohalobiaceae;Methylohalobius;";"100.0";"14.4";"4";"4";"4";"0";"0";"457179";"391203"
"V4mis2";"SILVA (only NR);Bacteria;Proteobacteria;Gammaproteobacteria;Methylococcales;Methylohalobiaceae;Methylomarinovum;";"66.7";"14.4";"3";"3";"2";"1";"0";"457180";"391205"
"V4mis2";"SILVA (only NR);Bacteria;Proteobacteria;Gammaproteobacteria;Methylococcales;Methylohalobiaceae;Methylothermus;";"100.0";"14.4";"5";"5";"5";"0";"0";"457178";"391202"
"V4mis2";"SILVA (only NR);Bacteria;Proteobacteria;Gammaproteobacteria;Methylococcales;Methylomonadaceae;";"95.8";"14.4";"528";"528";"506";"22";"0";"456655";"390701"
"V4mis2";"SILVA (only NR);Bacteria;Proteobacteria;Gammaproteobacteria;Methylococcales;Methylomonadaceae;Crenothrix;";"96.9";"14.4";"64";"64";"62";"2";"0";"457119";"391145"
"V4mis2";"SILVA (only NR);Bacteria;Proteobacteria;Gammaproteobacteria;Methylococcales;Methylomonadaceae;ET-SHO;";"100.0";"14.4";"7";"7";"7";"0";"0";"457176";"391200"
"V4mis2";"SILVA (only NR);Bacteria;Proteobacteria;Gammaproteobacteria;Methylococcales;Methylomonadaceae;IheB2-23;";"84.2";"14.4";"19";"19";"16";"3";"0";"457164";"391191"
"V4mis2";"SILVA (only NR);Bacteria;Proteobacteria;Gammaproteobacteria;Methylococcales;Methylomonadaceae;Marine Methylotrophic Group 2;";"95.8";"14.4";"71";"71";"68";"3";"0";"457112";"391139"
"V4mis2";"SILVA (only NR);Bacteria;Proteobacteria;Gammaproteobacteria;Methylococcales;Methylomonadaceae;Methylobacter;";"96.4";"14.4";"55";"55";"53";"2";"0";"457128";"391154"
"V4mis2";"SILVA (only NR);Bacteria;Proteobacteria;Gammaproteobacteria;Methylococcales;Methylomonadaceae;Methyloglobulus;";"92.3";"14.4";"13";"13";"12";"1";"0";"457170";"391195"
"V4mis2";"SILVA (only NR);Bacteria;Proteobacteria;Gammaproteobacteria;Methylococcales;Methylomonadaceae;Methylomarinum;";"88.9";"14.4";"9";"9";"8";"1";"0";"457174";"391199"
"V4mis2";"SILVA (only NR);Bacteria;Proteobacteria;Gammaproteobacteria;Methylococcales;Methylomonadaceae;Methylomicrobium;";"96.8";"14.4";"31";"31";"30";"1";"0";"457152";"391177"
"V4mis2";"SILVA (only NR);Bacteria;Proteobacteria;Gammaproteobacteria;Methylococcales;Methylomonadaceae;Methylomonas;";"97.6";"14.4";"83";"83";"81";"2";"0";"457100";"391126"
"V4mis2";"SILVA (only NR);Bacteria;Proteobacteria;Gammaproteobacteria;Methylococcales;Methylomonadaceae;Methyloprofundus;";"96.4";"14.4";"55";"55";"53";"2";"0";"457128";"391154"
"V4mis2";"SILVA (only NR);Bacteria;Proteobacteria;Gammaproteobacteria;Methylococcales;Methylomonadaceae;Methylosarcina;";"100.0";"14.4";"9";"9";"9";"0";"0";"457174";"391198"
"V4mis2";"SILVA (only NR);Bacteria;Proteobacteria;Gammaproteobacteria;Methylococcales;Methylomonadaceae;Methylosoma;";"100.0";"14.4";"1";"1";"1";"0";"0";"457182";"391206"
"V4mis2";"SILVA (only NR);Bacteria;Proteobacteria;Gammaproteobacteria;Methylococcales;Methylomonadaceae;Methylosphaera;";"100.0";"14.4";"1";"1";"1";"0";"0";"457182";"391206"
"V4mis2";"SILVA (only NR);Bacteria;Proteobacteria;Gammaproteobacteria;Methylococcales;Methylomonadaceae;Methylovulum;";"100.0";"14.4";"19";"19";"19";"0";"0";"457164";"391188"
"V4mis2";"SILVA (only NR);Bacteria;Proteobacteria;Gammaproteobacteria;Methylococcales;Methylomonadaceae;Milano-WF1B-03;";"92.1";"14.4";"38";"38";"35";"3";"0";"457145";"391172"
"V4mis2";"SILVA (only NR);Bacteria;Proteobacteria;Gammaproteobacteria;Methylococcales;Methylomonadaceae;Milano-WF1B-42;";"100.0";"14.4";"3";"3";"3";"0";"0";"457180";"391204"
"V4mis2";"SILVA (only NR);Bacteria;Proteobacteria;Gammaproteobacteria;Methylococcales;Methylomonadaceae;pItb-vmat-59;";"100.0";"14.4";"10";"10";"10";"0";"0";"457173";"391197"
"V4mis2";"SILVA (only NR);Bacteria;Proteobacteria;Gammaproteobacteria;Methylococcales;Methylomonadaceae;pLW-20;";"90.5";"14.4";"21";"21";"19";"2";"0";"457162";"391188"
"V4mis2";"SILVA (only NR);Bacteria;Proteobacteria;Gammaproteobacteria;Methylococcales;Methylomonadaceae;uncultured;";"100.0";"14.4";"19";"19";"19";"0";"0";"457164";"391188"
"V4mis2";"SILVA (only NR);Bacteria;Proteobacteria;Gammaproteobacteria;Milano-WF1B-44;";"95.2";"14.4";"21";"21";"20";"1";"0";"457162";"391187"
"V4mis2";"SILVA (only NR);Bacteria;Proteobacteria;Gammaproteobacteria;NKB5;";"100.0";"14.4";"2";"2";"2";"0";"0";"457181";"391205"
"V4mis2";"SILVA (only NR);Bacteria;Proteobacteria;Gammaproteobacteria;Nitrococcales;";"97.8";"14.4";"138";"138";"135";"3";"0";"457045";"391072"
"V4mis2";"SILVA (only NR);Bacteria;Proteobacteria;Gammaproteobacteria;Nitrococcales;Halorhodospiraceae;";"96.7";"14.4";"61";"61";"59";"2";"0";"457122";"391148"
"V4mis2";"SILVA (only NR);Bacteria;Proteobacteria;Gammaproteobacteria;Nitrococcales;Halorhodospiraceae;Alkalilimnicola;";"100.0";"14.4";"3";"3";"3";"0";"0";"457180";"391204"
"V4mis2";"SILVA (only NR);Bacteria;Proteobacteria;Gammaproteobacteria;Nitrococcales;Halorhodospiraceae;Alkalispirillum;";"100.0";"14.4";"2";"2";"2";"0";"0";"457181";"391205"
"V4mis2";"SILVA (only NR);Bacteria;Proteobacteria;Gammaproteobacteria;Nitrococcales;Halorhodospiraceae;Halorhodospira;";"95.7";"14.4";"46";"46";"44";"2";"0";"457137";"391163"
"V4mis2";"SILVA (only NR);Bacteria;Proteobacteria;Gammaproteobacteria;Nitrococcales;Halorhodospiraceae;Sulfurivirga;";"100.0";"14.4";"6";"6";"6";"0";"0";"457177";"391201"
"V4mis2";"SILVA (only NR);Bacteria;Proteobacteria;Gammaproteobacteria;Nitrococcales;Halorhodospiraceae;uncultured;";"100.0";"14.4";"2";"2";"2";"0";"0";"457181";"391205"
"V4mis2";"SILVA (only NR);Bacteria;Proteobacteria;Gammaproteobacteria;Nitrococcales;Nitrococcaceae;";"98.5";"14.4";"66";"66";"65";"1";"0";"457117";"391142"
"V4mis2";"SILVA (only NR);Bacteria;Proteobacteria;Gammaproteobacteria;Nitrococcales;Nitrococcaceae;Aquisalimonas;";"100.0";"14.4";"10";"10";"10";"0";"0";"457173";"391197"
"V4mis2";"SILVA (only NR);Bacteria;Proteobacteria;Gammaproteobacteria;Nitrococcales;Nitrococcaceae;Arhodomonas;";"100.0";"14.4";"4";"4";"4";"0";"0";"457179";"391203"
"V4mis2";"SILVA (only NR);Bacteria;Proteobacteria;Gammaproteobacteria;Nitrococcales;Nitrococcaceae;Halopeptonella;";"100.0";"14.4";"18";"18";"18";"0";"0";"457165";"391189"
"V4mis2";"SILVA (only NR);Bacteria;Proteobacteria;Gammaproteobacteria;Nitrococcales;Nitrococcaceae;Nitrococcus;";"100.0";"14.4";"7";"7";"7";"0";"0";"457176";"391200"
"V4mis2";"SILVA (only NR);Bacteria;Proteobacteria;Gammaproteobacteria;Nitrococcales;Nitrococcaceae;Spiribacter;";"100.0";"14.4";"16";"16";"16";"0";"0";"457167";"391191"
"V4mis2";"SILVA (only NR);Bacteria;Proteobacteria;Gammaproteobacteria;Nitrococcales;Nitrococcaceae;uncultured;";"100.0";"14.4";"10";"10";"10";"0";"0";"457173";"391197"
"V4mis2";"SILVA (only NR);Bacteria;Proteobacteria;Gammaproteobacteria;Nitrococcales;Nitrococcales Incertae Sedis;";"100.0";"14.4";"11";"11";"11";"0";"0";"457172";"391196"
"V4mis2";"SILVA (only NR);Bacteria;Proteobacteria;Gammaproteobacteria;Nitrococcales;Nitrococcales Incertae Sedis;Methylonatrum;";"100.0";"14.4";"10";"10";"10";"0";"0";"457173";"391197"
"V4mis2";"SILVA (only NR);Bacteria;Proteobacteria;Gammaproteobacteria;Nitrococcales;Nitrococcales Incertae Sedis;Natronocella;";"100.0";"14.4";"1";"1";"1";"0";"0";"457182";"391206"
"V4mis2";"SILVA (only NR);Bacteria;Proteobacteria;Gammaproteobacteria;Nitrosococcales;";"96.0";"14.4";"424";"424";"407";"17";"0";"456759";"390800"
"V4mis2";"SILVA (only NR);Bacteria;Proteobacteria;Gammaproteobacteria;Nitrosococcales;Methylophagaceae;";"95.2";"14.4";"209";"209";"199";"10";"0";"456974";"391008"
"V4mis2";"SILVA (only NR);Bacteria;Proteobacteria;Gammaproteobacteria;Nitrosococcales;Methylophagaceae;Marine Methylotrophic Group 3;";"100.0";"14.4";"40";"40";"40";"0";"0";"457143";"391167"
"V4mis2";"SILVA (only NR);Bacteria;Proteobacteria;Gammaproteobacteria;Nitrosococcales;Methylophagaceae;Methylophaga;";"91.8";"14.4";"122";"122";"112";"10";"0";"457061";"391095"
"V4mis2";"SILVA (only NR);Bacteria;Proteobacteria;Gammaproteobacteria;Nitrosococcales;Methylophagaceae;uncultured;";"100.0";"14.4";"46";"46";"46";"0";"0";"457137";"391161"
"V4mis2";"SILVA (only NR);Bacteria;Proteobacteria;Gammaproteobacteria;Nitrosococcales;Nitrosococcaceae;";"96.7";"14.4";"215";"215";"208";"7";"0";"456968";"390999"
"V4mis2";"SILVA (only NR);Bacteria;Proteobacteria;Gammaproteobacteria;Nitrosococcales;Nitrosococcaceae;3PJM14;";"100.0";"14.4";"5";"5";"5";"0";"0";"457178";"391202"
"V4mis2";"SILVA (only NR);Bacteria;Proteobacteria;Gammaproteobacteria;Nitrosococcales;Nitrosococcaceae;AqS1;";"98.6";"14.4";"70";"70";"69";"1";"0";"457113";"391138"
"V4mis2";"SILVA (only NR);Bacteria;Proteobacteria;Gammaproteobacteria;Nitrosococcales;Nitrosococcaceae;CI75cm.2.12;";"83.3";"14.4";"12";"12";"10";"2";"0";"457171";"391197"
"V4mis2";"SILVA (only NR);Bacteria;Proteobacteria;Gammaproteobacteria;Nitrosococcales;Nitrosococcaceae;Candidatus Nitrosoglobus;";"100.0";"14.4";"3";"3";"3";"0";"0";"457180";"391204"
"V4mis2";"SILVA (only NR);Bacteria;Proteobacteria;Gammaproteobacteria;Nitrosococcales;Nitrosococcaceae;Cm1-21;";"100.0";"14.4";"19";"19";"19";"0";"0";"457164";"391188"
"V4mis2";"SILVA (only NR);Bacteria;Proteobacteria;Gammaproteobacteria;Nitrosococcales;Nitrosococcaceae;FS142-36B-02;";"100.0";"14.4";"14";"14";"14";"0";"0";"457169";"391193"
"V4mis2";"SILVA (only NR);Bacteria;Proteobacteria;Gammaproteobacteria;Nitrosococcales;Nitrosococcaceae;Inmirania;";"100.0";"14.4";"7";"7";"7";"0";"0";"457176";"391200"
"V4mis2";"SILVA (only NR);Bacteria;Proteobacteria;Gammaproteobacteria;Nitrosococcales;Nitrosococcaceae;MSB-1D1;";"100.0";"14.4";"6";"6";"6";"0";"0";"457177";"391201"
"V4mis2";"SILVA (only NR);Bacteria;Proteobacteria;Gammaproteobacteria;Nitrosococcales;Nitrosococcaceae;Nitrosococcus;";"100.0";"14.4";"12";"12";"12";"0";"0";"457171";"391195"
"V4mis2";"SILVA (only NR);Bacteria;Proteobacteria;Gammaproteobacteria;Nitrosococcales;Nitrosococcaceae;SZB85;";"92.3";"14.4";"13";"13";"12";"1";"0";"457170";"391195"
"V4mis2";"SILVA (only NR);Bacteria;Proteobacteria;Gammaproteobacteria;Nitrosococcales;Nitrosococcaceae;wb1-P19;";"94.4";"14.4";"54";"54";"51";"3";"0";"457129";"391156"
"V4mis2";"SILVA (only NR);Bacteria;Proteobacteria;Gammaproteobacteria;P0X4b2H11;";"100.0";"14.4";"2";"2";"2";"0";"0";"457181";"391205"
"V4mis2";"SILVA (only NR);Bacteria;Proteobacteria;Gammaproteobacteria;PLTA13;";"97.8";"14.4";"92";"92";"90";"2";"0";"457091";"391117"
"V4mis2";"SILVA (only NR);Bacteria;Proteobacteria;Gammaproteobacteria;Piscirickettsiales;";"98.2";"14.4";"57";"57";"56";"1";"0";"457126";"391151"
"V4mis2";"SILVA (only NR);Bacteria;Proteobacteria;Gammaproteobacteria;Piscirickettsiales;Piscirickettsiaceae;";"98.2";"14.4";"57";"57";"56";"1";"0";"457126";"391151"
"V4mis2";"SILVA (only NR);Bacteria;Proteobacteria;Gammaproteobacteria;Piscirickettsiales;Piscirickettsiaceae;Candidatus Endoecteinascidia;";"100.0";"14.4";"23";"23";"23";"0";"0";"457160";"391184"
"V4mis2";"SILVA (only NR);Bacteria;Proteobacteria;Gammaproteobacteria;Piscirickettsiales;Piscirickettsiaceae;Piscirickettsia;";"97.1";"14.4";"34";"34";"33";"1";"0";"457149";"391174"
"V4mis2";"SILVA (only NR);Bacteria;Proteobacteria;Gammaproteobacteria;Pseudomonadales;";"93.3";"14.7";"17709";"17709";"16521";"1188";"0";"439474";"374686"
"V4mis2";"SILVA (only NR);Bacteria;Proteobacteria;Gammaproteobacteria;Pseudomonadales;211ds20;";"100.0";"14.4";"13";"13";"13";"0";"0";"457170";"391194"
"V4mis2";"SILVA (only NR);Bacteria;Proteobacteria;Gammaproteobacteria;Pseudomonadales;Alcanivoracaceae1;";"92.6";"14.4";"323";"323";"299";"24";"0";"456860";"390908"
"V4mis2";"SILVA (only NR);Bacteria;Proteobacteria;Gammaproteobacteria;Pseudomonadales;Alcanivoracaceae1;Alcanivorax;";"92.6";"14.4";"323";"323";"299";"24";"0";"456860";"390908"
"V4mis2";"SILVA (only NR);Bacteria;Proteobacteria;Gammaproteobacteria;Pseudomonadales;Alcanivoracaceae;";"94.9";"14.4";"39";"39";"37";"2";"0";"457144";"391170"
"V4mis2";"SILVA (only NR);Bacteria;Proteobacteria;Gammaproteobacteria;Pseudomonadales;Alcanivoracaceae;Ketobacter;";"94.9";"14.4";"39";"39";"37";"2";"0";"457144";"391170"
"V4mis2";"SILVA (only NR);Bacteria;Proteobacteria;Gammaproteobacteria;Pseudomonadales;BD2-7;";"100.0";"14.4";"14";"14";"14";"0";"0";"457169";"391193"
"V4mis2";"SILVA (only NR);Bacteria;Proteobacteria;Gammaproteobacteria;Pseudomonadales;Cellvibrionaceae;";"95.1";"14.4";"326";"326";"310";"16";"0";"456857";"390897"
"V4mis2";"SILVA (only NR);Bacteria;Proteobacteria;Gammaproteobacteria;Pseudomonadales;Cellvibrionaceae;Aestuariicella;";"94.1";"14.4";"17";"17";"16";"1";"0";"457166";"391191"
"V4mis2";"SILVA (only NR);Bacteria;Proteobacteria;Gammaproteobacteria;Pseudomonadales;Cellvibrionaceae;Agaribacterium;";"100.0";"14.4";"7";"7";"7";"0";"0";"457176";"391200"
"V4mis2";"SILVA (only NR);Bacteria;Proteobacteria;Gammaproteobacteria;Pseudomonadales;Cellvibrionaceae;Agarilytica;";"100.0";"14.4";"6";"6";"6";"0";"0";"457177";"391201"
"V4mis2";"SILVA (only NR);Bacteria;Proteobacteria;Gammaproteobacteria;Pseudomonadales;Cellvibrionaceae;Candidatus Endobugula;";"83.3";"14.4";"6";"6";"5";"1";"0";"457177";"391202"
"V4mis2";"SILVA (only NR);Bacteria;Proteobacteria;Gammaproteobacteria;Pseudomonadales;Cellvibrionaceae;Cellvibrio;";"95.0";"14.4";"100";"100";"95";"5";"0";"457083";"391112"
"V4mis2";"SILVA (only NR);Bacteria;Proteobacteria;Gammaproteobacteria;Pseudomonadales;Cellvibrionaceae;Eionea;";"100.0";"14.4";"4";"4";"4";"0";"0";"457179";"391203"
"V4mis2";"SILVA (only NR);Bacteria;Proteobacteria;Gammaproteobacteria;Pseudomonadales;Cellvibrionaceae;Gilvimarinus;";"93.8";"14.4";"16";"16";"15";"1";"0";"457167";"391192"
"V4mis2";"SILVA (only NR);Bacteria;Proteobacteria;Gammaproteobacteria;Pseudomonadales;Cellvibrionaceae;Halioxenophilus;";"100.0";"14.4";"3";"3";"3";"0";"0";"457180";"391204"
"V4mis2";"SILVA (only NR);Bacteria;Proteobacteria;Gammaproteobacteria;Pseudomonadales;Cellvibrionaceae;Maricurvus;";"100.0";"14.4";"2";"2";"2";"0";"0";"457181";"391205"
"V4mis2";"SILVA (only NR);Bacteria;Proteobacteria;Gammaproteobacteria;Pseudomonadales;Cellvibrionaceae;Marinagarivorans;";"100.0";"14.4";"4";"4";"4";"0";"0";"457179";"391203"
"V4mis2";"SILVA (only NR);Bacteria;Proteobacteria;Gammaproteobacteria;Pseudomonadales;Cellvibrionaceae;Marinibactrum;";"100.0";"14.4";"1";"1";"1";"0";"0";"457182";"391206"
"V4mis2";"SILVA (only NR);Bacteria;Proteobacteria;Gammaproteobacteria;Pseudomonadales;Cellvibrionaceae;Marinimicrobium;";"92.5";"14.4";"40";"40";"37";"3";"0";"457143";"391170"
"V4mis2";"SILVA (only NR);Bacteria;Proteobacteria;Gammaproteobacteria;Pseudomonadales;Cellvibrionaceae;Pseudomaricurvus;";"50.0";"14.4";"2";"2";"1";"1";"0";"457181";"391206"
"V4mis2";"SILVA (only NR);Bacteria;Proteobacteria;Gammaproteobacteria;Pseudomonadales;Cellvibrionaceae;Pseudoteredinibacter;";"100.0";"14.4";"5";"5";"5";"0";"0";"457178";"391202"
"V4mis2";"SILVA (only NR);Bacteria;Proteobacteria;Gammaproteobacteria;Pseudomonadales;Cellvibrionaceae;Saccharophagus;";"100.0";"14.4";"3";"3";"3";"0";"0";"457180";"391204"
"V4mis2";"SILVA (only NR);Bacteria;Proteobacteria;Gammaproteobacteria;Pseudomonadales;Cellvibrionaceae;Simiduia;";"100.0";"14.4";"6";"6";"6";"0";"0";"457177";"391201"
"V4mis2";"SILVA (only NR);Bacteria;Proteobacteria;Gammaproteobacteria;Pseudomonadales;Cellvibrionaceae;Teredinibacter;";"100.0";"14.4";"4";"4";"4";"0";"0";"457179";"391203"
"V4mis2";"SILVA (only NR);Bacteria;Proteobacteria;Gammaproteobacteria;Pseudomonadales;Cellvibrionaceae;Umboniibacter;";"85.7";"14.4";"7";"7";"6";"1";"0";"457176";"391201"
"V4mis2";"SILVA (only NR);Bacteria;Proteobacteria;Gammaproteobacteria;Pseudomonadales;Cellvibrionaceae;uncultured;";"97.4";"14.4";"77";"77";"75";"2";"0";"457106";"391132"
"V4mis2";"SILVA (only NR);Bacteria;Proteobacteria;Gammaproteobacteria;Pseudomonadales;Endozoicomonadaceae;";"89.8";"14.4";"334";"334";"300";"34";"0";"456849";"390907"
"V4mis2";"SILVA (only NR);Bacteria;Proteobacteria;Gammaproteobacteria;Pseudomonadales;Endozoicomonadaceae;Endozoicomonas;";"89.4";"14.4";"320";"320";"286";"34";"0";"456863";"390921"
"V4mis2";"SILVA (only NR);Bacteria;Proteobacteria;Gammaproteobacteria;Pseudomonadales;Endozoicomonadaceae;Kistimonas;";"100.0";"14.4";"9";"9";"9";"0";"0";"457174";"391198"
"V4mis2";"SILVA (only NR);Bacteria;Proteobacteria;Gammaproteobacteria;Pseudomonadales;Endozoicomonadaceae;Zooshikella;";"100.0";"14.4";"5";"5";"5";"0";"0";"457178";"391202"
"V4mis2";"SILVA (only NR);Bacteria;Proteobacteria;Gammaproteobacteria;Pseudomonadales;Gven-F17;";"100.0";"14.4";"3";"3";"3";"0";"0";"457180";"391204"
"V4mis2";"SILVA (only NR);Bacteria;Proteobacteria;Gammaproteobacteria;Pseudomonadales;Hahellaceae;";"96.3";"14.4";"27";"27";"26";"1";"0";"457156";"391181"
"V4mis2";"SILVA (only NR);Bacteria;Proteobacteria;Gammaproteobacteria;Pseudomonadales;Hahellaceae;Hahella;";"96.3";"14.4";"27";"27";"26";"1";"0";"457156";"391181"
"V4mis2";"SILVA (only NR);Bacteria;Proteobacteria;Gammaproteobacteria;Pseudomonadales;Halieaceae;";"94.8";"14.4";"517";"517";"490";"27";"0";"456666";"390717"
"V4mis2";"SILVA (only NR);Bacteria;Proteobacteria;Gammaproteobacteria;Pseudomonadales;Halieaceae;Chromatocurvus;";"100.0";"14.4";"2";"2";"2";"0";"0";"457181";"391205"
"V4mis2";"SILVA (only NR);Bacteria;Proteobacteria;Gammaproteobacteria;Pseudomonadales;Halieaceae;Congregibacter;";"100.0";"14.4";"9";"9";"9";"0";"0";"457174";"391198"
"V4mis2";"SILVA (only NR);Bacteria;Proteobacteria;Gammaproteobacteria;Pseudomonadales;Halieaceae;Haliea;";"91.7";"14.4";"12";"12";"11";"1";"0";"457171";"391196"
"V4mis2";"SILVA (only NR);Bacteria;Proteobacteria;Gammaproteobacteria;Pseudomonadales;Halieaceae;Halioglobus;";"94.4";"14.4";"160";"160";"151";"9";"0";"457023";"391056"
"V4mis2";"SILVA (only NR);Bacteria;Proteobacteria;Gammaproteobacteria;Pseudomonadales;Halieaceae;Luminiphilus;";"93.1";"14.4";"29";"29";"27";"2";"0";"457154";"391180"
"V4mis2";"SILVA (only NR);Bacteria;Proteobacteria;Gammaproteobacteria;Pseudomonadales;Halieaceae;Marimicrobium;";"75.0";"14.4";"8";"8";"6";"2";"0";"457175";"391201"
"V4mis2";"SILVA (only NR);Bacteria;Proteobacteria;Gammaproteobacteria;Pseudomonadales;Halieaceae;OM60(NOR5) clade;";"96.2";"14.4";"211";"211";"203";"8";"0";"456972";"391004"
"V4mis2";"SILVA (only NR);Bacteria;Proteobacteria;Gammaproteobacteria;Pseudomonadales;Halieaceae;Parahaliea;";"100.0";"14.4";"25";"25";"25";"0";"0";"457158";"391182"
"V4mis2";"SILVA (only NR);Bacteria;Proteobacteria;Gammaproteobacteria;Pseudomonadales;Halieaceae;Pseudohaliea;";"91.1";"14.4";"56";"56";"51";"5";"0";"457127";"391156"
"V4mis2";"SILVA (only NR);Bacteria;Proteobacteria;Gammaproteobacteria;Pseudomonadales;Halomonadaceae;";"94.7";"14.5";"1697";"1697";"1607";"90";"0";"455486";"389600"
"V4mis2";"SILVA (only NR);Bacteria;Proteobacteria;Gammaproteobacteria;Pseudomonadales;Halomonadaceae;Aidingimonas;";"100.0";"14.4";"6";"6";"6";"0";"0";"457177";"391201"
"V4mis2";"SILVA (only NR);Bacteria;Proteobacteria;Gammaproteobacteria;Pseudomonadales;Halomonadaceae;Candidatus Evansia;";"100.0";"14.4";"9";"9";"9";"0";"0";"457174";"391198"
"V4mis2";"SILVA (only NR);Bacteria;Proteobacteria;Gammaproteobacteria;Pseudomonadales;Halomonadaceae;Candidatus Portiera;";"100.0";"14.4";"41";"41";"41";"0";"0";"457142";"391166"
"V4mis2";"SILVA (only NR);Bacteria;Proteobacteria;Gammaproteobacteria;Pseudomonadales;Halomonadaceae;Carnimonas;";"85.7";"14.4";"14";"14";"12";"2";"0";"457169";"391195"
"V4mis2";"SILVA (only NR);Bacteria;Proteobacteria;Gammaproteobacteria;Pseudomonadales;Halomonadaceae;Chromohalobacter;";"95.4";"14.4";"65";"65";"62";"3";"0";"457118";"391145"
"V4mis2";"SILVA (only NR);Bacteria;Proteobacteria;Gammaproteobacteria;Pseudomonadales;Halomonadaceae;Cobetia;";"89.0";"14.4";"73";"73";"65";"8";"0";"457110";"391142"
"V4mis2";"SILVA (only NR);Bacteria;Proteobacteria;Gammaproteobacteria;Pseudomonadales;Halomonadaceae;Halomonas;";"95.0";"14.5";"1246";"1246";"1184";"62";"0";"455937";"390023"
"V4mis2";"SILVA (only NR);Bacteria;Proteobacteria;Gammaproteobacteria;Pseudomonadales;Halomonadaceae;Halospina;";"100.0";"14.4";"6";"6";"6";"0";"0";"457177";"391201"
"V4mis2";"SILVA (only NR);Bacteria;Proteobacteria;Gammaproteobacteria;Pseudomonadales;Halomonadaceae;Halotalea;";"100.0";"14.4";"2";"2";"2";"0";"0";"457181";"391205"
"V4mis2";"SILVA (only NR);Bacteria;Proteobacteria;Gammaproteobacteria;Pseudomonadales;Halomonadaceae;Halovibrio;";"85.7";"14.4";"7";"7";"6";"1";"0";"457176";"391201"
"V4mis2";"SILVA (only NR);Bacteria;Proteobacteria;Gammaproteobacteria;Pseudomonadales;Halomonadaceae;HdN1;";"100.0";"14.4";"1";"1";"1";"0";"0";"457182";"391206"
"V4mis2";"SILVA (only NR);Bacteria;Proteobacteria;Gammaproteobacteria;Pseudomonadales;Halomonadaceae;Kushneria;";"100.0";"14.4";"22";"22";"22";"0";"0";"457161";"391185"
"V4mis2";"SILVA (only NR);Bacteria;Proteobacteria;Gammaproteobacteria;Pseudomonadales;Halomonadaceae;Larsenimonas;";"100.0";"14.4";"3";"3";"3";"0";"0";"457180";"391204"
"V4mis2";"SILVA (only NR);Bacteria;Proteobacteria;Gammaproteobacteria;Pseudomonadales;Halomonadaceae;Marinospirillum;";"96.0";"14.4";"25";"25";"24";"1";"0";"457158";"391183"
"V4mis2";"SILVA (only NR);Bacteria;Proteobacteria;Gammaproteobacteria;Pseudomonadales;Halomonadaceae;Modicisalibacter;";"50.0";"14.4";"4";"4";"2";"2";"0";"457179";"391205"
"V4mis2";"SILVA (only NR);Bacteria;Proteobacteria;Gammaproteobacteria;Pseudomonadales;Halomonadaceae;Salicola;";"100.0";"14.4";"16";"16";"16";"0";"0";"457167";"391191"
"V4mis2";"SILVA (only NR);Bacteria;Proteobacteria;Gammaproteobacteria;Pseudomonadales;Halomonadaceae;Salinicola;";"88.4";"14.4";"86";"86";"76";"10";"0";"457097";"391131"
"V4mis2";"SILVA (only NR);Bacteria;Proteobacteria;Gammaproteobacteria;Pseudomonadales;Halomonadaceae;Terasakiispira;";"100.0";"14.4";"7";"7";"7";"0";"0";"457176";"391200"
"V4mis2";"SILVA (only NR);Bacteria;Proteobacteria;Gammaproteobacteria;Pseudomonadales;Halomonadaceae;Zymobacter;";"100.0";"14.4";"4";"4";"4";"0";"0";"457179";"391203"
"V4mis2";"SILVA (only NR);Bacteria;Proteobacteria;Gammaproteobacteria;Pseudomonadales;Halomonadaceae;uncultured;";"97.7";"14.4";"44";"44";"43";"1";"0";"457139";"391164"
"V4mis2";"SILVA (only NR);Bacteria;Proteobacteria;Gammaproteobacteria;Pseudomonadales;KI89A clade;";"98.7";"14.4";"78";"78";"77";"1";"0";"457105";"391130"
"V4mis2";"SILVA (only NR);Bacteria;Proteobacteria;Gammaproteobacteria;Pseudomonadales;Litoricolaceae;";"96.3";"14.4";"27";"27";"26";"1";"0";"457156";"391181"
"V4mis2";"SILVA (only NR);Bacteria;Proteobacteria;Gammaproteobacteria;Pseudomonadales;Litoricolaceae;Litoricola;";"96.3";"14.4";"27";"27";"26";"1";"0";"457156";"391181"
"V4mis2";"SILVA (only NR);Bacteria;Proteobacteria;Gammaproteobacteria;Pseudomonadales;MBAE14;";"100.0";"14.4";"41";"41";"41";"0";"0";"457142";"391166"
"V4mis2";"SILVA (only NR);Bacteria;Proteobacteria;Gammaproteobacteria;Pseudomonadales;Marinobacteraceae;";"94.6";"14.4";"590";"590";"558";"32";"0";"456593";"390649"
"V4mis2";"SILVA (only NR);Bacteria;Proteobacteria;Gammaproteobacteria;Pseudomonadales;Marinobacteraceae;Marinobacter;";"94.6";"14.4";"590";"590";"558";"32";"0";"456593";"390649"
"V4mis2";"SILVA (only NR);Bacteria;Proteobacteria;Gammaproteobacteria;Pseudomonadales;Marinomonadaceae;";"96.7";"14.4";"152";"152";"147";"5";"0";"457031";"391060"
"V4mis2";"SILVA (only NR);Bacteria;Proteobacteria;Gammaproteobacteria;Pseudomonadales;Marinomonadaceae;Marinomonas;";"96.7";"14.4";"152";"152";"147";"5";"0";"457031";"391060"
"V4mis2";"SILVA (only NR);Bacteria;Proteobacteria;Gammaproteobacteria;Pseudomonadales;Microbulbiferaceae;";"100.0";"14.4";"90";"90";"90";"0";"0";"457093";"391117"
"V4mis2";"SILVA (only NR);Bacteria;Proteobacteria;Gammaproteobacteria;Pseudomonadales;Microbulbiferaceae;Microbulbifer;";"100.0";"14.4";"90";"90";"90";"0";"0";"457093";"391117"
"V4mis2";"SILVA (only NR);Bacteria;Proteobacteria;Gammaproteobacteria;Pseudomonadales;Moraxellaceae;";"94.0";"14.5";"3680";"3680";"3459";"221";"0";"453503";"387748"
"V4mis2";"SILVA (only NR);Bacteria;Proteobacteria;Gammaproteobacteria;Pseudomonadales;Moraxellaceae;Acinetobacter;";"93.9";"14.5";"2460";"2460";"2311";"149";"0";"454723";"388896"
"V4mis2";"SILVA (only NR);Bacteria;Proteobacteria;Gammaproteobacteria;Pseudomonadales;Moraxellaceae;Alkanindiges;";"98.2";"14.4";"57";"57";"56";"1";"0";"457126";"391151"
"V4mis2";"SILVA (only NR);Bacteria;Proteobacteria;Gammaproteobacteria;Pseudomonadales;Moraxellaceae;Cavicella;";"100.0";"14.4";"14";"14";"14";"0";"0";"457169";"391193"
"V4mis2";"SILVA (only NR);Bacteria;Proteobacteria;Gammaproteobacteria;Pseudomonadales;Moraxellaceae;Enhydrobacter;";"91.7";"14.4";"132";"132";"121";"11";"0";"457051";"391086"
"V4mis2";"SILVA (only NR);Bacteria;Proteobacteria;Gammaproteobacteria;Pseudomonadales;Moraxellaceae;Faucicola;";"100.0";"14.4";"1";"1";"1";"0";"0";"457182";"391206"
"V4mis2";"SILVA (only NR);Bacteria;Proteobacteria;Gammaproteobacteria;Pseudomonadales;Moraxellaceae;Fluviicoccus;";"100.0";"14.4";"6";"6";"6";"0";"0";"457177";"391201"
"V4mis2";"SILVA (only NR);Bacteria;Proteobacteria;Gammaproteobacteria;Pseudomonadales;Moraxellaceae;Moraxella;";"90.9";"14.4";"285";"285";"259";"26";"0";"456898";"390948"
"V4mis2";"SILVA (only NR);Bacteria;Proteobacteria;Gammaproteobacteria;Pseudomonadales;Moraxellaceae;Paraperlucidibaca;";"80.0";"14.4";"5";"5";"4";"1";"0";"457178";"391203"
"V4mis2";"SILVA (only NR);Bacteria;Proteobacteria;Gammaproteobacteria;Pseudomonadales;Moraxellaceae;Perlucidibaca;";"100.0";"14.4";"7";"7";"7";"0";"0";"457176";"391200"
"V4mis2";"SILVA (only NR);Bacteria;Proteobacteria;Gammaproteobacteria;Pseudomonadales;Moraxellaceae;Permianibacter;";"100.0";"14.4";"3";"3";"3";"0";"0";"457180";"391204"
"V4mis2";"SILVA (only NR);Bacteria;Proteobacteria;Gammaproteobacteria;Pseudomonadales;Moraxellaceae;Psychrobacter;";"94.8";"14.4";"580";"580";"550";"30";"0";"456603";"390657"
"V4mis2";"SILVA (only NR);Bacteria;Proteobacteria;Gammaproteobacteria;Pseudomonadales;Moraxellaceae;[Agitococcus] lubricus group;";"93.1";"14.4";"29";"29";"27";"2";"0";"457154";"391180"
"V4mis2";"SILVA (only NR);Bacteria;Proteobacteria;Gammaproteobacteria;Pseudomonadales;Moraxellaceae;uncultured;";"98.9";"14.4";"95";"95";"94";"1";"0";"457088";"391113"
"V4mis2";"SILVA (only NR);Bacteria;Proteobacteria;Gammaproteobacteria;Pseudomonadales;Nitrincolaceae;";"93.7";"14.4";"397";"397";"372";"25";"0";"456786";"390835"
"V4mis2";"SILVA (only NR);Bacteria;Proteobacteria;Gammaproteobacteria;Pseudomonadales;Nitrincolaceae;Amphritea;";"94.1";"14.4";"34";"34";"32";"2";"0";"457149";"391175"
"V4mis2";"SILVA (only NR);Bacteria;Proteobacteria;Gammaproteobacteria;Pseudomonadales;Nitrincolaceae;Balneatrix;";"100.0";"14.4";"3";"3";"3";"0";"0";"457180";"391204"
"V4mis2";"SILVA (only NR);Bacteria;Proteobacteria;Gammaproteobacteria;Pseudomonadales;Nitrincolaceae;Corallomonas;";"100.0";"14.4";"2";"2";"2";"0";"0";"457181";"391205"
"V4mis2";"SILVA (only NR);Bacteria;Proteobacteria;Gammaproteobacteria;Pseudomonadales;Nitrincolaceae;Marinobacterium;";"96.0";"14.4";"124";"124";"119";"5";"0";"457059";"391088"
"V4mis2";"SILVA (only NR);Bacteria;Proteobacteria;Gammaproteobacteria;Pseudomonadales;Nitrincolaceae;Motiliproteus;";"100.0";"14.4";"14";"14";"14";"0";"0";"457169";"391193"
"V4mis2";"SILVA (only NR);Bacteria;Proteobacteria;Gammaproteobacteria;Pseudomonadales;Nitrincolaceae;Neptuniibacter;";"81.3";"14.4";"32";"32";"26";"6";"0";"457151";"391181"
"V4mis2";"SILVA (only NR);Bacteria;Proteobacteria;Gammaproteobacteria;Pseudomonadales;Nitrincolaceae;Neptunomonas;";"94.4";"14.4";"18";"18";"17";"1";"0";"457165";"391190"
"V4mis2";"SILVA (only NR);Bacteria;Proteobacteria;Gammaproteobacteria;Pseudomonadales;Nitrincolaceae;Nitrincola;";"91.7";"14.4";"24";"24";"22";"2";"0";"457159";"391185"
"V4mis2";"SILVA (only NR);Bacteria;Proteobacteria;Gammaproteobacteria;Pseudomonadales;Nitrincolaceae;Pontibacterium;";"100.0";"14.4";"3";"3";"3";"0";"0";"457180";"391204"
"V4mis2";"SILVA (only NR);Bacteria;Proteobacteria;Gammaproteobacteria;Pseudomonadales;Nitrincolaceae;Profundimonas;";"90.9";"14.4";"22";"22";"20";"2";"0";"457161";"391187"
"V4mis2";"SILVA (only NR);Bacteria;Proteobacteria;Gammaproteobacteria;Pseudomonadales;Nitrincolaceae;uncultured;";"94.1";"14.4";"118";"118";"111";"7";"0";"457065";"391096"
"V4mis2";"SILVA (only NR);Bacteria;Proteobacteria;Gammaproteobacteria;Pseudomonadales;OM182 clade;";"93.7";"14.4";"63";"63";"59";"4";"0";"457120";"391148"
"V4mis2";"SILVA (only NR);Bacteria;Proteobacteria;Gammaproteobacteria;Pseudomonadales;Oceanospirillaceae;";"100.0";"14.4";"19";"19";"19";"0";"0";"457164";"391188"
"V4mis2";"SILVA (only NR);Bacteria;Proteobacteria;Gammaproteobacteria;Pseudomonadales;Oceanospirillaceae;Oceanospirillum;";"100.0";"14.4";"19";"19";"19";"0";"0";"457164";"391188"
"V4mis2";"SILVA (only NR);Bacteria;Proteobacteria;Gammaproteobacteria;Pseudomonadales;Oleiphilaceae;";"96.9";"14.4";"32";"32";"31";"1";"0";"457151";"391176"
"V4mis2";"SILVA (only NR);Bacteria;Proteobacteria;Gammaproteobacteria;Pseudomonadales;Oleiphilaceae;Oleiphilus;";"96.9";"14.4";"32";"32";"31";"1";"0";"457151";"391176"
"V4mis2";"SILVA (only NR);Bacteria;Proteobacteria;Gammaproteobacteria;Pseudomonadales;P13-46;";"83.3";"14.4";"6";"6";"5";"1";"0";"457177";"391202"
"V4mis2";"SILVA (only NR);Bacteria;Proteobacteria;Gammaproteobacteria;Pseudomonadales;Porticoccaceae;";"95.4";"14.4";"240";"240";"229";"11";"0";"456943";"390978"
"V4mis2";"SILVA (only NR);Bacteria;Proteobacteria;Gammaproteobacteria;Pseudomonadales;Porticoccaceae;C1-B045;";"97.0";"14.4";"100";"100";"97";"3";"0";"457083";"391110"
"V4mis2";"SILVA (only NR);Bacteria;Proteobacteria;Gammaproteobacteria;Pseudomonadales;Porticoccaceae;Porticoccus;";"95.3";"14.4";"43";"43";"41";"2";"0";"457140";"391166"
"V4mis2";"SILVA (only NR);Bacteria;Proteobacteria;Gammaproteobacteria;Pseudomonadales;Porticoccaceae;SAR92 clade;";"93.8";"14.4";"97";"97";"91";"6";"0";"457086";"391116"
"V4mis2";"SILVA (only NR);Bacteria;Proteobacteria;Gammaproteobacteria;Pseudomonadales;Pseudohongiellaceae;";"96.8";"14.4";"250";"250";"242";"8";"0";"456933";"390965"
"V4mis2";"SILVA (only NR);Bacteria;Proteobacteria;Gammaproteobacteria;Pseudomonadales;Pseudohongiellaceae;BIyi10;";"100.0";"14.4";"29";"29";"29";"0";"0";"457154";"391178"
"V4mis2";"SILVA (only NR);Bacteria;Proteobacteria;Gammaproteobacteria;Pseudomonadales;Pseudohongiellaceae;Pseudohongiella;";"96.3";"14.4";"217";"217";"209";"8";"0";"456966";"390998"
"V4mis2";"SILVA (only NR);Bacteria;Proteobacteria;Gammaproteobacteria;Pseudomonadales;Pseudohongiellaceae;Pseudospirillum;";"100.0";"14.4";"4";"4";"4";"0";"0";"457179";"391203"
"V4mis2";"SILVA (only NR);Bacteria;Proteobacteria;Gammaproteobacteria;Pseudomonadales;Pseudomonadaceae;";"91.7";"14.5";"7564";"7564";"6936";"628";"0";"449619";"384271"
"V4mis2";"SILVA (only NR);Bacteria;Proteobacteria;Gammaproteobacteria;Pseudomonadales;Pseudomonadaceae;Azomonas;";"100.0";"14.4";"4";"4";"4";"0";"0";"457179";"391203"
"V4mis2";"SILVA (only NR);Bacteria;Proteobacteria;Gammaproteobacteria;Pseudomonadales;Pseudomonadaceae;Azorhizophilus;";"100.0";"14.4";"4";"4";"4";"0";"0";"457179";"391203"
"V4mis2";"SILVA (only NR);Bacteria;Proteobacteria;Gammaproteobacteria;Pseudomonadales;Pseudomonadaceae;Azotobacter;";"85.3";"14.4";"75";"75";"64";"11";"0";"457108";"391143"
"V4mis2";"SILVA (only NR);Bacteria;Proteobacteria;Gammaproteobacteria;Pseudomonadales;Pseudomonadaceae;Oblitimonas;";"100.0";"14.4";"9";"9";"9";"0";"0";"457174";"391198"
"V4mis2";"SILVA (only NR);Bacteria;Proteobacteria;Gammaproteobacteria;Pseudomonadales;Pseudomonadaceae;Pseudomonas;";"91.7";"14.5";"7435";"7435";"6821";"614";"0";"449748";"384386"
"V4mis2";"SILVA (only NR);Bacteria;Proteobacteria;Gammaproteobacteria;Pseudomonadales;Pseudomonadaceae;Thiopseudomonas;";"91.4";"14.4";"35";"35";"32";"3";"0";"457148";"391175"
"V4mis2";"SILVA (only NR);Bacteria;Proteobacteria;Gammaproteobacteria;Pseudomonadales;Pseudomonadaceae;Ventosimonas;";"100.0";"14.4";"1";"1";"1";"0";"0";"457182";"391206"
"V4mis2";"SILVA (only NR);Bacteria;Proteobacteria;Gammaproteobacteria;Pseudomonadales;SAR86 clade;";"96.2";"14.4";"503";"503";"484";"19";"0";"456680";"390723"
"V4mis2";"SILVA (only NR);Bacteria;Proteobacteria;Gammaproteobacteria;Pseudomonadales;Saccharospirillaceae;";"96.2";"14.4";"211";"211";"203";"8";"0";"456972";"391004"
"V4mis2";"SILVA (only NR);Bacteria;Proteobacteria;Gammaproteobacteria;Pseudomonadales;Saccharospirillaceae;Bermanella;";"100.0";"14.4";"4";"4";"4";"0";"0";"457179";"391203"
"V4mis2";"SILVA (only NR);Bacteria;Proteobacteria;Gammaproteobacteria;Pseudomonadales;Saccharospirillaceae;Gynuella;";"100.0";"14.4";"3";"3";"3";"0";"0";"457180";"391204"
"V4mis2";"SILVA (only NR);Bacteria;Proteobacteria;Gammaproteobacteria;Pseudomonadales;Saccharospirillaceae;Litoribacillus;";"100.0";"14.4";"2";"2";"2";"0";"0";"457181";"391205"
"V4mis2";"SILVA (only NR);Bacteria;Proteobacteria;Gammaproteobacteria;Pseudomonadales;Saccharospirillaceae;Litoribrevibacter;";"100.0";"14.4";"2";"2";"2";"0";"0";"457181";"391205"
"V4mis2";"SILVA (only NR);Bacteria;Proteobacteria;Gammaproteobacteria;Pseudomonadales;Saccharospirillaceae;Oceaniserpentilla;";"100.0";"14.4";"5";"5";"5";"0";"0";"457178";"391202"
"V4mis2";"SILVA (only NR);Bacteria;Proteobacteria;Gammaproteobacteria;Pseudomonadales;Saccharospirillaceae;Oceanobacter;";"100.0";"14.4";"18";"18";"18";"0";"0";"457165";"391189"
"V4mis2";"SILVA (only NR);Bacteria;Proteobacteria;Gammaproteobacteria;Pseudomonadales;Saccharospirillaceae;Oleibacter;";"95.8";"14.4";"24";"24";"23";"1";"0";"457159";"391184"
"V4mis2";"SILVA (only NR);Bacteria;Proteobacteria;Gammaproteobacteria;Pseudomonadales;Saccharospirillaceae;Oleispira;";"92.3";"14.4";"26";"26";"24";"2";"0";"457157";"391183"
"V4mis2";"SILVA (only NR);Bacteria;Proteobacteria;Gammaproteobacteria;Pseudomonadales;Saccharospirillaceae;Reinekea;";"93.3";"14.4";"30";"30";"28";"2";"0";"457153";"391179"
"V4mis2";"SILVA (only NR);Bacteria;Proteobacteria;Gammaproteobacteria;Pseudomonadales;Saccharospirillaceae;Saccharospirillum;";"100.0";"14.4";"15";"15";"15";"0";"0";"457168";"391192"
"V4mis2";"SILVA (only NR);Bacteria;Proteobacteria;Gammaproteobacteria;Pseudomonadales;Saccharospirillaceae;Salinispirillum;";"100.0";"14.4";"2";"2";"2";"0";"0";"457181";"391205"
"V4mis2";"SILVA (only NR);Bacteria;Proteobacteria;Gammaproteobacteria;Pseudomonadales;Saccharospirillaceae;Spongiispira;";"100.0";"14.4";"1";"1";"1";"0";"0";"457182";"391206"
"V4mis2";"SILVA (only NR);Bacteria;Proteobacteria;Gammaproteobacteria;Pseudomonadales;Saccharospirillaceae;Thalassolituus;";"93.3";"14.4";"15";"15";"14";"1";"0";"457168";"391193"
"V4mis2";"SILVA (only NR);Bacteria;Proteobacteria;Gammaproteobacteria;Pseudomonadales;Saccharospirillaceae;uncultured;";"96.6";"14.4";"58";"58";"56";"2";"0";"457125";"391151"
"V4mis2";"SILVA (only NR);Bacteria;Proteobacteria;Gammaproteobacteria;Pseudomonadales;Spongiibacteraceae;";"96.1";"14.4";"203";"203";"195";"8";"0";"456980";"391012"
"V4mis2";"SILVA (only NR);Bacteria;Proteobacteria;Gammaproteobacteria;Pseudomonadales;Spongiibacteraceae;BD1-7 clade;";"97.7";"14.4";"130";"130";"127";"3";"0";"457053";"391080"
"V4mis2";"SILVA (only NR);Bacteria;Proteobacteria;Gammaproteobacteria;Pseudomonadales;Spongiibacteraceae;Dasania;";"85.7";"14.4";"7";"7";"6";"1";"0";"457176";"391201"
"V4mis2";"SILVA (only NR);Bacteria;Proteobacteria;Gammaproteobacteria;Pseudomonadales;Spongiibacteraceae;Litorivivens;";"100.0";"14.4";"7";"7";"7";"0";"0";"457176";"391200"
"V4mis2";"SILVA (only NR);Bacteria;Proteobacteria;Gammaproteobacteria;Pseudomonadales;Spongiibacteraceae;Oceanicoccus;";"100.0";"14.4";"2";"2";"2";"0";"0";"457181";"391205"
"V4mis2";"SILVA (only NR);Bacteria;Proteobacteria;Gammaproteobacteria;Pseudomonadales;Spongiibacteraceae;Sinobacterium;";"75.0";"14.4";"8";"8";"6";"2";"0";"457175";"391201"
"V4mis2";"SILVA (only NR);Bacteria;Proteobacteria;Gammaproteobacteria;Pseudomonadales;Spongiibacteraceae;Spongiibacter;";"100.0";"14.4";"16";"16";"16";"0";"0";"457167";"391191"
"V4mis2";"SILVA (only NR);Bacteria;Proteobacteria;Gammaproteobacteria;Pseudomonadales;Spongiibacteraceae;Zhongshania;";"92.9";"14.4";"14";"14";"13";"1";"0";"457169";"391194"
"V4mis2";"SILVA (only NR);Bacteria;Proteobacteria;Gammaproteobacteria;Pseudomonadales;Spongiibacteraceae;uncultured;";"93.3";"14.4";"15";"15";"14";"1";"0";"457168";"391193"
"V4mis2";"SILVA (only NR);Bacteria;Proteobacteria;Gammaproteobacteria;Pseudomonadales;Thioglobaceae;";"92.2";"14.4";"257";"257";"237";"20";"0";"456926";"390970"
"V4mis2";"SILVA (only NR);Bacteria;Proteobacteria;Gammaproteobacteria;Pseudomonadales;Thioglobaceae;Candidatus Ruthia;";"100.0";"14.4";"4";"4";"4";"0";"0";"457179";"391203"
"V4mis2";"SILVA (only NR);Bacteria;Proteobacteria;Gammaproteobacteria;Pseudomonadales;Thioglobaceae;Candidatus Thioglobus;";"100.0";"14.4";"3";"3";"3";"0";"0";"457180";"391204"
"V4mis2";"SILVA (only NR);Bacteria;Proteobacteria;Gammaproteobacteria;Pseudomonadales;Thioglobaceae;Candidatus Vesicomyosocius;";"100.0";"14.4";"7";"7";"7";"0";"0";"457176";"391200"
"V4mis2";"SILVA (only NR);Bacteria;Proteobacteria;Gammaproteobacteria;Pseudomonadales;Thioglobaceae;IheB2-31;";"100.0";"14.4";"3";"3";"3";"0";"0";"457180";"391204"
"V4mis2";"SILVA (only NR);Bacteria;Proteobacteria;Gammaproteobacteria;Pseudomonadales;Thioglobaceae;JL-ETNP-Z34;";"100.0";"14.4";"2";"2";"2";"0";"0";"457181";"391205"
"V4mis2";"SILVA (only NR);Bacteria;Proteobacteria;Gammaproteobacteria;Pseudomonadales;Thioglobaceae;SUP05 cluster;";"91.2";"14.4";"228";"228";"208";"20";"0";"456955";"390999"
"V4mis2";"SILVA (only NR);Bacteria;Proteobacteria;Gammaproteobacteria;Pseudomonadales;Thioglobaceae;V38;";"100.0";"14.4";"10";"10";"10";"0";"0";"457173";"391197"
"V4mis2";"SILVA (only NR);Bacteria;Proteobacteria;Gammaproteobacteria;Pseudomonadales;Unknown Family;";"100.0";"14.4";"5";"5";"5";"0";"0";"457178";"391202"
"V4mis2";"SILVA (only NR);Bacteria;Proteobacteria;Gammaproteobacteria;Pseudomonadales;Unknown Family;Alkalimarinus;";"100.0";"14.4";"5";"5";"5";"0";"0";"457178";"391202"
"V4mis2";"SILVA (only NR);Bacteria;Proteobacteria;Gammaproteobacteria;R7C24;";"100.0";"14.4";"80";"80";"80";"0";"0";"457103";"391127"
"V4mis2";"SILVA (only NR);Bacteria;Proteobacteria;Gammaproteobacteria;Run-SP154;";"100.0";"14.4";"27";"27";"27";"0";"0";"457156";"391180"
"V4mis2";"SILVA (only NR);Bacteria;Proteobacteria;Gammaproteobacteria;S1-3-65;";"100.0";"14.4";"2";"2";"2";"0";"0";"457181";"391205"
"V4mis2";"SILVA (only NR);Bacteria;Proteobacteria;Gammaproteobacteria;SBYH-1030;";"100.0";"14.4";"2";"2";"2";"0";"0";"457181";"391205"
"V4mis2";"SILVA (only NR);Bacteria;Proteobacteria;Gammaproteobacteria;SS1-B-04-55;";"100.0";"14.4";"6";"6";"6";"0";"0";"457177";"391201"
"V4mis2";"SILVA (only NR);Bacteria;Proteobacteria;Gammaproteobacteria;SS1-B-07-19;";"100.0";"14.4";"5";"5";"5";"0";"0";"457178";"391202"
"V4mis2";"SILVA (only NR);Bacteria;Proteobacteria;Gammaproteobacteria;SS1-B-09-64;";"88.9";"14.4";"9";"9";"8";"1";"0";"457174";"391199"
"V4mis2";"SILVA (only NR);Bacteria;Proteobacteria;Gammaproteobacteria;SZB30;";"100.0";"14.4";"10";"10";"10";"0";"0";"457173";"391197"
"V4mis2";"SILVA (only NR);Bacteria;Proteobacteria;Gammaproteobacteria;SZB50;";"100.0";"14.4";"13";"13";"13";"0";"0";"457170";"391194"
"V4mis2";"SILVA (only NR);Bacteria;Proteobacteria;Gammaproteobacteria;SZB7;";"100.0";"14.4";"3";"3";"3";"0";"0";"457180";"391204"
"V4mis2";"SILVA (only NR);Bacteria;Proteobacteria;Gammaproteobacteria;Salinisphaerales;";"96.7";"14.4";"245";"245";"237";"8";"0";"456938";"390970"
"V4mis2";"SILVA (only NR);Bacteria;Proteobacteria;Gammaproteobacteria;Salinisphaerales;Algiphilaceae;";"100.0";"14.4";"5";"5";"5";"0";"0";"457178";"391202"
"V4mis2";"SILVA (only NR);Bacteria;Proteobacteria;Gammaproteobacteria;Salinisphaerales;Algiphilaceae;Algiphilus;";"100.0";"14.4";"5";"5";"5";"0";"0";"457178";"391202"
"V4mis2";"SILVA (only NR);Bacteria;Proteobacteria;Gammaproteobacteria;Salinisphaerales;Salinisphaeraceae;";"100.0";"14.4";"42";"42";"42";"0";"0";"457141";"391165"
"V4mis2";"SILVA (only NR);Bacteria;Proteobacteria;Gammaproteobacteria;Salinisphaerales;Salinisphaeraceae;Salinisphaera;";"100.0";"14.4";"42";"42";"42";"0";"0";"457141";"391165"
"V4mis2";"SILVA (only NR);Bacteria;Proteobacteria;Gammaproteobacteria;Salinisphaerales;Solimonadaceae;";"96.0";"14.4";"198";"198";"190";"8";"0";"456985";"391017"
"V4mis2";"SILVA (only NR);Bacteria;Proteobacteria;Gammaproteobacteria;Salinisphaerales;Solimonadaceae;Alkanibacter;";"92.3";"14.4";"13";"13";"12";"1";"0";"457170";"391195"
"V4mis2";"SILVA (only NR);Bacteria;Proteobacteria;Gammaproteobacteria;Salinisphaerales;Solimonadaceae;Fontimonas;";"100.0";"14.4";"17";"17";"17";"0";"0";"457166";"391190"
"V4mis2";"SILVA (only NR);Bacteria;Proteobacteria;Gammaproteobacteria;Salinisphaerales;Solimonadaceae;Hydrocarboniphaga;";"94.7";"14.4";"19";"19";"18";"1";"0";"457164";"391189"
"V4mis2";"SILVA (only NR);Bacteria;Proteobacteria;Gammaproteobacteria;Salinisphaerales;Solimonadaceae;Nevskia;";"95.0";"14.4";"40";"40";"38";"2";"0";"457143";"391169"
"V4mis2";"SILVA (only NR);Bacteria;Proteobacteria;Gammaproteobacteria;Salinisphaerales;Solimonadaceae;Oceanococcus;";"100.0";"14.4";"4";"4";"4";"0";"0";"457179";"391203"
"V4mis2";"SILVA (only NR);Bacteria;Proteobacteria;Gammaproteobacteria;Salinisphaerales;Solimonadaceae;Panacagrimonas;";"92.9";"14.4";"14";"14";"13";"1";"0";"457169";"391194"
"V4mis2";"SILVA (only NR);Bacteria;Proteobacteria;Gammaproteobacteria;Salinisphaerales;Solimonadaceae;Polycyclovorans;";"92.3";"14.4";"39";"39";"36";"3";"0";"457144";"391171"
"V4mis2";"SILVA (only NR);Bacteria;Proteobacteria;Gammaproteobacteria;Salinisphaerales;Solimonadaceae;Solimonas;";"100.0";"14.4";"18";"18";"18";"0";"0";"457165";"391189"
"V4mis2";"SILVA (only NR);Bacteria;Proteobacteria;Gammaproteobacteria;Salinisphaerales;Solimonadaceae;uncultured;";"100.0";"14.4";"31";"31";"31";"0";"0";"457152";"391176"
"V4mis2";"SILVA (only NR);Bacteria;Proteobacteria;Gammaproteobacteria;Steroidobacterales;";"96.6";"14.5";"827";"827";"799";"28";"0";"456356";"390408"
"V4mis2";"SILVA (only NR);Bacteria;Proteobacteria;Gammaproteobacteria;Steroidobacterales;Steroidobacteraceae;";"97.2";"14.4";"317";"317";"308";"9";"0";"456866";"390899"
"V4mis2";"SILVA (only NR);Bacteria;Proteobacteria;Gammaproteobacteria;Steroidobacterales;Steroidobacteraceae;Povalibacter;";"100.0";"14.4";"3";"3";"3";"0";"0";"457180";"391204"
"V4mis2";"SILVA (only NR);Bacteria;Proteobacteria;Gammaproteobacteria;Steroidobacterales;Steroidobacteraceae;Steroidobacter;";"96.8";"14.4";"157";"157";"152";"5";"0";"457026";"391055"
"V4mis2";"SILVA (only NR);Bacteria;Proteobacteria;Gammaproteobacteria;Steroidobacterales;Steroidobacteraceae;uncultured;";"97.4";"14.4";"155";"155";"151";"4";"0";"457028";"391056"
"V4mis2";"SILVA (only NR);Bacteria;Proteobacteria;Gammaproteobacteria;Steroidobacterales;Woeseiaceae;";"96.3";"14.4";"510";"510";"491";"19";"0";"456673";"390716"
"V4mis2";"SILVA (only NR);Bacteria;Proteobacteria;Gammaproteobacteria;Steroidobacterales;Woeseiaceae;JTB255 marine benthic group;";"100.0";"14.4";"46";"46";"46";"0";"0";"457137";"391161"
"V4mis2";"SILVA (only NR);Bacteria;Proteobacteria;Gammaproteobacteria;Steroidobacterales;Woeseiaceae;Woeseia;";"95.9";"14.4";"464";"464";"445";"19";"0";"456719";"390762"
"V4mis2";"SILVA (only NR);Bacteria;Proteobacteria;Gammaproteobacteria;TDNP-Wbc97-11-7-16;";"100.0";"14.4";"2";"2";"2";"0";"0";"457181";"391205"
"V4mis2";"SILVA (only NR);Bacteria;Proteobacteria;Gammaproteobacteria;Tenderiales;";"97.0";"14.4";"33";"33";"32";"1";"0";"457150";"391175"
"V4mis2";"SILVA (only NR);Bacteria;Proteobacteria;Gammaproteobacteria;Tenderiales;Tenderiaceae;";"97.0";"14.4";"33";"33";"32";"1";"0";"457150";"391175"
"V4mis2";"SILVA (only NR);Bacteria;Proteobacteria;Gammaproteobacteria;Tenderiales;Tenderiaceae;Candidatus Tenderia;";"97.0";"14.4";"33";"33";"32";"1";"0";"457150";"391175"
"V4mis2";"SILVA (only NR);Bacteria;Proteobacteria;Gammaproteobacteria;Thiohalorhabdales;";"98.2";"14.4";"56";"56";"55";"1";"0";"457127";"391152"
"V4mis2";"SILVA (only NR);Bacteria;Proteobacteria;Gammaproteobacteria;Thiohalorhabdales;Thiohalorhabdaceae;";"98.2";"14.4";"56";"56";"55";"1";"0";"457127";"391152"
"V4mis2";"SILVA (only NR);Bacteria;Proteobacteria;Gammaproteobacteria;Thiohalorhabdales;Thiohalorhabdaceae;Thiohalorhabdus;";"100.0";"14.4";"34";"34";"34";"0";"0";"457149";"391173"
"V4mis2";"SILVA (only NR);Bacteria;Proteobacteria;Gammaproteobacteria;Thiohalorhabdales;Thiohalorhabdaceae;uncultured;";"95.5";"14.4";"22";"22";"21";"1";"0";"457161";"391186"
"V4mis2";"SILVA (only NR);Bacteria;Proteobacteria;Gammaproteobacteria;Thiomicrospirales;";"97.5";"14.4";"281";"281";"274";"7";"0";"456902";"390933"
"V4mis2";"SILVA (only NR);Bacteria;Proteobacteria;Gammaproteobacteria;Thiomicrospirales;Thiomicrospiraceae;";"97.5";"14.4";"281";"281";"274";"7";"0";"456902";"390933"
"V4mis2";"SILVA (only NR);Bacteria;Proteobacteria;Gammaproteobacteria;Thiomicrospirales;Thiomicrospiraceae;Galenea;";"100.0";"14.4";"2";"2";"2";"0";"0";"457181";"391205"
"V4mis2";"SILVA (only NR);Bacteria;Proteobacteria;Gammaproteobacteria;Thiomicrospirales;Thiomicrospiraceae;Hydrogenovibrio;";"100.0";"14.4";"4";"4";"4";"0";"0";"457179";"391203"
"V4mis2";"SILVA (only NR);Bacteria;Proteobacteria;Gammaproteobacteria;Thiomicrospirales;Thiomicrospiraceae;Thioalkalimicrobium;";"100.0";"14.4";"12";"12";"12";"0";"0";"457171";"391195"
"V4mis2";"SILVA (only NR);Bacteria;Proteobacteria;Gammaproteobacteria;Thiomicrospirales;Thiomicrospiraceae;Thiomicrorhabdus;";"99.1";"14.4";"111";"111";"110";"1";"0";"457072";"391097"
"V4mis2";"SILVA (only NR);Bacteria;Proteobacteria;Gammaproteobacteria;Thiomicrospirales;Thiomicrospiraceae;Thiomicrospira;";"100.0";"14.4";"29";"29";"29";"0";"0";"457154";"391178"
"V4mis2";"SILVA (only NR);Bacteria;Proteobacteria;Gammaproteobacteria;Thiomicrospirales;Thiomicrospiraceae;endosymbionts;";"94.4";"14.4";"108";"108";"102";"6";"0";"457075";"391105"
"V4mis2";"SILVA (only NR);Bacteria;Proteobacteria;Gammaproteobacteria;Thiomicrospirales;Thiomicrospiraceae;uncultured;";"100.0";"14.4";"13";"13";"13";"0";"0";"457170";"391194"
"V4mis2";"SILVA (only NR);Bacteria;Proteobacteria;Gammaproteobacteria;Thioprofundaceae;";"100.0";"14.4";"8";"8";"8";"0";"0";"457175";"391199"
"V4mis2";"SILVA (only NR);Bacteria;Proteobacteria;Gammaproteobacteria;Thioprofundaceae;Thioprofundum;";"100.0";"14.4";"8";"8";"8";"0";"0";"457175";"391199"
"V4mis2";"SILVA (only NR);Bacteria;Proteobacteria;Gammaproteobacteria;Thiotrichales;";"96.8";"14.4";"623";"623";"603";"20";"0";"456560";"390604"
"V4mis2";"SILVA (only NR);Bacteria;Proteobacteria;Gammaproteobacteria;Thiotrichales;Thiotrichaceae;";"96.8";"14.4";"623";"623";"603";"20";"0";"456560";"390604"
"V4mis2";"SILVA (only NR);Bacteria;Proteobacteria;Gammaproteobacteria;Thiotrichales;Thiotrichaceae;Candidatus Navis;";"100.0";"14.4";"3";"3";"3";"0";"0";"457180";"391204"
"V4mis2";"SILVA (only NR);Bacteria;Proteobacteria;Gammaproteobacteria;Thiotrichales;Thiotrichaceae;Cocleimonas;";"94.5";"14.4";"73";"73";"69";"4";"0";"457110";"391138"
"V4mis2";"SILVA (only NR);Bacteria;Proteobacteria;Gammaproteobacteria;Thiotrichales;Thiotrichaceae;Leucothrix;";"91.7";"14.4";"24";"24";"22";"2";"0";"457159";"391185"
"V4mis2";"SILVA (only NR);Bacteria;Proteobacteria;Gammaproteobacteria;Thiotrichales;Thiotrichaceae;Thiothrix;";"97.7";"14.4";"216";"216";"211";"5";"0";"456967";"390996"
"V4mis2";"SILVA (only NR);Bacteria;Proteobacteria;Gammaproteobacteria;Thiotrichales;Thiotrichaceae;uncultured;";"97.1";"14.4";"306";"306";"297";"9";"0";"456877";"390910"
"V4mis2";"SILVA (only NR);Bacteria;Proteobacteria;Gammaproteobacteria;UBA10353 marine group;";"93.3";"14.4";"194";"194";"181";"13";"0";"456989";"391026"
"V4mis2";"SILVA (only NR);Bacteria;Proteobacteria;Gammaproteobacteria;UBA4486;";"92.9";"14.4";"14";"14";"13";"1";"0";"457169";"391194"
"V4mis2";"SILVA (only NR);Bacteria;Proteobacteria;Gammaproteobacteria;WD260;";"97.9";"14.4";"47";"47";"46";"1";"0";"457136";"391161"
"V4mis2";"SILVA (only NR);Bacteria;Proteobacteria;Gammaproteobacteria;WN-HWB-116;";"93.8";"14.4";"16";"16";"15";"1";"0";"457167";"391192"
"V4mis2";"SILVA (only NR);Bacteria;Proteobacteria;Gammaproteobacteria;Xanthomonadales;";"94.6";"14.5";"3619";"3619";"3423";"196";"0";"453564";"387784"
"V4mis2";"SILVA (only NR);Bacteria;Proteobacteria;Gammaproteobacteria;Xanthomonadales;Coralloluteibacterium;";"100.0";"14.4";"1";"1";"1";"0";"0";"457182";"391206"
"V4mis2";"SILVA (only NR);Bacteria;Proteobacteria;Gammaproteobacteria;Xanthomonadales;Rhodanobacteraceae;";"96.0";"14.4";"828";"828";"795";"33";"0";"456355";"390412"
"V4mis2";"SILVA (only NR);Bacteria;Proteobacteria;Gammaproteobacteria;Xanthomonadales;Rhodanobacteraceae;Ahniella;";"98.3";"14.4";"59";"59";"58";"1";"0";"457124";"391149"
"V4mis2";"SILVA (only NR);Bacteria;Proteobacteria;Gammaproteobacteria;Xanthomonadales;Rhodanobacteraceae;Aquimonas;";"85.0";"14.4";"20";"20";"17";"3";"0";"457163";"391190"
"V4mis2";"SILVA (only NR);Bacteria;Proteobacteria;Gammaproteobacteria;Xanthomonadales;Rhodanobacteraceae;Chiayiivirga;";"100.0";"14.4";"6";"6";"6";"0";"0";"457177";"391201"
"V4mis2";"SILVA (only NR);Bacteria;Proteobacteria;Gammaproteobacteria;Xanthomonadales;Rhodanobacteraceae;Chujaibacter;";"92.5";"14.4";"40";"40";"37";"3";"0";"457143";"391170"
"V4mis2";"SILVA (only NR);Bacteria;Proteobacteria;Gammaproteobacteria;Xanthomonadales;Rhodanobacteraceae;Dokdonella;";"97.9";"14.4";"95";"95";"93";"2";"0";"457088";"391114"
"V4mis2";"SILVA (only NR);Bacteria;Proteobacteria;Gammaproteobacteria;Xanthomonadales;Rhodanobacteraceae;Dyella;";"95.1";"14.4";"102";"102";"97";"5";"0";"457081";"391110"
"V4mis2";"SILVA (only NR);Bacteria;Proteobacteria;Gammaproteobacteria;Xanthomonadales;Rhodanobacteraceae;Frateuria;";"100.0";"14.4";"30";"30";"30";"0";"0";"457153";"391177"
"V4mis2";"SILVA (only NR);Bacteria;Proteobacteria;Gammaproteobacteria;Xanthomonadales;Rhodanobacteraceae;Fulvimonas;";"100.0";"14.4";"8";"8";"8";"0";"0";"457175";"391199"
"V4mis2";"SILVA (only NR);Bacteria;Proteobacteria;Gammaproteobacteria;Xanthomonadales;Rhodanobacteraceae;Luteibacter;";"95.2";"14.4";"62";"62";"59";"3";"0";"457121";"391148"
"V4mis2";"SILVA (only NR);Bacteria;Proteobacteria;Gammaproteobacteria;Xanthomonadales;Rhodanobacteraceae;Metallibacterium;";"86.7";"14.4";"15";"15";"13";"2";"0";"457168";"391194"
"V4mis2";"SILVA (only NR);Bacteria;Proteobacteria;Gammaproteobacteria;Xanthomonadales;Rhodanobacteraceae;Mizugakiibacter;";"100.0";"14.4";"8";"8";"8";"0";"0";"457175";"391199"
"V4mis2";"SILVA (only NR);Bacteria;Proteobacteria;Gammaproteobacteria;Xanthomonadales;Rhodanobacteraceae;Oleiagrimonas;";"100.0";"14.4";"6";"6";"6";"0";"0";"457177";"391201"
"V4mis2";"SILVA (only NR);Bacteria;Proteobacteria;Gammaproteobacteria;Xanthomonadales;Rhodanobacteraceae;Pseudofulvimonas;";"81.5";"14.4";"27";"27";"22";"5";"0";"457156";"391185"
"V4mis2";"SILVA (only NR);Bacteria;Proteobacteria;Gammaproteobacteria;Xanthomonadales;Rhodanobacteraceae;Rhodanobacter;";"97.5";"14.4";"238";"238";"232";"6";"0";"456945";"390975"
"V4mis2";"SILVA (only NR);Bacteria;Proteobacteria;Gammaproteobacteria;Xanthomonadales;Rhodanobacteraceae;Rudaea;";"100.0";"14.4";"8";"8";"8";"0";"0";"457175";"391199"
"V4mis2";"SILVA (only NR);Bacteria;Proteobacteria;Gammaproteobacteria;Xanthomonadales;Rhodanobacteraceae;Tahibacter;";"95.8";"14.4";"24";"24";"23";"1";"0";"457159";"391184"
"V4mis2";"SILVA (only NR);Bacteria;Proteobacteria;Gammaproteobacteria;Xanthomonadales;Rhodanobacteraceae;uncultured;";"97.3";"14.4";"75";"75";"73";"2";"0";"457108";"391134"
"V4mis2";"SILVA (only NR);Bacteria;Proteobacteria;Gammaproteobacteria;Xanthomonadales;Xanthomonadaceae;";"94.1";"14.5";"2774";"2774";"2611";"163";"0";"454409";"388596"
"V4mis2";"SILVA (only NR);Bacteria;Proteobacteria;Gammaproteobacteria;Xanthomonadales;Xanthomonadaceae;Arenimonas;";"97.1";"14.4";"207";"207";"201";"6";"0";"456976";"391006"
"V4mis2";"SILVA (only NR);Bacteria;Proteobacteria;Gammaproteobacteria;Xanthomonadales;Xanthomonadaceae;Luteimonas;";"95.5";"14.4";"244";"244";"233";"11";"0";"456939";"390974"
"V4mis2";"SILVA (only NR);Bacteria;Proteobacteria;Gammaproteobacteria;Xanthomonadales;Xanthomonadaceae;Lysobacter;";"91.2";"14.4";"455";"455";"415";"40";"0";"456728";"390792"
"V4mis2";"SILVA (only NR);Bacteria;Proteobacteria;Gammaproteobacteria;Xanthomonadales;Xanthomonadaceae;Pseudoxanthomonas;";"96.0";"14.4";"173";"173";"166";"7";"0";"457010";"391041"
"V4mis2";"SILVA (only NR);Bacteria;Proteobacteria;Gammaproteobacteria;Xanthomonadales;Xanthomonadaceae;Rehaibacterium;";"100.0";"14.4";"10";"10";"10";"0";"0";"457173";"391197"
"V4mis2";"SILVA (only NR);Bacteria;Proteobacteria;Gammaproteobacteria;Xanthomonadales;Xanthomonadaceae;SN8;";"100.0";"14.4";"6";"6";"6";"0";"0";"457177";"391201"
"V4mis2";"SILVA (only NR);Bacteria;Proteobacteria;Gammaproteobacteria;Xanthomonadales;Xanthomonadaceae;Silanimonas;";"94.7";"14.4";"19";"19";"18";"1";"0";"457164";"391189"
"V4mis2";"SILVA (only NR);Bacteria;Proteobacteria;Gammaproteobacteria;Xanthomonadales;Xanthomonadaceae;Stenotrophomonas;";"91.5";"14.4";"1011";"1011";"925";"86";"0";"456172";"390282"
"V4mis2";"SILVA (only NR);Bacteria;Proteobacteria;Gammaproteobacteria;Xanthomonadales;Xanthomonadaceae;Thermomonas;";"99.2";"14.4";"130";"130";"129";"1";"0";"457053";"391078"
"V4mis2";"SILVA (only NR);Bacteria;Proteobacteria;Gammaproteobacteria;Xanthomonadales;Xanthomonadaceae;Vulcaniibacterium;";"95.5";"14.4";"22";"22";"21";"1";"0";"457161";"391186"
"V4mis2";"SILVA (only NR);Bacteria;Proteobacteria;Gammaproteobacteria;Xanthomonadales;Xanthomonadaceae;Xanthomonas;";"98.4";"14.4";"369";"369";"363";"6";"0";"456814";"390844"
"V4mis2";"SILVA (only NR);Bacteria;Proteobacteria;Gammaproteobacteria;Xanthomonadales;Xanthomonadaceae;Xylella;";"100.0";"14.4";"52";"52";"52";"0";"0";"457131";"391155"
"V4mis2";"SILVA (only NR);Bacteria;Proteobacteria;Gammaproteobacteria;Xanthomonadales;Xanthomonadaceae;uncultured;";"95.4";"14.4";"65";"65";"62";"3";"0";"457118";"391145"
"V4mis2";"SILVA (only NR);Bacteria;Proteobacteria;Gammaproteobacteria;Xanthomonadales;uncultured;";"100.0";"14.4";"16";"16";"16";"0";"0";"457167";"391191"
"V4mis2";"SILVA (only NR);Bacteria;Proteobacteria;Gammaproteobacteria;eub62A3;";"100.0";"14.4";"9";"9";"9";"0";"0";"457174";"391198"
"V4mis2";"SILVA (only NR);Bacteria;Proteobacteria;Gammaproteobacteria;pItb-vmat-80;";"100.0";"14.4";"23";"23";"23";"0";"0";"457160";"391184"
"V4mis2";"SILVA (only NR);Bacteria;Proteobacteria;Gammaproteobacteria;sediment-surface35;";"100.0";"14.4";"2";"2";"2";"0";"0";"457181";"391205"
"V4mis2";"SILVA (only NR);Bacteria;Proteobacteria;Gammaproteobacteria;uncultured;";"95.8";"14.4";"240";"240";"230";"10";"0";"456943";"390977"
"V4mis2";"SILVA (only NR);Bacteria;Proteobacteria;Magnetococcia;";"97.9";"14.4";"194";"194";"190";"4";"0";"456989";"391017"
"V4mis2";"SILVA (only NR);Bacteria;Proteobacteria;Magnetococcia;Magnetococcales;";"97.9";"14.4";"194";"194";"190";"4";"0";"456989";"391017"
"V4mis2";"SILVA (only NR);Bacteria;Proteobacteria;Magnetococcia;Magnetococcales;Magnetococcaceae;";"97.9";"14.4";"194";"194";"190";"4";"0";"456989";"391017"
"V4mis2";"SILVA (only NR);Bacteria;Proteobacteria;Magnetococcia;Magnetococcales;Magnetococcaceae;Magnetococcus;";"97.9";"14.4";"194";"194";"190";"4";"0";"456989";"391017"
"V4mis2";"SILVA (only NR);Bacteria;Proteobacteria;Zetaproteobacteria;";"99.3";"14.4";"136";"136";"135";"1";"0";"457047";"391072"
"V4mis2";"SILVA (only NR);Bacteria;Proteobacteria;Zetaproteobacteria;Mariprofundales;";"99.3";"14.4";"136";"136";"135";"1";"0";"457047";"391072"
"V4mis2";"SILVA (only NR);Bacteria;Proteobacteria;Zetaproteobacteria;Mariprofundales;Mariprofundaceae;";"99.3";"14.4";"136";"136";"135";"1";"0";"457047";"391072"
"V4mis2";"SILVA (only NR);Bacteria;Proteobacteria;Zetaproteobacteria;Mariprofundales;Mariprofundaceae;Mariprofundus;";"99.3";"14.4";"136";"136";"135";"1";"0";"457047";"391072"
"V4mis2";"SILVA (only NR);Bacteria;RCP2-54;";"90.5";"14.4";"137";"137";"124";"13";"0";"457046";"391083"
"V4mis2";"SILVA (only NR);Bacteria;Rs-K70 termite group;";"93.5";"14.4";"31";"31";"29";"2";"0";"457152";"391178"
"V4mis2";"SILVA (only NR);Bacteria;SAR324 clade(Marine group B);";"97.5";"14.4";"629";"629";"613";"16";"0";"456554";"390594"
"V4mis2";"SILVA (only NR);Bacteria;Schekmanbacteria;";"97.6";"14.4";"42";"42";"41";"1";"0";"457141";"391166"
"V4mis2";"SILVA (only NR);Bacteria;Spirochaetota;";"95.8";"14.5";"4069";"4069";"3898";"171";"0";"453114";"387309"
"V4mis2";"SILVA (only NR);Bacteria;Spirochaetota;Brachyspirae;";"93.7";"14.4";"111";"111";"104";"7";"0";"457072";"391103"
"V4mis2";"SILVA (only NR);Bacteria;Spirochaetota;Brachyspirae;Brachyspirales;";"93.7";"14.4";"111";"111";"104";"7";"0";"457072";"391103"
"V4mis2";"SILVA (only NR);Bacteria;Spirochaetota;Brachyspirae;Brachyspirales;Brachyspiraceae;";"95.2";"14.4";"63";"63";"60";"3";"0";"457120";"391147"
"V4mis2";"SILVA (only NR);Bacteria;Spirochaetota;Brachyspirae;Brachyspirales;Brachyspiraceae;Brachyspira;";"95.2";"14.4";"63";"63";"60";"3";"0";"457120";"391147"
"V4mis2";"SILVA (only NR);Bacteria;Spirochaetota;Brachyspirae;Brachyspirales;Brachyspirales Incertae Sedis;";"86.7";"14.4";"15";"15";"13";"2";"0";"457168";"391194"
"V4mis2";"SILVA (only NR);Bacteria;Spirochaetota;Brachyspirae;Brachyspirales;Brachyspirales Incertae Sedis;Exilispira;";"86.7";"14.4";"15";"15";"13";"2";"0";"457168";"391194"
"V4mis2";"SILVA (only NR);Bacteria;Spirochaetota;Brachyspirae;Brachyspirales;LH041;";"93.9";"14.4";"33";"33";"31";"2";"0";"457150";"391176"
"V4mis2";"SILVA (only NR);Bacteria;Spirochaetota;Brevinematia;";"100.0";"14.4";"17";"17";"17";"0";"0";"457166";"391190"
"V4mis2";"SILVA (only NR);Bacteria;Spirochaetota;Brevinematia;Brevinematales;";"100.0";"14.4";"17";"17";"17";"0";"0";"457166";"391190"
"V4mis2";"SILVA (only NR);Bacteria;Spirochaetota;Brevinematia;Brevinematales;Brevinemataceae;";"100.0";"14.4";"17";"17";"17";"0";"0";"457166";"391190"
"V4mis2";"SILVA (only NR);Bacteria;Spirochaetota;Brevinematia;Brevinematales;Brevinemataceae;Brevinema;";"100.0";"14.4";"17";"17";"17";"0";"0";"457166";"391190"
"V4mis2";"SILVA (only NR);Bacteria;Spirochaetota;Leptospirae;";"96.4";"14.4";"336";"336";"324";"12";"0";"456847";"390883"
"V4mis2";"SILVA (only NR);Bacteria;Spirochaetota;Leptospirae;Leptospirales;";"96.4";"14.4";"336";"336";"324";"12";"0";"456847";"390883"
"V4mis2";"SILVA (only NR);Bacteria;Spirochaetota;Leptospirae;Leptospirales;Leptospiraceae;";"96.4";"14.4";"336";"336";"324";"12";"0";"456847";"390883"
"V4mis2";"SILVA (only NR);Bacteria;Spirochaetota;Leptospirae;Leptospirales;Leptospiraceae;Leptonema;";"100.0";"14.4";"5";"5";"5";"0";"0";"457178";"391202"
"V4mis2";"SILVA (only NR);Bacteria;Spirochaetota;Leptospirae;Leptospirales;Leptospiraceae;Leptospira;";"98.9";"14.4";"178";"178";"176";"2";"0";"457005";"391031"
"V4mis2";"SILVA (only NR);Bacteria;Spirochaetota;Leptospirae;Leptospirales;Leptospiraceae;RBG-16-49-21;";"90.4";"14.4";"104";"104";"94";"10";"0";"457079";"391113"
"V4mis2";"SILVA (only NR);Bacteria;Spirochaetota;Leptospirae;Leptospirales;Leptospiraceae;Rs-H88 termite group;";"100.0";"14.4";"6";"6";"6";"0";"0";"457177";"391201"
"V4mis2";"SILVA (only NR);Bacteria;Spirochaetota;Leptospirae;Leptospirales;Leptospiraceae;Turneriella;";"100.0";"14.4";"16";"16";"16";"0";"0";"457167";"391191"
"V4mis2";"SILVA (only NR);Bacteria;Spirochaetota;Leptospirae;Leptospirales;Leptospiraceae;uncultured;";"100.0";"14.4";"25";"25";"25";"0";"0";"457158";"391182"
"V4mis2";"SILVA (only NR);Bacteria;Spirochaetota;MVP-15;";"93.9";"14.4";"66";"66";"62";"4";"0";"457117";"391145"
"V4mis2";"SILVA (only NR);Bacteria;Spirochaetota;Spirochaetia;";"95.8";"14.5";"3514";"3514";"3367";"147";"0";"453669";"387840"
"V4mis2";"SILVA (only NR);Bacteria;Spirochaetota;Spirochaetia;Spirochaetales;";"95.8";"14.5";"3514";"3514";"3367";"147";"0";"453669";"387840"
"V4mis2";"SILVA (only NR);Bacteria;Spirochaetota;Spirochaetia;Spirochaetales;Spirochaetaceae;";"95.8";"14.5";"3514";"3514";"3367";"147";"0";"453669";"387840"
"V4mis2";"SILVA (only NR);Bacteria;Spirochaetota;Spirochaetia;Spirochaetales;Spirochaetaceae;Alkalispirochaeta;";"100.0";"14.4";"44";"44";"44";"0";"0";"457139";"391163"
"V4mis2";"SILVA (only NR);Bacteria;Spirochaetota;Spirochaetia;Spirochaetales;Spirochaetaceae;Borrelia;";"96.6";"14.4";"58";"58";"56";"2";"0";"457125";"391151"
"V4mis2";"SILVA (only NR);Bacteria;Spirochaetota;Spirochaetia;Spirochaetales;Spirochaetaceae;Borreliella;";"94.9";"14.4";"59";"59";"56";"3";"0";"457124";"391151"
"V4mis2";"SILVA (only NR);Bacteria;Spirochaetota;Spirochaetia;Spirochaetales;Spirochaetaceae;Candidatus Marispirochaeta;";"97.1";"14.4";"35";"35";"34";"1";"0";"457148";"391173"
"V4mis2";"SILVA (only NR);Bacteria;Spirochaetota;Spirochaetia;Spirochaetales;Spirochaetaceae;GWE2-31-10;";"100.0";"14.4";"22";"22";"22";"0";"0";"457161";"391185"
"V4mis2";"SILVA (only NR);Bacteria;Spirochaetota;Spirochaetia;Spirochaetales;Spirochaetaceae;M2PT2-76 termite group;";"100.0";"14.4";"11";"11";"11";"0";"0";"457172";"391196"
"V4mis2";"SILVA (only NR);Bacteria;Spirochaetota;Spirochaetia;Spirochaetales;Spirochaetaceae;Salinispira;";"90.9";"14.4";"11";"11";"10";"1";"0";"457172";"391197"
"V4mis2";"SILVA (only NR);Bacteria;Spirochaetota;Spirochaetia;Spirochaetales;Spirochaetaceae;Sediminispirochaeta;";"96.2";"14.4";"182";"182";"175";"7";"0";"457001";"391032"
"V4mis2";"SILVA (only NR);Bacteria;Spirochaetota;Spirochaetia;Spirochaetales;Spirochaetaceae;Sphaerochaeta;";"97.0";"14.4";"198";"198";"192";"6";"0";"456985";"391015"
"V4mis2";"SILVA (only NR);Bacteria;Spirochaetota;Spirochaetia;Spirochaetales;Spirochaetaceae;Spirochaeta 2;";"92.1";"14.4";"404";"404";"372";"32";"0";"456779";"390835"
"V4mis2";"SILVA (only NR);Bacteria;Spirochaetota;Spirochaetia;Spirochaetales;Spirochaetaceae;Spirochaeta;";"93.7";"14.4";"412";"412";"386";"26";"0";"456771";"390821"
"V4mis2";"SILVA (only NR);Bacteria;Spirochaetota;Spirochaetia;Spirochaetales;Spirochaetaceae;Termite Treponema cluster;";"95.4";"14.4";"261";"261";"249";"12";"0";"456922";"390958"
"V4mis2";"SILVA (only NR);Bacteria;Spirochaetota;Spirochaetia;Spirochaetales;Spirochaetaceae;Treponema;";"97.2";"14.5";"1427";"1427";"1387";"40";"0";"455756";"389820"
"V4mis2";"SILVA (only NR);Bacteria;Spirochaetota;Spirochaetia;Spirochaetales;Spirochaetaceae;uncultured;";"95.6";"14.4";"390";"390";"373";"17";"0";"456793";"390834"
"V4mis2";"SILVA (only NR);Bacteria;Spirochaetota;V2072-189E03;";"93.8";"14.4";"16";"16";"15";"1";"0";"457167";"391192"
"V4mis2";"SILVA (only NR);Bacteria;Spirochaetota;uncultured;";"100.0";"14.4";"7";"7";"7";"0";"0";"457176";"391200"
"V4mis2";"SILVA (only NR);Bacteria;Sumerlaeota;";"95.2";"14.4";"392";"392";"373";"19";"0";"456791";"390834"
"V4mis2";"SILVA (only NR);Bacteria;Sumerlaeota;Sumerlaeia;";"95.2";"14.4";"392";"392";"373";"19";"0";"456791";"390834"
"V4mis2";"SILVA (only NR);Bacteria;Sumerlaeota;Sumerlaeia;Sumerlaeales;";"97.7";"14.4";"261";"261";"255";"6";"0";"456922";"390952"
"V4mis2";"SILVA (only NR);Bacteria;Sumerlaeota;Sumerlaeia;Sumerlaeales;Sumerlaeaceae;";"97.7";"14.4";"261";"261";"255";"6";"0";"456922";"390952"
"V4mis2";"SILVA (only NR);Bacteria;Sumerlaeota;Sumerlaeia;Sumerlaeales;Sumerlaeaceae;Sumerlaea;";"97.7";"14.4";"261";"261";"255";"6";"0";"456922";"390952"
"V4mis2";"SILVA (only NR);Bacteria;Sumerlaeota;Sumerlaeia;uncultured;";"90.1";"14.4";"131";"131";"118";"13";"0";"457052";"391089"
"V4mis2";"SILVA (only NR);Bacteria;Sva0485;";"97.9";"14.4";"387";"387";"379";"8";"0";"456796";"390828"
"V4mis2";"SILVA (only NR);Bacteria;Synergistota;";"95.9";"14.5";"925";"925";"887";"38";"0";"456258";"390320"
"V4mis2";"SILVA (only NR);Bacteria;Synergistota;Synergistia;";"95.9";"14.5";"925";"925";"887";"38";"0";"456258";"390320"
"V4mis2";"SILVA (only NR);Bacteria;Synergistota;Synergistia;Synergistales;";"95.9";"14.5";"925";"925";"887";"38";"0";"456258";"390320"
"V4mis2";"SILVA (only NR);Bacteria;Synergistota;Synergistia;Synergistales;Synergistaceae;";"95.9";"14.5";"925";"925";"887";"38";"0";"456258";"390320"
"V4mis2";"SILVA (only NR);Bacteria;Synergistota;Synergistia;Synergistales;Synergistaceae;Acetomicrobium;";"97.0";"14.4";"33";"33";"32";"1";"0";"457150";"391175"
"V4mis2";"SILVA (only NR);Bacteria;Synergistota;Synergistia;Synergistales;Synergistaceae;Aminiphilus;";"71.4";"14.4";"7";"7";"5";"2";"0";"457176";"391202"
"V4mis2";"SILVA (only NR);Bacteria;Synergistota;Synergistia;Synergistales;Synergistaceae;Aminivibrio;";"100.0";"14.4";"12";"12";"12";"0";"0";"457171";"391195"
"V4mis2";"SILVA (only NR);Bacteria;Synergistota;Synergistia;Synergistales;Synergistaceae;Aminobacterium;";"95.5";"14.4";"22";"22";"21";"1";"0";"457161";"391186"
"V4mis2";"SILVA (only NR);Bacteria;Synergistota;Synergistia;Synergistales;Synergistaceae;Aminomonas;";"66.7";"14.4";"3";"3";"2";"1";"0";"457180";"391205"
"V4mis2";"SILVA (only NR);Bacteria;Synergistota;Synergistia;Synergistales;Synergistaceae;Candidatus Tammella;";"100.0";"14.4";"25";"25";"25";"0";"0";"457158";"391182"
"V4mis2";"SILVA (only NR);Bacteria;Synergistota;Synergistia;Synergistales;Synergistaceae;Cloacibacillus;";"95.5";"14.4";"22";"22";"21";"1";"0";"457161";"391186"
"V4mis2";"SILVA (only NR);Bacteria;Synergistota;Synergistia;Synergistales;Synergistaceae;Dethiosulfovibrio;";"100.0";"14.4";"13";"13";"13";"0";"0";"457170";"391194"
"V4mis2";"SILVA (only NR);Bacteria;Synergistota;Synergistia;Synergistales;Synergistaceae;EBM-39;";"100.0";"14.4";"9";"9";"9";"0";"0";"457174";"391198"
"V4mis2";"SILVA (only NR);Bacteria;Synergistota;Synergistia;Synergistales;Synergistaceae;Fretibacterium;";"94.5";"14.4";"181";"181";"171";"10";"0";"457002";"391036"
"V4mis2";"SILVA (only NR);Bacteria;Synergistota;Synergistia;Synergistales;Synergistaceae;JGI-0000079-D21;";"94.0";"14.4";"50";"50";"47";"3";"0";"457133";"391160"
"V4mis2";"SILVA (only NR);Bacteria;Synergistota;Synergistia;Synergistales;Synergistaceae;Jonquetella;";"100.0";"14.4";"1";"1";"1";"0";"0";"457182";"391206"
"V4mis2";"SILVA (only NR);Bacteria;Synergistota;Synergistia;Synergistales;Synergistaceae;Lactivibrio;";"93.3";"14.4";"15";"15";"14";"1";"0";"457168";"391193"
"V4mis2";"SILVA (only NR);Bacteria;Synergistota;Synergistia;Synergistales;Synergistaceae;Pyramidobacter;";"86.2";"14.4";"29";"29";"25";"4";"0";"457154";"391182"
"V4mis2";"SILVA (only NR);Bacteria;Synergistota;Synergistia;Synergistales;Synergistaceae;Syner-01;";"100.0";"14.4";"48";"48";"48";"0";"0";"457135";"391159"
"V4mis2";"SILVA (only NR);Bacteria;Synergistota;Synergistia;Synergistales;Synergistaceae;Synergistes;";"100.0";"14.4";"4";"4";"4";"0";"0";"457179";"391203"
"V4mis2";"SILVA (only NR);Bacteria;Synergistota;Synergistia;Synergistales;Synergistaceae;Thermanaerovibrio;";"100.0";"14.4";"4";"4";"4";"0";"0";"457179";"391203"
"V4mis2";"SILVA (only NR);Bacteria;Synergistota;Synergistia;Synergistales;Synergistaceae;Thermovirga;";"96.6";"14.4";"88";"88";"85";"3";"0";"457095";"391122"
"V4mis2";"SILVA (only NR);Bacteria;Synergistota;Synergistia;Synergistales;Synergistaceae;uncultured;";"96.9";"14.4";"358";"358";"347";"11";"0";"456825";"390860"
"V4mis2";"SILVA (only NR);Bacteria;TA06;";"100.0";"14.4";"72";"72";"72";"0";"0";"457111";"391135"
"V4mis2";"SILVA (only NR);Bacteria;TX1A-33;";"100.0";"14.4";"4";"4";"4";"0";"0";"457179";"391203"
"V4mis2";"SILVA (only NR);Bacteria;Thermodesulfobiota;";"100.0";"14.4";"7";"7";"7";"0";"0";"457176";"391200"
"V4mis2";"SILVA (only NR);Bacteria;Thermodesulfobiota;Thermodesulfobiia;";"100.0";"14.4";"7";"7";"7";"0";"0";"457176";"391200"
"V4mis2";"SILVA (only NR);Bacteria;Thermodesulfobiota;Thermodesulfobiia;Thermodesulfobiales;";"100.0";"14.4";"7";"7";"7";"0";"0";"457176";"391200"
"V4mis2";"SILVA (only NR);Bacteria;Thermodesulfobiota;Thermodesulfobiia;Thermodesulfobiales;Thermodesulfobiaceae;";"100.0";"14.4";"7";"7";"7";"0";"0";"457176";"391200"
"V4mis2";"SILVA (only NR);Bacteria;Thermodesulfobiota;Thermodesulfobiia;Thermodesulfobiales;Thermodesulfobiaceae;Thermodesulfobium;";"100.0";"14.4";"7";"7";"7";"0";"0";"457176";"391200"
"V4mis2";"SILVA (only NR);Bacteria;Thermosulfidibacterota;";"100.0";"14.4";"3";"3";"3";"0";"0";"457180";"391204"
"V4mis2";"SILVA (only NR);Bacteria;Thermosulfidibacterota;Thermosulfidibacteria;";"100.0";"14.4";"3";"3";"3";"0";"0";"457180";"391204"
"V4mis2";"SILVA (only NR);Bacteria;Thermosulfidibacterota;Thermosulfidibacteria;Thermosulfidibacterales;";"100.0";"14.4";"3";"3";"3";"0";"0";"457180";"391204"
"V4mis2";"SILVA (only NR);Bacteria;Thermosulfidibacterota;Thermosulfidibacteria;Thermosulfidibacterales;Thermosulfidibacteraceae;";"100.0";"14.4";"3";"3";"3";"0";"0";"457180";"391204"
"V4mis2";"SILVA (only NR);Bacteria;Thermosulfidibacterota;Thermosulfidibacteria;Thermosulfidibacterales;Thermosulfidibacteraceae;Thermosulfidibacter;";"100.0";"14.4";"3";"3";"3";"0";"0";"457180";"391204"
"V4mis2";"SILVA (only NR);Bacteria;Thermotogota;";"95.5";"14.4";"288";"288";"275";"13";"0";"456895";"390932"
"V4mis2";"SILVA (only NR);Bacteria;Thermotogota;Thermotogae;";"95.5";"14.4";"288";"288";"275";"13";"0";"456895";"390932"
"V4mis2";"SILVA (only NR);Bacteria;Thermotogota;Thermotogae;Kosmotogales;";"97.8";"14.4";"46";"46";"45";"1";"0";"457137";"391162"
"V4mis2";"SILVA (only NR);Bacteria;Thermotogota;Thermotogae;Kosmotogales;Kosmotogaceae;";"97.8";"14.4";"46";"46";"45";"1";"0";"457137";"391162"
"V4mis2";"SILVA (only NR);Bacteria;Thermotogota;Thermotogae;Kosmotogales;Kosmotogaceae;Kosmotoga;";"100.0";"14.4";"7";"7";"7";"0";"0";"457176";"391200"
"V4mis2";"SILVA (only NR);Bacteria;Thermotogota;Thermotogae;Kosmotogales;Kosmotogaceae;Mesotoga;";"97.1";"14.4";"34";"34";"33";"1";"0";"457149";"391174"
"V4mis2";"SILVA (only NR);Bacteria;Thermotogota;Thermotogae;Kosmotogales;Kosmotogaceae;uncultured;";"100.0";"14.4";"5";"5";"5";"0";"0";"457178";"391202"
"V4mis2";"SILVA (only NR);Bacteria;Thermotogota;Thermotogae;Mesoaciditogales;";"100.0";"14.4";"15";"15";"15";"0";"0";"457168";"391192"
"V4mis2";"SILVA (only NR);Bacteria;Thermotogota;Thermotogae;Mesoaciditogales;Mesoaciditogaceae;";"100.0";"14.4";"15";"15";"15";"0";"0";"457168";"391192"
"V4mis2";"SILVA (only NR);Bacteria;Thermotogota;Thermotogae;Mesoaciditogales;Mesoaciditogaceae;Mesoaciditoga;";"100.0";"14.4";"13";"13";"13";"0";"0";"457170";"391194"
"V4mis2";"SILVA (only NR);Bacteria;Thermotogota;Thermotogae;Mesoaciditogales;Mesoaciditogaceae;uncultured;";"100.0";"14.4";"2";"2";"2";"0";"0";"457181";"391205"
"V4mis2";"SILVA (only NR);Bacteria;Thermotogota;Thermotogae;Petrotogales;";"91.6";"14.4";"95";"95";"87";"8";"0";"457088";"391120"
"V4mis2";"SILVA (only NR);Bacteria;Thermotogota;Thermotogae;Petrotogales;Petrotogaceae;";"91.6";"14.4";"95";"95";"87";"8";"0";"457088";"391120"
"V4mis2";"SILVA (only NR);Bacteria;Thermotogota;Thermotogae;Petrotogales;Petrotogaceae;AUTHM297;";"75.0";"14.4";"4";"4";"3";"1";"0";"457179";"391204"
"V4mis2";"SILVA (only NR);Bacteria;Thermotogota;Thermotogae;Petrotogales;Petrotogaceae;Defluviitoga;";"79.4";"14.4";"34";"34";"27";"7";"0";"457149";"391180"
"V4mis2";"SILVA (only NR);Bacteria;Thermotogota;Thermotogae;Petrotogales;Petrotogaceae;Geotoga;";"100.0";"14.4";"4";"4";"4";"0";"0";"457179";"391203"
"V4mis2";"SILVA (only NR);Bacteria;Thermotogota;Thermotogae;Petrotogales;Petrotogaceae;Marinitoga;";"100.0";"14.4";"10";"10";"10";"0";"0";"457173";"391197"
"V4mis2";"SILVA (only NR);Bacteria;Thermotogota;Thermotogae;Petrotogales;Petrotogaceae;Oceanotoga;";"100.0";"14.4";"2";"2";"2";"0";"0";"457181";"391205"
"V4mis2";"SILVA (only NR);Bacteria;Thermotogota;Thermotogae;Petrotogales;Petrotogaceae;Petrotoga;";"100.0";"14.4";"16";"16";"16";"0";"0";"457167";"391191"
"V4mis2";"SILVA (only NR);Bacteria;Thermotogota;Thermotogae;Petrotogales;Petrotogaceae;SC103;";"100.0";"14.4";"24";"24";"24";"0";"0";"457159";"391183"
"V4mis2";"SILVA (only NR);Bacteria;Thermotogota;Thermotogae;Thermotogales;";"96.9";"14.4";"129";"129";"125";"4";"0";"457054";"391082"
"V4mis2";"SILVA (only NR);Bacteria;Thermotogota;Thermotogae;Thermotogales;Fervidobacteriaceae;";"98.6";"14.4";"74";"74";"73";"1";"0";"457109";"391134"
"V4mis2";"SILVA (only NR);Bacteria;Thermotogota;Thermotogae;Thermotogales;Fervidobacteriaceae;Fervidobacterium;";"97.9";"14.4";"48";"48";"47";"1";"0";"457135";"391160"
"V4mis2";"SILVA (only NR);Bacteria;Thermotogota;Thermotogae;Thermotogales;Fervidobacteriaceae;Thermopallium;";"100.0";"14.4";"3";"3";"3";"0";"0";"457180";"391204"
"V4mis2";"SILVA (only NR);Bacteria;Thermotogota;Thermotogae;Thermotogales;Fervidobacteriaceae;Thermosipho;";"100.0";"14.4";"23";"23";"23";"0";"0";"457160";"391184"
"V4mis2";"SILVA (only NR);Bacteria;Thermotogota;Thermotogae;Thermotogales;Thermotogaceae;";"94.5";"14.4";"55";"55";"52";"3";"0";"457128";"391155"
"V4mis2";"SILVA (only NR);Bacteria;Thermotogota;Thermotogae;Thermotogales;Thermotogaceae;Pseudothermotoga;";"92.6";"14.4";"27";"27";"25";"2";"0";"457156";"391182"
"V4mis2";"SILVA (only NR);Bacteria;Thermotogota;Thermotogae;Thermotogales;Thermotogaceae;Thermotoga;";"96.4";"14.4";"28";"28";"27";"1";"0";"457155";"391180"
"V4mis2";"SILVA (only NR);Bacteria;Thermotogota;Thermotogae;uncultured;";"100.0";"14.4";"2";"2";"2";"0";"0";"457181";"391205"
"V4mis2";"SILVA (only NR);Bacteria;Verrucomicrobiota;";"95.7";"14.6";"6648";"6648";"6364";"284";"0";"450535";"384843"
"V4mis2";"SILVA (only NR);Bacteria;Verrucomicrobiota;Chlamydiae;";"96.5";"14.4";"519";"519";"501";"18";"0";"456664";"390706"
"V4mis2";"SILVA (only NR);Bacteria;Verrucomicrobiota;Chlamydiae;Chlamydiales;";"97.2";"14.4";"433";"433";"421";"12";"0";"456750";"390786"
"V4mis2";"SILVA (only NR);Bacteria;Verrucomicrobiota;Chlamydiae;Chlamydiales;Chlamydiaceae;";"99.6";"14.4";"251";"251";"250";"1";"0";"456932";"390957"
"V4mis2";"SILVA (only NR);Bacteria;Verrucomicrobiota;Chlamydiae;Chlamydiales;Chlamydiaceae;Candidatus Amphibiichlamydia;";"100.0";"14.4";"3";"3";"3";"0";"0";"457180";"391204"
"V4mis2";"SILVA (only NR);Bacteria;Verrucomicrobiota;Chlamydiae;Chlamydiales;Chlamydiaceae;Candidatus Clavichlamydia;";"100.0";"14.4";"2";"2";"2";"0";"0";"457181";"391205"
"V4mis2";"SILVA (only NR);Bacteria;Verrucomicrobiota;Chlamydiae;Chlamydiales;Chlamydiaceae;Chlamydia;";"100.0";"14.4";"233";"233";"233";"0";"0";"456950";"390974"
"V4mis2";"SILVA (only NR);Bacteria;Verrucomicrobiota;Chlamydiae;Chlamydiales;Chlamydiaceae;uncultured;";"90.0";"14.4";"10";"10";"9";"1";"0";"457173";"391198"
"V4mis2";"SILVA (only NR);Bacteria;Verrucomicrobiota;Chlamydiae;Chlamydiales;Chlamydiales Incertae Sedis;";"100.0";"14.4";"15";"15";"15";"0";"0";"457168";"391192"
"V4mis2";"SILVA (only NR);Bacteria;Verrucomicrobiota;Chlamydiae;Chlamydiales;Chlamydiales Incertae Sedis;Candidatus Piscichlamydia;";"100.0";"14.4";"3";"3";"3";"0";"0";"457180";"391204"
"V4mis2";"SILVA (only NR);Bacteria;Verrucomicrobiota;Chlamydiae;Chlamydiales;Chlamydiales Incertae Sedis;Candidatus Similichlamydia;";"100.0";"14.4";"11";"11";"11";"0";"0";"457172";"391196"
"V4mis2";"SILVA (only NR);Bacteria;Verrucomicrobiota;Chlamydiae;Chlamydiales;Criblamydiaceae;";"100.0";"14.4";"6";"6";"6";"0";"0";"457177";"391201"
"V4mis2";"SILVA (only NR);Bacteria;Verrucomicrobiota;Chlamydiae;Chlamydiales;Criblamydiaceae;Criblamydia;";"100.0";"14.4";"1";"1";"1";"0";"0";"457182";"391206"
"V4mis2";"SILVA (only NR);Bacteria;Verrucomicrobiota;Chlamydiae;Chlamydiales;Criblamydiaceae;Estrella;";"100.0";"14.4";"1";"1";"1";"0";"0";"457182";"391206"
"V4mis2";"SILVA (only NR);Bacteria;Verrucomicrobiota;Chlamydiae;Chlamydiales;Criblamydiaceae;uncultured;";"100.0";"14.4";"2";"2";"2";"0";"0";"457181";"391205"
"V4mis2";"SILVA (only NR);Bacteria;Verrucomicrobiota;Chlamydiae;Chlamydiales;Parachlamydiaceae;";"100.0";"14.4";"62";"62";"62";"0";"0";"457121";"391145"
"V4mis2";"SILVA (only NR);Bacteria;Verrucomicrobiota;Chlamydiae;Chlamydiales;Parachlamydiaceae;Candidatus Mesochlamydia;";"100.0";"14.4";"1";"1";"1";"0";"0";"457182";"391206"
"V4mis2";"SILVA (only NR);Bacteria;Verrucomicrobiota;Chlamydiae;Chlamydiales;Parachlamydiaceae;Candidatus Metachlamydia;";"100.0";"14.4";"1";"1";"1";"0";"0";"457182";"391206"
"V4mis2";"SILVA (only NR);Bacteria;Verrucomicrobiota;Chlamydiae;Chlamydiales;Parachlamydiaceae;Candidatus Protochlamydia;";"100.0";"14.4";"19";"19";"19";"0";"0";"457164";"391188"
"V4mis2";"SILVA (only NR);Bacteria;Verrucomicrobiota;Chlamydiae;Chlamydiales;Parachlamydiaceae;Candidatus Rubidus;";"100.0";"14.4";"1";"1";"1";"0";"0";"457182";"391206"
"V4mis2";"SILVA (only NR);Bacteria;Verrucomicrobiota;Chlamydiae;Chlamydiales;Parachlamydiaceae;Neochlamydia;";"100.0";"14.4";"25";"25";"25";"0";"0";"457158";"391182"
"V4mis2";"SILVA (only NR);Bacteria;Verrucomicrobiota;Chlamydiae;Chlamydiales;Parachlamydiaceae;Parachlamydia;";"100.0";"14.4";"6";"6";"6";"0";"0";"457177";"391201"
"V4mis2";"SILVA (only NR);Bacteria;Verrucomicrobiota;Chlamydiae;Chlamydiales;Parachlamydiaceae;uncultured;";"100.0";"14.4";"7";"7";"7";"0";"0";"457176";"391200"
"V4mis2";"SILVA (only NR);Bacteria;Verrucomicrobiota;Chlamydiae;Chlamydiales;Simkaniaceae;";"87.1";"14.4";"70";"70";"61";"9";"0";"457113";"391146"
"V4mis2";"SILVA (only NR);Bacteria;Verrucomicrobiota;Chlamydiae;Chlamydiales;Simkaniaceae;Candidatus Fritschea;";"100.0";"14.4";"5";"5";"5";"0";"0";"457178";"391202"
"V4mis2";"SILVA (only NR);Bacteria;Verrucomicrobiota;Chlamydiae;Chlamydiales;Simkaniaceae;Candidatus Renichlamydia;";"100.0";"14.4";"2";"2";"2";"0";"0";"457181";"391205"
"V4mis2";"SILVA (only NR);Bacteria;Verrucomicrobiota;Chlamydiae;Chlamydiales;Simkaniaceae;Candidatus Rhabdochlamydia;";"100.0";"14.4";"6";"6";"6";"0";"0";"457177";"391201"
"V4mis2";"SILVA (only NR);Bacteria;Verrucomicrobiota;Chlamydiae;Chlamydiales;Simkaniaceae;Ga0074140;";"100.0";"14.4";"3";"3";"3";"0";"0";"457180";"391204"
"V4mis2";"SILVA (only NR);Bacteria;Verrucomicrobiota;Chlamydiae;Chlamydiales;Simkaniaceae;Simkania;";"100.0";"14.4";"2";"2";"2";"0";"0";"457181";"391205"
"V4mis2";"SILVA (only NR);Bacteria;Verrucomicrobiota;Chlamydiae;Chlamydiales;Simkaniaceae;uncultured;";"82.4";"14.4";"51";"51";"42";"9";"0";"457132";"391165"
"V4mis2";"SILVA (only NR);Bacteria;Verrucomicrobiota;Chlamydiae;Chlamydiales;Waddliaceae;";"100.0";"14.4";"6";"6";"6";"0";"0";"457177";"391201"
"V4mis2";"SILVA (only NR);Bacteria;Verrucomicrobiota;Chlamydiae;Chlamydiales;Waddliaceae;Waddlia;";"100.0";"14.4";"6";"6";"6";"0";"0";"457177";"391201"
"V4mis2";"SILVA (only NR);Bacteria;Verrucomicrobiota;Chlamydiae;Chlamydiales;cvE6;";"90.9";"14.4";"22";"22";"20";"2";"0";"457161";"391187"
"V4mis2";"SILVA (only NR);Bacteria;Verrucomicrobiota;Chlamydiae;LD1-PA32;";"93.0";"14.4";"86";"86";"80";"6";"0";"457097";"391127"
"V4mis2";"SILVA (only NR);Bacteria;Verrucomicrobiota;Kiritimatiellae;";"95.4";"14.5";"971";"971";"926";"45";"0";"456212";"390281"
"V4mis2";"SILVA (only NR);Bacteria;Verrucomicrobiota;Kiritimatiellae;113B434;";"100.0";"14.4";"4";"4";"4";"0";"0";"457179";"391203"
"V4mis2";"SILVA (only NR);Bacteria;Verrucomicrobiota;Kiritimatiellae;Kiritimatiellales;";"95.3";"14.4";"106";"106";"101";"5";"0";"457077";"391106"
"V4mis2";"SILVA (only NR);Bacteria;Verrucomicrobiota;Kiritimatiellae;Kiritimatiellales;Kiritimatiellaceae;";"95.3";"14.4";"106";"106";"101";"5";"0";"457077";"391106"
"V4mis2";"SILVA (only NR);Bacteria;Verrucomicrobiota;Kiritimatiellae;Kiritimatiellales;Kiritimatiellaceae;Kiritimatiella;";"100.0";"14.4";"3";"3";"3";"0";"0";"457180";"391204"
"V4mis2";"SILVA (only NR);Bacteria;Verrucomicrobiota;Kiritimatiellae;Kiritimatiellales;Kiritimatiellaceae;MSBL3;";"97.2";"14.4";"36";"36";"35";"1";"0";"457147";"391172"
"V4mis2";"SILVA (only NR);Bacteria;Verrucomicrobiota;Kiritimatiellae;Kiritimatiellales;Kiritimatiellaceae;R76-B128;";"95.4";"14.4";"65";"65";"62";"3";"0";"457118";"391145"
"V4mis2";"SILVA (only NR);Bacteria;Verrucomicrobiota;Kiritimatiellae;Kiritimatiellales;Kiritimatiellaceae;uncultured;";"50.0";"14.4";"2";"2";"1";"1";"0";"457181";"391206"
"V4mis2";"SILVA (only NR);Bacteria;Verrucomicrobiota;Kiritimatiellae;WCHB1-41;";"95.4";"14.4";"861";"861";"821";"40";"0";"456322";"390386"
"V4mis2";"SILVA (only NR);Bacteria;Verrucomicrobiota;Lentisphaeria;";"97.7";"14.4";"472";"472";"461";"11";"0";"456711";"390746"
"V4mis2";"SILVA (only NR);Bacteria;Verrucomicrobiota;Lentisphaeria;Lentisphaerales;";"90.9";"14.4";"33";"33";"30";"3";"0";"457150";"391177"
"V4mis2";"SILVA (only NR);Bacteria;Verrucomicrobiota;Lentisphaeria;Lentisphaerales;Lentisphaeraceae;";"90.9";"14.4";"33";"33";"30";"3";"0";"457150";"391177"
"V4mis2";"SILVA (only NR);Bacteria;Verrucomicrobiota;Lentisphaeria;Lentisphaerales;Lentisphaeraceae;Lentisphaera;";"90.9";"14.4";"33";"33";"30";"3";"0";"457150";"391177"
"V4mis2";"SILVA (only NR);Bacteria;Verrucomicrobiota;Lentisphaeria;Oligosphaerales;";"97.0";"14.4";"198";"198";"192";"6";"0";"456985";"391015"
"V4mis2";"SILVA (only NR);Bacteria;Verrucomicrobiota;Lentisphaeria;Oligosphaerales;Lenti-02;";"94.6";"14.4";"112";"112";"106";"6";"0";"457071";"391101"
"V4mis2";"SILVA (only NR);Bacteria;Verrucomicrobiota;Lentisphaeria;Oligosphaerales;Oligosphaeraceae;";"100.0";"14.4";"84";"84";"84";"0";"0";"457099";"391123"
"V4mis2";"SILVA (only NR);Bacteria;Verrucomicrobiota;Lentisphaeria;Oligosphaerales;Oligosphaeraceae;ADurb.Bin063-2;";"100.0";"14.4";"16";"16";"16";"0";"0";"457167";"391191"
"V4mis2";"SILVA (only NR);Bacteria;Verrucomicrobiota;Lentisphaeria;Oligosphaerales;Oligosphaeraceae;Oligosphaera;";"100.0";"14.4";"4";"4";"4";"0";"0";"457179";"391203"
"V4mis2";"SILVA (only NR);Bacteria;Verrucomicrobiota;Lentisphaeria;Oligosphaerales;Oligosphaeraceae;SBZC-1223;";"100.0";"14.4";"6";"6";"6";"0";"0";"457177";"391201"
"V4mis2";"SILVA (only NR);Bacteria;Verrucomicrobiota;Lentisphaeria;Oligosphaerales;Oligosphaeraceae;Z20;";"100.0";"14.4";"37";"37";"37";"0";"0";"457146";"391170"
"V4mis2";"SILVA (only NR);Bacteria;Verrucomicrobiota;Lentisphaeria;Oligosphaerales;Oligosphaeraceae;horsej-a03;";"100.0";"14.4";"18";"18";"18";"0";"0";"457165";"391189"
"V4mis2";"SILVA (only NR);Bacteria;Verrucomicrobiota;Lentisphaeria;Oligosphaerales;uncultured;";"100.0";"14.4";"2";"2";"2";"0";"0";"457181";"391205"
"V4mis2";"SILVA (only NR);Bacteria;Verrucomicrobiota;Lentisphaeria;P.palmC41;";"100.0";"14.4";"25";"25";"25";"0";"0";"457158";"391182"
"V4mis2";"SILVA (only NR);Bacteria;Verrucomicrobiota;Lentisphaeria;SS1-B-02-17;";"96.2";"14.4";"52";"52";"50";"2";"0";"457131";"391157"
"V4mis2";"SILVA (only NR);Bacteria;Verrucomicrobiota;Lentisphaeria;Victivallales;";"100.0";"14.4";"164";"164";"164";"0";"0";"457019";"391043"
"V4mis2";"SILVA (only NR);Bacteria;Verrucomicrobiota;Lentisphaeria;Victivallales;Arctic95B-14;";"100.0";"14.4";"12";"12";"12";"0";"0";"457171";"391195"
"V4mis2";"SILVA (only NR);Bacteria;Verrucomicrobiota;Lentisphaeria;Victivallales;BD2-3;";"100.0";"14.4";"10";"10";"10";"0";"0";"457173";"391197"
"V4mis2";"SILVA (only NR);Bacteria;Verrucomicrobiota;Lentisphaeria;Victivallales;GWF2-44-16;";"100.0";"14.4";"17";"17";"17";"0";"0";"457166";"391190"
"V4mis2";"SILVA (only NR);Bacteria;Verrucomicrobiota;Lentisphaeria;Victivallales;PRD18C08;";"100.0";"14.4";"16";"16";"16";"0";"0";"457167";"391191"
"V4mis2";"SILVA (only NR);Bacteria;Verrucomicrobiota;Lentisphaeria;Victivallales;SBYX-4944;";"100.0";"14.4";"6";"6";"6";"0";"0";"457177";"391201"
"V4mis2";"SILVA (only NR);Bacteria;Verrucomicrobiota;Lentisphaeria;Victivallales;SBZC-4624;";"100.0";"14.4";"5";"5";"5";"0";"0";"457178";"391202"
"V4mis2";"SILVA (only NR);Bacteria;Verrucomicrobiota;Lentisphaeria;Victivallales;Victivallaceae;";"100.0";"14.4";"52";"52";"52";"0";"0";"457131";"391155"
"V4mis2";"SILVA (only NR);Bacteria;Verrucomicrobiota;Lentisphaeria;Victivallales;Victivallaceae;Victivallis;";"100.0";"14.4";"15";"15";"15";"0";"0";"457168";"391192"
"V4mis2";"SILVA (only NR);Bacteria;Verrucomicrobiota;Lentisphaeria;Victivallales;vadinBE97;";"100.0";"14.4";"42";"42";"42";"0";"0";"457141";"391165"
"V4mis2";"SILVA (only NR);Bacteria;Verrucomicrobiota;Omnitrophia;";"96.9";"14.4";"520";"520";"504";"16";"0";"456663";"390703"
"V4mis2";"SILVA (only NR);Bacteria;Verrucomicrobiota;Omnitrophia;Omnitrophales;";"96.9";"14.4";"519";"519";"503";"16";"0";"456664";"390704"
"V4mis2";"SILVA (only NR);Bacteria;Verrucomicrobiota;Omnitrophia;Omnitrophales;Omnitrophaceae;";"96.2";"14.4";"426";"426";"410";"16";"0";"456757";"390797"
"V4mis2";"SILVA (only NR);Bacteria;Verrucomicrobiota;Omnitrophia;Omnitrophales;Omnitrophaceae;Candidatus Omnitrophus;";"96.2";"14.4";"426";"426";"410";"16";"0";"456757";"390797"
"V4mis2";"SILVA (only NR);Bacteria;Verrucomicrobiota;Omnitrophia;Omnitrophales;koll11;";"100.0";"14.4";"16";"16";"16";"0";"0";"457167";"391191"
"V4mis2";"SILVA (only NR);Bacteria;Verrucomicrobiota;Verrucomicrobiae;";"95.3";"14.5";"4166";"4166";"3972";"194";"0";"453017";"387235"
"V4mis2";"SILVA (only NR);Bacteria;Verrucomicrobiota;Verrucomicrobiae;Arctic97B-4 marine group;";"97.5";"14.4";"80";"80";"78";"2";"0";"457103";"391129"
"V4mis2";"SILVA (only NR);Bacteria;Verrucomicrobiota;Verrucomicrobiae;B29;";"100.0";"14.4";"2";"2";"2";"0";"0";"457181";"391205"
"V4mis2";"SILVA (only NR);Bacteria;Verrucomicrobiota;Verrucomicrobiae;Chthoniobacterales;";"95.4";"14.5";"1004";"1004";"958";"46";"0";"456179";"390249"
"V4mis2";"SILVA (only NR);Bacteria;Verrucomicrobiota;Verrucomicrobiae;Chthoniobacterales;01D2Z36;";"90.2";"14.4";"132";"132";"119";"13";"0";"457051";"391088"
"V4mis2";"SILVA (only NR);Bacteria;Verrucomicrobiota;Verrucomicrobiae;Chthoniobacterales;Chthoniobacteraceae;";"96.0";"14.4";"724";"724";"695";"29";"0";"456459";"390512"
"V4mis2";"SILVA (only NR);Bacteria;Verrucomicrobiota;Verrucomicrobiae;Chthoniobacterales;Chthoniobacteraceae;Candidatus Udaeobacter;";"96.0";"14.4";"397";"397";"381";"16";"0";"456786";"390826"
"V4mis2";"SILVA (only NR);Bacteria;Verrucomicrobiota;Verrucomicrobiae;Chthoniobacterales;Chthoniobacteraceae;Chthoniobacter;";"96.7";"14.4";"274";"274";"265";"9";"0";"456909";"390942"
"V4mis2";"SILVA (only NR);Bacteria;Verrucomicrobiota;Verrucomicrobiae;Chthoniobacterales;Chthoniobacteraceae;LD29;";"92.2";"14.4";"51";"51";"47";"4";"0";"457132";"391160"
"V4mis2";"SILVA (only NR);Bacteria;Verrucomicrobiota;Verrucomicrobiae;Chthoniobacterales;Terrimicrobiaceae;";"97.1";"14.4";"70";"70";"68";"2";"0";"457113";"391139"
"V4mis2";"SILVA (only NR);Bacteria;Verrucomicrobiota;Verrucomicrobiae;Chthoniobacterales;Terrimicrobiaceae;FukuN18 freshwater group;";"100.0";"14.4";"20";"20";"20";"0";"0";"457163";"391187"
"V4mis2";"SILVA (only NR);Bacteria;Verrucomicrobiota;Verrucomicrobiae;Chthoniobacterales;Terrimicrobiaceae;Terrimicrobium;";"96.0";"14.4";"50";"50";"48";"2";"0";"457133";"391159"
"V4mis2";"SILVA (only NR);Bacteria;Verrucomicrobiota;Verrucomicrobiae;Chthoniobacterales;Xiphinematobacteraceae;";"97.0";"14.4";"66";"66";"64";"2";"0";"457117";"391143"
"V4mis2";"SILVA (only NR);Bacteria;Verrucomicrobiota;Verrucomicrobiae;Chthoniobacterales;Xiphinematobacteraceae;Candidatus Xiphinematobacter;";"97.0";"14.4";"66";"66";"64";"2";"0";"457117";"391143"
"V4mis2";"SILVA (only NR);Bacteria;Verrucomicrobiota;Verrucomicrobiae;Chthoniobacterales;uncultured;";"100.0";"14.4";"12";"12";"12";"0";"0";"457171";"391195"
"V4mis2";"SILVA (only NR);Bacteria;Verrucomicrobiota;Verrucomicrobiae;LD1-PB3;";"100.0";"14.4";"70";"70";"70";"0";"0";"457113";"391137"
"V4mis2";"SILVA (only NR);Bacteria;Verrucomicrobiota;Verrucomicrobiae;Methylacidiphilales;";"99.0";"14.4";"101";"101";"100";"1";"0";"457082";"391107"
"V4mis2";"SILVA (only NR);Bacteria;Verrucomicrobiota;Verrucomicrobiae;Methylacidiphilales;Methylacidiphilaceae;";"99.0";"14.4";"101";"101";"100";"1";"0";"457082";"391107"
"V4mis2";"SILVA (only NR);Bacteria;Verrucomicrobiota;Verrucomicrobiae;Methylacidiphilales;Methylacidiphilaceae;Candidatus Methylacidiphilum;";"100.0";"14.4";"14";"14";"14";"0";"0";"457169";"391193"
"V4mis2";"SILVA (only NR);Bacteria;Verrucomicrobiota;Verrucomicrobiae;Methylacidiphilales;Methylacidiphilaceae;uncultured;";"98.9";"14.4";"87";"87";"86";"1";"0";"457096";"391121"
"V4mis2";"SILVA (only NR);Bacteria;Verrucomicrobiota;Verrucomicrobiae;Opitutales;";"95.9";"14.4";"833";"833";"799";"34";"0";"456350";"390408"
"V4mis2";"SILVA (only NR);Bacteria;Verrucomicrobiota;Verrucomicrobiae;Opitutales;Opitutaceae;";"96.8";"14.4";"315";"315";"305";"10";"0";"456868";"390902"
"V4mis2";"SILVA (only NR);Bacteria;Verrucomicrobiota;Verrucomicrobiae;Opitutales;Opitutaceae;Alterococcus;";"92.9";"14.4";"14";"14";"13";"1";"0";"457169";"391194"
"V4mis2";"SILVA (only NR);Bacteria;Verrucomicrobiota;Verrucomicrobiae;Opitutales;Opitutaceae;Cephaloticoccus;";"90.6";"14.4";"32";"32";"29";"3";"0";"457151";"391178"
"V4mis2";"SILVA (only NR);Bacteria;Verrucomicrobiota;Verrucomicrobiae;Opitutales;Opitutaceae;Diplosphaera;";"100.0";"14.4";"14";"14";"14";"0";"0";"457169";"391193"
"V4mis2";"SILVA (only NR);Bacteria;Verrucomicrobiota;Verrucomicrobiae;Opitutales;Opitutaceae;Ereboglobus;";"100.0";"14.4";"10";"10";"10";"0";"0";"457173";"391197"
"V4mis2";"SILVA (only NR);Bacteria;Verrucomicrobiota;Verrucomicrobiae;Opitutales;Opitutaceae;IMCC26134;";"95.7";"14.4";"23";"23";"22";"1";"0";"457160";"391185"
"V4mis2";"SILVA (only NR);Bacteria;Verrucomicrobiota;Verrucomicrobiae;Opitutales;Opitutaceae;Lacunisphaera;";"98.9";"14.4";"95";"95";"94";"1";"0";"457088";"391113"
"V4mis2";"SILVA (only NR);Bacteria;Verrucomicrobiota;Verrucomicrobiae;Opitutales;Opitutaceae;Opitutus;";"97.2";"14.4";"106";"106";"103";"3";"0";"457077";"391104"
"V4mis2";"SILVA (only NR);Bacteria;Verrucomicrobiota;Verrucomicrobiae;Opitutales;Opitutaceae;uncultured;";"95.0";"14.4";"20";"20";"19";"1";"0";"457163";"391188"
"V4mis2";"SILVA (only NR);Bacteria;Verrucomicrobiota;Verrucomicrobiae;Opitutales;Puniceicoccaceae;";"95.5";"14.4";"515";"515";"492";"23";"0";"456668";"390715"
"V4mis2";"SILVA (only NR);Bacteria;Verrucomicrobiota;Verrucomicrobiae;Opitutales;Puniceicoccaceae;A714019;";"100.0";"14.4";"4";"4";"4";"0";"0";"457179";"391203"
"V4mis2";"SILVA (only NR);Bacteria;Verrucomicrobiota;Verrucomicrobiae;Opitutales;Puniceicoccaceae;Cerasicoccus;";"92.9";"14.4";"56";"56";"52";"4";"0";"457127";"391155"
"V4mis2";"SILVA (only NR);Bacteria;Verrucomicrobiota;Verrucomicrobiae;Opitutales;Puniceicoccaceae;Coraliomargarita;";"91.2";"14.4";"34";"34";"31";"3";"0";"457149";"391176"
"V4mis2";"SILVA (only NR);Bacteria;Verrucomicrobiota;Verrucomicrobiae;Opitutales;Puniceicoccaceae;Lentimonas;";"95.2";"14.4";"83";"83";"79";"4";"0";"457100";"391128"
"V4mis2";"SILVA (only NR);Bacteria;Verrucomicrobiota;Verrucomicrobiae;Opitutales;Puniceicoccaceae;MB11C04 marine group;";"97.5";"14.4";"79";"79";"77";"2";"0";"457104";"391130"
"V4mis2";"SILVA (only NR);Bacteria;Verrucomicrobiota;Verrucomicrobiae;Opitutales;Puniceicoccaceae;Pelagicoccus;";"100.0";"14.4";"19";"19";"19";"0";"0";"457164";"391188"
"V4mis2";"SILVA (only NR);Bacteria;Verrucomicrobiota;Verrucomicrobiae;Opitutales;Puniceicoccaceae;Puniceicoccus;";"96.3";"14.4";"134";"134";"129";"5";"0";"457049";"391078"
"V4mis2";"SILVA (only NR);Bacteria;Verrucomicrobiota;Verrucomicrobiae;Opitutales;Puniceicoccaceae;Verruc-01;";"96.6";"14.4";"89";"89";"86";"3";"0";"457094";"391121"
"V4mis2";"SILVA (only NR);Bacteria;Verrucomicrobiota;Verrucomicrobiae;Opitutales;Puniceicoccaceae;uncultured;";"87.5";"14.4";"16";"16";"14";"2";"0";"457167";"391193"
"V4mis2";"SILVA (only NR);Bacteria;Verrucomicrobiota;Verrucomicrobiae;Opitutales;uncultured;";"66.7";"14.4";"3";"3";"2";"1";"0";"457180";"391205"
"V4mis2";"SILVA (only NR);Bacteria;Verrucomicrobiota;Verrucomicrobiae;Pedosphaerales;";"95.6";"14.4";"770";"770";"736";"34";"0";"456413";"390471"
"V4mis2";"SILVA (only NR);Bacteria;Verrucomicrobiota;Verrucomicrobiae;Pedosphaerales;Pedosphaeraceae;";"95.6";"14.4";"770";"770";"736";"34";"0";"456413";"390471"
"V4mis2";"SILVA (only NR);Bacteria;Verrucomicrobiota;Verrucomicrobiae;Pedosphaerales;Pedosphaeraceae;ADurb.Bin063-1;";"98.7";"14.4";"77";"77";"76";"1";"0";"457106";"391131"
"V4mis2";"SILVA (only NR);Bacteria;Verrucomicrobiota;Verrucomicrobiae;Pedosphaerales;Pedosphaeraceae;ADurb.Bin118;";"100.0";"14.4";"9";"9";"9";"0";"0";"457174";"391198"
"V4mis2";"SILVA (only NR);Bacteria;Verrucomicrobiota;Verrucomicrobiae;Pedosphaerales;Pedosphaeraceae;DEV008;";"95.8";"14.4";"24";"24";"23";"1";"0";"457159";"391184"
"V4mis2";"SILVA (only NR);Bacteria;Verrucomicrobiota;Verrucomicrobiae;Pedosphaerales;Pedosphaeraceae;DEV114;";"93.1";"14.4";"29";"29";"27";"2";"0";"457154";"391180"
"V4mis2";"SILVA (only NR);Bacteria;Verrucomicrobiota;Verrucomicrobiae;Pedosphaerales;Pedosphaeraceae;Ellin516;";"91.7";"14.4";"24";"24";"22";"2";"0";"457159";"391185"
"V4mis2";"SILVA (only NR);Bacteria;Verrucomicrobiota;Verrucomicrobiae;Pedosphaerales;Pedosphaeraceae;Ellin517;";"97.1";"14.4";"34";"34";"33";"1";"0";"457149";"391174"
"V4mis2";"SILVA (only NR);Bacteria;Verrucomicrobiota;Verrucomicrobiae;Pedosphaerales;Pedosphaeraceae;Limisphaera;";"75.0";"14.4";"4";"4";"3";"1";"0";"457179";"391204"
"V4mis2";"SILVA (only NR);Bacteria;Verrucomicrobiota;Verrucomicrobiae;Pedosphaerales;Pedosphaeraceae;Oikopleura;";"90.0";"14.4";"20";"20";"18";"2";"0";"457163";"391189"
"V4mis2";"SILVA (only NR);Bacteria;Verrucomicrobiota;Verrucomicrobiae;Pedosphaerales;Pedosphaeraceae;Pedosphaera;";"91.7";"14.4";"12";"12";"11";"1";"0";"457171";"391196"
"V4mis2";"SILVA (only NR);Bacteria;Verrucomicrobiota;Verrucomicrobiae;Pedosphaerales;Pedosphaeraceae;RS25G;";"100.0";"14.4";"2";"2";"2";"0";"0";"457181";"391205"
"V4mis2";"SILVA (only NR);Bacteria;Verrucomicrobiota;Verrucomicrobiae;Pedosphaerales;Pedosphaeraceae;SCGC AAA164-E04;";"100.0";"14.4";"23";"23";"23";"0";"0";"457160";"391184"
"V4mis2";"SILVA (only NR);Bacteria;Verrucomicrobiota;Verrucomicrobiae;Pedosphaerales;Pedosphaeraceae;SH3-11;";"90.3";"14.4";"31";"31";"28";"3";"0";"457152";"391179"
"V4mis2";"SILVA (only NR);Bacteria;Verrucomicrobiota;Verrucomicrobiae;Pedosphaerales;Pedosphaeraceae;uncultured;";"96.8";"14.4";"125";"125";"121";"4";"0";"457058";"391086"
"V4mis2";"SILVA (only NR);Bacteria;Verrucomicrobiota;Verrucomicrobiae;S-BQ2-57 soil group;";"100.0";"14.4";"38";"38";"38";"0";"0";"457145";"391169"
"V4mis2";"SILVA (only NR);Bacteria;Verrucomicrobiota;Verrucomicrobiae;UA11;";"100.0";"14.4";"2";"2";"2";"0";"0";"457181";"391205"
"V4mis2";"SILVA (only NR);Bacteria;Verrucomicrobiota;Verrucomicrobiae;Verrucomicrobiales;";"93.8";"14.5";"1241";"1241";"1164";"77";"0";"455942";"390043"
"V4mis2";"SILVA (only NR);Bacteria;Verrucomicrobiota;Verrucomicrobiae;Verrucomicrobiales;Akkermansiaceae;";"88.9";"14.4";"470";"470";"418";"52";"0";"456713";"390789"
"V4mis2";"SILVA (only NR);Bacteria;Verrucomicrobiota;Verrucomicrobiae;Verrucomicrobiales;Akkermansiaceae;Akkermansia;";"88.9";"14.4";"470";"470";"418";"52";"0";"456713";"390789"
"V4mis2";"SILVA (only NR);Bacteria;Verrucomicrobiota;Verrucomicrobiae;Verrucomicrobiales;DEV007;";"97.2";"14.4";"141";"141";"137";"4";"0";"457042";"391070"
"V4mis2";"SILVA (only NR);Bacteria;Verrucomicrobiota;Verrucomicrobiae;Verrucomicrobiales;Rubritaleaceae;";"96.1";"14.4";"413";"413";"397";"16";"0";"456770";"390810"
"V4mis2";"SILVA (only NR);Bacteria;Verrucomicrobiota;Verrucomicrobiae;Verrucomicrobiales;Rubritaleaceae;DBS1;";"100.0";"14.4";"10";"10";"10";"0";"0";"457173";"391197"
"V4mis2";"SILVA (only NR);Bacteria;Verrucomicrobiota;Verrucomicrobiae;Verrucomicrobiales;Rubritaleaceae;Haloferula;";"93.1";"14.4";"29";"29";"27";"2";"0";"457154";"391180"
"V4mis2";"SILVA (only NR);Bacteria;Verrucomicrobiota;Verrucomicrobiae;Verrucomicrobiales;Rubritaleaceae;Luteolibacter;";"96.2";"14.4";"211";"211";"203";"8";"0";"456972";"391004"
"V4mis2";"SILVA (only NR);Bacteria;Verrucomicrobiota;Verrucomicrobiae;Verrucomicrobiales;Rubritaleaceae;Persicirhabdus;";"96.9";"14.4";"32";"32";"31";"1";"0";"457151";"391176"
"V4mis2";"SILVA (only NR);Bacteria;Verrucomicrobiota;Verrucomicrobiae;Verrucomicrobiales;Rubritaleaceae;Roseibacillus;";"95.2";"14.4";"63";"63";"60";"3";"0";"457120";"391147"
"V4mis2";"SILVA (only NR);Bacteria;Verrucomicrobiota;Verrucomicrobiae;Verrucomicrobiales;Rubritaleaceae;Rubritalea;";"96.9";"14.4";"64";"64";"62";"2";"0";"457119";"391145"
"V4mis2";"SILVA (only NR);Bacteria;Verrucomicrobiota;Verrucomicrobiae;Verrucomicrobiales;Rubritaleaceae;uncultured;";"100.0";"14.4";"3";"3";"3";"0";"0";"457180";"391204"
"V4mis2";"SILVA (only NR);Bacteria;Verrucomicrobiota;Verrucomicrobiae;Verrucomicrobiales;Verrucomicrobiaceae;";"97.7";"14.4";"216";"216";"211";"5";"0";"456967";"390996"
"V4mis2";"SILVA (only NR);Bacteria;Verrucomicrobiota;Verrucomicrobiae;Verrucomicrobiales;Verrucomicrobiaceae;Brevifollis;";"100.0";"14.4";"6";"6";"6";"0";"0";"457177";"391201"
"V4mis2";"SILVA (only NR);Bacteria;Verrucomicrobiota;Verrucomicrobiae;Verrucomicrobiales;Verrucomicrobiaceae;Prosthecobacter;";"96.7";"14.4";"61";"61";"59";"2";"0";"457122";"391148"
"V4mis2";"SILVA (only NR);Bacteria;Verrucomicrobiota;Verrucomicrobiae;Verrucomicrobiales;Verrucomicrobiaceae;Roseimicrobium;";"97.4";"14.4";"39";"39";"38";"1";"0";"457144";"391169"
"V4mis2";"SILVA (only NR);Bacteria;Verrucomicrobiota;Verrucomicrobiae;Verrucomicrobiales;Verrucomicrobiaceae;Verrucomicrobium;";"100.0";"14.4";"19";"19";"19";"0";"0";"457164";"391188"
"V4mis2";"SILVA (only NR);Bacteria;Verrucomicrobiota;Verrucomicrobiae;Verrucomicrobiales;Verrucomicrobiaceae;uncultured;";"97.8";"14.4";"91";"91";"89";"2";"0";"457092";"391118"
"V4mis2";"SILVA (only NR);Bacteria;Verrucomicrobiota;Verrucomicrobiae;uncultured;";"100.0";"14.4";"25";"25";"25";"0";"0";"457158";"391182"
"V4mis2";"SILVA (only NR);Bacteria;WOR-1;";"97.4";"14.4";"38";"38";"37";"1";"0";"457145";"391170"
"V4mis2";"SILVA (only NR);Bacteria;WPS-2;";"96.7";"14.4";"61";"61";"59";"2";"0";"457122";"391148"
"V4mis2";"SILVA (only NR);Bacteria;WS1;";"94.6";"14.4";"93";"93";"88";"5";"0";"457090";"391119"
"V4mis2";"SILVA (only NR);Bacteria;WS2;";"88.1";"14.4";"59";"59";"52";"7";"0";"457124";"391155"
"V4mis2";"SILVA (only NR);Bacteria;WS4;";"88.2";"14.4";"17";"17";"15";"2";"0";"457166";"391192"
"V4mis2";"SILVA (only NR);Bacteria;Zixibacteria;";"95.2";"14.4";"207";"207";"197";"10";"0";"456976";"391010"
"V4mis2";"SILVA (only NR);Bacteria;uncultured;";"100.0";"14.4";"5";"5";"5";"0";"0";"457178";"391202"
"V4mis2";"SILVA (only NR);Eukaryota;";"18.5";"5.1";"56829";"55751";"10293";"45458";"1078";"401432";"380914"
"V4mis2";"SILVA (only NR);Eukaryota;Amorphea;";"8.7";"8.7";"31959";"31611";"2765";"28846";"348";"425572";"388442"
"V4mis2";"SILVA (only NR);Eukaryota;Amorphea;Amoebozoa;";"23.4";"14.3";"1148";"1060";"248";"812";"88";"456123";"390959"
"V4mis2";"SILVA (only NR);Eukaryota;Amorphea;Amoebozoa;Archamoebae;";"53.3";"14.4";"15";"15";"8";"7";"0";"457168";"391199"
"V4mis2";"SILVA (only NR);Eukaryota;Amorphea;Amoebozoa;Archamoebae;Entamoebida;";"100.0";"14.4";"4";"4";"4";"0";"0";"457179";"391203"
"V4mis2";"SILVA (only NR);Eukaryota;Amorphea;Amoebozoa;Archamoebae;Entamoebida;Entamoeba;";"100.0";"14.4";"4";"4";"4";"0";"0";"457179";"391203"
"V4mis2";"SILVA (only NR);Eukaryota;Amorphea;Amoebozoa;Archamoebae;Incertae Sedis;";"36.4";"14.4";"11";"11";"4";"7";"0";"457172";"391203"
"V4mis2";"SILVA (only NR);Eukaryota;Amorphea;Amoebozoa;Archamoebae;Incertae Sedis;Rhizomastix;";"36.4";"14.4";"11";"11";"4";"7";"0";"457172";"391203"
"V4mis2";"SILVA (only NR);Eukaryota;Amorphea;Amoebozoa;Cavosteliida;";"30.8";"14.4";"13";"13";"4";"9";"0";"457170";"391203"
"V4mis2";"SILVA (only NR);Eukaryota;Amorphea;Amoebozoa;Cavosteliida;Cavostelium;";"100.0";"14.4";"1";"1";"1";"0";"0";"457182";"391206"
"V4mis2";"SILVA (only NR);Eukaryota;Amorphea;Amoebozoa;Cavosteliida;Schizoplasmodiopsis;";"0.0";"0";"5";"5";"0";"5";"0";"457178";"391207"
"V4mis2";"SILVA (only NR);Eukaryota;Amorphea;Amoebozoa;Cavosteliida;Tychosporium;";"0.0";"0";"2";"2";"0";"2";"0";"457181";"391207"
"V4mis2";"SILVA (only NR);Eukaryota;Amorphea;Amoebozoa;Centrohelida;";"10.7";"14.4";"77";"75";"8";"67";"2";"457108";"391199"
"V4mis2";"SILVA (only NR);Eukaryota;Amorphea;Amoebozoa;Centrohelida;Acanthocystidae;";"8.7";"14.4";"24";"23";"2";"21";"1";"457160";"391205"
"V4mis2";"SILVA (only NR);Eukaryota;Amorphea;Amoebozoa;Centrohelida;Acanthocystidae;Choanocystis;";"40.0";"14.4";"5";"5";"2";"3";"0";"457178";"391205"
"V4mis2";"SILVA (only NR);Eukaryota;Amorphea;Amoebozoa;Centrohelida;Acanthocystidae;Pterocystis;";"0.0";"0";"16";"15";"0";"15";"1";"457168";"391207"
"V4mis2";"SILVA (only NR);Eukaryota;Amorphea;Amoebozoa;Centrohelida;Acanthocystidae;Raineriophrys;";"0.0";"0";"1";"1";"0";"1";"0";"457182";"391207"
"V4mis2";"SILVA (only NR);Eukaryota;Amorphea;Amoebozoa;Centrohelida;CV1-B1-93;";"0.0";"0";"3";"3";"0";"3";"0";"457180";"391207"
"V4mis2";"SILVA (only NR);Eukaryota;Amorphea;Amoebozoa;Centrohelida;H1-10;";"0.0";"0";"7";"7";"0";"7";"0";"457176";"391207"
"V4mis2";"SILVA (only NR);Eukaryota;Amorphea;Amoebozoa;Centrohelida;H15-6;";"44.4";"14.4";"9";"9";"4";"5";"0";"457174";"391203"
"V4mis2";"SILVA (only NR);Eukaryota;Amorphea;Amoebozoa;Centrohelida;H26-1;";"0.0";"0";"3";"3";"0";"3";"0";"457180";"391207"
"V4mis2";"SILVA (only NR);Eukaryota;Amorphea;Amoebozoa;Centrohelida;Heterophryidae;";"18.2";"14.4";"11";"11";"2";"9";"0";"457172";"391205"
"V4mis2";"SILVA (only NR);Eukaryota;Amorphea;Amoebozoa;Centrohelida;Heterophryidae;Chlamydaster;";"0.0";"0";"2";"2";"0";"2";"0";"457181";"391207"
"V4mis2";"SILVA (only NR);Eukaryota;Amorphea;Amoebozoa;Centrohelida;Heterophryidae;Heterophrys;";"50.0";"14.4";"2";"2";"1";"1";"0";"457181";"391206"
"V4mis2";"SILVA (only NR);Eukaryota;Amorphea;Amoebozoa;Centrohelida;Heterophryidae;Oxnerella;";"0.0";"0";"1";"1";"0";"1";"0";"457182";"391207"
"V4mis2";"SILVA (only NR);Eukaryota;Amorphea;Amoebozoa;Centrohelida;Heterophryidae;Sphaerastrum;";"100.0";"14.4";"1";"1";"1";"0";"0";"457182";"391206"
"V4mis2";"SILVA (only NR);Eukaryota;Amorphea;Amoebozoa;Centrohelida;Incertae Sedis;";"0.0";"0";"1";"1";"0";"1";"0";"457182";"391207"
"V4mis2";"SILVA (only NR);Eukaryota;Amorphea;Amoebozoa;Centrohelida;Incertae Sedis;Spiculophrys;";"0.0";"0";"1";"1";"0";"1";"0";"457182";"391207"
"V4mis2";"SILVA (only NR);Eukaryota;Amorphea;Amoebozoa;Centrohelida;M1-18D08;";"0.0";"0";"3";"3";"0";"3";"0";"457180";"391207"
"V4mis2";"SILVA (only NR);Eukaryota;Amorphea;Amoebozoa;Centrohelida;Raphidiophryidae;";"0.0";"0";"1";"1";"0";"1";"0";"457182";"391207"
"V4mis2";"SILVA (only NR);Eukaryota;Amorphea;Amoebozoa;Centrohelida;Raphidiophryidae;Raphidiophrys;";"0.0";"0";"1";"1";"0";"1";"0";"457182";"391207"
"V4mis2";"SILVA (only NR);Eukaryota;Amorphea;Amoebozoa;Collodictyonidae;";"0.0";"0";"2";"2";"0";"2";"0";"457181";"391207"
"V4mis2";"SILVA (only NR);Eukaryota;Amorphea;Amoebozoa;Collodictyonidae;Diphylleia;";"0.0";"0";"2";"2";"0";"2";"0";"457181";"391207"
"V4mis2";"SILVA (only NR);Eukaryota;Amorphea;Amoebozoa;Dictyostelia;";"97.0";"14.4";"66";"66";"64";"2";"0";"457117";"391143"
"V4mis2";"SILVA (only NR);Eukaryota;Amorphea;Amoebozoa;Dictyostelia;Acytostelium;";"66.7";"14.4";"3";"3";"2";"1";"0";"457180";"391205"
"V4mis2";"SILVA (only NR);Eukaryota;Amorphea;Amoebozoa;Dictyostelia;Dictyostelium;";"97.8";"14.4";"45";"45";"44";"1";"0";"457138";"391163"
"V4mis2";"SILVA (only NR);Eukaryota;Amorphea;Amoebozoa;Dictyostelia;Polysphondylium;";"100.0";"14.4";"17";"17";"17";"0";"0";"457166";"391190"
"V4mis2";"SILVA (only NR);Eukaryota;Amorphea;Amoebozoa;Discosea;";"18.8";"14.4";"431";"393";"74";"319";"38";"456790";"391133"
"V4mis2";"SILVA (only NR);Eukaryota;Amorphea;Amoebozoa;Discosea;Flabellinia;";"22.0";"14.4";"233";"205";"45";"160";"28";"456978";"391162"
"V4mis2";"SILVA (only NR);Eukaryota;Amorphea;Amoebozoa;Discosea;Flabellinia;Dactylopodida;";"2.9";"14.4";"110";"104";"3";"101";"6";"457079";"391204"
"V4mis2";"SILVA (only NR);Eukaryota;Amorphea;Amoebozoa;Discosea;Flabellinia;Dactylopodida;Angulamoeba;";"0.0";"0";"10";"9";"0";"9";"1";"457174";"391207"
"V4mis2";"SILVA (only NR);Eukaryota;Amorphea;Amoebozoa;Discosea;Flabellinia;Dactylopodida;Korotnevella;";"0.0";"0";"22";"18";"0";"18";"4";"457165";"391207"
"V4mis2";"SILVA (only NR);Eukaryota;Amorphea;Amoebozoa;Discosea;Flabellinia;Dactylopodida;Neoparamoeba;";"11.1";"14.4";"9";"9";"1";"8";"0";"457174";"391206"
"V4mis2";"SILVA (only NR);Eukaryota;Amorphea;Amoebozoa;Discosea;Flabellinia;Dactylopodida;Paramoeba;";"0.0";"0";"55";"55";"0";"55";"0";"457128";"391207"
"V4mis2";"SILVA (only NR);Eukaryota;Amorphea;Amoebozoa;Discosea;Flabellinia;Dactylopodida;Parvamoeba;";"0.0";"0";"1";"1";"0";"1";"0";"457182";"391207"
"V4mis2";"SILVA (only NR);Eukaryota;Amorphea;Amoebozoa;Discosea;Flabellinia;Dactylopodida;Pseudoparamoeba;";"0.0";"0";"2";"2";"0";"2";"0";"457181";"391207"
"V4mis2";"SILVA (only NR);Eukaryota;Amorphea;Amoebozoa;Discosea;Flabellinia;Stygamoebida;";"0.0";"0";"7";"7";"0";"7";"0";"457176";"391207"
"V4mis2";"SILVA (only NR);Eukaryota;Amorphea;Amoebozoa;Discosea;Flabellinia;Stygamoebida;Stygamoeba;";"0.0";"0";"1";"1";"0";"1";"0";"457182";"391207"
"V4mis2";"SILVA (only NR);Eukaryota;Amorphea;Amoebozoa;Discosea;Flabellinia;Stygamoebida;Vermistella;";"0.0";"0";"5";"5";"0";"5";"0";"457178";"391207"
"V4mis2";"SILVA (only NR);Eukaryota;Amorphea;Amoebozoa;Discosea;Flabellinia;Vannellida;";"44.7";"14.4";"116";"94";"42";"52";"22";"457089";"391165"
"V4mis2";"SILVA (only NR);Eukaryota;Amorphea;Amoebozoa;Discosea;Flabellinia;Vannellida;BIO10-D10;";"0.0";"0";"4";"4";"0";"4";"0";"457179";"391207"
"V4mis2";"SILVA (only NR);Eukaryota;Amorphea;Amoebozoa;Discosea;Flabellinia;Vannellida;Platyamoeba;";"2.9";"14.4";"34";"34";"1";"33";"0";"457149";"391206"
"V4mis2";"SILVA (only NR);Eukaryota;Amorphea;Amoebozoa;Discosea;Flabellinia;Vannellida;Protosteliopsis;";"100.0";"14.4";"4";"4";"4";"0";"0";"457179";"391203"
"V4mis2";"SILVA (only NR);Eukaryota;Amorphea;Amoebozoa;Discosea;Flabellinia;Vannellida;Unda;";"0.0";"0";"1";"0";"0";"0";"1";"457183";"391207"
"V4mis2";"SILVA (only NR);Eukaryota;Amorphea;Amoebozoa;Discosea;Flabellinia;Vannellida;Vannella;";"94.3";"14.4";"36";"35";"33";"2";"1";"457148";"391174"
"V4mis2";"SILVA (only NR);Eukaryota;Amorphea;Amoebozoa;Discosea;Flabellinia;Vannellida;uncultured;";"0.0";"0";"14";"6";"0";"6";"8";"457177";"391207"
"V4mis2";"SILVA (only NR);Eukaryota;Amorphea;Amoebozoa;Discosea;Longamoebia;";"15.3";"14.4";"193";"183";"28";"155";"10";"457000";"391179"
"V4mis2";"SILVA (only NR);Eukaryota;Amorphea;Amoebozoa;Discosea;Longamoebia;Centramoebida;";"15.3";"14.4";"193";"183";"28";"155";"10";"457000";"391179"
"V4mis2";"SILVA (only NR);Eukaryota;Amorphea;Amoebozoa;Discosea;Longamoebia;Centramoebida;Acanthamoeba;";"6.8";"14.4";"169";"161";"11";"150";"8";"457022";"391196"
"V4mis2";"SILVA (only NR);Eukaryota;Amorphea;Amoebozoa;Discosea;Longamoebia;Centramoebida;Balamuthia;";"89.5";"14.4";"21";"19";"17";"2";"2";"457164";"391190"
"V4mis2";"SILVA (only NR);Eukaryota;Amorphea;Amoebozoa;Fractovitelliida;";"100.0";"14.4";"3";"3";"3";"0";"0";"457180";"391204"
"V4mis2";"SILVA (only NR);Eukaryota;Amorphea;Amoebozoa;Fractovitelliida;Soliformovum;";"100.0";"14.4";"3";"3";"3";"0";"0";"457180";"391204"
"V4mis2";"SILVA (only NR);Eukaryota;Amorphea;Amoebozoa;Gracilipodida;";"0.0";"0";"34";"33";"0";"33";"1";"457150";"391207"
"V4mis2";"SILVA (only NR);Eukaryota;Amorphea;Amoebozoa;Gracilipodida;Filamoeba;";"0.0";"0";"4";"4";"0";"4";"0";"457179";"391207"
"V4mis2";"SILVA (only NR);Eukaryota;Amorphea;Amoebozoa;Gracilipodida;Flamella;";"0.0";"0";"17";"17";"0";"17";"0";"457166";"391207"
"V4mis2";"SILVA (only NR);Eukaryota;Amorphea;Amoebozoa;Gracilipodida;Heliamoeba;";"0.0";"0";"1";"1";"0";"1";"0";"457182";"391207"
"V4mis2";"SILVA (only NR);Eukaryota;Amorphea;Amoebozoa;Gracilipodida;LEMD267;";"0.0";"0";"4";"4";"0";"4";"0";"457179";"391207"
"V4mis2";"SILVA (only NR);Eukaryota;Amorphea;Amoebozoa;Gracilipodida;Telaepolella;";"0.0";"0";"3";"2";"0";"2";"1";"457181";"391207"
"V4mis2";"SILVA (only NR);Eukaryota;Amorphea;Amoebozoa;Incertae Sedis;";"11.7";"14.4";"114";"103";"12";"91";"11";"457080";"391195"
"V4mis2";"SILVA (only NR);Eukaryota;Amorphea;Amoebozoa;Incertae Sedis;Apusomonadidae;";"14.8";"14.4";"63";"61";"9";"52";"2";"457122";"391198"
"V4mis2";"SILVA (only NR);Eukaryota;Amorphea;Amoebozoa;Incertae Sedis;Apusomonadidae;Amastigomonas;";"17.6";"14.4";"34";"34";"6";"28";"0";"457149";"391201"
"V4mis2";"SILVA (only NR);Eukaryota;Amorphea;Amoebozoa;Incertae Sedis;Apusomonadidae;Apusomonas;";"0.0";"0";"7";"7";"0";"7";"0";"457176";"391207"
"V4mis2";"SILVA (only NR);Eukaryota;Amorphea;Amoebozoa;Incertae Sedis;Apusomonadidae;Fabomonas;";"0.0";"0";"1";"1";"0";"1";"0";"457182";"391207"
"V4mis2";"SILVA (only NR);Eukaryota;Amorphea;Amoebozoa;Incertae Sedis;Apusomonadidae;Multimonas;";"0.0";"0";"3";"3";"0";"3";"0";"457180";"391207"
"V4mis2";"SILVA (only NR);Eukaryota;Amorphea;Amoebozoa;Incertae Sedis;Apusomonadidae;Planomonas;";"0.0";"0";"1";"1";"0";"1";"0";"457182";"391207"
"V4mis2";"SILVA (only NR);Eukaryota;Amorphea;Amoebozoa;Incertae Sedis;Arboramoeba;";"33.3";"14.4";"4";"3";"1";"2";"1";"457180";"391206"
"V4mis2";"SILVA (only NR);Eukaryota;Amorphea;Amoebozoa;Incertae Sedis;Breviatea;";"8.3";"14.4";"27";"24";"2";"22";"3";"457159";"391205"
"V4mis2";"SILVA (only NR);Eukaryota;Amorphea;Amoebozoa;Incertae Sedis;Breviatea;Breviata;";"0.0";"0";"2";"2";"0";"2";"0";"457181";"391207"
"V4mis2";"SILVA (only NR);Eukaryota;Amorphea;Amoebozoa;Incertae Sedis;Breviatea;NAMAKO-2;";"12.5";"14.4";"8";"8";"1";"7";"0";"457175";"391206"
"V4mis2";"SILVA (only NR);Eukaryota;Amorphea;Amoebozoa;Incertae Sedis;Breviatea;Pygsuia;";"100.0";"14.4";"1";"1";"1";"0";"0";"457182";"391206"
"V4mis2";"SILVA (only NR);Eukaryota;Amorphea;Amoebozoa;Incertae Sedis;Breviatea;Subulatomonas;";"0.0";"0";"13";"10";"0";"10";"3";"457173";"391207"
"V4mis2";"SILVA (only NR);Eukaryota;Amorphea;Amoebozoa;Incertae Sedis;Dictyamoeba;";"0.0";"0";"3";"3";"0";"3";"0";"457180";"391207"
"V4mis2";"SILVA (only NR);Eukaryota;Amorphea;Amoebozoa;Incertae Sedis;Ischnamoeba;";"0.0";"0";"4";"4";"0";"4";"0";"457179";"391207"
"V4mis2";"SILVA (only NR);Eukaryota;Amorphea;Amoebozoa;Incertae Sedis;Luapeleamoeba;";"0.0";"0";"1";"0";"0";"0";"1";"457183";"391207"
"V4mis2";"SILVA (only NR);Eukaryota;Amorphea;Amoebozoa;Incertae Sedis;Rigifilida;";"0.0";"0";"3";"3";"0";"3";"0";"457180";"391207"
"V4mis2";"SILVA (only NR);Eukaryota;Amorphea;Amoebozoa;Incertae Sedis;Rigifilida;Micronuclearia;";"0.0";"0";"1";"1";"0";"1";"0";"457182";"391207"
"V4mis2";"SILVA (only NR);Eukaryota;Amorphea;Amoebozoa;Incertae Sedis;Rigifilida;Rigifila;";"0.0";"0";"1";"1";"0";"1";"0";"457182";"391207"
"V4mis2";"SILVA (only NR);Eukaryota;Amorphea;Amoebozoa;Mycamoeba;";"0.0";"0";"5";"4";"0";"4";"1";"457179";"391207"
"V4mis2";"SILVA (only NR);Eukaryota;Amorphea;Amoebozoa;Myxogastria;";"0.0";"0";"111";"106";"0";"106";"5";"457077";"391207"
"V4mis2";"SILVA (only NR);Eukaryota;Amorphea;Amoebozoa;Myxogastria;Amaurochaete;";"0.0";"0";"1";"1";"0";"1";"0";"457182";"391207"
"V4mis2";"SILVA (only NR);Eukaryota;Amorphea;Amoebozoa;Myxogastria;Badhamia;";"0.0";"0";"16";"14";"0";"14";"2";"457169";"391207"
"V4mis2";"SILVA (only NR);Eukaryota;Amorphea;Amoebozoa;Myxogastria;Brefeldia;";"0.0";"0";"1";"1";"0";"1";"0";"457182";"391207"
"V4mis2";"SILVA (only NR);Eukaryota;Amorphea;Amoebozoa;Myxogastria;Comatricha;";"0.0";"0";"4";"4";"0";"4";"0";"457179";"391207"
"V4mis2";"SILVA (only NR);Eukaryota;Amorphea;Amoebozoa;Myxogastria;Diderma;";"0.0";"0";"1";"1";"0";"1";"0";"457182";"391207"
"V4mis2";"SILVA (only NR);Eukaryota;Amorphea;Amoebozoa;Myxogastria;Didymium;";"0.0";"0";"12";"12";"0";"12";"0";"457171";"391207"
"V4mis2";"SILVA (only NR);Eukaryota;Amorphea;Amoebozoa;Myxogastria;Fuligo;";"0.0";"0";"2";"2";"0";"2";"0";"457181";"391207"
"V4mis2";"SILVA (only NR);Eukaryota;Amorphea;Amoebozoa;Myxogastria;Lamproderma;";"0.0";"0";"25";"25";"0";"25";"0";"457158";"391207"
"V4mis2";"SILVA (only NR);Eukaryota;Amorphea;Amoebozoa;Myxogastria;Lepidoderma;";"0.0";"0";"3";"3";"0";"3";"0";"457180";"391207"
"V4mis2";"SILVA (only NR);Eukaryota;Amorphea;Amoebozoa;Myxogastria;Macbrideola;";"0.0";"0";"1";"1";"0";"1";"0";"457182";"391207"
"V4mis2";"SILVA (only NR);Eukaryota;Amorphea;Amoebozoa;Myxogastria;Meriderma;";"0.0";"0";"4";"4";"0";"4";"0";"457179";"391207"
"V4mis2";"SILVA (only NR);Eukaryota;Amorphea;Amoebozoa;Myxogastria;Mucilago;";"0.0";"0";"1";"1";"0";"1";"0";"457182";"391207"
"V4mis2";"SILVA (only NR);Eukaryota;Amorphea;Amoebozoa;Myxogastria;Physarella;";"0.0";"0";"2";"2";"0";"2";"0";"457181";"391207"
"V4mis2";"SILVA (only NR);Eukaryota;Amorphea;Amoebozoa;Myxogastria;Physarum;";"0.0";"0";"18";"17";"0";"17";"1";"457166";"391207"
"V4mis2";"SILVA (only NR);Eukaryota;Amorphea;Amoebozoa;Myxogastria;Protophysarum;";"0.0";"0";"11";"11";"0";"11";"0";"457172";"391207"
"V4mis2";"SILVA (only NR);Eukaryota;Amorphea;Amoebozoa;Myxogastria;Stemonitis;";"0.0";"0";"2";"2";"0";"2";"0";"457181";"391207"
"V4mis2";"SILVA (only NR);Eukaryota;Amorphea;Amoebozoa;Myxogastria;Symphytocarpus;";"0.0";"0";"1";"1";"0";"1";"0";"457182";"391207"
"V4mis2";"SILVA (only NR);Eukaryota;Amorphea;Amoebozoa;Protosporangiida;";"76.5";"14.4";"18";"17";"13";"4";"1";"457166";"391194"
"V4mis2";"SILVA (only NR);Eukaryota;Amorphea;Amoebozoa;Protosporangiida;Protosporangiidae;";"76.5";"14.4";"18";"17";"13";"4";"1";"457166";"391194"
"V4mis2";"SILVA (only NR);Eukaryota;Amorphea;Amoebozoa;Protosporangiida;Protosporangiidae;Protosporangium;";"76.5";"14.4";"18";"17";"13";"4";"1";"457166";"391194"
"V4mis2";"SILVA (only NR);Eukaryota;Amorphea;Amoebozoa;Protosteliida;";"12.5";"14.4";"32";"32";"4";"28";"0";"457151";"391203"
"V4mis2";"SILVA (only NR);Eukaryota;Amorphea;Amoebozoa;Protosteliida;Planoprotostelium;";"100.0";"14.4";"3";"3";"3";"0";"0";"457180";"391204"
"V4mis2";"SILVA (only NR);Eukaryota;Amorphea;Amoebozoa;Protosteliida;Protostelium;";"5.6";"14.4";"18";"18";"1";"17";"0";"457165";"391206"
"V4mis2";"SILVA (only NR);Eukaryota;Amorphea;Amoebozoa;Protosteliida;Schoutedamoeba;";"0.0";"0";"1";"1";"0";"1";"0";"457182";"391207"
"V4mis2";"SILVA (only NR);Eukaryota;Amorphea;Amoebozoa;SAR;";"89.8";"14.4";"60";"49";"44";"5";"11";"457134";"391163"
"V4mis2";"SILVA (only NR);Eukaryota;Amorphea;Amoebozoa;SAR;Stramenopiles;";"89.8";"14.4";"60";"49";"44";"5";"11";"457134";"391163"
"V4mis2";"SILVA (only NR);Eukaryota;Amorphea;Amoebozoa;SAR;Stramenopiles;Labyrinthulomycetes;";"89.8";"14.4";"60";"49";"44";"5";"11";"457134";"391163"
"V4mis2";"SILVA (only NR);Eukaryota;Amorphea;Amoebozoa;SAR;Stramenopiles;Labyrinthulomycetes;Sorodiplophrys;";"89.8";"14.4";"60";"49";"44";"5";"11";"457134";"391163"
"V4mis2";"SILVA (only NR);Eukaryota;Amorphea;Amoebozoa;Schizoplasmodiida;";"9.1";"14.4";"14";"11";"1";"10";"3";"457172";"391206"
"V4mis2";"SILVA (only NR);Eukaryota;Amorphea;Amoebozoa;Schizoplasmodiida;Ceratiomyxella;";"0.0";"0";"1";"1";"0";"1";"0";"457182";"391207"
"V4mis2";"SILVA (only NR);Eukaryota;Amorphea;Amoebozoa;Schizoplasmodiida;Nematostelium;";"0.0";"0";"1";"1";"0";"1";"0";"457182";"391207"
"V4mis2";"SILVA (only NR);Eukaryota;Amorphea;Amoebozoa;Schizoplasmodiida;Phalansterium;";"14.3";"14.4";"10";"7";"1";"6";"3";"457176";"391206"
"V4mis2";"SILVA (only NR);Eukaryota;Amorphea;Amoebozoa;Schizoplasmodiida;Schizoplasmodium;";"0.0";"0";"1";"1";"0";"1";"0";"457182";"391207"
"V4mis2";"SILVA (only NR);Eukaryota;Amorphea;Amoebozoa;Tubulinea;";"11.0";"14.4";"132";"118";"13";"105";"14";"457065";"391194"
"V4mis2";"SILVA (only NR);Eukaryota;Amorphea;Amoebozoa;Tubulinea;Arcellinida;";"6.1";"14.4";"35";"33";"2";"31";"2";"457150";"391205"
"V4mis2";"SILVA (only NR);Eukaryota;Amorphea;Amoebozoa;Tubulinea;Arcellinida;Arcellina;";"100.0";"14.4";"4";"2";"2";"0";"2";"457181";"391205"
"V4mis2";"SILVA (only NR);Eukaryota;Amorphea;Amoebozoa;Tubulinea;Arcellinida;Arcellina;Arcella;";"100.0";"14.4";"4";"2";"2";"0";"2";"457181";"391205"
"V4mis2";"SILVA (only NR);Eukaryota;Amorphea;Amoebozoa;Tubulinea;Arcellinida;Echinamoebida;";"0.0";"0";"21";"21";"0";"21";"0";"457162";"391207"
"V4mis2";"SILVA (only NR);Eukaryota;Amorphea;Amoebozoa;Tubulinea;Arcellinida;Echinamoebida;Echinamoeba;";"0.0";"0";"5";"5";"0";"5";"0";"457178";"391207"
"V4mis2";"SILVA (only NR);Eukaryota;Amorphea;Amoebozoa;Tubulinea;Arcellinida;Echinamoebida;Vermamoeba;";"0.0";"0";"8";"8";"0";"8";"0";"457175";"391207"
"V4mis2";"SILVA (only NR);Eukaryota;Amorphea;Amoebozoa;Tubulinea;Arcellinida;Phryganellina;";"0.0";"0";"5";"5";"0";"5";"0";"457178";"391207"
"V4mis2";"SILVA (only NR);Eukaryota;Amorphea;Amoebozoa;Tubulinea;Arcellinida;Phryganellina;Cryptodifflugia;";"0.0";"0";"5";"5";"0";"5";"0";"457178";"391207"
"V4mis2";"SILVA (only NR);Eukaryota;Amorphea;Amoebozoa;Tubulinea;Euamoebida;";"18.8";"14.4";"57";"48";"9";"39";"9";"457135";"391198"
"V4mis2";"SILVA (only NR);Eukaryota;Amorphea;Amoebozoa;Tubulinea;Euamoebida;Amoeba;";"0.0";"0";"2";"2";"0";"2";"0";"457181";"391207"
"V4mis2";"SILVA (only NR);Eukaryota;Amorphea;Amoebozoa;Tubulinea;Euamoebida;BOLA868;";"0.0";"0";"8";"8";"0";"8";"0";"457175";"391207"
"V4mis2";"SILVA (only NR);Eukaryota;Amorphea;Amoebozoa;Tubulinea;Euamoebida;Chaos;";"0.0";"0";"1";"1";"0";"1";"0";"457182";"391207"
"V4mis2";"SILVA (only NR);Eukaryota;Amorphea;Amoebozoa;Tubulinea;Euamoebida;Copromyxa;";"100.0";"14.4";"3";"3";"3";"0";"0";"457180";"391204"
"V4mis2";"SILVA (only NR);Eukaryota;Amorphea;Amoebozoa;Tubulinea;Euamoebida;Glaeseria;";"0.0";"0";"1";"1";"0";"1";"0";"457182";"391207"
"V4mis2";"SILVA (only NR);Eukaryota;Amorphea;Amoebozoa;Tubulinea;Euamoebida;Hartmannella;";"0.0";"0";"6";"6";"0";"6";"0";"457177";"391207"
"V4mis2";"SILVA (only NR);Eukaryota;Amorphea;Amoebozoa;Tubulinea;Euamoebida;Ptolemeba;";"0.0";"0";"2";"2";"0";"2";"0";"457181";"391207"
"V4mis2";"SILVA (only NR);Eukaryota;Amorphea;Amoebozoa;Tubulinea;Euamoebida;Saccamoeba;";"33.3";"14.4";"3";"3";"1";"2";"0";"457180";"391206"
"V4mis2";"SILVA (only NR);Eukaryota;Amorphea;Amoebozoa;Tubulinea;Euamoebida;Sacchamoeba;";"0.0";"0";"1";"1";"0";"1";"0";"457182";"391207"
"V4mis2";"SILVA (only NR);Eukaryota;Amorphea;Amoebozoa;Tubulinea;Incertae Sedis;";"0.0";"0";"1";"1";"0";"1";"0";"457182";"391207"
"V4mis2";"SILVA (only NR);Eukaryota;Amorphea;Amoebozoa;Tubulinea;Incertae Sedis;Pyxidicula;";"0.0";"0";"1";"1";"0";"1";"0";"457182";"391207"
"V4mis2";"SILVA (only NR);Eukaryota;Amorphea;Amoebozoa;Tubulinea;Leptomyxida;";"0.0";"0";"35";"33";"0";"33";"2";"457150";"391207"
"V4mis2";"SILVA (only NR);Eukaryota;Amorphea;Amoebozoa;Tubulinea;Leptomyxida;Flabellula;";"0.0";"0";"9";"9";"0";"9";"0";"457174";"391207"
"V4mis2";"SILVA (only NR);Eukaryota;Amorphea;Amoebozoa;Tubulinea;Leptomyxida;Leptomyxa;";"0.0";"0";"7";"7";"0";"7";"0";"457176";"391207"
"V4mis2";"SILVA (only NR);Eukaryota;Amorphea;Amoebozoa;Tubulinea;Leptomyxida;NETC3-I;";"0.0";"0";"2";"2";"0";"2";"0";"457181";"391207"
"V4mis2";"SILVA (only NR);Eukaryota;Amorphea;Amoebozoa;Tubulinea;Leptomyxida;Paraflabellula;";"0.0";"0";"2";"2";"0";"2";"0";"457181";"391207"
"V4mis2";"SILVA (only NR);Eukaryota;Amorphea;Amoebozoa;Tubulinea;Leptomyxida;Rhizamoeba;";"0.0";"0";"2";"2";"0";"2";"0";"457181";"391207"
"V4mis2";"SILVA (only NR);Eukaryota;Amorphea;Amoebozoa;uncultured;";"0.0";"0";"12";"11";"0";"11";"1";"457172";"391207"
"V4mis2";"SILVA (only NR);Eukaryota;Amorphea;Obazoa;";"8.2";"8.9";"30811";"30551";"2517";"28034";"260";"426632";"388690"
"V4mis2";"SILVA (only NR);Eukaryota;Amorphea;Obazoa;Opisthokonta;";"8.2";"8.9";"30811";"30551";"2517";"28034";"260";"426632";"388690"
"V4mis2";"SILVA (only NR);Eukaryota;Amorphea;Obazoa;Opisthokonta;Holozoa;";"3.0";"10.4";"21360";"21153";"625";"20528";"207";"436030";"390582"
"V4mis2";"SILVA (only NR);Eukaryota;Amorphea;Obazoa;Opisthokonta;Holozoa;Choanozoa;";"3.0";"10.4";"21360";"21153";"625";"20528";"207";"436030";"390582"
"V4mis2";"SILVA (only NR);Eukaryota;Amorphea;Obazoa;Opisthokonta;Holozoa;Choanozoa;Choanoflagellata;";"22.3";"14.4";"328";"318";"71";"247";"10";"456865";"391136"
"V4mis2";"SILVA (only NR);Eukaryota;Amorphea;Obazoa;Opisthokonta;Holozoa;Choanozoa;Choanoflagellata;Choanoflagellida;";"26.8";"14.4";"200";"190";"51";"139";"10";"456993";"391156"
"V4mis2";"SILVA (only NR);Eukaryota;Amorphea;Obazoa;Opisthokonta;Holozoa;Choanozoa;Choanoflagellata;Choanoflagellida;Acanthoecida;";"0.0";"0";"67";"67";"0";"67";"0";"457116";"391207"
"V4mis2";"SILVA (only NR);Eukaryota;Amorphea;Obazoa;Opisthokonta;Holozoa;Choanozoa;Choanoflagellata;Choanoflagellida;Acanthoecida;Acanthoecidae;";"0.0";"0";"18";"18";"0";"18";"0";"457165";"391207"
"V4mis2";"SILVA (only NR);Eukaryota;Amorphea;Obazoa;Opisthokonta;Holozoa;Choanozoa;Choanoflagellata;Choanoflagellida;Acanthoecida;Acanthoecidae;Acanthoeca;";"0.0";"0";"2";"2";"0";"2";"0";"457181";"391207"
"V4mis2";"SILVA (only NR);Eukaryota;Amorphea;Obazoa;Opisthokonta;Holozoa;Choanozoa;Choanoflagellata;Choanoflagellida;Acanthoecida;Acanthoecidae;FV23-1A4;";"0.0";"0";"6";"6";"0";"6";"0";"457177";"391207"
"V4mis2";"SILVA (only NR);Eukaryota;Amorphea;Obazoa;Opisthokonta;Holozoa;Choanozoa;Choanoflagellata;Choanoflagellida;Acanthoecida;Acanthoecidae;Pleurasiga;";"0.0";"0";"3";"3";"0";"3";"0";"457180";"391207"
"V4mis2";"SILVA (only NR);Eukaryota;Amorphea;Obazoa;Opisthokonta;Holozoa;Choanozoa;Choanoflagellata;Choanoflagellida;Acanthoecida;Acanthoecidae;Polyoeca;";"0.0";"0";"1";"1";"0";"1";"0";"457182";"391207"
"V4mis2";"SILVA (only NR);Eukaryota;Amorphea;Obazoa;Opisthokonta;Holozoa;Choanozoa;Choanoflagellata;Choanoflagellida;Acanthoecida;Acanthoecidae;Savillea;";"0.0";"0";"1";"1";"0";"1";"0";"457182";"391207"
"V4mis2";"SILVA (only NR);Eukaryota;Amorphea;Obazoa;Opisthokonta;Holozoa;Choanozoa;Choanoflagellata;Choanoflagellida;Acanthoecida;Stephanoecidae;";"0.0";"0";"48";"48";"0";"48";"0";"457135";"391207"
"V4mis2";"SILVA (only NR);Eukaryota;Amorphea;Obazoa;Opisthokonta;Holozoa;Choanozoa;Choanoflagellata;Choanoflagellida;Acanthoecida;Stephanoecidae;Bicosta;";"0.0";"0";"6";"6";"0";"6";"0";"457177";"391207"
"V4mis2";"SILVA (only NR);Eukaryota;Amorphea;Obazoa;Opisthokonta;Holozoa;Choanozoa;Choanoflagellata;Choanoflagellida;Acanthoecida;Stephanoecidae;Calliacantha;";"0.0";"0";"2";"2";"0";"2";"0";"457181";"391207"
"V4mis2";"SILVA (only NR);Eukaryota;Amorphea;Obazoa;Opisthokonta;Holozoa;Choanozoa;Choanoflagellata;Choanoflagellida;Acanthoecida;Stephanoecidae;Diaphanoeca;";"0.0";"0";"15";"15";"0";"15";"0";"457168";"391207"
"V4mis2";"SILVA (only NR);Eukaryota;Amorphea;Obazoa;Opisthokonta;Holozoa;Choanozoa;Choanoflagellata;Choanoflagellida;Acanthoecida;Stephanoecidae;Didymoeca;";"0.0";"0";"2";"2";"0";"2";"0";"457181";"391207"
"V4mis2";"SILVA (only NR);Eukaryota;Amorphea;Obazoa;Opisthokonta;Holozoa;Choanozoa;Choanoflagellata;Choanoflagellida;Acanthoecida;Stephanoecidae;Marine Choanoflagellates 1;";"0.0";"0";"6";"6";"0";"6";"0";"457177";"391207"
"V4mis2";"SILVA (only NR);Eukaryota;Amorphea;Obazoa;Opisthokonta;Holozoa;Choanozoa;Choanoflagellata;Choanoflagellida;Acanthoecida;Stephanoecidae;Marine Choanoflagellates 2;";"0.0";"0";"2";"2";"0";"2";"0";"457181";"391207"
"V4mis2";"SILVA (only NR);Eukaryota;Amorphea;Obazoa;Opisthokonta;Holozoa;Choanozoa;Choanoflagellata;Choanoflagellida;Acanthoecida;Stephanoecidae;Stephanoeca;";"0.0";"0";"10";"10";"0";"10";"0";"457173";"391207"
"V4mis2";"SILVA (only NR);Eukaryota;Amorphea;Obazoa;Opisthokonta;Holozoa;Choanozoa;Choanoflagellata;Choanoflagellida;Clade L;";"0.0";"0";"4";"4";"0";"4";"0";"457179";"391207"
"V4mis2";"SILVA (only NR);Eukaryota;Amorphea;Obazoa;Opisthokonta;Holozoa;Choanozoa;Choanoflagellata;Choanoflagellida;Craspedida;";"42.9";"14.4";"129";"119";"51";"68";"10";"457064";"391156"
"V4mis2";"SILVA (only NR);Eukaryota;Amorphea;Obazoa;Opisthokonta;Holozoa;Choanozoa;Choanoflagellata;Choanoflagellida;Craspedida;Codonosigidae;";"53.6";"14.4";"28";"28";"15";"13";"0";"457155";"391192"
"V4mis2";"SILVA (only NR);Eukaryota;Amorphea;Obazoa;Opisthokonta;Holozoa;Choanozoa;Choanoflagellata;Choanoflagellida;Craspedida;Codonosigidae;Codosiga;";"100.0";"14.4";"9";"9";"9";"0";"0";"457174";"391198"
"V4mis2";"SILVA (only NR);Eukaryota;Amorphea;Obazoa;Opisthokonta;Holozoa;Choanozoa;Choanoflagellata;Choanoflagellida;Craspedida;Codonosigidae;Desmarella;";"100.0";"14.4";"1";"1";"1";"0";"0";"457182";"391206"
"V4mis2";"SILVA (only NR);Eukaryota;Amorphea;Obazoa;Opisthokonta;Holozoa;Choanozoa;Choanoflagellata;Choanoflagellida;Craspedida;Codonosigidae;Monosiga;";"50.0";"14.4";"10";"10";"5";"5";"0";"457173";"391202"
"V4mis2";"SILVA (only NR);Eukaryota;Amorphea;Obazoa;Opisthokonta;Holozoa;Choanozoa;Choanoflagellata;Choanoflagellida;Craspedida;Codonosigidae;Proterospongia;";"0.0";"0";"1";"1";"0";"1";"0";"457182";"391207"
"V4mis2";"SILVA (only NR);Eukaryota;Amorphea;Obazoa;Opisthokonta;Holozoa;Choanozoa;Choanoflagellata;Choanoflagellida;Craspedida;Codonosigidae;Sphaeroeca;";"0.0";"0";"5";"5";"0";"5";"0";"457178";"391207"
"V4mis2";"SILVA (only NR);Eukaryota;Amorphea;Obazoa;Opisthokonta;Holozoa;Choanozoa;Choanoflagellata;Choanoflagellida;Craspedida;Codosigidae;";"50.0";"14.4";"19";"16";"8";"8";"3";"457167";"391199"
"V4mis2";"SILVA (only NR);Eukaryota;Amorphea;Obazoa;Opisthokonta;Holozoa;Choanozoa;Choanoflagellata;Choanoflagellida;Craspedida;Codosigidae;Freshwater Choanoflagellates 1;";"77.8";"14.4";"10";"9";"7";"2";"1";"457174";"391200"
"V4mis2";"SILVA (only NR);Eukaryota;Amorphea;Obazoa;Opisthokonta;Holozoa;Choanozoa;Choanoflagellata;Choanoflagellida;Craspedida;Codosigidae;Lagenoeca;";"14.3";"14.4";"9";"7";"1";"6";"2";"457176";"391206"
"V4mis2";"SILVA (only NR);Eukaryota;Amorphea;Obazoa;Opisthokonta;Holozoa;Choanozoa;Choanoflagellata;Choanoflagellida;Craspedida;Incertae Sedis;";"100.0";"14.4";"1";"1";"1";"0";"0";"457182";"391206"
"V4mis2";"SILVA (only NR);Eukaryota;Amorphea;Obazoa;Opisthokonta;Holozoa;Choanozoa;Choanoflagellata;Choanoflagellida;Craspedida;Incertae Sedis;Paramonosiga;";"100.0";"14.4";"1";"1";"1";"0";"0";"457182";"391206"
"V4mis2";"SILVA (only NR);Eukaryota;Amorphea;Obazoa;Opisthokonta;Holozoa;Choanozoa;Choanoflagellata;Choanoflagellida;Craspedida;Salpingoecidae;";"30.2";"14.4";"70";"63";"19";"44";"7";"457120";"391188"
"V4mis2";"SILVA (only NR);Eukaryota;Amorphea;Obazoa;Opisthokonta;Holozoa;Choanozoa;Choanoflagellata;Choanoflagellida;Craspedida;Salpingoecidae;Choanoeca;";"0.0";"0";"1";"1";"0";"1";"0";"457182";"391207"
"V4mis2";"SILVA (only NR);Eukaryota;Amorphea;Obazoa;Opisthokonta;Holozoa;Choanozoa;Choanoflagellata;Choanoflagellida;Craspedida;Salpingoecidae;Freshwater Choanoflagellates 2;";"0.0";"0";"6";"6";"0";"6";"0";"457177";"391207"
"V4mis2";"SILVA (only NR);Eukaryota;Amorphea;Obazoa;Opisthokonta;Holozoa;Choanozoa;Choanoflagellata;Choanoflagellida;Craspedida;Salpingoecidae;Hartaetosiga;";"0.0";"0";"9";"7";"0";"7";"2";"457176";"391207"
"V4mis2";"SILVA (only NR);Eukaryota;Amorphea;Obazoa;Opisthokonta;Holozoa;Choanozoa;Choanoflagellata;Choanoflagellida;Craspedida;Salpingoecidae;Salpingoeca;";"78.3";"14.4";"28";"23";"18";"5";"5";"457160";"391189"
"V4mis2";"SILVA (only NR);Eukaryota;Amorphea;Obazoa;Opisthokonta;Holozoa;Choanozoa;Choanoflagellata;Choanoflagellida;Craspedida;Salpingoecidae;Stagondoeca;";"0.0";"0";"1";"1";"0";"1";"0";"457182";"391207"
"V4mis2";"SILVA (only NR);Eukaryota;Amorphea;Obazoa;Opisthokonta;Holozoa;Choanozoa;Choanoflagellata;Choanoflagellida;Craspedida;uncultured;";"50.0";"14.4";"4";"4";"2";"2";"0";"457179";"391205"
"V4mis2";"SILVA (only NR);Eukaryota;Amorphea;Obazoa;Opisthokonta;Holozoa;Choanozoa;Choanoflagellata;Corallochytrea;";"100.0";"14.4";"1";"1";"1";"0";"0";"457182";"391206"
"V4mis2";"SILVA (only NR);Eukaryota;Amorphea;Obazoa;Opisthokonta;Holozoa;Choanozoa;Choanoflagellata;Corallochytrea;Corallochytrida;";"100.0";"14.4";"1";"1";"1";"0";"0";"457182";"391206"
"V4mis2";"SILVA (only NR);Eukaryota;Amorphea;Obazoa;Opisthokonta;Holozoa;Choanozoa;Choanoflagellata;Corallochytrea;Corallochytrida;Corallochytridae;";"100.0";"14.4";"1";"1";"1";"0";"0";"457182";"391206"
"V4mis2";"SILVA (only NR);Eukaryota;Amorphea;Obazoa;Opisthokonta;Holozoa;Choanozoa;Choanoflagellata;Corallochytrea;Corallochytrida;Corallochytridae;Corallochytrium;";"100.0";"14.4";"1";"1";"1";"0";"0";"457182";"391206"
"V4mis2";"SILVA (only NR);Eukaryota;Amorphea;Obazoa;Opisthokonta;Holozoa;Choanozoa;Choanoflagellata;Eccrinales;";"0.0";"0";"27";"27";"0";"27";"0";"457156";"391207"
"V4mis2";"SILVA (only NR);Eukaryota;Amorphea;Obazoa;Opisthokonta;Holozoa;Choanozoa;Choanoflagellata;Eccrinales;Alacrinella;";"0.0";"0";"1";"1";"0";"1";"0";"457182";"391207"
"V4mis2";"SILVA (only NR);Eukaryota;Amorphea;Obazoa;Opisthokonta;Holozoa;Choanozoa;Choanoflagellata;Eccrinales;Arundinula;";"0.0";"0";"2";"2";"0";"2";"0";"457181";"391207"
"V4mis2";"SILVA (only NR);Eukaryota;Amorphea;Obazoa;Opisthokonta;Holozoa;Choanozoa;Choanoflagellata;Eccrinales;Astreptonema;";"0.0";"0";"3";"3";"0";"3";"0";"457180";"391207"
"V4mis2";"SILVA (only NR);Eukaryota;Amorphea;Obazoa;Opisthokonta;Holozoa;Choanozoa;Choanoflagellata;Eccrinales;Eccrinidus;";"0.0";"0";"1";"1";"0";"1";"0";"457182";"391207"
"V4mis2";"SILVA (only NR);Eukaryota;Amorphea;Obazoa;Opisthokonta;Holozoa;Choanozoa;Choanoflagellata;Eccrinales;Enterobryus;";"0.0";"0";"7";"7";"0";"7";"0";"457176";"391207"
"V4mis2";"SILVA (only NR);Eukaryota;Amorphea;Obazoa;Opisthokonta;Holozoa;Choanozoa;Choanoflagellata;Eccrinales;Enteromyces;";"0.0";"0";"1";"1";"0";"1";"0";"457182";"391207"
"V4mis2";"SILVA (only NR);Eukaryota;Amorphea;Obazoa;Opisthokonta;Holozoa;Choanozoa;Choanoflagellata;Eccrinales;Enteropogon;";"0.0";"0";"1";"1";"0";"1";"0";"457182";"391207"
"V4mis2";"SILVA (only NR);Eukaryota;Amorphea;Obazoa;Opisthokonta;Holozoa;Choanozoa;Choanoflagellata;Eccrinales;Leidyomyces;";"0.0";"0";"2";"2";"0";"2";"0";"457181";"391207"
"V4mis2";"SILVA (only NR);Eukaryota;Amorphea;Obazoa;Opisthokonta;Holozoa;Choanozoa;Choanoflagellata;Eccrinales;Palavascia;";"0.0";"0";"2";"2";"0";"2";"0";"457181";"391207"
"V4mis2";"SILVA (only NR);Eukaryota;Amorphea;Obazoa;Opisthokonta;Holozoa;Choanozoa;Choanoflagellata;Eccrinales;Parataeniella;";"0.0";"0";"3";"3";"0";"3";"0";"457180";"391207"
"V4mis2";"SILVA (only NR);Eukaryota;Amorphea;Obazoa;Opisthokonta;Holozoa;Choanozoa;Choanoflagellata;Eccrinales;Taeniella;";"0.0";"0";"1";"1";"0";"1";"0";"457182";"391207"
"V4mis2";"SILVA (only NR);Eukaryota;Amorphea;Obazoa;Opisthokonta;Holozoa;Choanozoa;Choanoflagellata;Filasterea;";"22.2";"14.4";"18";"18";"4";"14";"0";"457165";"391203"
"V4mis2";"SILVA (only NR);Eukaryota;Amorphea;Obazoa;Opisthokonta;Holozoa;Choanozoa;Choanoflagellata;Filasterea;Ministeriida;";"22.2";"14.4";"18";"18";"4";"14";"0";"457165";"391203"
"V4mis2";"SILVA (only NR);Eukaryota;Amorphea;Obazoa;Opisthokonta;Holozoa;Choanozoa;Choanoflagellata;Filasterea;Ministeriida;Capsasporidae;";"25.0";"14.4";"16";"16";"4";"12";"0";"457167";"391203"
"V4mis2";"SILVA (only NR);Eukaryota;Amorphea;Obazoa;Opisthokonta;Holozoa;Choanozoa;Choanoflagellata;Filasterea;Ministeriida;Capsasporidae;AT4-11;";"33.3";"14.4";"6";"6";"2";"4";"0";"457177";"391205"
"V4mis2";"SILVA (only NR);Eukaryota;Amorphea;Obazoa;Opisthokonta;Holozoa;Choanozoa;Choanoflagellata;Filasterea;Ministeriida;Capsasporidae;Capsaspora;";"0.0";"0";"1";"1";"0";"1";"0";"457182";"391207"
"V4mis2";"SILVA (only NR);Eukaryota;Amorphea;Obazoa;Opisthokonta;Holozoa;Choanozoa;Choanoflagellata;Filasterea;Ministeriida;Capsasporidae;Marine Group;";"28.6";"14.4";"7";"7";"2";"5";"0";"457176";"391205"
"V4mis2";"SILVA (only NR);Eukaryota;Amorphea;Obazoa;Opisthokonta;Holozoa;Choanozoa;Choanoflagellata;Filasterea;Ministeriida;Ministeridae;";"0.0";"0";"1";"1";"0";"1";"0";"457182";"391207"
"V4mis2";"SILVA (only NR);Eukaryota;Amorphea;Obazoa;Opisthokonta;Holozoa;Choanozoa;Choanoflagellata;Filasterea;Ministeriida;Ministeridae;Ministeria;";"0.0";"0";"1";"1";"0";"1";"0";"457182";"391207"
"V4mis2";"SILVA (only NR);Eukaryota;Amorphea;Obazoa;Opisthokonta;Holozoa;Choanozoa;Choanoflagellata;Ichthyosporea;";"18.8";"14.4";"80";"80";"15";"65";"0";"457103";"391192"
"V4mis2";"SILVA (only NR);Eukaryota;Amorphea;Obazoa;Opisthokonta;Holozoa;Choanozoa;Choanoflagellata;Ichthyosporea;Dermocystida;";"100.0";"14.4";"13";"13";"13";"0";"0";"457170";"391194"
"V4mis2";"SILVA (only NR);Eukaryota;Amorphea;Obazoa;Opisthokonta;Holozoa;Choanozoa;Choanoflagellata;Ichthyosporea;Dermocystida;Rhinosporideacae;";"100.0";"14.4";"13";"13";"13";"0";"0";"457170";"391194"
"V4mis2";"SILVA (only NR);Eukaryota;Amorphea;Obazoa;Opisthokonta;Holozoa;Choanozoa;Choanoflagellata;Ichthyosporea;Dermocystida;Rhinosporideacae;Amphibiocystidium;";"100.0";"14.4";"2";"2";"2";"0";"0";"457181";"391205"
"V4mis2";"SILVA (only NR);Eukaryota;Amorphea;Obazoa;Opisthokonta;Holozoa;Choanozoa;Choanoflagellata;Ichthyosporea;Dermocystida;Rhinosporideacae;Amphibiothecum;";"100.0";"14.4";"1";"1";"1";"0";"0";"457182";"391206"
"V4mis2";"SILVA (only NR);Eukaryota;Amorphea;Obazoa;Opisthokonta;Holozoa;Choanozoa;Choanoflagellata;Ichthyosporea;Dermocystida;Rhinosporideacae;Dermocystidium;";"100.0";"14.4";"4";"4";"4";"0";"0";"457179";"391203"
"V4mis2";"SILVA (only NR);Eukaryota;Amorphea;Obazoa;Opisthokonta;Holozoa;Choanozoa;Choanoflagellata;Ichthyosporea;Dermocystida;Rhinosporideacae;Rhinosporidium;";"100.0";"14.4";"1";"1";"1";"0";"0";"457182";"391206"
"V4mis2";"SILVA (only NR);Eukaryota;Amorphea;Obazoa;Opisthokonta;Holozoa;Choanozoa;Choanoflagellata;Ichthyosporea;Ichthyophonae;";"3.0";"14.4";"67";"67";"2";"65";"0";"457116";"391205"
"V4mis2";"SILVA (only NR);Eukaryota;Amorphea;Obazoa;Opisthokonta;Holozoa;Choanozoa;Choanoflagellata;Ichthyosporea;Ichthyophonae;Abeoformidae;";"0.0";"0";"11";"11";"0";"11";"0";"457172";"391207"
"V4mis2";"SILVA (only NR);Eukaryota;Amorphea;Obazoa;Opisthokonta;Holozoa;Choanozoa;Choanoflagellata;Ichthyosporea;Ichthyophonae;Abeoformidae;Abeoforma;";"0.0";"0";"2";"2";"0";"2";"0";"457181";"391207"
"V4mis2";"SILVA (only NR);Eukaryota;Amorphea;Obazoa;Opisthokonta;Holozoa;Choanozoa;Choanoflagellata;Ichthyosporea;Ichthyophonae;Abeoformidae;Caullerya;";"0.0";"0";"1";"1";"0";"1";"0";"457182";"391207"
"V4mis2";"SILVA (only NR);Eukaryota;Amorphea;Obazoa;Opisthokonta;Holozoa;Choanozoa;Choanoflagellata;Ichthyosporea;Ichthyophonae;Abeoformidae;Marine Ichthyosporeans 1;";"0.0";"0";"2";"2";"0";"2";"0";"457181";"391207"
"V4mis2";"SILVA (only NR);Eukaryota;Amorphea;Obazoa;Opisthokonta;Holozoa;Choanozoa;Choanoflagellata;Ichthyosporea;Ichthyophonae;Abeoformidae;Pirum;";"0.0";"0";"3";"3";"0";"3";"0";"457180";"391207"
"V4mis2";"SILVA (only NR);Eukaryota;Amorphea;Obazoa;Opisthokonta;Holozoa;Choanozoa;Choanoflagellata;Ichthyosporea;Ichthyophonae;Ichthyophonidae;";"2.3";"14.4";"43";"43";"1";"42";"0";"457140";"391206"
"V4mis2";"SILVA (only NR);Eukaryota;Amorphea;Obazoa;Opisthokonta;Holozoa;Choanozoa;Choanoflagellata;Ichthyosporea;Ichthyophonae;Ichthyophonidae;Amoebidium;";"0.0";"0";"1";"1";"0";"1";"0";"457182";"391207"
"V4mis2";"SILVA (only NR);Eukaryota;Amorphea;Obazoa;Opisthokonta;Holozoa;Choanozoa;Choanoflagellata;Ichthyosporea;Ichthyophonae;Ichthyophonidae;Freshwater Ichthyosporeans 1;";"33.3";"14.4";"3";"3";"1";"2";"0";"457180";"391206"
"V4mis2";"SILVA (only NR);Eukaryota;Amorphea;Obazoa;Opisthokonta;Holozoa;Choanozoa;Choanoflagellata;Ichthyosporea;Ichthyophonae;Ichthyophonidae;Ichthyophonus;";"0.0";"0";"4";"4";"0";"4";"0";"457179";"391207"
"V4mis2";"SILVA (only NR);Eukaryota;Amorphea;Obazoa;Opisthokonta;Holozoa;Choanozoa;Choanoflagellata;Ichthyosporea;Ichthyophonae;Ichthyophonidae;Paramoebidium;";"0.0";"0";"32";"32";"0";"32";"0";"457151";"391207"
"V4mis2";"SILVA (only NR);Eukaryota;Amorphea;Obazoa;Opisthokonta;Holozoa;Choanozoa;Choanoflagellata;Ichthyosporea;Ichthyophonae;Ichthyophonidae;Psorospermium;";"0.0";"0";"1";"1";"0";"1";"0";"457182";"391207"
"V4mis2";"SILVA (only NR);Eukaryota;Amorphea;Obazoa;Opisthokonta;Holozoa;Choanozoa;Choanoflagellata;Ichthyosporea;Ichthyophonae;Pseudoperkinsidae;";"8.3";"14.4";"12";"12";"1";"11";"0";"457171";"391206"
"V4mis2";"SILVA (only NR);Eukaryota;Amorphea;Obazoa;Opisthokonta;Holozoa;Choanozoa;Choanoflagellata;Ichthyosporea;Ichthyophonae;Pseudoperkinsidae;Anurofeca;";"0.0";"0";"3";"3";"0";"3";"0";"457180";"391207"
"V4mis2";"SILVA (only NR);Eukaryota;Amorphea;Obazoa;Opisthokonta;Holozoa;Choanozoa;Choanoflagellata;Ichthyosporea;Ichthyophonae;Pseudoperkinsidae;Creolimax;";"0.0";"0";"1";"1";"0";"1";"0";"457182";"391207"
"V4mis2";"SILVA (only NR);Eukaryota;Amorphea;Obazoa;Opisthokonta;Holozoa;Choanozoa;Choanoflagellata;Ichthyosporea;Ichthyophonae;Pseudoperkinsidae;LKM51;";"0.0";"0";"2";"2";"0";"2";"0";"457181";"391207"
"V4mis2";"SILVA (only NR);Eukaryota;Amorphea;Obazoa;Opisthokonta;Holozoa;Choanozoa;Metazoa;";"2.7";"10.5";"21032";"20835";"554";"20281";"197";"436348";"390653"
"V4mis2";"SILVA (only NR);Eukaryota;Amorphea;Obazoa;Opisthokonta;Holozoa;Choanozoa;Metazoa;Animalia;";"1.3";"10.5";"20636";"20440";"270";"20170";"196";"436743";"390937"
"V4mis2";"SILVA (only NR);Eukaryota;Amorphea;Obazoa;Opisthokonta;Holozoa;Choanozoa;Metazoa;Animalia;BCP clade;";"1.3";"10.5";"20636";"20440";"270";"20170";"196";"436743";"390937"
"V4mis2";"SILVA (only NR);Eukaryota;Amorphea;Obazoa;Opisthokonta;Holozoa;Choanozoa;Metazoa;Animalia;BCP clade;Bilateria;";"1.3";"10.8";"19180";"18990";"243";"18747";"190";"438193";"390964"
"V4mis2";"SILVA (only NR);Eukaryota;Amorphea;Obazoa;Opisthokonta;Holozoa;Choanozoa;Metazoa;Animalia;BCP clade;Bilateria;Deuterostomia;";"0.3";"14.2";"1400";"1390";"4";"1386";"10";"455793";"391203"
"V4mis2";"SILVA (only NR);Eukaryota;Amorphea;Obazoa;Opisthokonta;Holozoa;Choanozoa;Metazoa;Animalia;BCP clade;Bilateria;Deuterostomia;Ambulacraria;";"0.6";"14.4";"178";"178";"1";"177";"0";"457005";"391206"
"V4mis2";"SILVA (only NR);Eukaryota;Amorphea;Obazoa;Opisthokonta;Holozoa;Choanozoa;Metazoa;Animalia;BCP clade;Bilateria;Deuterostomia;Ambulacraria;Echinodermata;";"0.0";"0";"146";"146";"0";"146";"0";"457037";"391207"
"V4mis2";"SILVA (only NR);Eukaryota;Amorphea;Obazoa;Opisthokonta;Holozoa;Choanozoa;Metazoa;Animalia;BCP clade;Bilateria;Deuterostomia;Ambulacraria;Echinodermata;Asteroidea;";"0.0";"0";"35";"35";"0";"35";"0";"457148";"391207"
"V4mis2";"SILVA (only NR);Eukaryota;Amorphea;Obazoa;Opisthokonta;Holozoa;Choanozoa;Metazoa;Animalia;BCP clade;Bilateria;Deuterostomia;Ambulacraria;Echinodermata;Crinoidea;";"0.0";"0";"13";"13";"0";"13";"0";"457170";"391207"
"V4mis2";"SILVA (only NR);Eukaryota;Amorphea;Obazoa;Opisthokonta;Holozoa;Choanozoa;Metazoa;Animalia;BCP clade;Bilateria;Deuterostomia;Ambulacraria;Echinodermata;Echinoidea;";"0.0";"0";"39";"39";"0";"39";"0";"457144";"391207"
"V4mis2";"SILVA (only NR);Eukaryota;Amorphea;Obazoa;Opisthokonta;Holozoa;Choanozoa;Metazoa;Animalia;BCP clade;Bilateria;Deuterostomia;Ambulacraria;Echinodermata;Holothuroidea;";"0.0";"0";"44";"44";"0";"44";"0";"457139";"391207"
"V4mis2";"SILVA (only NR);Eukaryota;Amorphea;Obazoa;Opisthokonta;Holozoa;Choanozoa;Metazoa;Animalia;BCP clade;Bilateria;Deuterostomia;Ambulacraria;Echinodermata;Ophiuroidea;";"0.0";"0";"14";"14";"0";"14";"0";"457169";"391207"
"V4mis2";"SILVA (only NR);Eukaryota;Amorphea;Obazoa;Opisthokonta;Holozoa;Choanozoa;Metazoa;Animalia;BCP clade;Bilateria;Deuterostomia;Ambulacraria;Hemichordata;";"3.1";"14.4";"32";"32";"1";"31";"0";"457151";"391206"
"V4mis2";"SILVA (only NR);Eukaryota;Amorphea;Obazoa;Opisthokonta;Holozoa;Choanozoa;Metazoa;Animalia;BCP clade;Bilateria;Deuterostomia;Ambulacraria;Hemichordata;Enteropneusta;";"0.0";"0";"29";"29";"0";"29";"0";"457154";"391207"
"V4mis2";"SILVA (only NR);Eukaryota;Amorphea;Obazoa;Opisthokonta;Holozoa;Choanozoa;Metazoa;Animalia;BCP clade;Bilateria;Deuterostomia;Ambulacraria;Hemichordata;Enteropneusta;Harrimaniidae;";"0.0";"0";"14";"14";"0";"14";"0";"457169";"391207"
"V4mis2";"SILVA (only NR);Eukaryota;Amorphea;Obazoa;Opisthokonta;Holozoa;Choanozoa;Metazoa;Animalia;BCP clade;Bilateria;Deuterostomia;Ambulacraria;Hemichordata;Enteropneusta;Ptychoderidae;";"0.0";"0";"11";"11";"0";"11";"0";"457172";"391207"
"V4mis2";"SILVA (only NR);Eukaryota;Amorphea;Obazoa;Opisthokonta;Holozoa;Choanozoa;Metazoa;Animalia;BCP clade;Bilateria;Deuterostomia;Ambulacraria;Hemichordata;Enteropneusta;Saxipendiidae;";"0.0";"0";"2";"2";"0";"2";"0";"457181";"391207"
"V4mis2";"SILVA (only NR);Eukaryota;Amorphea;Obazoa;Opisthokonta;Holozoa;Choanozoa;Metazoa;Animalia;BCP clade;Bilateria;Deuterostomia;Ambulacraria;Hemichordata;Enteropneusta;Spengelidae;";"0.0";"0";"2";"2";"0";"2";"0";"457181";"391207"
"V4mis2";"SILVA (only NR);Eukaryota;Amorphea;Obazoa;Opisthokonta;Holozoa;Choanozoa;Metazoa;Animalia;BCP clade;Bilateria;Deuterostomia;Ambulacraria;Hemichordata;Graptolithoidea;";"33.3";"14.4";"3";"3";"1";"2";"0";"457180";"391206"
"V4mis2";"SILVA (only NR);Eukaryota;Amorphea;Obazoa;Opisthokonta;Holozoa;Choanozoa;Metazoa;Animalia;BCP clade;Bilateria;Deuterostomia;Ambulacraria;Hemichordata;Graptolithoidea;Cephalodiscidae;";"33.3";"14.4";"3";"3";"1";"2";"0";"457180";"391206"
"V4mis2";"SILVA (only NR);Eukaryota;Amorphea;Obazoa;Opisthokonta;Holozoa;Choanozoa;Metazoa;Animalia;BCP clade;Bilateria;Deuterostomia;Chordata;";"0.2";"14.2";"1221";"1211";"3";"1208";"10";"455972";"391204"
"V4mis2";"SILVA (only NR);Eukaryota;Amorphea;Obazoa;Opisthokonta;Holozoa;Choanozoa;Metazoa;Animalia;BCP clade;Bilateria;Deuterostomia;Chordata;Cephalochordata;";"0.0";"0";"6";"6";"0";"6";"0";"457177";"391207"
"V4mis2";"SILVA (only NR);Eukaryota;Amorphea;Obazoa;Opisthokonta;Holozoa;Choanozoa;Metazoa;Animalia;BCP clade;Bilateria;Deuterostomia;Chordata;Cephalochordata;Leptocardii;";"0.0";"0";"6";"6";"0";"6";"0";"457177";"391207"
"V4mis2";"SILVA (only NR);Eukaryota;Amorphea;Obazoa;Opisthokonta;Holozoa;Choanozoa;Metazoa;Animalia;BCP clade;Bilateria;Deuterostomia;Chordata;Cephalochordata;Leptocardii;Amphioxiformes;";"0.0";"0";"6";"6";"0";"6";"0";"457177";"391207"
"V4mis2";"SILVA (only NR);Eukaryota;Amorphea;Obazoa;Opisthokonta;Holozoa;Choanozoa;Metazoa;Animalia;BCP clade;Bilateria;Deuterostomia;Chordata;Cephalochordata;Leptocardii;Amphioxiformes;Branchiostomidae;";"0.0";"0";"6";"6";"0";"6";"0";"457177";"391207"
"V4mis2";"SILVA (only NR);Eukaryota;Amorphea;Obazoa;Opisthokonta;Holozoa;Choanozoa;Metazoa;Animalia;BCP clade;Bilateria;Deuterostomia;Chordata;Tunicata;";"0.0";"0";"130";"129";"0";"129";"1";"457054";"391207"
"V4mis2";"SILVA (only NR);Eukaryota;Amorphea;Obazoa;Opisthokonta;Holozoa;Choanozoa;Metazoa;Animalia;BCP clade;Bilateria;Deuterostomia;Chordata;Tunicata;Appendicularia;";"0.0";"0";"29";"29";"0";"29";"0";"457154";"391207"
"V4mis2";"SILVA (only NR);Eukaryota;Amorphea;Obazoa;Opisthokonta;Holozoa;Choanozoa;Metazoa;Animalia;BCP clade;Bilateria;Deuterostomia;Chordata;Tunicata;Appendicularia;Copelata;";"0.0";"0";"29";"29";"0";"29";"0";"457154";"391207"
"V4mis2";"SILVA (only NR);Eukaryota;Amorphea;Obazoa;Opisthokonta;Holozoa;Choanozoa;Metazoa;Animalia;BCP clade;Bilateria;Deuterostomia;Chordata;Tunicata;Appendicularia;Copelata;Oikopleuridae;";"0.0";"0";"29";"29";"0";"29";"0";"457154";"391207"
"V4mis2";"SILVA (only NR);Eukaryota;Amorphea;Obazoa;Opisthokonta;Holozoa;Choanozoa;Metazoa;Animalia;BCP clade;Bilateria;Deuterostomia;Chordata;Tunicata;Ascidiacea;";"0.0";"0";"78";"77";"0";"77";"1";"457106";"391207"
"V4mis2";"SILVA (only NR);Eukaryota;Amorphea;Obazoa;Opisthokonta;Holozoa;Choanozoa;Metazoa;Animalia;BCP clade;Bilateria;Deuterostomia;Chordata;Tunicata;Ascidiacea;Enterogona;";"0.0";"0";"39";"38";"0";"38";"1";"457145";"391207"
"V4mis2";"SILVA (only NR);Eukaryota;Amorphea;Obazoa;Opisthokonta;Holozoa;Choanozoa;Metazoa;Animalia;BCP clade;Bilateria;Deuterostomia;Chordata;Tunicata;Ascidiacea;Stolidobranchia;";"0.0";"0";"39";"39";"0";"39";"0";"457144";"391207"
"V4mis2";"SILVA (only NR);Eukaryota;Amorphea;Obazoa;Opisthokonta;Holozoa;Choanozoa;Metazoa;Animalia;BCP clade;Bilateria;Deuterostomia;Chordata;Tunicata;Thaliacea;";"0.0";"0";"23";"23";"0";"23";"0";"457160";"391207"
"V4mis2";"SILVA (only NR);Eukaryota;Amorphea;Obazoa;Opisthokonta;Holozoa;Choanozoa;Metazoa;Animalia;BCP clade;Bilateria;Deuterostomia;Chordata;Tunicata;Thaliacea;Doliolida;";"0.0";"0";"2";"2";"0";"2";"0";"457181";"391207"
"V4mis2";"SILVA (only NR);Eukaryota;Amorphea;Obazoa;Opisthokonta;Holozoa;Choanozoa;Metazoa;Animalia;BCP clade;Bilateria;Deuterostomia;Chordata;Tunicata;Thaliacea;Pyrosomata;";"0.0";"0";"3";"3";"0";"3";"0";"457180";"391207"
"V4mis2";"SILVA (only NR);Eukaryota;Amorphea;Obazoa;Opisthokonta;Holozoa;Choanozoa;Metazoa;Animalia;BCP clade;Bilateria;Deuterostomia;Chordata;Tunicata;Thaliacea;Salpida;";"0.0";"0";"18";"18";"0";"18";"0";"457165";"391207"
"V4mis2";"SILVA (only NR);Eukaryota;Amorphea;Obazoa;Opisthokonta;Holozoa;Choanozoa;Metazoa;Animalia;BCP clade;Bilateria;Deuterostomia;Chordata;Vertebrata;";"0.3";"14.2";"1085";"1076";"3";"1073";"9";"456107";"391204"
"V4mis2";"SILVA (only NR);Eukaryota;Amorphea;Obazoa;Opisthokonta;Holozoa;Choanozoa;Metazoa;Animalia;BCP clade;Bilateria;Deuterostomia;Chordata;Vertebrata;Agnatha;";"0.0";"0";"9";"9";"0";"9";"0";"457174";"391207"
"V4mis2";"SILVA (only NR);Eukaryota;Amorphea;Obazoa;Opisthokonta;Holozoa;Choanozoa;Metazoa;Animalia;BCP clade;Bilateria;Deuterostomia;Chordata;Vertebrata;Agnatha;Cephalaspidomorphi;";"0.0";"0";"7";"7";"0";"7";"0";"457176";"391207"
"V4mis2";"SILVA (only NR);Eukaryota;Amorphea;Obazoa;Opisthokonta;Holozoa;Choanozoa;Metazoa;Animalia;BCP clade;Bilateria;Deuterostomia;Chordata;Vertebrata;Agnatha;Cephalaspidomorphi;Petromyzontiformes;";"0.0";"0";"7";"7";"0";"7";"0";"457176";"391207"
"V4mis2";"SILVA (only NR);Eukaryota;Amorphea;Obazoa;Opisthokonta;Holozoa;Choanozoa;Metazoa;Animalia;BCP clade;Bilateria;Deuterostomia;Chordata;Vertebrata;Agnatha;Myxini;";"0.0";"0";"2";"2";"0";"2";"0";"457181";"391207"
"V4mis2";"SILVA (only NR);Eukaryota;Amorphea;Obazoa;Opisthokonta;Holozoa;Choanozoa;Metazoa;Animalia;BCP clade;Bilateria;Deuterostomia;Chordata;Vertebrata;Agnatha;Myxini;Myxiniformes;";"0.0";"0";"2";"2";"0";"2";"0";"457181";"391207"
"V4mis2";"SILVA (only NR);Eukaryota;Amorphea;Obazoa;Opisthokonta;Holozoa;Choanozoa;Metazoa;Animalia;BCP clade;Bilateria;Deuterostomia;Chordata;Vertebrata;Gnathostomata;";"0.3";"14.2";"1076";"1067";"3";"1064";"9";"456116";"391204"
"V4mis2";"SILVA (only NR);Eukaryota;Amorphea;Obazoa;Opisthokonta;Holozoa;Choanozoa;Metazoa;Animalia;BCP clade;Bilateria;Deuterostomia;Chordata;Vertebrata;Gnathostomata;Chimaeriformes;";"0.0";"0";"2";"2";"0";"2";"0";"457181";"391207"
"V4mis2";"SILVA (only NR);Eukaryota;Amorphea;Obazoa;Opisthokonta;Holozoa;Choanozoa;Metazoa;Animalia;BCP clade;Bilateria;Deuterostomia;Chordata;Vertebrata;Gnathostomata;Chimaeriformes;Callorhinchus;";"0.0";"0";"2";"2";"0";"2";"0";"457181";"391207"
"V4mis2";"SILVA (only NR);Eukaryota;Amorphea;Obazoa;Opisthokonta;Holozoa;Choanozoa;Metazoa;Animalia;BCP clade;Bilateria;Deuterostomia;Chordata;Vertebrata;Gnathostomata;Chondrichthyes;";"0.0";"0";"14";"14";"0";"14";"0";"457169";"391207"
"V4mis2";"SILVA (only NR);Eukaryota;Amorphea;Obazoa;Opisthokonta;Holozoa;Choanozoa;Metazoa;Animalia;BCP clade;Bilateria;Deuterostomia;Chordata;Vertebrata;Gnathostomata;Chondrichthyes;Elasmobranchii;";"0.0";"0";"14";"14";"0";"14";"0";"457169";"391207"
"V4mis2";"SILVA (only NR);Eukaryota;Amorphea;Obazoa;Opisthokonta;Holozoa;Choanozoa;Metazoa;Animalia;BCP clade;Bilateria;Deuterostomia;Chordata;Vertebrata;Gnathostomata;Chondrichthyes;Elasmobranchii;Batoidea;";"0.0";"0";"3";"3";"0";"3";"0";"457180";"391207"
"V4mis2";"SILVA (only NR);Eukaryota;Amorphea;Obazoa;Opisthokonta;Holozoa;Choanozoa;Metazoa;Animalia;BCP clade;Bilateria;Deuterostomia;Chordata;Vertebrata;Gnathostomata;Chondrichthyes;Elasmobranchii;Galeomorphii;";"0.0";"0";"8";"8";"0";"8";"0";"457175";"391207"
"V4mis2";"SILVA (only NR);Eukaryota;Amorphea;Obazoa;Opisthokonta;Holozoa;Choanozoa;Metazoa;Animalia;BCP clade;Bilateria;Deuterostomia;Chordata;Vertebrata;Gnathostomata;Chondrichthyes;Elasmobranchii;Squalimorphii;";"0.0";"0";"3";"3";"0";"3";"0";"457180";"391207"
"V4mis2";"SILVA (only NR);Eukaryota;Amorphea;Obazoa;Opisthokonta;Holozoa;Choanozoa;Metazoa;Animalia;BCP clade;Bilateria;Deuterostomia;Chordata;Vertebrata;Gnathostomata;Euteleostomi;";"0.3";"14.2";"1060";"1051";"3";"1048";"9";"456132";"391204"
"V4mis2";"SILVA (only NR);Eukaryota;Amorphea;Obazoa;Opisthokonta;Holozoa;Choanozoa;Metazoa;Animalia;BCP clade;Bilateria;Deuterostomia;Chordata;Vertebrata;Gnathostomata;Euteleostomi;Actinopterygii;";"0.0";"0";"426";"419";"0";"419";"7";"456764";"391207"
"V4mis2";"SILVA (only NR);Eukaryota;Amorphea;Obazoa;Opisthokonta;Holozoa;Choanozoa;Metazoa;Animalia;BCP clade;Bilateria;Deuterostomia;Chordata;Vertebrata;Gnathostomata;Euteleostomi;Actinopterygii;Chondrostei;";"0.0";"0";"13";"13";"0";"13";"0";"457170";"391207"
"V4mis2";"SILVA (only NR);Eukaryota;Amorphea;Obazoa;Opisthokonta;Holozoa;Choanozoa;Metazoa;Animalia;BCP clade;Bilateria;Deuterostomia;Chordata;Vertebrata;Gnathostomata;Euteleostomi;Actinopterygii;Chondrostei;Acipenseriformes;";"0.0";"0";"13";"13";"0";"13";"0";"457170";"391207"
"V4mis2";"SILVA (only NR);Eukaryota;Amorphea;Obazoa;Opisthokonta;Holozoa;Choanozoa;Metazoa;Animalia;BCP clade;Bilateria;Deuterostomia;Chordata;Vertebrata;Gnathostomata;Euteleostomi;Actinopterygii;Neopterygii;";"0.0";"0";"412";"405";"0";"405";"7";"456778";"391207"
"V4mis2";"SILVA (only NR);Eukaryota;Amorphea;Obazoa;Opisthokonta;Holozoa;Choanozoa;Metazoa;Animalia;BCP clade;Bilateria;Deuterostomia;Chordata;Vertebrata;Gnathostomata;Euteleostomi;Actinopterygii;Neopterygii;Amiiformes;";"0.0";"0";"10";"9";"0";"9";"1";"457174";"391207"
"V4mis2";"SILVA (only NR);Eukaryota;Amorphea;Obazoa;Opisthokonta;Holozoa;Choanozoa;Metazoa;Animalia;BCP clade;Bilateria;Deuterostomia;Chordata;Vertebrata;Gnathostomata;Euteleostomi;Actinopterygii;Neopterygii;Semionotiformes;";"0.0";"0";"4";"4";"0";"4";"0";"457179";"391207"
"V4mis2";"SILVA (only NR);Eukaryota;Amorphea;Obazoa;Opisthokonta;Holozoa;Choanozoa;Metazoa;Animalia;BCP clade;Bilateria;Deuterostomia;Chordata;Vertebrata;Gnathostomata;Euteleostomi;Actinopterygii;Neopterygii;Teleostei;";"0.0";"0";"397";"391";"0";"391";"6";"456792";"391207"
"V4mis2";"SILVA (only NR);Eukaryota;Amorphea;Obazoa;Opisthokonta;Holozoa;Choanozoa;Metazoa;Animalia;BCP clade;Bilateria;Deuterostomia;Chordata;Vertebrata;Gnathostomata;Euteleostomi;Sarcopterygii;";"0.0";"0";"6";"6";"0";"6";"0";"457177";"391207"
"V4mis2";"SILVA (only NR);Eukaryota;Amorphea;Obazoa;Opisthokonta;Holozoa;Choanozoa;Metazoa;Animalia;BCP clade;Bilateria;Deuterostomia;Chordata;Vertebrata;Gnathostomata;Euteleostomi;Sarcopterygii;Coelacanthiformes;";"0.0";"0";"3";"3";"0";"3";"0";"457180";"391207"
"V4mis2";"SILVA (only NR);Eukaryota;Amorphea;Obazoa;Opisthokonta;Holozoa;Choanozoa;Metazoa;Animalia;BCP clade;Bilateria;Deuterostomia;Chordata;Vertebrata;Gnathostomata;Euteleostomi;Sarcopterygii;Dipnoi;";"0.0";"0";"3";"3";"0";"3";"0";"457180";"391207"
"V4mis2";"SILVA (only NR);Eukaryota;Amorphea;Obazoa;Opisthokonta;Holozoa;Choanozoa;Metazoa;Animalia;BCP clade;Bilateria;Deuterostomia;Chordata;Vertebrata;Gnathostomata;Euteleostomi;Tetrapoda;";"0.5";"14.3";"627";"625";"3";"622";"2";"456558";"391204"
"V4mis2";"SILVA (only NR);Eukaryota;Amorphea;Obazoa;Opisthokonta;Holozoa;Choanozoa;Metazoa;Animalia;BCP clade;Bilateria;Deuterostomia;Chordata;Vertebrata;Gnathostomata;Euteleostomi;Tetrapoda;Amphibia;";"0.0";"0";"24";"24";"0";"24";"0";"457159";"391207"
"V4mis2";"SILVA (only NR);Eukaryota;Amorphea;Obazoa;Opisthokonta;Holozoa;Choanozoa;Metazoa;Animalia;BCP clade;Bilateria;Deuterostomia;Chordata;Vertebrata;Gnathostomata;Euteleostomi;Tetrapoda;Aves;";"0.0";"0";"10";"10";"0";"10";"0";"457173";"391207"
"V4mis2";"SILVA (only NR);Eukaryota;Amorphea;Obazoa;Opisthokonta;Holozoa;Choanozoa;Metazoa;Animalia;BCP clade;Bilateria;Deuterostomia;Chordata;Vertebrata;Gnathostomata;Euteleostomi;Tetrapoda;Crocodylia;";"0.0";"0";"23";"23";"0";"23";"0";"457160";"391207"
"V4mis2";"SILVA (only NR);Eukaryota;Amorphea;Obazoa;Opisthokonta;Holozoa;Choanozoa;Metazoa;Animalia;BCP clade;Bilateria;Deuterostomia;Chordata;Vertebrata;Gnathostomata;Euteleostomi;Tetrapoda;Lepidosauria;";"0.0";"0";"7";"7";"0";"7";"0";"457176";"391207"
"V4mis2";"SILVA (only NR);Eukaryota;Amorphea;Obazoa;Opisthokonta;Holozoa;Choanozoa;Metazoa;Animalia;BCP clade;Bilateria;Deuterostomia;Chordata;Vertebrata;Gnathostomata;Euteleostomi;Tetrapoda;Mammalia;";"0.5";"14.3";"550";"548";"3";"545";"2";"456635";"391204"
"V4mis2";"SILVA (only NR);Eukaryota;Amorphea;Obazoa;Opisthokonta;Holozoa;Choanozoa;Metazoa;Animalia;BCP clade;Bilateria;Deuterostomia;Chordata;Vertebrata;Gnathostomata;Euteleostomi;Tetrapoda;Testudines;";"0.0";"0";"13";"13";"0";"13";"0";"457170";"391207"
"V4mis2";"SILVA (only NR);Eukaryota;Amorphea;Obazoa;Opisthokonta;Holozoa;Choanozoa;Metazoa;Animalia;BCP clade;Bilateria;Protostomia;";"1.4";"11.1";"17780";"17600";"239";"17361";"180";"439583";"390968"
"V4mis2";"SILVA (only NR);Eukaryota;Amorphea;Obazoa;Opisthokonta;Holozoa;Choanozoa;Metazoa;Animalia;BCP clade;Bilateria;Protostomia;Chaetognatha;";"82.6";"14.4";"46";"46";"38";"8";"0";"457137";"391169"
"V4mis2";"SILVA (only NR);Eukaryota;Amorphea;Obazoa;Opisthokonta;Holozoa;Choanozoa;Metazoa;Animalia;BCP clade;Bilateria;Protostomia;Chaetognatha;Sagittoidea;";"82.6";"14.4";"46";"46";"38";"8";"0";"457137";"391169"
"V4mis2";"SILVA (only NR);Eukaryota;Amorphea;Obazoa;Opisthokonta;Holozoa;Choanozoa;Metazoa;Animalia;BCP clade;Bilateria;Protostomia;Chaetognatha;Sagittoidea;Aphragmophora;";"94.3";"14.4";"35";"35";"33";"2";"0";"457148";"391174"
"V4mis2";"SILVA (only NR);Eukaryota;Amorphea;Obazoa;Opisthokonta;Holozoa;Choanozoa;Metazoa;Animalia;BCP clade;Bilateria;Protostomia;Chaetognatha;Sagittoidea;Monophragmophora;";"100.0";"14.4";"4";"4";"4";"0";"0";"457179";"391203"
"V4mis2";"SILVA (only NR);Eukaryota;Amorphea;Obazoa;Opisthokonta;Holozoa;Choanozoa;Metazoa;Animalia;BCP clade;Bilateria;Protostomia;Chaetognatha;Sagittoidea;Phragmophora;";"14.3";"14.4";"7";"7";"1";"6";"0";"457176";"391206"
"V4mis2";"SILVA (only NR);Eukaryota;Amorphea;Obazoa;Opisthokonta;Holozoa;Choanozoa;Metazoa;Animalia;BCP clade;Bilateria;Protostomia;Ecdysozoa;";"0.4";"12.1";"12526";"12378";"50";"12328";"148";"444805";"391157"
"V4mis2";"SILVA (only NR);Eukaryota;Amorphea;Obazoa;Opisthokonta;Holozoa;Choanozoa;Metazoa;Animalia;BCP clade;Bilateria;Protostomia;Ecdysozoa;Arthropoda;";"0.2";"12.5";"10152";"10016";"22";"9994";"136";"447167";"391185"
"V4mis2";"SILVA (only NR);Eukaryota;Amorphea;Obazoa;Opisthokonta;Holozoa;Choanozoa;Metazoa;Animalia;BCP clade;Bilateria;Protostomia;Ecdysozoa;Arthropoda;Chelicerata;";"0.3";"14";"2232";"2230";"6";"2224";"2";"454953";"391201"
"V4mis2";"SILVA (only NR);Eukaryota;Amorphea;Obazoa;Opisthokonta;Holozoa;Choanozoa;Metazoa;Animalia;BCP clade;Bilateria;Protostomia;Ecdysozoa;Arthropoda;Chelicerata;Arachnida;";"0.3";"14";"2150";"2148";"6";"2142";"2";"455035";"391201"
"V4mis2";"SILVA (only NR);Eukaryota;Amorphea;Obazoa;Opisthokonta;Holozoa;Choanozoa;Metazoa;Animalia;BCP clade;Bilateria;Protostomia;Ecdysozoa;Arthropoda;Chelicerata;Arachnida;Acari;";"0.1";"14.3";"855";"853";"1";"852";"2";"456330";"391206"
"V4mis2";"SILVA (only NR);Eukaryota;Amorphea;Obazoa;Opisthokonta;Holozoa;Choanozoa;Metazoa;Animalia;BCP clade;Bilateria;Protostomia;Ecdysozoa;Arthropoda;Chelicerata;Arachnida;Amblypygi;";"0.0";"0";"15";"15";"0";"15";"0";"457168";"391207"
"V4mis2";"SILVA (only NR);Eukaryota;Amorphea;Obazoa;Opisthokonta;Holozoa;Choanozoa;Metazoa;Animalia;BCP clade;Bilateria;Protostomia;Ecdysozoa;Arthropoda;Chelicerata;Arachnida;Araneae;";"0.5";"14.3";"864";"864";"4";"860";"0";"456319";"391203"
"V4mis2";"SILVA (only NR);Eukaryota;Amorphea;Obazoa;Opisthokonta;Holozoa;Choanozoa;Metazoa;Animalia;BCP clade;Bilateria;Protostomia;Ecdysozoa;Arthropoda;Chelicerata;Arachnida;Opiliones;";"0.3";"14.4";"294";"294";"1";"293";"0";"456889";"391206"
"V4mis2";"SILVA (only NR);Eukaryota;Amorphea;Obazoa;Opisthokonta;Holozoa;Choanozoa;Metazoa;Animalia;BCP clade;Bilateria;Protostomia;Ecdysozoa;Arthropoda;Chelicerata;Arachnida;Palpigradi;";"0.0";"0";"10";"10";"0";"10";"0";"457173";"391207"
"V4mis2";"SILVA (only NR);Eukaryota;Amorphea;Obazoa;Opisthokonta;Holozoa;Choanozoa;Metazoa;Animalia;BCP clade;Bilateria;Protostomia;Ecdysozoa;Arthropoda;Chelicerata;Arachnida;Pseudoscorpiones;";"0.0";"0";"88";"88";"0";"88";"0";"457095";"391207"
"V4mis2";"SILVA (only NR);Eukaryota;Amorphea;Obazoa;Opisthokonta;Holozoa;Choanozoa;Metazoa;Animalia;BCP clade;Bilateria;Protostomia;Ecdysozoa;Arthropoda;Chelicerata;Arachnida;Ricinulei;";"0.0";"0";"3";"3";"0";"3";"0";"457180";"391207"
"V4mis2";"SILVA (only NR);Eukaryota;Amorphea;Obazoa;Opisthokonta;Holozoa;Choanozoa;Metazoa;Animalia;BCP clade;Bilateria;Protostomia;Ecdysozoa;Arthropoda;Chelicerata;Arachnida;Scorpiones;";"0.0";"0";"12";"12";"0";"12";"0";"457171";"391207"
"V4mis2";"SILVA (only NR);Eukaryota;Amorphea;Obazoa;Opisthokonta;Holozoa;Choanozoa;Metazoa;Animalia;BCP clade;Bilateria;Protostomia;Ecdysozoa;Arthropoda;Chelicerata;Arachnida;Solifugae;";"0.0";"0";"7";"7";"0";"7";"0";"457176";"391207"
"V4mis2";"SILVA (only NR);Eukaryota;Amorphea;Obazoa;Opisthokonta;Holozoa;Choanozoa;Metazoa;Animalia;BCP clade;Bilateria;Protostomia;Ecdysozoa;Arthropoda;Chelicerata;Arachnida;Uropygi;";"0.0";"0";"2";"2";"0";"2";"0";"457181";"391207"
"V4mis2";"SILVA (only NR);Eukaryota;Amorphea;Obazoa;Opisthokonta;Holozoa;Choanozoa;Metazoa;Animalia;BCP clade;Bilateria;Protostomia;Ecdysozoa;Arthropoda;Chelicerata;Merostomata;";"0.0";"0";"9";"9";"0";"9";"0";"457174";"391207"
"V4mis2";"SILVA (only NR);Eukaryota;Amorphea;Obazoa;Opisthokonta;Holozoa;Choanozoa;Metazoa;Animalia;BCP clade;Bilateria;Protostomia;Ecdysozoa;Arthropoda;Chelicerata;Merostomata;Xiphosura;";"0.0";"0";"9";"9";"0";"9";"0";"457174";"391207"
"V4mis2";"SILVA (only NR);Eukaryota;Amorphea;Obazoa;Opisthokonta;Holozoa;Choanozoa;Metazoa;Animalia;BCP clade;Bilateria;Protostomia;Ecdysozoa;Arthropoda;Chelicerata;Pycnogonida;";"0.0";"0";"72";"72";"0";"72";"0";"457111";"391207"
"V4mis2";"SILVA (only NR);Eukaryota;Amorphea;Obazoa;Opisthokonta;Holozoa;Choanozoa;Metazoa;Animalia;BCP clade;Bilateria;Protostomia;Ecdysozoa;Arthropoda;Chelicerata;Pycnogonida;Pantopoda;";"0.0";"0";"72";"72";"0";"72";"0";"457111";"391207"
"V4mis2";"SILVA (only NR);Eukaryota;Amorphea;Obazoa;Opisthokonta;Holozoa;Choanozoa;Metazoa;Animalia;BCP clade;Bilateria;Protostomia;Ecdysozoa;Arthropoda;Crustacea;";"0.0";"0";"1909";"1901";"0";"1901";"8";"455282";"391207"
"V4mis2";"SILVA (only NR);Eukaryota;Amorphea;Obazoa;Opisthokonta;Holozoa;Choanozoa;Metazoa;Animalia;BCP clade;Bilateria;Protostomia;Ecdysozoa;Arthropoda;Crustacea;Branchiopoda;";"0.0";"0";"82";"80";"0";"80";"2";"457103";"391207"
"V4mis2";"SILVA (only NR);Eukaryota;Amorphea;Obazoa;Opisthokonta;Holozoa;Choanozoa;Metazoa;Animalia;BCP clade;Bilateria;Protostomia;Ecdysozoa;Arthropoda;Crustacea;Branchiopoda;Phyllopoda;";"0.0";"0";"75";"73";"0";"73";"2";"457110";"391207"
"V4mis2";"SILVA (only NR);Eukaryota;Amorphea;Obazoa;Opisthokonta;Holozoa;Choanozoa;Metazoa;Animalia;BCP clade;Bilateria;Protostomia;Ecdysozoa;Arthropoda;Crustacea;Branchiopoda;Phyllopoda;Diplostraca;";"0.0";"0";"73";"71";"0";"71";"2";"457112";"391207"
"V4mis2";"SILVA (only NR);Eukaryota;Amorphea;Obazoa;Opisthokonta;Holozoa;Choanozoa;Metazoa;Animalia;BCP clade;Bilateria;Protostomia;Ecdysozoa;Arthropoda;Crustacea;Branchiopoda;Phyllopoda;Notostraca;";"0.0";"0";"2";"2";"0";"2";"0";"457181";"391207"
"V4mis2";"SILVA (only NR);Eukaryota;Amorphea;Obazoa;Opisthokonta;Holozoa;Choanozoa;Metazoa;Animalia;BCP clade;Bilateria;Protostomia;Ecdysozoa;Arthropoda;Crustacea;Branchiopoda;Sarsostraca;";"0.0";"0";"7";"7";"0";"7";"0";"457176";"391207"
"V4mis2";"SILVA (only NR);Eukaryota;Amorphea;Obazoa;Opisthokonta;Holozoa;Choanozoa;Metazoa;Animalia;BCP clade;Bilateria;Protostomia;Ecdysozoa;Arthropoda;Crustacea;Branchiopoda;Sarsostraca;Anostraca;";"0.0";"0";"7";"7";"0";"7";"0";"457176";"391207"
"V4mis2";"SILVA (only NR);Eukaryota;Amorphea;Obazoa;Opisthokonta;Holozoa;Choanozoa;Metazoa;Animalia;BCP clade;Bilateria;Protostomia;Ecdysozoa;Arthropoda;Crustacea;Malacostraca;";"0.0";"0";"839";"834";"0";"834";"5";"456349";"391207"
"V4mis2";"SILVA (only NR);Eukaryota;Amorphea;Obazoa;Opisthokonta;Holozoa;Choanozoa;Metazoa;Animalia;BCP clade;Bilateria;Protostomia;Ecdysozoa;Arthropoda;Crustacea;Malacostraca;Eumalacostraca;";"0.0";"0";"834";"829";"0";"829";"5";"456354";"391207"
"V4mis2";"SILVA (only NR);Eukaryota;Amorphea;Obazoa;Opisthokonta;Holozoa;Choanozoa;Metazoa;Animalia;BCP clade;Bilateria;Protostomia;Ecdysozoa;Arthropoda;Crustacea;Malacostraca;Eumalacostraca;Eucarida;";"0.0";"0";"477";"472";"0";"472";"5";"456711";"391207"
"V4mis2";"SILVA (only NR);Eukaryota;Amorphea;Obazoa;Opisthokonta;Holozoa;Choanozoa;Metazoa;Animalia;BCP clade;Bilateria;Protostomia;Ecdysozoa;Arthropoda;Crustacea;Malacostraca;Eumalacostraca;Hoplocarida;";"0.0";"0";"10";"10";"0";"10";"0";"457173";"391207"
"V4mis2";"SILVA (only NR);Eukaryota;Amorphea;Obazoa;Opisthokonta;Holozoa;Choanozoa;Metazoa;Animalia;BCP clade;Bilateria;Protostomia;Ecdysozoa;Arthropoda;Crustacea;Malacostraca;Eumalacostraca;Peracarida;";"0.0";"0";"312";"312";"0";"312";"0";"456871";"391207"
"V4mis2";"SILVA (only NR);Eukaryota;Amorphea;Obazoa;Opisthokonta;Holozoa;Choanozoa;Metazoa;Animalia;BCP clade;Bilateria;Protostomia;Ecdysozoa;Arthropoda;Crustacea;Malacostraca;Eumalacostraca;Syncarida;";"0.0";"0";"32";"32";"0";"32";"0";"457151";"391207"
"V4mis2";"SILVA (only NR);Eukaryota;Amorphea;Obazoa;Opisthokonta;Holozoa;Choanozoa;Metazoa;Animalia;BCP clade;Bilateria;Protostomia;Ecdysozoa;Arthropoda;Crustacea;Malacostraca;Phyllocarida;";"0.0";"0";"4";"4";"0";"4";"0";"457179";"391207"
"V4mis2";"SILVA (only NR);Eukaryota;Amorphea;Obazoa;Opisthokonta;Holozoa;Choanozoa;Metazoa;Animalia;BCP clade;Bilateria;Protostomia;Ecdysozoa;Arthropoda;Crustacea;Malacostraca;Phyllocarida;Leptostraca;";"0.0";"0";"4";"4";"0";"4";"0";"457179";"391207"
"V4mis2";"SILVA (only NR);Eukaryota;Amorphea;Obazoa;Opisthokonta;Holozoa;Choanozoa;Metazoa;Animalia;BCP clade;Bilateria;Protostomia;Ecdysozoa;Arthropoda;Crustacea;Maxillopoda;";"0.0";"0";"841";"841";"0";"841";"0";"456342";"391207"
"V4mis2";"SILVA (only NR);Eukaryota;Amorphea;Obazoa;Opisthokonta;Holozoa;Choanozoa;Metazoa;Animalia;BCP clade;Bilateria;Protostomia;Ecdysozoa;Arthropoda;Crustacea;Maxillopoda;Branchiura;";"0.0";"0";"12";"12";"0";"12";"0";"457171";"391207"
"V4mis2";"SILVA (only NR);Eukaryota;Amorphea;Obazoa;Opisthokonta;Holozoa;Choanozoa;Metazoa;Animalia;BCP clade;Bilateria;Protostomia;Ecdysozoa;Arthropoda;Crustacea;Maxillopoda;Branchiura;Arguloida;";"0.0";"0";"12";"12";"0";"12";"0";"457171";"391207"
"V4mis2";"SILVA (only NR);Eukaryota;Amorphea;Obazoa;Opisthokonta;Holozoa;Choanozoa;Metazoa;Animalia;BCP clade;Bilateria;Protostomia;Ecdysozoa;Arthropoda;Crustacea;Maxillopoda;Copepoda;";"0.0";"0";"673";"673";"0";"673";"0";"456510";"391207"
"V4mis2";"SILVA (only NR);Eukaryota;Amorphea;Obazoa;Opisthokonta;Holozoa;Choanozoa;Metazoa;Animalia;BCP clade;Bilateria;Protostomia;Ecdysozoa;Arthropoda;Crustacea;Maxillopoda;Copepoda;Calanoida;";"0.0";"0";"263";"263";"0";"263";"0";"456920";"391207"
"V4mis2";"SILVA (only NR);Eukaryota;Amorphea;Obazoa;Opisthokonta;Holozoa;Choanozoa;Metazoa;Animalia;BCP clade;Bilateria;Protostomia;Ecdysozoa;Arthropoda;Crustacea;Maxillopoda;Copepoda;Cyclopoida;";"0.0";"0";"159";"159";"0";"159";"0";"457024";"391207"
"V4mis2";"SILVA (only NR);Eukaryota;Amorphea;Obazoa;Opisthokonta;Holozoa;Choanozoa;Metazoa;Animalia;BCP clade;Bilateria;Protostomia;Ecdysozoa;Arthropoda;Crustacea;Maxillopoda;Copepoda;Harpacticoida;";"0.0";"0";"95";"95";"0";"95";"0";"457088";"391207"
"V4mis2";"SILVA (only NR);Eukaryota;Amorphea;Obazoa;Opisthokonta;Holozoa;Choanozoa;Metazoa;Animalia;BCP clade;Bilateria;Protostomia;Ecdysozoa;Arthropoda;Crustacea;Maxillopoda;Copepoda;Misophrioida;";"0.0";"0";"6";"6";"0";"6";"0";"457177";"391207"
"V4mis2";"SILVA (only NR);Eukaryota;Amorphea;Obazoa;Opisthokonta;Holozoa;Choanozoa;Metazoa;Animalia;BCP clade;Bilateria;Protostomia;Ecdysozoa;Arthropoda;Crustacea;Maxillopoda;Copepoda;Monstrilloida;";"0.0";"0";"18";"18";"0";"18";"0";"457165";"391207"
"V4mis2";"SILVA (only NR);Eukaryota;Amorphea;Obazoa;Opisthokonta;Holozoa;Choanozoa;Metazoa;Animalia;BCP clade;Bilateria;Protostomia;Ecdysozoa;Arthropoda;Crustacea;Maxillopoda;Copepoda;Poecilostomatoida;";"0.0";"0";"46";"46";"0";"46";"0";"457137";"391207"
"V4mis2";"SILVA (only NR);Eukaryota;Amorphea;Obazoa;Opisthokonta;Holozoa;Choanozoa;Metazoa;Animalia;BCP clade;Bilateria;Protostomia;Ecdysozoa;Arthropoda;Crustacea;Maxillopoda;Copepoda;Siphonostomatoida;";"0.0";"0";"58";"58";"0";"58";"0";"457125";"391207"
"V4mis2";"SILVA (only NR);Eukaryota;Amorphea;Obazoa;Opisthokonta;Holozoa;Choanozoa;Metazoa;Animalia;BCP clade;Bilateria;Protostomia;Ecdysozoa;Arthropoda;Crustacea;Maxillopoda;Pentastomida;";"0.0";"0";"13";"13";"0";"13";"0";"457170";"391207"
"V4mis2";"SILVA (only NR);Eukaryota;Amorphea;Obazoa;Opisthokonta;Holozoa;Choanozoa;Metazoa;Animalia;BCP clade;Bilateria;Protostomia;Ecdysozoa;Arthropoda;Crustacea;Maxillopoda;Pentastomida;Cephalobaenida;";"0.0";"0";"4";"4";"0";"4";"0";"457179";"391207"
"V4mis2";"SILVA (only NR);Eukaryota;Amorphea;Obazoa;Opisthokonta;Holozoa;Choanozoa;Metazoa;Animalia;BCP clade;Bilateria;Protostomia;Ecdysozoa;Arthropoda;Crustacea;Maxillopoda;Pentastomida;Porocephalida;";"0.0";"0";"8";"8";"0";"8";"0";"457175";"391207"
"V4mis2";"SILVA (only NR);Eukaryota;Amorphea;Obazoa;Opisthokonta;Holozoa;Choanozoa;Metazoa;Animalia;BCP clade;Bilateria;Protostomia;Ecdysozoa;Arthropoda;Crustacea;Maxillopoda;Tantulocarida;";"0.0";"0";"2";"2";"0";"2";"0";"457181";"391207"
"V4mis2";"SILVA (only NR);Eukaryota;Amorphea;Obazoa;Opisthokonta;Holozoa;Choanozoa;Metazoa;Animalia;BCP clade;Bilateria;Protostomia;Ecdysozoa;Arthropoda;Crustacea;Maxillopoda;Thecostraca;";"0.0";"0";"140";"140";"0";"140";"0";"457043";"391207"
"V4mis2";"SILVA (only NR);Eukaryota;Amorphea;Obazoa;Opisthokonta;Holozoa;Choanozoa;Metazoa;Animalia;BCP clade;Bilateria;Protostomia;Ecdysozoa;Arthropoda;Crustacea;Maxillopoda;Thecostraca;Akentrogonida;";"0.0";"0";"7";"7";"0";"7";"0";"457176";"391207"
"V4mis2";"SILVA (only NR);Eukaryota;Amorphea;Obazoa;Opisthokonta;Holozoa;Choanozoa;Metazoa;Animalia;BCP clade;Bilateria;Protostomia;Ecdysozoa;Arthropoda;Crustacea;Maxillopoda;Thecostraca;Apygophora;";"0.0";"0";"2";"2";"0";"2";"0";"457181";"391207"
"V4mis2";"SILVA (only NR);Eukaryota;Amorphea;Obazoa;Opisthokonta;Holozoa;Choanozoa;Metazoa;Animalia;BCP clade;Bilateria;Protostomia;Ecdysozoa;Arthropoda;Crustacea;Maxillopoda;Thecostraca;Dendrogastrida;";"0.0";"0";"4";"4";"0";"4";"0";"457179";"391207"
"V4mis2";"SILVA (only NR);Eukaryota;Amorphea;Obazoa;Opisthokonta;Holozoa;Choanozoa;Metazoa;Animalia;BCP clade;Bilateria;Protostomia;Ecdysozoa;Arthropoda;Crustacea;Maxillopoda;Thecostraca;Facetotecta;";"0.0";"0";"5";"5";"0";"5";"0";"457178";"391207"
"V4mis2";"SILVA (only NR);Eukaryota;Amorphea;Obazoa;Opisthokonta;Holozoa;Choanozoa;Metazoa;Animalia;BCP clade;Bilateria;Protostomia;Ecdysozoa;Arthropoda;Crustacea;Maxillopoda;Thecostraca;Kentrogonida;";"0.0";"0";"22";"22";"0";"22";"0";"457161";"391207"
"V4mis2";"SILVA (only NR);Eukaryota;Amorphea;Obazoa;Opisthokonta;Holozoa;Choanozoa;Metazoa;Animalia;BCP clade;Bilateria;Protostomia;Ecdysozoa;Arthropoda;Crustacea;Maxillopoda;Thecostraca;Laurida;";"0.0";"0";"2";"2";"0";"2";"0";"457181";"391207"
"V4mis2";"SILVA (only NR);Eukaryota;Amorphea;Obazoa;Opisthokonta;Holozoa;Choanozoa;Metazoa;Animalia;BCP clade;Bilateria;Protostomia;Ecdysozoa;Arthropoda;Crustacea;Maxillopoda;Thecostraca;Pedunculata;";"0.0";"0";"41";"41";"0";"41";"0";"457142";"391207"
"V4mis2";"SILVA (only NR);Eukaryota;Amorphea;Obazoa;Opisthokonta;Holozoa;Choanozoa;Metazoa;Animalia;BCP clade;Bilateria;Protostomia;Ecdysozoa;Arthropoda;Crustacea;Maxillopoda;Thecostraca;Pygophora;";"0.0";"0";"4";"4";"0";"4";"0";"457179";"391207"
"V4mis2";"SILVA (only NR);Eukaryota;Amorphea;Obazoa;Opisthokonta;Holozoa;Choanozoa;Metazoa;Animalia;BCP clade;Bilateria;Protostomia;Ecdysozoa;Arthropoda;Crustacea;Maxillopoda;Thecostraca;Sessilia;";"0.0";"0";"50";"50";"0";"50";"0";"457133";"391207"
"V4mis2";"SILVA (only NR);Eukaryota;Amorphea;Obazoa;Opisthokonta;Holozoa;Choanozoa;Metazoa;Animalia;BCP clade;Bilateria;Protostomia;Ecdysozoa;Arthropoda;Crustacea;Ostracoda;";"0.0";"0";"141";"141";"0";"141";"0";"457042";"391207"
"V4mis2";"SILVA (only NR);Eukaryota;Amorphea;Obazoa;Opisthokonta;Holozoa;Choanozoa;Metazoa;Animalia;BCP clade;Bilateria;Protostomia;Ecdysozoa;Arthropoda;Crustacea;Ostracoda;Myodocopa;";"0.0";"0";"35";"35";"0";"35";"0";"457148";"391207"
"V4mis2";"SILVA (only NR);Eukaryota;Amorphea;Obazoa;Opisthokonta;Holozoa;Choanozoa;Metazoa;Animalia;BCP clade;Bilateria;Protostomia;Ecdysozoa;Arthropoda;Crustacea;Ostracoda;Myodocopa;Halocyprida;";"0.0";"0";"14";"14";"0";"14";"0";"457169";"391207"
"V4mis2";"SILVA (only NR);Eukaryota;Amorphea;Obazoa;Opisthokonta;Holozoa;Choanozoa;Metazoa;Animalia;BCP clade;Bilateria;Protostomia;Ecdysozoa;Arthropoda;Crustacea;Ostracoda;Myodocopa;Myodocopida;";"0.0";"0";"21";"21";"0";"21";"0";"457162";"391207"
"V4mis2";"SILVA (only NR);Eukaryota;Amorphea;Obazoa;Opisthokonta;Holozoa;Choanozoa;Metazoa;Animalia;BCP clade;Bilateria;Protostomia;Ecdysozoa;Arthropoda;Crustacea;Ostracoda;Podocopa;";"0.0";"0";"106";"106";"0";"106";"0";"457077";"391207"
"V4mis2";"SILVA (only NR);Eukaryota;Amorphea;Obazoa;Opisthokonta;Holozoa;Choanozoa;Metazoa;Animalia;BCP clade;Bilateria;Protostomia;Ecdysozoa;Arthropoda;Crustacea;Ostracoda;Podocopa;Podocopida;";"0.0";"0";"105";"105";"0";"105";"0";"457078";"391207"
"V4mis2";"SILVA (only NR);Eukaryota;Amorphea;Obazoa;Opisthokonta;Holozoa;Choanozoa;Metazoa;Animalia;BCP clade;Bilateria;Protostomia;Ecdysozoa;Arthropoda;Hexapoda;";"0.3";"13.4";"5800";"5674";"15";"5659";"126";"451509";"391192"
"V4mis2";"SILVA (only NR);Eukaryota;Amorphea;Obazoa;Opisthokonta;Holozoa;Choanozoa;Metazoa;Animalia;BCP clade;Bilateria;Protostomia;Ecdysozoa;Arthropoda;Hexapoda;Diplura;";"0.0";"0";"13";"13";"0";"13";"0";"457170";"391207"
"V4mis2";"SILVA (only NR);Eukaryota;Amorphea;Obazoa;Opisthokonta;Holozoa;Choanozoa;Metazoa;Animalia;BCP clade;Bilateria;Protostomia;Ecdysozoa;Arthropoda;Hexapoda;Diplura;Campodeoidea;";"0.0";"0";"7";"7";"0";"7";"0";"457176";"391207"
"V4mis2";"SILVA (only NR);Eukaryota;Amorphea;Obazoa;Opisthokonta;Holozoa;Choanozoa;Metazoa;Animalia;BCP clade;Bilateria;Protostomia;Ecdysozoa;Arthropoda;Hexapoda;Diplura;Japygoidea;";"0.0";"0";"4";"4";"0";"4";"0";"457179";"391207"
"V4mis2";"SILVA (only NR);Eukaryota;Amorphea;Obazoa;Opisthokonta;Holozoa;Choanozoa;Metazoa;Animalia;BCP clade;Bilateria;Protostomia;Ecdysozoa;Arthropoda;Hexapoda;Ellipura;";"0.0";"0";"156";"155";"0";"155";"1";"457028";"391207"
"V4mis2";"SILVA (only NR);Eukaryota;Amorphea;Obazoa;Opisthokonta;Holozoa;Choanozoa;Metazoa;Animalia;BCP clade;Bilateria;Protostomia;Ecdysozoa;Arthropoda;Hexapoda;Ellipura;Collembola;";"0.0";"0";"129";"128";"0";"128";"1";"457055";"391207"
"V4mis2";"SILVA (only NR);Eukaryota;Amorphea;Obazoa;Opisthokonta;Holozoa;Choanozoa;Metazoa;Animalia;BCP clade;Bilateria;Protostomia;Ecdysozoa;Arthropoda;Hexapoda;Ellipura;Protura;";"0.0";"0";"27";"27";"0";"27";"0";"457156";"391207"
"V4mis2";"SILVA (only NR);Eukaryota;Amorphea;Obazoa;Opisthokonta;Holozoa;Choanozoa;Metazoa;Animalia;BCP clade;Bilateria;Protostomia;Ecdysozoa;Arthropoda;Hexapoda;Insecta;";"0.3";"13.4";"5631";"5506";"15";"5491";"125";"451677";"391192"
"V4mis2";"SILVA (only NR);Eukaryota;Amorphea;Obazoa;Opisthokonta;Holozoa;Choanozoa;Metazoa;Animalia;BCP clade;Bilateria;Protostomia;Ecdysozoa;Arthropoda;Hexapoda;Insecta;Monocondylia;";"0.0";"0";"11";"11";"0";"11";"0";"457172";"391207"
"V4mis2";"SILVA (only NR);Eukaryota;Amorphea;Obazoa;Opisthokonta;Holozoa;Choanozoa;Metazoa;Animalia;BCP clade;Bilateria;Protostomia;Ecdysozoa;Arthropoda;Hexapoda;Insecta;Monocondylia;Archaeognatha;";"0.0";"0";"11";"11";"0";"11";"0";"457172";"391207"
"V4mis2";"SILVA (only NR);Eukaryota;Amorphea;Obazoa;Opisthokonta;Holozoa;Choanozoa;Metazoa;Animalia;BCP clade;Bilateria;Protostomia;Ecdysozoa;Arthropoda;Hexapoda;Insecta;Pterygota;";"0.3";"13.4";"5605";"5480";"15";"5465";"125";"451703";"391192"
"V4mis2";"SILVA (only NR);Eukaryota;Amorphea;Obazoa;Opisthokonta;Holozoa;Choanozoa;Metazoa;Animalia;BCP clade;Bilateria;Protostomia;Ecdysozoa;Arthropoda;Hexapoda;Insecta;Pterygota;Neoptera;";"0.3";"13.4";"5443";"5319";"15";"5304";"124";"451864";"391192"
"V4mis2";"SILVA (only NR);Eukaryota;Amorphea;Obazoa;Opisthokonta;Holozoa;Choanozoa;Metazoa;Animalia;BCP clade;Bilateria;Protostomia;Ecdysozoa;Arthropoda;Hexapoda;Insecta;Pterygota;Neoptera;Amphiesmenoptera;";"16.3";"14.4";"84";"80";"13";"67";"4";"457103";"391194"
"V4mis2";"SILVA (only NR);Eukaryota;Amorphea;Obazoa;Opisthokonta;Holozoa;Choanozoa;Metazoa;Animalia;BCP clade;Bilateria;Protostomia;Ecdysozoa;Arthropoda;Hexapoda;Insecta;Pterygota;Neoptera;Amphiesmenoptera;Lepidoptera;";"0.0";"0";"69";"65";"0";"65";"4";"457118";"391207"
"V4mis2";"SILVA (only NR);Eukaryota;Amorphea;Obazoa;Opisthokonta;Holozoa;Choanozoa;Metazoa;Animalia;BCP clade;Bilateria;Protostomia;Ecdysozoa;Arthropoda;Hexapoda;Insecta;Pterygota;Neoptera;Amphiesmenoptera;Trichoptera;";"100.0";"14.4";"13";"13";"13";"0";"0";"457170";"391194"
"V4mis2";"SILVA (only NR);Eukaryota;Amorphea;Obazoa;Opisthokonta;Holozoa;Choanozoa;Metazoa;Animalia;BCP clade;Bilateria;Protostomia;Ecdysozoa;Arthropoda;Hexapoda;Insecta;Pterygota;Neoptera;Coleoptera;";"0.0";"0";"2365";"2348";"0";"2348";"17";"454835";"391207"
"V4mis2";"SILVA (only NR);Eukaryota;Amorphea;Obazoa;Opisthokonta;Holozoa;Choanozoa;Metazoa;Animalia;BCP clade;Bilateria;Protostomia;Ecdysozoa;Arthropoda;Hexapoda;Insecta;Pterygota;Neoptera;Dermaptera;";"0.0";"0";"19";"19";"0";"19";"0";"457164";"391207"
"V4mis2";"SILVA (only NR);Eukaryota;Amorphea;Obazoa;Opisthokonta;Holozoa;Choanozoa;Metazoa;Animalia;BCP clade;Bilateria;Protostomia;Ecdysozoa;Arthropoda;Hexapoda;Insecta;Pterygota;Neoptera;Dictyoptera;";"0.0";"0";"132";"130";"0";"130";"2";"457053";"391207"
"V4mis2";"SILVA (only NR);Eukaryota;Amorphea;Obazoa;Opisthokonta;Holozoa;Choanozoa;Metazoa;Animalia;BCP clade;Bilateria;Protostomia;Ecdysozoa;Arthropoda;Hexapoda;Insecta;Pterygota;Neoptera;Dictyoptera;Blattodea;";"0.0";"0";"84";"82";"0";"82";"2";"457101";"391207"
"V4mis2";"SILVA (only NR);Eukaryota;Amorphea;Obazoa;Opisthokonta;Holozoa;Choanozoa;Metazoa;Animalia;BCP clade;Bilateria;Protostomia;Ecdysozoa;Arthropoda;Hexapoda;Insecta;Pterygota;Neoptera;Dictyoptera;Isoptera;";"0.0";"0";"14";"14";"0";"14";"0";"457169";"391207"
"V4mis2";"SILVA (only NR);Eukaryota;Amorphea;Obazoa;Opisthokonta;Holozoa;Choanozoa;Metazoa;Animalia;BCP clade;Bilateria;Protostomia;Ecdysozoa;Arthropoda;Hexapoda;Insecta;Pterygota;Neoptera;Dictyoptera;Mantodea;";"0.0";"0";"32";"32";"0";"32";"0";"457151";"391207"
"V4mis2";"SILVA (only NR);Eukaryota;Amorphea;Obazoa;Opisthokonta;Holozoa;Choanozoa;Metazoa;Animalia;BCP clade;Bilateria;Protostomia;Ecdysozoa;Arthropoda;Hexapoda;Insecta;Pterygota;Neoptera;Diptera;";"0.1";"14.3";"810";"792";"1";"791";"18";"456391";"391206"
"V4mis2";"SILVA (only NR);Eukaryota;Amorphea;Obazoa;Opisthokonta;Holozoa;Choanozoa;Metazoa;Animalia;BCP clade;Bilateria;Protostomia;Ecdysozoa;Arthropoda;Hexapoda;Insecta;Pterygota;Neoptera;Embioptera;";"0.0";"0";"28";"28";"0";"28";"0";"457155";"391207"
"V4mis2";"SILVA (only NR);Eukaryota;Amorphea;Obazoa;Opisthokonta;Holozoa;Choanozoa;Metazoa;Animalia;BCP clade;Bilateria;Protostomia;Ecdysozoa;Arthropoda;Hexapoda;Insecta;Pterygota;Neoptera;Grylloblattodea;";"0.0";"0";"14";"14";"0";"14";"0";"457169";"391207"
"V4mis2";"SILVA (only NR);Eukaryota;Amorphea;Obazoa;Opisthokonta;Holozoa;Choanozoa;Metazoa;Animalia;BCP clade;Bilateria;Protostomia;Ecdysozoa;Arthropoda;Hexapoda;Insecta;Pterygota;Neoptera;Hemiptera;";"0.0";"0";"757";"699";"0";"699";"58";"456484";"391207"
"V4mis2";"SILVA (only NR);Eukaryota;Amorphea;Obazoa;Opisthokonta;Holozoa;Choanozoa;Metazoa;Animalia;BCP clade;Bilateria;Protostomia;Ecdysozoa;Arthropoda;Hexapoda;Insecta;Pterygota;Neoptera;Hymenoptera;";"0.0";"0";"418";"412";"0";"412";"6";"456771";"391207"
"V4mis2";"SILVA (only NR);Eukaryota;Amorphea;Obazoa;Opisthokonta;Holozoa;Choanozoa;Metazoa;Animalia;BCP clade;Bilateria;Protostomia;Ecdysozoa;Arthropoda;Hexapoda;Insecta;Pterygota;Neoptera;Mantophasmatodea;";"0.0";"0";"3";"2";"0";"2";"1";"457181";"391207"
"V4mis2";"SILVA (only NR);Eukaryota;Amorphea;Obazoa;Opisthokonta;Holozoa;Choanozoa;Metazoa;Animalia;BCP clade;Bilateria;Protostomia;Ecdysozoa;Arthropoda;Hexapoda;Insecta;Pterygota;Neoptera;Mecoptera;";"0.0";"0";"27";"27";"0";"27";"0";"457156";"391207"
"V4mis2";"SILVA (only NR);Eukaryota;Amorphea;Obazoa;Opisthokonta;Holozoa;Choanozoa;Metazoa;Animalia;BCP clade;Bilateria;Protostomia;Ecdysozoa;Arthropoda;Hexapoda;Insecta;Pterygota;Neoptera;Megaloptera;";"0.0";"0";"4";"4";"0";"4";"0";"457179";"391207"
"V4mis2";"SILVA (only NR);Eukaryota;Amorphea;Obazoa;Opisthokonta;Holozoa;Choanozoa;Metazoa;Animalia;BCP clade;Bilateria;Protostomia;Ecdysozoa;Arthropoda;Hexapoda;Insecta;Pterygota;Neoptera;Neuroptera;";"0.0";"0";"71";"66";"0";"66";"5";"457117";"391207"
"V4mis2";"SILVA (only NR);Eukaryota;Amorphea;Obazoa;Opisthokonta;Holozoa;Choanozoa;Metazoa;Animalia;BCP clade;Bilateria;Protostomia;Ecdysozoa;Arthropoda;Hexapoda;Insecta;Pterygota;Neoptera;Orthoptera;";"0.0";"0";"133";"131";"0";"131";"2";"457052";"391207"
"V4mis2";"SILVA (only NR);Eukaryota;Amorphea;Obazoa;Opisthokonta;Holozoa;Choanozoa;Metazoa;Animalia;BCP clade;Bilateria;Protostomia;Ecdysozoa;Arthropoda;Hexapoda;Insecta;Pterygota;Neoptera;Phasmatodea;";"0.0";"0";"32";"32";"0";"32";"0";"457151";"391207"
"V4mis2";"SILVA (only NR);Eukaryota;Amorphea;Obazoa;Opisthokonta;Holozoa;Choanozoa;Metazoa;Animalia;BCP clade;Bilateria;Protostomia;Ecdysozoa;Arthropoda;Hexapoda;Insecta;Pterygota;Neoptera;Phthiraptera;";"0.0";"0";"40";"34";"0";"34";"6";"457149";"391207"
"V4mis2";"SILVA (only NR);Eukaryota;Amorphea;Obazoa;Opisthokonta;Holozoa;Choanozoa;Metazoa;Animalia;BCP clade;Bilateria;Protostomia;Ecdysozoa;Arthropoda;Hexapoda;Insecta;Pterygota;Neoptera;Plecoptera;";"0.0";"0";"132";"130";"0";"130";"2";"457053";"391207"
"V4mis2";"SILVA (only NR);Eukaryota;Amorphea;Obazoa;Opisthokonta;Holozoa;Choanozoa;Metazoa;Animalia;BCP clade;Bilateria;Protostomia;Ecdysozoa;Arthropoda;Hexapoda;Insecta;Pterygota;Neoptera;Psocoptera;";"0.0";"0";"151";"150";"0";"150";"1";"457033";"391207"
"V4mis2";"SILVA (only NR);Eukaryota;Amorphea;Obazoa;Opisthokonta;Holozoa;Choanozoa;Metazoa;Animalia;BCP clade;Bilateria;Protostomia;Ecdysozoa;Arthropoda;Hexapoda;Insecta;Pterygota;Neoptera;Raphidioptera;";"0.0";"0";"5";"5";"0";"5";"0";"457178";"391207"
"V4mis2";"SILVA (only NR);Eukaryota;Amorphea;Obazoa;Opisthokonta;Holozoa;Choanozoa;Metazoa;Animalia;BCP clade;Bilateria;Protostomia;Ecdysozoa;Arthropoda;Hexapoda;Insecta;Pterygota;Neoptera;Siphonaptera;";"0.0";"0";"52";"52";"0";"52";"0";"457131";"391207"
"V4mis2";"SILVA (only NR);Eukaryota;Amorphea;Obazoa;Opisthokonta;Holozoa;Choanozoa;Metazoa;Animalia;BCP clade;Bilateria;Protostomia;Ecdysozoa;Arthropoda;Hexapoda;Insecta;Pterygota;Neoptera;Strepsiptera;";"0.0";"0";"7";"6";"0";"6";"1";"457177";"391207"
"V4mis2";"SILVA (only NR);Eukaryota;Amorphea;Obazoa;Opisthokonta;Holozoa;Choanozoa;Metazoa;Animalia;BCP clade;Bilateria;Protostomia;Ecdysozoa;Arthropoda;Hexapoda;Insecta;Pterygota;Neoptera;Thysanoptera;";"1.0";"14.4";"102";"102";"1";"101";"0";"457081";"391206"
"V4mis2";"SILVA (only NR);Eukaryota;Amorphea;Obazoa;Opisthokonta;Holozoa;Choanozoa;Metazoa;Animalia;BCP clade;Bilateria;Protostomia;Ecdysozoa;Arthropoda;Hexapoda;Insecta;Pterygota;Neoptera;Zoraptera;";"0.0";"0";"10";"10";"0";"10";"0";"457173";"391207"
"V4mis2";"SILVA (only NR);Eukaryota;Amorphea;Obazoa;Opisthokonta;Holozoa;Choanozoa;Metazoa;Animalia;BCP clade;Bilateria;Protostomia;Ecdysozoa;Arthropoda;Hexapoda;Insecta;Pterygota;Palaeoptera;";"0.0";"0";"162";"161";"0";"161";"1";"457022";"391207"
"V4mis2";"SILVA (only NR);Eukaryota;Amorphea;Obazoa;Opisthokonta;Holozoa;Choanozoa;Metazoa;Animalia;BCP clade;Bilateria;Protostomia;Ecdysozoa;Arthropoda;Hexapoda;Insecta;Pterygota;Palaeoptera;Ephemeroptera;";"0.0";"0";"115";"114";"0";"114";"1";"457069";"391207"
"V4mis2";"SILVA (only NR);Eukaryota;Amorphea;Obazoa;Opisthokonta;Holozoa;Choanozoa;Metazoa;Animalia;BCP clade;Bilateria;Protostomia;Ecdysozoa;Arthropoda;Hexapoda;Insecta;Pterygota;Palaeoptera;Odonata;";"0.0";"0";"47";"47";"0";"47";"0";"457136";"391207"
"V4mis2";"SILVA (only NR);Eukaryota;Amorphea;Obazoa;Opisthokonta;Holozoa;Choanozoa;Metazoa;Animalia;BCP clade;Bilateria;Protostomia;Ecdysozoa;Arthropoda;Hexapoda;Insecta;Thysanura;";"0.0";"0";"5";"5";"0";"5";"0";"457178";"391207"
"V4mis2";"SILVA (only NR);Eukaryota;Amorphea;Obazoa;Opisthokonta;Holozoa;Choanozoa;Metazoa;Animalia;BCP clade;Bilateria;Protostomia;Ecdysozoa;Arthropoda;Hexapoda;Insecta;Thysanura;Nicoletiidae;";"0.0";"0";"5";"5";"0";"5";"0";"457178";"391207"
"V4mis2";"SILVA (only NR);Eukaryota;Amorphea;Obazoa;Opisthokonta;Holozoa;Choanozoa;Metazoa;Animalia;BCP clade;Bilateria;Protostomia;Ecdysozoa;Arthropoda;Hexapoda;Insecta;Zygentoma;";"0.0";"0";"8";"8";"0";"8";"0";"457175";"391207"
"V4mis2";"SILVA (only NR);Eukaryota;Amorphea;Obazoa;Opisthokonta;Holozoa;Choanozoa;Metazoa;Animalia;BCP clade;Bilateria;Protostomia;Ecdysozoa;Arthropoda;Hexapoda;Insecta;Zygentoma;Lepismatidae;";"0.0";"0";"8";"8";"0";"8";"0";"457175";"391207"
"V4mis2";"SILVA (only NR);Eukaryota;Amorphea;Obazoa;Opisthokonta;Holozoa;Choanozoa;Metazoa;Animalia;BCP clade;Bilateria;Protostomia;Ecdysozoa;Arthropoda;Hexapoda;Insecta;Zygentoma;Lepismatidae;Lepisma;";"0.0";"0";"2";"2";"0";"2";"0";"457181";"391207"
"V4mis2";"SILVA (only NR);Eukaryota;Amorphea;Obazoa;Opisthokonta;Holozoa;Choanozoa;Metazoa;Animalia;BCP clade;Bilateria;Protostomia;Ecdysozoa;Arthropoda;Myriapoda;";"0.5";"14.4";"211";"211";"1";"210";"0";"456972";"391206"
"V4mis2";"SILVA (only NR);Eukaryota;Amorphea;Obazoa;Opisthokonta;Holozoa;Choanozoa;Metazoa;Animalia;BCP clade;Bilateria;Protostomia;Ecdysozoa;Arthropoda;Myriapoda;Chilopoda;";"0.0";"0";"126";"126";"0";"126";"0";"457057";"391207"
"V4mis2";"SILVA (only NR);Eukaryota;Amorphea;Obazoa;Opisthokonta;Holozoa;Choanozoa;Metazoa;Animalia;BCP clade;Bilateria;Protostomia;Ecdysozoa;Arthropoda;Myriapoda;Chilopoda;Notostigmophora;";"0.0";"0";"5";"5";"0";"5";"0";"457178";"391207"
"V4mis2";"SILVA (only NR);Eukaryota;Amorphea;Obazoa;Opisthokonta;Holozoa;Choanozoa;Metazoa;Animalia;BCP clade;Bilateria;Protostomia;Ecdysozoa;Arthropoda;Myriapoda;Chilopoda;Pleurostigmophora;";"0.0";"0";"120";"120";"0";"120";"0";"457063";"391207"
"V4mis2";"SILVA (only NR);Eukaryota;Amorphea;Obazoa;Opisthokonta;Holozoa;Choanozoa;Metazoa;Animalia;BCP clade;Bilateria;Protostomia;Ecdysozoa;Arthropoda;Myriapoda;Diplopoda;";"1.2";"14.4";"85";"85";"1";"84";"0";"457098";"391206"
"V4mis2";"SILVA (only NR);Eukaryota;Amorphea;Obazoa;Opisthokonta;Holozoa;Choanozoa;Metazoa;Animalia;BCP clade;Bilateria;Protostomia;Ecdysozoa;Arthropoda;Myriapoda;Diplopoda;Helminthomorpha;";"1.3";"14.4";"75";"75";"1";"74";"0";"457108";"391206"
"V4mis2";"SILVA (only NR);Eukaryota;Amorphea;Obazoa;Opisthokonta;Holozoa;Choanozoa;Metazoa;Animalia;BCP clade;Bilateria;Protostomia;Ecdysozoa;Arthropoda;Myriapoda;Diplopoda;Penicillata;";"0.0";"0";"8";"8";"0";"8";"0";"457175";"391207"
"V4mis2";"SILVA (only NR);Eukaryota;Amorphea;Obazoa;Opisthokonta;Holozoa;Choanozoa;Metazoa;Animalia;BCP clade;Bilateria;Protostomia;Ecdysozoa;Incertae Sedis;";"0.0";"0";"3";"3";"0";"3";"0";"457180";"391207"
"V4mis2";"SILVA (only NR);Eukaryota;Amorphea;Obazoa;Opisthokonta;Holozoa;Choanozoa;Metazoa;Animalia;BCP clade;Bilateria;Protostomia;Ecdysozoa;Nematozoa;";"1.3";"14";"2184";"2176";"28";"2148";"8";"455007";"391179"
"V4mis2";"SILVA (only NR);Eukaryota;Amorphea;Obazoa;Opisthokonta;Holozoa;Choanozoa;Metazoa;Animalia;BCP clade;Bilateria;Protostomia;Ecdysozoa;Nematozoa;Nematoda;";"1.3";"14";"2170";"2162";"28";"2134";"8";"455021";"391179"
"V4mis2";"SILVA (only NR);Eukaryota;Amorphea;Obazoa;Opisthokonta;Holozoa;Choanozoa;Metazoa;Animalia;BCP clade;Bilateria;Protostomia;Ecdysozoa;Nematozoa;Nematoda;Chromadorea;";"1.9";"14.2";"1443";"1442";"28";"1414";"1";"455741";"391179"
"V4mis2";"SILVA (only NR);Eukaryota;Amorphea;Obazoa;Opisthokonta;Holozoa;Choanozoa;Metazoa;Animalia;BCP clade;Bilateria;Protostomia;Ecdysozoa;Nematozoa;Nematoda;Chromadorea;Araeolaimida;";"0.0";"0";"55";"55";"0";"55";"0";"457128";"391207"
"V4mis2";"SILVA (only NR);Eukaryota;Amorphea;Obazoa;Opisthokonta;Holozoa;Choanozoa;Metazoa;Animalia;BCP clade;Bilateria;Protostomia;Ecdysozoa;Nematozoa;Nematoda;Chromadorea;Ascaridida;";"0.0";"0";"47";"47";"0";"47";"0";"457136";"391207"
"V4mis2";"SILVA (only NR);Eukaryota;Amorphea;Obazoa;Opisthokonta;Holozoa;Choanozoa;Metazoa;Animalia;BCP clade;Bilateria;Protostomia;Ecdysozoa;Nematozoa;Nematoda;Chromadorea;Chromadorida;";"0.0";"0";"39";"39";"0";"39";"0";"457144";"391207"
"V4mis2";"SILVA (only NR);Eukaryota;Amorphea;Obazoa;Opisthokonta;Holozoa;Choanozoa;Metazoa;Animalia;BCP clade;Bilateria;Protostomia;Ecdysozoa;Nematozoa;Nematoda;Chromadorea;Desmodorida;";"0.0";"0";"74";"74";"0";"74";"0";"457109";"391207"
"V4mis2";"SILVA (only NR);Eukaryota;Amorphea;Obazoa;Opisthokonta;Holozoa;Choanozoa;Metazoa;Animalia;BCP clade;Bilateria;Protostomia;Ecdysozoa;Nematozoa;Nematoda;Chromadorea;Desmoscolecida;";"0.0";"0";"2";"2";"0";"2";"0";"457181";"391207"
"V4mis2";"SILVA (only NR);Eukaryota;Amorphea;Obazoa;Opisthokonta;Holozoa;Choanozoa;Metazoa;Animalia;BCP clade;Bilateria;Protostomia;Ecdysozoa;Nematozoa;Nematoda;Chromadorea;Diplogasterida;";"0.9";"14.4";"107";"107";"1";"106";"0";"457076";"391206"
"V4mis2";"SILVA (only NR);Eukaryota;Amorphea;Obazoa;Opisthokonta;Holozoa;Choanozoa;Metazoa;Animalia;BCP clade;Bilateria;Protostomia;Ecdysozoa;Nematozoa;Nematoda;Chromadorea;Monhysterida;";"0.0";"0";"89";"89";"0";"89";"0";"457094";"391207"
"V4mis2";"SILVA (only NR);Eukaryota;Amorphea;Obazoa;Opisthokonta;Holozoa;Choanozoa;Metazoa;Animalia;BCP clade;Bilateria;Protostomia;Ecdysozoa;Nematozoa;Nematoda;Chromadorea;Oxyurida;";"0.0";"0";"30";"30";"0";"30";"0";"457153";"391207"
"V4mis2";"SILVA (only NR);Eukaryota;Amorphea;Obazoa;Opisthokonta;Holozoa;Choanozoa;Metazoa;Animalia;BCP clade;Bilateria;Protostomia;Ecdysozoa;Nematozoa;Nematoda;Chromadorea;Rhabditida;";"6.1";"14.4";"297";"297";"18";"279";"0";"456886";"391189"
"V4mis2";"SILVA (only NR);Eukaryota;Amorphea;Obazoa;Opisthokonta;Holozoa;Choanozoa;Metazoa;Animalia;BCP clade;Bilateria;Protostomia;Ecdysozoa;Nematozoa;Nematoda;Chromadorea;Rhigonematida;";"0.0";"0";"10";"10";"0";"10";"0";"457173";"391207"
"V4mis2";"SILVA (only NR);Eukaryota;Amorphea;Obazoa;Opisthokonta;Holozoa;Choanozoa;Metazoa;Animalia;BCP clade;Bilateria;Protostomia;Ecdysozoa;Nematozoa;Nematoda;Chromadorea;Spirurida;";"0.0";"0";"116";"115";"0";"115";"1";"457068";"391207"
"V4mis2";"SILVA (only NR);Eukaryota;Amorphea;Obazoa;Opisthokonta;Holozoa;Choanozoa;Metazoa;Animalia;BCP clade;Bilateria;Protostomia;Ecdysozoa;Nematozoa;Nematoda;Chromadorea;Tylenchida;";"1.6";"14.3";"565";"565";"9";"556";"0";"456618";"391198"
"V4mis2";"SILVA (only NR);Eukaryota;Amorphea;Obazoa;Opisthokonta;Holozoa;Choanozoa;Metazoa;Animalia;BCP clade;Bilateria;Protostomia;Ecdysozoa;Nematozoa;Nematoda;Chromadorea;Tylenchida;Anomyctus;";"0.0";"0";"1";"1";"0";"1";"0";"457182";"391207"
"V4mis2";"SILVA (only NR);Eukaryota;Amorphea;Obazoa;Opisthokonta;Holozoa;Choanozoa;Metazoa;Animalia;BCP clade;Bilateria;Protostomia;Ecdysozoa;Nematozoa;Nematoda;Chromadorea;Tylenchida;Aphelenchoides;";"7.5";"14.4";"40";"40";"3";"37";"0";"457143";"391204"
"V4mis2";"SILVA (only NR);Eukaryota;Amorphea;Obazoa;Opisthokonta;Holozoa;Choanozoa;Metazoa;Animalia;BCP clade;Bilateria;Protostomia;Ecdysozoa;Nematozoa;Nematoda;Chromadorea;Tylenchida;Basilaphelenchus;";"0.0";"0";"1";"1";"0";"1";"0";"457182";"391207"
"V4mis2";"SILVA (only NR);Eukaryota;Amorphea;Obazoa;Opisthokonta;Holozoa;Choanozoa;Metazoa;Animalia;BCP clade;Bilateria;Protostomia;Ecdysozoa;Nematozoa;Nematoda;Chromadorea;Tylenchida;Bursaphelenchus;";"1.7";"14.4";"59";"59";"1";"58";"0";"457124";"391206"
"V4mis2";"SILVA (only NR);Eukaryota;Amorphea;Obazoa;Opisthokonta;Holozoa;Choanozoa;Metazoa;Animalia;BCP clade;Bilateria;Protostomia;Ecdysozoa;Nematozoa;Nematoda;Chromadorea;Tylenchida;Cryptaphelenchus;";"0.0";"0";"2";"2";"0";"2";"0";"457181";"391207"
"V4mis2";"SILVA (only NR);Eukaryota;Amorphea;Obazoa;Opisthokonta;Holozoa;Choanozoa;Metazoa;Animalia;BCP clade;Bilateria;Protostomia;Ecdysozoa;Nematozoa;Nematoda;Chromadorea;Tylenchida;Ektaphelenchoides;";"0.0";"0";"1";"1";"0";"1";"0";"457182";"391207"
"V4mis2";"SILVA (only NR);Eukaryota;Amorphea;Obazoa;Opisthokonta;Holozoa;Choanozoa;Metazoa;Animalia;BCP clade;Bilateria;Protostomia;Ecdysozoa;Nematozoa;Nematoda;Chromadorea;Tylenchida;Ektaphelenchus;";"0.0";"0";"2";"2";"0";"2";"0";"457181";"391207"
"V4mis2";"SILVA (only NR);Eukaryota;Amorphea;Obazoa;Opisthokonta;Holozoa;Choanozoa;Metazoa;Animalia;BCP clade;Bilateria;Protostomia;Ecdysozoa;Nematozoa;Nematoda;Chromadorea;Tylenchida;Laimaphelenchus;";"0.0";"0";"15";"15";"0";"15";"0";"457168";"391207"
"V4mis2";"SILVA (only NR);Eukaryota;Amorphea;Obazoa;Opisthokonta;Holozoa;Choanozoa;Metazoa;Animalia;BCP clade;Bilateria;Protostomia;Ecdysozoa;Nematozoa;Nematoda;Chromadorea;Tylenchida;Noctuidonema;";"0.0";"0";"1";"1";"0";"1";"0";"457182";"391207"
"V4mis2";"SILVA (only NR);Eukaryota;Amorphea;Obazoa;Opisthokonta;Holozoa;Choanozoa;Metazoa;Animalia;BCP clade;Bilateria;Protostomia;Ecdysozoa;Nematozoa;Nematoda;Chromadorea;Tylenchida;Peraphelenchus;";"0.0";"0";"1";"1";"0";"1";"0";"457182";"391207"
"V4mis2";"SILVA (only NR);Eukaryota;Amorphea;Obazoa;Opisthokonta;Holozoa;Choanozoa;Metazoa;Animalia;BCP clade;Bilateria;Protostomia;Ecdysozoa;Nematozoa;Nematoda;Chromadorea;Tylenchida;Pseudaphelenchus;";"0.0";"0";"4";"4";"0";"4";"0";"457179";"391207"
"V4mis2";"SILVA (only NR);Eukaryota;Amorphea;Obazoa;Opisthokonta;Holozoa;Choanozoa;Metazoa;Animalia;BCP clade;Bilateria;Protostomia;Ecdysozoa;Nematozoa;Nematoda;Chromadorea;Tylenchida;Robustodorus;";"0.0";"0";"3";"3";"0";"3";"0";"457180";"391207"
"V4mis2";"SILVA (only NR);Eukaryota;Amorphea;Obazoa;Opisthokonta;Holozoa;Choanozoa;Metazoa;Animalia;BCP clade;Bilateria;Protostomia;Ecdysozoa;Nematozoa;Nematoda;Chromadorea;Tylenchida;Ruehmaphelenchus;";"0.0";"0";"4";"4";"0";"4";"0";"457179";"391207"
"V4mis2";"SILVA (only NR);Eukaryota;Amorphea;Obazoa;Opisthokonta;Holozoa;Choanozoa;Metazoa;Animalia;BCP clade;Bilateria;Protostomia;Ecdysozoa;Nematozoa;Nematoda;Chromadorea;Tylenchida;Schistonchus;";"0.0";"0";"22";"22";"0";"22";"0";"457161";"391207"
"V4mis2";"SILVA (only NR);Eukaryota;Amorphea;Obazoa;Opisthokonta;Holozoa;Choanozoa;Metazoa;Animalia;BCP clade;Bilateria;Protostomia;Ecdysozoa;Nematozoa;Nematoda;Chromadorea;Tylenchida;Tylaphelenchus;";"0.0";"0";"1";"1";"0";"1";"0";"457182";"391207"
"V4mis2";"SILVA (only NR);Eukaryota;Amorphea;Obazoa;Opisthokonta;Holozoa;Choanozoa;Metazoa;Animalia;BCP clade;Bilateria;Protostomia;Ecdysozoa;Nematozoa;Nematoda;Enoplea;";"0.0";"0";"727";"720";"0";"720";"7";"456463";"391207"
"V4mis2";"SILVA (only NR);Eukaryota;Amorphea;Obazoa;Opisthokonta;Holozoa;Choanozoa;Metazoa;Animalia;BCP clade;Bilateria;Protostomia;Ecdysozoa;Nematozoa;Nematoda;Enoplea;Dorylaimia;";"0.0";"0";"445";"439";"0";"439";"6";"456744";"391207"
"V4mis2";"SILVA (only NR);Eukaryota;Amorphea;Obazoa;Opisthokonta;Holozoa;Choanozoa;Metazoa;Animalia;BCP clade;Bilateria;Protostomia;Ecdysozoa;Nematozoa;Nematoda;Enoplea;Dorylaimia;Dioctophymatoidea;";"0.0";"0";"2";"2";"0";"2";"0";"457181";"391207"
"V4mis2";"SILVA (only NR);Eukaryota;Amorphea;Obazoa;Opisthokonta;Holozoa;Choanozoa;Metazoa;Animalia;BCP clade;Bilateria;Protostomia;Ecdysozoa;Nematozoa;Nematoda;Enoplea;Dorylaimia;Dorylaimida;";"0.0";"0";"147";"147";"0";"147";"0";"457036";"391207"
"V4mis2";"SILVA (only NR);Eukaryota;Amorphea;Obazoa;Opisthokonta;Holozoa;Choanozoa;Metazoa;Animalia;BCP clade;Bilateria;Protostomia;Ecdysozoa;Nematozoa;Nematoda;Enoplea;Dorylaimia;Mermithida;";"0.0";"0";"19";"19";"0";"19";"0";"457164";"391207"
"V4mis2";"SILVA (only NR);Eukaryota;Amorphea;Obazoa;Opisthokonta;Holozoa;Choanozoa;Metazoa;Animalia;BCP clade;Bilateria;Protostomia;Ecdysozoa;Nematozoa;Nematoda;Enoplea;Dorylaimia;Mononchida;";"0.0";"0";"30";"30";"0";"30";"0";"457153";"391207"
"V4mis2";"SILVA (only NR);Eukaryota;Amorphea;Obazoa;Opisthokonta;Holozoa;Choanozoa;Metazoa;Animalia;BCP clade;Bilateria;Protostomia;Ecdysozoa;Nematozoa;Nematoda;Enoplea;Dorylaimia;Trichocephalida;";"0.0";"0";"242";"236";"0";"236";"6";"456947";"391207"
"V4mis2";"SILVA (only NR);Eukaryota;Amorphea;Obazoa;Opisthokonta;Holozoa;Choanozoa;Metazoa;Animalia;BCP clade;Bilateria;Protostomia;Ecdysozoa;Nematozoa;Nematoda;Enoplea;Enoplia;";"0.0";"0";"282";"281";"0";"281";"1";"456902";"391207"
"V4mis2";"SILVA (only NR);Eukaryota;Amorphea;Obazoa;Opisthokonta;Holozoa;Choanozoa;Metazoa;Animalia;BCP clade;Bilateria;Protostomia;Ecdysozoa;Nematozoa;Nematoda;Enoplea;Enoplia;Enoplida;";"0.0";"0";"182";"182";"0";"182";"0";"457001";"391207"
"V4mis2";"SILVA (only NR);Eukaryota;Amorphea;Obazoa;Opisthokonta;Holozoa;Choanozoa;Metazoa;Animalia;BCP clade;Bilateria;Protostomia;Ecdysozoa;Nematozoa;Nematoda;Enoplea;Enoplia;Triplonchida;";"0.0";"0";"98";"97";"0";"97";"1";"457086";"391207"
"V4mis2";"SILVA (only NR);Eukaryota;Amorphea;Obazoa;Opisthokonta;Holozoa;Choanozoa;Metazoa;Animalia;BCP clade;Bilateria;Protostomia;Ecdysozoa;Nematozoa;Nematomorpha;";"0.0";"0";"14";"14";"0";"14";"0";"457169";"391207"
"V4mis2";"SILVA (only NR);Eukaryota;Amorphea;Obazoa;Opisthokonta;Holozoa;Choanozoa;Metazoa;Animalia;BCP clade;Bilateria;Protostomia;Ecdysozoa;Nematozoa;Nematomorpha;Gordioida;";"0.0";"0";"13";"13";"0";"13";"0";"457170";"391207"
"V4mis2";"SILVA (only NR);Eukaryota;Amorphea;Obazoa;Opisthokonta;Holozoa;Choanozoa;Metazoa;Animalia;BCP clade;Bilateria;Protostomia;Ecdysozoa;Nematozoa;Nematomorpha;Gordioida;Chordodea;";"0.0";"0";"6";"6";"0";"6";"0";"457177";"391207"
"V4mis2";"SILVA (only NR);Eukaryota;Amorphea;Obazoa;Opisthokonta;Holozoa;Choanozoa;Metazoa;Animalia;BCP clade;Bilateria;Protostomia;Ecdysozoa;Nematozoa;Nematomorpha;Gordioida;Gordea;";"0.0";"0";"7";"7";"0";"7";"0";"457176";"391207"
"V4mis2";"SILVA (only NR);Eukaryota;Amorphea;Obazoa;Opisthokonta;Holozoa;Choanozoa;Metazoa;Animalia;BCP clade;Bilateria;Protostomia;Ecdysozoa;Onychophora;";"0.0";"0";"23";"23";"0";"23";"0";"457160";"391207"
"V4mis2";"SILVA (only NR);Eukaryota;Amorphea;Obazoa;Opisthokonta;Holozoa;Choanozoa;Metazoa;Animalia;BCP clade;Bilateria;Protostomia;Ecdysozoa;Onychophora;Udeonycophora;";"0.0";"0";"23";"23";"0";"23";"0";"457160";"391207"
"V4mis2";"SILVA (only NR);Eukaryota;Amorphea;Obazoa;Opisthokonta;Holozoa;Choanozoa;Metazoa;Animalia;BCP clade;Bilateria;Protostomia;Ecdysozoa;Onychophora;Udeonycophora;Euonycophora;";"0.0";"0";"23";"23";"0";"23";"0";"457160";"391207"
"V4mis2";"SILVA (only NR);Eukaryota;Amorphea;Obazoa;Opisthokonta;Holozoa;Choanozoa;Metazoa;Animalia;BCP clade;Bilateria;Protostomia;Ecdysozoa;Onychophora;Udeonycophora;Euonycophora;Peripatopsidae;";"0.0";"0";"23";"23";"0";"23";"0";"457160";"391207"
"V4mis2";"SILVA (only NR);Eukaryota;Amorphea;Obazoa;Opisthokonta;Holozoa;Choanozoa;Metazoa;Animalia;BCP clade;Bilateria;Protostomia;Ecdysozoa;Scalidophora;";"0.0";"0";"52";"52";"0";"52";"0";"457131";"391207"
"V4mis2";"SILVA (only NR);Eukaryota;Amorphea;Obazoa;Opisthokonta;Holozoa;Choanozoa;Metazoa;Animalia;BCP clade;Bilateria;Protostomia;Ecdysozoa;Scalidophora;Kinorhyncha;";"0.0";"0";"42";"42";"0";"42";"0";"457141";"391207"
"V4mis2";"SILVA (only NR);Eukaryota;Amorphea;Obazoa;Opisthokonta;Holozoa;Choanozoa;Metazoa;Animalia;BCP clade;Bilateria;Protostomia;Ecdysozoa;Scalidophora;Kinorhyncha;Cyclorhagida;";"0.0";"0";"26";"26";"0";"26";"0";"457157";"391207"
"V4mis2";"SILVA (only NR);Eukaryota;Amorphea;Obazoa;Opisthokonta;Holozoa;Choanozoa;Metazoa;Animalia;BCP clade;Bilateria;Protostomia;Ecdysozoa;Scalidophora;Kinorhyncha;Homalorhagida;";"0.0";"0";"14";"14";"0";"14";"0";"457169";"391207"
"V4mis2";"SILVA (only NR);Eukaryota;Amorphea;Obazoa;Opisthokonta;Holozoa;Choanozoa;Metazoa;Animalia;BCP clade;Bilateria;Protostomia;Ecdysozoa;Scalidophora;Kinorhyncha;Kinorhyncha Incertae Sedis;";"0.0";"0";"2";"2";"0";"2";"0";"457181";"391207"
"V4mis2";"SILVA (only NR);Eukaryota;Amorphea;Obazoa;Opisthokonta;Holozoa;Choanozoa;Metazoa;Animalia;BCP clade;Bilateria;Protostomia;Ecdysozoa;Scalidophora;Loricifera;";"0.0";"0";"2";"2";"0";"2";"0";"457181";"391207"
"V4mis2";"SILVA (only NR);Eukaryota;Amorphea;Obazoa;Opisthokonta;Holozoa;Choanozoa;Metazoa;Animalia;BCP clade;Bilateria;Protostomia;Ecdysozoa;Scalidophora;Priapulida;";"0.0";"0";"8";"8";"0";"8";"0";"457175";"391207"
"V4mis2";"SILVA (only NR);Eukaryota;Amorphea;Obazoa;Opisthokonta;Holozoa;Choanozoa;Metazoa;Animalia;BCP clade;Bilateria;Protostomia;Ecdysozoa;Scalidophora;Priapulida;Priapulidae;";"0.0";"0";"4";"4";"0";"4";"0";"457179";"391207"
"V4mis2";"SILVA (only NR);Eukaryota;Amorphea;Obazoa;Opisthokonta;Holozoa;Choanozoa;Metazoa;Animalia;BCP clade;Bilateria;Protostomia;Ecdysozoa;Scalidophora;Priapulida;Tubiluchidae;";"0.0";"0";"4";"4";"0";"4";"0";"457179";"391207"
"V4mis2";"SILVA (only NR);Eukaryota;Amorphea;Obazoa;Opisthokonta;Holozoa;Choanozoa;Metazoa;Animalia;BCP clade;Bilateria;Protostomia;Ecdysozoa;Tardigrada;";"0.0";"0";"108";"104";"0";"104";"4";"457079";"391207"
"V4mis2";"SILVA (only NR);Eukaryota;Amorphea;Obazoa;Opisthokonta;Holozoa;Choanozoa;Metazoa;Animalia;BCP clade;Bilateria;Protostomia;Ecdysozoa;Tardigrada;Eutardigrada;";"0.0";"0";"78";"77";"0";"77";"1";"457106";"391207"
"V4mis2";"SILVA (only NR);Eukaryota;Amorphea;Obazoa;Opisthokonta;Holozoa;Choanozoa;Metazoa;Animalia;BCP clade;Bilateria;Protostomia;Ecdysozoa;Tardigrada;Eutardigrada;Apochela;";"0.0";"0";"7";"7";"0";"7";"0";"457176";"391207"
"V4mis2";"SILVA (only NR);Eukaryota;Amorphea;Obazoa;Opisthokonta;Holozoa;Choanozoa;Metazoa;Animalia;BCP clade;Bilateria;Protostomia;Ecdysozoa;Tardigrada;Eutardigrada;Parachaela;";"0.0";"0";"71";"70";"0";"70";"1";"457113";"391207"
"V4mis2";"SILVA (only NR);Eukaryota;Amorphea;Obazoa;Opisthokonta;Holozoa;Choanozoa;Metazoa;Animalia;BCP clade;Bilateria;Protostomia;Ecdysozoa;Tardigrada;Heterotardigrada;";"0.0";"0";"30";"27";"0";"27";"3";"457156";"391207"
"V4mis2";"SILVA (only NR);Eukaryota;Amorphea;Obazoa;Opisthokonta;Holozoa;Choanozoa;Metazoa;Animalia;BCP clade;Bilateria;Protostomia;Ecdysozoa;Tardigrada;Heterotardigrada;Echiniscoidea;";"0.0";"0";"29";"27";"0";"27";"2";"457156";"391207"
"V4mis2";"SILVA (only NR);Eukaryota;Amorphea;Obazoa;Opisthokonta;Holozoa;Choanozoa;Metazoa;Animalia;BCP clade;Bilateria;Protostomia;Lophotrochozoa;";"2.9";"13.5";"5194";"5162";"151";"5011";"32";"452021";"391056"
"V4mis2";"SILVA (only NR);Eukaryota;Amorphea;Obazoa;Opisthokonta;Holozoa;Choanozoa;Metazoa;Animalia;BCP clade;Bilateria;Protostomia;Lophotrochozoa;Acanthocephala;";"0.0";"0";"66";"66";"0";"66";"0";"457117";"391207"
"V4mis2";"SILVA (only NR);Eukaryota;Amorphea;Obazoa;Opisthokonta;Holozoa;Choanozoa;Metazoa;Animalia;BCP clade;Bilateria;Protostomia;Lophotrochozoa;Acanthocephala;Archiacanthocephala;";"0.0";"0";"7";"7";"0";"7";"0";"457176";"391207"
"V4mis2";"SILVA (only NR);Eukaryota;Amorphea;Obazoa;Opisthokonta;Holozoa;Choanozoa;Metazoa;Animalia;BCP clade;Bilateria;Protostomia;Lophotrochozoa;Acanthocephala;Archiacanthocephala;Gigantorhynchida;";"0.0";"0";"2";"2";"0";"2";"0";"457181";"391207"
"V4mis2";"SILVA (only NR);Eukaryota;Amorphea;Obazoa;Opisthokonta;Holozoa;Choanozoa;Metazoa;Animalia;BCP clade;Bilateria;Protostomia;Lophotrochozoa;Acanthocephala;Archiacanthocephala;Oligacanthorhynchida;";"0.0";"0";"4";"4";"0";"4";"0";"457179";"391207"
"V4mis2";"SILVA (only NR);Eukaryota;Amorphea;Obazoa;Opisthokonta;Holozoa;Choanozoa;Metazoa;Animalia;BCP clade;Bilateria;Protostomia;Lophotrochozoa;Acanthocephala;Eoacanthocephala;";"0.0";"0";"10";"10";"0";"10";"0";"457173";"391207"
"V4mis2";"SILVA (only NR);Eukaryota;Amorphea;Obazoa;Opisthokonta;Holozoa;Choanozoa;Metazoa;Animalia;BCP clade;Bilateria;Protostomia;Lophotrochozoa;Acanthocephala;Eoacanthocephala;Neoechinorhynchida;";"0.0";"0";"10";"10";"0";"10";"0";"457173";"391207"
"V4mis2";"SILVA (only NR);Eukaryota;Amorphea;Obazoa;Opisthokonta;Holozoa;Choanozoa;Metazoa;Animalia;BCP clade;Bilateria;Protostomia;Lophotrochozoa;Acanthocephala;Palaeacanthocephala;";"0.0";"0";"49";"49";"0";"49";"0";"457134";"391207"
"V4mis2";"SILVA (only NR);Eukaryota;Amorphea;Obazoa;Opisthokonta;Holozoa;Choanozoa;Metazoa;Animalia;BCP clade;Bilateria;Protostomia;Lophotrochozoa;Acanthocephala;Palaeacanthocephala;Echinorhynchida;";"0.0";"0";"24";"24";"0";"24";"0";"457159";"391207"
"V4mis2";"SILVA (only NR);Eukaryota;Amorphea;Obazoa;Opisthokonta;Holozoa;Choanozoa;Metazoa;Animalia;BCP clade;Bilateria;Protostomia;Lophotrochozoa;Acanthocephala;Palaeacanthocephala;Polymorphida;";"0.0";"0";"25";"25";"0";"25";"0";"457158";"391207"
"V4mis2";"SILVA (only NR);Eukaryota;Amorphea;Obazoa;Opisthokonta;Holozoa;Choanozoa;Metazoa;Animalia;BCP clade;Bilateria;Protostomia;Lophotrochozoa;Annelida;";"0.5";"14.2";"1328";"1321";"6";"1315";"7";"455862";"391201"
"V4mis2";"SILVA (only NR);Eukaryota;Amorphea;Obazoa;Opisthokonta;Holozoa;Choanozoa;Metazoa;Animalia;BCP clade;Bilateria;Protostomia;Lophotrochozoa;Annelida;Annelida Incertae Sedis;";"0.0";"0";"2";"2";"0";"2";"0";"457181";"391207"
"V4mis2";"SILVA (only NR);Eukaryota;Amorphea;Obazoa;Opisthokonta;Holozoa;Choanozoa;Metazoa;Animalia;BCP clade;Bilateria;Protostomia;Lophotrochozoa;Annelida;Annelida Incertae Sedis;Fauvelopsis;";"0.0";"0";"1";"1";"0";"1";"0";"457182";"391207"
"V4mis2";"SILVA (only NR);Eukaryota;Amorphea;Obazoa;Opisthokonta;Holozoa;Choanozoa;Metazoa;Animalia;BCP clade;Bilateria;Protostomia;Lophotrochozoa;Annelida;Annelida Incertae Sedis;Hrabeiella;";"0.0";"0";"1";"1";"0";"1";"0";"457182";"391207"
"V4mis2";"SILVA (only NR);Eukaryota;Amorphea;Obazoa;Opisthokonta;Holozoa;Choanozoa;Metazoa;Animalia;BCP clade;Bilateria;Protostomia;Lophotrochozoa;Annelida;Clitellata;";"0.0";"0";"290";"290";"0";"290";"0";"456893";"391207"
"V4mis2";"SILVA (only NR);Eukaryota;Amorphea;Obazoa;Opisthokonta;Holozoa;Choanozoa;Metazoa;Animalia;BCP clade;Bilateria;Protostomia;Lophotrochozoa;Annelida;Clitellata;Branchiobdellae;";"0.0";"0";"11";"11";"0";"11";"0";"457172";"391207"
"V4mis2";"SILVA (only NR);Eukaryota;Amorphea;Obazoa;Opisthokonta;Holozoa;Choanozoa;Metazoa;Animalia;BCP clade;Bilateria;Protostomia;Lophotrochozoa;Annelida;Clitellata;Branchiobdellae;Branchiobdellida;";"0.0";"0";"11";"11";"0";"11";"0";"457172";"391207"
"V4mis2";"SILVA (only NR);Eukaryota;Amorphea;Obazoa;Opisthokonta;Holozoa;Choanozoa;Metazoa;Animalia;BCP clade;Bilateria;Protostomia;Lophotrochozoa;Annelida;Clitellata;Hirudinida;";"0.0";"0";"106";"106";"0";"106";"0";"457077";"391207"
"V4mis2";"SILVA (only NR);Eukaryota;Amorphea;Obazoa;Opisthokonta;Holozoa;Choanozoa;Metazoa;Animalia;BCP clade;Bilateria;Protostomia;Lophotrochozoa;Annelida;Clitellata;Hirudinida;Arhynchobdellida;";"0.0";"0";"77";"77";"0";"77";"0";"457106";"391207"
"V4mis2";"SILVA (only NR);Eukaryota;Amorphea;Obazoa;Opisthokonta;Holozoa;Choanozoa;Metazoa;Animalia;BCP clade;Bilateria;Protostomia;Lophotrochozoa;Annelida;Clitellata;Hirudinida;Rhynchobdellida;";"0.0";"0";"28";"28";"0";"28";"0";"457155";"391207"
"V4mis2";"SILVA (only NR);Eukaryota;Amorphea;Obazoa;Opisthokonta;Holozoa;Choanozoa;Metazoa;Animalia;BCP clade;Bilateria;Protostomia;Lophotrochozoa;Annelida;Clitellata;Oligochaeta;";"0.0";"0";"173";"173";"0";"173";"0";"457010";"391207"
"V4mis2";"SILVA (only NR);Eukaryota;Amorphea;Obazoa;Opisthokonta;Holozoa;Choanozoa;Metazoa;Animalia;BCP clade;Bilateria;Protostomia;Lophotrochozoa;Annelida;Clitellata;Oligochaeta;Haplotaxida;";"0.0";"0";"165";"165";"0";"165";"0";"457018";"391207"
"V4mis2";"SILVA (only NR);Eukaryota;Amorphea;Obazoa;Opisthokonta;Holozoa;Choanozoa;Metazoa;Animalia;BCP clade;Bilateria;Protostomia;Lophotrochozoa;Annelida;Clitellata;Oligochaeta;Lumbriculida;";"0.0";"0";"3";"3";"0";"3";"0";"457180";"391207"
"V4mis2";"SILVA (only NR);Eukaryota;Amorphea;Obazoa;Opisthokonta;Holozoa;Choanozoa;Metazoa;Animalia;BCP clade;Bilateria;Protostomia;Lophotrochozoa;Annelida;Clitellata;Oligochaeta;Moniligastrida;";"0.0";"0";"4";"4";"0";"4";"0";"457179";"391207"
"V4mis2";"SILVA (only NR);Eukaryota;Amorphea;Obazoa;Opisthokonta;Holozoa;Choanozoa;Metazoa;Animalia;BCP clade;Bilateria;Protostomia;Lophotrochozoa;Annelida;Myzostomida;";"0.0";"0";"54";"54";"0";"54";"0";"457129";"391207"
"V4mis2";"SILVA (only NR);Eukaryota;Amorphea;Obazoa;Opisthokonta;Holozoa;Choanozoa;Metazoa;Animalia;BCP clade;Bilateria;Protostomia;Lophotrochozoa;Annelida;Myzostomida;Endomyzostomatidae;";"0.0";"0";"6";"6";"0";"6";"0";"457177";"391207"
"V4mis2";"SILVA (only NR);Eukaryota;Amorphea;Obazoa;Opisthokonta;Holozoa;Choanozoa;Metazoa;Animalia;BCP clade;Bilateria;Protostomia;Lophotrochozoa;Annelida;Myzostomida;Myzostomida Incertae Sedis;";"0.0";"0";"3";"3";"0";"3";"0";"457180";"391207"
"V4mis2";"SILVA (only NR);Eukaryota;Amorphea;Obazoa;Opisthokonta;Holozoa;Choanozoa;Metazoa;Animalia;BCP clade;Bilateria;Protostomia;Lophotrochozoa;Annelida;Myzostomida;Myzostomidae;";"0.0";"0";"43";"43";"0";"43";"0";"457140";"391207"
"V4mis2";"SILVA (only NR);Eukaryota;Amorphea;Obazoa;Opisthokonta;Holozoa;Choanozoa;Metazoa;Animalia;BCP clade;Bilateria;Protostomia;Lophotrochozoa;Annelida;Polychaeta;";"0.6";"14.3";"975";"968";"6";"962";"7";"456215";"391201"
"V4mis2";"SILVA (only NR);Eukaryota;Amorphea;Obazoa;Opisthokonta;Holozoa;Choanozoa;Metazoa;Animalia;BCP clade;Bilateria;Protostomia;Lophotrochozoa;Annelida;Polychaeta;Echiura;";"29.4";"14.4";"17";"17";"5";"12";"0";"457166";"391202"
"V4mis2";"SILVA (only NR);Eukaryota;Amorphea;Obazoa;Opisthokonta;Holozoa;Choanozoa;Metazoa;Animalia;BCP clade;Bilateria;Protostomia;Lophotrochozoa;Annelida;Polychaeta;Echiura;Echiuroinea;";"33.3";"14.4";"15";"15";"5";"10";"0";"457168";"391202"
"V4mis2";"SILVA (only NR);Eukaryota;Amorphea;Obazoa;Opisthokonta;Holozoa;Choanozoa;Metazoa;Animalia;BCP clade;Bilateria;Protostomia;Lophotrochozoa;Annelida;Polychaeta;Echiura;Xenopneusta;";"0.0";"0";"2";"2";"0";"2";"0";"457181";"391207"
"V4mis2";"SILVA (only NR);Eukaryota;Amorphea;Obazoa;Opisthokonta;Holozoa;Choanozoa;Metazoa;Animalia;BCP clade;Bilateria;Protostomia;Lophotrochozoa;Annelida;Polychaeta;Palpata;";"0.2";"14.3";"593";"586";"1";"585";"7";"456597";"391206"
"V4mis2";"SILVA (only NR);Eukaryota;Amorphea;Obazoa;Opisthokonta;Holozoa;Choanozoa;Metazoa;Animalia;BCP clade;Bilateria;Protostomia;Lophotrochozoa;Annelida;Polychaeta;Palpata;Eunicida;";"0.0";"0";"54";"54";"0";"54";"0";"457129";"391207"
"V4mis2";"SILVA (only NR);Eukaryota;Amorphea;Obazoa;Opisthokonta;Holozoa;Choanozoa;Metazoa;Animalia;BCP clade;Bilateria;Protostomia;Lophotrochozoa;Annelida;Polychaeta;Palpata;Flabelligerida;";"0.0";"0";"14";"14";"0";"14";"0";"457169";"391207"
"V4mis2";"SILVA (only NR);Eukaryota;Amorphea;Obazoa;Opisthokonta;Holozoa;Choanozoa;Metazoa;Animalia;BCP clade;Bilateria;Protostomia;Lophotrochozoa;Annelida;Polychaeta;Palpata;Palpata Incertae Sedis;";"0.0";"0";"27";"27";"0";"27";"0";"457156";"391207"
"V4mis2";"SILVA (only NR);Eukaryota;Amorphea;Obazoa;Opisthokonta;Holozoa;Choanozoa;Metazoa;Animalia;BCP clade;Bilateria;Protostomia;Lophotrochozoa;Annelida;Polychaeta;Palpata;Phyllodocida;";"0.3";"14.4";"353";"346";"1";"345";"7";"456837";"391206"
"V4mis2";"SILVA (only NR);Eukaryota;Amorphea;Obazoa;Opisthokonta;Holozoa;Choanozoa;Metazoa;Animalia;BCP clade;Bilateria;Protostomia;Lophotrochozoa;Annelida;Polychaeta;Palpata;Sabellida;";"0.0";"0";"144";"144";"0";"144";"0";"457039";"391207"
"V4mis2";"SILVA (only NR);Eukaryota;Amorphea;Obazoa;Opisthokonta;Holozoa;Choanozoa;Metazoa;Animalia;BCP clade;Bilateria;Protostomia;Lophotrochozoa;Annelida;Polychaeta;Protodrilidae;";"0.0";"0";"39";"39";"0";"39";"0";"457144";"391207"
"V4mis2";"SILVA (only NR);Eukaryota;Amorphea;Obazoa;Opisthokonta;Holozoa;Choanozoa;Metazoa;Animalia;BCP clade;Bilateria;Protostomia;Lophotrochozoa;Annelida;Polychaeta;Protodrilidae;Protodrilus;";"0.0";"0";"39";"39";"0";"39";"0";"457144";"391207"
"V4mis2";"SILVA (only NR);Eukaryota;Amorphea;Obazoa;Opisthokonta;Holozoa;Choanozoa;Metazoa;Animalia;BCP clade;Bilateria;Protostomia;Lophotrochozoa;Annelida;Polychaeta;Scolecida;";"0.0";"0";"290";"290";"0";"290";"0";"456893";"391207"
"V4mis2";"SILVA (only NR);Eukaryota;Amorphea;Obazoa;Opisthokonta;Holozoa;Choanozoa;Metazoa;Animalia;BCP clade;Bilateria;Protostomia;Lophotrochozoa;Annelida;Polychaeta;Scolecida;Capitellida;";"0.0";"0";"56";"56";"0";"56";"0";"457127";"391207"
"V4mis2";"SILVA (only NR);Eukaryota;Amorphea;Obazoa;Opisthokonta;Holozoa;Choanozoa;Metazoa;Animalia;BCP clade;Bilateria;Protostomia;Lophotrochozoa;Annelida;Polychaeta;Scolecida;Cossuridae;";"0.0";"0";"4";"4";"0";"4";"0";"457179";"391207"
"V4mis2";"SILVA (only NR);Eukaryota;Amorphea;Obazoa;Opisthokonta;Holozoa;Choanozoa;Metazoa;Animalia;BCP clade;Bilateria;Protostomia;Lophotrochozoa;Annelida;Polychaeta;Scolecida;Dinophilida;";"0.0";"0";"6";"6";"0";"6";"0";"457177";"391207"
"V4mis2";"SILVA (only NR);Eukaryota;Amorphea;Obazoa;Opisthokonta;Holozoa;Choanozoa;Metazoa;Animalia;BCP clade;Bilateria;Protostomia;Lophotrochozoa;Annelida;Polychaeta;Scolecida;Opheliidae;";"0.0";"0";"9";"9";"0";"9";"0";"457174";"391207"
"V4mis2";"SILVA (only NR);Eukaryota;Amorphea;Obazoa;Opisthokonta;Holozoa;Choanozoa;Metazoa;Animalia;BCP clade;Bilateria;Protostomia;Lophotrochozoa;Annelida;Polychaeta;Scolecida;Orbiniidae;";"0.0";"0";"25";"25";"0";"25";"0";"457158";"391207"
"V4mis2";"SILVA (only NR);Eukaryota;Amorphea;Obazoa;Opisthokonta;Holozoa;Choanozoa;Metazoa;Animalia;BCP clade;Bilateria;Protostomia;Lophotrochozoa;Annelida;Polychaeta;Scolecida;Paraonidae;";"0.0";"0";"6";"6";"0";"6";"0";"457177";"391207"
"V4mis2";"SILVA (only NR);Eukaryota;Amorphea;Obazoa;Opisthokonta;Holozoa;Choanozoa;Metazoa;Animalia;BCP clade;Bilateria;Protostomia;Lophotrochozoa;Annelida;Polychaeta;Scolecida;Parergodrilidae;";"0.0";"0";"4";"4";"0";"4";"0";"457179";"391207"
"V4mis2";"SILVA (only NR);Eukaryota;Amorphea;Obazoa;Opisthokonta;Holozoa;Choanozoa;Metazoa;Animalia;BCP clade;Bilateria;Protostomia;Lophotrochozoa;Annelida;Polychaeta;Scolecida;Questidae;";"0.0";"0";"2";"2";"0";"2";"0";"457181";"391207"
"V4mis2";"SILVA (only NR);Eukaryota;Amorphea;Obazoa;Opisthokonta;Holozoa;Choanozoa;Metazoa;Animalia;BCP clade;Bilateria;Protostomia;Lophotrochozoa;Annelida;Polychaeta;Scolecida;Spionida;";"0.0";"0";"93";"93";"0";"93";"0";"457090";"391207"
"V4mis2";"SILVA (only NR);Eukaryota;Amorphea;Obazoa;Opisthokonta;Holozoa;Choanozoa;Metazoa;Animalia;BCP clade;Bilateria;Protostomia;Lophotrochozoa;Annelida;Polychaeta;Scolecida;Terebellida;";"0.0";"0";"81";"81";"0";"81";"0";"457102";"391207"
"V4mis2";"SILVA (only NR);Eukaryota;Amorphea;Obazoa;Opisthokonta;Holozoa;Choanozoa;Metazoa;Animalia;BCP clade;Bilateria;Protostomia;Lophotrochozoa;Annelida;Polychaeta;Sipuncula;";"0.0";"0";"34";"34";"0";"34";"0";"457149";"391207"
"V4mis2";"SILVA (only NR);Eukaryota;Amorphea;Obazoa;Opisthokonta;Holozoa;Choanozoa;Metazoa;Animalia;BCP clade;Bilateria;Protostomia;Lophotrochozoa;Annelida;Polychaeta;Sipuncula;Aspidosiphonidormes;";"0.0";"0";"5";"5";"0";"5";"0";"457178";"391207"
"V4mis2";"SILVA (only NR);Eukaryota;Amorphea;Obazoa;Opisthokonta;Holozoa;Choanozoa;Metazoa;Animalia;BCP clade;Bilateria;Protostomia;Lophotrochozoa;Annelida;Polychaeta;Sipuncula;Golfingiida;";"0.0";"0";"20";"20";"0";"20";"0";"457163";"391207"
"V4mis2";"SILVA (only NR);Eukaryota;Amorphea;Obazoa;Opisthokonta;Holozoa;Choanozoa;Metazoa;Animalia;BCP clade;Bilateria;Protostomia;Lophotrochozoa;Annelida;Polychaeta;Sipuncula;Phascolosomatiformes;";"0.0";"0";"9";"9";"0";"9";"0";"457174";"391207"
"V4mis2";"SILVA (only NR);Eukaryota;Amorphea;Obazoa;Opisthokonta;Holozoa;Choanozoa;Metazoa;Animalia;BCP clade;Bilateria;Protostomia;Lophotrochozoa;Bryozoa;";"0.0";"0";"111";"111";"0";"111";"0";"457072";"391207"
"V4mis2";"SILVA (only NR);Eukaryota;Amorphea;Obazoa;Opisthokonta;Holozoa;Choanozoa;Metazoa;Animalia;BCP clade;Bilateria;Protostomia;Lophotrochozoa;Bryozoa;Gymnolaemata;";"0.0";"0";"71";"71";"0";"71";"0";"457112";"391207"
"V4mis2";"SILVA (only NR);Eukaryota;Amorphea;Obazoa;Opisthokonta;Holozoa;Choanozoa;Metazoa;Animalia;BCP clade;Bilateria;Protostomia;Lophotrochozoa;Bryozoa;Gymnolaemata;Cheilostomatida;";"0.0";"0";"54";"54";"0";"54";"0";"457129";"391207"
"V4mis2";"SILVA (only NR);Eukaryota;Amorphea;Obazoa;Opisthokonta;Holozoa;Choanozoa;Metazoa;Animalia;BCP clade;Bilateria;Protostomia;Lophotrochozoa;Bryozoa;Gymnolaemata;Ctenostomatida;";"0.0";"0";"17";"17";"0";"17";"0";"457166";"391207"
"V4mis2";"SILVA (only NR);Eukaryota;Amorphea;Obazoa;Opisthokonta;Holozoa;Choanozoa;Metazoa;Animalia;BCP clade;Bilateria;Protostomia;Lophotrochozoa;Bryozoa;Phylactolaemata;";"0.0";"0";"7";"7";"0";"7";"0";"457176";"391207"
"V4mis2";"SILVA (only NR);Eukaryota;Amorphea;Obazoa;Opisthokonta;Holozoa;Choanozoa;Metazoa;Animalia;BCP clade;Bilateria;Protostomia;Lophotrochozoa;Bryozoa;Phylactolaemata;Plumatellida;";"0.0";"0";"7";"7";"0";"7";"0";"457176";"391207"
"V4mis2";"SILVA (only NR);Eukaryota;Amorphea;Obazoa;Opisthokonta;Holozoa;Choanozoa;Metazoa;Animalia;BCP clade;Bilateria;Protostomia;Lophotrochozoa;Bryozoa;Phylactolaemata;Plumatellida;Plumatellidae;";"0.0";"0";"2";"2";"0";"2";"0";"457181";"391207"
"V4mis2";"SILVA (only NR);Eukaryota;Amorphea;Obazoa;Opisthokonta;Holozoa;Choanozoa;Metazoa;Animalia;BCP clade;Bilateria;Protostomia;Lophotrochozoa;Bryozoa;Stenolaemata;";"0.0";"0";"33";"33";"0";"33";"0";"457150";"391207"
"V4mis2";"SILVA (only NR);Eukaryota;Amorphea;Obazoa;Opisthokonta;Holozoa;Choanozoa;Metazoa;Animalia;BCP clade;Bilateria;Protostomia;Lophotrochozoa;Bryozoa;Stenolaemata;Cyclostomatida;";"0.0";"0";"28";"28";"0";"28";"0";"457155";"391207"
"V4mis2";"SILVA (only NR);Eukaryota;Amorphea;Obazoa;Opisthokonta;Holozoa;Choanozoa;Metazoa;Animalia;BCP clade;Bilateria;Protostomia;Lophotrochozoa;Bryozoa;Stenolaemata;Tubuliporida;";"0.0";"0";"4";"4";"0";"4";"0";"457179";"391207"
"V4mis2";"SILVA (only NR);Eukaryota;Amorphea;Obazoa;Opisthokonta;Holozoa;Choanozoa;Metazoa;Animalia;BCP clade;Bilateria;Protostomia;Lophotrochozoa;Entoprocta;";"0.0";"0";"19";"19";"0";"19";"0";"457164";"391207"
"V4mis2";"SILVA (only NR);Eukaryota;Amorphea;Obazoa;Opisthokonta;Holozoa;Choanozoa;Metazoa;Animalia;BCP clade;Bilateria;Protostomia;Lophotrochozoa;Entoprocta;Coloniales;";"0.0";"0";"4";"4";"0";"4";"0";"457179";"391207"
"V4mis2";"SILVA (only NR);Eukaryota;Amorphea;Obazoa;Opisthokonta;Holozoa;Choanozoa;Metazoa;Animalia;BCP clade;Bilateria;Protostomia;Lophotrochozoa;Entoprocta;Coloniales;Barentsiidae;";"0.0";"0";"4";"4";"0";"4";"0";"457179";"391207"
"V4mis2";"SILVA (only NR);Eukaryota;Amorphea;Obazoa;Opisthokonta;Holozoa;Choanozoa;Metazoa;Animalia;BCP clade;Bilateria;Protostomia;Lophotrochozoa;Entoprocta;Solitaria;";"0.0";"0";"13";"13";"0";"13";"0";"457170";"391207"
"V4mis2";"SILVA (only NR);Eukaryota;Amorphea;Obazoa;Opisthokonta;Holozoa;Choanozoa;Metazoa;Animalia;BCP clade;Bilateria;Protostomia;Lophotrochozoa;Entoprocta;Solitaria;Loxosomatidae;";"0.0";"0";"13";"13";"0";"13";"0";"457170";"391207"
"V4mis2";"SILVA (only NR);Eukaryota;Amorphea;Obazoa;Opisthokonta;Holozoa;Choanozoa;Metazoa;Animalia;BCP clade;Bilateria;Protostomia;Lophotrochozoa;Gastrotricha;";"0.0";"0";"149";"149";"0";"149";"0";"457034";"391207"
"V4mis2";"SILVA (only NR);Eukaryota;Amorphea;Obazoa;Opisthokonta;Holozoa;Choanozoa;Metazoa;Animalia;BCP clade;Bilateria;Protostomia;Lophotrochozoa;Gastrotricha;Chaetonotida;";"0.0";"0";"88";"88";"0";"88";"0";"457095";"391207"
"V4mis2";"SILVA (only NR);Eukaryota;Amorphea;Obazoa;Opisthokonta;Holozoa;Choanozoa;Metazoa;Animalia;BCP clade;Bilateria;Protostomia;Lophotrochozoa;Gastrotricha;Macrodasyida;";"0.0";"0";"61";"61";"0";"61";"0";"457122";"391207"
"V4mis2";"SILVA (only NR);Eukaryota;Amorphea;Obazoa;Opisthokonta;Holozoa;Choanozoa;Metazoa;Animalia;BCP clade;Bilateria;Protostomia;Lophotrochozoa;Gastrotricha;Macrodasyida;Dactylopodolidae;";"0.0";"0";"5";"5";"0";"5";"0";"457178";"391207"
"V4mis2";"SILVA (only NR);Eukaryota;Amorphea;Obazoa;Opisthokonta;Holozoa;Choanozoa;Metazoa;Animalia;BCP clade;Bilateria;Protostomia;Lophotrochozoa;Gnathostomulida;";"0.0";"0";"24";"24";"0";"24";"0";"457159";"391207"
"V4mis2";"SILVA (only NR);Eukaryota;Amorphea;Obazoa;Opisthokonta;Holozoa;Choanozoa;Metazoa;Animalia;BCP clade;Bilateria;Protostomia;Lophotrochozoa;Gnathostomulida;Bursovaginoidea;";"0.0";"0";"18";"18";"0";"18";"0";"457165";"391207"
"V4mis2";"SILVA (only NR);Eukaryota;Amorphea;Obazoa;Opisthokonta;Holozoa;Choanozoa;Metazoa;Animalia;BCP clade;Bilateria;Protostomia;Lophotrochozoa;Gnathostomulida;Filospermoidea;";"0.0";"0";"6";"6";"0";"6";"0";"457177";"391207"
"V4mis2";"SILVA (only NR);Eukaryota;Amorphea;Obazoa;Opisthokonta;Holozoa;Choanozoa;Metazoa;Animalia;BCP clade;Bilateria;Protostomia;Lophotrochozoa;Lophophorata;";"0.0";"0";"57";"57";"0";"57";"0";"457126";"391207"
"V4mis2";"SILVA (only NR);Eukaryota;Amorphea;Obazoa;Opisthokonta;Holozoa;Choanozoa;Metazoa;Animalia;BCP clade;Bilateria;Protostomia;Lophotrochozoa;Lophophorata;Brachiopoda;";"0.0";"0";"57";"57";"0";"57";"0";"457126";"391207"
"V4mis2";"SILVA (only NR);Eukaryota;Amorphea;Obazoa;Opisthokonta;Holozoa;Choanozoa;Metazoa;Animalia;BCP clade;Bilateria;Protostomia;Lophotrochozoa;Lophophorata;Brachiopoda;Linguliformea;";"0.0";"0";"6";"6";"0";"6";"0";"457177";"391207"
"V4mis2";"SILVA (only NR);Eukaryota;Amorphea;Obazoa;Opisthokonta;Holozoa;Choanozoa;Metazoa;Animalia;BCP clade;Bilateria;Protostomia;Lophotrochozoa;Lophophorata;Brachiopoda;Linguliformea;Lingulata;";"0.0";"0";"6";"6";"0";"6";"0";"457177";"391207"
"V4mis2";"SILVA (only NR);Eukaryota;Amorphea;Obazoa;Opisthokonta;Holozoa;Choanozoa;Metazoa;Animalia;BCP clade;Bilateria;Protostomia;Lophotrochozoa;Lophophorata;Brachiopoda;Linguliformea;Lingulata;Lingulida;";"0.0";"0";"6";"6";"0";"6";"0";"457177";"391207"
"V4mis2";"SILVA (only NR);Eukaryota;Amorphea;Obazoa;Opisthokonta;Holozoa;Choanozoa;Metazoa;Animalia;BCP clade;Bilateria;Protostomia;Lophotrochozoa;Lophophorata;Brachiopoda;Phoroniformea;";"0.0";"0";"12";"12";"0";"12";"0";"457171";"391207"
"V4mis2";"SILVA (only NR);Eukaryota;Amorphea;Obazoa;Opisthokonta;Holozoa;Choanozoa;Metazoa;Animalia;BCP clade;Bilateria;Protostomia;Lophotrochozoa;Lophophorata;Brachiopoda;Rhynchonelliformea;";"0.0";"0";"37";"37";"0";"37";"0";"457146";"391207"
"V4mis2";"SILVA (only NR);Eukaryota;Amorphea;Obazoa;Opisthokonta;Holozoa;Choanozoa;Metazoa;Animalia;BCP clade;Bilateria;Protostomia;Lophotrochozoa;Lophophorata;Brachiopoda;Rhynchonelliformea;Rhynchonellata;";"0.0";"0";"37";"37";"0";"37";"0";"457146";"391207"
"V4mis2";"SILVA (only NR);Eukaryota;Amorphea;Obazoa;Opisthokonta;Holozoa;Choanozoa;Metazoa;Animalia;BCP clade;Bilateria;Protostomia;Lophotrochozoa;Lophophorata;Brachiopoda;Rhynchonelliformea;Rhynchonellata;Rhynchonellida;";"0.0";"0";"9";"9";"0";"9";"0";"457174";"391207"
"V4mis2";"SILVA (only NR);Eukaryota;Amorphea;Obazoa;Opisthokonta;Holozoa;Choanozoa;Metazoa;Animalia;BCP clade;Bilateria;Protostomia;Lophotrochozoa;Lophophorata;Brachiopoda;Rhynchonelliformea;Rhynchonellata;Terebratulida;";"0.0";"0";"20";"20";"0";"20";"0";"457163";"391207"
"V4mis2";"SILVA (only NR);Eukaryota;Amorphea;Obazoa;Opisthokonta;Holozoa;Choanozoa;Metazoa;Animalia;BCP clade;Bilateria;Protostomia;Lophotrochozoa;Lophophorata;Brachiopoda;Rhynchonelliformea;Rhynchonellata;Thecideida;";"0.0";"0";"8";"8";"0";"8";"0";"457175";"391207"
"V4mis2";"SILVA (only NR);Eukaryota;Amorphea;Obazoa;Opisthokonta;Holozoa;Choanozoa;Metazoa;Animalia;BCP clade;Bilateria;Protostomia;Lophotrochozoa;Micrognathozoa;";"0.0";"0";"2";"2";"0";"2";"0";"457181";"391207"
"V4mis2";"SILVA (only NR);Eukaryota;Amorphea;Obazoa;Opisthokonta;Holozoa;Choanozoa;Metazoa;Animalia;BCP clade;Bilateria;Protostomia;Lophotrochozoa;Micrognathozoa;Limnognathia;";"0.0";"0";"2";"2";"0";"2";"0";"457181";"391207"
"V4mis2";"SILVA (only NR);Eukaryota;Amorphea;Obazoa;Opisthokonta;Holozoa;Choanozoa;Metazoa;Animalia;BCP clade;Bilateria;Protostomia;Lophotrochozoa;Mollusca;";"1.2";"14.2";"986";"983";"12";"971";"3";"456200";"391195"
"V4mis2";"SILVA (only NR);Eukaryota;Amorphea;Obazoa;Opisthokonta;Holozoa;Choanozoa;Metazoa;Animalia;BCP clade;Bilateria;Protostomia;Lophotrochozoa;Mollusca;Bivalvia;";"1.9";"14.4";"368";"368";"7";"361";"0";"456815";"391200"
"V4mis2";"SILVA (only NR);Eukaryota;Amorphea;Obazoa;Opisthokonta;Holozoa;Choanozoa;Metazoa;Animalia;BCP clade;Bilateria;Protostomia;Lophotrochozoa;Mollusca;Bivalvia;Anomalodesmata;";"9.3";"14.4";"43";"43";"4";"39";"0";"457140";"391203"
"V4mis2";"SILVA (only NR);Eukaryota;Amorphea;Obazoa;Opisthokonta;Holozoa;Choanozoa;Metazoa;Animalia;BCP clade;Bilateria;Protostomia;Lophotrochozoa;Mollusca;Bivalvia;Anomalodesmata;Pholadomyoida;";"9.3";"14.4";"43";"43";"4";"39";"0";"457140";"391203"
"V4mis2";"SILVA (only NR);Eukaryota;Amorphea;Obazoa;Opisthokonta;Holozoa;Choanozoa;Metazoa;Animalia;BCP clade;Bilateria;Protostomia;Lophotrochozoa;Mollusca;Bivalvia;Heteroconchia;";"1.7";"14.4";"176";"176";"3";"173";"0";"457007";"391204"
"V4mis2";"SILVA (only NR);Eukaryota;Amorphea;Obazoa;Opisthokonta;Holozoa;Choanozoa;Metazoa;Animalia;BCP clade;Bilateria;Protostomia;Lophotrochozoa;Mollusca;Bivalvia;Heteroconchia;Myoida;";"0.0";"0";"36";"36";"0";"36";"0";"457147";"391207"
"V4mis2";"SILVA (only NR);Eukaryota;Amorphea;Obazoa;Opisthokonta;Holozoa;Choanozoa;Metazoa;Animalia;BCP clade;Bilateria;Protostomia;Lophotrochozoa;Mollusca;Bivalvia;Heteroconchia;Veneroida;";"2.2";"14.4";"134";"134";"3";"131";"0";"457049";"391204"
"V4mis2";"SILVA (only NR);Eukaryota;Amorphea;Obazoa;Opisthokonta;Holozoa;Choanozoa;Metazoa;Animalia;BCP clade;Bilateria;Protostomia;Lophotrochozoa;Mollusca;Bivalvia;Palaeoheterodonta;";"0.0";"0";"15";"15";"0";"15";"0";"457168";"391207"
"V4mis2";"SILVA (only NR);Eukaryota;Amorphea;Obazoa;Opisthokonta;Holozoa;Choanozoa;Metazoa;Animalia;BCP clade;Bilateria;Protostomia;Lophotrochozoa;Mollusca;Bivalvia;Palaeoheterodonta;Unionoida;";"0.0";"0";"14";"14";"0";"14";"0";"457169";"391207"
"V4mis2";"SILVA (only NR);Eukaryota;Amorphea;Obazoa;Opisthokonta;Holozoa;Choanozoa;Metazoa;Animalia;BCP clade;Bilateria;Protostomia;Lophotrochozoa;Mollusca;Bivalvia;Protobranchia;";"0.0";"0";"26";"26";"0";"26";"0";"457157";"391207"
"V4mis2";"SILVA (only NR);Eukaryota;Amorphea;Obazoa;Opisthokonta;Holozoa;Choanozoa;Metazoa;Animalia;BCP clade;Bilateria;Protostomia;Lophotrochozoa;Mollusca;Bivalvia;Protobranchia;Nuculanoida;";"0.0";"0";"6";"6";"0";"6";"0";"457177";"391207"
"V4mis2";"SILVA (only NR);Eukaryota;Amorphea;Obazoa;Opisthokonta;Holozoa;Choanozoa;Metazoa;Animalia;BCP clade;Bilateria;Protostomia;Lophotrochozoa;Mollusca;Bivalvia;Protobranchia;Nuculoida;";"0.0";"0";"4";"4";"0";"4";"0";"457179";"391207"
"V4mis2";"SILVA (only NR);Eukaryota;Amorphea;Obazoa;Opisthokonta;Holozoa;Choanozoa;Metazoa;Animalia;BCP clade;Bilateria;Protostomia;Lophotrochozoa;Mollusca;Bivalvia;Protobranchia;Solemyoida;";"0.0";"0";"16";"16";"0";"16";"0";"457167";"391207"
"V4mis2";"SILVA (only NR);Eukaryota;Amorphea;Obazoa;Opisthokonta;Holozoa;Choanozoa;Metazoa;Animalia;BCP clade;Bilateria;Protostomia;Lophotrochozoa;Mollusca;Bivalvia;Pteriomorphia;";"0.0";"0";"108";"108";"0";"108";"0";"457075";"391207"
"V4mis2";"SILVA (only NR);Eukaryota;Amorphea;Obazoa;Opisthokonta;Holozoa;Choanozoa;Metazoa;Animalia;BCP clade;Bilateria;Protostomia;Lophotrochozoa;Mollusca;Bivalvia;Pteriomorphia;Arcoida;";"0.0";"0";"12";"12";"0";"12";"0";"457171";"391207"
"V4mis2";"SILVA (only NR);Eukaryota;Amorphea;Obazoa;Opisthokonta;Holozoa;Choanozoa;Metazoa;Animalia;BCP clade;Bilateria;Protostomia;Lophotrochozoa;Mollusca;Bivalvia;Pteriomorphia;Limoida;";"0.0";"0";"8";"8";"0";"8";"0";"457175";"391207"
"V4mis2";"SILVA (only NR);Eukaryota;Amorphea;Obazoa;Opisthokonta;Holozoa;Choanozoa;Metazoa;Animalia;BCP clade;Bilateria;Protostomia;Lophotrochozoa;Mollusca;Bivalvia;Pteriomorphia;Mytiloida;";"0.0";"0";"37";"37";"0";"37";"0";"457146";"391207"
"V4mis2";"SILVA (only NR);Eukaryota;Amorphea;Obazoa;Opisthokonta;Holozoa;Choanozoa;Metazoa;Animalia;BCP clade;Bilateria;Protostomia;Lophotrochozoa;Mollusca;Bivalvia;Pteriomorphia;Ostreoida;";"0.0";"0";"16";"16";"0";"16";"0";"457167";"391207"
"V4mis2";"SILVA (only NR);Eukaryota;Amorphea;Obazoa;Opisthokonta;Holozoa;Choanozoa;Metazoa;Animalia;BCP clade;Bilateria;Protostomia;Lophotrochozoa;Mollusca;Bivalvia;Pteriomorphia;Pectinoida;";"0.0";"0";"13";"13";"0";"13";"0";"457170";"391207"
"V4mis2";"SILVA (only NR);Eukaryota;Amorphea;Obazoa;Opisthokonta;Holozoa;Choanozoa;Metazoa;Animalia;BCP clade;Bilateria;Protostomia;Lophotrochozoa;Mollusca;Bivalvia;Pteriomorphia;Pterioida;";"0.0";"0";"22";"22";"0";"22";"0";"457161";"391207"
"V4mis2";"SILVA (only NR);Eukaryota;Amorphea;Obazoa;Opisthokonta;Holozoa;Choanozoa;Metazoa;Animalia;BCP clade;Bilateria;Protostomia;Lophotrochozoa;Mollusca;Caudofoveata;";"0.0";"0";"4";"4";"0";"4";"0";"457179";"391207"
"V4mis2";"SILVA (only NR);Eukaryota;Amorphea;Obazoa;Opisthokonta;Holozoa;Choanozoa;Metazoa;Animalia;BCP clade;Bilateria;Protostomia;Lophotrochozoa;Mollusca;Cephalopoda;";"0.0";"0";"53";"51";"0";"51";"2";"457132";"391207"
"V4mis2";"SILVA (only NR);Eukaryota;Amorphea;Obazoa;Opisthokonta;Holozoa;Choanozoa;Metazoa;Animalia;BCP clade;Bilateria;Protostomia;Lophotrochozoa;Mollusca;Cephalopoda;Coleoidea;";"0.0";"0";"53";"51";"0";"51";"2";"457132";"391207"
"V4mis2";"SILVA (only NR);Eukaryota;Amorphea;Obazoa;Opisthokonta;Holozoa;Choanozoa;Metazoa;Animalia;BCP clade;Bilateria;Protostomia;Lophotrochozoa;Mollusca;Cephalopoda;Coleoidea;Decapodiformes;";"0.0";"0";"50";"48";"0";"48";"2";"457135";"391207"
"V4mis2";"SILVA (only NR);Eukaryota;Amorphea;Obazoa;Opisthokonta;Holozoa;Choanozoa;Metazoa;Animalia;BCP clade;Bilateria;Protostomia;Lophotrochozoa;Mollusca;Cephalopoda;Coleoidea;Decapodiformes;Teuthida;";"0.0";"0";"46";"46";"0";"46";"0";"457137";"391207"
"V4mis2";"SILVA (only NR);Eukaryota;Amorphea;Obazoa;Opisthokonta;Holozoa;Choanozoa;Metazoa;Animalia;BCP clade;Bilateria;Protostomia;Lophotrochozoa;Mollusca;Gastropoda;";"1.0";"14.3";"496";"495";"5";"490";"1";"456688";"391202"
"V4mis2";"SILVA (only NR);Eukaryota;Amorphea;Obazoa;Opisthokonta;Holozoa;Choanozoa;Metazoa;Animalia;BCP clade;Bilateria;Protostomia;Lophotrochozoa;Mollusca;Gastropoda;Caenogastropoda;";"0.0";"0";"97";"96";"0";"96";"1";"457087";"391207"
"V4mis2";"SILVA (only NR);Eukaryota;Amorphea;Obazoa;Opisthokonta;Holozoa;Choanozoa;Metazoa;Animalia;BCP clade;Bilateria;Protostomia;Lophotrochozoa;Mollusca;Gastropoda;Cucculiniformia;";"0.0";"0";"6";"6";"0";"6";"0";"457177";"391207"
"V4mis2";"SILVA (only NR);Eukaryota;Amorphea;Obazoa;Opisthokonta;Holozoa;Choanozoa;Metazoa;Animalia;BCP clade;Bilateria;Protostomia;Lophotrochozoa;Mollusca;Gastropoda;Heterobranchia;";"1.0";"14.4";"314";"314";"3";"311";"0";"456869";"391204"
"V4mis2";"SILVA (only NR);Eukaryota;Amorphea;Obazoa;Opisthokonta;Holozoa;Choanozoa;Metazoa;Animalia;BCP clade;Bilateria;Protostomia;Lophotrochozoa;Mollusca;Gastropoda;Neritimorpha;";"0.0";"0";"6";"6";"0";"6";"0";"457177";"391207"
"V4mis2";"SILVA (only NR);Eukaryota;Amorphea;Obazoa;Opisthokonta;Holozoa;Choanozoa;Metazoa;Animalia;BCP clade;Bilateria;Protostomia;Lophotrochozoa;Mollusca;Gastropoda;Vetigastropoda;";"2.8";"14.4";"72";"72";"2";"70";"0";"457111";"391205"
"V4mis2";"SILVA (only NR);Eukaryota;Amorphea;Obazoa;Opisthokonta;Holozoa;Choanozoa;Metazoa;Animalia;BCP clade;Bilateria;Protostomia;Lophotrochozoa;Mollusca;Polyplacophora;";"0.0";"0";"45";"45";"0";"45";"0";"457138";"391207"
"V4mis2";"SILVA (only NR);Eukaryota;Amorphea;Obazoa;Opisthokonta;Holozoa;Choanozoa;Metazoa;Animalia;BCP clade;Bilateria;Protostomia;Lophotrochozoa;Mollusca;Polyplacophora;Neoloricata;";"0.0";"0";"45";"45";"0";"45";"0";"457138";"391207"
"V4mis2";"SILVA (only NR);Eukaryota;Amorphea;Obazoa;Opisthokonta;Holozoa;Choanozoa;Metazoa;Animalia;BCP clade;Bilateria;Protostomia;Lophotrochozoa;Mollusca;Scaphopoda;";"0.0";"0";"16";"16";"0";"16";"0";"457167";"391207"
"V4mis2";"SILVA (only NR);Eukaryota;Amorphea;Obazoa;Opisthokonta;Holozoa;Choanozoa;Metazoa;Animalia;BCP clade;Bilateria;Protostomia;Lophotrochozoa;Mollusca;Scaphopoda;Dentaliida;";"0.0";"0";"7";"7";"0";"7";"0";"457176";"391207"
"V4mis2";"SILVA (only NR);Eukaryota;Amorphea;Obazoa;Opisthokonta;Holozoa;Choanozoa;Metazoa;Animalia;BCP clade;Bilateria;Protostomia;Lophotrochozoa;Mollusca;Scaphopoda;Gadilida;";"0.0";"0";"9";"9";"0";"9";"0";"457174";"391207"
"V4mis2";"SILVA (only NR);Eukaryota;Amorphea;Obazoa;Opisthokonta;Holozoa;Choanozoa;Metazoa;Animalia;BCP clade;Bilateria;Protostomia;Lophotrochozoa;Nemertea;";"0.0";"0";"160";"160";"0";"160";"0";"457023";"391207"
"V4mis2";"SILVA (only NR);Eukaryota;Amorphea;Obazoa;Opisthokonta;Holozoa;Choanozoa;Metazoa;Animalia;BCP clade;Bilateria;Protostomia;Lophotrochozoa;Nemertea;Anopla;";"0.0";"0";"74";"74";"0";"74";"0";"457109";"391207"
"V4mis2";"SILVA (only NR);Eukaryota;Amorphea;Obazoa;Opisthokonta;Holozoa;Choanozoa;Metazoa;Animalia;BCP clade;Bilateria;Protostomia;Lophotrochozoa;Nemertea;Anopla;Heteronemertea;";"0.0";"0";"38";"38";"0";"38";"0";"457145";"391207"
"V4mis2";"SILVA (only NR);Eukaryota;Amorphea;Obazoa;Opisthokonta;Holozoa;Choanozoa;Metazoa;Animalia;BCP clade;Bilateria;Protostomia;Lophotrochozoa;Nemertea;Anopla;Palaeonemertea;";"0.0";"0";"34";"34";"0";"34";"0";"457149";"391207"
"V4mis2";"SILVA (only NR);Eukaryota;Amorphea;Obazoa;Opisthokonta;Holozoa;Choanozoa;Metazoa;Animalia;BCP clade;Bilateria;Protostomia;Lophotrochozoa;Nemertea;Enopla;";"0.0";"0";"86";"86";"0";"86";"0";"457097";"391207"
"V4mis2";"SILVA (only NR);Eukaryota;Amorphea;Obazoa;Opisthokonta;Holozoa;Choanozoa;Metazoa;Animalia;BCP clade;Bilateria;Protostomia;Lophotrochozoa;Nemertea;Enopla;Bdellonemertea;";"0.0";"0";"2";"2";"0";"2";"0";"457181";"391207"
"V4mis2";"SILVA (only NR);Eukaryota;Amorphea;Obazoa;Opisthokonta;Holozoa;Choanozoa;Metazoa;Animalia;BCP clade;Bilateria;Protostomia;Lophotrochozoa;Nemertea;Enopla;Monostilifera;";"0.0";"0";"79";"79";"0";"79";"0";"457104";"391207"
"V4mis2";"SILVA (only NR);Eukaryota;Amorphea;Obazoa;Opisthokonta;Holozoa;Choanozoa;Metazoa;Animalia;BCP clade;Bilateria;Protostomia;Lophotrochozoa;Nemertea;Enopla;Polystilifera;";"0.0";"0";"4";"4";"0";"4";"0";"457179";"391207"
"V4mis2";"SILVA (only NR);Eukaryota;Amorphea;Obazoa;Opisthokonta;Holozoa;Choanozoa;Metazoa;Animalia;BCP clade;Bilateria;Protostomia;Lophotrochozoa;Pauropoda;";"0.0";"0";"5";"5";"0";"5";"0";"457178";"391207"
"V4mis2";"SILVA (only NR);Eukaryota;Amorphea;Obazoa;Opisthokonta;Holozoa;Choanozoa;Metazoa;Animalia;BCP clade;Bilateria;Protostomia;Lophotrochozoa;Platyhelminthes;";"0.3";"14.1";"1993";"1971";"5";"1966";"22";"455212";"391202"
"V4mis2";"SILVA (only NR);Eukaryota;Amorphea;Obazoa;Opisthokonta;Holozoa;Choanozoa;Metazoa;Animalia;BCP clade;Bilateria;Protostomia;Lophotrochozoa;Platyhelminthes;Catenulida;";"0.0";"0";"43";"42";"0";"42";"1";"457141";"391207"
"V4mis2";"SILVA (only NR);Eukaryota;Amorphea;Obazoa;Opisthokonta;Holozoa;Choanozoa;Metazoa;Animalia;BCP clade;Bilateria;Protostomia;Lophotrochozoa;Platyhelminthes;Catenulida;Catenulidae;";"0.0";"0";"22";"22";"0";"22";"0";"457161";"391207"
"V4mis2";"SILVA (only NR);Eukaryota;Amorphea;Obazoa;Opisthokonta;Holozoa;Choanozoa;Metazoa;Animalia;BCP clade;Bilateria;Protostomia;Lophotrochozoa;Platyhelminthes;Catenulida;Stenostomidae;";"0.0";"0";"20";"19";"0";"19";"1";"457164";"391207"
"V4mis2";"SILVA (only NR);Eukaryota;Amorphea;Obazoa;Opisthokonta;Holozoa;Choanozoa;Metazoa;Animalia;BCP clade;Bilateria;Protostomia;Lophotrochozoa;Platyhelminthes;Cestoda;";"0.0";"0";"508";"495";"0";"495";"13";"456688";"391207"
"V4mis2";"SILVA (only NR);Eukaryota;Amorphea;Obazoa;Opisthokonta;Holozoa;Choanozoa;Metazoa;Animalia;BCP clade;Bilateria;Protostomia;Lophotrochozoa;Platyhelminthes;Cestoda;Cestodaria;";"0.0";"0";"4";"4";"0";"4";"0";"457179";"391207"
"V4mis2";"SILVA (only NR);Eukaryota;Amorphea;Obazoa;Opisthokonta;Holozoa;Choanozoa;Metazoa;Animalia;BCP clade;Bilateria;Protostomia;Lophotrochozoa;Platyhelminthes;Cestoda;Cestodaria;Amphilinidea;";"0.0";"0";"2";"2";"0";"2";"0";"457181";"391207"
"V4mis2";"SILVA (only NR);Eukaryota;Amorphea;Obazoa;Opisthokonta;Holozoa;Choanozoa;Metazoa;Animalia;BCP clade;Bilateria;Protostomia;Lophotrochozoa;Platyhelminthes;Cestoda;Cestodaria;Gyrocotylidea;";"0.0";"0";"2";"2";"0";"2";"0";"457181";"391207"
"V4mis2";"SILVA (only NR);Eukaryota;Amorphea;Obazoa;Opisthokonta;Holozoa;Choanozoa;Metazoa;Animalia;BCP clade;Bilateria;Protostomia;Lophotrochozoa;Platyhelminthes;Cestoda;Eucestoda;";"0.0";"0";"503";"490";"0";"490";"13";"456693";"391207"
"V4mis2";"SILVA (only NR);Eukaryota;Amorphea;Obazoa;Opisthokonta;Holozoa;Choanozoa;Metazoa;Animalia;BCP clade;Bilateria;Protostomia;Lophotrochozoa;Platyhelminthes;Cestoda;Eucestoda;Bothriocephalidea;";"0.0";"0";"43";"43";"0";"43";"0";"457140";"391207"
"V4mis2";"SILVA (only NR);Eukaryota;Amorphea;Obazoa;Opisthokonta;Holozoa;Choanozoa;Metazoa;Animalia;BCP clade;Bilateria;Protostomia;Lophotrochozoa;Platyhelminthes;Cestoda;Eucestoda;Caryophyllidea;";"0.0";"0";"31";"31";"0";"31";"0";"457152";"391207"
"V4mis2";"SILVA (only NR);Eukaryota;Amorphea;Obazoa;Opisthokonta;Holozoa;Choanozoa;Metazoa;Animalia;BCP clade;Bilateria;Protostomia;Lophotrochozoa;Platyhelminthes;Cestoda;Eucestoda;Cathetocephalidea;";"0.0";"0";"2";"2";"0";"2";"0";"457181";"391207"
"V4mis2";"SILVA (only NR);Eukaryota;Amorphea;Obazoa;Opisthokonta;Holozoa;Choanozoa;Metazoa;Animalia;BCP clade;Bilateria;Protostomia;Lophotrochozoa;Platyhelminthes;Cestoda;Eucestoda;Cyclophyllidea;";"0.0";"0";"90";"80";"0";"80";"10";"457103";"391207"
"V4mis2";"SILVA (only NR);Eukaryota;Amorphea;Obazoa;Opisthokonta;Holozoa;Choanozoa;Metazoa;Animalia;BCP clade;Bilateria;Protostomia;Lophotrochozoa;Platyhelminthes;Cestoda;Eucestoda;Diphyllidea;";"0.0";"0";"21";"21";"0";"21";"0";"457162";"391207"
"V4mis2";"SILVA (only NR);Eukaryota;Amorphea;Obazoa;Opisthokonta;Holozoa;Choanozoa;Metazoa;Animalia;BCP clade;Bilateria;Protostomia;Lophotrochozoa;Platyhelminthes;Cestoda;Eucestoda;Diphyllobothriidea;";"0.0";"0";"12";"12";"0";"12";"0";"457171";"391207"
"V4mis2";"SILVA (only NR);Eukaryota;Amorphea;Obazoa;Opisthokonta;Holozoa;Choanozoa;Metazoa;Animalia;BCP clade;Bilateria;Protostomia;Lophotrochozoa;Platyhelminthes;Cestoda;Eucestoda;Eucestoda Incertae Sedis;";"0.0";"0";"4";"4";"0";"4";"0";"457179";"391207"
"V4mis2";"SILVA (only NR);Eukaryota;Amorphea;Obazoa;Opisthokonta;Holozoa;Choanozoa;Metazoa;Animalia;BCP clade;Bilateria;Protostomia;Lophotrochozoa;Platyhelminthes;Cestoda;Eucestoda;Lecanicephalidea;";"0.0";"0";"36";"36";"0";"36";"0";"457147";"391207"
"V4mis2";"SILVA (only NR);Eukaryota;Amorphea;Obazoa;Opisthokonta;Holozoa;Choanozoa;Metazoa;Animalia;BCP clade;Bilateria;Protostomia;Lophotrochozoa;Platyhelminthes;Cestoda;Eucestoda;Litobothriidea;";"0.0";"0";"3";"3";"0";"3";"0";"457180";"391207"
"V4mis2";"SILVA (only NR);Eukaryota;Amorphea;Obazoa;Opisthokonta;Holozoa;Choanozoa;Metazoa;Animalia;BCP clade;Bilateria;Protostomia;Lophotrochozoa;Platyhelminthes;Cestoda;Eucestoda;Nippotaeniidea;";"0.0";"0";"4";"4";"0";"4";"0";"457179";"391207"
"V4mis2";"SILVA (only NR);Eukaryota;Amorphea;Obazoa;Opisthokonta;Holozoa;Choanozoa;Metazoa;Animalia;BCP clade;Bilateria;Protostomia;Lophotrochozoa;Platyhelminthes;Cestoda;Eucestoda;Proteocephalidea;";"0.0";"0";"28";"28";"0";"28";"0";"457155";"391207"
"V4mis2";"SILVA (only NR);Eukaryota;Amorphea;Obazoa;Opisthokonta;Holozoa;Choanozoa;Metazoa;Animalia;BCP clade;Bilateria;Protostomia;Lophotrochozoa;Platyhelminthes;Cestoda;Eucestoda;Pseudophyllidea;";"0.0";"0";"7";"7";"0";"7";"0";"457176";"391207"
"V4mis2";"SILVA (only NR);Eukaryota;Amorphea;Obazoa;Opisthokonta;Holozoa;Choanozoa;Metazoa;Animalia;BCP clade;Bilateria;Protostomia;Lophotrochozoa;Platyhelminthes;Cestoda;Eucestoda;Rhinebothriidea;";"0.0";"0";"50";"50";"0";"50";"0";"457133";"391207"
"V4mis2";"SILVA (only NR);Eukaryota;Amorphea;Obazoa;Opisthokonta;Holozoa;Choanozoa;Metazoa;Animalia;BCP clade;Bilateria;Protostomia;Lophotrochozoa;Platyhelminthes;Cestoda;Eucestoda;Spathebothriidea;";"0.0";"0";"4";"4";"0";"4";"0";"457179";"391207"
"V4mis2";"SILVA (only NR);Eukaryota;Amorphea;Obazoa;Opisthokonta;Holozoa;Choanozoa;Metazoa;Animalia;BCP clade;Bilateria;Protostomia;Lophotrochozoa;Platyhelminthes;Cestoda;Eucestoda;Tetrabothriidea;";"0.0";"0";"3";"3";"0";"3";"0";"457180";"391207"
"V4mis2";"SILVA (only NR);Eukaryota;Amorphea;Obazoa;Opisthokonta;Holozoa;Choanozoa;Metazoa;Animalia;BCP clade;Bilateria;Protostomia;Lophotrochozoa;Platyhelminthes;Cestoda;Eucestoda;Tetraphyllidea;";"0.0";"0";"52";"49";"0";"49";"3";"457134";"391207"
"V4mis2";"SILVA (only NR);Eukaryota;Amorphea;Obazoa;Opisthokonta;Holozoa;Choanozoa;Metazoa;Animalia;BCP clade;Bilateria;Protostomia;Lophotrochozoa;Platyhelminthes;Cestoda;Eucestoda;Trypanorhyncha;";"0.0";"0";"78";"78";"0";"78";"0";"457105";"391207"
"V4mis2";"SILVA (only NR);Eukaryota;Amorphea;Obazoa;Opisthokonta;Holozoa;Choanozoa;Metazoa;Animalia;BCP clade;Bilateria;Protostomia;Lophotrochozoa;Platyhelminthes;Monogenea;";"0.0";"0";"195";"194";"0";"194";"1";"456989";"391207"
"V4mis2";"SILVA (only NR);Eukaryota;Amorphea;Obazoa;Opisthokonta;Holozoa;Choanozoa;Metazoa;Animalia;BCP clade;Bilateria;Protostomia;Lophotrochozoa;Platyhelminthes;Monogenea;Monopisthocotylea;";"0.0";"0";"121";"120";"0";"120";"1";"457063";"391207"
"V4mis2";"SILVA (only NR);Eukaryota;Amorphea;Obazoa;Opisthokonta;Holozoa;Choanozoa;Metazoa;Animalia;BCP clade;Bilateria;Protostomia;Lophotrochozoa;Platyhelminthes;Monogenea;Monopisthocotylea;Ancylodiscoididae;";"0.0";"0";"17";"16";"0";"16";"1";"457167";"391207"
"V4mis2";"SILVA (only NR);Eukaryota;Amorphea;Obazoa;Opisthokonta;Holozoa;Choanozoa;Metazoa;Animalia;BCP clade;Bilateria;Protostomia;Lophotrochozoa;Platyhelminthes;Monogenea;Monopisthocotylea;Ancyrocephalidae;";"0.0";"0";"32";"32";"0";"32";"0";"457151";"391207"
"V4mis2";"SILVA (only NR);Eukaryota;Amorphea;Obazoa;Opisthokonta;Holozoa;Choanozoa;Metazoa;Animalia;BCP clade;Bilateria;Protostomia;Lophotrochozoa;Platyhelminthes;Monogenea;Monopisthocotylea;Capsalidae;";"0.0";"0";"5";"5";"0";"5";"0";"457178";"391207"
"V4mis2";"SILVA (only NR);Eukaryota;Amorphea;Obazoa;Opisthokonta;Holozoa;Choanozoa;Metazoa;Animalia;BCP clade;Bilateria;Protostomia;Lophotrochozoa;Platyhelminthes;Monogenea;Monopisthocotylea;Dactylogyridae;";"0.0";"0";"4";"4";"0";"4";"0";"457179";"391207"
"V4mis2";"SILVA (only NR);Eukaryota;Amorphea;Obazoa;Opisthokonta;Holozoa;Choanozoa;Metazoa;Animalia;BCP clade;Bilateria;Protostomia;Lophotrochozoa;Platyhelminthes;Monogenea;Monopisthocotylea;Diplectanidae;";"0.0";"0";"9";"9";"0";"9";"0";"457174";"391207"
"V4mis2";"SILVA (only NR);Eukaryota;Amorphea;Obazoa;Opisthokonta;Holozoa;Choanozoa;Metazoa;Animalia;BCP clade;Bilateria;Protostomia;Lophotrochozoa;Platyhelminthes;Monogenea;Monopisthocotylea;Gyrodactylidae;";"0.0";"0";"30";"30";"0";"30";"0";"457153";"391207"
"V4mis2";"SILVA (only NR);Eukaryota;Amorphea;Obazoa;Opisthokonta;Holozoa;Choanozoa;Metazoa;Animalia;BCP clade;Bilateria;Protostomia;Lophotrochozoa;Platyhelminthes;Monogenea;Monopisthocotylea;Monocotylidae;";"0.0";"0";"4";"4";"0";"4";"0";"457179";"391207"
"V4mis2";"SILVA (only NR);Eukaryota;Amorphea;Obazoa;Opisthokonta;Holozoa;Choanozoa;Metazoa;Animalia;BCP clade;Bilateria;Protostomia;Lophotrochozoa;Platyhelminthes;Monogenea;Monopisthocotylea;Ooegyrodactylidae;";"0.0";"0";"2";"2";"0";"2";"0";"457181";"391207"
"V4mis2";"SILVA (only NR);Eukaryota;Amorphea;Obazoa;Opisthokonta;Holozoa;Choanozoa;Metazoa;Animalia;BCP clade;Bilateria;Protostomia;Lophotrochozoa;Platyhelminthes;Monogenea;Monopisthocotylea;Pseudodactylogyridae;";"0.0";"0";"3";"3";"0";"3";"0";"457180";"391207"
"V4mis2";"SILVA (only NR);Eukaryota;Amorphea;Obazoa;Opisthokonta;Holozoa;Choanozoa;Metazoa;Animalia;BCP clade;Bilateria;Protostomia;Lophotrochozoa;Platyhelminthes;Monogenea;Monopisthocotylea;Udonellidae;";"0.0";"0";"4";"4";"0";"4";"0";"457179";"391207"
"V4mis2";"SILVA (only NR);Eukaryota;Amorphea;Obazoa;Opisthokonta;Holozoa;Choanozoa;Metazoa;Animalia;BCP clade;Bilateria;Protostomia;Lophotrochozoa;Platyhelminthes;Monogenea;Polyopisthocotylea;";"0.0";"0";"74";"74";"0";"74";"0";"457109";"391207"
"V4mis2";"SILVA (only NR);Eukaryota;Amorphea;Obazoa;Opisthokonta;Holozoa;Choanozoa;Metazoa;Animalia;BCP clade;Bilateria;Protostomia;Lophotrochozoa;Platyhelminthes;Monogenea;Polyopisthocotylea;Diclidophoridae;";"0.0";"0";"6";"6";"0";"6";"0";"457177";"391207"
"V4mis2";"SILVA (only NR);Eukaryota;Amorphea;Obazoa;Opisthokonta;Holozoa;Choanozoa;Metazoa;Animalia;BCP clade;Bilateria;Protostomia;Lophotrochozoa;Platyhelminthes;Monogenea;Polyopisthocotylea;Diclybothriidae;";"0.0";"0";"2";"2";"0";"2";"0";"457181";"391207"
"V4mis2";"SILVA (only NR);Eukaryota;Amorphea;Obazoa;Opisthokonta;Holozoa;Choanozoa;Metazoa;Animalia;BCP clade;Bilateria;Protostomia;Lophotrochozoa;Platyhelminthes;Monogenea;Polyopisthocotylea;Gotocotylidae;";"0.0";"0";"3";"3";"0";"3";"0";"457180";"391207"
"V4mis2";"SILVA (only NR);Eukaryota;Amorphea;Obazoa;Opisthokonta;Holozoa;Choanozoa;Metazoa;Animalia;BCP clade;Bilateria;Protostomia;Lophotrochozoa;Platyhelminthes;Monogenea;Polyopisthocotylea;Mazocraeidae;";"0.0";"0";"6";"6";"0";"6";"0";"457177";"391207"
"V4mis2";"SILVA (only NR);Eukaryota;Amorphea;Obazoa;Opisthokonta;Holozoa;Choanozoa;Metazoa;Animalia;BCP clade;Bilateria;Protostomia;Lophotrochozoa;Platyhelminthes;Monogenea;Polyopisthocotylea;Microcotylidae;";"0.0";"0";"5";"5";"0";"5";"0";"457178";"391207"
"V4mis2";"SILVA (only NR);Eukaryota;Amorphea;Obazoa;Opisthokonta;Holozoa;Choanozoa;Metazoa;Animalia;BCP clade;Bilateria;Protostomia;Lophotrochozoa;Platyhelminthes;Monogenea;Polyopisthocotylea;Neothoracocotylidae;";"0.0";"0";"2";"2";"0";"2";"0";"457181";"391207"
"V4mis2";"SILVA (only NR);Eukaryota;Amorphea;Obazoa;Opisthokonta;Holozoa;Choanozoa;Metazoa;Animalia;BCP clade;Bilateria;Protostomia;Lophotrochozoa;Platyhelminthes;Monogenea;Polyopisthocotylea;Polystomatidae;";"0.0";"0";"37";"37";"0";"37";"0";"457146";"391207"
"V4mis2";"SILVA (only NR);Eukaryota;Amorphea;Obazoa;Opisthokonta;Holozoa;Choanozoa;Metazoa;Animalia;BCP clade;Bilateria;Protostomia;Lophotrochozoa;Platyhelminthes;Rhabditophora;";"0.6";"14.3";"886";"883";"5";"878";"3";"456300";"391202"
"V4mis2";"SILVA (only NR);Eukaryota;Amorphea;Obazoa;Opisthokonta;Holozoa;Choanozoa;Metazoa;Animalia;BCP clade;Bilateria;Protostomia;Lophotrochozoa;Platyhelminthes;Rhabditophora;Haplopharyngida;";"0.0";"0";"3";"3";"0";"3";"0";"457180";"391207"
"V4mis2";"SILVA (only NR);Eukaryota;Amorphea;Obazoa;Opisthokonta;Holozoa;Choanozoa;Metazoa;Animalia;BCP clade;Bilateria;Protostomia;Lophotrochozoa;Platyhelminthes;Rhabditophora;Lecithoepitheliata;";"0.0";"0";"21";"21";"0";"21";"0";"457162";"391207"
"V4mis2";"SILVA (only NR);Eukaryota;Amorphea;Obazoa;Opisthokonta;Holozoa;Choanozoa;Metazoa;Animalia;BCP clade;Bilateria;Protostomia;Lophotrochozoa;Platyhelminthes;Rhabditophora;Macrostomida;";"0.0";"0";"198";"198";"0";"198";"0";"456985";"391207"
"V4mis2";"SILVA (only NR);Eukaryota;Amorphea;Obazoa;Opisthokonta;Holozoa;Choanozoa;Metazoa;Animalia;BCP clade;Bilateria;Protostomia;Lophotrochozoa;Platyhelminthes;Rhabditophora;Mediofusata;";"0.0";"0";"3";"3";"0";"3";"0";"457180";"391207"
"V4mis2";"SILVA (only NR);Eukaryota;Amorphea;Obazoa;Opisthokonta;Holozoa;Choanozoa;Metazoa;Animalia;BCP clade;Bilateria;Protostomia;Lophotrochozoa;Platyhelminthes;Rhabditophora;Mediofusata;Urastomidae;";"0.0";"0";"3";"3";"0";"3";"0";"457180";"391207"
"V4mis2";"SILVA (only NR);Eukaryota;Amorphea;Obazoa;Opisthokonta;Holozoa;Choanozoa;Metazoa;Animalia;BCP clade;Bilateria;Protostomia;Lophotrochozoa;Platyhelminthes;Rhabditophora;Polycladida;";"0.0";"0";"15";"15";"0";"15";"0";"457168";"391207"
"V4mis2";"SILVA (only NR);Eukaryota;Amorphea;Obazoa;Opisthokonta;Holozoa;Choanozoa;Metazoa;Animalia;BCP clade;Bilateria;Protostomia;Lophotrochozoa;Platyhelminthes;Rhabditophora;Prolecithophora;";"0.0";"0";"28";"28";"0";"28";"0";"457155";"391207"
"V4mis2";"SILVA (only NR);Eukaryota;Amorphea;Obazoa;Opisthokonta;Holozoa;Choanozoa;Metazoa;Animalia;BCP clade;Bilateria;Protostomia;Lophotrochozoa;Platyhelminthes;Rhabditophora;Rhabdocoela;";"1.7";"14.4";"287";"287";"5";"282";"0";"456896";"391202"
"V4mis2";"SILVA (only NR);Eukaryota;Amorphea;Obazoa;Opisthokonta;Holozoa;Choanozoa;Metazoa;Animalia;BCP clade;Bilateria;Protostomia;Lophotrochozoa;Platyhelminthes;Rhabditophora;Rhabdocoela;Dalyellioida;";"0.0";"0";"38";"38";"0";"38";"0";"457145";"391207"
"V4mis2";"SILVA (only NR);Eukaryota;Amorphea;Obazoa;Opisthokonta;Holozoa;Choanozoa;Metazoa;Animalia;BCP clade;Bilateria;Protostomia;Lophotrochozoa;Platyhelminthes;Rhabditophora;Rhabdocoela;Kalyptorhynchia;";"3.1";"14.4";"130";"130";"4";"126";"0";"457053";"391203"
"V4mis2";"SILVA (only NR);Eukaryota;Amorphea;Obazoa;Opisthokonta;Holozoa;Choanozoa;Metazoa;Animalia;BCP clade;Bilateria;Protostomia;Lophotrochozoa;Platyhelminthes;Rhabditophora;Rhabdocoela;Neodalyellida;";"0.9";"14.4";"114";"114";"1";"113";"0";"457069";"391206"
"V4mis2";"SILVA (only NR);Eukaryota;Amorphea;Obazoa;Opisthokonta;Holozoa;Choanozoa;Metazoa;Animalia;BCP clade;Bilateria;Protostomia;Lophotrochozoa;Platyhelminthes;Rhabditophora;Rhabdocoela;Typhloplanoida;";"0.0";"0";"5";"5";"0";"5";"0";"457178";"391207"
"V4mis2";"SILVA (only NR);Eukaryota;Amorphea;Obazoa;Opisthokonta;Holozoa;Choanozoa;Metazoa;Animalia;BCP clade;Bilateria;Protostomia;Lophotrochozoa;Platyhelminthes;Rhabditophora;Seriata;";"0.0";"0";"330";"327";"0";"327";"3";"456856";"391207"
"V4mis2";"SILVA (only NR);Eukaryota;Amorphea;Obazoa;Opisthokonta;Holozoa;Choanozoa;Metazoa;Animalia;BCP clade;Bilateria;Protostomia;Lophotrochozoa;Platyhelminthes;Rhabditophora;Seriata;Proseriata;";"0.0";"0";"99";"99";"0";"99";"0";"457084";"391207"
"V4mis2";"SILVA (only NR);Eukaryota;Amorphea;Obazoa;Opisthokonta;Holozoa;Choanozoa;Metazoa;Animalia;BCP clade;Bilateria;Protostomia;Lophotrochozoa;Platyhelminthes;Rhabditophora;Seriata;Tricladida;";"0.0";"0";"230";"227";"0";"227";"3";"456956";"391207"
"V4mis2";"SILVA (only NR);Eukaryota;Amorphea;Obazoa;Opisthokonta;Holozoa;Choanozoa;Metazoa;Animalia;BCP clade;Bilateria;Protostomia;Lophotrochozoa;Platyhelminthes;Rhabditophora;Seriata;Tricladida;Continenticola;";"0.0";"0";"213";"210";"0";"210";"3";"456973";"391207"
"V4mis2";"SILVA (only NR);Eukaryota;Amorphea;Obazoa;Opisthokonta;Holozoa;Choanozoa;Metazoa;Animalia;BCP clade;Bilateria;Protostomia;Lophotrochozoa;Platyhelminthes;Rhabditophora;Seriata;Tricladida;Maricola;";"0.0";"0";"15";"15";"0";"15";"0";"457168";"391207"
"V4mis2";"SILVA (only NR);Eukaryota;Amorphea;Obazoa;Opisthokonta;Holozoa;Choanozoa;Metazoa;Animalia;BCP clade;Bilateria;Protostomia;Lophotrochozoa;Platyhelminthes;Trematoda;";"0.0";"0";"360";"356";"0";"356";"4";"456827";"391207"
"V4mis2";"SILVA (only NR);Eukaryota;Amorphea;Obazoa;Opisthokonta;Holozoa;Choanozoa;Metazoa;Animalia;BCP clade;Bilateria;Protostomia;Lophotrochozoa;Platyhelminthes;Trematoda;Aspidogastrea;";"0.0";"0";"9";"9";"0";"9";"0";"457174";"391207"
"V4mis2";"SILVA (only NR);Eukaryota;Amorphea;Obazoa;Opisthokonta;Holozoa;Choanozoa;Metazoa;Animalia;BCP clade;Bilateria;Protostomia;Lophotrochozoa;Platyhelminthes;Trematoda;Aspidogastrea;Aspidogastridae;";"0.0";"0";"7";"7";"0";"7";"0";"457176";"391207"
"V4mis2";"SILVA (only NR);Eukaryota;Amorphea;Obazoa;Opisthokonta;Holozoa;Choanozoa;Metazoa;Animalia;BCP clade;Bilateria;Protostomia;Lophotrochozoa;Platyhelminthes;Trematoda;Digenea;";"0.0";"0";"351";"347";"0";"347";"4";"456836";"391207"
"V4mis2";"SILVA (only NR);Eukaryota;Amorphea;Obazoa;Opisthokonta;Holozoa;Choanozoa;Metazoa;Animalia;BCP clade;Bilateria;Protostomia;Lophotrochozoa;Platyhelminthes;Trematoda;Digenea;Azygiida;";"0.0";"0";"39";"39";"0";"39";"0";"457144";"391207"
"V4mis2";"SILVA (only NR);Eukaryota;Amorphea;Obazoa;Opisthokonta;Holozoa;Choanozoa;Metazoa;Animalia;BCP clade;Bilateria;Protostomia;Lophotrochozoa;Platyhelminthes;Trematoda;Digenea;Diplostomida;";"0.0";"0";"2";"2";"0";"2";"0";"457181";"391207"
"V4mis2";"SILVA (only NR);Eukaryota;Amorphea;Obazoa;Opisthokonta;Holozoa;Choanozoa;Metazoa;Animalia;BCP clade;Bilateria;Protostomia;Lophotrochozoa;Platyhelminthes;Trematoda;Digenea;Diplostomida;Brachylaimoidea;";"0.0";"0";"2";"2";"0";"2";"0";"457181";"391207"
"V4mis2";"SILVA (only NR);Eukaryota;Amorphea;Obazoa;Opisthokonta;Holozoa;Choanozoa;Metazoa;Animalia;BCP clade;Bilateria;Protostomia;Lophotrochozoa;Platyhelminthes;Trematoda;Digenea;Echinostomida;";"0.0";"0";"53";"52";"0";"52";"1";"457131";"391207"
"V4mis2";"SILVA (only NR);Eukaryota;Amorphea;Obazoa;Opisthokonta;Holozoa;Choanozoa;Metazoa;Animalia;BCP clade;Bilateria;Protostomia;Lophotrochozoa;Platyhelminthes;Trematoda;Digenea;Incertae Sedis;";"0.0";"0";"1";"1";"0";"1";"0";"457182";"391207"
"V4mis2";"SILVA (only NR);Eukaryota;Amorphea;Obazoa;Opisthokonta;Holozoa;Choanozoa;Metazoa;Animalia;BCP clade;Bilateria;Protostomia;Lophotrochozoa;Platyhelminthes;Trematoda;Digenea;Incertae Sedis;Prosorhynchoides;";"0.0";"0";"1";"1";"0";"1";"0";"457182";"391207"
"V4mis2";"SILVA (only NR);Eukaryota;Amorphea;Obazoa;Opisthokonta;Holozoa;Choanozoa;Metazoa;Animalia;BCP clade;Bilateria;Protostomia;Lophotrochozoa;Platyhelminthes;Trematoda;Digenea;Opisthorchiida;";"0.0";"0";"36";"35";"0";"35";"1";"457148";"391207"
"V4mis2";"SILVA (only NR);Eukaryota;Amorphea;Obazoa;Opisthokonta;Holozoa;Choanozoa;Metazoa;Animalia;BCP clade;Bilateria;Protostomia;Lophotrochozoa;Platyhelminthes;Trematoda;Digenea;Plagiorchiida;";"0.0";"0";"119";"118";"0";"118";"1";"457065";"391207"
"V4mis2";"SILVA (only NR);Eukaryota;Amorphea;Obazoa;Opisthokonta;Holozoa;Choanozoa;Metazoa;Animalia;BCP clade;Bilateria;Protostomia;Lophotrochozoa;Platyhelminthes;Trematoda;Digenea;Strigeidida;";"0.0";"0";"93";"92";"0";"92";"1";"457091";"391207"
"V4mis2";"SILVA (only NR);Eukaryota;Amorphea;Obazoa;Opisthokonta;Holozoa;Choanozoa;Metazoa;Animalia;BCP clade;Bilateria;Protostomia;Lophotrochozoa;Rotifera;";"0.0";"0";"122";"122";"0";"122";"0";"457061";"391207"
"V4mis2";"SILVA (only NR);Eukaryota;Amorphea;Obazoa;Opisthokonta;Holozoa;Choanozoa;Metazoa;Animalia;BCP clade;Bilateria;Protostomia;Lophotrochozoa;Rotifera;Bdelloidea;";"0.0";"0";"57";"57";"0";"57";"0";"457126";"391207"
"V4mis2";"SILVA (only NR);Eukaryota;Amorphea;Obazoa;Opisthokonta;Holozoa;Choanozoa;Metazoa;Animalia;BCP clade;Bilateria;Protostomia;Lophotrochozoa;Rotifera;Bdelloidea;Adinetida;";"0.0";"0";"28";"28";"0";"28";"0";"457155";"391207"
"V4mis2";"SILVA (only NR);Eukaryota;Amorphea;Obazoa;Opisthokonta;Holozoa;Choanozoa;Metazoa;Animalia;BCP clade;Bilateria;Protostomia;Lophotrochozoa;Rotifera;Bdelloidea;Philodinida;";"0.0";"0";"19";"19";"0";"19";"0";"457164";"391207"
"V4mis2";"SILVA (only NR);Eukaryota;Amorphea;Obazoa;Opisthokonta;Holozoa;Choanozoa;Metazoa;Animalia;BCP clade;Bilateria;Protostomia;Lophotrochozoa;Rotifera;Bdelloidea;Rotaria;";"0.0";"0";"9";"9";"0";"9";"0";"457174";"391207"
"V4mis2";"SILVA (only NR);Eukaryota;Amorphea;Obazoa;Opisthokonta;Holozoa;Choanozoa;Metazoa;Animalia;BCP clade;Bilateria;Protostomia;Lophotrochozoa;Rotifera;Monogononta;";"0.0";"0";"64";"64";"0";"64";"0";"457119";"391207"
"V4mis2";"SILVA (only NR);Eukaryota;Amorphea;Obazoa;Opisthokonta;Holozoa;Choanozoa;Metazoa;Animalia;BCP clade;Bilateria;Protostomia;Lophotrochozoa;Rotifera;Monogononta;Flosculariacea;";"0.0";"0";"16";"16";"0";"16";"0";"457167";"391207"
"V4mis2";"SILVA (only NR);Eukaryota;Amorphea;Obazoa;Opisthokonta;Holozoa;Choanozoa;Metazoa;Animalia;BCP clade;Bilateria;Protostomia;Lophotrochozoa;Rotifera;Monogononta;Ploimida;";"0.0";"0";"48";"48";"0";"48";"0";"457135";"391207"
"V4mis2";"SILVA (only NR);Eukaryota;Amorphea;Obazoa;Opisthokonta;Holozoa;Choanozoa;Metazoa;Animalia;BCP clade;Bilateria;Protostomia;Lophotrochozoa;Xenacoelomorpha;";"78.5";"14.4";"163";"163";"128";"35";"0";"457020";"391079"
"V4mis2";"SILVA (only NR);Eukaryota;Amorphea;Obazoa;Opisthokonta;Holozoa;Choanozoa;Metazoa;Animalia;BCP clade;Bilateria;Protostomia;Lophotrochozoa;Xenacoelomorpha;Acoelomorpha;";"78.5";"14.4";"163";"163";"128";"35";"0";"457020";"391079"
"V4mis2";"SILVA (only NR);Eukaryota;Amorphea;Obazoa;Opisthokonta;Holozoa;Choanozoa;Metazoa;Animalia;BCP clade;Bilateria;Protostomia;Lophotrochozoa;Xenacoelomorpha;Acoelomorpha;Acoela;";"94.1";"14.4";"135";"135";"127";"8";"0";"457048";"391080"
"V4mis2";"SILVA (only NR);Eukaryota;Amorphea;Obazoa;Opisthokonta;Holozoa;Choanozoa;Metazoa;Animalia;BCP clade;Bilateria;Protostomia;Lophotrochozoa;Xenacoelomorpha;Acoelomorpha;Nemertodermatida;";"3.6";"14.4";"28";"28";"1";"27";"0";"457155";"391206"
"V4mis2";"SILVA (only NR);Eukaryota;Amorphea;Obazoa;Opisthokonta;Holozoa;Choanozoa;Metazoa;Animalia;BCP clade;Bilateria;Protostomia;Lophotrochozoa;Xenacoelomorpha;Acoelomorpha;Nemertodermatida;Nemertodermatidae;";"3.6";"14.4";"28";"28";"1";"27";"0";"457155";"391206"
"V4mis2";"SILVA (only NR);Eukaryota;Amorphea;Obazoa;Opisthokonta;Holozoa;Choanozoa;Metazoa;Animalia;BCP clade;Bilateria;Protostomia;uncultured;";"0.0";"0";"12";"12";"0";"12";"0";"457171";"391207"
"V4mis2";"SILVA (only NR);Eukaryota;Amorphea;Obazoa;Opisthokonta;Holozoa;Choanozoa;Metazoa;Animalia;BCP clade;Cnidaria;";"1.9";"14.2";"1397";"1393";"26";"1367";"4";"455790";"391181"
"V4mis2";"SILVA (only NR);Eukaryota;Amorphea;Obazoa;Opisthokonta;Holozoa;Choanozoa;Metazoa;Animalia;BCP clade;Cnidaria;Anthozoa;";"0.0";"0";"313";"313";"0";"313";"0";"456870";"391207"
"V4mis2";"SILVA (only NR);Eukaryota;Amorphea;Obazoa;Opisthokonta;Holozoa;Choanozoa;Metazoa;Animalia;BCP clade;Cnidaria;Anthozoa;Hexacorallia;";"0.0";"0";"209";"209";"0";"209";"0";"456974";"391207"
"V4mis2";"SILVA (only NR);Eukaryota;Amorphea;Obazoa;Opisthokonta;Holozoa;Choanozoa;Metazoa;Animalia;BCP clade;Cnidaria;Anthozoa;Hexacorallia;Actiniaria;";"0.0";"0";"100";"100";"0";"100";"0";"457083";"391207"
"V4mis2";"SILVA (only NR);Eukaryota;Amorphea;Obazoa;Opisthokonta;Holozoa;Choanozoa;Metazoa;Animalia;BCP clade;Cnidaria;Anthozoa;Hexacorallia;Ceriantharia;";"0.0";"0";"6";"6";"0";"6";"0";"457177";"391207"
"V4mis2";"SILVA (only NR);Eukaryota;Amorphea;Obazoa;Opisthokonta;Holozoa;Choanozoa;Metazoa;Animalia;BCP clade;Cnidaria;Anthozoa;Hexacorallia;Corallimorpharia;";"0.0";"0";"9";"9";"0";"9";"0";"457174";"391207"
"V4mis2";"SILVA (only NR);Eukaryota;Amorphea;Obazoa;Opisthokonta;Holozoa;Choanozoa;Metazoa;Animalia;BCP clade;Cnidaria;Anthozoa;Hexacorallia;Scleractinia;";"0.0";"0";"61";"61";"0";"61";"0";"457122";"391207"
"V4mis2";"SILVA (only NR);Eukaryota;Amorphea;Obazoa;Opisthokonta;Holozoa;Choanozoa;Metazoa;Animalia;BCP clade;Cnidaria;Anthozoa;Hexacorallia;Zoantharia;";"0.0";"0";"7";"7";"0";"7";"0";"457176";"391207"
"V4mis2";"SILVA (only NR);Eukaryota;Amorphea;Obazoa;Opisthokonta;Holozoa;Choanozoa;Metazoa;Animalia;BCP clade;Cnidaria;Anthozoa;Octocorallia;";"0.0";"0";"104";"104";"0";"104";"0";"457079";"391207"
"V4mis2";"SILVA (only NR);Eukaryota;Amorphea;Obazoa;Opisthokonta;Holozoa;Choanozoa;Metazoa;Animalia;BCP clade;Cnidaria;Anthozoa;Octocorallia;Alcyonacea;";"0.0";"0";"88";"88";"0";"88";"0";"457095";"391207"
"V4mis2";"SILVA (only NR);Eukaryota;Amorphea;Obazoa;Opisthokonta;Holozoa;Choanozoa;Metazoa;Animalia;BCP clade;Cnidaria;Anthozoa;Octocorallia;Pennatulacea;";"0.0";"0";"8";"8";"0";"8";"0";"457175";"391207"
"V4mis2";"SILVA (only NR);Eukaryota;Amorphea;Obazoa;Opisthokonta;Holozoa;Choanozoa;Metazoa;Animalia;BCP clade;Cnidaria;Cubozoa;";"0.0";"0";"13";"13";"0";"13";"0";"457170";"391207"
"V4mis2";"SILVA (only NR);Eukaryota;Amorphea;Obazoa;Opisthokonta;Holozoa;Choanozoa;Metazoa;Animalia;BCP clade;Cnidaria;Cubozoa;Carybdeida;";"0.0";"0";"10";"10";"0";"10";"0";"457173";"391207"
"V4mis2";"SILVA (only NR);Eukaryota;Amorphea;Obazoa;Opisthokonta;Holozoa;Choanozoa;Metazoa;Animalia;BCP clade;Cnidaria;Cubozoa;Chirodropida;";"0.0";"0";"3";"3";"0";"3";"0";"457180";"391207"
"V4mis2";"SILVA (only NR);Eukaryota;Amorphea;Obazoa;Opisthokonta;Holozoa;Choanozoa;Metazoa;Animalia;BCP clade;Cnidaria;Hydrozoa;";"0.0";"0";"352";"349";"0";"349";"3";"456834";"391207"
"V4mis2";"SILVA (only NR);Eukaryota;Amorphea;Obazoa;Opisthokonta;Holozoa;Choanozoa;Metazoa;Animalia;BCP clade;Cnidaria;Hydrozoa;Hydroidolina;";"0.0";"0";"319";"317";"0";"317";"2";"456866";"391207"
"V4mis2";"SILVA (only NR);Eukaryota;Amorphea;Obazoa;Opisthokonta;Holozoa;Choanozoa;Metazoa;Animalia;BCP clade;Cnidaria;Hydrozoa;Hydroidolina;Anthoathecata;";"0.0";"0";"98";"96";"0";"96";"2";"457087";"391207"
"V4mis2";"SILVA (only NR);Eukaryota;Amorphea;Obazoa;Opisthokonta;Holozoa;Choanozoa;Metazoa;Animalia;BCP clade;Cnidaria;Hydrozoa;Hydroidolina;Leptothecata;";"0.0";"0";"158";"158";"0";"158";"0";"457025";"391207"
"V4mis2";"SILVA (only NR);Eukaryota;Amorphea;Obazoa;Opisthokonta;Holozoa;Choanozoa;Metazoa;Animalia;BCP clade;Cnidaria;Hydrozoa;Hydroidolina;Siphonophorae;";"0.0";"0";"58";"58";"0";"58";"0";"457125";"391207"
"V4mis2";"SILVA (only NR);Eukaryota;Amorphea;Obazoa;Opisthokonta;Holozoa;Choanozoa;Metazoa;Animalia;BCP clade;Cnidaria;Hydrozoa;Trachylinae;";"0.0";"0";"32";"31";"0";"31";"1";"457152";"391207"
"V4mis2";"SILVA (only NR);Eukaryota;Amorphea;Obazoa;Opisthokonta;Holozoa;Choanozoa;Metazoa;Animalia;BCP clade;Cnidaria;Hydrozoa;Trachylinae;Limnomedusae;";"0.0";"0";"9";"9";"0";"9";"0";"457174";"391207"
"V4mis2";"SILVA (only NR);Eukaryota;Amorphea;Obazoa;Opisthokonta;Holozoa;Choanozoa;Metazoa;Animalia;BCP clade;Cnidaria;Hydrozoa;Trachylinae;Narcomedusae;";"0.0";"0";"9";"9";"0";"9";"0";"457174";"391207"
"V4mis2";"SILVA (only NR);Eukaryota;Amorphea;Obazoa;Opisthokonta;Holozoa;Choanozoa;Metazoa;Animalia;BCP clade;Cnidaria;Hydrozoa;Trachylinae;Trachymedusae;";"0.0";"0";"9";"8";"0";"8";"1";"457175";"391207"
"V4mis2";"SILVA (only NR);Eukaryota;Amorphea;Obazoa;Opisthokonta;Holozoa;Choanozoa;Metazoa;Animalia;BCP clade;Cnidaria;Myxozoa;";"3.9";"14.3";"673";"672";"26";"646";"1";"456511";"391181"
"V4mis2";"SILVA (only NR);Eukaryota;Amorphea;Obazoa;Opisthokonta;Holozoa;Choanozoa;Metazoa;Animalia;BCP clade;Cnidaria;Myxozoa;Malacosporea;";"5.0";"14.4";"20";"20";"1";"19";"0";"457163";"391206"
"V4mis2";"SILVA (only NR);Eukaryota;Amorphea;Obazoa;Opisthokonta;Holozoa;Choanozoa;Metazoa;Animalia;BCP clade;Cnidaria;Myxozoa;Malacosporea;Malacovalvulida;";"5.0";"14.4";"20";"20";"1";"19";"0";"457163";"391206"
"V4mis2";"SILVA (only NR);Eukaryota;Amorphea;Obazoa;Opisthokonta;Holozoa;Choanozoa;Metazoa;Animalia;BCP clade;Cnidaria;Myxozoa;Myxosporea;";"3.8";"14.3";"653";"652";"25";"627";"1";"456531";"391182"
"V4mis2";"SILVA (only NR);Eukaryota;Amorphea;Obazoa;Opisthokonta;Holozoa;Choanozoa;Metazoa;Animalia;BCP clade;Cnidaria;Myxozoa;Myxosporea;Bivalvulida;";"4.3";"14.3";"587";"586";"25";"561";"1";"456597";"391182"
"V4mis2";"SILVA (only NR);Eukaryota;Amorphea;Obazoa;Opisthokonta;Holozoa;Choanozoa;Metazoa;Animalia;BCP clade;Cnidaria;Myxozoa;Myxosporea;Multivalvulida;";"0.0";"0";"65";"65";"0";"65";"0";"457118";"391207"
"V4mis2";"SILVA (only NR);Eukaryota;Amorphea;Obazoa;Opisthokonta;Holozoa;Choanozoa;Metazoa;Animalia;BCP clade;Cnidaria;Scyphozoa;";"0.0";"0";"46";"46";"0";"46";"0";"457137";"391207"
"V4mis2";"SILVA (only NR);Eukaryota;Amorphea;Obazoa;Opisthokonta;Holozoa;Choanozoa;Metazoa;Animalia;BCP clade;Cnidaria;Scyphozoa;Coronatae;";"0.0";"0";"2";"2";"0";"2";"0";"457181";"391207"
"V4mis2";"SILVA (only NR);Eukaryota;Amorphea;Obazoa;Opisthokonta;Holozoa;Choanozoa;Metazoa;Animalia;BCP clade;Cnidaria;Scyphozoa;Rhizostomeae;";"0.0";"0";"12";"12";"0";"12";"0";"457171";"391207"
"V4mis2";"SILVA (only NR);Eukaryota;Amorphea;Obazoa;Opisthokonta;Holozoa;Choanozoa;Metazoa;Animalia;BCP clade;Cnidaria;Scyphozoa;Semaeostomeae;";"0.0";"0";"19";"19";"0";"19";"0";"457164";"391207"
"V4mis2";"SILVA (only NR);Eukaryota;Amorphea;Obazoa;Opisthokonta;Holozoa;Choanozoa;Metazoa;Animalia;BCP clade;Cnidaria;Scyphozoa;Stauromedusae;";"0.0";"0";"10";"10";"0";"10";"0";"457173";"391207"
"V4mis2";"SILVA (only NR);Eukaryota;Amorphea;Obazoa;Opisthokonta;Holozoa;Choanozoa;Metazoa;Animalia;BCP clade;Ctenophora;";"0.0";"0";"27";"26";"0";"26";"1";"457157";"391207"
"V4mis2";"SILVA (only NR);Eukaryota;Amorphea;Obazoa;Opisthokonta;Holozoa;Choanozoa;Metazoa;Animalia;BCP clade;Ctenophora;Nuda;";"0.0";"0";"2";"2";"0";"2";"0";"457181";"391207"
"V4mis2";"SILVA (only NR);Eukaryota;Amorphea;Obazoa;Opisthokonta;Holozoa;Choanozoa;Metazoa;Animalia;BCP clade;Ctenophora;Nuda;Beroida;";"0.0";"0";"2";"2";"0";"2";"0";"457181";"391207"
"V4mis2";"SILVA (only NR);Eukaryota;Amorphea;Obazoa;Opisthokonta;Holozoa;Choanozoa;Metazoa;Animalia;BCP clade;Ctenophora;Tentaculata;";"0.0";"0";"18";"17";"0";"17";"1";"457166";"391207"
"V4mis2";"SILVA (only NR);Eukaryota;Amorphea;Obazoa;Opisthokonta;Holozoa;Choanozoa;Metazoa;Animalia;BCP clade;Ctenophora;Tentaculata;Cydippida;";"0.0";"0";"12";"11";"0";"11";"1";"457172";"391207"
"V4mis2";"SILVA (only NR);Eukaryota;Amorphea;Obazoa;Opisthokonta;Holozoa;Choanozoa;Metazoa;Animalia;BCP clade;Ctenophora;Tentaculata;Lobata;";"0.0";"0";"2";"2";"0";"2";"0";"457181";"391207"
"V4mis2";"SILVA (only NR);Eukaryota;Amorphea;Obazoa;Opisthokonta;Holozoa;Choanozoa;Metazoa;Animalia;BCP clade;Ctenophora;Tentaculata;Platyctenida;";"0.0";"0";"2";"2";"0";"2";"0";"457181";"391207"
"V4mis2";"SILVA (only NR);Eukaryota;Amorphea;Obazoa;Opisthokonta;Holozoa;Choanozoa;Metazoa;Animalia;BCP clade;Mesozoa;";"0.0";"0";"26";"26";"0";"26";"0";"457157";"391207"
"V4mis2";"SILVA (only NR);Eukaryota;Amorphea;Obazoa;Opisthokonta;Holozoa;Choanozoa;Metazoa;Animalia;BCP clade;Mesozoa;Orthonectida;";"0.0";"0";"3";"3";"0";"3";"0";"457180";"391207"
"V4mis2";"SILVA (only NR);Eukaryota;Amorphea;Obazoa;Opisthokonta;Holozoa;Choanozoa;Metazoa;Animalia;BCP clade;Mesozoa;Orthonectida;Rhopaluridae;";"0.0";"0";"3";"3";"0";"3";"0";"457180";"391207"
"V4mis2";"SILVA (only NR);Eukaryota;Amorphea;Obazoa;Opisthokonta;Holozoa;Choanozoa;Metazoa;Animalia;BCP clade;Mesozoa;Rhombozoa;";"0.0";"0";"20";"20";"0";"20";"0";"457163";"391207"
"V4mis2";"SILVA (only NR);Eukaryota;Amorphea;Obazoa;Opisthokonta;Holozoa;Choanozoa;Metazoa;Animalia;BCP clade;Mesozoa;Rhombozoa;Dicyemida;";"0.0";"0";"20";"20";"0";"20";"0";"457163";"391207"
"V4mis2";"SILVA (only NR);Eukaryota;Amorphea;Obazoa;Opisthokonta;Holozoa;Choanozoa;Metazoa;Animalia;BCP clade;Mesozoa;Rhombozoa;Dicyemida;Dicyema;";"0.0";"0";"8";"8";"0";"8";"0";"457175";"391207"
"V4mis2";"SILVA (only NR);Eukaryota;Amorphea;Obazoa;Opisthokonta;Holozoa;Choanozoa;Metazoa;Animalia;BCP clade;Mesozoa;Rhombozoa;Dicyemida;Dicyemennea;";"0.0";"0";"5";"5";"0";"5";"0";"457178";"391207"
"V4mis2";"SILVA (only NR);Eukaryota;Amorphea;Obazoa;Opisthokonta;Holozoa;Choanozoa;Metazoa;Animalia;BCP clade;Placozoa;";"0.0";"0";"4";"3";"0";"3";"1";"457180";"391207"
"V4mis2";"SILVA (only NR);Eukaryota;Amorphea;Obazoa;Opisthokonta;Holozoa;Choanozoa;Metazoa;Animalia;BCP clade;Placozoa;Trichoplax;";"0.0";"0";"4";"3";"0";"3";"1";"457180";"391207"
"V4mis2";"SILVA (only NR);Eukaryota;Amorphea;Obazoa;Opisthokonta;Holozoa;Choanozoa;Metazoa;Porifera;";"71.9";"14.4";"396";"395";"284";"111";"1";"456788";"390923"
"V4mis2";"SILVA (only NR);Eukaryota;Amorphea;Obazoa;Opisthokonta;Holozoa;Choanozoa;Metazoa;Porifera;Calcarea;";"0.0";"0";"34";"34";"0";"34";"0";"457149";"391207"
"V4mis2";"SILVA (only NR);Eukaryota;Amorphea;Obazoa;Opisthokonta;Holozoa;Choanozoa;Metazoa;Porifera;Calcarea;Calcaronea;";"0.0";"0";"14";"14";"0";"14";"0";"457169";"391207"
"V4mis2";"SILVA (only NR);Eukaryota;Amorphea;Obazoa;Opisthokonta;Holozoa;Choanozoa;Metazoa;Porifera;Calcarea;Calcaronea;Leucosolenida;";"0.0";"0";"9";"9";"0";"9";"0";"457174";"391207"
"V4mis2";"SILVA (only NR);Eukaryota;Amorphea;Obazoa;Opisthokonta;Holozoa;Choanozoa;Metazoa;Porifera;Calcarea;Calcinea;";"0.0";"0";"20";"20";"0";"20";"0";"457163";"391207"
"V4mis2";"SILVA (only NR);Eukaryota;Amorphea;Obazoa;Opisthokonta;Holozoa;Choanozoa;Metazoa;Porifera;Calcarea;Calcinea;Clathrinida;";"0.0";"0";"18";"18";"0";"18";"0";"457165";"391207"
"V4mis2";"SILVA (only NR);Eukaryota;Amorphea;Obazoa;Opisthokonta;Holozoa;Choanozoa;Metazoa;Porifera;Calcarea;Calcinea;Murrayonida;";"0.0";"0";"2";"2";"0";"2";"0";"457181";"391207"
"V4mis2";"SILVA (only NR);Eukaryota;Amorphea;Obazoa;Opisthokonta;Holozoa;Choanozoa;Metazoa;Porifera;DemHex clade;";"84.6";"14.4";"26";"26";"22";"4";"0";"457157";"391185"
"V4mis2";"SILVA (only NR);Eukaryota;Amorphea;Obazoa;Opisthokonta;Holozoa;Choanozoa;Metazoa;Porifera;DemHex clade;Hexactinellida;";"84.6";"14.4";"26";"26";"22";"4";"0";"457157";"391185"
"V4mis2";"SILVA (only NR);Eukaryota;Amorphea;Obazoa;Opisthokonta;Holozoa;Choanozoa;Metazoa;Porifera;DemHex clade;Hexactinellida;Amphidiscophora;";"0.0";"0";"3";"3";"0";"3";"0";"457180";"391207"
"V4mis2";"SILVA (only NR);Eukaryota;Amorphea;Obazoa;Opisthokonta;Holozoa;Choanozoa;Metazoa;Porifera;DemHex clade;Hexactinellida;Amphidiscophora;Amphidiscosida;";"0.0";"0";"3";"3";"0";"3";"0";"457180";"391207"
"V4mis2";"SILVA (only NR);Eukaryota;Amorphea;Obazoa;Opisthokonta;Holozoa;Choanozoa;Metazoa;Porifera;DemHex clade;Hexactinellida;Hexasterophora;";"95.7";"14.4";"23";"23";"22";"1";"0";"457160";"391185"
"V4mis2";"SILVA (only NR);Eukaryota;Amorphea;Obazoa;Opisthokonta;Holozoa;Choanozoa;Metazoa;Porifera;DemHex clade;Hexactinellida;Hexasterophora;Hexactinosida;";"92.9";"14.4";"14";"14";"13";"1";"0";"457169";"391194"
"V4mis2";"SILVA (only NR);Eukaryota;Amorphea;Obazoa;Opisthokonta;Holozoa;Choanozoa;Metazoa;Porifera;DemHex clade;Hexactinellida;Hexasterophora;Lyssacinosida;";"100.0";"14.4";"9";"9";"9";"0";"0";"457174";"391198"
"V4mis2";"SILVA (only NR);Eukaryota;Amorphea;Obazoa;Opisthokonta;Holozoa;Choanozoa;Metazoa;Porifera;Demospongiae;";"76.8";"14.4";"315";"315";"242";"73";"0";"456868";"390965"
"V4mis2";"SILVA (only NR);Eukaryota;Amorphea;Obazoa;Opisthokonta;Holozoa;Choanozoa;Metazoa;Porifera;Demospongiae;Axinellida;";"93.3";"14.4";"15";"15";"14";"1";"0";"457168";"391193"
"V4mis2";"SILVA (only NR);Eukaryota;Amorphea;Obazoa;Opisthokonta;Holozoa;Choanozoa;Metazoa;Porifera;Demospongiae;Biemnida;";"100.0";"14.4";"3";"3";"3";"0";"0";"457180";"391204"
"V4mis2";"SILVA (only NR);Eukaryota;Amorphea;Obazoa;Opisthokonta;Holozoa;Choanozoa;Metazoa;Porifera;Demospongiae;Bubarida;";"100.0";"14.4";"8";"8";"8";"0";"0";"457175";"391199"
"V4mis2";"SILVA (only NR);Eukaryota;Amorphea;Obazoa;Opisthokonta;Holozoa;Choanozoa;Metazoa;Porifera;Demospongiae;Clionaida;";"75.0";"14.4";"4";"4";"3";"1";"0";"457179";"391204"
"V4mis2";"SILVA (only NR);Eukaryota;Amorphea;Obazoa;Opisthokonta;Holozoa;Choanozoa;Metazoa;Porifera;Demospongiae;Dendroceratida;";"0.0";"0";"3";"3";"0";"3";"0";"457180";"391207"
"V4mis2";"SILVA (only NR);Eukaryota;Amorphea;Obazoa;Opisthokonta;Holozoa;Choanozoa;Metazoa;Porifera;Demospongiae;Dictyoceratida;";"0.0";"0";"27";"27";"0";"27";"0";"457156";"391207"
"V4mis2";"SILVA (only NR);Eukaryota;Amorphea;Obazoa;Opisthokonta;Holozoa;Choanozoa;Metazoa;Porifera;Demospongiae;Hadromerida;";"0.0";"0";"5";"5";"0";"5";"0";"457178";"391207"
"V4mis2";"SILVA (only NR);Eukaryota;Amorphea;Obazoa;Opisthokonta;Holozoa;Choanozoa;Metazoa;Porifera;Demospongiae;Halichondrida;";"100.0";"14.4";"3";"3";"3";"0";"0";"457180";"391204"
"V4mis2";"SILVA (only NR);Eukaryota;Amorphea;Obazoa;Opisthokonta;Holozoa;Choanozoa;Metazoa;Porifera;Demospongiae;Haplosclerida;";"72.5";"14.4";"69";"69";"50";"19";"0";"457114";"391157"
"V4mis2";"SILVA (only NR);Eukaryota;Amorphea;Obazoa;Opisthokonta;Holozoa;Choanozoa;Metazoa;Porifera;Demospongiae;Lithistida;";"100.0";"14.4";"2";"2";"2";"0";"0";"457181";"391205"
"V4mis2";"SILVA (only NR);Eukaryota;Amorphea;Obazoa;Opisthokonta;Holozoa;Choanozoa;Metazoa;Porifera;Demospongiae;Poecilosclerida;";"100.0";"14.4";"83";"83";"83";"0";"0";"457100";"391124"
"V4mis2";"SILVA (only NR);Eukaryota;Amorphea;Obazoa;Opisthokonta;Holozoa;Choanozoa;Metazoa;Porifera;Demospongiae;Polymastiida;";"100.0";"14.4";"4";"4";"4";"0";"0";"457179";"391203"
"V4mis2";"SILVA (only NR);Eukaryota;Amorphea;Obazoa;Opisthokonta;Holozoa;Choanozoa;Metazoa;Porifera;Demospongiae;Spongillida;";"100.0";"14.4";"5";"5";"5";"0";"0";"457178";"391202"
"V4mis2";"SILVA (only NR);Eukaryota;Amorphea;Obazoa;Opisthokonta;Holozoa;Choanozoa;Metazoa;Porifera;Demospongiae;Suberitida;";"89.5";"14.4";"19";"19";"17";"2";"0";"457164";"391190"
"V4mis2";"SILVA (only NR);Eukaryota;Amorphea;Obazoa;Opisthokonta;Holozoa;Choanozoa;Metazoa;Porifera;Demospongiae;Tetractinellida;";"95.7";"14.4";"23";"23";"22";"1";"0";"457160";"391185"
"V4mis2";"SILVA (only NR);Eukaryota;Amorphea;Obazoa;Opisthokonta;Holozoa;Choanozoa;Metazoa;Porifera;Demospongiae;Verongiida;";"0.0";"0";"12";"12";"0";"12";"0";"457171";"391207"
"V4mis2";"SILVA (only NR);Eukaryota;Amorphea;Obazoa;Opisthokonta;Holozoa;Choanozoa;Metazoa;Porifera;Homoscleromorpha;";"100.0";"14.4";"20";"20";"20";"0";"0";"457163";"391187"
"V4mis2";"SILVA (only NR);Eukaryota;Amorphea;Obazoa;Opisthokonta;Holozoa;Choanozoa;Metazoa;Porifera;Homoscleromorpha;Homosclerophorida;";"100.0";"14.4";"20";"20";"20";"0";"0";"457163";"391187"
"V4mis2";"SILVA (only NR);Eukaryota;Amorphea;Obazoa;Opisthokonta;Nucletmycea;";"20.1";"13.1";"9451";"9398";"1892";"7506";"53";"447785";"389315"
"V4mis2";"SILVA (only NR);Eukaryota;Amorphea;Obazoa;Opisthokonta;Nucletmycea;Aphelidea;";"77.6";"14.4";"49";"49";"38";"11";"0";"457134";"391169"
"V4mis2";"SILVA (only NR);Eukaryota;Amorphea;Obazoa;Opisthokonta;Nucletmycea;Aphelidea;Aphelidium;";"44.4";"14.4";"9";"9";"4";"5";"0";"457174";"391203"
"V4mis2";"SILVA (only NR);Eukaryota;Amorphea;Obazoa;Opisthokonta;Nucletmycea;Aphelidea;Paraphelidium;";"100.0";"14.4";"11";"11";"11";"0";"0";"457172";"391196"
"V4mis2";"SILVA (only NR);Eukaryota;Amorphea;Obazoa;Opisthokonta;Nucletmycea;Aphelidea;uncultured;";"84.0";"14.4";"25";"25";"21";"4";"0";"457158";"391186"
"V4mis2";"SILVA (only NR);Eukaryota;Amorphea;Obazoa;Opisthokonta;Nucletmycea;Fungi;";"19.9";"13.1";"9373";"9321";"1854";"7467";"52";"447862";"389353"
"V4mis2";"SILVA (only NR);Eukaryota;Amorphea;Obazoa;Opisthokonta;Nucletmycea;Fungi;Blastocladiomycota;";"97.0";"14.4";"33";"33";"32";"1";"0";"457150";"391175"
"V4mis2";"SILVA (only NR);Eukaryota;Amorphea;Obazoa;Opisthokonta;Nucletmycea;Fungi;Blastocladiomycota;Incertae Sedis;";"97.0";"14.4";"33";"33";"32";"1";"0";"457150";"391175"
"V4mis2";"SILVA (only NR);Eukaryota;Amorphea;Obazoa;Opisthokonta;Nucletmycea;Fungi;Blastocladiomycota;Incertae Sedis;Blastocladiomycetes;";"97.0";"14.4";"33";"33";"32";"1";"0";"457150";"391175"
"V4mis2";"SILVA (only NR);Eukaryota;Amorphea;Obazoa;Opisthokonta;Nucletmycea;Fungi;Blastocladiomycota;Incertae Sedis;Blastocladiomycetes;Blastocladiales;";"97.0";"14.4";"33";"33";"32";"1";"0";"457150";"391175"
"V4mis2";"SILVA (only NR);Eukaryota;Amorphea;Obazoa;Opisthokonta;Nucletmycea;Fungi;Blastocladiomycota;Incertae Sedis;Blastocladiomycetes;Blastocladiales;Blastocladiaceae;";"100.0";"14.4";"19";"19";"19";"0";"0";"457164";"391188"
"V4mis2";"SILVA (only NR);Eukaryota;Amorphea;Obazoa;Opisthokonta;Nucletmycea;Fungi;Blastocladiomycota;Incertae Sedis;Blastocladiomycetes;Blastocladiales;Blastocladiaceae;Allomyces;";"100.0";"14.4";"10";"10";"10";"0";"0";"457173";"391197"
"V4mis2";"SILVA (only NR);Eukaryota;Amorphea;Obazoa;Opisthokonta;Nucletmycea;Fungi;Blastocladiomycota;Incertae Sedis;Blastocladiomycetes;Blastocladiales;Blastocladiaceae;Blastocladia;";"100.0";"14.4";"4";"4";"4";"0";"0";"457179";"391203"
"V4mis2";"SILVA (only NR);Eukaryota;Amorphea;Obazoa;Opisthokonta;Nucletmycea;Fungi;Blastocladiomycota;Incertae Sedis;Blastocladiomycetes;Blastocladiales;Blastocladiaceae;Blastocladiella;";"100.0";"14.4";"4";"4";"4";"0";"0";"457179";"391203"
"V4mis2";"SILVA (only NR);Eukaryota;Amorphea;Obazoa;Opisthokonta;Nucletmycea;Fungi;Blastocladiomycota;Incertae Sedis;Blastocladiomycetes;Blastocladiales;Blastocladiaceae;Microallomyces;";"100.0";"14.4";"1";"1";"1";"0";"0";"457182";"391206"
"V4mis2";"SILVA (only NR);Eukaryota;Amorphea;Obazoa;Opisthokonta;Nucletmycea;Fungi;Blastocladiomycota;Incertae Sedis;Blastocladiomycetes;Blastocladiales;Catenaria;";"100.0";"14.4";"6";"6";"6";"0";"0";"457177";"391201"
"V4mis2";"SILVA (only NR);Eukaryota;Amorphea;Obazoa;Opisthokonta;Nucletmycea;Fungi;Blastocladiomycota;Incertae Sedis;Blastocladiomycetes;Blastocladiales;Coelomomyces;";"0.0";"0";"1";"1";"0";"1";"0";"457182";"391207"
"V4mis2";"SILVA (only NR);Eukaryota;Amorphea;Obazoa;Opisthokonta;Nucletmycea;Fungi;Blastocladiomycota;Incertae Sedis;Blastocladiomycetes;Blastocladiales;Physodermataceae;";"100.0";"14.4";"6";"6";"6";"0";"0";"457177";"391201"
"V4mis2";"SILVA (only NR);Eukaryota;Amorphea;Obazoa;Opisthokonta;Nucletmycea;Fungi;Blastocladiomycota;Incertae Sedis;Blastocladiomycetes;Blastocladiales;Physodermataceae;Paraphysoderma;";"100.0";"14.4";"1";"1";"1";"0";"0";"457182";"391206"
"V4mis2";"SILVA (only NR);Eukaryota;Amorphea;Obazoa;Opisthokonta;Nucletmycea;Fungi;Blastocladiomycota;Incertae Sedis;Blastocladiomycetes;Blastocladiales;Physodermataceae;Physoderma;";"100.0";"14.4";"3";"3";"3";"0";"0";"457180";"391204"
"V4mis2";"SILVA (only NR);Eukaryota;Amorphea;Obazoa;Opisthokonta;Nucletmycea;Fungi;Blastocladiomycota;Incertae Sedis;Blastocladiomycetes;Blastocladiales;Physodermataceae;Urophlyctis;";"100.0";"14.4";"1";"1";"1";"0";"0";"457182";"391206"
"V4mis2";"SILVA (only NR);Eukaryota;Amorphea;Obazoa;Opisthokonta;Nucletmycea;Fungi;Chytridiomycota;";"23.2";"14.4";"319";"315";"73";"242";"4";"456868";"391134"
"V4mis2";"SILVA (only NR);Eukaryota;Amorphea;Obazoa;Opisthokonta;Nucletmycea;Fungi;Chytridiomycota;Incertae Sedis;";"23.2";"14.4";"319";"315";"73";"242";"4";"456868";"391134"
"V4mis2";"SILVA (only NR);Eukaryota;Amorphea;Obazoa;Opisthokonta;Nucletmycea;Fungi;Chytridiomycota;Incertae Sedis;Chytridiomycetes;";"22.5";"14.4";"306";"302";"68";"234";"4";"456881";"391139"
"V4mis2";"SILVA (only NR);Eukaryota;Amorphea;Obazoa;Opisthokonta;Nucletmycea;Fungi;Chytridiomycota;Incertae Sedis;Chytridiomycetes;Chytridiales;";"37.9";"14.4";"30";"29";"11";"18";"1";"457154";"391196"
"V4mis2";"SILVA (only NR);Eukaryota;Amorphea;Obazoa;Opisthokonta;Nucletmycea;Fungi;Chytridiomycota;Incertae Sedis;Chytridiomycetes;Chytridiales;Chytridiaceae;";"0.0";"0";"10";"10";"0";"10";"0";"457173";"391207"
"V4mis2";"SILVA (only NR);Eukaryota;Amorphea;Obazoa;Opisthokonta;Nucletmycea;Fungi;Chytridiomycota;Incertae Sedis;Chytridiomycetes;Chytridiales;Chytridiaceae;Chytridium;";"0.0";"0";"1";"1";"0";"1";"0";"457182";"391207"
"V4mis2";"SILVA (only NR);Eukaryota;Amorphea;Obazoa;Opisthokonta;Nucletmycea;Fungi;Chytridiomycota;Incertae Sedis;Chytridiomycetes;Chytridiales;Chytridiaceae;Dendrochytridium;";"0.0";"0";"2";"2";"0";"2";"0";"457181";"391207"
"V4mis2";"SILVA (only NR);Eukaryota;Amorphea;Obazoa;Opisthokonta;Nucletmycea;Fungi;Chytridiomycota;Incertae Sedis;Chytridiomycetes;Chytridiales;Chytridiaceae;uncultured;";"0.0";"0";"7";"7";"0";"7";"0";"457176";"391207"
"V4mis2";"SILVA (only NR);Eukaryota;Amorphea;Obazoa;Opisthokonta;Nucletmycea;Fungi;Chytridiomycota;Incertae Sedis;Chytridiomycetes;Chytridiales;Chytriomycetaceae;";"81.8";"14.4";"12";"11";"9";"2";"1";"457172";"391198"
"V4mis2";"SILVA (only NR);Eukaryota;Amorphea;Obazoa;Opisthokonta;Nucletmycea;Fungi;Chytridiomycota;Incertae Sedis;Chytridiomycetes;Chytridiales;Chytriomycetaceae;Chytriomyces;";"100.0";"14.4";"2";"2";"2";"0";"0";"457181";"391205"
"V4mis2";"SILVA (only NR);Eukaryota;Amorphea;Obazoa;Opisthokonta;Nucletmycea;Fungi;Chytridiomycota;Incertae Sedis;Chytridiomycetes;Chytridiales;Chytriomycetaceae;Entophlyctis;";"100.0";"14.4";"1";"1";"1";"0";"0";"457182";"391206"
"V4mis2";"SILVA (only NR);Eukaryota;Amorphea;Obazoa;Opisthokonta;Nucletmycea;Fungi;Chytridiomycota;Incertae Sedis;Chytridiomycetes;Chytridiales;Chytriomycetaceae;Rhizoclosmatium;";"100.0";"14.4";"3";"2";"2";"0";"1";"457181";"391205"
"V4mis2";"SILVA (only NR);Eukaryota;Amorphea;Obazoa;Opisthokonta;Nucletmycea;Fungi;Chytridiomycota;Incertae Sedis;Chytridiomycetes;Chytridiales;Incertae Sedis;";"25.0";"14.4";"8";"8";"2";"6";"0";"457175";"391205"
"V4mis2";"SILVA (only NR);Eukaryota;Amorphea;Obazoa;Opisthokonta;Nucletmycea;Fungi;Chytridiomycota;Incertae Sedis;Chytridiomycetes;Chytridiales;Incertae Sedis;Pseudorhizidium;";"100.0";"14.4";"1";"1";"1";"0";"0";"457182";"391206"
"V4mis2";"SILVA (only NR);Eukaryota;Amorphea;Obazoa;Opisthokonta;Nucletmycea;Fungi;Chytridiomycota;Incertae Sedis;Chytridiomycetes;Chytridiales;Incertae Sedis;Zygorhizidium;";"0.0";"0";"2";"2";"0";"2";"0";"457181";"391207"
"V4mis2";"SILVA (only NR);Eukaryota;Amorphea;Obazoa;Opisthokonta;Nucletmycea;Fungi;Chytridiomycota;Incertae Sedis;Chytridiomycetes;Cladochytriales;";"10.0";"14.4";"10";"10";"1";"9";"0";"457173";"391206"
"V4mis2";"SILVA (only NR);Eukaryota;Amorphea;Obazoa;Opisthokonta;Nucletmycea;Fungi;Chytridiomycota;Incertae Sedis;Chytridiomycetes;Cladochytriales;Cladochytriaceae;";"33.3";"14.4";"3";"3";"1";"2";"0";"457180";"391206"
"V4mis2";"SILVA (only NR);Eukaryota;Amorphea;Obazoa;Opisthokonta;Nucletmycea;Fungi;Chytridiomycota;Incertae Sedis;Chytridiomycetes;Cladochytriales;Cladochytriaceae;Cladochytrium;";"33.3";"14.4";"3";"3";"1";"2";"0";"457180";"391206"
"V4mis2";"SILVA (only NR);Eukaryota;Amorphea;Obazoa;Opisthokonta;Nucletmycea;Fungi;Chytridiomycota;Incertae Sedis;Chytridiomycetes;Cladochytriales;Nowakowskiellaceae;";"0.0";"0";"7";"7";"0";"7";"0";"457176";"391207"
"V4mis2";"SILVA (only NR);Eukaryota;Amorphea;Obazoa;Opisthokonta;Nucletmycea;Fungi;Chytridiomycota;Incertae Sedis;Chytridiomycetes;Cladochytriales;Nowakowskiellaceae;Nowakowskiella;";"0.0";"0";"7";"7";"0";"7";"0";"457176";"391207"
"V4mis2";"SILVA (only NR);Eukaryota;Amorphea;Obazoa;Opisthokonta;Nucletmycea;Fungi;Chytridiomycota;Incertae Sedis;Chytridiomycetes;Gromochytriales;";"90.9";"14.4";"22";"22";"20";"2";"0";"457161";"391187"
"V4mis2";"SILVA (only NR);Eukaryota;Amorphea;Obazoa;Opisthokonta;Nucletmycea;Fungi;Chytridiomycota;Incertae Sedis;Chytridiomycetes;Gromochytriales;Gromochytriaceae;";"90.9";"14.4";"22";"22";"20";"2";"0";"457161";"391187"
"V4mis2";"SILVA (only NR);Eukaryota;Amorphea;Obazoa;Opisthokonta;Nucletmycea;Fungi;Chytridiomycota;Incertae Sedis;Chytridiomycetes;Gromochytriales;Gromochytriaceae;Gromochytrium;";"100.0";"14.4";"1";"1";"1";"0";"0";"457182";"391206"
"V4mis2";"SILVA (only NR);Eukaryota;Amorphea;Obazoa;Opisthokonta;Nucletmycea;Fungi;Chytridiomycota;Incertae Sedis;Chytridiomycetes;Gromochytriales;Gromochytriaceae;uncultured;";"89.5";"14.4";"19";"19";"17";"2";"0";"457164";"391190"
"V4mis2";"SILVA (only NR);Eukaryota;Amorphea;Obazoa;Opisthokonta;Nucletmycea;Fungi;Chytridiomycota;Incertae Sedis;Chytridiomycetes;Incertae Sedis;";"0.0";"0";"19";"18";"0";"18";"1";"457165";"391207"
"V4mis2";"SILVA (only NR);Eukaryota;Amorphea;Obazoa;Opisthokonta;Nucletmycea;Fungi;Chytridiomycota;Incertae Sedis;Chytridiomycetes;Incertae Sedis;Incertae Sedis;";"0.0";"0";"5";"5";"0";"5";"0";"457178";"391207"
"V4mis2";"SILVA (only NR);Eukaryota;Amorphea;Obazoa;Opisthokonta;Nucletmycea;Fungi;Chytridiomycota;Incertae Sedis;Chytridiomycetes;Incertae Sedis;Incertae Sedis;Blyttiomyces;";"0.0";"0";"1";"1";"0";"1";"0";"457182";"391207"
"V4mis2";"SILVA (only NR);Eukaryota;Amorphea;Obazoa;Opisthokonta;Nucletmycea;Fungi;Chytridiomycota;Incertae Sedis;Chytridiomycetes;Incertae Sedis;Incertae Sedis;Catenomyces;";"0.0";"0";"2";"2";"0";"2";"0";"457181";"391207"
"V4mis2";"SILVA (only NR);Eukaryota;Amorphea;Obazoa;Opisthokonta;Nucletmycea;Fungi;Chytridiomycota;Incertae Sedis;Chytridiomycetes;Incertae Sedis;Synchytriaceae;";"0.0";"0";"14";"13";"0";"13";"1";"457170";"391207"
"V4mis2";"SILVA (only NR);Eukaryota;Amorphea;Obazoa;Opisthokonta;Nucletmycea;Fungi;Chytridiomycota;Incertae Sedis;Chytridiomycetes;Incertae Sedis;Synchytriaceae;Synchytrium;";"0.0";"0";"14";"13";"0";"13";"1";"457170";"391207"
"V4mis2";"SILVA (only NR);Eukaryota;Amorphea;Obazoa;Opisthokonta;Nucletmycea;Fungi;Chytridiomycota;Incertae Sedis;Chytridiomycetes;Lobulomycetales;";"0.0";"0";"33";"32";"0";"32";"1";"457151";"391207"
"V4mis2";"SILVA (only NR);Eukaryota;Amorphea;Obazoa;Opisthokonta;Nucletmycea;Fungi;Chytridiomycota;Incertae Sedis;Chytridiomycetes;Lobulomycetales;Lobulomycetaceae;";"0.0";"0";"33";"32";"0";"32";"1";"457151";"391207"
"V4mis2";"SILVA (only NR);Eukaryota;Amorphea;Obazoa;Opisthokonta;Nucletmycea;Fungi;Chytridiomycota;Incertae Sedis;Chytridiomycetes;Lobulomycetales;Lobulomycetaceae;Clydaea;";"0.0";"0";"1";"1";"0";"1";"0";"457182";"391207"
"V4mis2";"SILVA (only NR);Eukaryota;Amorphea;Obazoa;Opisthokonta;Nucletmycea;Fungi;Chytridiomycota;Incertae Sedis;Chytridiomycetes;Lobulomycetales;Lobulomycetaceae;Lobulomyces;";"0.0";"0";"3";"3";"0";"3";"0";"457180";"391207"
"V4mis2";"SILVA (only NR);Eukaryota;Amorphea;Obazoa;Opisthokonta;Nucletmycea;Fungi;Chytridiomycota;Incertae Sedis;Chytridiomycetes;Lobulomycetales;Lobulomycetaceae;uncultured;";"0.0";"0";"24";"23";"0";"23";"1";"457160";"391207"
"V4mis2";"SILVA (only NR);Eukaryota;Amorphea;Obazoa;Opisthokonta;Nucletmycea;Fungi;Chytridiomycota;Incertae Sedis;Chytridiomycetes;Polychytriales;";"0.0";"0";"12";"12";"0";"12";"0";"457171";"391207"
"V4mis2";"SILVA (only NR);Eukaryota;Amorphea;Obazoa;Opisthokonta;Nucletmycea;Fungi;Chytridiomycota;Incertae Sedis;Chytridiomycetes;Polychytriales;Incertae Sedis;";"0.0";"0";"12";"12";"0";"12";"0";"457171";"391207"
"V4mis2";"SILVA (only NR);Eukaryota;Amorphea;Obazoa;Opisthokonta;Nucletmycea;Fungi;Chytridiomycota;Incertae Sedis;Chytridiomycetes;Polychytriales;Incertae Sedis;Arkaya;";"0.0";"0";"3";"3";"0";"3";"0";"457180";"391207"
"V4mis2";"SILVA (only NR);Eukaryota;Amorphea;Obazoa;Opisthokonta;Nucletmycea;Fungi;Chytridiomycota;Incertae Sedis;Chytridiomycetes;Polychytriales;Incertae Sedis;Karlingiomyces;";"0.0";"0";"2";"2";"0";"2";"0";"457181";"391207"
"V4mis2";"SILVA (only NR);Eukaryota;Amorphea;Obazoa;Opisthokonta;Nucletmycea;Fungi;Chytridiomycota;Incertae Sedis;Chytridiomycetes;Polychytriales;Incertae Sedis;Neokarlingia;";"0.0";"0";"1";"1";"0";"1";"0";"457182";"391207"
"V4mis2";"SILVA (only NR);Eukaryota;Amorphea;Obazoa;Opisthokonta;Nucletmycea;Fungi;Chytridiomycota;Incertae Sedis;Chytridiomycetes;Polychytriales;Incertae Sedis;Polychytrium;";"0.0";"0";"1";"1";"0";"1";"0";"457182";"391207"
"V4mis2";"SILVA (only NR);Eukaryota;Amorphea;Obazoa;Opisthokonta;Nucletmycea;Fungi;Chytridiomycota;Incertae Sedis;Chytridiomycetes;Polychytriales;Incertae Sedis;Polytrychium;";"0.0";"0";"2";"2";"0";"2";"0";"457181";"391207"
"V4mis2";"SILVA (only NR);Eukaryota;Amorphea;Obazoa;Opisthokonta;Nucletmycea;Fungi;Chytridiomycota;Incertae Sedis;Chytridiomycetes;Rhizophlyctidales;";"0.0";"0";"3";"3";"0";"3";"0";"457180";"391207"
"V4mis2";"SILVA (only NR);Eukaryota;Amorphea;Obazoa;Opisthokonta;Nucletmycea;Fungi;Chytridiomycota;Incertae Sedis;Chytridiomycetes;Rhizophlyctidales;Rhizophlyctidaceae;";"0.0";"0";"3";"3";"0";"3";"0";"457180";"391207"
"V4mis2";"SILVA (only NR);Eukaryota;Amorphea;Obazoa;Opisthokonta;Nucletmycea;Fungi;Chytridiomycota;Incertae Sedis;Chytridiomycetes;Rhizophlyctidales;Rhizophlyctidaceae;Rhizophlyctis;";"0.0";"0";"3";"3";"0";"3";"0";"457180";"391207"
"V4mis2";"SILVA (only NR);Eukaryota;Amorphea;Obazoa;Opisthokonta;Nucletmycea;Fungi;Chytridiomycota;Incertae Sedis;Chytridiomycetes;Rhizophydiales;";"31.9";"14.4";"95";"94";"30";"64";"1";"457089";"391177"
"V4mis2";"SILVA (only NR);Eukaryota;Amorphea;Obazoa;Opisthokonta;Nucletmycea;Fungi;Chytridiomycota;Incertae Sedis;Chytridiomycetes;Rhizophydiales;Boothiomyces;";"0.0";"0";"1";"1";"0";"1";"0";"457182";"391207"
"V4mis2";"SILVA (only NR);Eukaryota;Amorphea;Obazoa;Opisthokonta;Nucletmycea;Fungi;Chytridiomycota;Incertae Sedis;Chytridiomycetes;Rhizophydiales;Incertae Sedis;";"100.0";"14.4";"21";"21";"21";"0";"0";"457162";"391186"
"V4mis2";"SILVA (only NR);Eukaryota;Amorphea;Obazoa;Opisthokonta;Nucletmycea;Fungi;Chytridiomycota;Incertae Sedis;Chytridiomycetes;Rhizophydiales;Incertae Sedis;Batrachochytrium;";"100.0";"14.4";"20";"20";"20";"0";"0";"457163";"391187"
"V4mis2";"SILVA (only NR);Eukaryota;Amorphea;Obazoa;Opisthokonta;Nucletmycea;Fungi;Chytridiomycota;Incertae Sedis;Chytridiomycetes;Rhizophydiales;Kappamycetaceae;";"18.8";"14.4";"16";"16";"3";"13";"0";"457167";"391204"
"V4mis2";"SILVA (only NR);Eukaryota;Amorphea;Obazoa;Opisthokonta;Nucletmycea;Fungi;Chytridiomycota;Incertae Sedis;Chytridiomycetes;Rhizophydiales;Kappamycetaceae;Kappamyces;";"0.0";"0";"1";"1";"0";"1";"0";"457182";"391207"
"V4mis2";"SILVA (only NR);Eukaryota;Amorphea;Obazoa;Opisthokonta;Nucletmycea;Fungi;Chytridiomycota;Incertae Sedis;Chytridiomycetes;Rhizophydiales;Rhizophydiaceae;";"28.6";"14.4";"22";"21";"6";"15";"1";"457162";"391201"
"V4mis2";"SILVA (only NR);Eukaryota;Amorphea;Obazoa;Opisthokonta;Nucletmycea;Fungi;Chytridiomycota;Incertae Sedis;Chytridiomycetes;Rhizophydiales;Rhizophydiaceae;Rhizophydium;";"50.0";"14.4";"13";"12";"6";"6";"1";"457171";"391201"
"V4mis2";"SILVA (only NR);Eukaryota;Amorphea;Obazoa;Opisthokonta;Nucletmycea;Fungi;Chytridiomycota;Incertae Sedis;Chytridiomycetes;Rhizophydiales;uncultured;";"0.0";"0";"30";"30";"0";"30";"0";"457153";"391207"
"V4mis2";"SILVA (only NR);Eukaryota;Amorphea;Obazoa;Opisthokonta;Nucletmycea;Fungi;Chytridiomycota;Incertae Sedis;Chytridiomycetes;Spizellomycetales;";"4.9";"14.4";"41";"41";"2";"39";"0";"457142";"391205"
"V4mis2";"SILVA (only NR);Eukaryota;Amorphea;Obazoa;Opisthokonta;Nucletmycea;Fungi;Chytridiomycota;Incertae Sedis;Chytridiomycetes;Spizellomycetales;Olpidiaceae;";"0.0";"0";"6";"6";"0";"6";"0";"457177";"391207"
"V4mis2";"SILVA (only NR);Eukaryota;Amorphea;Obazoa;Opisthokonta;Nucletmycea;Fungi;Chytridiomycota;Incertae Sedis;Chytridiomycetes;Spizellomycetales;Olpidiaceae;Olpidium;";"0.0";"0";"6";"6";"0";"6";"0";"457177";"391207"
"V4mis2";"SILVA (only NR);Eukaryota;Amorphea;Obazoa;Opisthokonta;Nucletmycea;Fungi;Chytridiomycota;Incertae Sedis;Chytridiomycetes;Spizellomycetales;Powellomycetaceae;";"0.0";"0";"24";"24";"0";"24";"0";"457159";"391207"
"V4mis2";"SILVA (only NR);Eukaryota;Amorphea;Obazoa;Opisthokonta;Nucletmycea;Fungi;Chytridiomycota;Incertae Sedis;Chytridiomycetes;Spizellomycetales;Powellomycetaceae;Geranomyces;";"0.0";"0";"17";"17";"0";"17";"0";"457166";"391207"
"V4mis2";"SILVA (only NR);Eukaryota;Amorphea;Obazoa;Opisthokonta;Nucletmycea;Fungi;Chytridiomycota;Incertae Sedis;Chytridiomycetes;Spizellomycetales;Spizellomycetaceae;";"14.3";"14.4";"7";"7";"1";"6";"0";"457176";"391206"
"V4mis2";"SILVA (only NR);Eukaryota;Amorphea;Obazoa;Opisthokonta;Nucletmycea;Fungi;Chytridiomycota;Incertae Sedis;Chytridiomycetes;Spizellomycetales;Spizellomycetaceae;Gaertneriomyces;";"0.0";"0";"1";"1";"0";"1";"0";"457182";"391207"
"V4mis2";"SILVA (only NR);Eukaryota;Amorphea;Obazoa;Opisthokonta;Nucletmycea;Fungi;Chytridiomycota;Incertae Sedis;Chytridiomycetes;Spizellomycetales;Spizellomycetaceae;Phlyctochytrium;";"0.0";"0";"2";"2";"0";"2";"0";"457181";"391207"
"V4mis2";"SILVA (only NR);Eukaryota;Amorphea;Obazoa;Opisthokonta;Nucletmycea;Fungi;Chytridiomycota;Incertae Sedis;Chytridiomycetes;Spizellomycetales;Spizellomycetaceae;Spizellomyces;";"33.3";"14.4";"3";"3";"1";"2";"0";"457180";"391206"
"V4mis2";"SILVA (only NR);Eukaryota;Amorphea;Obazoa;Opisthokonta;Nucletmycea;Fungi;Chytridiomycota;Incertae Sedis;Chytridiomycetes;Spizellomycetales;uncultured;";"25.0";"14.4";"4";"4";"1";"3";"0";"457179";"391206"
"V4mis2";"SILVA (only NR);Eukaryota;Amorphea;Obazoa;Opisthokonta;Nucletmycea;Fungi;Chytridiomycota;Incertae Sedis;Chytridiomycetes;uncultured;";"3.7";"14.4";"27";"27";"1";"26";"0";"457156";"391206"
"V4mis2";"SILVA (only NR);Eukaryota;Amorphea;Obazoa;Opisthokonta;Nucletmycea;Fungi;Chytridiomycota;Incertae Sedis;Monoblepharidomycetes;";"38.5";"14.4";"13";"13";"5";"8";"0";"457170";"391202"
"V4mis2";"SILVA (only NR);Eukaryota;Amorphea;Obazoa;Opisthokonta;Nucletmycea;Fungi;Chytridiomycota;Incertae Sedis;Monoblepharidomycetes;Monoblepharidales;";"38.5";"14.4";"13";"13";"5";"8";"0";"457170";"391202"
"V4mis2";"SILVA (only NR);Eukaryota;Amorphea;Obazoa;Opisthokonta;Nucletmycea;Fungi;Chytridiomycota;Incertae Sedis;Monoblepharidomycetes;Monoblepharidales;Gonapodyaceae;";"0.0";"0";"4";"4";"0";"4";"0";"457179";"391207"
"V4mis2";"SILVA (only NR);Eukaryota;Amorphea;Obazoa;Opisthokonta;Nucletmycea;Fungi;Chytridiomycota;Incertae Sedis;Monoblepharidomycetes;Monoblepharidales;Gonapodyaceae;Gonapodya;";"0.0";"0";"4";"4";"0";"4";"0";"457179";"391207"
"V4mis2";"SILVA (only NR);Eukaryota;Amorphea;Obazoa;Opisthokonta;Nucletmycea;Fungi;Chytridiomycota;Incertae Sedis;Monoblepharidomycetes;Monoblepharidales;Harpochytriaceae;";"0.0";"0";"2";"2";"0";"2";"0";"457181";"391207"
"V4mis2";"SILVA (only NR);Eukaryota;Amorphea;Obazoa;Opisthokonta;Nucletmycea;Fungi;Chytridiomycota;Incertae Sedis;Monoblepharidomycetes;Monoblepharidales;Harpochytriaceae;Harpochytrium;";"0.0";"0";"2";"2";"0";"2";"0";"457181";"391207"
"V4mis2";"SILVA (only NR);Eukaryota;Amorphea;Obazoa;Opisthokonta;Nucletmycea;Fungi;Chytridiomycota;Incertae Sedis;Monoblepharidomycetes;Monoblepharidales;Hyaloraphidium;";"100.0";"14.4";"1";"1";"1";"0";"0";"457182";"391206"
"V4mis2";"SILVA (only NR);Eukaryota;Amorphea;Obazoa;Opisthokonta;Nucletmycea;Fungi;Chytridiomycota;Incertae Sedis;Monoblepharidomycetes;Monoblepharidales;Monoblepharidaceae;";"0.0";"0";"2";"2";"0";"2";"0";"457181";"391207"
"V4mis2";"SILVA (only NR);Eukaryota;Amorphea;Obazoa;Opisthokonta;Nucletmycea;Fungi;Chytridiomycota;Incertae Sedis;Monoblepharidomycetes;Monoblepharidales;Monoblepharidaceae;Monoblepharella;";"0.0";"0";"2";"2";"0";"2";"0";"457181";"391207"
"V4mis2";"SILVA (only NR);Eukaryota;Amorphea;Obazoa;Opisthokonta;Nucletmycea;Fungi;Cryptomycota;";"57.3";"14.4";"213";"213";"122";"91";"0";"456970";"391085"
"V4mis2";"SILVA (only NR);Eukaryota;Amorphea;Obazoa;Opisthokonta;Nucletmycea;Fungi;Cryptomycota;Incertae Sedis;";"28.6";"14.4";"49";"49";"14";"35";"0";"457134";"391193"
"V4mis2";"SILVA (only NR);Eukaryota;Amorphea;Obazoa;Opisthokonta;Nucletmycea;Fungi;Cryptomycota;Incertae Sedis;Incertae Sedis;";"28.6";"14.4";"49";"49";"14";"35";"0";"457134";"391193"
"V4mis2";"SILVA (only NR);Eukaryota;Amorphea;Obazoa;Opisthokonta;Nucletmycea;Fungi;Cryptomycota;Incertae Sedis;Incertae Sedis;Incertae Sedis;";"28.6";"14.4";"49";"49";"14";"35";"0";"457134";"391193"
"V4mis2";"SILVA (only NR);Eukaryota;Amorphea;Obazoa;Opisthokonta;Nucletmycea;Fungi;Cryptomycota;Incertae Sedis;Incertae Sedis;Incertae Sedis;Incertae Sedis;";"28.6";"14.4";"49";"49";"14";"35";"0";"457134";"391193"
"V4mis2";"SILVA (only NR);Eukaryota;Amorphea;Obazoa;Opisthokonta;Nucletmycea;Fungi;Cryptomycota;Incertae Sedis;Incertae Sedis;Incertae Sedis;Incertae Sedis;Nucleophaga;";"0.0";"0";"2";"2";"0";"2";"0";"457181";"391207"
"V4mis2";"SILVA (only NR);Eukaryota;Amorphea;Obazoa;Opisthokonta;Nucletmycea;Fungi;Cryptomycota;Incertae Sedis;Incertae Sedis;Incertae Sedis;Incertae Sedis;Paramicrosporidium;";"3.1";"14.4";"32";"32";"1";"31";"0";"457151";"391206"
"V4mis2";"SILVA (only NR);Eukaryota;Amorphea;Obazoa;Opisthokonta;Nucletmycea;Fungi;Cryptomycota;Incertae Sedis;Incertae Sedis;Incertae Sedis;Incertae Sedis;Rozella;";"86.7";"14.4";"15";"15";"13";"2";"0";"457168";"391194"
"V4mis2";"SILVA (only NR);Eukaryota;Amorphea;Obazoa;Opisthokonta;Nucletmycea;Fungi;Cryptomycota;LKM11;";"79.7";"14.4";"123";"123";"98";"25";"0";"457060";"391109"
"V4mis2";"SILVA (only NR);Eukaryota;Amorphea;Obazoa;Opisthokonta;Nucletmycea;Fungi;Cryptomycota;uncultured;";"23.1";"14.4";"39";"39";"9";"30";"0";"457144";"391198"
"V4mis2";"SILVA (only NR);Eukaryota;Amorphea;Obazoa;Opisthokonta;Nucletmycea;Fungi;Dikarya;";"15.6";"13.2";"7696";"7659";"1195";"6464";"37";"449524";"390012"
"V4mis2";"SILVA (only NR);Eukaryota;Amorphea;Obazoa;Opisthokonta;Nucletmycea;Fungi;Dikarya;Ascomycota;";"1.1";"13.5";"5156";"5136";"55";"5081";"20";"452047";"391152"
"V4mis2";"SILVA (only NR);Eukaryota;Amorphea;Obazoa;Opisthokonta;Nucletmycea;Fungi;Dikarya;Ascomycota;Incertae Sedis;";"0.0";"0";"3";"3";"0";"3";"0";"457180";"391207"
"V4mis2";"SILVA (only NR);Eukaryota;Amorphea;Obazoa;Opisthokonta;Nucletmycea;Fungi;Dikarya;Ascomycota;Incertae Sedis;Incertae Sedis;";"0.0";"0";"3";"3";"0";"3";"0";"457180";"391207"
"V4mis2";"SILVA (only NR);Eukaryota;Amorphea;Obazoa;Opisthokonta;Nucletmycea;Fungi;Dikarya;Ascomycota;Incertae Sedis;Incertae Sedis;Incertae Sedis;";"0.0";"0";"3";"3";"0";"3";"0";"457180";"391207"
"V4mis2";"SILVA (only NR);Eukaryota;Amorphea;Obazoa;Opisthokonta;Nucletmycea;Fungi;Dikarya;Ascomycota;Incertae Sedis;Incertae Sedis;Incertae Sedis;Incertae Sedis;";"0.0";"0";"3";"3";"0";"3";"0";"457180";"391207"
"V4mis2";"SILVA (only NR);Eukaryota;Amorphea;Obazoa;Opisthokonta;Nucletmycea;Fungi;Dikarya;Ascomycota;Incertae Sedis;Incertae Sedis;Incertae Sedis;Incertae Sedis;Calcarisporiella;";"0.0";"0";"3";"3";"0";"3";"0";"457180";"391207"
"V4mis2";"SILVA (only NR);Eukaryota;Amorphea;Obazoa;Opisthokonta;Nucletmycea;Fungi;Dikarya;Ascomycota;Pezizomycotina;";"0.7";"13.7";"3667";"3650";"27";"3623";"17";"453533";"391180"
"V4mis2";"SILVA (only NR);Eukaryota;Amorphea;Obazoa;Opisthokonta;Nucletmycea;Fungi;Dikarya;Ascomycota;Pezizomycotina;Arthoniomycetes;";"0.0";"0";"13";"13";"0";"13";"0";"457170";"391207"
"V4mis2";"SILVA (only NR);Eukaryota;Amorphea;Obazoa;Opisthokonta;Nucletmycea;Fungi;Dikarya;Ascomycota;Pezizomycotina;Arthoniomycetes;Arthoniales;";"0.0";"0";"8";"8";"0";"8";"0";"457175";"391207"
"V4mis2";"SILVA (only NR);Eukaryota;Amorphea;Obazoa;Opisthokonta;Nucletmycea;Fungi;Dikarya;Ascomycota;Pezizomycotina;Arthoniomycetes;Arthoniales;Opegrapha;";"0.0";"0";"1";"1";"0";"1";"0";"457182";"391207"
"V4mis2";"SILVA (only NR);Eukaryota;Amorphea;Obazoa;Opisthokonta;Nucletmycea;Fungi;Dikarya;Ascomycota;Pezizomycotina;Arthoniomycetes;Arthoniales;Roccellaceae;";"0.0";"0";"4";"4";"0";"4";"0";"457179";"391207"
"V4mis2";"SILVA (only NR);Eukaryota;Amorphea;Obazoa;Opisthokonta;Nucletmycea;Fungi;Dikarya;Ascomycota;Pezizomycotina;Arthoniomycetes;Arthoniales;Roccellaceae;Combea;";"0.0";"0";"1";"1";"0";"1";"0";"457182";"391207"
"V4mis2";"SILVA (only NR);Eukaryota;Amorphea;Obazoa;Opisthokonta;Nucletmycea;Fungi;Dikarya;Ascomycota;Pezizomycotina;Arthoniomycetes;Arthoniales;Roccellaceae;Dendrographa;";"0.0";"0";"1";"1";"0";"1";"0";"457182";"391207"
"V4mis2";"SILVA (only NR);Eukaryota;Amorphea;Obazoa;Opisthokonta;Nucletmycea;Fungi;Dikarya;Ascomycota;Pezizomycotina;Arthoniomycetes;Arthoniales;Roccellaceae;Lecanactis;";"0.0";"0";"1";"1";"0";"1";"0";"457182";"391207"
"V4mis2";"SILVA (only NR);Eukaryota;Amorphea;Obazoa;Opisthokonta;Nucletmycea;Fungi;Dikarya;Ascomycota;Pezizomycotina;Arthoniomycetes;Arthoniales;Roccellaceae;Roccella;";"0.0";"0";"1";"1";"0";"1";"0";"457182";"391207"
"V4mis2";"SILVA (only NR);Eukaryota;Amorphea;Obazoa;Opisthokonta;Nucletmycea;Fungi;Dikarya;Ascomycota;Pezizomycotina;Arthoniomycetes;Arthoniales;Roccellographa;";"0.0";"0";"1";"1";"0";"1";"0";"457182";"391207"
"V4mis2";"SILVA (only NR);Eukaryota;Amorphea;Obazoa;Opisthokonta;Nucletmycea;Fungi;Dikarya;Ascomycota;Pezizomycotina;Arthoniomycetes;Arthoniales;Simonyella;";"0.0";"0";"1";"1";"0";"1";"0";"457182";"391207"
"V4mis2";"SILVA (only NR);Eukaryota;Amorphea;Obazoa;Opisthokonta;Nucletmycea;Fungi;Dikarya;Ascomycota;Pezizomycotina;Arthoniomycetes;uncultured;";"0.0";"0";"5";"5";"0";"5";"0";"457178";"391207"
"V4mis2";"SILVA (only NR);Eukaryota;Amorphea;Obazoa;Opisthokonta;Nucletmycea;Fungi;Dikarya;Ascomycota;Pezizomycotina;Dothideomycetes;";"1.8";"14.2";"1025";"1017";"18";"999";"8";"456166";"391189"
"V4mis2";"SILVA (only NR);Eukaryota;Amorphea;Obazoa;Opisthokonta;Nucletmycea;Fungi;Dikarya;Ascomycota;Pezizomycotina;Dothideomycetes;Botryosphaeriales;";"0.0";"0";"21";"21";"0";"21";"0";"457162";"391207"
"V4mis2";"SILVA (only NR);Eukaryota;Amorphea;Obazoa;Opisthokonta;Nucletmycea;Fungi;Dikarya;Ascomycota;Pezizomycotina;Dothideomycetes;Botryosphaeriales;Bagnisiella;";"0.0";"0";"1";"1";"0";"1";"0";"457182";"391207"
"V4mis2";"SILVA (only NR);Eukaryota;Amorphea;Obazoa;Opisthokonta;Nucletmycea;Fungi;Dikarya;Ascomycota;Pezizomycotina;Dothideomycetes;Botryosphaeriales;Botryosphaeriaceae;";"0.0";"0";"6";"6";"0";"6";"0";"457177";"391207"
"V4mis2";"SILVA (only NR);Eukaryota;Amorphea;Obazoa;Opisthokonta;Nucletmycea;Fungi;Dikarya;Ascomycota;Pezizomycotina;Dothideomycetes;Botryosphaeriales;Botryosphaeriaceae;Botryosphaeria;";"0.0";"0";"1";"1";"0";"1";"0";"457182";"391207"
"V4mis2";"SILVA (only NR);Eukaryota;Amorphea;Obazoa;Opisthokonta;Nucletmycea;Fungi;Dikarya;Ascomycota;Pezizomycotina;Dothideomycetes;Botryosphaeriales;Botryosphaeriaceae;Diplodia;";"0.0";"0";"1";"1";"0";"1";"0";"457182";"391207"
"V4mis2";"SILVA (only NR);Eukaryota;Amorphea;Obazoa;Opisthokonta;Nucletmycea;Fungi;Dikarya;Ascomycota;Pezizomycotina;Dothideomycetes;Botryosphaeriales;Botryosphaeriaceae;Lasiodiplodia;";"0.0";"0";"1";"1";"0";"1";"0";"457182";"391207"
"V4mis2";"SILVA (only NR);Eukaryota;Amorphea;Obazoa;Opisthokonta;Nucletmycea;Fungi;Dikarya;Ascomycota;Pezizomycotina;Dothideomycetes;Botryosphaeriales;Botryosphaeriaceae;Macrophomina;";"0.0";"0";"1";"1";"0";"1";"0";"457182";"391207"
"V4mis2";"SILVA (only NR);Eukaryota;Amorphea;Obazoa;Opisthokonta;Nucletmycea;Fungi;Dikarya;Ascomycota;Pezizomycotina;Dothideomycetes;Botryosphaeriales;Botryosphaeriaceae;Neofusicoccum;";"0.0";"0";"1";"1";"0";"1";"0";"457182";"391207"
"V4mis2";"SILVA (only NR);Eukaryota;Amorphea;Obazoa;Opisthokonta;Nucletmycea;Fungi;Dikarya;Ascomycota;Pezizomycotina;Dothideomycetes;Botryosphaeriales;Botryosphaeriaceae;Neoscytalidium;";"0.0";"0";"1";"1";"0";"1";"0";"457182";"391207"
"V4mis2";"SILVA (only NR);Eukaryota;Amorphea;Obazoa;Opisthokonta;Nucletmycea;Fungi;Dikarya;Ascomycota;Pezizomycotina;Dothideomycetes;Botryosphaeriales;Phyllostictaceae;";"0.0";"0";"14";"14";"0";"14";"0";"457169";"391207"
"V4mis2";"SILVA (only NR);Eukaryota;Amorphea;Obazoa;Opisthokonta;Nucletmycea;Fungi;Dikarya;Ascomycota;Pezizomycotina;Dothideomycetes;Botryosphaeriales;Phyllostictaceae;Phyllosticta;";"0.0";"0";"14";"14";"0";"14";"0";"457169";"391207"
"V4mis2";"SILVA (only NR);Eukaryota;Amorphea;Obazoa;Opisthokonta;Nucletmycea;Fungi;Dikarya;Ascomycota;Pezizomycotina;Dothideomycetes;Capnodiales;";"0.6";"14.4";"351";"350";"2";"348";"1";"456833";"391205"
"V4mis2";"SILVA (only NR);Eukaryota;Amorphea;Obazoa;Opisthokonta;Nucletmycea;Fungi;Dikarya;Ascomycota;Pezizomycotina;Dothideomycetes;Capnodiales;Acrodontium;";"0.0";"0";"1";"1";"0";"1";"0";"457182";"391207"
"V4mis2";"SILVA (only NR);Eukaryota;Amorphea;Obazoa;Opisthokonta;Nucletmycea;Fungi;Dikarya;Ascomycota;Pezizomycotina;Dothideomycetes;Capnodiales;Capnodiaceae;";"0.0";"0";"5";"5";"0";"5";"0";"457178";"391207"
"V4mis2";"SILVA (only NR);Eukaryota;Amorphea;Obazoa;Opisthokonta;Nucletmycea;Fungi;Dikarya;Ascomycota;Pezizomycotina;Dothideomycetes;Capnodiales;Capnodiaceae;Conidiocarpus;";"0.0";"0";"1";"1";"0";"1";"0";"457182";"391207"
"V4mis2";"SILVA (only NR);Eukaryota;Amorphea;Obazoa;Opisthokonta;Nucletmycea;Fungi;Dikarya;Ascomycota;Pezizomycotina;Dothideomycetes;Capnodiales;Capnodiaceae;Leptoxyphium;";"0.0";"0";"2";"2";"0";"2";"0";"457181";"391207"
"V4mis2";"SILVA (only NR);Eukaryota;Amorphea;Obazoa;Opisthokonta;Nucletmycea;Fungi;Dikarya;Ascomycota;Pezizomycotina;Dothideomycetes;Capnodiales;Capnodiaceae;Scorias;";"0.0";"0";"2";"2";"0";"2";"0";"457181";"391207"
"V4mis2";"SILVA (only NR);Eukaryota;Amorphea;Obazoa;Opisthokonta;Nucletmycea;Fungi;Dikarya;Ascomycota;Pezizomycotina;Dothideomycetes;Capnodiales;Cladosporiaceae;";"1.1";"14.4";"91";"90";"1";"89";"1";"457093";"391206"
"V4mis2";"SILVA (only NR);Eukaryota;Amorphea;Obazoa;Opisthokonta;Nucletmycea;Fungi;Dikarya;Ascomycota;Pezizomycotina;Dothideomycetes;Capnodiales;Cladosporiaceae;Cladosporium;";"1.2";"14.4";"86";"85";"1";"84";"1";"457098";"391206"
"V4mis2";"SILVA (only NR);Eukaryota;Amorphea;Obazoa;Opisthokonta;Nucletmycea;Fungi;Dikarya;Ascomycota;Pezizomycotina;Dothideomycetes;Capnodiales;Cladosporiaceae;Rachicladosporium;";"0.0";"0";"2";"2";"0";"2";"0";"457181";"391207"
"V4mis2";"SILVA (only NR);Eukaryota;Amorphea;Obazoa;Opisthokonta;Nucletmycea;Fungi;Dikarya;Ascomycota;Pezizomycotina;Dothideomycetes;Capnodiales;Cladosporiaceae;Toxicocladosporium;";"0.0";"0";"3";"3";"0";"3";"0";"457180";"391207"
"V4mis2";"SILVA (only NR);Eukaryota;Amorphea;Obazoa;Opisthokonta;Nucletmycea;Fungi;Dikarya;Ascomycota;Pezizomycotina;Dothideomycetes;Capnodiales;Dissoconiaceae;";"0.0";"0";"8";"8";"0";"8";"0";"457175";"391207"
"V4mis2";"SILVA (only NR);Eukaryota;Amorphea;Obazoa;Opisthokonta;Nucletmycea;Fungi;Dikarya;Ascomycota;Pezizomycotina;Dothideomycetes;Capnodiales;Dissoconiaceae;Dissoconium;";"0.0";"0";"3";"3";"0";"3";"0";"457180";"391207"
"V4mis2";"SILVA (only NR);Eukaryota;Amorphea;Obazoa;Opisthokonta;Nucletmycea;Fungi;Dikarya;Ascomycota;Pezizomycotina;Dothideomycetes;Capnodiales;Dissoconiaceae;Ramichloridium;";"0.0";"0";"1";"1";"0";"1";"0";"457182";"391207"
"V4mis2";"SILVA (only NR);Eukaryota;Amorphea;Obazoa;Opisthokonta;Nucletmycea;Fungi;Dikarya;Ascomycota;Pezizomycotina;Dothideomycetes;Capnodiales;Dissoconiaceae;Uwebraunia;";"0.0";"0";"3";"3";"0";"3";"0";"457180";"391207"
"V4mis2";"SILVA (only NR);Eukaryota;Amorphea;Obazoa;Opisthokonta;Nucletmycea;Fungi;Dikarya;Ascomycota;Pezizomycotina;Dothideomycetes;Capnodiales;Extremaceae;";"0.0";"0";"9";"9";"0";"9";"0";"457174";"391207"
"V4mis2";"SILVA (only NR);Eukaryota;Amorphea;Obazoa;Opisthokonta;Nucletmycea;Fungi;Dikarya;Ascomycota;Pezizomycotina;Dothideomycetes;Capnodiales;Extremaceae;Vermiconia;";"0.0";"0";"3";"3";"0";"3";"0";"457180";"391207"
"V4mis2";"SILVA (only NR);Eukaryota;Amorphea;Obazoa;Opisthokonta;Nucletmycea;Fungi;Dikarya;Ascomycota;Pezizomycotina;Dothideomycetes;Capnodiales;Incertae Sedis;";"0.0";"0";"4";"4";"0";"4";"0";"457179";"391207"
"V4mis2";"SILVA (only NR);Eukaryota;Amorphea;Obazoa;Opisthokonta;Nucletmycea;Fungi;Dikarya;Ascomycota;Pezizomycotina;Dothideomycetes;Capnodiales;Incertae Sedis;Peltaster;";"0.0";"0";"4";"4";"0";"4";"0";"457179";"391207"
"V4mis2";"SILVA (only NR);Eukaryota;Amorphea;Obazoa;Opisthokonta;Nucletmycea;Fungi;Dikarya;Ascomycota;Pezizomycotina;Dothideomycetes;Capnodiales;Microcyclospora;";"0.0";"0";"1";"1";"0";"1";"0";"457182";"391207"
"V4mis2";"SILVA (only NR);Eukaryota;Amorphea;Obazoa;Opisthokonta;Nucletmycea;Fungi;Dikarya;Ascomycota;Pezizomycotina;Dothideomycetes;Capnodiales;Mucomycosphaerella;";"0.0";"0";"1";"1";"0";"1";"0";"457182";"391207"
"V4mis2";"SILVA (only NR);Eukaryota;Amorphea;Obazoa;Opisthokonta;Nucletmycea;Fungi;Dikarya;Ascomycota;Pezizomycotina;Dothideomycetes;Capnodiales;Mycosphaerellaceae;";"0.8";"14.4";"122";"122";"1";"121";"0";"457061";"391206"
"V4mis2";"SILVA (only NR);Eukaryota;Amorphea;Obazoa;Opisthokonta;Nucletmycea;Fungi;Dikarya;Ascomycota;Pezizomycotina;Dothideomycetes;Capnodiales;Mycosphaerellaceae;Cercospora;";"0.0";"0";"1";"1";"0";"1";"0";"457182";"391207"
"V4mis2";"SILVA (only NR);Eukaryota;Amorphea;Obazoa;Opisthokonta;Nucletmycea;Fungi;Dikarya;Ascomycota;Pezizomycotina;Dothideomycetes;Capnodiales;Mycosphaerellaceae;Cercosporella;";"0.0";"0";"1";"1";"0";"1";"0";"457182";"391207"
"V4mis2";"SILVA (only NR);Eukaryota;Amorphea;Obazoa;Opisthokonta;Nucletmycea;Fungi;Dikarya;Ascomycota;Pezizomycotina;Dothideomycetes;Capnodiales;Mycosphaerellaceae;Exopassalora;";"0.0";"0";"1";"1";"0";"1";"0";"457182";"391207"
"V4mis2";"SILVA (only NR);Eukaryota;Amorphea;Obazoa;Opisthokonta;Nucletmycea;Fungi;Dikarya;Ascomycota;Pezizomycotina;Dothideomycetes;Capnodiales;Mycosphaerellaceae;Exutisphaerella;";"0.0";"0";"1";"1";"0";"1";"0";"457182";"391207"
"V4mis2";"SILVA (only NR);Eukaryota;Amorphea;Obazoa;Opisthokonta;Nucletmycea;Fungi;Dikarya;Ascomycota;Pezizomycotina;Dothideomycetes;Capnodiales;Mycosphaerellaceae;Graminopassalora;";"0.0";"0";"1";"1";"0";"1";"0";"457182";"391207"
"V4mis2";"SILVA (only NR);Eukaryota;Amorphea;Obazoa;Opisthokonta;Nucletmycea;Fungi;Dikarya;Ascomycota;Pezizomycotina;Dothideomycetes;Capnodiales;Mycosphaerellaceae;Lecanosticta;";"0.0";"0";"1";"1";"0";"1";"0";"457182";"391207"
"V4mis2";"SILVA (only NR);Eukaryota;Amorphea;Obazoa;Opisthokonta;Nucletmycea;Fungi;Dikarya;Ascomycota;Pezizomycotina;Dothideomycetes;Capnodiales;Mycosphaerellaceae;Mycosphaerella;";"0.0";"0";"15";"15";"0";"15";"0";"457168";"391207"
"V4mis2";"SILVA (only NR);Eukaryota;Amorphea;Obazoa;Opisthokonta;Nucletmycea;Fungi;Dikarya;Ascomycota;Pezizomycotina;Dothideomycetes;Capnodiales;Mycosphaerellaceae;Neophloeospora;";"0.0";"0";"1";"1";"0";"1";"0";"457182";"391207"
"V4mis2";"SILVA (only NR);Eukaryota;Amorphea;Obazoa;Opisthokonta;Nucletmycea;Fungi;Dikarya;Ascomycota;Pezizomycotina;Dothideomycetes;Capnodiales;Mycosphaerellaceae;Neopseudocercosporella;";"0.0";"0";"1";"1";"0";"1";"0";"457182";"391207"
"V4mis2";"SILVA (only NR);Eukaryota;Amorphea;Obazoa;Opisthokonta;Nucletmycea;Fungi;Dikarya;Ascomycota;Pezizomycotina;Dothideomycetes;Capnodiales;Mycosphaerellaceae;Pallidocercospora;";"0.0";"0";"1";"1";"0";"1";"0";"457182";"391207"
"V4mis2";"SILVA (only NR);Eukaryota;Amorphea;Obazoa;Opisthokonta;Nucletmycea;Fungi;Dikarya;Ascomycota;Pezizomycotina;Dothideomycetes;Capnodiales;Mycosphaerellaceae;Paramycosphaerella;";"0.0";"0";"1";"1";"0";"1";"0";"457182";"391207"
"V4mis2";"SILVA (only NR);Eukaryota;Amorphea;Obazoa;Opisthokonta;Nucletmycea;Fungi;Dikarya;Ascomycota;Pezizomycotina;Dothideomycetes;Capnodiales;Mycosphaerellaceae;Passalora;";"0.0";"0";"3";"3";"0";"3";"0";"457180";"391207"
"V4mis2";"SILVA (only NR);Eukaryota;Amorphea;Obazoa;Opisthokonta;Nucletmycea;Fungi;Dikarya;Ascomycota;Pezizomycotina;Dothideomycetes;Capnodiales;Mycosphaerellaceae;Phaeoisariopsis;";"0.0";"0";"2";"2";"0";"2";"0";"457181";"391207"
"V4mis2";"SILVA (only NR);Eukaryota;Amorphea;Obazoa;Opisthokonta;Nucletmycea;Fungi;Dikarya;Ascomycota;Pezizomycotina;Dothideomycetes;Capnodiales;Mycosphaerellaceae;Phaeophleospora;";"0.0";"0";"1";"1";"0";"1";"0";"457182";"391207"
"V4mis2";"SILVA (only NR);Eukaryota;Amorphea;Obazoa;Opisthokonta;Nucletmycea;Fungi;Dikarya;Ascomycota;Pezizomycotina;Dothideomycetes;Capnodiales;Mycosphaerellaceae;Pseudocercospora;";"0.0";"0";"5";"5";"0";"5";"0";"457178";"391207"
"V4mis2";"SILVA (only NR);Eukaryota;Amorphea;Obazoa;Opisthokonta;Nucletmycea;Fungi;Dikarya;Ascomycota;Pezizomycotina;Dothideomycetes;Capnodiales;Mycosphaerellaceae;Ramularia;";"0.0";"0";"66";"66";"0";"66";"0";"457117";"391207"
"V4mis2";"SILVA (only NR);Eukaryota;Amorphea;Obazoa;Opisthokonta;Nucletmycea;Fungi;Dikarya;Ascomycota;Pezizomycotina;Dothideomycetes;Capnodiales;Mycosphaerellaceae;Septoria;";"0.0";"0";"3";"3";"0";"3";"0";"457180";"391207"
"V4mis2";"SILVA (only NR);Eukaryota;Amorphea;Obazoa;Opisthokonta;Nucletmycea;Fungi;Dikarya;Ascomycota;Pezizomycotina;Dothideomycetes;Capnodiales;Mycosphaerellaceae;Sphaerulina;";"0.0";"0";"4";"4";"0";"4";"0";"457179";"391207"
"V4mis2";"SILVA (only NR);Eukaryota;Amorphea;Obazoa;Opisthokonta;Nucletmycea;Fungi;Dikarya;Ascomycota;Pezizomycotina;Dothideomycetes;Capnodiales;Mycosphaerellaceae;Stigmina;";"0.0";"0";"1";"1";"0";"1";"0";"457182";"391207"
"V4mis2";"SILVA (only NR);Eukaryota;Amorphea;Obazoa;Opisthokonta;Nucletmycea;Fungi;Dikarya;Ascomycota;Pezizomycotina;Dothideomycetes;Capnodiales;Mycosphaerellaceae;Zasmidium;";"0.0";"0";"1";"1";"0";"1";"0";"457182";"391207"
"V4mis2";"SILVA (only NR);Eukaryota;Amorphea;Obazoa;Opisthokonta;Nucletmycea;Fungi;Dikarya;Ascomycota;Pezizomycotina;Dothideomycetes;Capnodiales;Mycosphaerellaceae;Zymoseptoria;";"0.0";"0";"7";"7";"0";"7";"0";"457176";"391207"
"V4mis2";"SILVA (only NR);Eukaryota;Amorphea;Obazoa;Opisthokonta;Nucletmycea;Fungi;Dikarya;Ascomycota;Pezizomycotina;Dothideomycetes;Capnodiales;Piedraia;";"0.0";"0";"1";"1";"0";"1";"0";"457182";"391207"
"V4mis2";"SILVA (only NR);Eukaryota;Amorphea;Obazoa;Opisthokonta;Nucletmycea;Fungi;Dikarya;Ascomycota;Pezizomycotina;Dothideomycetes;Capnodiales;Readeriella;";"0.0";"0";"1";"1";"0";"1";"0";"457182";"391207"
"V4mis2";"SILVA (only NR);Eukaryota;Amorphea;Obazoa;Opisthokonta;Nucletmycea;Fungi;Dikarya;Ascomycota;Pezizomycotina;Dothideomycetes;Capnodiales;Schizothyriaceae;";"0.0";"0";"3";"3";"0";"3";"0";"457180";"391207"
"V4mis2";"SILVA (only NR);Eukaryota;Amorphea;Obazoa;Opisthokonta;Nucletmycea;Fungi;Dikarya;Ascomycota;Pezizomycotina;Dothideomycetes;Capnodiales;Schizothyriaceae;Schizothyrium;";"0.0";"0";"3";"3";"0";"3";"0";"457180";"391207"
"V4mis2";"SILVA (only NR);Eukaryota;Amorphea;Obazoa;Opisthokonta;Nucletmycea;Fungi;Dikarya;Ascomycota;Pezizomycotina;Dothideomycetes;Capnodiales;Teratoramularia;";"0.0";"0";"1";"1";"0";"1";"0";"457182";"391207"
"V4mis2";"SILVA (only NR);Eukaryota;Amorphea;Obazoa;Opisthokonta;Nucletmycea;Fungi;Dikarya;Ascomycota;Pezizomycotina;Dothideomycetes;Capnodiales;Teratosphaeriaceae;";"0.0";"0";"99";"99";"0";"99";"0";"457084";"391207"
"V4mis2";"SILVA (only NR);Eukaryota;Amorphea;Obazoa;Opisthokonta;Nucletmycea;Fungi;Dikarya;Ascomycota;Pezizomycotina;Dothideomycetes;Capnodiales;Teratosphaeriaceae;Acidomyces;";"0.0";"0";"2";"2";"0";"2";"0";"457181";"391207"
"V4mis2";"SILVA (only NR);Eukaryota;Amorphea;Obazoa;Opisthokonta;Nucletmycea;Fungi;Dikarya;Ascomycota;Pezizomycotina;Dothideomycetes;Capnodiales;Teratosphaeriaceae;Baudoinia;";"0.0";"0";"2";"2";"0";"2";"0";"457181";"391207"
"V4mis2";"SILVA (only NR);Eukaryota;Amorphea;Obazoa;Opisthokonta;Nucletmycea;Fungi;Dikarya;Ascomycota;Pezizomycotina;Dothideomycetes;Capnodiales;Teratosphaeriaceae;Bryochiton;";"0.0";"0";"1";"1";"0";"1";"0";"457182";"391207"
"V4mis2";"SILVA (only NR);Eukaryota;Amorphea;Obazoa;Opisthokonta;Nucletmycea;Fungi;Dikarya;Ascomycota;Pezizomycotina;Dothideomycetes;Capnodiales;Teratosphaeriaceae;Capnobotryella;";"0.0";"0";"8";"8";"0";"8";"0";"457175";"391207"
"V4mis2";"SILVA (only NR);Eukaryota;Amorphea;Obazoa;Opisthokonta;Nucletmycea;Fungi;Dikarya;Ascomycota;Pezizomycotina;Dothideomycetes;Capnodiales;Teratosphaeriaceae;Catenulostroma;";"0.0";"0";"1";"1";"0";"1";"0";"457182";"391207"
"V4mis2";"SILVA (only NR);Eukaryota;Amorphea;Obazoa;Opisthokonta;Nucletmycea;Fungi;Dikarya;Ascomycota;Pezizomycotina;Dothideomycetes;Capnodiales;Teratosphaeriaceae;Devriesia;";"0.0";"0";"1";"1";"0";"1";"0";"457182";"391207"
"V4mis2";"SILVA (only NR);Eukaryota;Amorphea;Obazoa;Opisthokonta;Nucletmycea;Fungi;Dikarya;Ascomycota;Pezizomycotina;Dothideomycetes;Capnodiales;Teratosphaeriaceae;Elasticomyces;";"0.0";"0";"1";"1";"0";"1";"0";"457182";"391207"
"V4mis2";"SILVA (only NR);Eukaryota;Amorphea;Obazoa;Opisthokonta;Nucletmycea;Fungi;Dikarya;Ascomycota;Pezizomycotina;Dothideomycetes;Capnodiales;Teratosphaeriaceae;Friedmanniomyces;";"0.0";"0";"1";"1";"0";"1";"0";"457182";"391207"
"V4mis2";"SILVA (only NR);Eukaryota;Amorphea;Obazoa;Opisthokonta;Nucletmycea;Fungi;Dikarya;Ascomycota;Pezizomycotina;Dothideomycetes;Capnodiales;Teratosphaeriaceae;Hortaea;";"0.0";"0";"4";"4";"0";"4";"0";"457179";"391207"
"V4mis2";"SILVA (only NR);Eukaryota;Amorphea;Obazoa;Opisthokonta;Nucletmycea;Fungi;Dikarya;Ascomycota;Pezizomycotina;Dothideomycetes;Capnodiales;Teratosphaeriaceae;Monticola;";"0.0";"0";"1";"1";"0";"1";"0";"457182";"391207"
"V4mis2";"SILVA (only NR);Eukaryota;Amorphea;Obazoa;Opisthokonta;Nucletmycea;Fungi;Dikarya;Ascomycota;Pezizomycotina;Dothideomycetes;Capnodiales;Teratosphaeriaceae;Neocatenulostroma;";"0.0";"0";"62";"62";"0";"62";"0";"457121";"391207"
"V4mis2";"SILVA (only NR);Eukaryota;Amorphea;Obazoa;Opisthokonta;Nucletmycea;Fungi;Dikarya;Ascomycota;Pezizomycotina;Dothideomycetes;Capnodiales;Teratosphaeriaceae;Penidiella;";"0.0";"0";"1";"1";"0";"1";"0";"457182";"391207"
"V4mis2";"SILVA (only NR);Eukaryota;Amorphea;Obazoa;Opisthokonta;Nucletmycea;Fungi;Dikarya;Ascomycota;Pezizomycotina;Dothideomycetes;Capnodiales;Teratosphaeriaceae;Pseudotaeniolina;";"0.0";"0";"1";"1";"0";"1";"0";"457182";"391207"
"V4mis2";"SILVA (only NR);Eukaryota;Amorphea;Obazoa;Opisthokonta;Nucletmycea;Fungi;Dikarya;Ascomycota;Pezizomycotina;Dothideomycetes;Capnodiales;Teratosphaeriaceae;Recurvomyces;";"0.0";"0";"2";"2";"0";"2";"0";"457181";"391207"
"V4mis2";"SILVA (only NR);Eukaryota;Amorphea;Obazoa;Opisthokonta;Nucletmycea;Fungi;Dikarya;Ascomycota;Pezizomycotina;Dothideomycetes;Capnodiales;Teratosphaeriaceae;Suberoteratosphaeria;";"0.0";"0";"2";"2";"0";"2";"0";"457181";"391207"
"V4mis2";"SILVA (only NR);Eukaryota;Amorphea;Obazoa;Opisthokonta;Nucletmycea;Fungi;Dikarya;Ascomycota;Pezizomycotina;Dothideomycetes;Capnodiales;Teratosphaeriaceae;Teratosphaeria;";"0.0";"0";"6";"6";"0";"6";"0";"457177";"391207"
"V4mis2";"SILVA (only NR);Eukaryota;Amorphea;Obazoa;Opisthokonta;Nucletmycea;Fungi;Dikarya;Ascomycota;Pezizomycotina;Dothideomycetes;Cenococcum;";"0.0";"0";"2";"2";"0";"2";"0";"457181";"391207"
"V4mis2";"SILVA (only NR);Eukaryota;Amorphea;Obazoa;Opisthokonta;Nucletmycea;Fungi;Dikarya;Ascomycota;Pezizomycotina;Dothideomycetes;Dothideales;";"0.0";"0";"35";"35";"0";"35";"0";"457148";"391207"
"V4mis2";"SILVA (only NR);Eukaryota;Amorphea;Obazoa;Opisthokonta;Nucletmycea;Fungi;Dikarya;Ascomycota;Pezizomycotina;Dothideomycetes;Dothideales;Aureobasidiaceae;";"0.0";"0";"22";"22";"0";"22";"0";"457161";"391207"
"V4mis2";"SILVA (only NR);Eukaryota;Amorphea;Obazoa;Opisthokonta;Nucletmycea;Fungi;Dikarya;Ascomycota;Pezizomycotina;Dothideomycetes;Dothideales;Aureobasidiaceae;Aureobasidium;";"0.0";"0";"18";"18";"0";"18";"0";"457165";"391207"
"V4mis2";"SILVA (only NR);Eukaryota;Amorphea;Obazoa;Opisthokonta;Nucletmycea;Fungi;Dikarya;Ascomycota;Pezizomycotina;Dothideomycetes;Dothideales;Aureobasidiaceae;Columnosphaeria;";"0.0";"0";"1";"1";"0";"1";"0";"457182";"391207"
"V4mis2";"SILVA (only NR);Eukaryota;Amorphea;Obazoa;Opisthokonta;Nucletmycea;Fungi;Dikarya;Ascomycota;Pezizomycotina;Dothideomycetes;Dothideales;Aureobasidiaceae;Kabatiella;";"0.0";"0";"1";"1";"0";"1";"0";"457182";"391207"
"V4mis2";"SILVA (only NR);Eukaryota;Amorphea;Obazoa;Opisthokonta;Nucletmycea;Fungi;Dikarya;Ascomycota;Pezizomycotina;Dothideomycetes;Dothideales;Dothideaceae;";"0.0";"0";"6";"6";"0";"6";"0";"457177";"391207"
"V4mis2";"SILVA (only NR);Eukaryota;Amorphea;Obazoa;Opisthokonta;Nucletmycea;Fungi;Dikarya;Ascomycota;Pezizomycotina;Dothideomycetes;Dothideales;Dothideaceae;Dothidea;";"0.0";"0";"4";"4";"0";"4";"0";"457179";"391207"
"V4mis2";"SILVA (only NR);Eukaryota;Amorphea;Obazoa;Opisthokonta;Nucletmycea;Fungi;Dikarya;Ascomycota;Pezizomycotina;Dothideomycetes;Dothideales;Dothideaceae;Endoconidioma;";"0.0";"0";"1";"1";"0";"1";"0";"457182";"391207"
"V4mis2";"SILVA (only NR);Eukaryota;Amorphea;Obazoa;Opisthokonta;Nucletmycea;Fungi;Dikarya;Ascomycota;Pezizomycotina;Dothideomycetes;Dothideales;Dothideaceae;Stylodothis;";"0.0";"0";"1";"1";"0";"1";"0";"457182";"391207"
"V4mis2";"SILVA (only NR);Eukaryota;Amorphea;Obazoa;Opisthokonta;Nucletmycea;Fungi;Dikarya;Ascomycota;Pezizomycotina;Dothideomycetes;Dothideales;Dothioraceae;";"0.0";"0";"6";"6";"0";"6";"0";"457177";"391207"
"V4mis2";"SILVA (only NR);Eukaryota;Amorphea;Obazoa;Opisthokonta;Nucletmycea;Fungi;Dikarya;Ascomycota;Pezizomycotina;Dothideomycetes;Dothideales;Dothioraceae;Delphinella;";"0.0";"0";"2";"2";"0";"2";"0";"457181";"391207"
"V4mis2";"SILVA (only NR);Eukaryota;Amorphea;Obazoa;Opisthokonta;Nucletmycea;Fungi;Dikarya;Ascomycota;Pezizomycotina;Dothideomycetes;Dothideales;Dothioraceae;Dothiora;";"0.0";"0";"2";"2";"0";"2";"0";"457181";"391207"
"V4mis2";"SILVA (only NR);Eukaryota;Amorphea;Obazoa;Opisthokonta;Nucletmycea;Fungi;Dikarya;Ascomycota;Pezizomycotina;Dothideomycetes;Dothideales;Dothioraceae;Sydowia;";"0.0";"0";"1";"1";"0";"1";"0";"457182";"391207"
"V4mis2";"SILVA (only NR);Eukaryota;Amorphea;Obazoa;Opisthokonta;Nucletmycea;Fungi;Dikarya;Ascomycota;Pezizomycotina;Dothideomycetes;Dothideales;Scleroconidioma;";"0.0";"0";"1";"1";"0";"1";"0";"457182";"391207"
"V4mis2";"SILVA (only NR);Eukaryota;Amorphea;Obazoa;Opisthokonta;Nucletmycea;Fungi;Dikarya;Ascomycota;Pezizomycotina;Dothideomycetes;Hysteriales;";"0.0";"0";"2";"2";"0";"2";"0";"457181";"391207"
"V4mis2";"SILVA (only NR);Eukaryota;Amorphea;Obazoa;Opisthokonta;Nucletmycea;Fungi;Dikarya;Ascomycota;Pezizomycotina;Dothideomycetes;Hysteriales;Hysterographium;";"0.0";"0";"1";"1";"0";"1";"0";"457182";"391207"
"V4mis2";"SILVA (only NR);Eukaryota;Amorphea;Obazoa;Opisthokonta;Nucletmycea;Fungi;Dikarya;Ascomycota;Pezizomycotina;Dothideomycetes;Hysteriales;Rhytidhysteron;";"0.0";"0";"1";"1";"0";"1";"0";"457182";"391207"
"V4mis2";"SILVA (only NR);Eukaryota;Amorphea;Obazoa;Opisthokonta;Nucletmycea;Fungi;Dikarya;Ascomycota;Pezizomycotina;Dothideomycetes;Incertae Sedis;";"0.0";"0";"31";"31";"0";"31";"0";"457152";"391207"
"V4mis2";"SILVA (only NR);Eukaryota;Amorphea;Obazoa;Opisthokonta;Nucletmycea;Fungi;Dikarya;Ascomycota;Pezizomycotina;Dothideomycetes;Incertae Sedis;Eremomycetaceae;";"0.0";"0";"1";"1";"0";"1";"0";"457182";"391207"
"V4mis2";"SILVA (only NR);Eukaryota;Amorphea;Obazoa;Opisthokonta;Nucletmycea;Fungi;Dikarya;Ascomycota;Pezizomycotina;Dothideomycetes;Incertae Sedis;Eremomycetaceae;Arthrographis;";"0.0";"0";"1";"1";"0";"1";"0";"457182";"391207"
"V4mis2";"SILVA (only NR);Eukaryota;Amorphea;Obazoa;Opisthokonta;Nucletmycea;Fungi;Dikarya;Ascomycota;Pezizomycotina;Dothideomycetes;Incertae Sedis;Incertae Sedis;";"0.0";"0";"26";"26";"0";"26";"0";"457157";"391207"
"V4mis2";"SILVA (only NR);Eukaryota;Amorphea;Obazoa;Opisthokonta;Nucletmycea;Fungi;Dikarya;Ascomycota;Pezizomycotina;Dothideomycetes;Incertae Sedis;Incertae Sedis;Brachyconidiella;";"0.0";"0";"1";"1";"0";"1";"0";"457182";"391207"
"V4mis2";"SILVA (only NR);Eukaryota;Amorphea;Obazoa;Opisthokonta;Nucletmycea;Fungi;Dikarya;Ascomycota;Pezizomycotina;Dothideomycetes;Incertae Sedis;Incertae Sedis;Catinella;";"0.0";"0";"1";"1";"0";"1";"0";"457182";"391207"
"V4mis2";"SILVA (only NR);Eukaryota;Amorphea;Obazoa;Opisthokonta;Nucletmycea;Fungi;Dikarya;Ascomycota;Pezizomycotina;Dothideomycetes;Incertae Sedis;Incertae Sedis;Cryomyces;";"0.0";"0";"2";"2";"0";"2";"0";"457181";"391207"
"V4mis2";"SILVA (only NR);Eukaryota;Amorphea;Obazoa;Opisthokonta;Nucletmycea;Fungi;Dikarya;Ascomycota;Pezizomycotina;Dothideomycetes;Incertae Sedis;Incertae Sedis;Endosporium;";"0.0";"0";"1";"1";"0";"1";"0";"457182";"391207"
"V4mis2";"SILVA (only NR);Eukaryota;Amorphea;Obazoa;Opisthokonta;Nucletmycea;Fungi;Dikarya;Ascomycota;Pezizomycotina;Dothideomycetes;Incertae Sedis;Incertae Sedis;Heliocephala;";"0.0";"0";"3";"3";"0";"3";"0";"457180";"391207"
"V4mis2";"SILVA (only NR);Eukaryota;Amorphea;Obazoa;Opisthokonta;Nucletmycea;Fungi;Dikarya;Ascomycota;Pezizomycotina;Dothideomycetes;Incertae Sedis;Incertae Sedis;Phaeosclera;";"0.0";"0";"1";"1";"0";"1";"0";"457182";"391207"
"V4mis2";"SILVA (only NR);Eukaryota;Amorphea;Obazoa;Opisthokonta;Nucletmycea;Fungi;Dikarya;Ascomycota;Pezizomycotina;Dothideomycetes;Incertae Sedis;Incertae Sedis;Phaeotheca;";"0.0";"0";"1";"1";"0";"1";"0";"457182";"391207"
"V4mis2";"SILVA (only NR);Eukaryota;Amorphea;Obazoa;Opisthokonta;Nucletmycea;Fungi;Dikarya;Ascomycota;Pezizomycotina;Dothideomycetes;Incertae Sedis;Incertae Sedis;Pseudosigmoidea;";"0.0";"0";"1";"1";"0";"1";"0";"457182";"391207"
"V4mis2";"SILVA (only NR);Eukaryota;Amorphea;Obazoa;Opisthokonta;Nucletmycea;Fungi;Dikarya;Ascomycota;Pezizomycotina;Dothideomycetes;Incertae Sedis;Incertae Sedis;Rupestriomyces;";"0.0";"0";"1";"1";"0";"1";"0";"457182";"391207"
"V4mis2";"SILVA (only NR);Eukaryota;Amorphea;Obazoa;Opisthokonta;Nucletmycea;Fungi;Dikarya;Ascomycota;Pezizomycotina;Dothideomycetes;Incertae Sedis;Incertae Sedis;Saxomyces;";"0.0";"0";"2";"2";"0";"2";"0";"457181";"391207"
"V4mis2";"SILVA (only NR);Eukaryota;Amorphea;Obazoa;Opisthokonta;Nucletmycea;Fungi;Dikarya;Ascomycota;Pezizomycotina;Dothideomycetes;Incertae Sedis;Incertae Sedis;Scolecobasidium;";"0.0";"0";"1";"1";"0";"1";"0";"457182";"391207"
"V4mis2";"SILVA (only NR);Eukaryota;Amorphea;Obazoa;Opisthokonta;Nucletmycea;Fungi;Dikarya;Ascomycota;Pezizomycotina;Dothideomycetes;Incertae Sedis;Incertae Sedis;Spissiomyces;";"0.0";"0";"1";"1";"0";"1";"0";"457182";"391207"
"V4mis2";"SILVA (only NR);Eukaryota;Amorphea;Obazoa;Opisthokonta;Nucletmycea;Fungi;Dikarya;Ascomycota;Pezizomycotina;Dothideomycetes;Incertae Sedis;Incertae Sedis;Tyrannosorus;";"0.0";"0";"1";"1";"0";"1";"0";"457182";"391207"
"V4mis2";"SILVA (only NR);Eukaryota;Amorphea;Obazoa;Opisthokonta;Nucletmycea;Fungi;Dikarya;Ascomycota;Pezizomycotina;Dothideomycetes;Incertae Sedis;Kirschsteiniotheliaceae;";"0.0";"0";"2";"2";"0";"2";"0";"457181";"391207"
"V4mis2";"SILVA (only NR);Eukaryota;Amorphea;Obazoa;Opisthokonta;Nucletmycea;Fungi;Dikarya;Ascomycota;Pezizomycotina;Dothideomycetes;Incertae Sedis;Kirschsteiniotheliaceae;Kirschsteiniothelia;";"0.0";"0";"2";"2";"0";"2";"0";"457181";"391207"
"V4mis2";"SILVA (only NR);Eukaryota;Amorphea;Obazoa;Opisthokonta;Nucletmycea;Fungi;Dikarya;Ascomycota;Pezizomycotina;Dothideomycetes;Incertae Sedis;Micropeltidaceae;";"0.0";"0";"1";"1";"0";"1";"0";"457182";"391207"
"V4mis2";"SILVA (only NR);Eukaryota;Amorphea;Obazoa;Opisthokonta;Nucletmycea;Fungi;Dikarya;Ascomycota;Pezizomycotina;Dothideomycetes;Incertae Sedis;Micropeltidaceae;Stomiopeltis;";"0.0";"0";"1";"1";"0";"1";"0";"457182";"391207"
"V4mis2";"SILVA (only NR);Eukaryota;Amorphea;Obazoa;Opisthokonta;Nucletmycea;Fungi;Dikarya;Ascomycota;Pezizomycotina;Dothideomycetes;Jahnulales;";"100.0";"14.4";"7";"7";"7";"0";"0";"457176";"391200"
"V4mis2";"SILVA (only NR);Eukaryota;Amorphea;Obazoa;Opisthokonta;Nucletmycea;Fungi;Dikarya;Ascomycota;Pezizomycotina;Dothideomycetes;Jahnulales;Aliquandostipitaceae;";"100.0";"14.4";"6";"6";"6";"0";"0";"457177";"391201"
"V4mis2";"SILVA (only NR);Eukaryota;Amorphea;Obazoa;Opisthokonta;Nucletmycea;Fungi;Dikarya;Ascomycota;Pezizomycotina;Dothideomycetes;Jahnulales;Aliquandostipitaceae;Aliquandostipite;";"100.0";"14.4";"2";"2";"2";"0";"0";"457181";"391205"
"V4mis2";"SILVA (only NR);Eukaryota;Amorphea;Obazoa;Opisthokonta;Nucletmycea;Fungi;Dikarya;Ascomycota;Pezizomycotina;Dothideomycetes;Jahnulales;Aliquandostipitaceae;Jahnula;";"100.0";"14.4";"4";"4";"4";"0";"0";"457179";"391203"
"V4mis2";"SILVA (only NR);Eukaryota;Amorphea;Obazoa;Opisthokonta;Nucletmycea;Fungi;Dikarya;Ascomycota;Pezizomycotina;Dothideomycetes;Jahnulales;Manglicola;";"100.0";"14.4";"1";"1";"1";"0";"0";"457182";"391206"
"V4mis2";"SILVA (only NR);Eukaryota;Amorphea;Obazoa;Opisthokonta;Nucletmycea;Fungi;Dikarya;Ascomycota;Pezizomycotina;Dothideomycetes;Myriangiales;";"0.0";"0";"5";"5";"0";"5";"0";"457178";"391207"
"V4mis2";"SILVA (only NR);Eukaryota;Amorphea;Obazoa;Opisthokonta;Nucletmycea;Fungi;Dikarya;Ascomycota;Pezizomycotina;Dothideomycetes;Myriangiales;Elsinoaceae;";"0.0";"0";"3";"3";"0";"3";"0";"457180";"391207"
"V4mis2";"SILVA (only NR);Eukaryota;Amorphea;Obazoa;Opisthokonta;Nucletmycea;Fungi;Dikarya;Ascomycota;Pezizomycotina;Dothideomycetes;Myriangiales;Elsinoaceae;Elsinoe;";"0.0";"0";"3";"3";"0";"3";"0";"457180";"391207"
"V4mis2";"SILVA (only NR);Eukaryota;Amorphea;Obazoa;Opisthokonta;Nucletmycea;Fungi;Dikarya;Ascomycota;Pezizomycotina;Dothideomycetes;Myriangiales;Myriangiaceae;";"0.0";"0";"2";"2";"0";"2";"0";"457181";"391207"
"V4mis2";"SILVA (only NR);Eukaryota;Amorphea;Obazoa;Opisthokonta;Nucletmycea;Fungi;Dikarya;Ascomycota;Pezizomycotina;Dothideomycetes;Myriangiales;Myriangiaceae;Myriangium;";"0.0";"0";"2";"2";"0";"2";"0";"457181";"391207"
"V4mis2";"SILVA (only NR);Eukaryota;Amorphea;Obazoa;Opisthokonta;Nucletmycea;Fungi;Dikarya;Ascomycota;Pezizomycotina;Dothideomycetes;Mytilinidiales;";"0.0";"0";"3";"3";"0";"3";"0";"457180";"391207"
"V4mis2";"SILVA (only NR);Eukaryota;Amorphea;Obazoa;Opisthokonta;Nucletmycea;Fungi;Dikarya;Ascomycota;Pezizomycotina;Dothideomycetes;Mytilinidiales;Mytilinidiaceae;";"0.0";"0";"3";"3";"0";"3";"0";"457180";"391207"
"V4mis2";"SILVA (only NR);Eukaryota;Amorphea;Obazoa;Opisthokonta;Nucletmycea;Fungi;Dikarya;Ascomycota;Pezizomycotina;Dothideomycetes;Mytilinidiales;Mytilinidiaceae;Lophium;";"0.0";"0";"1";"1";"0";"1";"0";"457182";"391207"
"V4mis2";"SILVA (only NR);Eukaryota;Amorphea;Obazoa;Opisthokonta;Nucletmycea;Fungi;Dikarya;Ascomycota;Pezizomycotina;Dothideomycetes;Mytilinidiales;Mytilinidiaceae;Mytilinidion;";"0.0";"0";"1";"1";"0";"1";"0";"457182";"391207"
"V4mis2";"SILVA (only NR);Eukaryota;Amorphea;Obazoa;Opisthokonta;Nucletmycea;Fungi;Dikarya;Ascomycota;Pezizomycotina;Dothideomycetes;Mytilinidiales;Mytilinidiaceae;Slimacomyces;";"0.0";"0";"1";"1";"0";"1";"0";"457182";"391207"
"V4mis2";"SILVA (only NR);Eukaryota;Amorphea;Obazoa;Opisthokonta;Nucletmycea;Fungi;Dikarya;Ascomycota;Pezizomycotina;Dothideomycetes;Pleosporales;";"1.9";"14.3";"477";"470";"9";"461";"7";"456713";"391198"
"V4mis2";"SILVA (only NR);Eukaryota;Amorphea;Obazoa;Opisthokonta;Nucletmycea;Fungi;Dikarya;Ascomycota;Pezizomycotina;Dothideomycetes;Pleosporales;Acrocordiopsis;";"0.0";"0";"1";"1";"0";"1";"0";"457182";"391207"
"V4mis2";"SILVA (only NR);Eukaryota;Amorphea;Obazoa;Opisthokonta;Nucletmycea;Fungi;Dikarya;Ascomycota;Pezizomycotina;Dothideomycetes;Pleosporales;Aigialaceae;";"0.0";"0";"3";"3";"0";"3";"0";"457180";"391207"
"V4mis2";"SILVA (only NR);Eukaryota;Amorphea;Obazoa;Opisthokonta;Nucletmycea;Fungi;Dikarya;Ascomycota;Pezizomycotina;Dothideomycetes;Pleosporales;Aigialaceae;Aigialus;";"0.0";"0";"3";"3";"0";"3";"0";"457180";"391207"
"V4mis2";"SILVA (only NR);Eukaryota;Amorphea;Obazoa;Opisthokonta;Nucletmycea;Fungi;Dikarya;Ascomycota;Pezizomycotina;Dothideomycetes;Pleosporales;Amia;";"0.0";"0";"1";"1";"0";"1";"0";"457182";"391207"
"V4mis2";"SILVA (only NR);Eukaryota;Amorphea;Obazoa;Opisthokonta;Nucletmycea;Fungi;Dikarya;Ascomycota;Pezizomycotina;Dothideomycetes;Pleosporales;Amorosiaceae;";"0.0";"0";"3";"3";"0";"3";"0";"457180";"391207"
"V4mis2";"SILVA (only NR);Eukaryota;Amorphea;Obazoa;Opisthokonta;Nucletmycea;Fungi;Dikarya;Ascomycota;Pezizomycotina;Dothideomycetes;Pleosporales;Amorosiaceae;Amorosia;";"0.0";"0";"1";"1";"0";"1";"0";"457182";"391207"
"V4mis2";"SILVA (only NR);Eukaryota;Amorphea;Obazoa;Opisthokonta;Nucletmycea;Fungi;Dikarya;Ascomycota;Pezizomycotina;Dothideomycetes;Pleosporales;Anguillospora;";"0.0";"0";"1";"1";"0";"1";"0";"457182";"391207"
"V4mis2";"SILVA (only NR);Eukaryota;Amorphea;Obazoa;Opisthokonta;Nucletmycea;Fungi;Dikarya;Ascomycota;Pezizomycotina;Dothideomycetes;Pleosporales;Arthopyrenia;";"0.0";"0";"1";"1";"0";"1";"0";"457182";"391207"
"V4mis2";"SILVA (only NR);Eukaryota;Amorphea;Obazoa;Opisthokonta;Nucletmycea;Fungi;Dikarya;Ascomycota;Pezizomycotina;Dothideomycetes;Pleosporales;Biatriosporaceae;";"0.0";"0";"2";"2";"0";"2";"0";"457181";"391207"
"V4mis2";"SILVA (only NR);Eukaryota;Amorphea;Obazoa;Opisthokonta;Nucletmycea;Fungi;Dikarya;Ascomycota;Pezizomycotina;Dothideomycetes;Pleosporales;Biatriosporaceae;Biatriospora;";"0.0";"0";"2";"2";"0";"2";"0";"457181";"391207"
"V4mis2";"SILVA (only NR);Eukaryota;Amorphea;Obazoa;Opisthokonta;Nucletmycea;Fungi;Dikarya;Ascomycota;Pezizomycotina;Dothideomycetes;Pleosporales;Byssothecium;";"0.0";"0";"1";"1";"0";"1";"0";"457182";"391207"
"V4mis2";"SILVA (only NR);Eukaryota;Amorphea;Obazoa;Opisthokonta;Nucletmycea;Fungi;Dikarya;Ascomycota;Pezizomycotina;Dothideomycetes;Pleosporales;Coniothyriaceae;";"0.0";"0";"3";"3";"0";"3";"0";"457180";"391207"
"V4mis2";"SILVA (only NR);Eukaryota;Amorphea;Obazoa;Opisthokonta;Nucletmycea;Fungi;Dikarya;Ascomycota;Pezizomycotina;Dothideomycetes;Pleosporales;Coniothyriaceae;Coniothyrium;";"0.0";"0";"3";"3";"0";"3";"0";"457180";"391207"
"V4mis2";"SILVA (only NR);Eukaryota;Amorphea;Obazoa;Opisthokonta;Nucletmycea;Fungi;Dikarya;Ascomycota;Pezizomycotina;Dothideomycetes;Pleosporales;Corynespora;";"0.0";"0";"2";"2";"0";"2";"0";"457181";"391207"
"V4mis2";"SILVA (only NR);Eukaryota;Amorphea;Obazoa;Opisthokonta;Nucletmycea;Fungi;Dikarya;Ascomycota;Pezizomycotina;Dothideomycetes;Pleosporales;Cucurbitariaceae;";"0.0";"0";"10";"10";"0";"10";"0";"457173";"391207"
"V4mis2";"SILVA (only NR);Eukaryota;Amorphea;Obazoa;Opisthokonta;Nucletmycea;Fungi;Dikarya;Ascomycota;Pezizomycotina;Dothideomycetes;Pleosporales;Cucurbitariaceae;Cucurbitaria;";"0.0";"0";"1";"1";"0";"1";"0";"457182";"391207"
"V4mis2";"SILVA (only NR);Eukaryota;Amorphea;Obazoa;Opisthokonta;Nucletmycea;Fungi;Dikarya;Ascomycota;Pezizomycotina;Dothideomycetes;Pleosporales;Cucurbitariaceae;Pyrenochaeta;";"0.0";"0";"7";"7";"0";"7";"0";"457176";"391207"
"V4mis2";"SILVA (only NR);Eukaryota;Amorphea;Obazoa;Opisthokonta;Nucletmycea;Fungi;Dikarya;Ascomycota;Pezizomycotina;Dothideomycetes;Pleosporales;Cucurbitariaceae;uncultured;";"0.0";"0";"2";"2";"0";"2";"0";"457181";"391207"
"V4mis2";"SILVA (only NR);Eukaryota;Amorphea;Obazoa;Opisthokonta;Nucletmycea;Fungi;Dikarya;Ascomycota;Pezizomycotina;Dothideomycetes;Pleosporales;Curreya;";"0.0";"0";"1";"1";"0";"1";"0";"457182";"391207"
"V4mis2";"SILVA (only NR);Eukaryota;Amorphea;Obazoa;Opisthokonta;Nucletmycea;Fungi;Dikarya;Ascomycota;Pezizomycotina;Dothideomycetes;Pleosporales;Cyclothyriella;";"0.0";"0";"1";"1";"0";"1";"0";"457182";"391207"
"V4mis2";"SILVA (only NR);Eukaryota;Amorphea;Obazoa;Opisthokonta;Nucletmycea;Fungi;Dikarya;Ascomycota;Pezizomycotina;Dothideomycetes;Pleosporales;Decaisnella;";"0.0";"0";"1";"1";"0";"1";"0";"457182";"391207"
"V4mis2";"SILVA (only NR);Eukaryota;Amorphea;Obazoa;Opisthokonta;Nucletmycea;Fungi;Dikarya;Ascomycota;Pezizomycotina;Dothideomycetes;Pleosporales;Delitschia;";"0.0";"0";"2";"2";"0";"2";"0";"457181";"391207"
"V4mis2";"SILVA (only NR);Eukaryota;Amorphea;Obazoa;Opisthokonta;Nucletmycea;Fungi;Dikarya;Ascomycota;Pezizomycotina;Dothideomycetes;Pleosporales;Didymellaceae;";"0.0";"0";"86";"82";"0";"82";"4";"457101";"391207"
"V4mis2";"SILVA (only NR);Eukaryota;Amorphea;Obazoa;Opisthokonta;Nucletmycea;Fungi;Dikarya;Ascomycota;Pezizomycotina;Dothideomycetes;Pleosporales;Didymellaceae;Ascochyta;";"0.0";"0";"9";"9";"0";"9";"0";"457174";"391207"
"V4mis2";"SILVA (only NR);Eukaryota;Amorphea;Obazoa;Opisthokonta;Nucletmycea;Fungi;Dikarya;Ascomycota;Pezizomycotina;Dothideomycetes;Pleosporales;Didymellaceae;Boeremia;";"0.0";"0";"63";"63";"0";"63";"0";"457120";"391207"
"V4mis2";"SILVA (only NR);Eukaryota;Amorphea;Obazoa;Opisthokonta;Nucletmycea;Fungi;Dikarya;Ascomycota;Pezizomycotina;Dothideomycetes;Pleosporales;Didymellaceae;Didymella;";"0.0";"0";"6";"2";"0";"2";"4";"457181";"391207"
"V4mis2";"SILVA (only NR);Eukaryota;Amorphea;Obazoa;Opisthokonta;Nucletmycea;Fungi;Dikarya;Ascomycota;Pezizomycotina;Dothideomycetes;Pleosporales;Didymellaceae;Neoascochyta;";"0.0";"0";"1";"1";"0";"1";"0";"457182";"391207"
"V4mis2";"SILVA (only NR);Eukaryota;Amorphea;Obazoa;Opisthokonta;Nucletmycea;Fungi;Dikarya;Ascomycota;Pezizomycotina;Dothideomycetes;Pleosporales;Didymellaceae;Phoma;";"0.0";"0";"5";"5";"0";"5";"0";"457178";"391207"
"V4mis2";"SILVA (only NR);Eukaryota;Amorphea;Obazoa;Opisthokonta;Nucletmycea;Fungi;Dikarya;Ascomycota;Pezizomycotina;Dothideomycetes;Pleosporales;Didymellaceae;Stagonosporopsis;";"0.0";"0";"1";"1";"0";"1";"0";"457182";"391207"
"V4mis2";"SILVA (only NR);Eukaryota;Amorphea;Obazoa;Opisthokonta;Nucletmycea;Fungi;Dikarya;Ascomycota;Pezizomycotina;Dothideomycetes;Pleosporales;Didymocrea;";"0.0";"0";"2";"2";"0";"2";"0";"457181";"391207"
"V4mis2";"SILVA (only NR);Eukaryota;Amorphea;Obazoa;Opisthokonta;Nucletmycea;Fungi;Dikarya;Ascomycota;Pezizomycotina;Dothideomycetes;Pleosporales;Didymosphaeriaceae;";"6.7";"14.4";"15";"15";"1";"14";"0";"457168";"391206"
"V4mis2";"SILVA (only NR);Eukaryota;Amorphea;Obazoa;Opisthokonta;Nucletmycea;Fungi;Dikarya;Ascomycota;Pezizomycotina;Dothideomycetes;Pleosporales;Didymosphaeriaceae;Bimuria;";"0.0";"0";"3";"3";"0";"3";"0";"457180";"391207"
"V4mis2";"SILVA (only NR);Eukaryota;Amorphea;Obazoa;Opisthokonta;Nucletmycea;Fungi;Dikarya;Ascomycota;Pezizomycotina;Dothideomycetes;Pleosporales;Didymosphaeriaceae;Didymosphaeria;";"0.0";"0";"1";"1";"0";"1";"0";"457182";"391207"
"V4mis2";"SILVA (only NR);Eukaryota;Amorphea;Obazoa;Opisthokonta;Nucletmycea;Fungi;Dikarya;Ascomycota;Pezizomycotina;Dothideomycetes;Pleosporales;Didymosphaeriaceae;Letendraea;";"0.0";"0";"1";"1";"0";"1";"0";"457182";"391207"
"V4mis2";"SILVA (only NR);Eukaryota;Amorphea;Obazoa;Opisthokonta;Nucletmycea;Fungi;Dikarya;Ascomycota;Pezizomycotina;Dothideomycetes;Pleosporales;Didymosphaeriaceae;Paraconiothyrium;";"0.0";"0";"1";"1";"0";"1";"0";"457182";"391207"
"V4mis2";"SILVA (only NR);Eukaryota;Amorphea;Obazoa;Opisthokonta;Nucletmycea;Fungi;Dikarya;Ascomycota;Pezizomycotina;Dothideomycetes;Pleosporales;Didymosphaeriaceae;Paraphaeosphaeria;";"0.0";"0";"3";"3";"0";"3";"0";"457180";"391207"
"V4mis2";"SILVA (only NR);Eukaryota;Amorphea;Obazoa;Opisthokonta;Nucletmycea;Fungi;Dikarya;Ascomycota;Pezizomycotina;Dothideomycetes;Pleosporales;Didymosphaeriaceae;Pseudocamarosporium;";"0.0";"0";"2";"2";"0";"2";"0";"457181";"391207"
"V4mis2";"SILVA (only NR);Eukaryota;Amorphea;Obazoa;Opisthokonta;Nucletmycea;Fungi;Dikarya;Ascomycota;Pezizomycotina;Dothideomycetes;Pleosporales;Halojulellaceae;";"0.0";"0";"2";"2";"0";"2";"0";"457181";"391207"
"V4mis2";"SILVA (only NR);Eukaryota;Amorphea;Obazoa;Opisthokonta;Nucletmycea;Fungi;Dikarya;Ascomycota;Pezizomycotina;Dothideomycetes;Pleosporales;Halojulellaceae;Halojulella;";"0.0";"0";"1";"1";"0";"1";"0";"457182";"391207"
"V4mis2";"SILVA (only NR);Eukaryota;Amorphea;Obazoa;Opisthokonta;Nucletmycea;Fungi;Dikarya;Ascomycota;Pezizomycotina;Dothideomycetes;Pleosporales;Halokirschsteiniothelia;";"0.0";"0";"1";"1";"0";"1";"0";"457182";"391207"
"V4mis2";"SILVA (only NR);Eukaryota;Amorphea;Obazoa;Opisthokonta;Nucletmycea;Fungi;Dikarya;Ascomycota;Pezizomycotina;Dothideomycetes;Pleosporales;Herpotrichia;";"0.0";"0";"3";"3";"0";"3";"0";"457180";"391207"
"V4mis2";"SILVA (only NR);Eukaryota;Amorphea;Obazoa;Opisthokonta;Nucletmycea;Fungi;Dikarya;Ascomycota;Pezizomycotina;Dothideomycetes;Pleosporales;Hypoderma;";"0.0";"0";"1";"1";"0";"1";"0";"457182";"391207"
"V4mis2";"SILVA (only NR);Eukaryota;Amorphea;Obazoa;Opisthokonta;Nucletmycea;Fungi;Dikarya;Ascomycota;Pezizomycotina;Dothideomycetes;Pleosporales;Incertae Sedis;";"0.0";"0";"24";"24";"0";"24";"0";"457159";"391207"
"V4mis2";"SILVA (only NR);Eukaryota;Amorphea;Obazoa;Opisthokonta;Nucletmycea;Fungi;Dikarya;Ascomycota;Pezizomycotina;Dothideomycetes;Pleosporales;Incertae Sedis;Astrosphaeriella;";"0.0";"0";"1";"1";"0";"1";"0";"457182";"391207"
"V4mis2";"SILVA (only NR);Eukaryota;Amorphea;Obazoa;Opisthokonta;Nucletmycea;Fungi;Dikarya;Ascomycota;Pezizomycotina;Dothideomycetes;Pleosporales;Incertae Sedis;Camarosporium;";"0.0";"0";"2";"2";"0";"2";"0";"457181";"391207"
"V4mis2";"SILVA (only NR);Eukaryota;Amorphea;Obazoa;Opisthokonta;Nucletmycea;Fungi;Dikarya;Ascomycota;Pezizomycotina;Dothideomycetes;Pleosporales;Incertae Sedis;Dictyosporium;";"0.0";"0";"3";"3";"0";"3";"0";"457180";"391207"
"V4mis2";"SILVA (only NR);Eukaryota;Amorphea;Obazoa;Opisthokonta;Nucletmycea;Fungi;Dikarya;Ascomycota;Pezizomycotina;Dothideomycetes;Pleosporales;Incertae Sedis;Heleiosa;";"0.0";"0";"1";"1";"0";"1";"0";"457182";"391207"
"V4mis2";"SILVA (only NR);Eukaryota;Amorphea;Obazoa;Opisthokonta;Nucletmycea;Fungi;Dikarya;Ascomycota;Pezizomycotina;Dothideomycetes;Pleosporales;Incertae Sedis;Microsphaeropsis;";"0.0";"0";"3";"3";"0";"3";"0";"457180";"391207"
"V4mis2";"SILVA (only NR);Eukaryota;Amorphea;Obazoa;Opisthokonta;Nucletmycea;Fungi;Dikarya;Ascomycota;Pezizomycotina;Dothideomycetes;Pleosporales;Incertae Sedis;Pleiochaeta;";"0.0";"0";"2";"2";"0";"2";"0";"457181";"391207"
"V4mis2";"SILVA (only NR);Eukaryota;Amorphea;Obazoa;Opisthokonta;Nucletmycea;Fungi;Dikarya;Ascomycota;Pezizomycotina;Dothideomycetes;Pleosporales;Incertae Sedis;Pseudodictyosporium;";"0.0";"0";"2";"2";"0";"2";"0";"457181";"391207"
"V4mis2";"SILVA (only NR);Eukaryota;Amorphea;Obazoa;Opisthokonta;Nucletmycea;Fungi;Dikarya;Ascomycota;Pezizomycotina;Dothideomycetes;Pleosporales;Incertae Sedis;Pseudorobillarda;";"0.0";"0";"1";"1";"0";"1";"0";"457182";"391207"
"V4mis2";"SILVA (only NR);Eukaryota;Amorphea;Obazoa;Opisthokonta;Nucletmycea;Fungi;Dikarya;Ascomycota;Pezizomycotina;Dothideomycetes;Pleosporales;Incertae Sedis;Shiraia;";"0.0";"0";"4";"4";"0";"4";"0";"457179";"391207"
"V4mis2";"SILVA (only NR);Eukaryota;Amorphea;Obazoa;Opisthokonta;Nucletmycea;Fungi;Dikarya;Ascomycota;Pezizomycotina;Dothideomycetes;Pleosporales;Incertae Sedis;uncultured;";"0.0";"0";"3";"3";"0";"3";"0";"457180";"391207"
"V4mis2";"SILVA (only NR);Eukaryota;Amorphea;Obazoa;Opisthokonta;Nucletmycea;Fungi;Dikarya;Ascomycota;Pezizomycotina;Dothideomycetes;Pleosporales;Lentithecium;";"0.0";"0";"1";"1";"0";"1";"0";"457182";"391207"
"V4mis2";"SILVA (only NR);Eukaryota;Amorphea;Obazoa;Opisthokonta;Nucletmycea;Fungi;Dikarya;Ascomycota;Pezizomycotina;Dothideomycetes;Pleosporales;Leptosphaeriaceae;";"12.7";"14.4";"63";"63";"8";"55";"0";"457120";"391199"
"V4mis2";"SILVA (only NR);Eukaryota;Amorphea;Obazoa;Opisthokonta;Nucletmycea;Fungi;Dikarya;Ascomycota;Pezizomycotina;Dothideomycetes;Pleosporales;Leptosphaeriaceae;Leptosphaeria;";"22.2";"14.4";"36";"36";"8";"28";"0";"457147";"391199"
"V4mis2";"SILVA (only NR);Eukaryota;Amorphea;Obazoa;Opisthokonta;Nucletmycea;Fungi;Dikarya;Ascomycota;Pezizomycotina;Dothideomycetes;Pleosporales;Leptosphaeriaceae;Neophaeosphaeria;";"0.0";"0";"27";"27";"0";"27";"0";"457156";"391207"
"V4mis2";"SILVA (only NR);Eukaryota;Amorphea;Obazoa;Opisthokonta;Nucletmycea;Fungi;Dikarya;Ascomycota;Pezizomycotina;Dothideomycetes;Pleosporales;Lophiostomataceae;";"0.0";"0";"3";"3";"0";"3";"0";"457180";"391207"
"V4mis2";"SILVA (only NR);Eukaryota;Amorphea;Obazoa;Opisthokonta;Nucletmycea;Fungi;Dikarya;Ascomycota;Pezizomycotina;Dothideomycetes;Pleosporales;Lophiostomataceae;Lophiostoma;";"0.0";"0";"2";"2";"0";"2";"0";"457181";"391207"
"V4mis2";"SILVA (only NR);Eukaryota;Amorphea;Obazoa;Opisthokonta;Nucletmycea;Fungi;Dikarya;Ascomycota;Pezizomycotina;Dothideomycetes;Pleosporales;Lophiostomataceae;Sigarispora;";"0.0";"0";"1";"1";"0";"1";"0";"457182";"391207"
"V4mis2";"SILVA (only NR);Eukaryota;Amorphea;Obazoa;Opisthokonta;Nucletmycea;Fungi;Dikarya;Ascomycota;Pezizomycotina;Dothideomycetes;Pleosporales;Massariaceae;";"0.0";"0";"4";"4";"0";"4";"0";"457179";"391207"
"V4mis2";"SILVA (only NR);Eukaryota;Amorphea;Obazoa;Opisthokonta;Nucletmycea;Fungi;Dikarya;Ascomycota;Pezizomycotina;Dothideomycetes;Pleosporales;Massariaceae;Massaria;";"0.0";"0";"4";"4";"0";"4";"0";"457179";"391207"
"V4mis2";"SILVA (only NR);Eukaryota;Amorphea;Obazoa;Opisthokonta;Nucletmycea;Fungi;Dikarya;Ascomycota;Pezizomycotina;Dothideomycetes;Pleosporales;Massarinaceae;";"0.0";"0";"4";"4";"0";"4";"0";"457179";"391207"
"V4mis2";"SILVA (only NR);Eukaryota;Amorphea;Obazoa;Opisthokonta;Nucletmycea;Fungi;Dikarya;Ascomycota;Pezizomycotina;Dothideomycetes;Pleosporales;Massarinaceae;Helminthosporium;";"0.0";"0";"3";"3";"0";"3";"0";"457180";"391207"
"V4mis2";"SILVA (only NR);Eukaryota;Amorphea;Obazoa;Opisthokonta;Nucletmycea;Fungi;Dikarya;Ascomycota;Pezizomycotina;Dothideomycetes;Pleosporales;Massarinaceae;Stagonospora;";"0.0";"0";"1";"1";"0";"1";"0";"457182";"391207"
"V4mis2";"SILVA (only NR);Eukaryota;Amorphea;Obazoa;Opisthokonta;Nucletmycea;Fungi;Dikarya;Ascomycota;Pezizomycotina;Dothideomycetes;Pleosporales;Morosphaeriaceae;";"0.0";"0";"9";"9";"0";"9";"0";"457174";"391207"
"V4mis2";"SILVA (only NR);Eukaryota;Amorphea;Obazoa;Opisthokonta;Nucletmycea;Fungi;Dikarya;Ascomycota;Pezizomycotina;Dothideomycetes;Pleosporales;Morosphaeriaceae;Helicascus;";"0.0";"0";"4";"4";"0";"4";"0";"457179";"391207"
"V4mis2";"SILVA (only NR);Eukaryota;Amorphea;Obazoa;Opisthokonta;Nucletmycea;Fungi;Dikarya;Ascomycota;Pezizomycotina;Dothideomycetes;Pleosporales;Morosphaeriaceae;Helicoon;";"0.0";"0";"1";"1";"0";"1";"0";"457182";"391207"
"V4mis2";"SILVA (only NR);Eukaryota;Amorphea;Obazoa;Opisthokonta;Nucletmycea;Fungi;Dikarya;Ascomycota;Pezizomycotina;Dothideomycetes;Pleosporales;Morosphaeriaceae;Morosphaeria;";"0.0";"0";"1";"1";"0";"1";"0";"457182";"391207"
"V4mis2";"SILVA (only NR);Eukaryota;Amorphea;Obazoa;Opisthokonta;Nucletmycea;Fungi;Dikarya;Ascomycota;Pezizomycotina;Dothideomycetes;Pleosporales;Periconia;";"0.0";"0";"1";"1";"0";"1";"0";"457182";"391207"
"V4mis2";"SILVA (only NR);Eukaryota;Amorphea;Obazoa;Opisthokonta;Nucletmycea;Fungi;Dikarya;Ascomycota;Pezizomycotina;Dothideomycetes;Pleosporales;Phaeosphaeriaceae;";"0.0";"0";"34";"33";"0";"33";"1";"457150";"391207"
"V4mis2";"SILVA (only NR);Eukaryota;Amorphea;Obazoa;Opisthokonta;Nucletmycea;Fungi;Dikarya;Ascomycota;Pezizomycotina;Dothideomycetes;Pleosporales;Phaeosphaeriaceae;Ophiosphaerella;";"0.0";"0";"8";"7";"0";"7";"1";"457176";"391207"
"V4mis2";"SILVA (only NR);Eukaryota;Amorphea;Obazoa;Opisthokonta;Nucletmycea;Fungi;Dikarya;Ascomycota;Pezizomycotina;Dothideomycetes;Pleosporales;Phaeosphaeriaceae;Parastagonospora;";"0.0";"0";"13";"13";"0";"13";"0";"457170";"391207"
"V4mis2";"SILVA (only NR);Eukaryota;Amorphea;Obazoa;Opisthokonta;Nucletmycea;Fungi;Dikarya;Ascomycota;Pezizomycotina;Dothideomycetes;Pleosporales;Phaeosphaeriaceae;Phaeodothis;";"0.0";"0";"4";"4";"0";"4";"0";"457179";"391207"
"V4mis2";"SILVA (only NR);Eukaryota;Amorphea;Obazoa;Opisthokonta;Nucletmycea;Fungi;Dikarya;Ascomycota;Pezizomycotina;Dothideomycetes;Pleosporales;Phaeosphaeriaceae;Phaeosphaeria;";"0.0";"0";"4";"4";"0";"4";"0";"457179";"391207"
"V4mis2";"SILVA (only NR);Eukaryota;Amorphea;Obazoa;Opisthokonta;Nucletmycea;Fungi;Dikarya;Ascomycota;Pezizomycotina;Dothideomycetes;Pleosporales;Phaeosphaeriaceae;Phaeosphaeriopsis;";"0.0";"0";"1";"1";"0";"1";"0";"457182";"391207"
"V4mis2";"SILVA (only NR);Eukaryota;Amorphea;Obazoa;Opisthokonta;Nucletmycea;Fungi;Dikarya;Ascomycota;Pezizomycotina;Dothideomycetes;Pleosporales;Phaeosphaeriaceae;Setomelanomma;";"0.0";"0";"2";"2";"0";"2";"0";"457181";"391207"
"V4mis2";"SILVA (only NR);Eukaryota;Amorphea;Obazoa;Opisthokonta;Nucletmycea;Fungi;Dikarya;Ascomycota;Pezizomycotina;Dothideomycetes;Pleosporales;Phaeosphaeriaceae;uncultured;";"0.0";"0";"2";"2";"0";"2";"0";"457181";"391207"
"V4mis2";"SILVA (only NR);Eukaryota;Amorphea;Obazoa;Opisthokonta;Nucletmycea;Fungi;Dikarya;Ascomycota;Pezizomycotina;Dothideomycetes;Pleosporales;Pleomassaria;";"0.0";"0";"1";"1";"0";"1";"0";"457182";"391207"
"V4mis2";"SILVA (only NR);Eukaryota;Amorphea;Obazoa;Opisthokonta;Nucletmycea;Fungi;Dikarya;Ascomycota;Pezizomycotina;Dothideomycetes;Pleosporales;Pleosporaceae;";"0.0";"0";"110";"109";"0";"109";"1";"457074";"391207"
"V4mis2";"SILVA (only NR);Eukaryota;Amorphea;Obazoa;Opisthokonta;Nucletmycea;Fungi;Dikarya;Ascomycota;Pezizomycotina;Dothideomycetes;Pleosporales;Pleosporaceae;Alternaria;";"0.0";"0";"27";"27";"0";"27";"0";"457156";"391207"
"V4mis2";"SILVA (only NR);Eukaryota;Amorphea;Obazoa;Opisthokonta;Nucletmycea;Fungi;Dikarya;Ascomycota;Pezizomycotina;Dothideomycetes;Pleosporales;Pleosporaceae;Bipolaris;";"0.0";"0";"34";"33";"0";"33";"1";"457150";"391207"
"V4mis2";"SILVA (only NR);Eukaryota;Amorphea;Obazoa;Opisthokonta;Nucletmycea;Fungi;Dikarya;Ascomycota;Pezizomycotina;Dothideomycetes;Pleosporales;Pleosporaceae;Curvularia;";"0.0";"0";"30";"30";"0";"30";"0";"457153";"391207"
"V4mis2";"SILVA (only NR);Eukaryota;Amorphea;Obazoa;Opisthokonta;Nucletmycea;Fungi;Dikarya;Ascomycota;Pezizomycotina;Dothideomycetes;Pleosporales;Pleosporaceae;Decorospora;";"0.0";"0";"1";"1";"0";"1";"0";"457182";"391207"
"V4mis2";"SILVA (only NR);Eukaryota;Amorphea;Obazoa;Opisthokonta;Nucletmycea;Fungi;Dikarya;Ascomycota;Pezizomycotina;Dothideomycetes;Pleosporales;Pleosporaceae;Drechslera;";"0.0";"0";"1";"1";"0";"1";"0";"457182";"391207"
"V4mis2";"SILVA (only NR);Eukaryota;Amorphea;Obazoa;Opisthokonta;Nucletmycea;Fungi;Dikarya;Ascomycota;Pezizomycotina;Dothideomycetes;Pleosporales;Pleosporaceae;Pleospora;";"0.0";"0";"5";"5";"0";"5";"0";"457178";"391207"
"V4mis2";"SILVA (only NR);Eukaryota;Amorphea;Obazoa;Opisthokonta;Nucletmycea;Fungi;Dikarya;Ascomycota;Pezizomycotina;Dothideomycetes;Pleosporales;Pleosporaceae;Pyrenophora;";"0.0";"0";"6";"6";"0";"6";"0";"457177";"391207"
"V4mis2";"SILVA (only NR);Eukaryota;Amorphea;Obazoa;Opisthokonta;Nucletmycea;Fungi;Dikarya;Ascomycota;Pezizomycotina;Dothideomycetes;Pleosporales;Pleosporaceae;Setosphaeria;";"0.0";"0";"4";"4";"0";"4";"0";"457179";"391207"
"V4mis2";"SILVA (only NR);Eukaryota;Amorphea;Obazoa;Opisthokonta;Nucletmycea;Fungi;Dikarya;Ascomycota;Pezizomycotina;Dothideomycetes;Pleosporales;Pseudochaetosphaeronema;";"0.0";"0";"1";"1";"0";"1";"0";"457182";"391207"
"V4mis2";"SILVA (only NR);Eukaryota;Amorphea;Obazoa;Opisthokonta;Nucletmycea;Fungi;Dikarya;Ascomycota;Pezizomycotina;Dothideomycetes;Pleosporales;Roussoellaceae;";"0.0";"0";"6";"6";"0";"6";"0";"457177";"391207"
"V4mis2";"SILVA (only NR);Eukaryota;Amorphea;Obazoa;Opisthokonta;Nucletmycea;Fungi;Dikarya;Ascomycota;Pezizomycotina;Dothideomycetes;Pleosporales;Roussoellaceae;Roussoella;";"0.0";"0";"6";"6";"0";"6";"0";"457177";"391207"
"V4mis2";"SILVA (only NR);Eukaryota;Amorphea;Obazoa;Opisthokonta;Nucletmycea;Fungi;Dikarya;Ascomycota;Pezizomycotina;Dothideomycetes;Pleosporales;Sporormiaceae;";"0.0";"0";"10";"10";"0";"10";"0";"457173";"391207"
"V4mis2";"SILVA (only NR);Eukaryota;Amorphea;Obazoa;Opisthokonta;Nucletmycea;Fungi;Dikarya;Ascomycota;Pezizomycotina;Dothideomycetes;Pleosporales;Sporormiaceae;Preussia;";"0.0";"0";"7";"7";"0";"7";"0";"457176";"391207"
"V4mis2";"SILVA (only NR);Eukaryota;Amorphea;Obazoa;Opisthokonta;Nucletmycea;Fungi;Dikarya;Ascomycota;Pezizomycotina;Dothideomycetes;Pleosporales;Sporormiaceae;Westerdykella;";"0.0";"0";"3";"3";"0";"3";"0";"457180";"391207"
"V4mis2";"SILVA (only NR);Eukaryota;Amorphea;Obazoa;Opisthokonta;Nucletmycea;Fungi;Dikarya;Ascomycota;Pezizomycotina;Dothideomycetes;Pleosporales;Teichospora;";"0.0";"0";"1";"1";"0";"1";"0";"457182";"391207"
"V4mis2";"SILVA (only NR);Eukaryota;Amorphea;Obazoa;Opisthokonta;Nucletmycea;Fungi;Dikarya;Ascomycota;Pezizomycotina;Dothideomycetes;Pleosporales;Testudinaceae;";"0.0";"0";"5";"5";"0";"5";"0";"457178";"391207"
"V4mis2";"SILVA (only NR);Eukaryota;Amorphea;Obazoa;Opisthokonta;Nucletmycea;Fungi;Dikarya;Ascomycota;Pezizomycotina;Dothideomycetes;Pleosporales;Testudinaceae;Lepidosphaeria;";"0.0";"0";"1";"1";"0";"1";"0";"457182";"391207"
"V4mis2";"SILVA (only NR);Eukaryota;Amorphea;Obazoa;Opisthokonta;Nucletmycea;Fungi;Dikarya;Ascomycota;Pezizomycotina;Dothideomycetes;Pleosporales;Testudinaceae;Neotestudina;";"0.0";"0";"2";"2";"0";"2";"0";"457181";"391207"
"V4mis2";"SILVA (only NR);Eukaryota;Amorphea;Obazoa;Opisthokonta;Nucletmycea;Fungi;Dikarya;Ascomycota;Pezizomycotina;Dothideomycetes;Pleosporales;Testudinaceae;Ulospora;";"0.0";"0";"2";"2";"0";"2";"0";"457181";"391207"
"V4mis2";"SILVA (only NR);Eukaryota;Amorphea;Obazoa;Opisthokonta;Nucletmycea;Fungi;Dikarya;Ascomycota;Pezizomycotina;Dothideomycetes;Pleosporales;Torula;";"0.0";"0";"1";"1";"0";"1";"0";"457182";"391207"
"V4mis2";"SILVA (only NR);Eukaryota;Amorphea;Obazoa;Opisthokonta;Nucletmycea;Fungi;Dikarya;Ascomycota;Pezizomycotina;Dothideomycetes;Pleosporales;Trematosphaeria;";"0.0";"0";"2";"2";"0";"2";"0";"457181";"391207"
"V4mis2";"SILVA (only NR);Eukaryota;Amorphea;Obazoa;Opisthokonta;Nucletmycea;Fungi;Dikarya;Ascomycota;Pezizomycotina;Dothideomycetes;Pleosporales;Trematosphaeriaceae;";"0.0";"0";"2";"2";"0";"2";"0";"457181";"391207"
"V4mis2";"SILVA (only NR);Eukaryota;Amorphea;Obazoa;Opisthokonta;Nucletmycea;Fungi;Dikarya;Ascomycota;Pezizomycotina;Dothideomycetes;Pleosporales;Trematosphaeriaceae;Falciformispora;";"0.0";"0";"1";"1";"0";"1";"0";"457182";"391207"
"V4mis2";"SILVA (only NR);Eukaryota;Amorphea;Obazoa;Opisthokonta;Nucletmycea;Fungi;Dikarya;Ascomycota;Pezizomycotina;Dothideomycetes;Pleosporales;Zopfia;";"0.0";"0";"1";"1";"0";"1";"0";"457182";"391207"
"V4mis2";"SILVA (only NR);Eukaryota;Amorphea;Obazoa;Opisthokonta;Nucletmycea;Fungi;Dikarya;Ascomycota;Pezizomycotina;Dothideomycetes;Pleosporales;uncultured;";"0.0";"0";"31";"31";"0";"31";"0";"457152";"391207"
"V4mis2";"SILVA (only NR);Eukaryota;Amorphea;Obazoa;Opisthokonta;Nucletmycea;Fungi;Dikarya;Ascomycota;Pezizomycotina;Dothideomycetes;Stigmatodiscales;";"0.0";"0";"5";"5";"0";"5";"0";"457178";"391207"
"V4mis2";"SILVA (only NR);Eukaryota;Amorphea;Obazoa;Opisthokonta;Nucletmycea;Fungi;Dikarya;Ascomycota;Pezizomycotina;Dothideomycetes;Stigmatodiscales;Stigmatodiscaceae;";"0.0";"0";"5";"5";"0";"5";"0";"457178";"391207"
"V4mis2";"SILVA (only NR);Eukaryota;Amorphea;Obazoa;Opisthokonta;Nucletmycea;Fungi;Dikarya;Ascomycota;Pezizomycotina;Dothideomycetes;Stigmatodiscales;Stigmatodiscaceae;Asterodiscus;";"0.0";"0";"1";"1";"0";"1";"0";"457182";"391207"
"V4mis2";"SILVA (only NR);Eukaryota;Amorphea;Obazoa;Opisthokonta;Nucletmycea;Fungi;Dikarya;Ascomycota;Pezizomycotina;Dothideomycetes;Stigmatodiscales;Stigmatodiscaceae;Stigmatodiscus;";"0.0";"0";"2";"2";"0";"2";"0";"457181";"391207"
"V4mis2";"SILVA (only NR);Eukaryota;Amorphea;Obazoa;Opisthokonta;Nucletmycea;Fungi;Dikarya;Ascomycota;Pezizomycotina;Dothideomycetes;Stigmatodiscales;Stigmatodiscaceae;uncultured;";"0.0";"0";"2";"2";"0";"2";"0";"457181";"391207"
"V4mis2";"SILVA (only NR);Eukaryota;Amorphea;Obazoa;Opisthokonta;Nucletmycea;Fungi;Dikarya;Ascomycota;Pezizomycotina;Dothideomycetes;Tubeufiales;";"0.0";"0";"32";"32";"0";"32";"0";"457151";"391207"
"V4mis2";"SILVA (only NR);Eukaryota;Amorphea;Obazoa;Opisthokonta;Nucletmycea;Fungi;Dikarya;Ascomycota;Pezizomycotina;Dothideomycetes;Tubeufiales;Tubeufiaceae;";"0.0";"0";"31";"31";"0";"31";"0";"457152";"391207"
"V4mis2";"SILVA (only NR);Eukaryota;Amorphea;Obazoa;Opisthokonta;Nucletmycea;Fungi;Dikarya;Ascomycota;Pezizomycotina;Dothideomycetes;Tubeufiales;Tubeufiaceae;Acanthostigma;";"0.0";"0";"1";"1";"0";"1";"0";"457182";"391207"
"V4mis2";"SILVA (only NR);Eukaryota;Amorphea;Obazoa;Opisthokonta;Nucletmycea;Fungi;Dikarya;Ascomycota;Pezizomycotina;Dothideomycetes;Tubeufiales;Tubeufiaceae;Aquaphila;";"0.0";"0";"1";"1";"0";"1";"0";"457182";"391207"
"V4mis2";"SILVA (only NR);Eukaryota;Amorphea;Obazoa;Opisthokonta;Nucletmycea;Fungi;Dikarya;Ascomycota;Pezizomycotina;Dothideomycetes;Tubeufiales;Tubeufiaceae;Helicoma;";"0.0";"0";"11";"11";"0";"11";"0";"457172";"391207"
"V4mis2";"SILVA (only NR);Eukaryota;Amorphea;Obazoa;Opisthokonta;Nucletmycea;Fungi;Dikarya;Ascomycota;Pezizomycotina;Dothideomycetes;Tubeufiales;Tubeufiaceae;Helicomyces;";"0.0";"0";"4";"4";"0";"4";"0";"457179";"391207"
"V4mis2";"SILVA (only NR);Eukaryota;Amorphea;Obazoa;Opisthokonta;Nucletmycea;Fungi;Dikarya;Ascomycota;Pezizomycotina;Dothideomycetes;Tubeufiales;Tubeufiaceae;Helicosporium;";"0.0";"0";"7";"7";"0";"7";"0";"457176";"391207"
"V4mis2";"SILVA (only NR);Eukaryota;Amorphea;Obazoa;Opisthokonta;Nucletmycea;Fungi;Dikarya;Ascomycota;Pezizomycotina;Dothideomycetes;Tubeufiales;Tubeufiaceae;Tubeufia;";"0.0";"0";"7";"7";"0";"7";"0";"457176";"391207"
"V4mis2";"SILVA (only NR);Eukaryota;Amorphea;Obazoa;Opisthokonta;Nucletmycea;Fungi;Dikarya;Ascomycota;Pezizomycotina;Dothideomycetes;Tubeufiales;Wiesneriomyces;";"0.0";"0";"1";"1";"0";"1";"0";"457182";"391207"
"V4mis2";"SILVA (only NR);Eukaryota;Amorphea;Obazoa;Opisthokonta;Nucletmycea;Fungi;Dikarya;Ascomycota;Pezizomycotina;Dothideomycetes;Valsariales;";"0.0";"0";"4";"4";"0";"4";"0";"457179";"391207"
"V4mis2";"SILVA (only NR);Eukaryota;Amorphea;Obazoa;Opisthokonta;Nucletmycea;Fungi;Dikarya;Ascomycota;Pezizomycotina;Dothideomycetes;Valsariales;Valsariaceae;";"0.0";"0";"4";"4";"0";"4";"0";"457179";"391207"
"V4mis2";"SILVA (only NR);Eukaryota;Amorphea;Obazoa;Opisthokonta;Nucletmycea;Fungi;Dikarya;Ascomycota;Pezizomycotina;Dothideomycetes;Valsariales;Valsariaceae;Myrmaecium;";"0.0";"0";"1";"1";"0";"1";"0";"457182";"391207"
"V4mis2";"SILVA (only NR);Eukaryota;Amorphea;Obazoa;Opisthokonta;Nucletmycea;Fungi;Dikarya;Ascomycota;Pezizomycotina;Dothideomycetes;Valsariales;Valsariaceae;Valsaria;";"0.0";"0";"3";"3";"0";"3";"0";"457180";"391207"
"V4mis2";"SILVA (only NR);Eukaryota;Amorphea;Obazoa;Opisthokonta;Nucletmycea;Fungi;Dikarya;Ascomycota;Pezizomycotina;Dothideomycetes;Venturiales;";"0.0";"0";"33";"33";"0";"33";"0";"457150";"391207"
"V4mis2";"SILVA (only NR);Eukaryota;Amorphea;Obazoa;Opisthokonta;Nucletmycea;Fungi;Dikarya;Ascomycota;Pezizomycotina;Dothideomycetes;Venturiales;Sympoventuriaceae;";"0.0";"0";"28";"28";"0";"28";"0";"457155";"391207"
"V4mis2";"SILVA (only NR);Eukaryota;Amorphea;Obazoa;Opisthokonta;Nucletmycea;Fungi;Dikarya;Ascomycota;Pezizomycotina;Dothideomycetes;Venturiales;Sympoventuriaceae;Fusicladium;";"0.0";"0";"1";"1";"0";"1";"0";"457182";"391207"
"V4mis2";"SILVA (only NR);Eukaryota;Amorphea;Obazoa;Opisthokonta;Nucletmycea;Fungi;Dikarya;Ascomycota;Pezizomycotina;Dothideomycetes;Venturiales;Sympoventuriaceae;Mycosisymbrium;";"0.0";"0";"1";"1";"0";"1";"0";"457182";"391207"
"V4mis2";"SILVA (only NR);Eukaryota;Amorphea;Obazoa;Opisthokonta;Nucletmycea;Fungi;Dikarya;Ascomycota;Pezizomycotina;Dothideomycetes;Venturiales;Sympoventuriaceae;Ochroconis;";"0.0";"0";"20";"20";"0";"20";"0";"457163";"391207"
"V4mis2";"SILVA (only NR);Eukaryota;Amorphea;Obazoa;Opisthokonta;Nucletmycea;Fungi;Dikarya;Ascomycota;Pezizomycotina;Dothideomycetes;Venturiales;Sympoventuriaceae;Veronaeopsis;";"0.0";"0";"1";"1";"0";"1";"0";"457182";"391207"
"V4mis2";"SILVA (only NR);Eukaryota;Amorphea;Obazoa;Opisthokonta;Nucletmycea;Fungi;Dikarya;Ascomycota;Pezizomycotina;Dothideomycetes;Venturiales;Sympoventuriaceae;Verruconis;";"0.0";"0";"2";"2";"0";"2";"0";"457181";"391207"
"V4mis2";"SILVA (only NR);Eukaryota;Amorphea;Obazoa;Opisthokonta;Nucletmycea;Fungi;Dikarya;Ascomycota;Pezizomycotina;Dothideomycetes;Venturiales;Sympoventuriaceae;uncultured;";"0.0";"0";"2";"2";"0";"2";"0";"457181";"391207"
"V4mis2";"SILVA (only NR);Eukaryota;Amorphea;Obazoa;Opisthokonta;Nucletmycea;Fungi;Dikarya;Ascomycota;Pezizomycotina;Dothideomycetes;Venturiales;Venturiaceae;";"0.0";"0";"5";"5";"0";"5";"0";"457178";"391207"
"V4mis2";"SILVA (only NR);Eukaryota;Amorphea;Obazoa;Opisthokonta;Nucletmycea;Fungi;Dikarya;Ascomycota;Pezizomycotina;Dothideomycetes;Venturiales;Venturiaceae;Venturia;";"0.0";"0";"5";"5";"0";"5";"0";"457178";"391207"
"V4mis2";"SILVA (only NR);Eukaryota;Amorphea;Obazoa;Opisthokonta;Nucletmycea;Fungi;Dikarya;Ascomycota;Pezizomycotina;Dothideomycetes;uncultured;";"0.0";"0";"8";"8";"0";"8";"0";"457175";"391207"
"V4mis2";"SILVA (only NR);Eukaryota;Amorphea;Obazoa;Opisthokonta;Nucletmycea;Fungi;Dikarya;Ascomycota;Pezizomycotina;Eurotiomycetes;";"0.1";"14.3";"833";"827";"1";"826";"6";"456356";"391206"
"V4mis2";"SILVA (only NR);Eukaryota;Amorphea;Obazoa;Opisthokonta;Nucletmycea;Fungi;Dikarya;Ascomycota;Pezizomycotina;Eurotiomycetes;Chaetothyriales;";"0.6";"14.4";"176";"176";"1";"175";"0";"457007";"391206"
"V4mis2";"SILVA (only NR);Eukaryota;Amorphea;Obazoa;Opisthokonta;Nucletmycea;Fungi;Dikarya;Ascomycota;Pezizomycotina;Eurotiomycetes;Chaetothyriales;Chaetothyriaceae;";"0.0";"0";"4";"4";"0";"4";"0";"457179";"391207"
"V4mis2";"SILVA (only NR);Eukaryota;Amorphea;Obazoa;Opisthokonta;Nucletmycea;Fungi;Dikarya;Ascomycota;Pezizomycotina;Eurotiomycetes;Chaetothyriales;Chaetothyriaceae;Camptophora;";"0.0";"0";"2";"2";"0";"2";"0";"457181";"391207"
"V4mis2";"SILVA (only NR);Eukaryota;Amorphea;Obazoa;Opisthokonta;Nucletmycea;Fungi;Dikarya;Ascomycota;Pezizomycotina;Eurotiomycetes;Chaetothyriales;Chaetothyriaceae;Ceramothyrium;";"0.0";"0";"2";"2";"0";"2";"0";"457181";"391207"
"V4mis2";"SILVA (only NR);Eukaryota;Amorphea;Obazoa;Opisthokonta;Nucletmycea;Fungi;Dikarya;Ascomycota;Pezizomycotina;Eurotiomycetes;Chaetothyriales;Cyphellophoraceae;";"0.0";"0";"17";"17";"0";"17";"0";"457166";"391207"
"V4mis2";"SILVA (only NR);Eukaryota;Amorphea;Obazoa;Opisthokonta;Nucletmycea;Fungi;Dikarya;Ascomycota;Pezizomycotina;Eurotiomycetes;Chaetothyriales;Cyphellophoraceae;Cyphellophora;";"0.0";"0";"17";"17";"0";"17";"0";"457166";"391207"
"V4mis2";"SILVA (only NR);Eukaryota;Amorphea;Obazoa;Opisthokonta;Nucletmycea;Fungi;Dikarya;Ascomycota;Pezizomycotina;Eurotiomycetes;Chaetothyriales;Herpotrichiellaceae;";"0.9";"14.4";"109";"109";"1";"108";"0";"457074";"391206"
"V4mis2";"SILVA (only NR);Eukaryota;Amorphea;Obazoa;Opisthokonta;Nucletmycea;Fungi;Dikarya;Ascomycota;Pezizomycotina;Eurotiomycetes;Chaetothyriales;Herpotrichiellaceae;Berlesiella;";"0.0";"0";"1";"1";"0";"1";"0";"457182";"391207"
"V4mis2";"SILVA (only NR);Eukaryota;Amorphea;Obazoa;Opisthokonta;Nucletmycea;Fungi;Dikarya;Ascomycota;Pezizomycotina;Eurotiomycetes;Chaetothyriales;Herpotrichiellaceae;Capronia;";"0.0";"0";"15";"15";"0";"15";"0";"457168";"391207"
"V4mis2";"SILVA (only NR);Eukaryota;Amorphea;Obazoa;Opisthokonta;Nucletmycea;Fungi;Dikarya;Ascomycota;Pezizomycotina;Eurotiomycetes;Chaetothyriales;Herpotrichiellaceae;Cladophialophora;";"4.0";"14.4";"25";"25";"1";"24";"0";"457158";"391206"
"V4mis2";"SILVA (only NR);Eukaryota;Amorphea;Obazoa;Opisthokonta;Nucletmycea;Fungi;Dikarya;Ascomycota;Pezizomycotina;Eurotiomycetes;Chaetothyriales;Herpotrichiellaceae;Exophiala;";"0.0";"0";"44";"44";"0";"44";"0";"457139";"391207"
"V4mis2";"SILVA (only NR);Eukaryota;Amorphea;Obazoa;Opisthokonta;Nucletmycea;Fungi;Dikarya;Ascomycota;Pezizomycotina;Eurotiomycetes;Chaetothyriales;Herpotrichiellaceae;Fonsecaea;";"0.0";"0";"9";"9";"0";"9";"0";"457174";"391207"
"V4mis2";"SILVA (only NR);Eukaryota;Amorphea;Obazoa;Opisthokonta;Nucletmycea;Fungi;Dikarya;Ascomycota;Pezizomycotina;Eurotiomycetes;Chaetothyriales;Herpotrichiellaceae;Phialophora;";"0.0";"0";"5";"5";"0";"5";"0";"457178";"391207"
"V4mis2";"SILVA (only NR);Eukaryota;Amorphea;Obazoa;Opisthokonta;Nucletmycea;Fungi;Dikarya;Ascomycota;Pezizomycotina;Eurotiomycetes;Chaetothyriales;Herpotrichiellaceae;Rhinocladiella;";"0.0";"0";"5";"5";"0";"5";"0";"457178";"391207"
"V4mis2";"SILVA (only NR);Eukaryota;Amorphea;Obazoa;Opisthokonta;Nucletmycea;Fungi;Dikarya;Ascomycota;Pezizomycotina;Eurotiomycetes;Chaetothyriales;Herpotrichiellaceae;Veronaea;";"0.0";"0";"1";"1";"0";"1";"0";"457182";"391207"
"V4mis2";"SILVA (only NR);Eukaryota;Amorphea;Obazoa;Opisthokonta;Nucletmycea;Fungi;Dikarya;Ascomycota;Pezizomycotina;Eurotiomycetes;Chaetothyriales;Herpotrichiellaceae;uncultured;";"0.0";"0";"2";"2";"0";"2";"0";"457181";"391207"
"V4mis2";"SILVA (only NR);Eukaryota;Amorphea;Obazoa;Opisthokonta;Nucletmycea;Fungi;Dikarya;Ascomycota;Pezizomycotina;Eurotiomycetes;Chaetothyriales;Trichomeriaceae;";"0.0";"0";"34";"34";"0";"34";"0";"457149";"391207"
"V4mis2";"SILVA (only NR);Eukaryota;Amorphea;Obazoa;Opisthokonta;Nucletmycea;Fungi;Dikarya;Ascomycota;Pezizomycotina;Eurotiomycetes;Chaetothyriales;Trichomeriaceae;Bacillicladium;";"0.0";"0";"1";"1";"0";"1";"0";"457182";"391207"
"V4mis2";"SILVA (only NR);Eukaryota;Amorphea;Obazoa;Opisthokonta;Nucletmycea;Fungi;Dikarya;Ascomycota;Pezizomycotina;Eurotiomycetes;Chaetothyriales;Trichomeriaceae;Bradymyces;";"0.0";"0";"10";"10";"0";"10";"0";"457173";"391207"
"V4mis2";"SILVA (only NR);Eukaryota;Amorphea;Obazoa;Opisthokonta;Nucletmycea;Fungi;Dikarya;Ascomycota;Pezizomycotina;Eurotiomycetes;Chaetothyriales;Trichomeriaceae;Knufia;";"0.0";"0";"18";"18";"0";"18";"0";"457165";"391207"
"V4mis2";"SILVA (only NR);Eukaryota;Amorphea;Obazoa;Opisthokonta;Nucletmycea;Fungi;Dikarya;Ascomycota;Pezizomycotina;Eurotiomycetes;Chaetothyriales;Trichomeriaceae;Neophaeococcomyces;";"0.0";"0";"1";"1";"0";"1";"0";"457182";"391207"
"V4mis2";"SILVA (only NR);Eukaryota;Amorphea;Obazoa;Opisthokonta;Nucletmycea;Fungi;Dikarya;Ascomycota;Pezizomycotina;Eurotiomycetes;Chaetothyriales;Trichomeriaceae;uncultured;";"0.0";"0";"2";"2";"0";"2";"0";"457181";"391207"
"V4mis2";"SILVA (only NR);Eukaryota;Amorphea;Obazoa;Opisthokonta;Nucletmycea;Fungi;Dikarya;Ascomycota;Pezizomycotina;Eurotiomycetes;Chaetothyriales;uncultured;";"0.0";"0";"8";"8";"0";"8";"0";"457175";"391207"
"V4mis2";"SILVA (only NR);Eukaryota;Amorphea;Obazoa;Opisthokonta;Nucletmycea;Fungi;Dikarya;Ascomycota;Pezizomycotina;Eurotiomycetes;Coryneliales;";"0.0";"0";"5";"5";"0";"5";"0";"457178";"391207"
"V4mis2";"SILVA (only NR);Eukaryota;Amorphea;Obazoa;Opisthokonta;Nucletmycea;Fungi;Dikarya;Ascomycota;Pezizomycotina;Eurotiomycetes;Coryneliales;Coryneliaceae;";"0.0";"0";"5";"5";"0";"5";"0";"457178";"391207"
"V4mis2";"SILVA (only NR);Eukaryota;Amorphea;Obazoa;Opisthokonta;Nucletmycea;Fungi;Dikarya;Ascomycota;Pezizomycotina;Eurotiomycetes;Coryneliales;Coryneliaceae;Caliciopsis;";"0.0";"0";"2";"2";"0";"2";"0";"457181";"391207"
"V4mis2";"SILVA (only NR);Eukaryota;Amorphea;Obazoa;Opisthokonta;Nucletmycea;Fungi;Dikarya;Ascomycota;Pezizomycotina;Eurotiomycetes;Coryneliales;Coryneliaceae;Corynelia;";"0.0";"0";"2";"2";"0";"2";"0";"457181";"391207"
"V4mis2";"SILVA (only NR);Eukaryota;Amorphea;Obazoa;Opisthokonta;Nucletmycea;Fungi;Dikarya;Ascomycota;Pezizomycotina;Eurotiomycetes;Coryneliales;Coryneliaceae;Lagenulopsis;";"0.0";"0";"1";"1";"0";"1";"0";"457182";"391207"
"V4mis2";"SILVA (only NR);Eukaryota;Amorphea;Obazoa;Opisthokonta;Nucletmycea;Fungi;Dikarya;Ascomycota;Pezizomycotina;Eurotiomycetes;Eurotiales;";"0.0";"0";"440";"435";"0";"435";"5";"456748";"391207"
"V4mis2";"SILVA (only NR);Eukaryota;Amorphea;Obazoa;Opisthokonta;Nucletmycea;Fungi;Dikarya;Ascomycota;Pezizomycotina;Eurotiomycetes;Eurotiales;Aspergillaceae;";"0.0";"0";"304";"299";"0";"299";"5";"456884";"391207"
"V4mis2";"SILVA (only NR);Eukaryota;Amorphea;Obazoa;Opisthokonta;Nucletmycea;Fungi;Dikarya;Ascomycota;Pezizomycotina;Eurotiomycetes;Eurotiales;Aspergillaceae;Aspergillus;";"0.0";"0";"201";"196";"0";"196";"5";"456987";"391207"
"V4mis2";"SILVA (only NR);Eukaryota;Amorphea;Obazoa;Opisthokonta;Nucletmycea;Fungi;Dikarya;Ascomycota;Pezizomycotina;Eurotiomycetes;Eurotiales;Aspergillaceae;Chromocleista;";"0.0";"0";"2";"2";"0";"2";"0";"457181";"391207"
"V4mis2";"SILVA (only NR);Eukaryota;Amorphea;Obazoa;Opisthokonta;Nucletmycea;Fungi;Dikarya;Ascomycota;Pezizomycotina;Eurotiomycetes;Eurotiales;Aspergillaceae;Eurotium;";"0.0";"0";"1";"1";"0";"1";"0";"457182";"391207"
"V4mis2";"SILVA (only NR);Eukaryota;Amorphea;Obazoa;Opisthokonta;Nucletmycea;Fungi;Dikarya;Ascomycota;Pezizomycotina;Eurotiomycetes;Eurotiales;Aspergillaceae;Hamigera;";"0.0";"0";"3";"3";"0";"3";"0";"457180";"391207"
"V4mis2";"SILVA (only NR);Eukaryota;Amorphea;Obazoa;Opisthokonta;Nucletmycea;Fungi;Dikarya;Ascomycota;Pezizomycotina;Eurotiomycetes;Eurotiales;Aspergillaceae;Leiothecium;";"0.0";"0";"2";"2";"0";"2";"0";"457181";"391207"
"V4mis2";"SILVA (only NR);Eukaryota;Amorphea;Obazoa;Opisthokonta;Nucletmycea;Fungi;Dikarya;Ascomycota;Pezizomycotina;Eurotiomycetes;Eurotiales;Aspergillaceae;Merimbla;";"0.0";"0";"1";"1";"0";"1";"0";"457182";"391207"
"V4mis2";"SILVA (only NR);Eukaryota;Amorphea;Obazoa;Opisthokonta;Nucletmycea;Fungi;Dikarya;Ascomycota;Pezizomycotina;Eurotiomycetes;Eurotiales;Aspergillaceae;Monascus;";"0.0";"0";"8";"8";"0";"8";"0";"457175";"391207"
"V4mis2";"SILVA (only NR);Eukaryota;Amorphea;Obazoa;Opisthokonta;Nucletmycea;Fungi;Dikarya;Ascomycota;Pezizomycotina;Eurotiomycetes;Eurotiales;Aspergillaceae;Penicilliopsis;";"0.0";"0";"5";"5";"0";"5";"0";"457178";"391207"
"V4mis2";"SILVA (only NR);Eukaryota;Amorphea;Obazoa;Opisthokonta;Nucletmycea;Fungi;Dikarya;Ascomycota;Pezizomycotina;Eurotiomycetes;Eurotiales;Aspergillaceae;Penicillium;";"0.0";"0";"60";"60";"0";"60";"0";"457123";"391207"
"V4mis2";"SILVA (only NR);Eukaryota;Amorphea;Obazoa;Opisthokonta;Nucletmycea;Fungi;Dikarya;Ascomycota;Pezizomycotina;Eurotiomycetes;Eurotiales;Aspergillaceae;Sclerocleista;";"0.0";"0";"3";"3";"0";"3";"0";"457180";"391207"
"V4mis2";"SILVA (only NR);Eukaryota;Amorphea;Obazoa;Opisthokonta;Nucletmycea;Fungi;Dikarya;Ascomycota;Pezizomycotina;Eurotiomycetes;Eurotiales;Aspergillaceae;Thysanophora;";"0.0";"0";"10";"10";"0";"10";"0";"457173";"391207"
"V4mis2";"SILVA (only NR);Eukaryota;Amorphea;Obazoa;Opisthokonta;Nucletmycea;Fungi;Dikarya;Ascomycota;Pezizomycotina;Eurotiomycetes;Eurotiales;Aspergillaceae;Warcupiella;";"0.0";"0";"2";"2";"0";"2";"0";"457181";"391207"
"V4mis2";"SILVA (only NR);Eukaryota;Amorphea;Obazoa;Opisthokonta;Nucletmycea;Fungi;Dikarya;Ascomycota;Pezizomycotina;Eurotiomycetes;Eurotiales;Aspergillaceae;Xerochrysium;";"0.0";"0";"1";"1";"0";"1";"0";"457182";"391207"
"V4mis2";"SILVA (only NR);Eukaryota;Amorphea;Obazoa;Opisthokonta;Nucletmycea;Fungi;Dikarya;Ascomycota;Pezizomycotina;Eurotiomycetes;Eurotiales;Aspergillaceae;Xeromyces;";"0.0";"0";"3";"3";"0";"3";"0";"457180";"391207"
"V4mis2";"SILVA (only NR);Eukaryota;Amorphea;Obazoa;Opisthokonta;Nucletmycea;Fungi;Dikarya;Ascomycota;Pezizomycotina;Eurotiomycetes;Eurotiales;Elaphomycetaceae;";"0.0";"0";"4";"4";"0";"4";"0";"457179";"391207"
"V4mis2";"SILVA (only NR);Eukaryota;Amorphea;Obazoa;Opisthokonta;Nucletmycea;Fungi;Dikarya;Ascomycota;Pezizomycotina;Eurotiomycetes;Eurotiales;Elaphomycetaceae;Elaphomyces;";"0.0";"0";"2";"2";"0";"2";"0";"457181";"391207"
"V4mis2";"SILVA (only NR);Eukaryota;Amorphea;Obazoa;Opisthokonta;Nucletmycea;Fungi;Dikarya;Ascomycota;Pezizomycotina;Eurotiomycetes;Eurotiales;Elaphomycetaceae;Pseudotulostoma;";"0.0";"0";"2";"2";"0";"2";"0";"457181";"391207"
"V4mis2";"SILVA (only NR);Eukaryota;Amorphea;Obazoa;Opisthokonta;Nucletmycea;Fungi;Dikarya;Ascomycota;Pezizomycotina;Eurotiomycetes;Eurotiales;Incertae Sedis;";"0.0";"0";"2";"2";"0";"2";"0";"457181";"391207"
"V4mis2";"SILVA (only NR);Eukaryota;Amorphea;Obazoa;Opisthokonta;Nucletmycea;Fungi;Dikarya;Ascomycota;Pezizomycotina;Eurotiomycetes;Eurotiales;Incertae Sedis;Eladia;";"0.0";"0";"2";"2";"0";"2";"0";"457181";"391207"
"V4mis2";"SILVA (only NR);Eukaryota;Amorphea;Obazoa;Opisthokonta;Nucletmycea;Fungi;Dikarya;Ascomycota;Pezizomycotina;Eurotiomycetes;Eurotiales;Thermoascaceae;";"0.0";"0";"17";"17";"0";"17";"0";"457166";"391207"
"V4mis2";"SILVA (only NR);Eukaryota;Amorphea;Obazoa;Opisthokonta;Nucletmycea;Fungi;Dikarya;Ascomycota;Pezizomycotina;Eurotiomycetes;Eurotiales;Thermoascaceae;Byssochlamys;";"0.0";"0";"13";"13";"0";"13";"0";"457170";"391207"
"V4mis2";"SILVA (only NR);Eukaryota;Amorphea;Obazoa;Opisthokonta;Nucletmycea;Fungi;Dikarya;Ascomycota;Pezizomycotina;Eurotiomycetes;Eurotiales;Thermoascaceae;Thermoascus;";"0.0";"0";"4";"4";"0";"4";"0";"457179";"391207"
"V4mis2";"SILVA (only NR);Eukaryota;Amorphea;Obazoa;Opisthokonta;Nucletmycea;Fungi;Dikarya;Ascomycota;Pezizomycotina;Eurotiomycetes;Eurotiales;Trichocomaceae;";"0.0";"0";"110";"110";"0";"110";"0";"457073";"391207"
"V4mis2";"SILVA (only NR);Eukaryota;Amorphea;Obazoa;Opisthokonta;Nucletmycea;Fungi;Dikarya;Ascomycota;Pezizomycotina;Eurotiomycetes;Eurotiales;Trichocomaceae;Rasamsonia;";"0.0";"0";"6";"6";"0";"6";"0";"457177";"391207"
"V4mis2";"SILVA (only NR);Eukaryota;Amorphea;Obazoa;Opisthokonta;Nucletmycea;Fungi;Dikarya;Ascomycota;Pezizomycotina;Eurotiomycetes;Eurotiales;Trichocomaceae;Sagenomella;";"0.0";"0";"6";"6";"0";"6";"0";"457177";"391207"
"V4mis2";"SILVA (only NR);Eukaryota;Amorphea;Obazoa;Opisthokonta;Nucletmycea;Fungi;Dikarya;Ascomycota;Pezizomycotina;Eurotiomycetes;Eurotiales;Trichocomaceae;Talaromyces;";"0.0";"0";"91";"91";"0";"91";"0";"457092";"391207"
"V4mis2";"SILVA (only NR);Eukaryota;Amorphea;Obazoa;Opisthokonta;Nucletmycea;Fungi;Dikarya;Ascomycota;Pezizomycotina;Eurotiomycetes;Eurotiales;Trichocomaceae;Thermomyces;";"0.0";"0";"3";"3";"0";"3";"0";"457180";"391207"
"V4mis2";"SILVA (only NR);Eukaryota;Amorphea;Obazoa;Opisthokonta;Nucletmycea;Fungi;Dikarya;Ascomycota;Pezizomycotina;Eurotiomycetes;Eurotiales;Trichocomaceae;Trichocoma;";"0.0";"0";"3";"3";"0";"3";"0";"457180";"391207"
"V4mis2";"SILVA (only NR);Eukaryota;Amorphea;Obazoa;Opisthokonta;Nucletmycea;Fungi;Dikarya;Ascomycota;Pezizomycotina;Eurotiomycetes;Incertae Sedis;";"0.0";"0";"3";"3";"0";"3";"0";"457180";"391207"
"V4mis2";"SILVA (only NR);Eukaryota;Amorphea;Obazoa;Opisthokonta;Nucletmycea;Fungi;Dikarya;Ascomycota;Pezizomycotina;Eurotiomycetes;Incertae Sedis;Incertae Sedis;";"0.0";"0";"1";"1";"0";"1";"0";"457182";"391207"
"V4mis2";"SILVA (only NR);Eukaryota;Amorphea;Obazoa;Opisthokonta;Nucletmycea;Fungi;Dikarya;Ascomycota;Pezizomycotina;Eurotiomycetes;Incertae Sedis;Incertae Sedis;Pseudospiromastix;";"0.0";"0";"1";"1";"0";"1";"0";"457182";"391207"
"V4mis2";"SILVA (only NR);Eukaryota;Amorphea;Obazoa;Opisthokonta;Nucletmycea;Fungi;Dikarya;Ascomycota;Pezizomycotina;Eurotiomycetes;Incertae Sedis;Rhynchostomataceae;";"0.0";"0";"2";"2";"0";"2";"0";"457181";"391207"
"V4mis2";"SILVA (only NR);Eukaryota;Amorphea;Obazoa;Opisthokonta;Nucletmycea;Fungi;Dikarya;Ascomycota;Pezizomycotina;Eurotiomycetes;Incertae Sedis;Rhynchostomataceae;Rhynchostoma;";"0.0";"0";"2";"2";"0";"2";"0";"457181";"391207"
"V4mis2";"SILVA (only NR);Eukaryota;Amorphea;Obazoa;Opisthokonta;Nucletmycea;Fungi;Dikarya;Ascomycota;Pezizomycotina;Eurotiomycetes;Mycocaliciales;";"0.0";"0";"4";"4";"0";"4";"0";"457179";"391207"
"V4mis2";"SILVA (only NR);Eukaryota;Amorphea;Obazoa;Opisthokonta;Nucletmycea;Fungi;Dikarya;Ascomycota;Pezizomycotina;Eurotiomycetes;Mycocaliciales;Mycocaliciaceae;";"0.0";"0";"3";"3";"0";"3";"0";"457180";"391207"
"V4mis2";"SILVA (only NR);Eukaryota;Amorphea;Obazoa;Opisthokonta;Nucletmycea;Fungi;Dikarya;Ascomycota;Pezizomycotina;Eurotiomycetes;Mycocaliciales;Mycocaliciaceae;Chaenothecopsis;";"0.0";"0";"1";"1";"0";"1";"0";"457182";"391207"
"V4mis2";"SILVA (only NR);Eukaryota;Amorphea;Obazoa;Opisthokonta;Nucletmycea;Fungi;Dikarya;Ascomycota;Pezizomycotina;Eurotiomycetes;Mycocaliciales;Mycocaliciaceae;Mycocalicium;";"0.0";"0";"1";"1";"0";"1";"0";"457182";"391207"
"V4mis2";"SILVA (only NR);Eukaryota;Amorphea;Obazoa;Opisthokonta;Nucletmycea;Fungi;Dikarya;Ascomycota;Pezizomycotina;Eurotiomycetes;Mycocaliciales;Mycocaliciaceae;Stenocybe;";"0.0";"0";"1";"1";"0";"1";"0";"457182";"391207"
"V4mis2";"SILVA (only NR);Eukaryota;Amorphea;Obazoa;Opisthokonta;Nucletmycea;Fungi;Dikarya;Ascomycota;Pezizomycotina;Eurotiomycetes;Mycocaliciales;Sphinctrina;";"0.0";"0";"1";"1";"0";"1";"0";"457182";"391207"
"V4mis2";"SILVA (only NR);Eukaryota;Amorphea;Obazoa;Opisthokonta;Nucletmycea;Fungi;Dikarya;Ascomycota;Pezizomycotina;Eurotiomycetes;Onygenales;";"0.0";"0";"150";"150";"0";"150";"0";"457033";"391207"
"V4mis2";"SILVA (only NR);Eukaryota;Amorphea;Obazoa;Opisthokonta;Nucletmycea;Fungi;Dikarya;Ascomycota;Pezizomycotina;Eurotiomycetes;Onygenales;Ajellomycetaceae;";"0.0";"0";"19";"19";"0";"19";"0";"457164";"391207"
"V4mis2";"SILVA (only NR);Eukaryota;Amorphea;Obazoa;Opisthokonta;Nucletmycea;Fungi;Dikarya;Ascomycota;Pezizomycotina;Eurotiomycetes;Onygenales;Ajellomycetaceae;Blastomyces;";"0.0";"0";"6";"6";"0";"6";"0";"457177";"391207"
"V4mis2";"SILVA (only NR);Eukaryota;Amorphea;Obazoa;Opisthokonta;Nucletmycea;Fungi;Dikarya;Ascomycota;Pezizomycotina;Eurotiomycetes;Onygenales;Ajellomycetaceae;Helicocarpus;";"0.0";"0";"1";"1";"0";"1";"0";"457182";"391207"
"V4mis2";"SILVA (only NR);Eukaryota;Amorphea;Obazoa;Opisthokonta;Nucletmycea;Fungi;Dikarya;Ascomycota;Pezizomycotina;Eurotiomycetes;Onygenales;Ajellomycetaceae;Histoplasma;";"0.0";"0";"8";"8";"0";"8";"0";"457175";"391207"
"V4mis2";"SILVA (only NR);Eukaryota;Amorphea;Obazoa;Opisthokonta;Nucletmycea;Fungi;Dikarya;Ascomycota;Pezizomycotina;Eurotiomycetes;Onygenales;Ajellomycetaceae;Lacazia;";"0.0";"0";"2";"2";"0";"2";"0";"457181";"391207"
"V4mis2";"SILVA (only NR);Eukaryota;Amorphea;Obazoa;Opisthokonta;Nucletmycea;Fungi;Dikarya;Ascomycota;Pezizomycotina;Eurotiomycetes;Onygenales;Ajellomycetaceae;Paracoccidioides;";"0.0";"0";"2";"2";"0";"2";"0";"457181";"391207"
"V4mis2";"SILVA (only NR);Eukaryota;Amorphea;Obazoa;Opisthokonta;Nucletmycea;Fungi;Dikarya;Ascomycota;Pezizomycotina;Eurotiomycetes;Onygenales;Amaurascopsis;";"0.0";"0";"1";"1";"0";"1";"0";"457182";"391207"
"V4mis2";"SILVA (only NR);Eukaryota;Amorphea;Obazoa;Opisthokonta;Nucletmycea;Fungi;Dikarya;Ascomycota;Pezizomycotina;Eurotiomycetes;Onygenales;Arachnomycetaceae;";"0.0";"0";"8";"8";"0";"8";"0";"457175";"391207"
"V4mis2";"SILVA (only NR);Eukaryota;Amorphea;Obazoa;Opisthokonta;Nucletmycea;Fungi;Dikarya;Ascomycota;Pezizomycotina;Eurotiomycetes;Onygenales;Arachnomycetaceae;Arachnomyces;";"0.0";"0";"8";"8";"0";"8";"0";"457175";"391207"
"V4mis2";"SILVA (only NR);Eukaryota;Amorphea;Obazoa;Opisthokonta;Nucletmycea;Fungi;Dikarya;Ascomycota;Pezizomycotina;Eurotiomycetes;Onygenales;Arthrodermataceae;";"0.0";"0";"29";"29";"0";"29";"0";"457154";"391207"
"V4mis2";"SILVA (only NR);Eukaryota;Amorphea;Obazoa;Opisthokonta;Nucletmycea;Fungi;Dikarya;Ascomycota;Pezizomycotina;Eurotiomycetes;Onygenales;Arthrodermataceae;Arthroderma;";"0.0";"0";"10";"10";"0";"10";"0";"457173";"391207"
"V4mis2";"SILVA (only NR);Eukaryota;Amorphea;Obazoa;Opisthokonta;Nucletmycea;Fungi;Dikarya;Ascomycota;Pezizomycotina;Eurotiomycetes;Onygenales;Arthrodermataceae;Ctenomyces;";"0.0";"0";"3";"3";"0";"3";"0";"457180";"391207"
"V4mis2";"SILVA (only NR);Eukaryota;Amorphea;Obazoa;Opisthokonta;Nucletmycea;Fungi;Dikarya;Ascomycota;Pezizomycotina;Eurotiomycetes;Onygenales;Arthrodermataceae;Epidermophyton;";"0.0";"0";"1";"1";"0";"1";"0";"457182";"391207"
"V4mis2";"SILVA (only NR);Eukaryota;Amorphea;Obazoa;Opisthokonta;Nucletmycea;Fungi;Dikarya;Ascomycota;Pezizomycotina;Eurotiomycetes;Onygenales;Arthrodermataceae;Microsporum;";"0.0";"0";"4";"4";"0";"4";"0";"457179";"391207"
"V4mis2";"SILVA (only NR);Eukaryota;Amorphea;Obazoa;Opisthokonta;Nucletmycea;Fungi;Dikarya;Ascomycota;Pezizomycotina;Eurotiomycetes;Onygenales;Arthrodermataceae;Nannizzia;";"0.0";"0";"1";"1";"0";"1";"0";"457182";"391207"
"V4mis2";"SILVA (only NR);Eukaryota;Amorphea;Obazoa;Opisthokonta;Nucletmycea;Fungi;Dikarya;Ascomycota;Pezizomycotina;Eurotiomycetes;Onygenales;Arthrodermataceae;Trichophyton;";"0.0";"0";"10";"10";"0";"10";"0";"457173";"391207"
"V4mis2";"SILVA (only NR);Eukaryota;Amorphea;Obazoa;Opisthokonta;Nucletmycea;Fungi;Dikarya;Ascomycota;Pezizomycotina;Eurotiomycetes;Onygenales;Ascosphaeraceae;";"0.0";"0";"6";"6";"0";"6";"0";"457177";"391207"
"V4mis2";"SILVA (only NR);Eukaryota;Amorphea;Obazoa;Opisthokonta;Nucletmycea;Fungi;Dikarya;Ascomycota;Pezizomycotina;Eurotiomycetes;Onygenales;Ascosphaeraceae;Ascosphaera;";"0.0";"0";"6";"6";"0";"6";"0";"457177";"391207"
"V4mis2";"SILVA (only NR);Eukaryota;Amorphea;Obazoa;Opisthokonta;Nucletmycea;Fungi;Dikarya;Ascomycota;Pezizomycotina;Eurotiomycetes;Onygenales;Auxarthronopsis;";"0.0";"0";"1";"1";"0";"1";"0";"457182";"391207"
"V4mis2";"SILVA (only NR);Eukaryota;Amorphea;Obazoa;Opisthokonta;Nucletmycea;Fungi;Dikarya;Ascomycota;Pezizomycotina;Eurotiomycetes;Onygenales;Eremascaceae;";"0.0";"0";"2";"2";"0";"2";"0";"457181";"391207"
"V4mis2";"SILVA (only NR);Eukaryota;Amorphea;Obazoa;Opisthokonta;Nucletmycea;Fungi;Dikarya;Ascomycota;Pezizomycotina;Eurotiomycetes;Onygenales;Eremascaceae;Eremascus;";"0.0";"0";"2";"2";"0";"2";"0";"457181";"391207"
"V4mis2";"SILVA (only NR);Eukaryota;Amorphea;Obazoa;Opisthokonta;Nucletmycea;Fungi;Dikarya;Ascomycota;Pezizomycotina;Eurotiomycetes;Onygenales;Gymnoascaceae;";"0.0";"0";"12";"12";"0";"12";"0";"457171";"391207"
"V4mis2";"SILVA (only NR);Eukaryota;Amorphea;Obazoa;Opisthokonta;Nucletmycea;Fungi;Dikarya;Ascomycota;Pezizomycotina;Eurotiomycetes;Onygenales;Gymnoascaceae;Arachniotus;";"0.0";"0";"2";"2";"0";"2";"0";"457181";"391207"
"V4mis2";"SILVA (only NR);Eukaryota;Amorphea;Obazoa;Opisthokonta;Nucletmycea;Fungi;Dikarya;Ascomycota;Pezizomycotina;Eurotiomycetes;Onygenales;Gymnoascaceae;Gymnascella;";"0.0";"0";"3";"3";"0";"3";"0";"457180";"391207"
"V4mis2";"SILVA (only NR);Eukaryota;Amorphea;Obazoa;Opisthokonta;Nucletmycea;Fungi;Dikarya;Ascomycota;Pezizomycotina;Eurotiomycetes;Onygenales;Gymnoascaceae;Gymnoascus;";"0.0";"0";"6";"6";"0";"6";"0";"457177";"391207"
"V4mis2";"SILVA (only NR);Eukaryota;Amorphea;Obazoa;Opisthokonta;Nucletmycea;Fungi;Dikarya;Ascomycota;Pezizomycotina;Eurotiomycetes;Onygenales;Gymnoascaceae;Kraurogymnocarpa;";"0.0";"0";"1";"1";"0";"1";"0";"457182";"391207"
"V4mis2";"SILVA (only NR);Eukaryota;Amorphea;Obazoa;Opisthokonta;Nucletmycea;Fungi;Dikarya;Ascomycota;Pezizomycotina;Eurotiomycetes;Onygenales;Incertae Sedis;";"0.0";"0";"16";"16";"0";"16";"0";"457167";"391207"
"V4mis2";"SILVA (only NR);Eukaryota;Amorphea;Obazoa;Opisthokonta;Nucletmycea;Fungi;Dikarya;Ascomycota;Pezizomycotina;Eurotiomycetes;Onygenales;Incertae Sedis;Coccidioides;";"0.0";"0";"14";"14";"0";"14";"0";"457169";"391207"
"V4mis2";"SILVA (only NR);Eukaryota;Amorphea;Obazoa;Opisthokonta;Nucletmycea;Fungi;Dikarya;Ascomycota;Pezizomycotina;Eurotiomycetes;Onygenales;Incertae Sedis;Spiromastix;";"0.0";"0";"2";"2";"0";"2";"0";"457181";"391207"
"V4mis2";"SILVA (only NR);Eukaryota;Amorphea;Obazoa;Opisthokonta;Nucletmycea;Fungi;Dikarya;Ascomycota;Pezizomycotina;Eurotiomycetes;Onygenales;Leucothecium;";"0.0";"0";"1";"1";"0";"1";"0";"457182";"391207"
"V4mis2";"SILVA (only NR);Eukaryota;Amorphea;Obazoa;Opisthokonta;Nucletmycea;Fungi;Dikarya;Ascomycota;Pezizomycotina;Eurotiomycetes;Onygenales;Nannizziopsiaceae;";"0.0";"0";"4";"4";"0";"4";"0";"457179";"391207"
"V4mis2";"SILVA (only NR);Eukaryota;Amorphea;Obazoa;Opisthokonta;Nucletmycea;Fungi;Dikarya;Ascomycota;Pezizomycotina;Eurotiomycetes;Onygenales;Nannizziopsiaceae;Nannizziopsis;";"0.0";"0";"2";"2";"0";"2";"0";"457181";"391207"
"V4mis2";"SILVA (only NR);Eukaryota;Amorphea;Obazoa;Opisthokonta;Nucletmycea;Fungi;Dikarya;Ascomycota;Pezizomycotina;Eurotiomycetes;Onygenales;Nannizziopsiaceae;Paranannizziopsis;";"0.0";"0";"2";"2";"0";"2";"0";"457181";"391207"
"V4mis2";"SILVA (only NR);Eukaryota;Amorphea;Obazoa;Opisthokonta;Nucletmycea;Fungi;Dikarya;Ascomycota;Pezizomycotina;Eurotiomycetes;Onygenales;Onygenaceae;";"0.0";"0";"50";"50";"0";"50";"0";"457133";"391207"
"V4mis2";"SILVA (only NR);Eukaryota;Amorphea;Obazoa;Opisthokonta;Nucletmycea;Fungi;Dikarya;Ascomycota;Pezizomycotina;Eurotiomycetes;Onygenales;Onygenaceae;Aphanoascus;";"0.0";"0";"13";"13";"0";"13";"0";"457170";"391207"
"V4mis2";"SILVA (only NR);Eukaryota;Amorphea;Obazoa;Opisthokonta;Nucletmycea;Fungi;Dikarya;Ascomycota;Pezizomycotina;Eurotiomycetes;Onygenales;Onygenaceae;Apinisia;";"0.0";"0";"1";"1";"0";"1";"0";"457182";"391207"
"V4mis2";"SILVA (only NR);Eukaryota;Amorphea;Obazoa;Opisthokonta;Nucletmycea;Fungi;Dikarya;Ascomycota;Pezizomycotina;Eurotiomycetes;Onygenales;Onygenaceae;Ascocalvatia;";"0.0";"0";"1";"1";"0";"1";"0";"457182";"391207"
"V4mis2";"SILVA (only NR);Eukaryota;Amorphea;Obazoa;Opisthokonta;Nucletmycea;Fungi;Dikarya;Ascomycota;Pezizomycotina;Eurotiomycetes;Onygenales;Onygenaceae;Auxarthron;";"0.0";"0";"15";"15";"0";"15";"0";"457168";"391207"
"V4mis2";"SILVA (only NR);Eukaryota;Amorphea;Obazoa;Opisthokonta;Nucletmycea;Fungi;Dikarya;Ascomycota;Pezizomycotina;Eurotiomycetes;Onygenales;Onygenaceae;Chlamydosauromyces;";"0.0";"0";"1";"1";"0";"1";"0";"457182";"391207"
"V4mis2";"SILVA (only NR);Eukaryota;Amorphea;Obazoa;Opisthokonta;Nucletmycea;Fungi;Dikarya;Ascomycota;Pezizomycotina;Eurotiomycetes;Onygenales;Onygenaceae;Chrysosporium;";"0.0";"0";"3";"3";"0";"3";"0";"457180";"391207"
"V4mis2";"SILVA (only NR);Eukaryota;Amorphea;Obazoa;Opisthokonta;Nucletmycea;Fungi;Dikarya;Ascomycota;Pezizomycotina;Eurotiomycetes;Onygenales;Onygenaceae;Onygena;";"0.0";"0";"2";"2";"0";"2";"0";"457181";"391207"
"V4mis2";"SILVA (only NR);Eukaryota;Amorphea;Obazoa;Opisthokonta;Nucletmycea;Fungi;Dikarya;Ascomycota;Pezizomycotina;Eurotiomycetes;Onygenales;Onygenaceae;Ophidiomyces;";"0.0";"0";"1";"1";"0";"1";"0";"457182";"391207"
"V4mis2";"SILVA (only NR);Eukaryota;Amorphea;Obazoa;Opisthokonta;Nucletmycea;Fungi;Dikarya;Ascomycota;Pezizomycotina;Eurotiomycetes;Onygenales;Onygenaceae;Pectinotrichum;";"0.0";"0";"2";"2";"0";"2";"0";"457181";"391207"
"V4mis2";"SILVA (only NR);Eukaryota;Amorphea;Obazoa;Opisthokonta;Nucletmycea;Fungi;Dikarya;Ascomycota;Pezizomycotina;Eurotiomycetes;Onygenales;Onygenaceae;Pseudoamauroascus;";"0.0";"0";"1";"1";"0";"1";"0";"457182";"391207"
"V4mis2";"SILVA (only NR);Eukaryota;Amorphea;Obazoa;Opisthokonta;Nucletmycea;Fungi;Dikarya;Ascomycota;Pezizomycotina;Eurotiomycetes;Onygenales;Onygenaceae;Renispora;";"0.0";"0";"2";"2";"0";"2";"0";"457181";"391207"
"V4mis2";"SILVA (only NR);Eukaryota;Amorphea;Obazoa;Opisthokonta;Nucletmycea;Fungi;Dikarya;Ascomycota;Pezizomycotina;Eurotiomycetes;Onygenales;Onygenaceae;Shanorella;";"0.0";"0";"1";"1";"0";"1";"0";"457182";"391207"
"V4mis2";"SILVA (only NR);Eukaryota;Amorphea;Obazoa;Opisthokonta;Nucletmycea;Fungi;Dikarya;Ascomycota;Pezizomycotina;Eurotiomycetes;Onygenales;Onygenaceae;Uncinocarpus;";"0.0";"0";"7";"7";"0";"7";"0";"457176";"391207"
"V4mis2";"SILVA (only NR);Eukaryota;Amorphea;Obazoa;Opisthokonta;Nucletmycea;Fungi;Dikarya;Ascomycota;Pezizomycotina;Eurotiomycetes;Phaeomoniellales;";"0.0";"0";"3";"3";"0";"3";"0";"457180";"391207"
"V4mis2";"SILVA (only NR);Eukaryota;Amorphea;Obazoa;Opisthokonta;Nucletmycea;Fungi;Dikarya;Ascomycota;Pezizomycotina;Eurotiomycetes;Phaeomoniellales;Incertae Sedis;";"0.0";"0";"3";"3";"0";"3";"0";"457180";"391207"
"V4mis2";"SILVA (only NR);Eukaryota;Amorphea;Obazoa;Opisthokonta;Nucletmycea;Fungi;Dikarya;Ascomycota;Pezizomycotina;Eurotiomycetes;Phaeomoniellales;Incertae Sedis;Aequabiliella;";"0.0";"0";"1";"1";"0";"1";"0";"457182";"391207"
"V4mis2";"SILVA (only NR);Eukaryota;Amorphea;Obazoa;Opisthokonta;Nucletmycea;Fungi;Dikarya;Ascomycota;Pezizomycotina;Eurotiomycetes;Phaeomoniellales;Incertae Sedis;Neophaeomoniella;";"0.0";"0";"1";"1";"0";"1";"0";"457182";"391207"
"V4mis2";"SILVA (only NR);Eukaryota;Amorphea;Obazoa;Opisthokonta;Nucletmycea;Fungi;Dikarya;Ascomycota;Pezizomycotina;Eurotiomycetes;Phaeomoniellales;Incertae Sedis;Phaeomoniella;";"0.0";"0";"1";"1";"0";"1";"0";"457182";"391207"
"V4mis2";"SILVA (only NR);Eukaryota;Amorphea;Obazoa;Opisthokonta;Nucletmycea;Fungi;Dikarya;Ascomycota;Pezizomycotina;Eurotiomycetes;Pyrenulales;";"0.0";"0";"1";"1";"0";"1";"0";"457182";"391207"
"V4mis2";"SILVA (only NR);Eukaryota;Amorphea;Obazoa;Opisthokonta;Nucletmycea;Fungi;Dikarya;Ascomycota;Pezizomycotina;Eurotiomycetes;Pyrenulales;Pyrenulaceae;";"0.0";"0";"1";"1";"0";"1";"0";"457182";"391207"
"V4mis2";"SILVA (only NR);Eukaryota;Amorphea;Obazoa;Opisthokonta;Nucletmycea;Fungi;Dikarya;Ascomycota;Pezizomycotina;Eurotiomycetes;Pyrenulales;Pyrenulaceae;Pyrgillus;";"0.0";"0";"1";"1";"0";"1";"0";"457182";"391207"
"V4mis2";"SILVA (only NR);Eukaryota;Amorphea;Obazoa;Opisthokonta;Nucletmycea;Fungi;Dikarya;Ascomycota;Pezizomycotina;Eurotiomycetes;Verrucariales;";"0.0";"0";"47";"47";"0";"47";"0";"457136";"391207"
"V4mis2";"SILVA (only NR);Eukaryota;Amorphea;Obazoa;Opisthokonta;Nucletmycea;Fungi;Dikarya;Ascomycota;Pezizomycotina;Eurotiomycetes;Verrucariales;Verrucariaceae;";"0.0";"0";"47";"47";"0";"47";"0";"457136";"391207"
"V4mis2";"SILVA (only NR);Eukaryota;Amorphea;Obazoa;Opisthokonta;Nucletmycea;Fungi;Dikarya;Ascomycota;Pezizomycotina;Eurotiomycetes;Verrucariales;Verrucariaceae;Bagliettoa;";"0.0";"0";"2";"2";"0";"2";"0";"457181";"391207"
"V4mis2";"SILVA (only NR);Eukaryota;Amorphea;Obazoa;Opisthokonta;Nucletmycea;Fungi;Dikarya;Ascomycota;Pezizomycotina;Eurotiomycetes;Verrucariales;Verrucariaceae;Catapyrenium;";"0.0";"0";"2";"2";"0";"2";"0";"457181";"391207"
"V4mis2";"SILVA (only NR);Eukaryota;Amorphea;Obazoa;Opisthokonta;Nucletmycea;Fungi;Dikarya;Ascomycota;Pezizomycotina;Eurotiomycetes;Verrucariales;Verrucariaceae;Dermatocarpon;";"0.0";"0";"2";"2";"0";"2";"0";"457181";"391207"
"V4mis2";"SILVA (only NR);Eukaryota;Amorphea;Obazoa;Opisthokonta;Nucletmycea;Fungi;Dikarya;Ascomycota;Pezizomycotina;Eurotiomycetes;Verrucariales;Verrucariaceae;Endocarpon;";"0.0";"0";"1";"1";"0";"1";"0";"457182";"391207"
"V4mis2";"SILVA (only NR);Eukaryota;Amorphea;Obazoa;Opisthokonta;Nucletmycea;Fungi;Dikarya;Ascomycota;Pezizomycotina;Eurotiomycetes;Verrucariales;Verrucariaceae;Flakea;";"0.0";"0";"1";"1";"0";"1";"0";"457182";"391207"
"V4mis2";"SILVA (only NR);Eukaryota;Amorphea;Obazoa;Opisthokonta;Nucletmycea;Fungi;Dikarya;Ascomycota;Pezizomycotina;Eurotiomycetes;Verrucariales;Verrucariaceae;Heteroplacidium;";"0.0";"0";"3";"3";"0";"3";"0";"457180";"391207"
"V4mis2";"SILVA (only NR);Eukaryota;Amorphea;Obazoa;Opisthokonta;Nucletmycea;Fungi;Dikarya;Ascomycota;Pezizomycotina;Eurotiomycetes;Verrucariales;Verrucariaceae;Hydropunctaria;";"0.0";"0";"2";"2";"0";"2";"0";"457181";"391207"
"V4mis2";"SILVA (only NR);Eukaryota;Amorphea;Obazoa;Opisthokonta;Nucletmycea;Fungi;Dikarya;Ascomycota;Pezizomycotina;Eurotiomycetes;Verrucariales;Verrucariaceae;Normandina;";"0.0";"0";"2";"2";"0";"2";"0";"457181";"391207"
"V4mis2";"SILVA (only NR);Eukaryota;Amorphea;Obazoa;Opisthokonta;Nucletmycea;Fungi;Dikarya;Ascomycota;Pezizomycotina;Eurotiomycetes;Verrucariales;Verrucariaceae;Norrlinia;";"0.0";"0";"1";"1";"0";"1";"0";"457182";"391207"
"V4mis2";"SILVA (only NR);Eukaryota;Amorphea;Obazoa;Opisthokonta;Nucletmycea;Fungi;Dikarya;Ascomycota;Pezizomycotina;Eurotiomycetes;Verrucariales;Verrucariaceae;Parabagliettoa;";"0.0";"0";"2";"2";"0";"2";"0";"457181";"391207"
"V4mis2";"SILVA (only NR);Eukaryota;Amorphea;Obazoa;Opisthokonta;Nucletmycea;Fungi;Dikarya;Ascomycota;Pezizomycotina;Eurotiomycetes;Verrucariales;Verrucariaceae;Placidiopsis;";"0.0";"0";"2";"2";"0";"2";"0";"457181";"391207"
"V4mis2";"SILVA (only NR);Eukaryota;Amorphea;Obazoa;Opisthokonta;Nucletmycea;Fungi;Dikarya;Ascomycota;Pezizomycotina;Eurotiomycetes;Verrucariales;Verrucariaceae;Placidium;";"0.0";"0";"4";"4";"0";"4";"0";"457179";"391207"
"V4mis2";"SILVA (only NR);Eukaryota;Amorphea;Obazoa;Opisthokonta;Nucletmycea;Fungi;Dikarya;Ascomycota;Pezizomycotina;Eurotiomycetes;Verrucariales;Verrucariaceae;Placocarpus;";"0.0";"0";"1";"1";"0";"1";"0";"457182";"391207"
"V4mis2";"SILVA (only NR);Eukaryota;Amorphea;Obazoa;Opisthokonta;Nucletmycea;Fungi;Dikarya;Ascomycota;Pezizomycotina;Eurotiomycetes;Verrucariales;Verrucariaceae;Placopyrenium;";"0.0";"0";"2";"2";"0";"2";"0";"457181";"391207"
"V4mis2";"SILVA (only NR);Eukaryota;Amorphea;Obazoa;Opisthokonta;Nucletmycea;Fungi;Dikarya;Ascomycota;Pezizomycotina;Eurotiomycetes;Verrucariales;Verrucariaceae;Staurothele;";"0.0";"0";"2";"2";"0";"2";"0";"457181";"391207"
"V4mis2";"SILVA (only NR);Eukaryota;Amorphea;Obazoa;Opisthokonta;Nucletmycea;Fungi;Dikarya;Ascomycota;Pezizomycotina;Eurotiomycetes;Verrucariales;Verrucariaceae;Thelidium;";"0.0";"0";"2";"2";"0";"2";"0";"457181";"391207"
"V4mis2";"SILVA (only NR);Eukaryota;Amorphea;Obazoa;Opisthokonta;Nucletmycea;Fungi;Dikarya;Ascomycota;Pezizomycotina;Eurotiomycetes;Verrucariales;Verrucariaceae;Verrucaria;";"0.0";"0";"8";"8";"0";"8";"0";"457175";"391207"
"V4mis2";"SILVA (only NR);Eukaryota;Amorphea;Obazoa;Opisthokonta;Nucletmycea;Fungi;Dikarya;Ascomycota;Pezizomycotina;Eurotiomycetes;Verrucariales;Verrucariaceae;Verrucula;";"0.0";"0";"2";"2";"0";"2";"0";"457181";"391207"
"V4mis2";"SILVA (only NR);Eukaryota;Amorphea;Obazoa;Opisthokonta;Nucletmycea;Fungi;Dikarya;Ascomycota;Pezizomycotina;Eurotiomycetes;Verrucariales;Verrucariaceae;Verruculopsis;";"0.0";"0";"1";"1";"0";"1";"0";"457182";"391207"
"V4mis2";"SILVA (only NR);Eukaryota;Amorphea;Obazoa;Opisthokonta;Nucletmycea;Fungi;Dikarya;Ascomycota;Pezizomycotina;Eurotiomycetes;Verrucariales;Verrucariaceae;Wahlenbergiella;";"0.0";"0";"2";"2";"0";"2";"0";"457181";"391207"
"V4mis2";"SILVA (only NR);Eukaryota;Amorphea;Obazoa;Opisthokonta;Nucletmycea;Fungi;Dikarya;Ascomycota;Pezizomycotina;Eurotiomycetes;Verrucariales;Verrucariaceae;uncultured;";"0.0";"0";"2";"2";"0";"2";"0";"457181";"391207"
"V4mis2";"SILVA (only NR);Eukaryota;Amorphea;Obazoa;Opisthokonta;Nucletmycea;Fungi;Dikarya;Ascomycota;Pezizomycotina;Geoglossomycetes;";"0.0";"0";"2";"2";"0";"2";"0";"457181";"391207"
"V4mis2";"SILVA (only NR);Eukaryota;Amorphea;Obazoa;Opisthokonta;Nucletmycea;Fungi;Dikarya;Ascomycota;Pezizomycotina;Geoglossomycetes;Geoglossales;";"0.0";"0";"2";"2";"0";"2";"0";"457181";"391207"
"V4mis2";"SILVA (only NR);Eukaryota;Amorphea;Obazoa;Opisthokonta;Nucletmycea;Fungi;Dikarya;Ascomycota;Pezizomycotina;Geoglossomycetes;Geoglossales;Geoglossaceae;";"0.0";"0";"2";"2";"0";"2";"0";"457181";"391207"
"V4mis2";"SILVA (only NR);Eukaryota;Amorphea;Obazoa;Opisthokonta;Nucletmycea;Fungi;Dikarya;Ascomycota;Pezizomycotina;Geoglossomycetes;Geoglossales;Geoglossaceae;Geoglossum;";"0.0";"0";"1";"1";"0";"1";"0";"457182";"391207"
"V4mis2";"SILVA (only NR);Eukaryota;Amorphea;Obazoa;Opisthokonta;Nucletmycea;Fungi;Dikarya;Ascomycota;Pezizomycotina;Geoglossomycetes;Geoglossales;Geoglossaceae;Trichoglossum;";"0.0";"0";"1";"1";"0";"1";"0";"457182";"391207"
"V4mis2";"SILVA (only NR);Eukaryota;Amorphea;Obazoa;Opisthokonta;Nucletmycea;Fungi;Dikarya;Ascomycota;Pezizomycotina;Incertae Sedis;";"0.0";"0";"9";"9";"0";"9";"0";"457174";"391207"
"V4mis2";"SILVA (only NR);Eukaryota;Amorphea;Obazoa;Opisthokonta;Nucletmycea;Fungi;Dikarya;Ascomycota;Pezizomycotina;Incertae Sedis;Incertae Sedis;";"0.0";"0";"8";"8";"0";"8";"0";"457175";"391207"
"V4mis2";"SILVA (only NR);Eukaryota;Amorphea;Obazoa;Opisthokonta;Nucletmycea;Fungi;Dikarya;Ascomycota;Pezizomycotina;Incertae Sedis;Incertae Sedis;Incertae Sedis;";"0.0";"0";"8";"8";"0";"8";"0";"457175";"391207"
"V4mis2";"SILVA (only NR);Eukaryota;Amorphea;Obazoa;Opisthokonta;Nucletmycea;Fungi;Dikarya;Ascomycota;Pezizomycotina;Incertae Sedis;Incertae Sedis;Incertae Sedis;Dictyocatenulata;";"0.0";"0";"5";"5";"0";"5";"0";"457178";"391207"
"V4mis2";"SILVA (only NR);Eukaryota;Amorphea;Obazoa;Opisthokonta;Nucletmycea;Fungi;Dikarya;Ascomycota;Pezizomycotina;Incertae Sedis;Incertae Sedis;Incertae Sedis;Kendrickiella;";"0.0";"0";"1";"1";"0";"1";"0";"457182";"391207"
"V4mis2";"SILVA (only NR);Eukaryota;Amorphea;Obazoa;Opisthokonta;Nucletmycea;Fungi;Dikarya;Ascomycota;Pezizomycotina;Incertae Sedis;Incertae Sedis;Incertae Sedis;Lecophagus;";"0.0";"0";"2";"2";"0";"2";"0";"457181";"391207"
"V4mis2";"SILVA (only NR);Eukaryota;Amorphea;Obazoa;Opisthokonta;Nucletmycea;Fungi;Dikarya;Ascomycota;Pezizomycotina;Incertae Sedis;Medeolariales;";"0.0";"0";"1";"1";"0";"1";"0";"457182";"391207"
"V4mis2";"SILVA (only NR);Eukaryota;Amorphea;Obazoa;Opisthokonta;Nucletmycea;Fungi;Dikarya;Ascomycota;Pezizomycotina;Incertae Sedis;Medeolariales;Medeolariaceae;";"0.0";"0";"1";"1";"0";"1";"0";"457182";"391207"
"V4mis2";"SILVA (only NR);Eukaryota;Amorphea;Obazoa;Opisthokonta;Nucletmycea;Fungi;Dikarya;Ascomycota;Pezizomycotina;Incertae Sedis;Medeolariales;Medeolariaceae;Medeolaria;";"0.0";"0";"1";"1";"0";"1";"0";"457182";"391207"
"V4mis2";"SILVA (only NR);Eukaryota;Amorphea;Obazoa;Opisthokonta;Nucletmycea;Fungi;Dikarya;Ascomycota;Pezizomycotina;Laboulbeniomycetes;";"0.0";"0";"11";"11";"0";"11";"0";"457172";"391207"
"V4mis2";"SILVA (only NR);Eukaryota;Amorphea;Obazoa;Opisthokonta;Nucletmycea;Fungi;Dikarya;Ascomycota;Pezizomycotina;Laboulbeniomycetes;Laboulbeniales;";"0.0";"0";"6";"6";"0";"6";"0";"457177";"391207"
"V4mis2";"SILVA (only NR);Eukaryota;Amorphea;Obazoa;Opisthokonta;Nucletmycea;Fungi;Dikarya;Ascomycota;Pezizomycotina;Laboulbeniomycetes;Laboulbeniales;Laboulbeniaceae;";"0.0";"0";"6";"6";"0";"6";"0";"457177";"391207"
"V4mis2";"SILVA (only NR);Eukaryota;Amorphea;Obazoa;Opisthokonta;Nucletmycea;Fungi;Dikarya;Ascomycota;Pezizomycotina;Laboulbeniomycetes;Laboulbeniales;Laboulbeniaceae;Gloeandromyces;";"0.0";"0";"1";"1";"0";"1";"0";"457182";"391207"
"V4mis2";"SILVA (only NR);Eukaryota;Amorphea;Obazoa;Opisthokonta;Nucletmycea;Fungi;Dikarya;Ascomycota;Pezizomycotina;Laboulbeniomycetes;Laboulbeniales;Laboulbeniaceae;Hesperomyces;";"0.0";"0";"2";"2";"0";"2";"0";"457181";"391207"
"V4mis2";"SILVA (only NR);Eukaryota;Amorphea;Obazoa;Opisthokonta;Nucletmycea;Fungi;Dikarya;Ascomycota;Pezizomycotina;Laboulbeniomycetes;Laboulbeniales;Laboulbeniaceae;Laboulbenia;";"0.0";"0";"1";"1";"0";"1";"0";"457182";"391207"
"V4mis2";"SILVA (only NR);Eukaryota;Amorphea;Obazoa;Opisthokonta;Nucletmycea;Fungi;Dikarya;Ascomycota;Pezizomycotina;Laboulbeniomycetes;Laboulbeniales;Laboulbeniaceae;Monoicomyces;";"0.0";"0";"1";"1";"0";"1";"0";"457182";"391207"
"V4mis2";"SILVA (only NR);Eukaryota;Amorphea;Obazoa;Opisthokonta;Nucletmycea;Fungi;Dikarya;Ascomycota;Pezizomycotina;Laboulbeniomycetes;Laboulbeniales;Laboulbeniaceae;Stigmatomyces;";"0.0";"0";"1";"1";"0";"1";"0";"457182";"391207"
"V4mis2";"SILVA (only NR);Eukaryota;Amorphea;Obazoa;Opisthokonta;Nucletmycea;Fungi;Dikarya;Ascomycota;Pezizomycotina;Laboulbeniomycetes;Pyxidiophorales;";"0.0";"0";"1";"1";"0";"1";"0";"457182";"391207"
"V4mis2";"SILVA (only NR);Eukaryota;Amorphea;Obazoa;Opisthokonta;Nucletmycea;Fungi;Dikarya;Ascomycota;Pezizomycotina;Laboulbeniomycetes;Pyxidiophorales;Pyxidiophoraceae;";"0.0";"0";"1";"1";"0";"1";"0";"457182";"391207"
"V4mis2";"SILVA (only NR);Eukaryota;Amorphea;Obazoa;Opisthokonta;Nucletmycea;Fungi;Dikarya;Ascomycota;Pezizomycotina;Laboulbeniomycetes;Pyxidiophorales;Pyxidiophoraceae;Pyxidiophora;";"0.0";"0";"1";"1";"0";"1";"0";"457182";"391207"
"V4mis2";"SILVA (only NR);Eukaryota;Amorphea;Obazoa;Opisthokonta;Nucletmycea;Fungi;Dikarya;Ascomycota;Pezizomycotina;Lecanoromycetes;";"0.4";"14.4";"282";"282";"1";"281";"0";"456901";"391206"
"V4mis2";"SILVA (only NR);Eukaryota;Amorphea;Obazoa;Opisthokonta;Nucletmycea;Fungi;Dikarya;Ascomycota;Pezizomycotina;Lecanoromycetes;Acarosporales;";"0.0";"0";"7";"7";"0";"7";"0";"457176";"391207"
"V4mis2";"SILVA (only NR);Eukaryota;Amorphea;Obazoa;Opisthokonta;Nucletmycea;Fungi;Dikarya;Ascomycota;Pezizomycotina;Lecanoromycetes;Acarosporales;Acarosporaceae;";"0.0";"0";"7";"7";"0";"7";"0";"457176";"391207"
"V4mis2";"SILVA (only NR);Eukaryota;Amorphea;Obazoa;Opisthokonta;Nucletmycea;Fungi;Dikarya;Ascomycota;Pezizomycotina;Lecanoromycetes;Acarosporales;Acarosporaceae;Acarospora;";"0.0";"0";"4";"4";"0";"4";"0";"457179";"391207"
"V4mis2";"SILVA (only NR);Eukaryota;Amorphea;Obazoa;Opisthokonta;Nucletmycea;Fungi;Dikarya;Ascomycota;Pezizomycotina;Lecanoromycetes;Acarosporales;Acarosporaceae;Myriospora;";"0.0";"0";"1";"1";"0";"1";"0";"457182";"391207"
"V4mis2";"SILVA (only NR);Eukaryota;Amorphea;Obazoa;Opisthokonta;Nucletmycea;Fungi;Dikarya;Ascomycota;Pezizomycotina;Lecanoromycetes;Acarosporales;Acarosporaceae;Phacopsis;";"0.0";"0";"2";"2";"0";"2";"0";"457181";"391207"
"V4mis2";"SILVA (only NR);Eukaryota;Amorphea;Obazoa;Opisthokonta;Nucletmycea;Fungi;Dikarya;Ascomycota;Pezizomycotina;Lecanoromycetes;Arctomiales;";"0.0";"0";"1";"1";"0";"1";"0";"457182";"391207"
"V4mis2";"SILVA (only NR);Eukaryota;Amorphea;Obazoa;Opisthokonta;Nucletmycea;Fungi;Dikarya;Ascomycota;Pezizomycotina;Lecanoromycetes;Arctomiales;Arctomiaceae;";"0.0";"0";"1";"1";"0";"1";"0";"457182";"391207"
"V4mis2";"SILVA (only NR);Eukaryota;Amorphea;Obazoa;Opisthokonta;Nucletmycea;Fungi;Dikarya;Ascomycota;Pezizomycotina;Lecanoromycetes;Arctomiales;Arctomiaceae;Gregorella;";"0.0";"0";"1";"1";"0";"1";"0";"457182";"391207"
"V4mis2";"SILVA (only NR);Eukaryota;Amorphea;Obazoa;Opisthokonta;Nucletmycea;Fungi;Dikarya;Ascomycota;Pezizomycotina;Lecanoromycetes;Baeomycetales;";"0.0";"0";"4";"4";"0";"4";"0";"457179";"391207"
"V4mis2";"SILVA (only NR);Eukaryota;Amorphea;Obazoa;Opisthokonta;Nucletmycea;Fungi;Dikarya;Ascomycota;Pezizomycotina;Lecanoromycetes;Baeomycetales;Anamylopsora;";"0.0";"0";"1";"1";"0";"1";"0";"457182";"391207"
"V4mis2";"SILVA (only NR);Eukaryota;Amorphea;Obazoa;Opisthokonta;Nucletmycea;Fungi;Dikarya;Ascomycota;Pezizomycotina;Lecanoromycetes;Baeomycetales;Baeomyces;";"0.0";"0";"3";"3";"0";"3";"0";"457180";"391207"
"V4mis2";"SILVA (only NR);Eukaryota;Amorphea;Obazoa;Opisthokonta;Nucletmycea;Fungi;Dikarya;Ascomycota;Pezizomycotina;Lecanoromycetes;Caliciales;";"0.0";"0";"32";"32";"0";"32";"0";"457151";"391207"
"V4mis2";"SILVA (only NR);Eukaryota;Amorphea;Obazoa;Opisthokonta;Nucletmycea;Fungi;Dikarya;Ascomycota;Pezizomycotina;Lecanoromycetes;Caliciales;Caliciaceae;";"0.0";"0";"18";"18";"0";"18";"0";"457165";"391207"
"V4mis2";"SILVA (only NR);Eukaryota;Amorphea;Obazoa;Opisthokonta;Nucletmycea;Fungi;Dikarya;Ascomycota;Pezizomycotina;Lecanoromycetes;Caliciales;Caliciaceae;Buellia;";"0.0";"0";"9";"9";"0";"9";"0";"457174";"391207"
"V4mis2";"SILVA (only NR);Eukaryota;Amorphea;Obazoa;Opisthokonta;Nucletmycea;Fungi;Dikarya;Ascomycota;Pezizomycotina;Lecanoromycetes;Caliciales;Caliciaceae;Calicium;";"0.0";"0";"1";"1";"0";"1";"0";"457182";"391207"
"V4mis2";"SILVA (only NR);Eukaryota;Amorphea;Obazoa;Opisthokonta;Nucletmycea;Fungi;Dikarya;Ascomycota;Pezizomycotina;Lecanoromycetes;Caliciales;Caliciaceae;Cyphelium;";"0.0";"0";"3";"3";"0";"3";"0";"457180";"391207"
"V4mis2";"SILVA (only NR);Eukaryota;Amorphea;Obazoa;Opisthokonta;Nucletmycea;Fungi;Dikarya;Ascomycota;Pezizomycotina;Lecanoromycetes;Caliciales;Caliciaceae;Dimelaena;";"0.0";"0";"1";"1";"0";"1";"0";"457182";"391207"
"V4mis2";"SILVA (only NR);Eukaryota;Amorphea;Obazoa;Opisthokonta;Nucletmycea;Fungi;Dikarya;Ascomycota;Pezizomycotina;Lecanoromycetes;Caliciales;Caliciaceae;Diploicia;";"0.0";"0";"1";"1";"0";"1";"0";"457182";"391207"
"V4mis2";"SILVA (only NR);Eukaryota;Amorphea;Obazoa;Opisthokonta;Nucletmycea;Fungi;Dikarya;Ascomycota;Pezizomycotina;Lecanoromycetes;Caliciales;Caliciaceae;Pyxine;";"0.0";"0";"2";"2";"0";"2";"0";"457181";"391207"
"V4mis2";"SILVA (only NR);Eukaryota;Amorphea;Obazoa;Opisthokonta;Nucletmycea;Fungi;Dikarya;Ascomycota;Pezizomycotina;Lecanoromycetes;Caliciales;Caliciaceae;Texosporium;";"0.0";"0";"1";"1";"0";"1";"0";"457182";"391207"
"V4mis2";"SILVA (only NR);Eukaryota;Amorphea;Obazoa;Opisthokonta;Nucletmycea;Fungi;Dikarya;Ascomycota;Pezizomycotina;Lecanoromycetes;Caliciales;Physciaceae;";"0.0";"0";"14";"14";"0";"14";"0";"457169";"391207"
"V4mis2";"SILVA (only NR);Eukaryota;Amorphea;Obazoa;Opisthokonta;Nucletmycea;Fungi;Dikarya;Ascomycota;Pezizomycotina;Lecanoromycetes;Caliciales;Physciaceae;Anaptychia;";"0.0";"0";"1";"1";"0";"1";"0";"457182";"391207"
"V4mis2";"SILVA (only NR);Eukaryota;Amorphea;Obazoa;Opisthokonta;Nucletmycea;Fungi;Dikarya;Ascomycota;Pezizomycotina;Lecanoromycetes;Caliciales;Physciaceae;Heterodermia;";"0.0";"0";"2";"2";"0";"2";"0";"457181";"391207"
"V4mis2";"SILVA (only NR);Eukaryota;Amorphea;Obazoa;Opisthokonta;Nucletmycea;Fungi;Dikarya;Ascomycota;Pezizomycotina;Lecanoromycetes;Caliciales;Physciaceae;Phaeophyscia;";"0.0";"0";"1";"1";"0";"1";"0";"457182";"391207"
"V4mis2";"SILVA (only NR);Eukaryota;Amorphea;Obazoa;Opisthokonta;Nucletmycea;Fungi;Dikarya;Ascomycota;Pezizomycotina;Lecanoromycetes;Caliciales;Physciaceae;Physcia;";"0.0";"0";"5";"5";"0";"5";"0";"457178";"391207"
"V4mis2";"SILVA (only NR);Eukaryota;Amorphea;Obazoa;Opisthokonta;Nucletmycea;Fungi;Dikarya;Ascomycota;Pezizomycotina;Lecanoromycetes;Caliciales;Physciaceae;Physconia;";"0.0";"0";"1";"1";"0";"1";"0";"457182";"391207"
"V4mis2";"SILVA (only NR);Eukaryota;Amorphea;Obazoa;Opisthokonta;Nucletmycea;Fungi;Dikarya;Ascomycota;Pezizomycotina;Lecanoromycetes;Caliciales;Physciaceae;Rinodina;";"0.0";"0";"2";"2";"0";"2";"0";"457181";"391207"
"V4mis2";"SILVA (only NR);Eukaryota;Amorphea;Obazoa;Opisthokonta;Nucletmycea;Fungi;Dikarya;Ascomycota;Pezizomycotina;Lecanoromycetes;Caliciales;Physciaceae;Rinodinella;";"0.0";"0";"1";"1";"0";"1";"0";"457182";"391207"
"V4mis2";"SILVA (only NR);Eukaryota;Amorphea;Obazoa;Opisthokonta;Nucletmycea;Fungi;Dikarya;Ascomycota;Pezizomycotina;Lecanoromycetes;Lecanorales;";"1.0";"14.4";"98";"98";"1";"97";"0";"457085";"391206"
"V4mis2";"SILVA (only NR);Eukaryota;Amorphea;Obazoa;Opisthokonta;Nucletmycea;Fungi;Dikarya;Ascomycota;Pezizomycotina;Lecanoromycetes;Lecanorales;Allocetraria;";"0.0";"0";"1";"1";"0";"1";"0";"457182";"391207"
"V4mis2";"SILVA (only NR);Eukaryota;Amorphea;Obazoa;Opisthokonta;Nucletmycea;Fungi;Dikarya;Ascomycota;Pezizomycotina;Lecanoromycetes;Lecanorales;Austropeltum;";"0.0";"0";"1";"1";"0";"1";"0";"457182";"391207"
"V4mis2";"SILVA (only NR);Eukaryota;Amorphea;Obazoa;Opisthokonta;Nucletmycea;Fungi;Dikarya;Ascomycota;Pezizomycotina;Lecanoromycetes;Lecanorales;Bachmanniomyces;";"0.0";"0";"1";"1";"0";"1";"0";"457182";"391207"
"V4mis2";"SILVA (only NR);Eukaryota;Amorphea;Obazoa;Opisthokonta;Nucletmycea;Fungi;Dikarya;Ascomycota;Pezizomycotina;Lecanoromycetes;Lecanorales;Bunodophoron;";"0.0";"0";"2";"2";"0";"2";"0";"457181";"391207"
"V4mis2";"SILVA (only NR);Eukaryota;Amorphea;Obazoa;Opisthokonta;Nucletmycea;Fungi;Dikarya;Ascomycota;Pezizomycotina;Lecanoromycetes;Lecanorales;Byssoloma;";"0.0";"0";"1";"1";"0";"1";"0";"457182";"391207"
"V4mis2";"SILVA (only NR);Eukaryota;Amorphea;Obazoa;Opisthokonta;Nucletmycea;Fungi;Dikarya;Ascomycota;Pezizomycotina;Lecanoromycetes;Lecanorales;Cetradonia;";"0.0";"0";"1";"1";"0";"1";"0";"457182";"391207"
"V4mis2";"SILVA (only NR);Eukaryota;Amorphea;Obazoa;Opisthokonta;Nucletmycea;Fungi;Dikarya;Ascomycota;Pezizomycotina;Lecanoromycetes;Lecanorales;Cladoniaceae;";"0.0";"0";"7";"7";"0";"7";"0";"457176";"391207"
"V4mis2";"SILVA (only NR);Eukaryota;Amorphea;Obazoa;Opisthokonta;Nucletmycea;Fungi;Dikarya;Ascomycota;Pezizomycotina;Lecanoromycetes;Lecanorales;Cladoniaceae;Cladia;";"0.0";"0";"2";"2";"0";"2";"0";"457181";"391207"
"V4mis2";"SILVA (only NR);Eukaryota;Amorphea;Obazoa;Opisthokonta;Nucletmycea;Fungi;Dikarya;Ascomycota;Pezizomycotina;Lecanoromycetes;Lecanorales;Cladoniaceae;Cladonia;";"0.0";"0";"3";"3";"0";"3";"0";"457180";"391207"
"V4mis2";"SILVA (only NR);Eukaryota;Amorphea;Obazoa;Opisthokonta;Nucletmycea;Fungi;Dikarya;Ascomycota;Pezizomycotina;Lecanoromycetes;Lecanorales;Cladoniaceae;Gymnoderma;";"0.0";"0";"1";"1";"0";"1";"0";"457182";"391207"
"V4mis2";"SILVA (only NR);Eukaryota;Amorphea;Obazoa;Opisthokonta;Nucletmycea;Fungi;Dikarya;Ascomycota;Pezizomycotina;Lecanoromycetes;Lecanorales;Cladoniaceae;Pilophorus;";"0.0";"0";"1";"1";"0";"1";"0";"457182";"391207"
"V4mis2";"SILVA (only NR);Eukaryota;Amorphea;Obazoa;Opisthokonta;Nucletmycea;Fungi;Dikarya;Ascomycota;Pezizomycotina;Lecanoromycetes;Lecanorales;Crocynia;";"0.0";"0";"1";"1";"0";"1";"0";"457182";"391207"
"V4mis2";"SILVA (only NR);Eukaryota;Amorphea;Obazoa;Opisthokonta;Nucletmycea;Fungi;Dikarya;Ascomycota;Pezizomycotina;Lecanoromycetes;Lecanorales;Lecanoraceae;";"0.0";"0";"12";"12";"0";"12";"0";"457171";"391207"
"V4mis2";"SILVA (only NR);Eukaryota;Amorphea;Obazoa;Opisthokonta;Nucletmycea;Fungi;Dikarya;Ascomycota;Pezizomycotina;Lecanoromycetes;Lecanorales;Lecanoraceae;Lecanora;";"0.0";"0";"4";"4";"0";"4";"0";"457179";"391207"
"V4mis2";"SILVA (only NR);Eukaryota;Amorphea;Obazoa;Opisthokonta;Nucletmycea;Fungi;Dikarya;Ascomycota;Pezizomycotina;Lecanoromycetes;Lecanorales;Lecanoraceae;Lecidella;";"0.0";"0";"1";"1";"0";"1";"0";"457182";"391207"
"V4mis2";"SILVA (only NR);Eukaryota;Amorphea;Obazoa;Opisthokonta;Nucletmycea;Fungi;Dikarya;Ascomycota;Pezizomycotina;Lecanoromycetes;Lecanorales;Lecanoraceae;Miriquidica;";"0.0";"0";"1";"1";"0";"1";"0";"457182";"391207"
"V4mis2";"SILVA (only NR);Eukaryota;Amorphea;Obazoa;Opisthokonta;Nucletmycea;Fungi;Dikarya;Ascomycota;Pezizomycotina;Lecanoromycetes;Lecanorales;Lecanoraceae;Protoparmeliopsis;";"0.0";"0";"1";"1";"0";"1";"0";"457182";"391207"
"V4mis2";"SILVA (only NR);Eukaryota;Amorphea;Obazoa;Opisthokonta;Nucletmycea;Fungi;Dikarya;Ascomycota;Pezizomycotina;Lecanoromycetes;Lecanorales;Lecanoraceae;Pyrrhospora;";"0.0";"0";"1";"1";"0";"1";"0";"457182";"391207"
"V4mis2";"SILVA (only NR);Eukaryota;Amorphea;Obazoa;Opisthokonta;Nucletmycea;Fungi;Dikarya;Ascomycota;Pezizomycotina;Lecanoromycetes;Lecanorales;Lecanoraceae;Rhizoplaca;";"0.0";"0";"2";"2";"0";"2";"0";"457181";"391207"
"V4mis2";"SILVA (only NR);Eukaryota;Amorphea;Obazoa;Opisthokonta;Nucletmycea;Fungi;Dikarya;Ascomycota;Pezizomycotina;Lecanoromycetes;Lecanorales;Lecanoraceae;Scoliciosporum;";"0.0";"0";"2";"2";"0";"2";"0";"457181";"391207"
"V4mis2";"SILVA (only NR);Eukaryota;Amorphea;Obazoa;Opisthokonta;Nucletmycea;Fungi;Dikarya;Ascomycota;Pezizomycotina;Lecanoromycetes;Lecanorales;Micareaceae;";"0.0";"0";"2";"2";"0";"2";"0";"457181";"391207"
"V4mis2";"SILVA (only NR);Eukaryota;Amorphea;Obazoa;Opisthokonta;Nucletmycea;Fungi;Dikarya;Ascomycota;Pezizomycotina;Lecanoromycetes;Lecanorales;Micareaceae;Micarea;";"0.0";"0";"2";"2";"0";"2";"0";"457181";"391207"
"V4mis2";"SILVA (only NR);Eukaryota;Amorphea;Obazoa;Opisthokonta;Nucletmycea;Fungi;Dikarya;Ascomycota;Pezizomycotina;Lecanoromycetes;Lecanorales;Mycoblastaceae;";"0.0";"0";"1";"1";"0";"1";"0";"457182";"391207"
"V4mis2";"SILVA (only NR);Eukaryota;Amorphea;Obazoa;Opisthokonta;Nucletmycea;Fungi;Dikarya;Ascomycota;Pezizomycotina;Lecanoromycetes;Lecanorales;Mycoblastaceae;Mycoblastus;";"0.0";"0";"1";"1";"0";"1";"0";"457182";"391207"
"V4mis2";"SILVA (only NR);Eukaryota;Amorphea;Obazoa;Opisthokonta;Nucletmycea;Fungi;Dikarya;Ascomycota;Pezizomycotina;Lecanoromycetes;Lecanorales;Neophyllis;";"0.0";"0";"1";"1";"0";"1";"0";"457182";"391207"
"V4mis2";"SILVA (only NR);Eukaryota;Amorphea;Obazoa;Opisthokonta;Nucletmycea;Fungi;Dikarya;Ascomycota;Pezizomycotina;Lecanoromycetes;Lecanorales;Parmeliaceae;";"0.0";"0";"30";"30";"0";"30";"0";"457153";"391207"
"V4mis2";"SILVA (only NR);Eukaryota;Amorphea;Obazoa;Opisthokonta;Nucletmycea;Fungi;Dikarya;Ascomycota;Pezizomycotina;Lecanoromycetes;Lecanorales;Parmeliaceae;Anzia;";"0.0";"0";"2";"2";"0";"2";"0";"457181";"391207"
"V4mis2";"SILVA (only NR);Eukaryota;Amorphea;Obazoa;Opisthokonta;Nucletmycea;Fungi;Dikarya;Ascomycota;Pezizomycotina;Lecanoromycetes;Lecanorales;Parmeliaceae;Cetraria;";"0.0";"0";"1";"1";"0";"1";"0";"457182";"391207"
"V4mis2";"SILVA (only NR);Eukaryota;Amorphea;Obazoa;Opisthokonta;Nucletmycea;Fungi;Dikarya;Ascomycota;Pezizomycotina;Lecanoromycetes;Lecanorales;Parmeliaceae;Cornicularia;";"0.0";"0";"1";"1";"0";"1";"0";"457182";"391207"
"V4mis2";"SILVA (only NR);Eukaryota;Amorphea;Obazoa;Opisthokonta;Nucletmycea;Fungi;Dikarya;Ascomycota;Pezizomycotina;Lecanoromycetes;Lecanorales;Parmeliaceae;Evernia;";"0.0";"0";"1";"1";"0";"1";"0";"457182";"391207"
"V4mis2";"SILVA (only NR);Eukaryota;Amorphea;Obazoa;Opisthokonta;Nucletmycea;Fungi;Dikarya;Ascomycota;Pezizomycotina;Lecanoromycetes;Lecanorales;Parmeliaceae;Hypogymnia;";"0.0";"0";"5";"5";"0";"5";"0";"457178";"391207"
"V4mis2";"SILVA (only NR);Eukaryota;Amorphea;Obazoa;Opisthokonta;Nucletmycea;Fungi;Dikarya;Ascomycota;Pezizomycotina;Lecanoromycetes;Lecanorales;Parmeliaceae;Letharia;";"0.0";"0";"1";"1";"0";"1";"0";"457182";"391207"
"V4mis2";"SILVA (only NR);Eukaryota;Amorphea;Obazoa;Opisthokonta;Nucletmycea;Fungi;Dikarya;Ascomycota;Pezizomycotina;Lecanoromycetes;Lecanorales;Parmeliaceae;Menegazzia;";"0.0";"0";"2";"2";"0";"2";"0";"457181";"391207"
"V4mis2";"SILVA (only NR);Eukaryota;Amorphea;Obazoa;Opisthokonta;Nucletmycea;Fungi;Dikarya;Ascomycota;Pezizomycotina;Lecanoromycetes;Lecanorales;Parmeliaceae;Pannoparmelia;";"0.0";"0";"1";"1";"0";"1";"0";"457182";"391207"
"V4mis2";"SILVA (only NR);Eukaryota;Amorphea;Obazoa;Opisthokonta;Nucletmycea;Fungi;Dikarya;Ascomycota;Pezizomycotina;Lecanoromycetes;Lecanorales;Parmeliaceae;Parmelia;";"0.0";"0";"1";"1";"0";"1";"0";"457182";"391207"
"V4mis2";"SILVA (only NR);Eukaryota;Amorphea;Obazoa;Opisthokonta;Nucletmycea;Fungi;Dikarya;Ascomycota;Pezizomycotina;Lecanoromycetes;Lecanorales;Parmeliaceae;Parmeliopsis;";"0.0";"0";"1";"1";"0";"1";"0";"457182";"391207"
"V4mis2";"SILVA (only NR);Eukaryota;Amorphea;Obazoa;Opisthokonta;Nucletmycea;Fungi;Dikarya;Ascomycota;Pezizomycotina;Lecanoromycetes;Lecanorales;Parmeliaceae;Parmotrema;";"0.0";"0";"3";"3";"0";"3";"0";"457180";"391207"
"V4mis2";"SILVA (only NR);Eukaryota;Amorphea;Obazoa;Opisthokonta;Nucletmycea;Fungi;Dikarya;Ascomycota;Pezizomycotina;Lecanoromycetes;Lecanorales;Parmeliaceae;Pleurosticta;";"0.0";"0";"2";"2";"0";"2";"0";"457181";"391207"
"V4mis2";"SILVA (only NR);Eukaryota;Amorphea;Obazoa;Opisthokonta;Nucletmycea;Fungi;Dikarya;Ascomycota;Pezizomycotina;Lecanoromycetes;Lecanorales;Parmeliaceae;Punctelia;";"0.0";"0";"1";"1";"0";"1";"0";"457182";"391207"
"V4mis2";"SILVA (only NR);Eukaryota;Amorphea;Obazoa;Opisthokonta;Nucletmycea;Fungi;Dikarya;Ascomycota;Pezizomycotina;Lecanoromycetes;Lecanorales;Parmeliaceae;Usnea;";"0.0";"0";"3";"3";"0";"3";"0";"457180";"391207"
"V4mis2";"SILVA (only NR);Eukaryota;Amorphea;Obazoa;Opisthokonta;Nucletmycea;Fungi;Dikarya;Ascomycota;Pezizomycotina;Lecanoromycetes;Lecanorales;Parmeliaceae;Vulpicida;";"0.0";"0";"1";"1";"0";"1";"0";"457182";"391207"
"V4mis2";"SILVA (only NR);Eukaryota;Amorphea;Obazoa;Opisthokonta;Nucletmycea;Fungi;Dikarya;Ascomycota;Pezizomycotina;Lecanoromycetes;Lecanorales;Parmeliaceae;Xanthoparmelia;";"0.0";"0";"2";"2";"0";"2";"0";"457181";"391207"
"V4mis2";"SILVA (only NR);Eukaryota;Amorphea;Obazoa;Opisthokonta;Nucletmycea;Fungi;Dikarya;Ascomycota;Pezizomycotina;Lecanoromycetes;Lecanorales;Porpidiaceae;";"0.0";"0";"2";"2";"0";"2";"0";"457181";"391207"
"V4mis2";"SILVA (only NR);Eukaryota;Amorphea;Obazoa;Opisthokonta;Nucletmycea;Fungi;Dikarya;Ascomycota;Pezizomycotina;Lecanoromycetes;Lecanorales;Porpidiaceae;Porpidia;";"0.0";"0";"1";"1";"0";"1";"0";"457182";"391207"
"V4mis2";"SILVA (only NR);Eukaryota;Amorphea;Obazoa;Opisthokonta;Nucletmycea;Fungi;Dikarya;Ascomycota;Pezizomycotina;Lecanoromycetes;Lecanorales;Porpidiaceae;Romjularia;";"0.0";"0";"1";"1";"0";"1";"0";"457182";"391207"
"V4mis2";"SILVA (only NR);Eukaryota;Amorphea;Obazoa;Opisthokonta;Nucletmycea;Fungi;Dikarya;Ascomycota;Pezizomycotina;Lecanoromycetes;Lecanorales;Psilolechia;";"0.0";"0";"1";"1";"0";"1";"0";"457182";"391207"
"V4mis2";"SILVA (only NR);Eukaryota;Amorphea;Obazoa;Opisthokonta;Nucletmycea;Fungi;Dikarya;Ascomycota;Pezizomycotina;Lecanoromycetes;Lecanorales;Psoraceae;";"0.0";"0";"5";"5";"0";"5";"0";"457178";"391207"
"V4mis2";"SILVA (only NR);Eukaryota;Amorphea;Obazoa;Opisthokonta;Nucletmycea;Fungi;Dikarya;Ascomycota;Pezizomycotina;Lecanoromycetes;Lecanorales;Psoraceae;Protoblastenia;";"0.0";"0";"3";"3";"0";"3";"0";"457180";"391207"
"V4mis2";"SILVA (only NR);Eukaryota;Amorphea;Obazoa;Opisthokonta;Nucletmycea;Fungi;Dikarya;Ascomycota;Pezizomycotina;Lecanoromycetes;Lecanorales;Psoraceae;Psora;";"0.0";"0";"2";"2";"0";"2";"0";"457181";"391207"
"V4mis2";"SILVA (only NR);Eukaryota;Amorphea;Obazoa;Opisthokonta;Nucletmycea;Fungi;Dikarya;Ascomycota;Pezizomycotina;Lecanoromycetes;Lecanorales;Ramalinaceae;";"6.3";"14.4";"16";"16";"1";"15";"0";"457167";"391206"
"V4mis2";"SILVA (only NR);Eukaryota;Amorphea;Obazoa;Opisthokonta;Nucletmycea;Fungi;Dikarya;Ascomycota;Pezizomycotina;Lecanoromycetes;Lecanorales;Ramalinaceae;Bacidia;";"0.0";"0";"1";"1";"0";"1";"0";"457182";"391207"
"V4mis2";"SILVA (only NR);Eukaryota;Amorphea;Obazoa;Opisthokonta;Nucletmycea;Fungi;Dikarya;Ascomycota;Pezizomycotina;Lecanoromycetes;Lecanorales;Ramalinaceae;Bacidina;";"0.0";"0";"3";"3";"0";"3";"0";"457180";"391207"
"V4mis2";"SILVA (only NR);Eukaryota;Amorphea;Obazoa;Opisthokonta;Nucletmycea;Fungi;Dikarya;Ascomycota;Pezizomycotina;Lecanoromycetes;Lecanorales;Ramalinaceae;Biatora;";"0.0";"0";"1";"1";"0";"1";"0";"457182";"391207"
"V4mis2";"SILVA (only NR);Eukaryota;Amorphea;Obazoa;Opisthokonta;Nucletmycea;Fungi;Dikarya;Ascomycota;Pezizomycotina;Lecanoromycetes;Lecanorales;Ramalinaceae;Bilimbia;";"0.0";"0";"1";"1";"0";"1";"0";"457182";"391207"
"V4mis2";"SILVA (only NR);Eukaryota;Amorphea;Obazoa;Opisthokonta;Nucletmycea;Fungi;Dikarya;Ascomycota;Pezizomycotina;Lecanoromycetes;Lecanorales;Ramalinaceae;Cliostomum;";"0.0";"0";"1";"1";"0";"1";"0";"457182";"391207"
"V4mis2";"SILVA (only NR);Eukaryota;Amorphea;Obazoa;Opisthokonta;Nucletmycea;Fungi;Dikarya;Ascomycota;Pezizomycotina;Lecanoromycetes;Lecanorales;Ramalinaceae;Lecania;";"33.3";"14.4";"3";"3";"1";"2";"0";"457180";"391206"
"V4mis2";"SILVA (only NR);Eukaryota;Amorphea;Obazoa;Opisthokonta;Nucletmycea;Fungi;Dikarya;Ascomycota;Pezizomycotina;Lecanoromycetes;Lecanorales;Ramalinaceae;Lopezaria;";"0.0";"0";"1";"1";"0";"1";"0";"457182";"391207"
"V4mis2";"SILVA (only NR);Eukaryota;Amorphea;Obazoa;Opisthokonta;Nucletmycea;Fungi;Dikarya;Ascomycota;Pezizomycotina;Lecanoromycetes;Lecanorales;Ramalinaceae;Ramalina;";"0.0";"0";"1";"1";"0";"1";"0";"457182";"391207"
"V4mis2";"SILVA (only NR);Eukaryota;Amorphea;Obazoa;Opisthokonta;Nucletmycea;Fungi;Dikarya;Ascomycota;Pezizomycotina;Lecanoromycetes;Lecanorales;Ramalinaceae;Toninia;";"0.0";"0";"2";"2";"0";"2";"0";"457181";"391207"
"V4mis2";"SILVA (only NR);Eukaryota;Amorphea;Obazoa;Opisthokonta;Nucletmycea;Fungi;Dikarya;Ascomycota;Pezizomycotina;Lecanoromycetes;Lecanorales;Ramalinaceae;[Epicladonia];";"0.0";"0";"1";"1";"0";"1";"0";"457182";"391207"
"V4mis2";"SILVA (only NR);Eukaryota;Amorphea;Obazoa;Opisthokonta;Nucletmycea;Fungi;Dikarya;Ascomycota;Pezizomycotina;Lecanoromycetes;Lecanorales;Ramboldiaceae;";"0.0";"0";"2";"2";"0";"2";"0";"457181";"391207"
"V4mis2";"SILVA (only NR);Eukaryota;Amorphea;Obazoa;Opisthokonta;Nucletmycea;Fungi;Dikarya;Ascomycota;Pezizomycotina;Lecanoromycetes;Lecanorales;Ramboldiaceae;Ramboldia;";"0.0";"0";"2";"2";"0";"2";"0";"457181";"391207"
"V4mis2";"SILVA (only NR);Eukaryota;Amorphea;Obazoa;Opisthokonta;Nucletmycea;Fungi;Dikarya;Ascomycota;Pezizomycotina;Lecanoromycetes;Lecanorales;Sphaerophorus;";"0.0";"0";"1";"1";"0";"1";"0";"457182";"391207"
"V4mis2";"SILVA (only NR);Eukaryota;Amorphea;Obazoa;Opisthokonta;Nucletmycea;Fungi;Dikarya;Ascomycota;Pezizomycotina;Lecanoromycetes;Lecanorales;Squamarinaceae;";"0.0";"0";"2";"2";"0";"2";"0";"457181";"391207"
"V4mis2";"SILVA (only NR);Eukaryota;Amorphea;Obazoa;Opisthokonta;Nucletmycea;Fungi;Dikarya;Ascomycota;Pezizomycotina;Lecanoromycetes;Lecanorales;Squamarinaceae;Squamarina;";"0.0";"0";"2";"2";"0";"2";"0";"457181";"391207"
"V4mis2";"SILVA (only NR);Eukaryota;Amorphea;Obazoa;Opisthokonta;Nucletmycea;Fungi;Dikarya;Ascomycota;Pezizomycotina;Lecanoromycetes;Lecanorales;Stereocaulaceae;";"0.0";"0";"6";"6";"0";"6";"0";"457177";"391207"
"V4mis2";"SILVA (only NR);Eukaryota;Amorphea;Obazoa;Opisthokonta;Nucletmycea;Fungi;Dikarya;Ascomycota;Pezizomycotina;Lecanoromycetes;Lecanorales;Stereocaulaceae;Lepraria;";"0.0";"0";"1";"1";"0";"1";"0";"457182";"391207"
"V4mis2";"SILVA (only NR);Eukaryota;Amorphea;Obazoa;Opisthokonta;Nucletmycea;Fungi;Dikarya;Ascomycota;Pezizomycotina;Lecanoromycetes;Lecanorales;Stereocaulaceae;Stereocaulon;";"0.0";"0";"5";"5";"0";"5";"0";"457178";"391207"
"V4mis2";"SILVA (only NR);Eukaryota;Amorphea;Obazoa;Opisthokonta;Nucletmycea;Fungi;Dikarya;Ascomycota;Pezizomycotina;Lecanoromycetes;Lecanorales;Tephromela;";"0.0";"0";"1";"1";"0";"1";"0";"457182";"391207"
"V4mis2";"SILVA (only NR);Eukaryota;Amorphea;Obazoa;Opisthokonta;Nucletmycea;Fungi;Dikarya;Ascomycota;Pezizomycotina;Lecanoromycetes;Lecideales;";"0.0";"0";"2";"2";"0";"2";"0";"457181";"391207"
"V4mis2";"SILVA (only NR);Eukaryota;Amorphea;Obazoa;Opisthokonta;Nucletmycea;Fungi;Dikarya;Ascomycota;Pezizomycotina;Lecanoromycetes;Lecideales;Lecideaceae;";"0.0";"0";"2";"2";"0";"2";"0";"457181";"391207"
"V4mis2";"SILVA (only NR);Eukaryota;Amorphea;Obazoa;Opisthokonta;Nucletmycea;Fungi;Dikarya;Ascomycota;Pezizomycotina;Lecanoromycetes;Lecideales;Lecideaceae;Lecidea;";"0.0";"0";"2";"2";"0";"2";"0";"457181";"391207"
"V4mis2";"SILVA (only NR);Eukaryota;Amorphea;Obazoa;Opisthokonta;Nucletmycea;Fungi;Dikarya;Ascomycota;Pezizomycotina;Lecanoromycetes;Ostropales;";"0.0";"0";"12";"12";"0";"12";"0";"457171";"391207"
"V4mis2";"SILVA (only NR);Eukaryota;Amorphea;Obazoa;Opisthokonta;Nucletmycea;Fungi;Dikarya;Ascomycota;Pezizomycotina;Lecanoromycetes;Ostropales;Gomphillaceae;";"0.0";"0";"1";"1";"0";"1";"0";"457182";"391207"
"V4mis2";"SILVA (only NR);Eukaryota;Amorphea;Obazoa;Opisthokonta;Nucletmycea;Fungi;Dikarya;Ascomycota;Pezizomycotina;Lecanoromycetes;Ostropales;Gomphillaceae;Gyalideopsis;";"0.0";"0";"1";"1";"0";"1";"0";"457182";"391207"
"V4mis2";"SILVA (only NR);Eukaryota;Amorphea;Obazoa;Opisthokonta;Nucletmycea;Fungi;Dikarya;Ascomycota;Pezizomycotina;Lecanoromycetes;Ostropales;Graphidaceae;";"0.0";"0";"6";"6";"0";"6";"0";"457177";"391207"
"V4mis2";"SILVA (only NR);Eukaryota;Amorphea;Obazoa;Opisthokonta;Nucletmycea;Fungi;Dikarya;Ascomycota;Pezizomycotina;Lecanoromycetes;Ostropales;Graphidaceae;Diploschistes;";"0.0";"0";"1";"1";"0";"1";"0";"457182";"391207"
"V4mis2";"SILVA (only NR);Eukaryota;Amorphea;Obazoa;Opisthokonta;Nucletmycea;Fungi;Dikarya;Ascomycota;Pezizomycotina;Lecanoromycetes;Ostropales;Graphidaceae;Gomphillus;";"0.0";"0";"1";"1";"0";"1";"0";"457182";"391207"
"V4mis2";"SILVA (only NR);Eukaryota;Amorphea;Obazoa;Opisthokonta;Nucletmycea;Fungi;Dikarya;Ascomycota;Pezizomycotina;Lecanoromycetes;Ostropales;Graphidaceae;Graphis;";"0.0";"0";"3";"3";"0";"3";"0";"457180";"391207"
"V4mis2";"SILVA (only NR);Eukaryota;Amorphea;Obazoa;Opisthokonta;Nucletmycea;Fungi;Dikarya;Ascomycota;Pezizomycotina;Lecanoromycetes;Ostropales;Graphidaceae;Xalocoa;";"0.0";"0";"1";"1";"0";"1";"0";"457182";"391207"
"V4mis2";"SILVA (only NR);Eukaryota;Amorphea;Obazoa;Opisthokonta;Nucletmycea;Fungi;Dikarya;Ascomycota;Pezizomycotina;Lecanoromycetes;Ostropales;Gyalecta;";"0.0";"0";"1";"1";"0";"1";"0";"457182";"391207"
"V4mis2";"SILVA (only NR);Eukaryota;Amorphea;Obazoa;Opisthokonta;Nucletmycea;Fungi;Dikarya;Ascomycota;Pezizomycotina;Lecanoromycetes;Ostropales;Petractis;";"0.0";"0";"1";"1";"0";"1";"0";"457182";"391207"
"V4mis2";"SILVA (only NR);Eukaryota;Amorphea;Obazoa;Opisthokonta;Nucletmycea;Fungi;Dikarya;Ascomycota;Pezizomycotina;Lecanoromycetes;Ostropales;Stictidaceae;";"0.0";"0";"3";"3";"0";"3";"0";"457180";"391207"
"V4mis2";"SILVA (only NR);Eukaryota;Amorphea;Obazoa;Opisthokonta;Nucletmycea;Fungi;Dikarya;Ascomycota;Pezizomycotina;Lecanoromycetes;Ostropales;Stictidaceae;Acarosporina;";"0.0";"0";"1";"1";"0";"1";"0";"457182";"391207"
"V4mis2";"SILVA (only NR);Eukaryota;Amorphea;Obazoa;Opisthokonta;Nucletmycea;Fungi;Dikarya;Ascomycota;Pezizomycotina;Lecanoromycetes;Ostropales;Stictidaceae;Cyanodermella;";"0.0";"0";"1";"1";"0";"1";"0";"457182";"391207"
"V4mis2";"SILVA (only NR);Eukaryota;Amorphea;Obazoa;Opisthokonta;Nucletmycea;Fungi;Dikarya;Ascomycota;Pezizomycotina;Lecanoromycetes;Ostropales;Stictidaceae;Stictis;";"0.0";"0";"1";"1";"0";"1";"0";"457182";"391207"
"V4mis2";"SILVA (only NR);Eukaryota;Amorphea;Obazoa;Opisthokonta;Nucletmycea;Fungi;Dikarya;Ascomycota;Pezizomycotina;Lecanoromycetes;Peltigerales;";"0.0";"0";"23";"23";"0";"23";"0";"457160";"391207"
"V4mis2";"SILVA (only NR);Eukaryota;Amorphea;Obazoa;Opisthokonta;Nucletmycea;Fungi;Dikarya;Ascomycota;Pezizomycotina;Lecanoromycetes;Peltigerales;Coccocarpiaceae;";"0.0";"0";"3";"3";"0";"3";"0";"457180";"391207"
"V4mis2";"SILVA (only NR);Eukaryota;Amorphea;Obazoa;Opisthokonta;Nucletmycea;Fungi;Dikarya;Ascomycota;Pezizomycotina;Lecanoromycetes;Peltigerales;Coccocarpiaceae;Coccocarpia;";"0.0";"0";"3";"3";"0";"3";"0";"457180";"391207"
"V4mis2";"SILVA (only NR);Eukaryota;Amorphea;Obazoa;Opisthokonta;Nucletmycea;Fungi;Dikarya;Ascomycota;Pezizomycotina;Lecanoromycetes;Peltigerales;Collemataceae;";"0.0";"0";"5";"5";"0";"5";"0";"457178";"391207"
"V4mis2";"SILVA (only NR);Eukaryota;Amorphea;Obazoa;Opisthokonta;Nucletmycea;Fungi;Dikarya;Ascomycota;Pezizomycotina;Lecanoromycetes;Peltigerales;Collemataceae;Collema;";"0.0";"0";"2";"2";"0";"2";"0";"457181";"391207"
"V4mis2";"SILVA (only NR);Eukaryota;Amorphea;Obazoa;Opisthokonta;Nucletmycea;Fungi;Dikarya;Ascomycota;Pezizomycotina;Lecanoromycetes;Peltigerales;Collemataceae;Leptogium;";"0.0";"0";"3";"3";"0";"3";"0";"457180";"391207"
"V4mis2";"SILVA (only NR);Eukaryota;Amorphea;Obazoa;Opisthokonta;Nucletmycea;Fungi;Dikarya;Ascomycota;Pezizomycotina;Lecanoromycetes;Peltigerales;Fuscopannaria;";"0.0";"0";"1";"1";"0";"1";"0";"457182";"391207"
"V4mis2";"SILVA (only NR);Eukaryota;Amorphea;Obazoa;Opisthokonta;Nucletmycea;Fungi;Dikarya;Ascomycota;Pezizomycotina;Lecanoromycetes;Peltigerales;Koerberiaceae;";"0.0";"0";"1";"1";"0";"1";"0";"457182";"391207"
"V4mis2";"SILVA (only NR);Eukaryota;Amorphea;Obazoa;Opisthokonta;Nucletmycea;Fungi;Dikarya;Ascomycota;Pezizomycotina;Lecanoromycetes;Peltigerales;Koerberiaceae;Koerberia;";"0.0";"0";"1";"1";"0";"1";"0";"457182";"391207"
"V4mis2";"SILVA (only NR);Eukaryota;Amorphea;Obazoa;Opisthokonta;Nucletmycea;Fungi;Dikarya;Ascomycota;Pezizomycotina;Lecanoromycetes;Peltigerales;Leciophysma;";"0.0";"0";"1";"1";"0";"1";"0";"457182";"391207"
"V4mis2";"SILVA (only NR);Eukaryota;Amorphea;Obazoa;Opisthokonta;Nucletmycea;Fungi;Dikarya;Ascomycota;Pezizomycotina;Lecanoromycetes;Peltigerales;Leptochidium;";"0.0";"0";"1";"1";"0";"1";"0";"457182";"391207"
"V4mis2";"SILVA (only NR);Eukaryota;Amorphea;Obazoa;Opisthokonta;Nucletmycea;Fungi;Dikarya;Ascomycota;Pezizomycotina;Lecanoromycetes;Peltigerales;Lobaria;";"0.0";"0";"1";"1";"0";"1";"0";"457182";"391207"
"V4mis2";"SILVA (only NR);Eukaryota;Amorphea;Obazoa;Opisthokonta;Nucletmycea;Fungi;Dikarya;Ascomycota;Pezizomycotina;Lecanoromycetes;Peltigerales;Massalongia;";"0.0";"0";"1";"1";"0";"1";"0";"457182";"391207"
"V4mis2";"SILVA (only NR);Eukaryota;Amorphea;Obazoa;Opisthokonta;Nucletmycea;Fungi;Dikarya;Ascomycota;Pezizomycotina;Lecanoromycetes;Peltigerales;Nephroma;";"0.0";"0";"1";"1";"0";"1";"0";"457182";"391207"
"V4mis2";"SILVA (only NR);Eukaryota;Amorphea;Obazoa;Opisthokonta;Nucletmycea;Fungi;Dikarya;Ascomycota;Pezizomycotina;Lecanoromycetes;Peltigerales;Parmeliella;";"0.0";"0";"1";"1";"0";"1";"0";"457182";"391207"
"V4mis2";"SILVA (only NR);Eukaryota;Amorphea;Obazoa;Opisthokonta;Nucletmycea;Fungi;Dikarya;Ascomycota;Pezizomycotina;Lecanoromycetes;Peltigerales;Peltigeraceae;";"0.0";"0";"4";"4";"0";"4";"0";"457179";"391207"
"V4mis2";"SILVA (only NR);Eukaryota;Amorphea;Obazoa;Opisthokonta;Nucletmycea;Fungi;Dikarya;Ascomycota;Pezizomycotina;Lecanoromycetes;Peltigerales;Peltigeraceae;Peltigera;";"0.0";"0";"2";"2";"0";"2";"0";"457181";"391207"
"V4mis2";"SILVA (only NR);Eukaryota;Amorphea;Obazoa;Opisthokonta;Nucletmycea;Fungi;Dikarya;Ascomycota;Pezizomycotina;Lecanoromycetes;Peltigerales;Peltigeraceae;Solorina;";"0.0";"0";"2";"2";"0";"2";"0";"457181";"391207"
"V4mis2";"SILVA (only NR);Eukaryota;Amorphea;Obazoa;Opisthokonta;Nucletmycea;Fungi;Dikarya;Ascomycota;Pezizomycotina;Lecanoromycetes;Peltigerales;Placynthium;";"0.0";"0";"1";"1";"0";"1";"0";"457182";"391207"
"V4mis2";"SILVA (only NR);Eukaryota;Amorphea;Obazoa;Opisthokonta;Nucletmycea;Fungi;Dikarya;Ascomycota;Pezizomycotina;Lecanoromycetes;Peltigerales;Pseudocyphellaria;";"0.0";"0";"1";"1";"0";"1";"0";"457182";"391207"
"V4mis2";"SILVA (only NR);Eukaryota;Amorphea;Obazoa;Opisthokonta;Nucletmycea;Fungi;Dikarya;Ascomycota;Pezizomycotina;Lecanoromycetes;Peltigerales;Vahliella;";"0.0";"0";"1";"1";"0";"1";"0";"457182";"391207"
"V4mis2";"SILVA (only NR);Eukaryota;Amorphea;Obazoa;Opisthokonta;Nucletmycea;Fungi;Dikarya;Ascomycota;Pezizomycotina;Lecanoromycetes;Pertusariales;";"0.0";"0";"24";"24";"0";"24";"0";"457159";"391207"
"V4mis2";"SILVA (only NR);Eukaryota;Amorphea;Obazoa;Opisthokonta;Nucletmycea;Fungi;Dikarya;Ascomycota;Pezizomycotina;Lecanoromycetes;Pertusariales;Coccotrema;";"0.0";"0";"1";"1";"0";"1";"0";"457182";"391207"
"V4mis2";"SILVA (only NR);Eukaryota;Amorphea;Obazoa;Opisthokonta;Nucletmycea;Fungi;Dikarya;Ascomycota;Pezizomycotina;Lecanoromycetes;Pertusariales;Icmadophilaceae;";"0.0";"0";"8";"8";"0";"8";"0";"457175";"391207"
"V4mis2";"SILVA (only NR);Eukaryota;Amorphea;Obazoa;Opisthokonta;Nucletmycea;Fungi;Dikarya;Ascomycota;Pezizomycotina;Lecanoromycetes;Pertusariales;Icmadophilaceae;Dibaeis;";"0.0";"0";"2";"2";"0";"2";"0";"457181";"391207"
"V4mis2";"SILVA (only NR);Eukaryota;Amorphea;Obazoa;Opisthokonta;Nucletmycea;Fungi;Dikarya;Ascomycota;Pezizomycotina;Lecanoromycetes;Pertusariales;Icmadophilaceae;Icmadophila;";"0.0";"0";"1";"1";"0";"1";"0";"457182";"391207"
"V4mis2";"SILVA (only NR);Eukaryota;Amorphea;Obazoa;Opisthokonta;Nucletmycea;Fungi;Dikarya;Ascomycota;Pezizomycotina;Lecanoromycetes;Pertusariales;Icmadophilaceae;Siphula;";"0.0";"0";"4";"4";"0";"4";"0";"457179";"391207"
"V4mis2";"SILVA (only NR);Eukaryota;Amorphea;Obazoa;Opisthokonta;Nucletmycea;Fungi;Dikarya;Ascomycota;Pezizomycotina;Lecanoromycetes;Pertusariales;Icmadophilaceae;Thamnolia;";"0.0";"0";"1";"1";"0";"1";"0";"457182";"391207"
"V4mis2";"SILVA (only NR);Eukaryota;Amorphea;Obazoa;Opisthokonta;Nucletmycea;Fungi;Dikarya;Ascomycota;Pezizomycotina;Lecanoromycetes;Pertusariales;Ochrolechiaceae;";"0.0";"0";"4";"4";"0";"4";"0";"457179";"391207"
"V4mis2";"SILVA (only NR);Eukaryota;Amorphea;Obazoa;Opisthokonta;Nucletmycea;Fungi;Dikarya;Ascomycota;Pezizomycotina;Lecanoromycetes;Pertusariales;Ochrolechiaceae;Ochrolechia;";"0.0";"0";"4";"4";"0";"4";"0";"457179";"391207"
"V4mis2";"SILVA (only NR);Eukaryota;Amorphea;Obazoa;Opisthokonta;Nucletmycea;Fungi;Dikarya;Ascomycota;Pezizomycotina;Lecanoromycetes;Pertusariales;Pertusariaceae;";"0.0";"0";"10";"10";"0";"10";"0";"457173";"391207"
"V4mis2";"SILVA (only NR);Eukaryota;Amorphea;Obazoa;Opisthokonta;Nucletmycea;Fungi;Dikarya;Ascomycota;Pezizomycotina;Lecanoromycetes;Pertusariales;Pertusariaceae;Loxosporopsis;";"0.0";"0";"1";"1";"0";"1";"0";"457182";"391207"
"V4mis2";"SILVA (only NR);Eukaryota;Amorphea;Obazoa;Opisthokonta;Nucletmycea;Fungi;Dikarya;Ascomycota;Pezizomycotina;Lecanoromycetes;Pertusariales;Pertusariaceae;Pertusaria;";"0.0";"0";"8";"8";"0";"8";"0";"457175";"391207"
"V4mis2";"SILVA (only NR);Eukaryota;Amorphea;Obazoa;Opisthokonta;Nucletmycea;Fungi;Dikarya;Ascomycota;Pezizomycotina;Lecanoromycetes;Rhizocarpales;";"0.0";"0";"2";"2";"0";"2";"0";"457181";"391207"
"V4mis2";"SILVA (only NR);Eukaryota;Amorphea;Obazoa;Opisthokonta;Nucletmycea;Fungi;Dikarya;Ascomycota;Pezizomycotina;Lecanoromycetes;Rhizocarpales;Rhizocarpaceae;";"0.0";"0";"2";"2";"0";"2";"0";"457181";"391207"
"V4mis2";"SILVA (only NR);Eukaryota;Amorphea;Obazoa;Opisthokonta;Nucletmycea;Fungi;Dikarya;Ascomycota;Pezizomycotina;Lecanoromycetes;Rhizocarpales;Rhizocarpaceae;Rhizocarpon;";"0.0";"0";"2";"2";"0";"2";"0";"457181";"391207"
"V4mis2";"SILVA (only NR);Eukaryota;Amorphea;Obazoa;Opisthokonta;Nucletmycea;Fungi;Dikarya;Ascomycota;Pezizomycotina;Lecanoromycetes;Teloschistales;";"0.0";"0";"48";"48";"0";"48";"0";"457135";"391207"
"V4mis2";"SILVA (only NR);Eukaryota;Amorphea;Obazoa;Opisthokonta;Nucletmycea;Fungi;Dikarya;Ascomycota;Pezizomycotina;Lecanoromycetes;Teloschistales;Brigantiaeaceae;";"0.0";"0";"2";"2";"0";"2";"0";"457181";"391207"
"V4mis2";"SILVA (only NR);Eukaryota;Amorphea;Obazoa;Opisthokonta;Nucletmycea;Fungi;Dikarya;Ascomycota;Pezizomycotina;Lecanoromycetes;Teloschistales;Brigantiaeaceae;Brigantiaea;";"0.0";"0";"2";"2";"0";"2";"0";"457181";"391207"
"V4mis2";"SILVA (only NR);Eukaryota;Amorphea;Obazoa;Opisthokonta;Nucletmycea;Fungi;Dikarya;Ascomycota;Pezizomycotina;Lecanoromycetes;Teloschistales;Letrouitiaceae;";"0.0";"0";"4";"4";"0";"4";"0";"457179";"391207"
"V4mis2";"SILVA (only NR);Eukaryota;Amorphea;Obazoa;Opisthokonta;Nucletmycea;Fungi;Dikarya;Ascomycota;Pezizomycotina;Lecanoromycetes;Teloschistales;Letrouitiaceae;Letrouitia;";"0.0";"0";"4";"4";"0";"4";"0";"457179";"391207"
"V4mis2";"SILVA (only NR);Eukaryota;Amorphea;Obazoa;Opisthokonta;Nucletmycea;Fungi;Dikarya;Ascomycota;Pezizomycotina;Lecanoromycetes;Teloschistales;Megalosporaceae;";"0.0";"0";"3";"3";"0";"3";"0";"457180";"391207"
"V4mis2";"SILVA (only NR);Eukaryota;Amorphea;Obazoa;Opisthokonta;Nucletmycea;Fungi;Dikarya;Ascomycota;Pezizomycotina;Lecanoromycetes;Teloschistales;Megalosporaceae;Megalospora;";"0.0";"0";"2";"2";"0";"2";"0";"457181";"391207"
"V4mis2";"SILVA (only NR);Eukaryota;Amorphea;Obazoa;Opisthokonta;Nucletmycea;Fungi;Dikarya;Ascomycota;Pezizomycotina;Lecanoromycetes;Teloschistales;Megalosporaceae;Sipmaniella;";"0.0";"0";"1";"1";"0";"1";"0";"457182";"391207"
"V4mis2";"SILVA (only NR);Eukaryota;Amorphea;Obazoa;Opisthokonta;Nucletmycea;Fungi;Dikarya;Ascomycota;Pezizomycotina;Lecanoromycetes;Teloschistales;Teloschistaceae;";"0.0";"0";"39";"39";"0";"39";"0";"457144";"391207"
"V4mis2";"SILVA (only NR);Eukaryota;Amorphea;Obazoa;Opisthokonta;Nucletmycea;Fungi;Dikarya;Ascomycota;Pezizomycotina;Lecanoromycetes;Teloschistales;Teloschistaceae;Caloplaca;";"0.0";"0";"3";"3";"0";"3";"0";"457180";"391207"
"V4mis2";"SILVA (only NR);Eukaryota;Amorphea;Obazoa;Opisthokonta;Nucletmycea;Fungi;Dikarya;Ascomycota;Pezizomycotina;Lecanoromycetes;Teloschistales;Teloschistaceae;Dufourea;";"0.0";"0";"2";"2";"0";"2";"0";"457181";"391207"
"V4mis2";"SILVA (only NR);Eukaryota;Amorphea;Obazoa;Opisthokonta;Nucletmycea;Fungi;Dikarya;Ascomycota;Pezizomycotina;Lecanoromycetes;Teloschistales;Teloschistaceae;Flavoplaca;";"0.0";"0";"1";"1";"0";"1";"0";"457182";"391207"
"V4mis2";"SILVA (only NR);Eukaryota;Amorphea;Obazoa;Opisthokonta;Nucletmycea;Fungi;Dikarya;Ascomycota;Pezizomycotina;Lecanoromycetes;Teloschistales;Teloschistaceae;Gyalolechia;";"0.0";"0";"1";"1";"0";"1";"0";"457182";"391207"
"V4mis2";"SILVA (only NR);Eukaryota;Amorphea;Obazoa;Opisthokonta;Nucletmycea;Fungi;Dikarya;Ascomycota;Pezizomycotina;Lecanoromycetes;Teloschistales;Teloschistaceae;Hosseusiella;";"0.0";"0";"1";"1";"0";"1";"0";"457182";"391207"
"V4mis2";"SILVA (only NR);Eukaryota;Amorphea;Obazoa;Opisthokonta;Nucletmycea;Fungi;Dikarya;Ascomycota;Pezizomycotina;Lecanoromycetes;Teloschistales;Teloschistaceae;Josefpoeltia;";"0.0";"0";"1";"1";"0";"1";"0";"457182";"391207"
"V4mis2";"SILVA (only NR);Eukaryota;Amorphea;Obazoa;Opisthokonta;Nucletmycea;Fungi;Dikarya;Ascomycota;Pezizomycotina;Lecanoromycetes;Teloschistales;Teloschistaceae;Niorma;";"0.0";"0";"3";"3";"0";"3";"0";"457180";"391207"
"V4mis2";"SILVA (only NR);Eukaryota;Amorphea;Obazoa;Opisthokonta;Nucletmycea;Fungi;Dikarya;Ascomycota;Pezizomycotina;Lecanoromycetes;Teloschistales;Teloschistaceae;Olegblumia;";"0.0";"0";"1";"1";"0";"1";"0";"457182";"391207"
"V4mis2";"SILVA (only NR);Eukaryota;Amorphea;Obazoa;Opisthokonta;Nucletmycea;Fungi;Dikarya;Ascomycota;Pezizomycotina;Lecanoromycetes;Teloschistales;Teloschistaceae;Polycauliona;";"0.0";"0";"1";"1";"0";"1";"0";"457182";"391207"
"V4mis2";"SILVA (only NR);Eukaryota;Amorphea;Obazoa;Opisthokonta;Nucletmycea;Fungi;Dikarya;Ascomycota;Pezizomycotina;Lecanoromycetes;Teloschistales;Teloschistaceae;Pyrenodesmia;";"0.0";"0";"1";"1";"0";"1";"0";"457182";"391207"
"V4mis2";"SILVA (only NR);Eukaryota;Amorphea;Obazoa;Opisthokonta;Nucletmycea;Fungi;Dikarya;Ascomycota;Pezizomycotina;Lecanoromycetes;Teloschistales;Teloschistaceae;Rusavskia;";"0.0";"0";"4";"4";"0";"4";"0";"457179";"391207"
"V4mis2";"SILVA (only NR);Eukaryota;Amorphea;Obazoa;Opisthokonta;Nucletmycea;Fungi;Dikarya;Ascomycota;Pezizomycotina;Lecanoromycetes;Teloschistales;Teloschistaceae;Teloschistes;";"0.0";"0";"3";"3";"0";"3";"0";"457180";"391207"
"V4mis2";"SILVA (only NR);Eukaryota;Amorphea;Obazoa;Opisthokonta;Nucletmycea;Fungi;Dikarya;Ascomycota;Pezizomycotina;Lecanoromycetes;Teloschistales;Teloschistaceae;Usnochroma;";"0.0";"0";"1";"1";"0";"1";"0";"457182";"391207"
"V4mis2";"SILVA (only NR);Eukaryota;Amorphea;Obazoa;Opisthokonta;Nucletmycea;Fungi;Dikarya;Ascomycota;Pezizomycotina;Lecanoromycetes;Teloschistales;Teloschistaceae;Xanthocarpia;";"0.0";"0";"1";"1";"0";"1";"0";"457182";"391207"
"V4mis2";"SILVA (only NR);Eukaryota;Amorphea;Obazoa;Opisthokonta;Nucletmycea;Fungi;Dikarya;Ascomycota;Pezizomycotina;Lecanoromycetes;Teloschistales;Teloschistaceae;Xanthomendoza;";"0.0";"0";"9";"9";"0";"9";"0";"457174";"391207"
"V4mis2";"SILVA (only NR);Eukaryota;Amorphea;Obazoa;Opisthokonta;Nucletmycea;Fungi;Dikarya;Ascomycota;Pezizomycotina;Lecanoromycetes;Teloschistales;Teloschistaceae;Xanthoria;";"0.0";"0";"4";"4";"0";"4";"0";"457179";"391207"
"V4mis2";"SILVA (only NR);Eukaryota;Amorphea;Obazoa;Opisthokonta;Nucletmycea;Fungi;Dikarya;Ascomycota;Pezizomycotina;Lecanoromycetes;Trapeliales;";"0.0";"0";"4";"4";"0";"4";"0";"457179";"391207"
"V4mis2";"SILVA (only NR);Eukaryota;Amorphea;Obazoa;Opisthokonta;Nucletmycea;Fungi;Dikarya;Ascomycota;Pezizomycotina;Lecanoromycetes;Trapeliales;Trapeliaceae;";"0.0";"0";"4";"4";"0";"4";"0";"457179";"391207"
"V4mis2";"SILVA (only NR);Eukaryota;Amorphea;Obazoa;Opisthokonta;Nucletmycea;Fungi;Dikarya;Ascomycota;Pezizomycotina;Lecanoromycetes;Trapeliales;Trapeliaceae;Placopsis;";"0.0";"0";"1";"1";"0";"1";"0";"457182";"391207"
"V4mis2";"SILVA (only NR);Eukaryota;Amorphea;Obazoa;Opisthokonta;Nucletmycea;Fungi;Dikarya;Ascomycota;Pezizomycotina;Lecanoromycetes;Trapeliales;Trapeliaceae;Trapelia;";"0.0";"0";"1";"1";"0";"1";"0";"457182";"391207"
"V4mis2";"SILVA (only NR);Eukaryota;Amorphea;Obazoa;Opisthokonta;Nucletmycea;Fungi;Dikarya;Ascomycota;Pezizomycotina;Lecanoromycetes;Trapeliales;Trapeliaceae;Trapeliopsis;";"0.0";"0";"1";"1";"0";"1";"0";"457182";"391207"
"V4mis2";"SILVA (only NR);Eukaryota;Amorphea;Obazoa;Opisthokonta;Nucletmycea;Fungi;Dikarya;Ascomycota;Pezizomycotina;Lecanoromycetes;Trapeliales;Trapeliaceae;Xylographa;";"0.0";"0";"1";"1";"0";"1";"0";"457182";"391207"
"V4mis2";"SILVA (only NR);Eukaryota;Amorphea;Obazoa;Opisthokonta;Nucletmycea;Fungi;Dikarya;Ascomycota;Pezizomycotina;Lecanoromycetes;Umbilicariales;";"0.0";"0";"13";"13";"0";"13";"0";"457170";"391207"
"V4mis2";"SILVA (only NR);Eukaryota;Amorphea;Obazoa;Opisthokonta;Nucletmycea;Fungi;Dikarya;Ascomycota;Pezizomycotina;Lecanoromycetes;Umbilicariales;Umbilicariaceae;";"0.0";"0";"13";"13";"0";"13";"0";"457170";"391207"
"V4mis2";"SILVA (only NR);Eukaryota;Amorphea;Obazoa;Opisthokonta;Nucletmycea;Fungi;Dikarya;Ascomycota;Pezizomycotina;Lecanoromycetes;Umbilicariales;Umbilicariaceae;Umbilicaria;";"0.0";"0";"13";"13";"0";"13";"0";"457170";"391207"
"V4mis2";"SILVA (only NR);Eukaryota;Amorphea;Obazoa;Opisthokonta;Nucletmycea;Fungi;Dikarya;Ascomycota;Pezizomycotina;Leotiomyceta Incertae Sedis;";"0.0";"0";"2";"2";"0";"2";"0";"457181";"391207"
"V4mis2";"SILVA (only NR);Eukaryota;Amorphea;Obazoa;Opisthokonta;Nucletmycea;Fungi;Dikarya;Ascomycota;Pezizomycotina;Leotiomyceta Incertae Sedis;Candelariales;";"0.0";"0";"2";"2";"0";"2";"0";"457181";"391207"
"V4mis2";"SILVA (only NR);Eukaryota;Amorphea;Obazoa;Opisthokonta;Nucletmycea;Fungi;Dikarya;Ascomycota;Pezizomycotina;Leotiomyceta Incertae Sedis;Candelariales;Pycnoraceae;";"0.0";"0";"2";"2";"0";"2";"0";"457181";"391207"
"V4mis2";"SILVA (only NR);Eukaryota;Amorphea;Obazoa;Opisthokonta;Nucletmycea;Fungi;Dikarya;Ascomycota;Pezizomycotina;Leotiomyceta Incertae Sedis;Candelariales;Pycnoraceae;Pycnora;";"0.0";"0";"1";"1";"0";"1";"0";"457182";"391207"
"V4mis2";"SILVA (only NR);Eukaryota;Amorphea;Obazoa;Opisthokonta;Nucletmycea;Fungi;Dikarya;Ascomycota;Pezizomycotina;Leotiomycetes;";"0.4";"14.4";"226";"226";"1";"225";"0";"456957";"391206"
"V4mis2";"SILVA (only NR);Eukaryota;Amorphea;Obazoa;Opisthokonta;Nucletmycea;Fungi;Dikarya;Ascomycota;Pezizomycotina;Leotiomycetes;Cyttariales;";"0.0";"0";"6";"6";"0";"6";"0";"457177";"391207"
"V4mis2";"SILVA (only NR);Eukaryota;Amorphea;Obazoa;Opisthokonta;Nucletmycea;Fungi;Dikarya;Ascomycota;Pezizomycotina;Leotiomycetes;Cyttariales;Cyttariaceae;";"0.0";"0";"6";"6";"0";"6";"0";"457177";"391207"
"V4mis2";"SILVA (only NR);Eukaryota;Amorphea;Obazoa;Opisthokonta;Nucletmycea;Fungi;Dikarya;Ascomycota;Pezizomycotina;Leotiomycetes;Cyttariales;Cyttariaceae;Cyttaria;";"0.0";"0";"6";"6";"0";"6";"0";"457177";"391207"
"V4mis2";"SILVA (only NR);Eukaryota;Amorphea;Obazoa;Opisthokonta;Nucletmycea;Fungi;Dikarya;Ascomycota;Pezizomycotina;Leotiomycetes;Erysiphales;";"0.0";"0";"17";"17";"0";"17";"0";"457166";"391207"
"V4mis2";"SILVA (only NR);Eukaryota;Amorphea;Obazoa;Opisthokonta;Nucletmycea;Fungi;Dikarya;Ascomycota;Pezizomycotina;Leotiomycetes;Erysiphales;Erysiphaceae;";"0.0";"0";"17";"17";"0";"17";"0";"457166";"391207"
"V4mis2";"SILVA (only NR);Eukaryota;Amorphea;Obazoa;Opisthokonta;Nucletmycea;Fungi;Dikarya;Ascomycota;Pezizomycotina;Leotiomycetes;Erysiphales;Erysiphaceae;Arthrocladiella;";"0.0";"0";"1";"1";"0";"1";"0";"457182";"391207"
"V4mis2";"SILVA (only NR);Eukaryota;Amorphea;Obazoa;Opisthokonta;Nucletmycea;Fungi;Dikarya;Ascomycota;Pezizomycotina;Leotiomycetes;Erysiphales;Erysiphaceae;Blumeria;";"0.0";"0";"1";"1";"0";"1";"0";"457182";"391207"
"V4mis2";"SILVA (only NR);Eukaryota;Amorphea;Obazoa;Opisthokonta;Nucletmycea;Fungi;Dikarya;Ascomycota;Pezizomycotina;Leotiomycetes;Erysiphales;Erysiphaceae;Brasiliomyces;";"0.0";"0";"1";"1";"0";"1";"0";"457182";"391207"
"V4mis2";"SILVA (only NR);Eukaryota;Amorphea;Obazoa;Opisthokonta;Nucletmycea;Fungi;Dikarya;Ascomycota;Pezizomycotina;Leotiomycetes;Erysiphales;Erysiphaceae;Caespitotheca;";"0.0";"0";"1";"1";"0";"1";"0";"457182";"391207"
"V4mis2";"SILVA (only NR);Eukaryota;Amorphea;Obazoa;Opisthokonta;Nucletmycea;Fungi;Dikarya;Ascomycota;Pezizomycotina;Leotiomycetes;Erysiphales;Erysiphaceae;Erysiphe;";"0.0";"0";"5";"5";"0";"5";"0";"457178";"391207"
"V4mis2";"SILVA (only NR);Eukaryota;Amorphea;Obazoa;Opisthokonta;Nucletmycea;Fungi;Dikarya;Ascomycota;Pezizomycotina;Leotiomycetes;Erysiphales;Erysiphaceae;Golovinomyces;";"0.0";"0";"1";"1";"0";"1";"0";"457182";"391207"
"V4mis2";"SILVA (only NR);Eukaryota;Amorphea;Obazoa;Opisthokonta;Nucletmycea;Fungi;Dikarya;Ascomycota;Pezizomycotina;Leotiomycetes;Erysiphales;Erysiphaceae;Microidium;";"0.0";"0";"1";"1";"0";"1";"0";"457182";"391207"
"V4mis2";"SILVA (only NR);Eukaryota;Amorphea;Obazoa;Opisthokonta;Nucletmycea;Fungi;Dikarya;Ascomycota;Pezizomycotina;Leotiomycetes;Erysiphales;Erysiphaceae;Neoerysiphe;";"0.0";"0";"1";"1";"0";"1";"0";"457182";"391207"
"V4mis2";"SILVA (only NR);Eukaryota;Amorphea;Obazoa;Opisthokonta;Nucletmycea;Fungi;Dikarya;Ascomycota;Pezizomycotina;Leotiomycetes;Erysiphales;Erysiphaceae;Parauncinula;";"0.0";"0";"1";"1";"0";"1";"0";"457182";"391207"
"V4mis2";"SILVA (only NR);Eukaryota;Amorphea;Obazoa;Opisthokonta;Nucletmycea;Fungi;Dikarya;Ascomycota;Pezizomycotina;Leotiomycetes;Erysiphales;Erysiphaceae;Phyllactinia;";"0.0";"0";"1";"1";"0";"1";"0";"457182";"391207"
"V4mis2";"SILVA (only NR);Eukaryota;Amorphea;Obazoa;Opisthokonta;Nucletmycea;Fungi;Dikarya;Ascomycota;Pezizomycotina;Leotiomycetes;Erysiphales;Erysiphaceae;Pleochaeta;";"0.0";"0";"2";"2";"0";"2";"0";"457181";"391207"
"V4mis2";"SILVA (only NR);Eukaryota;Amorphea;Obazoa;Opisthokonta;Nucletmycea;Fungi;Dikarya;Ascomycota;Pezizomycotina;Leotiomycetes;Erysiphales;Erysiphaceae;Podosphaera;";"0.0";"0";"1";"1";"0";"1";"0";"457182";"391207"
"V4mis2";"SILVA (only NR);Eukaryota;Amorphea;Obazoa;Opisthokonta;Nucletmycea;Fungi;Dikarya;Ascomycota;Pezizomycotina;Leotiomycetes;Helotiales;";"0.7";"14.4";"147";"147";"1";"146";"0";"457036";"391206"
"V4mis2";"SILVA (only NR);Eukaryota;Amorphea;Obazoa;Opisthokonta;Nucletmycea;Fungi;Dikarya;Ascomycota;Pezizomycotina;Leotiomycetes;Helotiales;Bambusicola;";"0.0";"0";"1";"1";"0";"1";"0";"457182";"391207"
"V4mis2";"SILVA (only NR);Eukaryota;Amorphea;Obazoa;Opisthokonta;Nucletmycea;Fungi;Dikarya;Ascomycota;Pezizomycotina;Leotiomycetes;Helotiales;Bisporella;";"0.0";"0";"1";"1";"0";"1";"0";"457182";"391207"
"V4mis2";"SILVA (only NR);Eukaryota;Amorphea;Obazoa;Opisthokonta;Nucletmycea;Fungi;Dikarya;Ascomycota;Pezizomycotina;Leotiomycetes;Helotiales;Calycellinopsis;";"0.0";"0";"1";"1";"0";"1";"0";"457182";"391207"
"V4mis2";"SILVA (only NR);Eukaryota;Amorphea;Obazoa;Opisthokonta;Nucletmycea;Fungi;Dikarya;Ascomycota;Pezizomycotina;Leotiomycetes;Helotiales;Calycina;";"0.0";"0";"2";"2";"0";"2";"0";"457181";"391207"
"V4mis2";"SILVA (only NR);Eukaryota;Amorphea;Obazoa;Opisthokonta;Nucletmycea;Fungi;Dikarya;Ascomycota;Pezizomycotina;Leotiomycetes;Helotiales;Cashiella;";"0.0";"0";"1";"1";"0";"1";"0";"457182";"391207"
"V4mis2";"SILVA (only NR);Eukaryota;Amorphea;Obazoa;Opisthokonta;Nucletmycea;Fungi;Dikarya;Ascomycota;Pezizomycotina;Leotiomycetes;Helotiales;Cenangiaceae;";"0.0";"0";"5";"5";"0";"5";"0";"457178";"391207"
"V4mis2";"SILVA (only NR);Eukaryota;Amorphea;Obazoa;Opisthokonta;Nucletmycea;Fungi;Dikarya;Ascomycota;Pezizomycotina;Leotiomycetes;Helotiales;Cenangiaceae;Cenangium;";"0.0";"0";"2";"2";"0";"2";"0";"457181";"391207"
"V4mis2";"SILVA (only NR);Eukaryota;Amorphea;Obazoa;Opisthokonta;Nucletmycea;Fungi;Dikarya;Ascomycota;Pezizomycotina;Leotiomycetes;Helotiales;Cenangiaceae;Chlorencoelia;";"0.0";"0";"1";"1";"0";"1";"0";"457182";"391207"
"V4mis2";"SILVA (only NR);Eukaryota;Amorphea;Obazoa;Opisthokonta;Nucletmycea;Fungi;Dikarya;Ascomycota;Pezizomycotina;Leotiomycetes;Helotiales;Cenangiaceae;Heyderia;";"0.0";"0";"1";"1";"0";"1";"0";"457182";"391207"
"V4mis2";"SILVA (only NR);Eukaryota;Amorphea;Obazoa;Opisthokonta;Nucletmycea;Fungi;Dikarya;Ascomycota;Pezizomycotina;Leotiomycetes;Helotiales;Cenangiaceae;Sarcotrochila;";"0.0";"0";"1";"1";"0";"1";"0";"457182";"391207"
"V4mis2";"SILVA (only NR);Eukaryota;Amorphea;Obazoa;Opisthokonta;Nucletmycea;Fungi;Dikarya;Ascomycota;Pezizomycotina;Leotiomycetes;Helotiales;Chaetomellaceae;";"0.0";"0";"9";"9";"0";"9";"0";"457174";"391207"
"V4mis2";"SILVA (only NR);Eukaryota;Amorphea;Obazoa;Opisthokonta;Nucletmycea;Fungi;Dikarya;Ascomycota;Pezizomycotina;Leotiomycetes;Helotiales;Chaetomellaceae;Chaetomella;";"0.0";"0";"5";"5";"0";"5";"0";"457178";"391207"
"V4mis2";"SILVA (only NR);Eukaryota;Amorphea;Obazoa;Opisthokonta;Nucletmycea;Fungi;Dikarya;Ascomycota;Pezizomycotina;Leotiomycetes;Helotiales;Chaetomellaceae;Pilidium;";"0.0";"0";"2";"2";"0";"2";"0";"457181";"391207"
"V4mis2";"SILVA (only NR);Eukaryota;Amorphea;Obazoa;Opisthokonta;Nucletmycea;Fungi;Dikarya;Ascomycota;Pezizomycotina;Leotiomycetes;Helotiales;Chaetomellaceae;Sphaerographium;";"0.0";"0";"1";"1";"0";"1";"0";"457182";"391207"
"V4mis2";"SILVA (only NR);Eukaryota;Amorphea;Obazoa;Opisthokonta;Nucletmycea;Fungi;Dikarya;Ascomycota;Pezizomycotina;Leotiomycetes;Helotiales;Chaetomellaceae;Synchaetomella;";"0.0";"0";"1";"1";"0";"1";"0";"457182";"391207"
"V4mis2";"SILVA (only NR);Eukaryota;Amorphea;Obazoa;Opisthokonta;Nucletmycea;Fungi;Dikarya;Ascomycota;Pezizomycotina;Leotiomycetes;Helotiales;Chlorociboriaceae;";"0.0";"0";"4";"4";"0";"4";"0";"457179";"391207"
"V4mis2";"SILVA (only NR);Eukaryota;Amorphea;Obazoa;Opisthokonta;Nucletmycea;Fungi;Dikarya;Ascomycota;Pezizomycotina;Leotiomycetes;Helotiales;Chlorociboriaceae;Chlorociboria;";"0.0";"0";"4";"4";"0";"4";"0";"457179";"391207"
"V4mis2";"SILVA (only NR);Eukaryota;Amorphea;Obazoa;Opisthokonta;Nucletmycea;Fungi;Dikarya;Ascomycota;Pezizomycotina;Leotiomycetes;Helotiales;Chlorovibrissea;";"0.0";"0";"1";"1";"0";"1";"0";"457182";"391207"
"V4mis2";"SILVA (only NR);Eukaryota;Amorphea;Obazoa;Opisthokonta;Nucletmycea;Fungi;Dikarya;Ascomycota;Pezizomycotina;Leotiomycetes;Helotiales;Claussenomyces;";"0.0";"0";"1";"1";"0";"1";"0";"457182";"391207"
"V4mis2";"SILVA (only NR);Eukaryota;Amorphea;Obazoa;Opisthokonta;Nucletmycea;Fungi;Dikarya;Ascomycota;Pezizomycotina;Leotiomycetes;Helotiales;Cordieritidaceae;";"0.0";"0";"2";"2";"0";"2";"0";"457181";"391207"
"V4mis2";"SILVA (only NR);Eukaryota;Amorphea;Obazoa;Opisthokonta;Nucletmycea;Fungi;Dikarya;Ascomycota;Pezizomycotina;Leotiomycetes;Helotiales;Cordieritidaceae;Cordierites;";"0.0";"0";"1";"1";"0";"1";"0";"457182";"391207"
"V4mis2";"SILVA (only NR);Eukaryota;Amorphea;Obazoa;Opisthokonta;Nucletmycea;Fungi;Dikarya;Ascomycota;Pezizomycotina;Leotiomycetes;Helotiales;Cordieritidaceae;Thamnogalla;";"0.0";"0";"1";"1";"0";"1";"0";"457182";"391207"
"V4mis2";"SILVA (only NR);Eukaryota;Amorphea;Obazoa;Opisthokonta;Nucletmycea;Fungi;Dikarya;Ascomycota;Pezizomycotina;Leotiomycetes;Helotiales;Cyclaneusma;";"0.0";"0";"1";"1";"0";"1";"0";"457182";"391207"
"V4mis2";"SILVA (only NR);Eukaryota;Amorphea;Obazoa;Opisthokonta;Nucletmycea;Fungi;Dikarya;Ascomycota;Pezizomycotina;Leotiomycetes;Helotiales;Dermateaceae;";"0.0";"0";"2";"2";"0";"2";"0";"457181";"391207"
"V4mis2";"SILVA (only NR);Eukaryota;Amorphea;Obazoa;Opisthokonta;Nucletmycea;Fungi;Dikarya;Ascomycota;Pezizomycotina;Leotiomycetes;Helotiales;Dermateaceae;Dermea;";"0.0";"0";"1";"1";"0";"1";"0";"457182";"391207"
"V4mis2";"SILVA (only NR);Eukaryota;Amorphea;Obazoa;Opisthokonta;Nucletmycea;Fungi;Dikarya;Ascomycota;Pezizomycotina;Leotiomycetes;Helotiales;Dermateaceae;Pezicula;";"0.0";"0";"1";"1";"0";"1";"0";"457182";"391207"
"V4mis2";"SILVA (only NR);Eukaryota;Amorphea;Obazoa;Opisthokonta;Nucletmycea;Fungi;Dikarya;Ascomycota;Pezizomycotina;Leotiomycetes;Helotiales;Discohainesia;";"0.0";"0";"1";"1";"0";"1";"0";"457182";"391207"
"V4mis2";"SILVA (only NR);Eukaryota;Amorphea;Obazoa;Opisthokonta;Nucletmycea;Fungi;Dikarya;Ascomycota;Pezizomycotina;Leotiomycetes;Helotiales;Encoelia;";"0.0";"0";"1";"1";"0";"1";"0";"457182";"391207"
"V4mis2";"SILVA (only NR);Eukaryota;Amorphea;Obazoa;Opisthokonta;Nucletmycea;Fungi;Dikarya;Ascomycota;Pezizomycotina;Leotiomycetes;Helotiales;Glarea;";"0.0";"0";"1";"1";"0";"1";"0";"457182";"391207"
"V4mis2";"SILVA (only NR);Eukaryota;Amorphea;Obazoa;Opisthokonta;Nucletmycea;Fungi;Dikarya;Ascomycota;Pezizomycotina;Leotiomycetes;Helotiales;Helotiaceae;";"0.0";"0";"25";"25";"0";"25";"0";"457158";"391207"
"V4mis2";"SILVA (only NR);Eukaryota;Amorphea;Obazoa;Opisthokonta;Nucletmycea;Fungi;Dikarya;Ascomycota;Pezizomycotina;Leotiomycetes;Helotiales;Helotiaceae;Acidea;";"0.0";"0";"2";"2";"0";"2";"0";"457181";"391207"
"V4mis2";"SILVA (only NR);Eukaryota;Amorphea;Obazoa;Opisthokonta;Nucletmycea;Fungi;Dikarya;Ascomycota;Pezizomycotina;Leotiomycetes;Helotiales;Helotiaceae;Ascocoryne;";"0.0";"0";"1";"1";"0";"1";"0";"457182";"391207"
"V4mis2";"SILVA (only NR);Eukaryota;Amorphea;Obazoa;Opisthokonta;Nucletmycea;Fungi;Dikarya;Ascomycota;Pezizomycotina;Leotiomycetes;Helotiales;Helotiaceae;Chloroscypha;";"0.0";"0";"1";"1";"0";"1";"0";"457182";"391207"
"V4mis2";"SILVA (only NR);Eukaryota;Amorphea;Obazoa;Opisthokonta;Nucletmycea;Fungi;Dikarya;Ascomycota;Pezizomycotina;Leotiomycetes;Helotiales;Helotiaceae;Epiglia;";"0.0";"0";"1";"1";"0";"1";"0";"457182";"391207"
"V4mis2";"SILVA (only NR);Eukaryota;Amorphea;Obazoa;Opisthokonta;Nucletmycea;Fungi;Dikarya;Ascomycota;Pezizomycotina;Leotiomycetes;Helotiales;Helotiaceae;Epithamnolia;";"0.0";"0";"1";"1";"0";"1";"0";"457182";"391207"
"V4mis2";"SILVA (only NR);Eukaryota;Amorphea;Obazoa;Opisthokonta;Nucletmycea;Fungi;Dikarya;Ascomycota;Pezizomycotina;Leotiomycetes;Helotiales;Helotiaceae;Gremmeniella;";"0.0";"0";"1";"1";"0";"1";"0";"457182";"391207"
"V4mis2";"SILVA (only NR);Eukaryota;Amorphea;Obazoa;Opisthokonta;Nucletmycea;Fungi;Dikarya;Ascomycota;Pezizomycotina;Leotiomycetes;Helotiales;Helotiaceae;Helicodendron;";"0.0";"0";"2";"2";"0";"2";"0";"457181";"391207"
"V4mis2";"SILVA (only NR);Eukaryota;Amorphea;Obazoa;Opisthokonta;Nucletmycea;Fungi;Dikarya;Ascomycota;Pezizomycotina;Leotiomycetes;Helotiales;Helotiaceae;Holwaya;";"0.0";"0";"1";"1";"0";"1";"0";"457182";"391207"
"V4mis2";"SILVA (only NR);Eukaryota;Amorphea;Obazoa;Opisthokonta;Nucletmycea;Fungi;Dikarya;Ascomycota;Pezizomycotina;Leotiomycetes;Helotiales;Helotiaceae;Meliniomyces;";"0.0";"0";"4";"4";"0";"4";"0";"457179";"391207"
"V4mis2";"SILVA (only NR);Eukaryota;Amorphea;Obazoa;Opisthokonta;Nucletmycea;Fungi;Dikarya;Ascomycota;Pezizomycotina;Leotiomycetes;Helotiales;Helotiaceae;Mniaecia;";"0.0";"0";"1";"1";"0";"1";"0";"457182";"391207"
"V4mis2";"SILVA (only NR);Eukaryota;Amorphea;Obazoa;Opisthokonta;Nucletmycea;Fungi;Dikarya;Ascomycota;Pezizomycotina;Leotiomycetes;Helotiales;Helotiaceae;Tetrachaetum;";"0.0";"0";"1";"1";"0";"1";"0";"457182";"391207"
"V4mis2";"SILVA (only NR);Eukaryota;Amorphea;Obazoa;Opisthokonta;Nucletmycea;Fungi;Dikarya;Ascomycota;Pezizomycotina;Leotiomycetes;Helotiales;Helotiaceae;Varicosporium;";"0.0";"0";"1";"1";"0";"1";"0";"457182";"391207"
"V4mis2";"SILVA (only NR);Eukaryota;Amorphea;Obazoa;Opisthokonta;Nucletmycea;Fungi;Dikarya;Ascomycota;Pezizomycotina;Leotiomycetes;Helotiales;Hyaloscypha;";"0.0";"0";"1";"1";"0";"1";"0";"457182";"391207"
"V4mis2";"SILVA (only NR);Eukaryota;Amorphea;Obazoa;Opisthokonta;Nucletmycea;Fungi;Dikarya;Ascomycota;Pezizomycotina;Leotiomycetes;Helotiales;Hymenoscyphus;";"0.0";"0";"2";"2";"0";"2";"0";"457181";"391207"
"V4mis2";"SILVA (only NR);Eukaryota;Amorphea;Obazoa;Opisthokonta;Nucletmycea;Fungi;Dikarya;Ascomycota;Pezizomycotina;Leotiomycetes;Helotiales;Incertae Sedis;";"0.0";"0";"26";"26";"0";"26";"0";"457157";"391207"
"V4mis2";"SILVA (only NR);Eukaryota;Amorphea;Obazoa;Opisthokonta;Nucletmycea;Fungi;Dikarya;Ascomycota;Pezizomycotina;Leotiomycetes;Helotiales;Incertae Sedis;Brachyalara;";"0.0";"0";"2";"2";"0";"2";"0";"457181";"391207"
"V4mis2";"SILVA (only NR);Eukaryota;Amorphea;Obazoa;Opisthokonta;Nucletmycea;Fungi;Dikarya;Ascomycota;Pezizomycotina;Leotiomycetes;Helotiales;Incertae Sedis;Cadophora;";"0.0";"0";"1";"1";"0";"1";"0";"457182";"391207"
"V4mis2";"SILVA (only NR);Eukaryota;Amorphea;Obazoa;Opisthokonta;Nucletmycea;Fungi;Dikarya;Ascomycota;Pezizomycotina;Leotiomycetes;Helotiales;Incertae Sedis;Exochalara;";"0.0";"0";"2";"2";"0";"2";"0";"457181";"391207"
"V4mis2";"SILVA (only NR);Eukaryota;Amorphea;Obazoa;Opisthokonta;Nucletmycea;Fungi;Dikarya;Ascomycota;Pezizomycotina;Leotiomycetes;Helotiales;Incertae Sedis;Infundichalara;";"0.0";"0";"2";"2";"0";"2";"0";"457181";"391207"
"V4mis2";"SILVA (only NR);Eukaryota;Amorphea;Obazoa;Opisthokonta;Nucletmycea;Fungi;Dikarya;Ascomycota;Pezizomycotina;Leotiomycetes;Helotiales;Incertae Sedis;Lemonniera;";"0.0";"0";"3";"3";"0";"3";"0";"457180";"391207"
"V4mis2";"SILVA (only NR);Eukaryota;Amorphea;Obazoa;Opisthokonta;Nucletmycea;Fungi;Dikarya;Ascomycota;Pezizomycotina;Leotiomycetes;Helotiales;Incertae Sedis;Phialocephala;";"0.0";"0";"4";"4";"0";"4";"0";"457179";"391207"
"V4mis2";"SILVA (only NR);Eukaryota;Amorphea;Obazoa;Opisthokonta;Nucletmycea;Fungi;Dikarya;Ascomycota;Pezizomycotina;Leotiomycetes;Helotiales;Incertae Sedis;Rhexocercosporidium;";"0.0";"0";"1";"1";"0";"1";"0";"457182";"391207"
"V4mis2";"SILVA (only NR);Eukaryota;Amorphea;Obazoa;Opisthokonta;Nucletmycea;Fungi;Dikarya;Ascomycota;Pezizomycotina;Leotiomycetes;Helotiales;Incertae Sedis;Skyttea;";"0.0";"0";"2";"2";"0";"2";"0";"457181";"391207"
"V4mis2";"SILVA (only NR);Eukaryota;Amorphea;Obazoa;Opisthokonta;Nucletmycea;Fungi;Dikarya;Ascomycota;Pezizomycotina;Leotiomycetes;Helotiales;Incertae Sedis;Tetracladium;";"0.0";"0";"9";"9";"0";"9";"0";"457174";"391207"
"V4mis2";"SILVA (only NR);Eukaryota;Amorphea;Obazoa;Opisthokonta;Nucletmycea;Fungi;Dikarya;Ascomycota;Pezizomycotina;Leotiomycetes;Helotiales;Ionomidotis;";"0.0";"0";"1";"1";"0";"1";"0";"457182";"391207"
"V4mis2";"SILVA (only NR);Eukaryota;Amorphea;Obazoa;Opisthokonta;Nucletmycea;Fungi;Dikarya;Ascomycota;Pezizomycotina;Leotiomycetes;Helotiales;Lachnellula;";"0.0";"0";"1";"1";"0";"1";"0";"457182";"391207"
"V4mis2";"SILVA (only NR);Eukaryota;Amorphea;Obazoa;Opisthokonta;Nucletmycea;Fungi;Dikarya;Ascomycota;Pezizomycotina;Leotiomycetes;Helotiales;Lachnum;";"0.0";"0";"2";"2";"0";"2";"0";"457181";"391207"
"V4mis2";"SILVA (only NR);Eukaryota;Amorphea;Obazoa;Opisthokonta;Nucletmycea;Fungi;Dikarya;Ascomycota;Pezizomycotina;Leotiomycetes;Helotiales;Lambertella;";"0.0";"0";"1";"1";"0";"1";"0";"457182";"391207"
"V4mis2";"SILVA (only NR);Eukaryota;Amorphea;Obazoa;Opisthokonta;Nucletmycea;Fungi;Dikarya;Ascomycota;Pezizomycotina;Leotiomycetes;Helotiales;Leotiaceae;";"0.0";"0";"9";"9";"0";"9";"0";"457174";"391207"
"V4mis2";"SILVA (only NR);Eukaryota;Amorphea;Obazoa;Opisthokonta;Nucletmycea;Fungi;Dikarya;Ascomycota;Pezizomycotina;Leotiomycetes;Helotiales;Leotiaceae;Alatospora;";"0.0";"0";"3";"3";"0";"3";"0";"457180";"391207"
"V4mis2";"SILVA (only NR);Eukaryota;Amorphea;Obazoa;Opisthokonta;Nucletmycea;Fungi;Dikarya;Ascomycota;Pezizomycotina;Leotiomycetes;Helotiales;Leotiaceae;Leotia;";"0.0";"0";"3";"3";"0";"3";"0";"457180";"391207"
"V4mis2";"SILVA (only NR);Eukaryota;Amorphea;Obazoa;Opisthokonta;Nucletmycea;Fungi;Dikarya;Ascomycota;Pezizomycotina;Leotiomycetes;Helotiales;Leotiaceae;Pezoloma;";"0.0";"0";"3";"3";"0";"3";"0";"457180";"391207"
"V4mis2";"SILVA (only NR);Eukaryota;Amorphea;Obazoa;Opisthokonta;Nucletmycea;Fungi;Dikarya;Ascomycota;Pezizomycotina;Leotiomycetes;Helotiales;Loramyces;";"0.0";"0";"1";"1";"0";"1";"0";"457182";"391207"
"V4mis2";"SILVA (only NR);Eukaryota;Amorphea;Obazoa;Opisthokonta;Nucletmycea;Fungi;Dikarya;Ascomycota;Pezizomycotina;Leotiomycetes;Helotiales;Microglossum;";"0.0";"0";"1";"1";"0";"1";"0";"457182";"391207"
"V4mis2";"SILVA (only NR);Eukaryota;Amorphea;Obazoa;Opisthokonta;Nucletmycea;Fungi;Dikarya;Ascomycota;Pezizomycotina;Leotiomycetes;Helotiales;Neobulgaria;";"0.0";"0";"1";"1";"0";"1";"0";"457182";"391207"
"V4mis2";"SILVA (only NR);Eukaryota;Amorphea;Obazoa;Opisthokonta;Nucletmycea;Fungi;Dikarya;Ascomycota;Pezizomycotina;Leotiomycetes;Helotiales;Neocudoniella;";"0.0";"0";"1";"1";"0";"1";"0";"457182";"391207"
"V4mis2";"SILVA (only NR);Eukaryota;Amorphea;Obazoa;Opisthokonta;Nucletmycea;Fungi;Dikarya;Ascomycota;Pezizomycotina;Leotiomycetes;Helotiales;Rhymbocarpus;";"0.0";"0";"1";"1";"0";"1";"0";"457182";"391207"
"V4mis2";"SILVA (only NR);Eukaryota;Amorphea;Obazoa;Opisthokonta;Nucletmycea;Fungi;Dikarya;Ascomycota;Pezizomycotina;Leotiomycetes;Helotiales;Rhynchosporium;";"0.0";"0";"1";"1";"0";"1";"0";"457182";"391207"
"V4mis2";"SILVA (only NR);Eukaryota;Amorphea;Obazoa;Opisthokonta;Nucletmycea;Fungi;Dikarya;Ascomycota;Pezizomycotina;Leotiomycetes;Helotiales;Rutstroemia;";"0.0";"0";"1";"1";"0";"1";"0";"457182";"391207"
"V4mis2";"SILVA (only NR);Eukaryota;Amorphea;Obazoa;Opisthokonta;Nucletmycea;Fungi;Dikarya;Ascomycota;Pezizomycotina;Leotiomycetes;Helotiales;Sclerotiniaceae;";"10.0";"14.4";"10";"10";"1";"9";"0";"457173";"391206"
"V4mis2";"SILVA (only NR);Eukaryota;Amorphea;Obazoa;Opisthokonta;Nucletmycea;Fungi;Dikarya;Ascomycota;Pezizomycotina;Leotiomycetes;Helotiales;Sclerotiniaceae;Botrytis;";"0.0";"0";"2";"2";"0";"2";"0";"457181";"391207"
"V4mis2";"SILVA (only NR);Eukaryota;Amorphea;Obazoa;Opisthokonta;Nucletmycea;Fungi;Dikarya;Ascomycota;Pezizomycotina;Leotiomycetes;Helotiales;Sclerotiniaceae;Scleromitrula;";"0.0";"0";"1";"1";"0";"1";"0";"457182";"391207"
"V4mis2";"SILVA (only NR);Eukaryota;Amorphea;Obazoa;Opisthokonta;Nucletmycea;Fungi;Dikarya;Ascomycota;Pezizomycotina;Leotiomycetes;Helotiales;Sclerotiniaceae;Sclerotinia;";"0.0";"0";"5";"5";"0";"5";"0";"457178";"391207"
"V4mis2";"SILVA (only NR);Eukaryota;Amorphea;Obazoa;Opisthokonta;Nucletmycea;Fungi;Dikarya;Ascomycota;Pezizomycotina;Leotiomycetes;Helotiales;Tornabea;";"0.0";"0";"1";"1";"0";"1";"0";"457182";"391207"
"V4mis2";"SILVA (only NR);Eukaryota;Amorphea;Obazoa;Opisthokonta;Nucletmycea;Fungi;Dikarya;Ascomycota;Pezizomycotina;Leotiomycetes;Helotiales;Tricladium;";"0.0";"0";"1";"1";"0";"1";"0";"457182";"391207"
"V4mis2";"SILVA (only NR);Eukaryota;Amorphea;Obazoa;Opisthokonta;Nucletmycea;Fungi;Dikarya;Ascomycota;Pezizomycotina;Leotiomycetes;Helotiales;uncultured;";"0.0";"0";"4";"4";"0";"4";"0";"457179";"391207"
"V4mis2";"SILVA (only NR);Eukaryota;Amorphea;Obazoa;Opisthokonta;Nucletmycea;Fungi;Dikarya;Ascomycota;Pezizomycotina;Leotiomycetes;Incertae Sedis;";"0.0";"0";"16";"16";"0";"16";"0";"457167";"391207"
"V4mis2";"SILVA (only NR);Eukaryota;Amorphea;Obazoa;Opisthokonta;Nucletmycea;Fungi;Dikarya;Ascomycota;Pezizomycotina;Leotiomycetes;Incertae Sedis;Incertae Sedis;";"0.0";"0";"12";"12";"0";"12";"0";"457171";"391207"
"V4mis2";"SILVA (only NR);Eukaryota;Amorphea;Obazoa;Opisthokonta;Nucletmycea;Fungi;Dikarya;Ascomycota;Pezizomycotina;Leotiomycetes;Incertae Sedis;Incertae Sedis;Collophora;";"0.0";"0";"1";"1";"0";"1";"0";"457182";"391207"
"V4mis2";"SILVA (only NR);Eukaryota;Amorphea;Obazoa;Opisthokonta;Nucletmycea;Fungi;Dikarya;Ascomycota;Pezizomycotina;Leotiomycetes;Incertae Sedis;Incertae Sedis;Gelatinomyces;";"0.0";"0";"1";"1";"0";"1";"0";"457182";"391207"
"V4mis2";"SILVA (only NR);Eukaryota;Amorphea;Obazoa;Opisthokonta;Nucletmycea;Fungi;Dikarya;Ascomycota;Pezizomycotina;Leotiomycetes;Incertae Sedis;Incertae Sedis;Leohumicola;";"0.0";"0";"2";"2";"0";"2";"0";"457181";"391207"
"V4mis2";"SILVA (only NR);Eukaryota;Amorphea;Obazoa;Opisthokonta;Nucletmycea;Fungi;Dikarya;Ascomycota;Pezizomycotina;Leotiomycetes;Incertae Sedis;Incertae Sedis;Scytalidium;";"0.0";"0";"5";"5";"0";"5";"0";"457178";"391207"
"V4mis2";"SILVA (only NR);Eukaryota;Amorphea;Obazoa;Opisthokonta;Nucletmycea;Fungi;Dikarya;Ascomycota;Pezizomycotina;Leotiomycetes;Incertae Sedis;Incertae Sedis;Soosiella;";"0.0";"0";"1";"1";"0";"1";"0";"457182";"391207"
"V4mis2";"SILVA (only NR);Eukaryota;Amorphea;Obazoa;Opisthokonta;Nucletmycea;Fungi;Dikarya;Ascomycota;Pezizomycotina;Leotiomycetes;Incertae Sedis;Incertae Sedis;Xylogone;";"0.0";"0";"2";"2";"0";"2";"0";"457181";"391207"
"V4mis2";"SILVA (only NR);Eukaryota;Amorphea;Obazoa;Opisthokonta;Nucletmycea;Fungi;Dikarya;Ascomycota;Pezizomycotina;Leotiomycetes;Incertae Sedis;Myxotrichaceae;";"0.0";"0";"4";"4";"0";"4";"0";"457179";"391207"
"V4mis2";"SILVA (only NR);Eukaryota;Amorphea;Obazoa;Opisthokonta;Nucletmycea;Fungi;Dikarya;Ascomycota;Pezizomycotina;Leotiomycetes;Incertae Sedis;Myxotrichaceae;Byssoascus;";"0.0";"0";"1";"1";"0";"1";"0";"457182";"391207"
"V4mis2";"SILVA (only NR);Eukaryota;Amorphea;Obazoa;Opisthokonta;Nucletmycea;Fungi;Dikarya;Ascomycota;Pezizomycotina;Leotiomycetes;Incertae Sedis;Myxotrichaceae;Myxotrichum;";"0.0";"0";"1";"1";"0";"1";"0";"457182";"391207"
"V4mis2";"SILVA (only NR);Eukaryota;Amorphea;Obazoa;Opisthokonta;Nucletmycea;Fungi;Dikarya;Ascomycota;Pezizomycotina;Leotiomycetes;Incertae Sedis;Myxotrichaceae;Oidiodendron;";"0.0";"0";"1";"1";"0";"1";"0";"457182";"391207"
"V4mis2";"SILVA (only NR);Eukaryota;Amorphea;Obazoa;Opisthokonta;Nucletmycea;Fungi;Dikarya;Ascomycota;Pezizomycotina;Leotiomycetes;Phacidiales;";"0.0";"0";"2";"2";"0";"2";"0";"457181";"391207"
"V4mis2";"SILVA (only NR);Eukaryota;Amorphea;Obazoa;Opisthokonta;Nucletmycea;Fungi;Dikarya;Ascomycota;Pezizomycotina;Leotiomycetes;Phacidiales;Bulgariaceae;";"0.0";"0";"2";"2";"0";"2";"0";"457181";"391207"
"V4mis2";"SILVA (only NR);Eukaryota;Amorphea;Obazoa;Opisthokonta;Nucletmycea;Fungi;Dikarya;Ascomycota;Pezizomycotina;Leotiomycetes;Phacidiales;Bulgariaceae;Bulgaria;";"0.0";"0";"1";"1";"0";"1";"0";"457182";"391207"
"V4mis2";"SILVA (only NR);Eukaryota;Amorphea;Obazoa;Opisthokonta;Nucletmycea;Fungi;Dikarya;Ascomycota;Pezizomycotina;Leotiomycetes;Phacidiales;Bulgariaceae;Bulgariella;";"0.0";"0";"1";"1";"0";"1";"0";"457182";"391207"
"V4mis2";"SILVA (only NR);Eukaryota;Amorphea;Obazoa;Opisthokonta;Nucletmycea;Fungi;Dikarya;Ascomycota;Pezizomycotina;Leotiomycetes;Pseudogymnoascus;";"0.0";"0";"4";"4";"0";"4";"0";"457179";"391207"
"V4mis2";"SILVA (only NR);Eukaryota;Amorphea;Obazoa;Opisthokonta;Nucletmycea;Fungi;Dikarya;Ascomycota;Pezizomycotina;Leotiomycetes;Rhytismatales;";"0.0";"0";"7";"7";"0";"7";"0";"457176";"391207"
"V4mis2";"SILVA (only NR);Eukaryota;Amorphea;Obazoa;Opisthokonta;Nucletmycea;Fungi;Dikarya;Ascomycota;Pezizomycotina;Leotiomycetes;Rhytismatales;Cudoniaceae;";"0.0";"0";"2";"2";"0";"2";"0";"457181";"391207"
"V4mis2";"SILVA (only NR);Eukaryota;Amorphea;Obazoa;Opisthokonta;Nucletmycea;Fungi;Dikarya;Ascomycota;Pezizomycotina;Leotiomycetes;Rhytismatales;Cudoniaceae;Spathularia;";"0.0";"0";"2";"2";"0";"2";"0";"457181";"391207"
"V4mis2";"SILVA (only NR);Eukaryota;Amorphea;Obazoa;Opisthokonta;Nucletmycea;Fungi;Dikarya;Ascomycota;Pezizomycotina;Leotiomycetes;Rhytismatales;Darkera;";"0.0";"0";"1";"1";"0";"1";"0";"457182";"391207"
"V4mis2";"SILVA (only NR);Eukaryota;Amorphea;Obazoa;Opisthokonta;Nucletmycea;Fungi;Dikarya;Ascomycota;Pezizomycotina;Leotiomycetes;Rhytismatales;Rhytismataceae;";"0.0";"0";"4";"4";"0";"4";"0";"457179";"391207"
"V4mis2";"SILVA (only NR);Eukaryota;Amorphea;Obazoa;Opisthokonta;Nucletmycea;Fungi;Dikarya;Ascomycota;Pezizomycotina;Leotiomycetes;Rhytismatales;Rhytismataceae;Coccomyces;";"0.0";"0";"1";"1";"0";"1";"0";"457182";"391207"
"V4mis2";"SILVA (only NR);Eukaryota;Amorphea;Obazoa;Opisthokonta;Nucletmycea;Fungi;Dikarya;Ascomycota;Pezizomycotina;Leotiomycetes;Rhytismatales;Rhytismataceae;Meria;";"0.0";"0";"1";"1";"0";"1";"0";"457182";"391207"
"V4mis2";"SILVA (only NR);Eukaryota;Amorphea;Obazoa;Opisthokonta;Nucletmycea;Fungi;Dikarya;Ascomycota;Pezizomycotina;Leotiomycetes;Rhytismatales;Rhytismataceae;Propolis;";"0.0";"0";"1";"1";"0";"1";"0";"457182";"391207"
"V4mis2";"SILVA (only NR);Eukaryota;Amorphea;Obazoa;Opisthokonta;Nucletmycea;Fungi;Dikarya;Ascomycota;Pezizomycotina;Leotiomycetes;Rhytismatales;Rhytismataceae;Rhytisma;";"0.0";"0";"1";"1";"0";"1";"0";"457182";"391207"
"V4mis2";"SILVA (only NR);Eukaryota;Amorphea;Obazoa;Opisthokonta;Nucletmycea;Fungi;Dikarya;Ascomycota;Pezizomycotina;Leotiomycetes;Satchmopsis;";"0.0";"0";"1";"1";"0";"1";"0";"457182";"391207"
"V4mis2";"SILVA (only NR);Eukaryota;Amorphea;Obazoa;Opisthokonta;Nucletmycea;Fungi;Dikarya;Ascomycota;Pezizomycotina;Leotiomycetes;Thelebolales;";"0.0";"0";"19";"19";"0";"19";"0";"457164";"391207"
"V4mis2";"SILVA (only NR);Eukaryota;Amorphea;Obazoa;Opisthokonta;Nucletmycea;Fungi;Dikarya;Ascomycota;Pezizomycotina;Leotiomycetes;Thelebolales;Thelebolaceae;";"0.0";"0";"19";"19";"0";"19";"0";"457164";"391207"
"V4mis2";"SILVA (only NR);Eukaryota;Amorphea;Obazoa;Opisthokonta;Nucletmycea;Fungi;Dikarya;Ascomycota;Pezizomycotina;Leotiomycetes;Thelebolales;Thelebolaceae;Ascozonus;";"0.0";"0";"1";"1";"0";"1";"0";"457182";"391207"
"V4mis2";"SILVA (only NR);Eukaryota;Amorphea;Obazoa;Opisthokonta;Nucletmycea;Fungi;Dikarya;Ascomycota;Pezizomycotina;Leotiomycetes;Thelebolales;Thelebolaceae;Hyphozyma;";"0.0";"0";"2";"2";"0";"2";"0";"457181";"391207"
"V4mis2";"SILVA (only NR);Eukaryota;Amorphea;Obazoa;Opisthokonta;Nucletmycea;Fungi;Dikarya;Ascomycota;Pezizomycotina;Leotiomycetes;Thelebolales;Thelebolaceae;Thelebolus;";"0.0";"0";"16";"16";"0";"16";"0";"457167";"391207"
"V4mis2";"SILVA (only NR);Eukaryota;Amorphea;Obazoa;Opisthokonta;Nucletmycea;Fungi;Dikarya;Ascomycota;Pezizomycotina;Leotiomycetes;uncultured;";"0.0";"0";"2";"2";"0";"2";"0";"457181";"391207"
"V4mis2";"SILVA (only NR);Eukaryota;Amorphea;Obazoa;Opisthokonta;Nucletmycea;Fungi;Dikarya;Ascomycota;Pezizomycotina;Lichinomycetes;";"0.0";"0";"45";"45";"0";"45";"0";"457138";"391207"
"V4mis2";"SILVA (only NR);Eukaryota;Amorphea;Obazoa;Opisthokonta;Nucletmycea;Fungi;Dikarya;Ascomycota;Pezizomycotina;Lichinomycetes;Lichinales;";"0.0";"0";"45";"45";"0";"45";"0";"457138";"391207"
"V4mis2";"SILVA (only NR);Eukaryota;Amorphea;Obazoa;Opisthokonta;Nucletmycea;Fungi;Dikarya;Ascomycota;Pezizomycotina;Lichinomycetes;Lichinales;Heppiaceae;";"0.0";"0";"2";"2";"0";"2";"0";"457181";"391207"
"V4mis2";"SILVA (only NR);Eukaryota;Amorphea;Obazoa;Opisthokonta;Nucletmycea;Fungi;Dikarya;Ascomycota;Pezizomycotina;Lichinomycetes;Lichinales;Heppiaceae;Heppia;";"0.0";"0";"2";"2";"0";"2";"0";"457181";"391207"
"V4mis2";"SILVA (only NR);Eukaryota;Amorphea;Obazoa;Opisthokonta;Nucletmycea;Fungi;Dikarya;Ascomycota;Pezizomycotina;Lichinomycetes;Lichinales;Lichinaceae;";"0.0";"0";"28";"28";"0";"28";"0";"457155";"391207"
"V4mis2";"SILVA (only NR);Eukaryota;Amorphea;Obazoa;Opisthokonta;Nucletmycea;Fungi;Dikarya;Ascomycota;Pezizomycotina;Lichinomycetes;Lichinales;Lichinaceae;Anema;";"0.0";"0";"1";"1";"0";"1";"0";"457182";"391207"
"V4mis2";"SILVA (only NR);Eukaryota;Amorphea;Obazoa;Opisthokonta;Nucletmycea;Fungi;Dikarya;Ascomycota;Pezizomycotina;Lichinomycetes;Lichinales;Lichinaceae;Digitothyrea;";"0.0";"0";"1";"1";"0";"1";"0";"457182";"391207"
"V4mis2";"SILVA (only NR);Eukaryota;Amorphea;Obazoa;Opisthokonta;Nucletmycea;Fungi;Dikarya;Ascomycota;Pezizomycotina;Lichinomycetes;Lichinales;Lichinaceae;Ephebe;";"0.0";"0";"1";"1";"0";"1";"0";"457182";"391207"
"V4mis2";"SILVA (only NR);Eukaryota;Amorphea;Obazoa;Opisthokonta;Nucletmycea;Fungi;Dikarya;Ascomycota;Pezizomycotina;Lichinomycetes;Lichinales;Lichinaceae;Euopsis;";"0.0";"0";"1";"1";"0";"1";"0";"457182";"391207"
"V4mis2";"SILVA (only NR);Eukaryota;Amorphea;Obazoa;Opisthokonta;Nucletmycea;Fungi;Dikarya;Ascomycota;Pezizomycotina;Lichinomycetes;Lichinales;Lichinaceae;Harpidium;";"0.0";"0";"1";"1";"0";"1";"0";"457182";"391207"
"V4mis2";"SILVA (only NR);Eukaryota;Amorphea;Obazoa;Opisthokonta;Nucletmycea;Fungi;Dikarya;Ascomycota;Pezizomycotina;Lichinomycetes;Lichinales;Lichinaceae;Jenmania;";"0.0";"0";"1";"1";"0";"1";"0";"457182";"391207"
"V4mis2";"SILVA (only NR);Eukaryota;Amorphea;Obazoa;Opisthokonta;Nucletmycea;Fungi;Dikarya;Ascomycota;Pezizomycotina;Lichinomycetes;Lichinales;Lichinaceae;Lichina;";"0.0";"0";"2";"2";"0";"2";"0";"457181";"391207"
"V4mis2";"SILVA (only NR);Eukaryota;Amorphea;Obazoa;Opisthokonta;Nucletmycea;Fungi;Dikarya;Ascomycota;Pezizomycotina;Lichinomycetes;Lichinales;Lichinaceae;Lichinella;";"0.0";"0";"1";"1";"0";"1";"0";"457182";"391207"
"V4mis2";"SILVA (only NR);Eukaryota;Amorphea;Obazoa;Opisthokonta;Nucletmycea;Fungi;Dikarya;Ascomycota;Pezizomycotina;Lichinomycetes;Lichinales;Lichinaceae;Paulia;";"0.0";"0";"4";"4";"0";"4";"0";"457179";"391207"
"V4mis2";"SILVA (only NR);Eukaryota;Amorphea;Obazoa;Opisthokonta;Nucletmycea;Fungi;Dikarya;Ascomycota;Pezizomycotina;Lichinomycetes;Lichinales;Lichinaceae;Peccania;";"0.0";"0";"4";"4";"0";"4";"0";"457179";"391207"
"V4mis2";"SILVA (only NR);Eukaryota;Amorphea;Obazoa;Opisthokonta;Nucletmycea;Fungi;Dikarya;Ascomycota;Pezizomycotina;Lichinomycetes;Lichinales;Lichinaceae;Phloeopeccania;";"0.0";"0";"1";"1";"0";"1";"0";"457182";"391207"
"V4mis2";"SILVA (only NR);Eukaryota;Amorphea;Obazoa;Opisthokonta;Nucletmycea;Fungi;Dikarya;Ascomycota;Pezizomycotina;Lichinomycetes;Lichinales;Lichinaceae;Porocyphus;";"0.0";"0";"1";"1";"0";"1";"0";"457182";"391207"
"V4mis2";"SILVA (only NR);Eukaryota;Amorphea;Obazoa;Opisthokonta;Nucletmycea;Fungi;Dikarya;Ascomycota;Pezizomycotina;Lichinomycetes;Lichinales;Lichinaceae;Psorotichia;";"0.0";"0";"3";"3";"0";"3";"0";"457180";"391207"
"V4mis2";"SILVA (only NR);Eukaryota;Amorphea;Obazoa;Opisthokonta;Nucletmycea;Fungi;Dikarya;Ascomycota;Pezizomycotina;Lichinomycetes;Lichinales;Lichinaceae;Pterygiopsis;";"0.0";"0";"1";"1";"0";"1";"0";"457182";"391207"
"V4mis2";"SILVA (only NR);Eukaryota;Amorphea;Obazoa;Opisthokonta;Nucletmycea;Fungi;Dikarya;Ascomycota;Pezizomycotina;Lichinomycetes;Lichinales;Lichinaceae;Stromatella;";"0.0";"0";"1";"1";"0";"1";"0";"457182";"391207"
"V4mis2";"SILVA (only NR);Eukaryota;Amorphea;Obazoa;Opisthokonta;Nucletmycea;Fungi;Dikarya;Ascomycota;Pezizomycotina;Lichinomycetes;Lichinales;Lichinaceae;Thyrea;";"0.0";"0";"2";"2";"0";"2";"0";"457181";"391207"
"V4mis2";"SILVA (only NR);Eukaryota;Amorphea;Obazoa;Opisthokonta;Nucletmycea;Fungi;Dikarya;Ascomycota;Pezizomycotina;Lichinomycetes;Lichinales;Peltulaceae;";"0.0";"0";"14";"14";"0";"14";"0";"457169";"391207"
"V4mis2";"SILVA (only NR);Eukaryota;Amorphea;Obazoa;Opisthokonta;Nucletmycea;Fungi;Dikarya;Ascomycota;Pezizomycotina;Lichinomycetes;Lichinales;Peltulaceae;Peltula;";"0.0";"0";"14";"14";"0";"14";"0";"457169";"391207"
"V4mis2";"SILVA (only NR);Eukaryota;Amorphea;Obazoa;Opisthokonta;Nucletmycea;Fungi;Dikarya;Ascomycota;Pezizomycotina;Orbiliomycetes;";"5.9";"14.4";"17";"17";"1";"16";"0";"457166";"391206"
"V4mis2";"SILVA (only NR);Eukaryota;Amorphea;Obazoa;Opisthokonta;Nucletmycea;Fungi;Dikarya;Ascomycota;Pezizomycotina;Orbiliomycetes;Orbiliales;";"5.9";"14.4";"17";"17";"1";"16";"0";"457166";"391206"
"V4mis2";"SILVA (only NR);Eukaryota;Amorphea;Obazoa;Opisthokonta;Nucletmycea;Fungi;Dikarya;Ascomycota;Pezizomycotina;Orbiliomycetes;Orbiliales;Orbiliaceae;";"5.9";"14.4";"17";"17";"1";"16";"0";"457166";"391206"
"V4mis2";"SILVA (only NR);Eukaryota;Amorphea;Obazoa;Opisthokonta;Nucletmycea;Fungi;Dikarya;Ascomycota;Pezizomycotina;Orbiliomycetes;Orbiliales;Orbiliaceae;Arthrobotrys;";"0.0";"0";"8";"8";"0";"8";"0";"457175";"391207"
"V4mis2";"SILVA (only NR);Eukaryota;Amorphea;Obazoa;Opisthokonta;Nucletmycea;Fungi;Dikarya;Ascomycota;Pezizomycotina;Orbiliomycetes;Orbiliales;Orbiliaceae;Dactylella;";"50.0";"14.4";"2";"2";"1";"1";"0";"457181";"391206"
"V4mis2";"SILVA (only NR);Eukaryota;Amorphea;Obazoa;Opisthokonta;Nucletmycea;Fungi;Dikarya;Ascomycota;Pezizomycotina;Orbiliomycetes;Orbiliales;Orbiliaceae;Dactylellina;";"0.0";"0";"2";"2";"0";"2";"0";"457181";"391207"
"V4mis2";"SILVA (only NR);Eukaryota;Amorphea;Obazoa;Opisthokonta;Nucletmycea;Fungi;Dikarya;Ascomycota;Pezizomycotina;Orbiliomycetes;Orbiliales;Orbiliaceae;Drechslerella;";"0.0";"0";"1";"1";"0";"1";"0";"457182";"391207"
"V4mis2";"SILVA (only NR);Eukaryota;Amorphea;Obazoa;Opisthokonta;Nucletmycea;Fungi;Dikarya;Ascomycota;Pezizomycotina;Orbiliomycetes;Orbiliales;Orbiliaceae;Duddingtonia;";"0.0";"0";"1";"1";"0";"1";"0";"457182";"391207"
"V4mis2";"SILVA (only NR);Eukaryota;Amorphea;Obazoa;Opisthokonta;Nucletmycea;Fungi;Dikarya;Ascomycota;Pezizomycotina;Orbiliomycetes;Orbiliales;Orbiliaceae;Monacrosporium;";"0.0";"0";"1";"1";"0";"1";"0";"457182";"391207"
"V4mis2";"SILVA (only NR);Eukaryota;Amorphea;Obazoa;Opisthokonta;Nucletmycea;Fungi;Dikarya;Ascomycota;Pezizomycotina;Orbiliomycetes;Orbiliales;Orbiliaceae;Orbilia;";"0.0";"0";"2";"2";"0";"2";"0";"457181";"391207"
"V4mis2";"SILVA (only NR);Eukaryota;Amorphea;Obazoa;Opisthokonta;Nucletmycea;Fungi;Dikarya;Ascomycota;Pezizomycotina;Pezizomycetes;";"0.0";"0";"189";"188";"0";"188";"1";"456995";"391207"
"V4mis2";"SILVA (only NR);Eukaryota;Amorphea;Obazoa;Opisthokonta;Nucletmycea;Fungi;Dikarya;Ascomycota;Pezizomycotina;Pezizomycetes;Pezizales;";"0.0";"0";"189";"188";"0";"188";"1";"456995";"391207"
"V4mis2";"SILVA (only NR);Eukaryota;Amorphea;Obazoa;Opisthokonta;Nucletmycea;Fungi;Dikarya;Ascomycota;Pezizomycotina;Pezizomycetes;Pezizales;Ascobolaceae;";"0.0";"0";"7";"7";"0";"7";"0";"457176";"391207"
"V4mis2";"SILVA (only NR);Eukaryota;Amorphea;Obazoa;Opisthokonta;Nucletmycea;Fungi;Dikarya;Ascomycota;Pezizomycotina;Pezizomycetes;Pezizales;Ascobolaceae;Ascobolus;";"0.0";"0";"2";"2";"0";"2";"0";"457181";"391207"
"V4mis2";"SILVA (only NR);Eukaryota;Amorphea;Obazoa;Opisthokonta;Nucletmycea;Fungi;Dikarya;Ascomycota;Pezizomycotina;Pezizomycetes;Pezizales;Ascobolaceae;Saccobolus;";"0.0";"0";"1";"1";"0";"1";"0";"457182";"391207"
"V4mis2";"SILVA (only NR);Eukaryota;Amorphea;Obazoa;Opisthokonta;Nucletmycea;Fungi;Dikarya;Ascomycota;Pezizomycotina;Pezizomycetes;Pezizales;Ascobolaceae;Thecotheus;";"0.0";"0";"1";"1";"0";"1";"0";"457182";"391207"
"V4mis2";"SILVA (only NR);Eukaryota;Amorphea;Obazoa;Opisthokonta;Nucletmycea;Fungi;Dikarya;Ascomycota;Pezizomycotina;Pezizomycetes;Pezizales;Ascobolaceae;uncultured;";"0.0";"0";"3";"3";"0";"3";"0";"457180";"391207"
"V4mis2";"SILVA (only NR);Eukaryota;Amorphea;Obazoa;Opisthokonta;Nucletmycea;Fungi;Dikarya;Ascomycota;Pezizomycotina;Pezizomycetes;Pezizales;Ascodesmidaceae;";"0.0";"0";"9";"9";"0";"9";"0";"457174";"391207"
"V4mis2";"SILVA (only NR);Eukaryota;Amorphea;Obazoa;Opisthokonta;Nucletmycea;Fungi;Dikarya;Ascomycota;Pezizomycotina;Pezizomycetes;Pezizales;Ascodesmidaceae;Cephaliophora;";"0.0";"0";"5";"5";"0";"5";"0";"457178";"391207"
"V4mis2";"SILVA (only NR);Eukaryota;Amorphea;Obazoa;Opisthokonta;Nucletmycea;Fungi;Dikarya;Ascomycota;Pezizomycotina;Pezizomycetes;Pezizales;Ascodesmidaceae;Eleutherascus;";"0.0";"0";"2";"2";"0";"2";"0";"457181";"391207"
"V4mis2";"SILVA (only NR);Eukaryota;Amorphea;Obazoa;Opisthokonta;Nucletmycea;Fungi;Dikarya;Ascomycota;Pezizomycotina;Pezizomycetes;Pezizales;Ascodesmidaceae;Lasiobolus;";"0.0";"0";"1";"1";"0";"1";"0";"457182";"391207"
"V4mis2";"SILVA (only NR);Eukaryota;Amorphea;Obazoa;Opisthokonta;Nucletmycea;Fungi;Dikarya;Ascomycota;Pezizomycotina;Pezizomycetes;Pezizales;Caloscypha;";"0.0";"0";"2";"2";"0";"2";"0";"457181";"391207"
"V4mis2";"SILVA (only NR);Eukaryota;Amorphea;Obazoa;Opisthokonta;Nucletmycea;Fungi;Dikarya;Ascomycota;Pezizomycotina;Pezizomycetes;Pezizales;Chalazion;";"0.0";"0";"1";"1";"0";"1";"0";"457182";"391207"
"V4mis2";"SILVA (only NR);Eukaryota;Amorphea;Obazoa;Opisthokonta;Nucletmycea;Fungi;Dikarya;Ascomycota;Pezizomycotina;Pezizomycetes;Pezizales;Chorioactidaceae;";"0.0";"0";"3";"3";"0";"3";"0";"457180";"391207"
"V4mis2";"SILVA (only NR);Eukaryota;Amorphea;Obazoa;Opisthokonta;Nucletmycea;Fungi;Dikarya;Ascomycota;Pezizomycotina;Pezizomycetes;Pezizales;Chorioactidaceae;Chorioactis;";"0.0";"0";"1";"1";"0";"1";"0";"457182";"391207"
"V4mis2";"SILVA (only NR);Eukaryota;Amorphea;Obazoa;Opisthokonta;Nucletmycea;Fungi;Dikarya;Ascomycota;Pezizomycotina;Pezizomycetes;Pezizales;Chorioactidaceae;Neournula;";"0.0";"0";"1";"1";"0";"1";"0";"457182";"391207"
"V4mis2";"SILVA (only NR);Eukaryota;Amorphea;Obazoa;Opisthokonta;Nucletmycea;Fungi;Dikarya;Ascomycota;Pezizomycotina;Pezizomycetes;Pezizales;Chorioactidaceae;Pseudosarcosoma;";"0.0";"0";"1";"1";"0";"1";"0";"457182";"391207"
"V4mis2";"SILVA (only NR);Eukaryota;Amorphea;Obazoa;Opisthokonta;Nucletmycea;Fungi;Dikarya;Ascomycota;Pezizomycotina;Pezizomycetes;Pezizales;Desmazierella;";"0.0";"0";"1";"1";"0";"1";"0";"457182";"391207"
"V4mis2";"SILVA (only NR);Eukaryota;Amorphea;Obazoa;Opisthokonta;Nucletmycea;Fungi;Dikarya;Ascomycota;Pezizomycotina;Pezizomycetes;Pezizales;Glaziella;";"0.0";"0";"1";"1";"0";"1";"0";"457182";"391207"
"V4mis2";"SILVA (only NR);Eukaryota;Amorphea;Obazoa;Opisthokonta;Nucletmycea;Fungi;Dikarya;Ascomycota;Pezizomycotina;Pezizomycetes;Pezizales;Gyromitra;";"0.0";"0";"4";"4";"0";"4";"0";"457179";"391207"
"V4mis2";"SILVA (only NR);Eukaryota;Amorphea;Obazoa;Opisthokonta;Nucletmycea;Fungi;Dikarya;Ascomycota;Pezizomycotina;Pezizomycetes;Pezizales;Helvellaceae;";"0.0";"0";"15";"15";"0";"15";"0";"457168";"391207"
"V4mis2";"SILVA (only NR);Eukaryota;Amorphea;Obazoa;Opisthokonta;Nucletmycea;Fungi;Dikarya;Ascomycota;Pezizomycotina;Pezizomycetes;Pezizales;Helvellaceae;Balsamia;";"0.0";"0";"1";"1";"0";"1";"0";"457182";"391207"
"V4mis2";"SILVA (only NR);Eukaryota;Amorphea;Obazoa;Opisthokonta;Nucletmycea;Fungi;Dikarya;Ascomycota;Pezizomycotina;Pezizomycetes;Pezizales;Helvellaceae;Barssia;";"0.0";"0";"1";"1";"0";"1";"0";"457182";"391207"
"V4mis2";"SILVA (only NR);Eukaryota;Amorphea;Obazoa;Opisthokonta;Nucletmycea;Fungi;Dikarya;Ascomycota;Pezizomycotina;Pezizomycetes;Pezizales;Helvellaceae;Fischerula;";"0.0";"0";"1";"1";"0";"1";"0";"457182";"391207"
"V4mis2";"SILVA (only NR);Eukaryota;Amorphea;Obazoa;Opisthokonta;Nucletmycea;Fungi;Dikarya;Ascomycota;Pezizomycotina;Pezizomycetes;Pezizales;Helvellaceae;Helvella;";"0.0";"0";"10";"10";"0";"10";"0";"457173";"391207"
"V4mis2";"SILVA (only NR);Eukaryota;Amorphea;Obazoa;Opisthokonta;Nucletmycea;Fungi;Dikarya;Ascomycota;Pezizomycotina;Pezizomycetes;Pezizales;Helvellaceae;Imaia;";"0.0";"0";"1";"1";"0";"1";"0";"457182";"391207"
"V4mis2";"SILVA (only NR);Eukaryota;Amorphea;Obazoa;Opisthokonta;Nucletmycea;Fungi;Dikarya;Ascomycota;Pezizomycotina;Pezizomycetes;Pezizales;Helvellaceae;Leucangium;";"0.0";"0";"1";"1";"0";"1";"0";"457182";"391207"
"V4mis2";"SILVA (only NR);Eukaryota;Amorphea;Obazoa;Opisthokonta;Nucletmycea;Fungi;Dikarya;Ascomycota;Pezizomycotina;Pezizomycetes;Pezizales;Hydnotrya;";"0.0";"0";"1";"1";"0";"1";"0";"457182";"391207"
"V4mis2";"SILVA (only NR);Eukaryota;Amorphea;Obazoa;Opisthokonta;Nucletmycea;Fungi;Dikarya;Ascomycota;Pezizomycotina;Pezizomycetes;Pezizales;Incertae Sedis;";"0.0";"0";"2";"2";"0";"2";"0";"457181";"391207"
"V4mis2";"SILVA (only NR);Eukaryota;Amorphea;Obazoa;Opisthokonta;Nucletmycea;Fungi;Dikarya;Ascomycota;Pezizomycotina;Pezizomycetes;Pezizales;Incertae Sedis;Pulchromyces;";"0.0";"0";"2";"2";"0";"2";"0";"457181";"391207"
"V4mis2";"SILVA (only NR);Eukaryota;Amorphea;Obazoa;Opisthokonta;Nucletmycea;Fungi;Dikarya;Ascomycota;Pezizomycotina;Pezizomycetes;Pezizales;Karstenella;";"0.0";"0";"1";"1";"0";"1";"0";"457182";"391207"
"V4mis2";"SILVA (only NR);Eukaryota;Amorphea;Obazoa;Opisthokonta;Nucletmycea;Fungi;Dikarya;Ascomycota;Pezizomycotina;Pezizomycetes;Pezizales;Morchellaceae;";"0.0";"0";"4";"4";"0";"4";"0";"457179";"391207"
"V4mis2";"SILVA (only NR);Eukaryota;Amorphea;Obazoa;Opisthokonta;Nucletmycea;Fungi;Dikarya;Ascomycota;Pezizomycotina;Pezizomycetes;Pezizales;Morchellaceae;Morchella;";"0.0";"0";"1";"1";"0";"1";"0";"457182";"391207"
"V4mis2";"SILVA (only NR);Eukaryota;Amorphea;Obazoa;Opisthokonta;Nucletmycea;Fungi;Dikarya;Ascomycota;Pezizomycotina;Pezizomycetes;Pezizales;Morchellaceae;Verpa;";"0.0";"0";"3";"3";"0";"3";"0";"457180";"391207"
"V4mis2";"SILVA (only NR);Eukaryota;Amorphea;Obazoa;Opisthokonta;Nucletmycea;Fungi;Dikarya;Ascomycota;Pezizomycotina;Pezizomycetes;Pezizales;Pezizaceae;";"0.0";"0";"34";"34";"0";"34";"0";"457149";"391207"
"V4mis2";"SILVA (only NR);Eukaryota;Amorphea;Obazoa;Opisthokonta;Nucletmycea;Fungi;Dikarya;Ascomycota;Pezizomycotina;Pezizomycetes;Pezizales;Pezizaceae;Boudiera;";"0.0";"0";"1";"1";"0";"1";"0";"457182";"391207"
"V4mis2";"SILVA (only NR);Eukaryota;Amorphea;Obazoa;Opisthokonta;Nucletmycea;Fungi;Dikarya;Ascomycota;Pezizomycotina;Pezizomycetes;Pezizales;Pezizaceae;Cazia;";"0.0";"0";"1";"1";"0";"1";"0";"457182";"391207"
"V4mis2";"SILVA (only NR);Eukaryota;Amorphea;Obazoa;Opisthokonta;Nucletmycea;Fungi;Dikarya;Ascomycota;Pezizomycotina;Pezizomycetes;Pezizales;Pezizaceae;Iodowynnea;";"0.0";"0";"1";"1";"0";"1";"0";"457182";"391207"
"V4mis2";"SILVA (only NR);Eukaryota;Amorphea;Obazoa;Opisthokonta;Nucletmycea;Fungi;Dikarya;Ascomycota;Pezizomycotina;Pezizomycetes;Pezizales;Pezizaceae;Mattirolomyces;";"0.0";"0";"1";"1";"0";"1";"0";"457182";"391207"
"V4mis2";"SILVA (only NR);Eukaryota;Amorphea;Obazoa;Opisthokonta;Nucletmycea;Fungi;Dikarya;Ascomycota;Pezizomycotina;Pezizomycetes;Pezizales;Pezizaceae;Pachyella;";"0.0";"0";"3";"3";"0";"3";"0";"457180";"391207"
"V4mis2";"SILVA (only NR);Eukaryota;Amorphea;Obazoa;Opisthokonta;Nucletmycea;Fungi;Dikarya;Ascomycota;Pezizomycotina;Pezizomycetes;Pezizales;Pezizaceae;Peziza;";"0.0";"0";"15";"15";"0";"15";"0";"457168";"391207"
"V4mis2";"SILVA (only NR);Eukaryota;Amorphea;Obazoa;Opisthokonta;Nucletmycea;Fungi;Dikarya;Ascomycota;Pezizomycotina;Pezizomycetes;Pezizales;Pezizaceae;Plicaria;";"0.0";"0";"2";"2";"0";"2";"0";"457181";"391207"
"V4mis2";"SILVA (only NR);Eukaryota;Amorphea;Obazoa;Opisthokonta;Nucletmycea;Fungi;Dikarya;Ascomycota;Pezizomycotina;Pezizomycetes;Pezizales;Pezizaceae;Sarcosphaera;";"0.0";"0";"2";"2";"0";"2";"0";"457181";"391207"
"V4mis2";"SILVA (only NR);Eukaryota;Amorphea;Obazoa;Opisthokonta;Nucletmycea;Fungi;Dikarya;Ascomycota;Pezizomycotina;Pezizomycetes;Pezizales;Pezizaceae;uncultured;";"0.0";"0";"3";"3";"0";"3";"0";"457180";"391207"
"V4mis2";"SILVA (only NR);Eukaryota;Amorphea;Obazoa;Opisthokonta;Nucletmycea;Fungi;Dikarya;Ascomycota;Pezizomycotina;Pezizomycetes;Pezizales;Pyronemataceae;";"0.0";"0";"57";"57";"0";"57";"0";"457126";"391207"
"V4mis2";"SILVA (only NR);Eukaryota;Amorphea;Obazoa;Opisthokonta;Nucletmycea;Fungi;Dikarya;Ascomycota;Pezizomycotina;Pezizomycetes;Pezizales;Pyronemataceae;Acervus;";"0.0";"0";"2";"2";"0";"2";"0";"457181";"391207"
"V4mis2";"SILVA (only NR);Eukaryota;Amorphea;Obazoa;Opisthokonta;Nucletmycea;Fungi;Dikarya;Ascomycota;Pezizomycotina;Pezizomycetes;Pezizales;Pyronemataceae;Anthracobia;";"0.0";"0";"1";"1";"0";"1";"0";"457182";"391207"
"V4mis2";"SILVA (only NR);Eukaryota;Amorphea;Obazoa;Opisthokonta;Nucletmycea;Fungi;Dikarya;Ascomycota;Pezizomycotina;Pezizomycetes;Pezizales;Pyronemataceae;Byssonectria;";"0.0";"0";"1";"1";"0";"1";"0";"457182";"391207"
"V4mis2";"SILVA (only NR);Eukaryota;Amorphea;Obazoa;Opisthokonta;Nucletmycea;Fungi;Dikarya;Ascomycota;Pezizomycotina;Pezizomycetes;Pezizales;Pyronemataceae;Cheilymenia;";"0.0";"0";"3";"3";"0";"3";"0";"457180";"391207"
"V4mis2";"SILVA (only NR);Eukaryota;Amorphea;Obazoa;Opisthokonta;Nucletmycea;Fungi;Dikarya;Ascomycota;Pezizomycotina;Pezizomycetes;Pezizales;Pyronemataceae;Diehliomyces;";"0.0";"0";"1";"1";"0";"1";"0";"457182";"391207"
"V4mis2";"SILVA (only NR);Eukaryota;Amorphea;Obazoa;Opisthokonta;Nucletmycea;Fungi;Dikarya;Ascomycota;Pezizomycotina;Pezizomycetes;Pezizales;Pyronemataceae;Geopora;";"0.0";"0";"3";"3";"0";"3";"0";"457180";"391207"
"V4mis2";"SILVA (only NR);Eukaryota;Amorphea;Obazoa;Opisthokonta;Nucletmycea;Fungi;Dikarya;Ascomycota;Pezizomycotina;Pezizomycetes;Pezizales;Pyronemataceae;Geopyxis;";"0.0";"0";"3";"3";"0";"3";"0";"457180";"391207"
"V4mis2";"SILVA (only NR);Eukaryota;Amorphea;Obazoa;Opisthokonta;Nucletmycea;Fungi;Dikarya;Ascomycota;Pezizomycotina;Pezizomycetes;Pezizales;Pyronemataceae;Humaria;";"0.0";"0";"1";"1";"0";"1";"0";"457182";"391207"
"V4mis2";"SILVA (only NR);Eukaryota;Amorphea;Obazoa;Opisthokonta;Nucletmycea;Fungi;Dikarya;Ascomycota;Pezizomycotina;Pezizomycetes;Pezizales;Pyronemataceae;Inermisia;";"0.0";"0";"1";"1";"0";"1";"0";"457182";"391207"
"V4mis2";"SILVA (only NR);Eukaryota;Amorphea;Obazoa;Opisthokonta;Nucletmycea;Fungi;Dikarya;Ascomycota;Pezizomycotina;Pezizomycetes;Pezizales;Pyronemataceae;Lamprospora;";"0.0";"0";"2";"2";"0";"2";"0";"457181";"391207"
"V4mis2";"SILVA (only NR);Eukaryota;Amorphea;Obazoa;Opisthokonta;Nucletmycea;Fungi;Dikarya;Ascomycota;Pezizomycotina;Pezizomycetes;Pezizales;Pyronemataceae;Lasiobolidium;";"0.0";"0";"2";"2";"0";"2";"0";"457181";"391207"
"V4mis2";"SILVA (only NR);Eukaryota;Amorphea;Obazoa;Opisthokonta;Nucletmycea;Fungi;Dikarya;Ascomycota;Pezizomycotina;Pezizomycetes;Pezizales;Pyronemataceae;Leucoscypha;";"0.0";"0";"1";"1";"0";"1";"0";"457182";"391207"
"V4mis2";"SILVA (only NR);Eukaryota;Amorphea;Obazoa;Opisthokonta;Nucletmycea;Fungi;Dikarya;Ascomycota;Pezizomycotina;Pezizomycetes;Pezizales;Pyronemataceae;Marcelleina;";"0.0";"0";"2";"2";"0";"2";"0";"457181";"391207"
"V4mis2";"SILVA (only NR);Eukaryota;Amorphea;Obazoa;Opisthokonta;Nucletmycea;Fungi;Dikarya;Ascomycota;Pezizomycotina;Pezizomycetes;Pezizales;Pyronemataceae;Melastiza;";"0.0";"0";"1";"1";"0";"1";"0";"457182";"391207"
"V4mis2";"SILVA (only NR);Eukaryota;Amorphea;Obazoa;Opisthokonta;Nucletmycea;Fungi;Dikarya;Ascomycota;Pezizomycotina;Pezizomycetes;Pezizales;Pyronemataceae;Miladina;";"0.0";"0";"1";"1";"0";"1";"0";"457182";"391207"
"V4mis2";"SILVA (only NR);Eukaryota;Amorphea;Obazoa;Opisthokonta;Nucletmycea;Fungi;Dikarya;Ascomycota;Pezizomycotina;Pezizomycetes;Pezizales;Pyronemataceae;Octospora;";"0.0";"0";"2";"2";"0";"2";"0";"457181";"391207"
"V4mis2";"SILVA (only NR);Eukaryota;Amorphea;Obazoa;Opisthokonta;Nucletmycea;Fungi;Dikarya;Ascomycota;Pezizomycotina;Pezizomycetes;Pezizales;Pyronemataceae;Octosporella;";"0.0";"0";"2";"2";"0";"2";"0";"457181";"391207"
"V4mis2";"SILVA (only NR);Eukaryota;Amorphea;Obazoa;Opisthokonta;Nucletmycea;Fungi;Dikarya;Ascomycota;Pezizomycotina;Pezizomycetes;Pezizales;Pyronemataceae;Otidea;";"0.0";"0";"3";"3";"0";"3";"0";"457180";"391207"
"V4mis2";"SILVA (only NR);Eukaryota;Amorphea;Obazoa;Opisthokonta;Nucletmycea;Fungi;Dikarya;Ascomycota;Pezizomycotina;Pezizomycetes;Pezizales;Pyronemataceae;Parascutellinia;";"0.0";"0";"1";"1";"0";"1";"0";"457182";"391207"
"V4mis2";"SILVA (only NR);Eukaryota;Amorphea;Obazoa;Opisthokonta;Nucletmycea;Fungi;Dikarya;Ascomycota;Pezizomycotina;Pezizomycetes;Pezizales;Pyronemataceae;Pseudombrophila;";"0.0";"0";"1";"1";"0";"1";"0";"457182";"391207"
"V4mis2";"SILVA (only NR);Eukaryota;Amorphea;Obazoa;Opisthokonta;Nucletmycea;Fungi;Dikarya;Ascomycota;Pezizomycotina;Pezizomycetes;Pezizales;Pyronemataceae;Pulvinula;";"0.0";"0";"2";"2";"0";"2";"0";"457181";"391207"
"V4mis2";"SILVA (only NR);Eukaryota;Amorphea;Obazoa;Opisthokonta;Nucletmycea;Fungi;Dikarya;Ascomycota;Pezizomycotina;Pezizomycetes;Pezizales;Pyronemataceae;Pyronema;";"0.0";"0";"1";"1";"0";"1";"0";"457182";"391207"
"V4mis2";"SILVA (only NR);Eukaryota;Amorphea;Obazoa;Opisthokonta;Nucletmycea;Fungi;Dikarya;Ascomycota;Pezizomycotina;Pezizomycetes;Pezizales;Pyronemataceae;Rhodoscypha;";"0.0";"0";"1";"1";"0";"1";"0";"457182";"391207"
"V4mis2";"SILVA (only NR);Eukaryota;Amorphea;Obazoa;Opisthokonta;Nucletmycea;Fungi;Dikarya;Ascomycota;Pezizomycotina;Pezizomycetes;Pezizales;Pyronemataceae;Rhodotarzetta;";"0.0";"0";"1";"1";"0";"1";"0";"457182";"391207"
"V4mis2";"SILVA (only NR);Eukaryota;Amorphea;Obazoa;Opisthokonta;Nucletmycea;Fungi;Dikarya;Ascomycota;Pezizomycotina;Pezizomycetes;Pezizales;Pyronemataceae;Scutellinia;";"0.0";"0";"1";"1";"0";"1";"0";"457182";"391207"
"V4mis2";"SILVA (only NR);Eukaryota;Amorphea;Obazoa;Opisthokonta;Nucletmycea;Fungi;Dikarya;Ascomycota;Pezizomycotina;Pezizomycetes;Pezizales;Pyronemataceae;Selenaspora;";"0.0";"0";"1";"1";"0";"1";"0";"457182";"391207"
"V4mis2";"SILVA (only NR);Eukaryota;Amorphea;Obazoa;Opisthokonta;Nucletmycea;Fungi;Dikarya;Ascomycota;Pezizomycotina;Pezizomycetes;Pezizales;Pyronemataceae;Sowerbyella;";"0.0";"0";"3";"3";"0";"3";"0";"457180";"391207"
"V4mis2";"SILVA (only NR);Eukaryota;Amorphea;Obazoa;Opisthokonta;Nucletmycea;Fungi;Dikarya;Ascomycota;Pezizomycotina;Pezizomycetes;Pezizales;Pyronemataceae;Sporendonema;";"0.0";"0";"1";"1";"0";"1";"0";"457182";"391207"
"V4mis2";"SILVA (only NR);Eukaryota;Amorphea;Obazoa;Opisthokonta;Nucletmycea;Fungi;Dikarya;Ascomycota;Pezizomycotina;Pezizomycetes;Pezizales;Pyronemataceae;Tarzetta;";"0.0";"0";"2";"2";"0";"2";"0";"457181";"391207"
"V4mis2";"SILVA (only NR);Eukaryota;Amorphea;Obazoa;Opisthokonta;Nucletmycea;Fungi;Dikarya;Ascomycota;Pezizomycotina;Pezizomycetes;Pezizales;Pyronemataceae;Tricharina;";"0.0";"0";"1";"1";"0";"1";"0";"457182";"391207"
"V4mis2";"SILVA (only NR);Eukaryota;Amorphea;Obazoa;Opisthokonta;Nucletmycea;Fungi;Dikarya;Ascomycota;Pezizomycotina;Pezizomycetes;Pezizales;Pyronemataceae;Trichophaea;";"0.0";"0";"1";"1";"0";"1";"0";"457182";"391207"
"V4mis2";"SILVA (only NR);Eukaryota;Amorphea;Obazoa;Opisthokonta;Nucletmycea;Fungi;Dikarya;Ascomycota;Pezizomycotina;Pezizomycetes;Pezizales;Pyronemataceae;Wilcoxina;";"0.0";"0";"1";"1";"0";"1";"0";"457182";"391207"
"V4mis2";"SILVA (only NR);Eukaryota;Amorphea;Obazoa;Opisthokonta;Nucletmycea;Fungi;Dikarya;Ascomycota;Pezizomycotina;Pezizomycetes;Pezizales;Pyronemataceae;uncultured;";"0.0";"0";"5";"5";"0";"5";"0";"457178";"391207"
"V4mis2";"SILVA (only NR);Eukaryota;Amorphea;Obazoa;Opisthokonta;Nucletmycea;Fungi;Dikarya;Ascomycota;Pezizomycotina;Pezizomycetes;Pezizales;Reddellomyces;";"0.0";"0";"1";"1";"0";"1";"0";"457182";"391207"
"V4mis2";"SILVA (only NR);Eukaryota;Amorphea;Obazoa;Opisthokonta;Nucletmycea;Fungi;Dikarya;Ascomycota;Pezizomycotina;Pezizomycetes;Pezizales;Rhizinaceae;";"0.0";"0";"14";"14";"0";"14";"0";"457169";"391207"
"V4mis2";"SILVA (only NR);Eukaryota;Amorphea;Obazoa;Opisthokonta;Nucletmycea;Fungi;Dikarya;Ascomycota;Pezizomycotina;Pezizomycetes;Pezizales;Rhizinaceae;Phymatotrichopsis;";"0.0";"0";"9";"9";"0";"9";"0";"457174";"391207"
"V4mis2";"SILVA (only NR);Eukaryota;Amorphea;Obazoa;Opisthokonta;Nucletmycea;Fungi;Dikarya;Ascomycota;Pezizomycotina;Pezizomycetes;Pezizales;Rhizinaceae;Psilopezia;";"0.0";"0";"3";"3";"0";"3";"0";"457180";"391207"
"V4mis2";"SILVA (only NR);Eukaryota;Amorphea;Obazoa;Opisthokonta;Nucletmycea;Fungi;Dikarya;Ascomycota;Pezizomycotina;Pezizomycetes;Pezizales;Rhizinaceae;Rhizina;";"0.0";"0";"2";"2";"0";"2";"0";"457181";"391207"
"V4mis2";"SILVA (only NR);Eukaryota;Amorphea;Obazoa;Opisthokonta;Nucletmycea;Fungi;Dikarya;Ascomycota;Pezizomycotina;Pezizomycetes;Pezizales;Sarcoscyphaceae;";"0.0";"0";"13";"13";"0";"13";"0";"457170";"391207"
"V4mis2";"SILVA (only NR);Eukaryota;Amorphea;Obazoa;Opisthokonta;Nucletmycea;Fungi;Dikarya;Ascomycota;Pezizomycotina;Pezizomycetes;Pezizales;Sarcoscyphaceae;Cookeina;";"0.0";"0";"2";"2";"0";"2";"0";"457181";"391207"
"V4mis2";"SILVA (only NR);Eukaryota;Amorphea;Obazoa;Opisthokonta;Nucletmycea;Fungi;Dikarya;Ascomycota;Pezizomycotina;Pezizomycetes;Pezizales;Sarcoscyphaceae;Microstoma;";"0.0";"0";"2";"2";"0";"2";"0";"457181";"391207"
"V4mis2";"SILVA (only NR);Eukaryota;Amorphea;Obazoa;Opisthokonta;Nucletmycea;Fungi;Dikarya;Ascomycota;Pezizomycotina;Pezizomycetes;Pezizales;Sarcoscyphaceae;Nanoscypha;";"0.0";"0";"1";"1";"0";"1";"0";"457182";"391207"
"V4mis2";"SILVA (only NR);Eukaryota;Amorphea;Obazoa;Opisthokonta;Nucletmycea;Fungi;Dikarya;Ascomycota;Pezizomycotina;Pezizomycetes;Pezizales;Sarcoscyphaceae;Phillipsia;";"0.0";"0";"2";"2";"0";"2";"0";"457181";"391207"
"V4mis2";"SILVA (only NR);Eukaryota;Amorphea;Obazoa;Opisthokonta;Nucletmycea;Fungi;Dikarya;Ascomycota;Pezizomycotina;Pezizomycetes;Pezizales;Sarcoscyphaceae;Pithya;";"0.0";"0";"1";"1";"0";"1";"0";"457182";"391207"
"V4mis2";"SILVA (only NR);Eukaryota;Amorphea;Obazoa;Opisthokonta;Nucletmycea;Fungi;Dikarya;Ascomycota;Pezizomycotina;Pezizomycetes;Pezizales;Sarcoscyphaceae;Pseudopithyella;";"0.0";"0";"1";"1";"0";"1";"0";"457182";"391207"
"V4mis2";"SILVA (only NR);Eukaryota;Amorphea;Obazoa;Opisthokonta;Nucletmycea;Fungi;Dikarya;Ascomycota;Pezizomycotina;Pezizomycetes;Pezizales;Sarcoscyphaceae;Rickiella;";"0.0";"0";"1";"1";"0";"1";"0";"457182";"391207"
"V4mis2";"SILVA (only NR);Eukaryota;Amorphea;Obazoa;Opisthokonta;Nucletmycea;Fungi;Dikarya;Ascomycota;Pezizomycotina;Pezizomycetes;Pezizales;Sarcoscyphaceae;Sarcoscypha;";"0.0";"0";"2";"2";"0";"2";"0";"457181";"391207"
"V4mis2";"SILVA (only NR);Eukaryota;Amorphea;Obazoa;Opisthokonta;Nucletmycea;Fungi;Dikarya;Ascomycota;Pezizomycotina;Pezizomycetes;Pezizales;Sarcosomataceae;";"0.0";"0";"3";"3";"0";"3";"0";"457180";"391207"
"V4mis2";"SILVA (only NR);Eukaryota;Amorphea;Obazoa;Opisthokonta;Nucletmycea;Fungi;Dikarya;Ascomycota;Pezizomycotina;Pezizomycetes;Pezizales;Sarcosomataceae;Plectania;";"0.0";"0";"1";"1";"0";"1";"0";"457182";"391207"
"V4mis2";"SILVA (only NR);Eukaryota;Amorphea;Obazoa;Opisthokonta;Nucletmycea;Fungi;Dikarya;Ascomycota;Pezizomycotina;Pezizomycetes;Pezizales;Sarcosomataceae;Pseudoplectania;";"0.0";"0";"1";"1";"0";"1";"0";"457182";"391207"
"V4mis2";"SILVA (only NR);Eukaryota;Amorphea;Obazoa;Opisthokonta;Nucletmycea;Fungi;Dikarya;Ascomycota;Pezizomycotina;Pezizomycetes;Pezizales;Sarcosomataceae;Sarcosoma;";"0.0";"0";"1";"1";"0";"1";"0";"457182";"391207"
"V4mis2";"SILVA (only NR);Eukaryota;Amorphea;Obazoa;Opisthokonta;Nucletmycea;Fungi;Dikarya;Ascomycota;Pezizomycotina;Pezizomycetes;Pezizales;Strobiloscypha;";"0.0";"0";"1";"1";"0";"1";"0";"457182";"391207"
"V4mis2";"SILVA (only NR);Eukaryota;Amorphea;Obazoa;Opisthokonta;Nucletmycea;Fungi;Dikarya;Ascomycota;Pezizomycotina;Pezizomycetes;Pezizales;Tuberaceae;";"0.0";"0";"10";"9";"0";"9";"1";"457174";"391207"
"V4mis2";"SILVA (only NR);Eukaryota;Amorphea;Obazoa;Opisthokonta;Nucletmycea;Fungi;Dikarya;Ascomycota;Pezizomycotina;Pezizomycetes;Pezizales;Tuberaceae;Choiromyces;";"0.0";"0";"1";"1";"0";"1";"0";"457182";"391207"
"V4mis2";"SILVA (only NR);Eukaryota;Amorphea;Obazoa;Opisthokonta;Nucletmycea;Fungi;Dikarya;Ascomycota;Pezizomycotina;Pezizomycetes;Pezizales;Tuberaceae;Tuber;";"0.0";"0";"9";"8";"0";"8";"1";"457175";"391207"
"V4mis2";"SILVA (only NR);Eukaryota;Amorphea;Obazoa;Opisthokonta;Nucletmycea;Fungi;Dikarya;Ascomycota;Pezizomycotina;Pezizomycetes;Pezizales;Wolfina;";"0.0";"0";"1";"1";"0";"1";"0";"457182";"391207"
"V4mis2";"SILVA (only NR);Eukaryota;Amorphea;Obazoa;Opisthokonta;Nucletmycea;Fungi;Dikarya;Ascomycota;Pezizomycotina;Rhopalophora;";"0.0";"0";"2";"2";"0";"2";"0";"457181";"391207"
"V4mis2";"SILVA (only NR);Eukaryota;Amorphea;Obazoa;Opisthokonta;Nucletmycea;Fungi;Dikarya;Ascomycota;Pezizomycotina;Sordariomycetes;";"0.5";"14.2";"989";"988";"5";"983";"1";"456195";"391202"
"V4mis2";"SILVA (only NR);Eukaryota;Amorphea;Obazoa;Opisthokonta;Nucletmycea;Fungi;Dikarya;Ascomycota;Pezizomycotina;Sordariomycetes;Annulatascales;";"0.0";"0";"1";"1";"0";"1";"0";"457182";"391207"
"V4mis2";"SILVA (only NR);Eukaryota;Amorphea;Obazoa;Opisthokonta;Nucletmycea;Fungi;Dikarya;Ascomycota;Pezizomycotina;Sordariomycetes;Annulatascales;Annulatascaceae;";"0.0";"0";"1";"1";"0";"1";"0";"457182";"391207"
"V4mis2";"SILVA (only NR);Eukaryota;Amorphea;Obazoa;Opisthokonta;Nucletmycea;Fungi;Dikarya;Ascomycota;Pezizomycotina;Sordariomycetes;Annulatascales;Annulatascaceae;Ascitendus;";"0.0";"0";"1";"1";"0";"1";"0";"457182";"391207"
"V4mis2";"SILVA (only NR);Eukaryota;Amorphea;Obazoa;Opisthokonta;Nucletmycea;Fungi;Dikarya;Ascomycota;Pezizomycotina;Sordariomycetes;Boliniales;";"0.0";"0";"1";"1";"0";"1";"0";"457182";"391207"
"V4mis2";"SILVA (only NR);Eukaryota;Amorphea;Obazoa;Opisthokonta;Nucletmycea;Fungi;Dikarya;Ascomycota;Pezizomycotina;Sordariomycetes;Boliniales;Boliniaceae;";"0.0";"0";"1";"1";"0";"1";"0";"457182";"391207"
"V4mis2";"SILVA (only NR);Eukaryota;Amorphea;Obazoa;Opisthokonta;Nucletmycea;Fungi;Dikarya;Ascomycota;Pezizomycotina;Sordariomycetes;Boliniales;Boliniaceae;Camarops;";"0.0";"0";"1";"1";"0";"1";"0";"457182";"391207"
"V4mis2";"SILVA (only NR);Eukaryota;Amorphea;Obazoa;Opisthokonta;Nucletmycea;Fungi;Dikarya;Ascomycota;Pezizomycotina;Sordariomycetes;Calosphaeriales;";"0.0";"0";"6";"6";"0";"6";"0";"457177";"391207"
"V4mis2";"SILVA (only NR);Eukaryota;Amorphea;Obazoa;Opisthokonta;Nucletmycea;Fungi;Dikarya;Ascomycota;Pezizomycotina;Sordariomycetes;Calosphaeriales;Calosphaeriaceae;";"0.0";"0";"4";"4";"0";"4";"0";"457179";"391207"
"V4mis2";"SILVA (only NR);Eukaryota;Amorphea;Obazoa;Opisthokonta;Nucletmycea;Fungi;Dikarya;Ascomycota;Pezizomycotina;Sordariomycetes;Calosphaeriales;Calosphaeriaceae;Calosphaeria;";"0.0";"0";"1";"1";"0";"1";"0";"457182";"391207"
"V4mis2";"SILVA (only NR);Eukaryota;Amorphea;Obazoa;Opisthokonta;Nucletmycea;Fungi;Dikarya;Ascomycota;Pezizomycotina;Sordariomycetes;Calosphaeriales;Calosphaeriaceae;Jattaea;";"0.0";"0";"2";"2";"0";"2";"0";"457181";"391207"
"V4mis2";"SILVA (only NR);Eukaryota;Amorphea;Obazoa;Opisthokonta;Nucletmycea;Fungi;Dikarya;Ascomycota;Pezizomycotina;Sordariomycetes;Calosphaeriales;Calosphaeriaceae;Togniniella;";"0.0";"0";"1";"1";"0";"1";"0";"457182";"391207"
"V4mis2";"SILVA (only NR);Eukaryota;Amorphea;Obazoa;Opisthokonta;Nucletmycea;Fungi;Dikarya;Ascomycota;Pezizomycotina;Sordariomycetes;Calosphaeriales;Pleurostomataceae;";"0.0";"0";"2";"2";"0";"2";"0";"457181";"391207"
"V4mis2";"SILVA (only NR);Eukaryota;Amorphea;Obazoa;Opisthokonta;Nucletmycea;Fungi;Dikarya;Ascomycota;Pezizomycotina;Sordariomycetes;Calosphaeriales;Pleurostomataceae;Pleurostoma;";"0.0";"0";"2";"2";"0";"2";"0";"457181";"391207"
"V4mis2";"SILVA (only NR);Eukaryota;Amorphea;Obazoa;Opisthokonta;Nucletmycea;Fungi;Dikarya;Ascomycota;Pezizomycotina;Sordariomycetes;Coniochaetales;";"0.0";"0";"6";"6";"0";"6";"0";"457177";"391207"
"V4mis2";"SILVA (only NR);Eukaryota;Amorphea;Obazoa;Opisthokonta;Nucletmycea;Fungi;Dikarya;Ascomycota;Pezizomycotina;Sordariomycetes;Coniochaetales;Coniochaetaceae;";"0.0";"0";"6";"6";"0";"6";"0";"457177";"391207"
"V4mis2";"SILVA (only NR);Eukaryota;Amorphea;Obazoa;Opisthokonta;Nucletmycea;Fungi;Dikarya;Ascomycota;Pezizomycotina;Sordariomycetes;Coniochaetales;Coniochaetaceae;Coniochaeta;";"0.0";"0";"6";"6";"0";"6";"0";"457177";"391207"
"V4mis2";"SILVA (only NR);Eukaryota;Amorphea;Obazoa;Opisthokonta;Nucletmycea;Fungi;Dikarya;Ascomycota;Pezizomycotina;Sordariomycetes;Conioscyphales;";"0.0";"0";"3";"3";"0";"3";"0";"457180";"391207"
"V4mis2";"SILVA (only NR);Eukaryota;Amorphea;Obazoa;Opisthokonta;Nucletmycea;Fungi;Dikarya;Ascomycota;Pezizomycotina;Sordariomycetes;Conioscyphales;Conioscyphaceae;";"0.0";"0";"3";"3";"0";"3";"0";"457180";"391207"
"V4mis2";"SILVA (only NR);Eukaryota;Amorphea;Obazoa;Opisthokonta;Nucletmycea;Fungi;Dikarya;Ascomycota;Pezizomycotina;Sordariomycetes;Conioscyphales;Conioscyphaceae;Conioscypha;";"0.0";"0";"3";"3";"0";"3";"0";"457180";"391207"
"V4mis2";"SILVA (only NR);Eukaryota;Amorphea;Obazoa;Opisthokonta;Nucletmycea;Fungi;Dikarya;Ascomycota;Pezizomycotina;Sordariomycetes;Diaporthales;";"0.0";"0";"23";"23";"0";"23";"0";"457160";"391207"
"V4mis2";"SILVA (only NR);Eukaryota;Amorphea;Obazoa;Opisthokonta;Nucletmycea;Fungi;Dikarya;Ascomycota;Pezizomycotina;Sordariomycetes;Diaporthales;Cryphonectriaceae;";"0.0";"0";"9";"9";"0";"9";"0";"457174";"391207"
"V4mis2";"SILVA (only NR);Eukaryota;Amorphea;Obazoa;Opisthokonta;Nucletmycea;Fungi;Dikarya;Ascomycota;Pezizomycotina;Sordariomycetes;Diaporthales;Cryphonectriaceae;Cryphonectria-Endothia complex;";"0.0";"0";"9";"9";"0";"9";"0";"457174";"391207"
"V4mis2";"SILVA (only NR);Eukaryota;Amorphea;Obazoa;Opisthokonta;Nucletmycea;Fungi;Dikarya;Ascomycota;Pezizomycotina;Sordariomycetes;Diaporthales;Diaporthe;";"0.0";"0";"1";"1";"0";"1";"0";"457182";"391207"
"V4mis2";"SILVA (only NR);Eukaryota;Amorphea;Obazoa;Opisthokonta;Nucletmycea;Fungi;Dikarya;Ascomycota;Pezizomycotina;Sordariomycetes;Diaporthales;Gnomoniaceae;";"0.0";"0";"4";"4";"0";"4";"0";"457179";"391207"
"V4mis2";"SILVA (only NR);Eukaryota;Amorphea;Obazoa;Opisthokonta;Nucletmycea;Fungi;Dikarya;Ascomycota;Pezizomycotina;Sordariomycetes;Diaporthales;Gnomoniaceae;Cryptosporella;";"0.0";"0";"1";"1";"0";"1";"0";"457182";"391207"
"V4mis2";"SILVA (only NR);Eukaryota;Amorphea;Obazoa;Opisthokonta;Nucletmycea;Fungi;Dikarya;Ascomycota;Pezizomycotina;Sordariomycetes;Diaporthales;Gnomoniaceae;Gnomonia;";"0.0";"0";"1";"1";"0";"1";"0";"457182";"391207"
"V4mis2";"SILVA (only NR);Eukaryota;Amorphea;Obazoa;Opisthokonta;Nucletmycea;Fungi;Dikarya;Ascomycota;Pezizomycotina;Sordariomycetes;Diaporthales;Gnomoniaceae;Ophiognomonia;";"0.0";"0";"1";"1";"0";"1";"0";"457182";"391207"
"V4mis2";"SILVA (only NR);Eukaryota;Amorphea;Obazoa;Opisthokonta;Nucletmycea;Fungi;Dikarya;Ascomycota;Pezizomycotina;Sordariomycetes;Diaporthales;Gnomoniaceae;Plagiostoma;";"0.0";"0";"1";"1";"0";"1";"0";"457182";"391207"
"V4mis2";"SILVA (only NR);Eukaryota;Amorphea;Obazoa;Opisthokonta;Nucletmycea;Fungi;Dikarya;Ascomycota;Pezizomycotina;Sordariomycetes;Diaporthales;Melanconidaceae;";"0.0";"0";"2";"2";"0";"2";"0";"457181";"391207"
"V4mis2";"SILVA (only NR);Eukaryota;Amorphea;Obazoa;Opisthokonta;Nucletmycea;Fungi;Dikarya;Ascomycota;Pezizomycotina;Sordariomycetes;Diaporthales;Melanconidaceae;Melanconis;";"0.0";"0";"2";"2";"0";"2";"0";"457181";"391207"
"V4mis2";"SILVA (only NR);Eukaryota;Amorphea;Obazoa;Opisthokonta;Nucletmycea;Fungi;Dikarya;Ascomycota;Pezizomycotina;Sordariomycetes;Diaporthales;Phomopsis;";"0.0";"0";"1";"1";"0";"1";"0";"457182";"391207"
"V4mis2";"SILVA (only NR);Eukaryota;Amorphea;Obazoa;Opisthokonta;Nucletmycea;Fungi;Dikarya;Ascomycota;Pezizomycotina;Sordariomycetes;Diaporthales;Sirococcus;";"0.0";"0";"1";"1";"0";"1";"0";"457182";"391207"
"V4mis2";"SILVA (only NR);Eukaryota;Amorphea;Obazoa;Opisthokonta;Nucletmycea;Fungi;Dikarya;Ascomycota;Pezizomycotina;Sordariomycetes;Diaporthales;Valsa;";"0.0";"0";"1";"1";"0";"1";"0";"457182";"391207"
"V4mis2";"SILVA (only NR);Eukaryota;Amorphea;Obazoa;Opisthokonta;Nucletmycea;Fungi;Dikarya;Ascomycota;Pezizomycotina;Sordariomycetes;Diaporthales;Valsaceae;";"0.0";"0";"3";"3";"0";"3";"0";"457180";"391207"
"V4mis2";"SILVA (only NR);Eukaryota;Amorphea;Obazoa;Opisthokonta;Nucletmycea;Fungi;Dikarya;Ascomycota;Pezizomycotina;Sordariomycetes;Diaporthales;Valsaceae;Phruensis;";"0.0";"0";"2";"2";"0";"2";"0";"457181";"391207"
"V4mis2";"SILVA (only NR);Eukaryota;Amorphea;Obazoa;Opisthokonta;Nucletmycea;Fungi;Dikarya;Ascomycota;Pezizomycotina;Sordariomycetes;Glomerellales;";"0.0";"0";"92";"92";"0";"92";"0";"457091";"391207"
"V4mis2";"SILVA (only NR);Eukaryota;Amorphea;Obazoa;Opisthokonta;Nucletmycea;Fungi;Dikarya;Ascomycota;Pezizomycotina;Sordariomycetes;Glomerellales;Australiascaceae;";"0.0";"0";"5";"5";"0";"5";"0";"457178";"391207"
"V4mis2";"SILVA (only NR);Eukaryota;Amorphea;Obazoa;Opisthokonta;Nucletmycea;Fungi;Dikarya;Ascomycota;Pezizomycotina;Sordariomycetes;Glomerellales;Australiascaceae;Australiasca;";"0.0";"0";"1";"1";"0";"1";"0";"457182";"391207"
"V4mis2";"SILVA (only NR);Eukaryota;Amorphea;Obazoa;Opisthokonta;Nucletmycea;Fungi;Dikarya;Ascomycota;Pezizomycotina;Sordariomycetes;Glomerellales;Australiascaceae;Monilochaetes;";"0.0";"0";"4";"4";"0";"4";"0";"457179";"391207"
"V4mis2";"SILVA (only NR);Eukaryota;Amorphea;Obazoa;Opisthokonta;Nucletmycea;Fungi;Dikarya;Ascomycota;Pezizomycotina;Sordariomycetes;Glomerellales;Glomerellaceae;";"0.0";"0";"64";"64";"0";"64";"0";"457119";"391207"
"V4mis2";"SILVA (only NR);Eukaryota;Amorphea;Obazoa;Opisthokonta;Nucletmycea;Fungi;Dikarya;Ascomycota;Pezizomycotina;Sordariomycetes;Glomerellales;Glomerellaceae;Colletotrichum;";"0.0";"0";"64";"64";"0";"64";"0";"457119";"391207"
"V4mis2";"SILVA (only NR);Eukaryota;Amorphea;Obazoa;Opisthokonta;Nucletmycea;Fungi;Dikarya;Ascomycota;Pezizomycotina;Sordariomycetes;Glomerellales;Plectosphaerellaceae;";"0.0";"0";"18";"18";"0";"18";"0";"457165";"391207"
"V4mis2";"SILVA (only NR);Eukaryota;Amorphea;Obazoa;Opisthokonta;Nucletmycea;Fungi;Dikarya;Ascomycota;Pezizomycotina;Sordariomycetes;Glomerellales;Plectosphaerellaceae;Acrostalagmus;";"0.0";"0";"1";"1";"0";"1";"0";"457182";"391207"
"V4mis2";"SILVA (only NR);Eukaryota;Amorphea;Obazoa;Opisthokonta;Nucletmycea;Fungi;Dikarya;Ascomycota;Pezizomycotina;Sordariomycetes;Glomerellales;Plectosphaerellaceae;Gibellulopsis;";"0.0";"0";"1";"1";"0";"1";"0";"457182";"391207"
"V4mis2";"SILVA (only NR);Eukaryota;Amorphea;Obazoa;Opisthokonta;Nucletmycea;Fungi;Dikarya;Ascomycota;Pezizomycotina;Sordariomycetes;Glomerellales;Plectosphaerellaceae;Plectosphaerella;";"0.0";"0";"2";"2";"0";"2";"0";"457181";"391207"
"V4mis2";"SILVA (only NR);Eukaryota;Amorphea;Obazoa;Opisthokonta;Nucletmycea;Fungi;Dikarya;Ascomycota;Pezizomycotina;Sordariomycetes;Glomerellales;Plectosphaerellaceae;Verticillium;";"0.0";"0";"12";"12";"0";"12";"0";"457171";"391207"
"V4mis2";"SILVA (only NR);Eukaryota;Amorphea;Obazoa;Opisthokonta;Nucletmycea;Fungi;Dikarya;Ascomycota;Pezizomycotina;Sordariomycetes;Glomerellales;Reticulascaceae;";"0.0";"0";"5";"5";"0";"5";"0";"457178";"391207"
"V4mis2";"SILVA (only NR);Eukaryota;Amorphea;Obazoa;Opisthokonta;Nucletmycea;Fungi;Dikarya;Ascomycota;Pezizomycotina;Sordariomycetes;Glomerellales;Reticulascaceae;Kylindria;";"0.0";"0";"1";"1";"0";"1";"0";"457182";"391207"
"V4mis2";"SILVA (only NR);Eukaryota;Amorphea;Obazoa;Opisthokonta;Nucletmycea;Fungi;Dikarya;Ascomycota;Pezizomycotina;Sordariomycetes;Glomerellales;Reticulascaceae;Reticulascus;";"0.0";"0";"3";"3";"0";"3";"0";"457180";"391207"
"V4mis2";"SILVA (only NR);Eukaryota;Amorphea;Obazoa;Opisthokonta;Nucletmycea;Fungi;Dikarya;Ascomycota;Pezizomycotina;Sordariomycetes;Glomerellales;Reticulascaceae;Sporoschismopsis;";"0.0";"0";"1";"1";"0";"1";"0";"457182";"391207"
"V4mis2";"SILVA (only NR);Eukaryota;Amorphea;Obazoa;Opisthokonta;Nucletmycea;Fungi;Dikarya;Ascomycota;Pezizomycotina;Sordariomycetes;Hypocreales;";"0.9";"14.4";"435";"434";"4";"430";"1";"456749";"391203"
"V4mis2";"SILVA (only NR);Eukaryota;Amorphea;Obazoa;Opisthokonta;Nucletmycea;Fungi;Dikarya;Ascomycota;Pezizomycotina;Sordariomycetes;Hypocreales;Bionectriaceae;";"0.0";"0";"19";"19";"0";"19";"0";"457164";"391207"
"V4mis2";"SILVA (only NR);Eukaryota;Amorphea;Obazoa;Opisthokonta;Nucletmycea;Fungi;Dikarya;Ascomycota;Pezizomycotina;Sordariomycetes;Hypocreales;Bionectriaceae;Bryocentria;";"0.0";"0";"1";"1";"0";"1";"0";"457182";"391207"
"V4mis2";"SILVA (only NR);Eukaryota;Amorphea;Obazoa;Opisthokonta;Nucletmycea;Fungi;Dikarya;Ascomycota;Pezizomycotina;Sordariomycetes;Hypocreales;Bionectriaceae;Clonostachys;";"0.0";"0";"5";"5";"0";"5";"0";"457178";"391207"
"V4mis2";"SILVA (only NR);Eukaryota;Amorphea;Obazoa;Opisthokonta;Nucletmycea;Fungi;Dikarya;Ascomycota;Pezizomycotina;Sordariomycetes;Hypocreales;Bionectriaceae;Geosmithia;";"0.0";"0";"9";"9";"0";"9";"0";"457174";"391207"
"V4mis2";"SILVA (only NR);Eukaryota;Amorphea;Obazoa;Opisthokonta;Nucletmycea;Fungi;Dikarya;Ascomycota;Pezizomycotina;Sordariomycetes;Hypocreales;Bionectriaceae;Mycoarachis;";"0.0";"0";"1";"1";"0";"1";"0";"457182";"391207"
"V4mis2";"SILVA (only NR);Eukaryota;Amorphea;Obazoa;Opisthokonta;Nucletmycea;Fungi;Dikarya;Ascomycota;Pezizomycotina;Sordariomycetes;Hypocreales;Bionectriaceae;Nigrosabulum;";"0.0";"0";"1";"1";"0";"1";"0";"457182";"391207"
"V4mis2";"SILVA (only NR);Eukaryota;Amorphea;Obazoa;Opisthokonta;Nucletmycea;Fungi;Dikarya;Ascomycota;Pezizomycotina;Sordariomycetes;Hypocreales;Bionectriaceae;Ochronectria;";"0.0";"0";"1";"1";"0";"1";"0";"457182";"391207"
"V4mis2";"SILVA (only NR);Eukaryota;Amorphea;Obazoa;Opisthokonta;Nucletmycea;Fungi;Dikarya;Ascomycota;Pezizomycotina;Sordariomycetes;Hypocreales;Claviceps;";"0.0";"0";"1";"1";"0";"1";"0";"457182";"391207"
"V4mis2";"SILVA (only NR);Eukaryota;Amorphea;Obazoa;Opisthokonta;Nucletmycea;Fungi;Dikarya;Ascomycota;Pezizomycotina;Sordariomycetes;Hypocreales;Clavicipitaceae;";"0.0";"0";"39";"38";"0";"38";"1";"457145";"391207"
"V4mis2";"SILVA (only NR);Eukaryota;Amorphea;Obazoa;Opisthokonta;Nucletmycea;Fungi;Dikarya;Ascomycota;Pezizomycotina;Sordariomycetes;Hypocreales;Clavicipitaceae;Aciculosporium;";"0.0";"0";"1";"1";"0";"1";"0";"457182";"391207"
"V4mis2";"SILVA (only NR);Eukaryota;Amorphea;Obazoa;Opisthokonta;Nucletmycea;Fungi;Dikarya;Ascomycota;Pezizomycotina;Sordariomycetes;Hypocreales;Clavicipitaceae;Balansia;";"0.0";"0";"1";"1";"0";"1";"0";"457182";"391207"
"V4mis2";"SILVA (only NR);Eukaryota;Amorphea;Obazoa;Opisthokonta;Nucletmycea;Fungi;Dikarya;Ascomycota;Pezizomycotina;Sordariomycetes;Hypocreales;Clavicipitaceae;Conoideocrella;";"0.0";"0";"3";"3";"0";"3";"0";"457180";"391207"
"V4mis2";"SILVA (only NR);Eukaryota;Amorphea;Obazoa;Opisthokonta;Nucletmycea;Fungi;Dikarya;Ascomycota;Pezizomycotina;Sordariomycetes;Hypocreales;Clavicipitaceae;Epichloe;";"0.0";"0";"6";"5";"0";"5";"1";"457178";"391207"
"V4mis2";"SILVA (only NR);Eukaryota;Amorphea;Obazoa;Opisthokonta;Nucletmycea;Fungi;Dikarya;Ascomycota;Pezizomycotina;Sordariomycetes;Hypocreales;Clavicipitaceae;Hypocrella;";"0.0";"0";"1";"1";"0";"1";"0";"457182";"391207"
"V4mis2";"SILVA (only NR);Eukaryota;Amorphea;Obazoa;Opisthokonta;Nucletmycea;Fungi;Dikarya;Ascomycota;Pezizomycotina;Sordariomycetes;Hypocreales;Clavicipitaceae;Metapochonia;";"0.0";"0";"2";"2";"0";"2";"0";"457181";"391207"
"V4mis2";"SILVA (only NR);Eukaryota;Amorphea;Obazoa;Opisthokonta;Nucletmycea;Fungi;Dikarya;Ascomycota;Pezizomycotina;Sordariomycetes;Hypocreales;Clavicipitaceae;Metarhizium;";"0.0";"0";"18";"18";"0";"18";"0";"457165";"391207"
"V4mis2";"SILVA (only NR);Eukaryota;Amorphea;Obazoa;Opisthokonta;Nucletmycea;Fungi;Dikarya;Ascomycota;Pezizomycotina;Sordariomycetes;Hypocreales;Clavicipitaceae;Pochonia;";"0.0";"0";"2";"2";"0";"2";"0";"457181";"391207"
"V4mis2";"SILVA (only NR);Eukaryota;Amorphea;Obazoa;Opisthokonta;Nucletmycea;Fungi;Dikarya;Ascomycota;Pezizomycotina;Sordariomycetes;Hypocreales;Clavicipitaceae;Torrubiella;";"0.0";"0";"1";"1";"0";"1";"0";"457182";"391207"
"V4mis2";"SILVA (only NR);Eukaryota;Amorphea;Obazoa;Opisthokonta;Nucletmycea;Fungi;Dikarya;Ascomycota;Pezizomycotina;Sordariomycetes;Hypocreales;Cordycipitaceae;";"0.0";"0";"95";"95";"0";"95";"0";"457088";"391207"
"V4mis2";"SILVA (only NR);Eukaryota;Amorphea;Obazoa;Opisthokonta;Nucletmycea;Fungi;Dikarya;Ascomycota;Pezizomycotina;Sordariomycetes;Hypocreales;Cordycipitaceae;Akanthomyces;";"0.0";"0";"1";"1";"0";"1";"0";"457182";"391207"
"V4mis2";"SILVA (only NR);Eukaryota;Amorphea;Obazoa;Opisthokonta;Nucletmycea;Fungi;Dikarya;Ascomycota;Pezizomycotina;Sordariomycetes;Hypocreales;Cordycipitaceae;Beauveria;";"0.0";"0";"15";"15";"0";"15";"0";"457168";"391207"
"V4mis2";"SILVA (only NR);Eukaryota;Amorphea;Obazoa;Opisthokonta;Nucletmycea;Fungi;Dikarya;Ascomycota;Pezizomycotina;Sordariomycetes;Hypocreales;Cordycipitaceae;Blackwellomyces;";"0.0";"0";"1";"1";"0";"1";"0";"457182";"391207"
"V4mis2";"SILVA (only NR);Eukaryota;Amorphea;Obazoa;Opisthokonta;Nucletmycea;Fungi;Dikarya;Ascomycota;Pezizomycotina;Sordariomycetes;Hypocreales;Cordycipitaceae;Cordyceps;";"0.0";"0";"43";"43";"0";"43";"0";"457140";"391207"
"V4mis2";"SILVA (only NR);Eukaryota;Amorphea;Obazoa;Opisthokonta;Nucletmycea;Fungi;Dikarya;Ascomycota;Pezizomycotina;Sordariomycetes;Hypocreales;Cordycipitaceae;Gibellula;";"0.0";"0";"1";"1";"0";"1";"0";"457182";"391207"
"V4mis2";"SILVA (only NR);Eukaryota;Amorphea;Obazoa;Opisthokonta;Nucletmycea;Fungi;Dikarya;Ascomycota;Pezizomycotina;Sordariomycetes;Hypocreales;Cordycipitaceae;Hevansia;";"0.0";"0";"1";"1";"0";"1";"0";"457182";"391207"
"V4mis2";"SILVA (only NR);Eukaryota;Amorphea;Obazoa;Opisthokonta;Nucletmycea;Fungi;Dikarya;Ascomycota;Pezizomycotina;Sordariomycetes;Hypocreales;Cordycipitaceae;Isaria;";"0.0";"0";"16";"16";"0";"16";"0";"457167";"391207"
"V4mis2";"SILVA (only NR);Eukaryota;Amorphea;Obazoa;Opisthokonta;Nucletmycea;Fungi;Dikarya;Ascomycota;Pezizomycotina;Sordariomycetes;Hypocreales;Cordycipitaceae;Lecanicillium;";"0.0";"0";"5";"5";"0";"5";"0";"457178";"391207"
"V4mis2";"SILVA (only NR);Eukaryota;Amorphea;Obazoa;Opisthokonta;Nucletmycea;Fungi;Dikarya;Ascomycota;Pezizomycotina;Sordariomycetes;Hypocreales;Cordycipitaceae;Parengyodontium;";"0.0";"0";"4";"4";"0";"4";"0";"457179";"391207"
"V4mis2";"SILVA (only NR);Eukaryota;Amorphea;Obazoa;Opisthokonta;Nucletmycea;Fungi;Dikarya;Ascomycota;Pezizomycotina;Sordariomycetes;Hypocreales;Cordycipitaceae;Simplicillium;";"0.0";"0";"3";"3";"0";"3";"0";"457180";"391207"
"V4mis2";"SILVA (only NR);Eukaryota;Amorphea;Obazoa;Opisthokonta;Nucletmycea;Fungi;Dikarya;Ascomycota;Pezizomycotina;Sordariomycetes;Hypocreales;Drechmeria;";"0.0";"0";"1";"1";"0";"1";"0";"457182";"391207"
"V4mis2";"SILVA (only NR);Eukaryota;Amorphea;Obazoa;Opisthokonta;Nucletmycea;Fungi;Dikarya;Ascomycota;Pezizomycotina;Sordariomycetes;Hypocreales;Hypocreaceae;";"0.0";"0";"30";"30";"0";"30";"0";"457153";"391207"
"V4mis2";"SILVA (only NR);Eukaryota;Amorphea;Obazoa;Opisthokonta;Nucletmycea;Fungi;Dikarya;Ascomycota;Pezizomycotina;Sordariomycetes;Hypocreales;Hypocreaceae;Trichoderma;";"0.0";"0";"30";"30";"0";"30";"0";"457153";"391207"
"V4mis2";"SILVA (only NR);Eukaryota;Amorphea;Obazoa;Opisthokonta;Nucletmycea;Fungi;Dikarya;Ascomycota;Pezizomycotina;Sordariomycetes;Hypocreales;Incertae Sedis;";"0.0";"0";"50";"50";"0";"50";"0";"457133";"391207"
"V4mis2";"SILVA (only NR);Eukaryota;Amorphea;Obazoa;Opisthokonta;Nucletmycea;Fungi;Dikarya;Ascomycota;Pezizomycotina;Sordariomycetes;Hypocreales;Incertae Sedis;Acremonium;";"0.0";"0";"31";"31";"0";"31";"0";"457152";"391207"
"V4mis2";"SILVA (only NR);Eukaryota;Amorphea;Obazoa;Opisthokonta;Nucletmycea;Fungi;Dikarya;Ascomycota;Pezizomycotina;Sordariomycetes;Hypocreales;Incertae Sedis;Emericellopsis;";"0.0";"0";"1";"1";"0";"1";"0";"457182";"391207"
"V4mis2";"SILVA (only NR);Eukaryota;Amorphea;Obazoa;Opisthokonta;Nucletmycea;Fungi;Dikarya;Ascomycota;Pezizomycotina;Sordariomycetes;Hypocreales;Incertae Sedis;Sarocladium;";"0.0";"0";"14";"14";"0";"14";"0";"457169";"391207"
"V4mis2";"SILVA (only NR);Eukaryota;Amorphea;Obazoa;Opisthokonta;Nucletmycea;Fungi;Dikarya;Ascomycota;Pezizomycotina;Sordariomycetes;Hypocreales;Incertae Sedis;Trichothecium;";"0.0";"0";"2";"2";"0";"2";"0";"457181";"391207"
"V4mis2";"SILVA (only NR);Eukaryota;Amorphea;Obazoa;Opisthokonta;Nucletmycea;Fungi;Dikarya;Ascomycota;Pezizomycotina;Sordariomycetes;Hypocreales;Juncigena;";"0.0";"0";"1";"1";"0";"1";"0";"457182";"391207"
"V4mis2";"SILVA (only NR);Eukaryota;Amorphea;Obazoa;Opisthokonta;Nucletmycea;Fungi;Dikarya;Ascomycota;Pezizomycotina;Sordariomycetes;Hypocreales;Nectriaceae;";"0.0";"0";"71";"71";"0";"71";"0";"457112";"391207"
"V4mis2";"SILVA (only NR);Eukaryota;Amorphea;Obazoa;Opisthokonta;Nucletmycea;Fungi;Dikarya;Ascomycota;Pezizomycotina;Sordariomycetes;Hypocreales;Nectriaceae;Chaetopsina;";"0.0";"0";"1";"1";"0";"1";"0";"457182";"391207"
"V4mis2";"SILVA (only NR);Eukaryota;Amorphea;Obazoa;Opisthokonta;Nucletmycea;Fungi;Dikarya;Ascomycota;Pezizomycotina;Sordariomycetes;Hypocreales;Nectriaceae;Fusarium;";"0.0";"0";"57";"57";"0";"57";"0";"457126";"391207"
"V4mis2";"SILVA (only NR);Eukaryota;Amorphea;Obazoa;Opisthokonta;Nucletmycea;Fungi;Dikarya;Ascomycota;Pezizomycotina;Sordariomycetes;Hypocreales;Nectriaceae;Mariannaea;";"0.0";"0";"5";"5";"0";"5";"0";"457178";"391207"
"V4mis2";"SILVA (only NR);Eukaryota;Amorphea;Obazoa;Opisthokonta;Nucletmycea;Fungi;Dikarya;Ascomycota;Pezizomycotina;Sordariomycetes;Hypocreales;Nectriaceae;Nectria;";"0.0";"0";"5";"5";"0";"5";"0";"457178";"391207"
"V4mis2";"SILVA (only NR);Eukaryota;Amorphea;Obazoa;Opisthokonta;Nucletmycea;Fungi;Dikarya;Ascomycota;Pezizomycotina;Sordariomycetes;Hypocreales;Nectriaceae;Neonectria;";"0.0";"0";"2";"2";"0";"2";"0";"457181";"391207"
"V4mis2";"SILVA (only NR);Eukaryota;Amorphea;Obazoa;Opisthokonta;Nucletmycea;Fungi;Dikarya;Ascomycota;Pezizomycotina;Sordariomycetes;Hypocreales;Nectriaceae;Xenoacremonium;";"0.0";"0";"1";"1";"0";"1";"0";"457182";"391207"
"V4mis2";"SILVA (only NR);Eukaryota;Amorphea;Obazoa;Opisthokonta;Nucletmycea;Fungi;Dikarya;Ascomycota;Pezizomycotina;Sordariomycetes;Hypocreales;Nectriopsis;";"0.0";"0";"1";"1";"0";"1";"0";"457182";"391207"
"V4mis2";"SILVA (only NR);Eukaryota;Amorphea;Obazoa;Opisthokonta;Nucletmycea;Fungi;Dikarya;Ascomycota;Pezizomycotina;Sordariomycetes;Hypocreales;Niesslia;";"0.0";"0";"2";"2";"0";"2";"0";"457181";"391207"
"V4mis2";"SILVA (only NR);Eukaryota;Amorphea;Obazoa;Opisthokonta;Nucletmycea;Fungi;Dikarya;Ascomycota;Pezizomycotina;Sordariomycetes;Hypocreales;Ophiocordycipitaceae;";"3.7";"14.4";"81";"81";"3";"78";"0";"457102";"391204"
"V4mis2";"SILVA (only NR);Eukaryota;Amorphea;Obazoa;Opisthokonta;Nucletmycea;Fungi;Dikarya;Ascomycota;Pezizomycotina;Sordariomycetes;Hypocreales;Ophiocordycipitaceae;Hirsutella;";"0.0";"0";"4";"4";"0";"4";"0";"457179";"391207"
"V4mis2";"SILVA (only NR);Eukaryota;Amorphea;Obazoa;Opisthokonta;Nucletmycea;Fungi;Dikarya;Ascomycota;Pezizomycotina;Sordariomycetes;Hypocreales;Ophiocordycipitaceae;Hymenostilbe;";"0.0";"0";"1";"1";"0";"1";"0";"457182";"391207"
"V4mis2";"SILVA (only NR);Eukaryota;Amorphea;Obazoa;Opisthokonta;Nucletmycea;Fungi;Dikarya;Ascomycota;Pezizomycotina;Sordariomycetes;Hypocreales;Ophiocordycipitaceae;Ophiocordyceps;";"0.0";"0";"42";"42";"0";"42";"0";"457141";"391207"
"V4mis2";"SILVA (only NR);Eukaryota;Amorphea;Obazoa;Opisthokonta;Nucletmycea;Fungi;Dikarya;Ascomycota;Pezizomycotina;Sordariomycetes;Hypocreales;Ophiocordycipitaceae;Polycephalomyces;";"20.0";"14.4";"5";"5";"1";"4";"0";"457178";"391206"
"V4mis2";"SILVA (only NR);Eukaryota;Amorphea;Obazoa;Opisthokonta;Nucletmycea;Fungi;Dikarya;Ascomycota;Pezizomycotina;Sordariomycetes;Hypocreales;Ophiocordycipitaceae;Purpureocillium;";"0.0";"0";"4";"4";"0";"4";"0";"457179";"391207"
"V4mis2";"SILVA (only NR);Eukaryota;Amorphea;Obazoa;Opisthokonta;Nucletmycea;Fungi;Dikarya;Ascomycota;Pezizomycotina;Sordariomycetes;Hypocreales;Ophiocordycipitaceae;Tolypocladium;";"0.0";"0";"19";"19";"0";"19";"0";"457164";"391207"
"V4mis2";"SILVA (only NR);Eukaryota;Amorphea;Obazoa;Opisthokonta;Nucletmycea;Fungi;Dikarya;Ascomycota;Pezizomycotina;Sordariomycetes;Hypocreales;Septofusidium;";"100.0";"14.4";"1";"1";"1";"0";"0";"457182";"391206"
"V4mis2";"SILVA (only NR);Eukaryota;Amorphea;Obazoa;Opisthokonta;Nucletmycea;Fungi;Dikarya;Ascomycota;Pezizomycotina;Sordariomycetes;Hypocreales;Stachybotryaceae;";"0.0";"0";"32";"32";"0";"32";"0";"457151";"391207"
"V4mis2";"SILVA (only NR);Eukaryota;Amorphea;Obazoa;Opisthokonta;Nucletmycea;Fungi;Dikarya;Ascomycota;Pezizomycotina;Sordariomycetes;Hypocreales;Stachybotryaceae;Melanopsamma;";"0.0";"0";"2";"2";"0";"2";"0";"457181";"391207"
"V4mis2";"SILVA (only NR);Eukaryota;Amorphea;Obazoa;Opisthokonta;Nucletmycea;Fungi;Dikarya;Ascomycota;Pezizomycotina;Sordariomycetes;Hypocreales;Stachybotryaceae;Myrothecium;";"0.0";"0";"15";"15";"0";"15";"0";"457168";"391207"
"V4mis2";"SILVA (only NR);Eukaryota;Amorphea;Obazoa;Opisthokonta;Nucletmycea;Fungi;Dikarya;Ascomycota;Pezizomycotina;Sordariomycetes;Hypocreales;Stachybotryaceae;Paramyrothecium;";"0.0";"0";"1";"1";"0";"1";"0";"457182";"391207"
"V4mis2";"SILVA (only NR);Eukaryota;Amorphea;Obazoa;Opisthokonta;Nucletmycea;Fungi;Dikarya;Ascomycota;Pezizomycotina;Sordariomycetes;Hypocreales;Stachybotryaceae;Stachybotrys;";"0.0";"0";"12";"12";"0";"12";"0";"457171";"391207"
"V4mis2";"SILVA (only NR);Eukaryota;Amorphea;Obazoa;Opisthokonta;Nucletmycea;Fungi;Dikarya;Ascomycota;Pezizomycotina;Sordariomycetes;Hypocreales;Stachybotryaceae;Virgatospora;";"0.0";"0";"1";"1";"0";"1";"0";"457182";"391207"
"V4mis2";"SILVA (only NR);Eukaryota;Amorphea;Obazoa;Opisthokonta;Nucletmycea;Fungi;Dikarya;Ascomycota;Pezizomycotina;Sordariomycetes;Hypocreales;Stachybotryaceae;Xepicula;";"0.0";"0";"1";"1";"0";"1";"0";"457182";"391207"
"V4mis2";"SILVA (only NR);Eukaryota;Amorphea;Obazoa;Opisthokonta;Nucletmycea;Fungi;Dikarya;Ascomycota;Pezizomycotina;Sordariomycetes;Hypocreales;Ustilaginoidea;";"0.0";"0";"3";"3";"0";"3";"0";"457180";"391207"
"V4mis2";"SILVA (only NR);Eukaryota;Amorphea;Obazoa;Opisthokonta;Nucletmycea;Fungi;Dikarya;Ascomycota;Pezizomycotina;Sordariomycetes;Hypocreales;uncultured;";"0.0";"0";"2";"2";"0";"2";"0";"457181";"391207"
"V4mis2";"SILVA (only NR);Eukaryota;Amorphea;Obazoa;Opisthokonta;Nucletmycea;Fungi;Dikarya;Ascomycota;Pezizomycotina;Sordariomycetes;Incertae Sedis;";"0.0";"0";"37";"37";"0";"37";"0";"457146";"391207"
"V4mis2";"SILVA (only NR);Eukaryota;Amorphea;Obazoa;Opisthokonta;Nucletmycea;Fungi;Dikarya;Ascomycota;Pezizomycotina;Sordariomycetes;Incertae Sedis;Calcarisporium;";"0.0";"0";"2";"2";"0";"2";"0";"457181";"391207"
"V4mis2";"SILVA (only NR);Eukaryota;Amorphea;Obazoa;Opisthokonta;Nucletmycea;Fungi;Dikarya;Ascomycota;Pezizomycotina;Sordariomycetes;Incertae Sedis;Etheirophoraceae;";"0.0";"0";"1";"1";"0";"1";"0";"457182";"391207"
"V4mis2";"SILVA (only NR);Eukaryota;Amorphea;Obazoa;Opisthokonta;Nucletmycea;Fungi;Dikarya;Ascomycota;Pezizomycotina;Sordariomycetes;Incertae Sedis;Etheirophoraceae;Etheirophora;";"0.0";"0";"1";"1";"0";"1";"0";"457182";"391207"
"V4mis2";"SILVA (only NR);Eukaryota;Amorphea;Obazoa;Opisthokonta;Nucletmycea;Fungi;Dikarya;Ascomycota;Pezizomycotina;Sordariomycetes;Incertae Sedis;Incertae Sedis;";"0.0";"0";"27";"27";"0";"27";"0";"457156";"391207"
"V4mis2";"SILVA (only NR);Eukaryota;Amorphea;Obazoa;Opisthokonta;Nucletmycea;Fungi;Dikarya;Ascomycota;Pezizomycotina;Sordariomycetes;Incertae Sedis;Incertae Sedis;Asteroma;";"0.0";"0";"1";"1";"0";"1";"0";"457182";"391207"
"V4mis2";"SILVA (only NR);Eukaryota;Amorphea;Obazoa;Opisthokonta;Nucletmycea;Fungi;Dikarya;Ascomycota;Pezizomycotina;Sordariomycetes;Incertae Sedis;Incertae Sedis;Atractospora;";"0.0";"0";"1";"1";"0";"1";"0";"457182";"391207"
"V4mis2";"SILVA (only NR);Eukaryota;Amorphea;Obazoa;Opisthokonta;Nucletmycea;Fungi;Dikarya;Ascomycota;Pezizomycotina;Sordariomycetes;Incertae Sedis;Incertae Sedis;Bahusakala;";"0.0";"0";"1";"1";"0";"1";"0";"457182";"391207"
"V4mis2";"SILVA (only NR);Eukaryota;Amorphea;Obazoa;Opisthokonta;Nucletmycea;Fungi;Dikarya;Ascomycota;Pezizomycotina;Sordariomycetes;Incertae Sedis;Incertae Sedis;Barbatosphaeria;";"0.0";"0";"2";"2";"0";"2";"0";"457181";"391207"
"V4mis2";"SILVA (only NR);Eukaryota;Amorphea;Obazoa;Opisthokonta;Nucletmycea;Fungi;Dikarya;Ascomycota;Pezizomycotina;Sordariomycetes;Incertae Sedis;Incertae Sedis;Canalisporium;";"0.0";"0";"2";"2";"0";"2";"0";"457181";"391207"
"V4mis2";"SILVA (only NR);Eukaryota;Amorphea;Obazoa;Opisthokonta;Nucletmycea;Fungi;Dikarya;Ascomycota;Pezizomycotina;Sordariomycetes;Incertae Sedis;Incertae Sedis;Ceratolenta;";"0.0";"0";"1";"1";"0";"1";"0";"457182";"391207"
"V4mis2";"SILVA (only NR);Eukaryota;Amorphea;Obazoa;Opisthokonta;Nucletmycea;Fungi;Dikarya;Ascomycota;Pezizomycotina;Sordariomycetes;Incertae Sedis;Incertae Sedis;Ceratostomella;";"0.0";"0";"2";"2";"0";"2";"0";"457181";"391207"
"V4mis2";"SILVA (only NR);Eukaryota;Amorphea;Obazoa;Opisthokonta;Nucletmycea;Fungi;Dikarya;Ascomycota;Pezizomycotina;Sordariomycetes;Incertae Sedis;Incertae Sedis;Flammispora;";"0.0";"0";"2";"2";"0";"2";"0";"457181";"391207"
"V4mis2";"SILVA (only NR);Eukaryota;Amorphea;Obazoa;Opisthokonta;Nucletmycea;Fungi;Dikarya;Ascomycota;Pezizomycotina;Sordariomycetes;Incertae Sedis;Incertae Sedis;Infundibulomyces;";"0.0";"0";"2";"2";"0";"2";"0";"457181";"391207"
"V4mis2";"SILVA (only NR);Eukaryota;Amorphea;Obazoa;Opisthokonta;Nucletmycea;Fungi;Dikarya;Ascomycota;Pezizomycotina;Sordariomycetes;Incertae Sedis;Incertae Sedis;Lentomitella;";"0.0";"0";"2";"2";"0";"2";"0";"457181";"391207"
"V4mis2";"SILVA (only NR);Eukaryota;Amorphea;Obazoa;Opisthokonta;Nucletmycea;Fungi;Dikarya;Ascomycota;Pezizomycotina;Sordariomycetes;Incertae Sedis;Incertae Sedis;Lunulospora;";"0.0";"0";"1";"1";"0";"1";"0";"457182";"391207"
"V4mis2";"SILVA (only NR);Eukaryota;Amorphea;Obazoa;Opisthokonta;Nucletmycea;Fungi;Dikarya;Ascomycota;Pezizomycotina;Sordariomycetes;Incertae Sedis;Incertae Sedis;Orbimyces;";"0.0";"0";"1";"1";"0";"1";"0";"457182";"391207"
"V4mis2";"SILVA (only NR);Eukaryota;Amorphea;Obazoa;Opisthokonta;Nucletmycea;Fungi;Dikarya;Ascomycota;Pezizomycotina;Sordariomycetes;Incertae Sedis;Incertae Sedis;Platytrachelon;";"0.0";"0";"1";"1";"0";"1";"0";"457182";"391207"
"V4mis2";"SILVA (only NR);Eukaryota;Amorphea;Obazoa;Opisthokonta;Nucletmycea;Fungi;Dikarya;Ascomycota;Pezizomycotina;Sordariomycetes;Incertae Sedis;Incertae Sedis;Rhodoveronaea;";"0.0";"0";"1";"1";"0";"1";"0";"457182";"391207"
"V4mis2";"SILVA (only NR);Eukaryota;Amorphea;Obazoa;Opisthokonta;Nucletmycea;Fungi;Dikarya;Ascomycota;Pezizomycotina;Sordariomycetes;Incertae Sedis;Incertae Sedis;Rubellisphaeria;";"0.0";"0";"1";"1";"0";"1";"0";"457182";"391207"
"V4mis2";"SILVA (only NR);Eukaryota;Amorphea;Obazoa;Opisthokonta;Nucletmycea;Fungi;Dikarya;Ascomycota;Pezizomycotina;Sordariomycetes;Incertae Sedis;Incertae Sedis;Woswasia;";"0.0";"0";"1";"1";"0";"1";"0";"457182";"391207"
"V4mis2";"SILVA (only NR);Eukaryota;Amorphea;Obazoa;Opisthokonta;Nucletmycea;Fungi;Dikarya;Ascomycota;Pezizomycotina;Sordariomycetes;Incertae Sedis;Incertae Sedis;Xylochrysis;";"0.0";"0";"1";"1";"0";"1";"0";"457182";"391207"
"V4mis2";"SILVA (only NR);Eukaryota;Amorphea;Obazoa;Opisthokonta;Nucletmycea;Fungi;Dikarya;Ascomycota;Pezizomycotina;Sordariomycetes;Incertae Sedis;Incertae Sedis;Xylomelasma;";"0.0";"0";"3";"3";"0";"3";"0";"457180";"391207"
"V4mis2";"SILVA (only NR);Eukaryota;Amorphea;Obazoa;Opisthokonta;Nucletmycea;Fungi;Dikarya;Ascomycota;Pezizomycotina;Sordariomycetes;Incertae Sedis;Papulosaceae;";"0.0";"0";"2";"2";"0";"2";"0";"457181";"391207"
"V4mis2";"SILVA (only NR);Eukaryota;Amorphea;Obazoa;Opisthokonta;Nucletmycea;Fungi;Dikarya;Ascomycota;Pezizomycotina;Sordariomycetes;Incertae Sedis;Papulosaceae;Papulosa;";"0.0";"0";"2";"2";"0";"2";"0";"457181";"391207"
"V4mis2";"SILVA (only NR);Eukaryota;Amorphea;Obazoa;Opisthokonta;Nucletmycea;Fungi;Dikarya;Ascomycota;Pezizomycotina;Sordariomycetes;Incertae Sedis;Thyridiaceae;";"0.0";"0";"1";"1";"0";"1";"0";"457182";"391207"
"V4mis2";"SILVA (only NR);Eukaryota;Amorphea;Obazoa;Opisthokonta;Nucletmycea;Fungi;Dikarya;Ascomycota;Pezizomycotina;Sordariomycetes;Incertae Sedis;Thyridiaceae;Thyridium;";"0.0";"0";"1";"1";"0";"1";"0";"457182";"391207"
"V4mis2";"SILVA (only NR);Eukaryota;Amorphea;Obazoa;Opisthokonta;Nucletmycea;Fungi;Dikarya;Ascomycota;Pezizomycotina;Sordariomycetes;Lulworthiales;";"0.0";"0";"23";"23";"0";"23";"0";"457160";"391207"
"V4mis2";"SILVA (only NR);Eukaryota;Amorphea;Obazoa;Opisthokonta;Nucletmycea;Fungi;Dikarya;Ascomycota;Pezizomycotina;Sordariomycetes;Lulworthiales;Lulworthiaceae;";"0.0";"0";"21";"21";"0";"21";"0";"457162";"391207"
"V4mis2";"SILVA (only NR);Eukaryota;Amorphea;Obazoa;Opisthokonta;Nucletmycea;Fungi;Dikarya;Ascomycota;Pezizomycotina;Sordariomycetes;Lulworthiales;Lulworthiaceae;Kohlmeyeriella;";"0.0";"0";"2";"2";"0";"2";"0";"457181";"391207"
"V4mis2";"SILVA (only NR);Eukaryota;Amorphea;Obazoa;Opisthokonta;Nucletmycea;Fungi;Dikarya;Ascomycota;Pezizomycotina;Sordariomycetes;Lulworthiales;Lulworthiaceae;Lindra;";"0.0";"0";"4";"4";"0";"4";"0";"457179";"391207"
"V4mis2";"SILVA (only NR);Eukaryota;Amorphea;Obazoa;Opisthokonta;Nucletmycea;Fungi;Dikarya;Ascomycota;Pezizomycotina;Sordariomycetes;Lulworthiales;Lulworthiaceae;Lulwoana;";"0.0";"0";"2";"2";"0";"2";"0";"457181";"391207"
"V4mis2";"SILVA (only NR);Eukaryota;Amorphea;Obazoa;Opisthokonta;Nucletmycea;Fungi;Dikarya;Ascomycota;Pezizomycotina;Sordariomycetes;Lulworthiales;Lulworthiaceae;Lulwoidea;";"0.0";"0";"3";"3";"0";"3";"0";"457180";"391207"
"V4mis2";"SILVA (only NR);Eukaryota;Amorphea;Obazoa;Opisthokonta;Nucletmycea;Fungi;Dikarya;Ascomycota;Pezizomycotina;Sordariomycetes;Lulworthiales;Lulworthiaceae;Lulworthia;";"0.0";"0";"8";"8";"0";"8";"0";"457175";"391207"
"V4mis2";"SILVA (only NR);Eukaryota;Amorphea;Obazoa;Opisthokonta;Nucletmycea;Fungi;Dikarya;Ascomycota;Pezizomycotina;Sordariomycetes;Lulworthiales;Spathulosporaceae;";"0.0";"0";"2";"2";"0";"2";"0";"457181";"391207"
"V4mis2";"SILVA (only NR);Eukaryota;Amorphea;Obazoa;Opisthokonta;Nucletmycea;Fungi;Dikarya;Ascomycota;Pezizomycotina;Sordariomycetes;Lulworthiales;Spathulosporaceae;Spathulospora;";"0.0";"0";"2";"2";"0";"2";"0";"457181";"391207"
"V4mis2";"SILVA (only NR);Eukaryota;Amorphea;Obazoa;Opisthokonta;Nucletmycea;Fungi;Dikarya;Ascomycota;Pezizomycotina;Sordariomycetes;Magnaporthales;";"0.0";"0";"6";"6";"0";"6";"0";"457177";"391207"
"V4mis2";"SILVA (only NR);Eukaryota;Amorphea;Obazoa;Opisthokonta;Nucletmycea;Fungi;Dikarya;Ascomycota;Pezizomycotina;Sordariomycetes;Magnaporthales;Magnaporthaceae;";"0.0";"0";"6";"6";"0";"6";"0";"457177";"391207"
"V4mis2";"SILVA (only NR);Eukaryota;Amorphea;Obazoa;Opisthokonta;Nucletmycea;Fungi;Dikarya;Ascomycota;Pezizomycotina;Sordariomycetes;Magnaporthales;Magnaporthaceae;Ceratosphaeria;";"0.0";"0";"1";"1";"0";"1";"0";"457182";"391207"
"V4mis2";"SILVA (only NR);Eukaryota;Amorphea;Obazoa;Opisthokonta;Nucletmycea;Fungi;Dikarya;Ascomycota;Pezizomycotina;Sordariomycetes;Magnaporthales;Magnaporthaceae;Kohlmeyeriopsis;";"0.0";"0";"1";"1";"0";"1";"0";"457182";"391207"
"V4mis2";"SILVA (only NR);Eukaryota;Amorphea;Obazoa;Opisthokonta;Nucletmycea;Fungi;Dikarya;Ascomycota;Pezizomycotina;Sordariomycetes;Magnaporthales;Magnaporthaceae;Magnaporthe;";"0.0";"0";"1";"1";"0";"1";"0";"457182";"391207"
"V4mis2";"SILVA (only NR);Eukaryota;Amorphea;Obazoa;Opisthokonta;Nucletmycea;Fungi;Dikarya;Ascomycota;Pezizomycotina;Sordariomycetes;Magnaporthales;Magnaporthaceae;Ophioceras;";"0.0";"0";"1";"1";"0";"1";"0";"457182";"391207"
"V4mis2";"SILVA (only NR);Eukaryota;Amorphea;Obazoa;Opisthokonta;Nucletmycea;Fungi;Dikarya;Ascomycota;Pezizomycotina;Sordariomycetes;Magnaporthales;Magnaporthaceae;Pseudohalonectria;";"0.0";"0";"1";"1";"0";"1";"0";"457182";"391207"
"V4mis2";"SILVA (only NR);Eukaryota;Amorphea;Obazoa;Opisthokonta;Nucletmycea;Fungi;Dikarya;Ascomycota;Pezizomycotina;Sordariomycetes;Meliolales;";"0.0";"0";"2";"2";"0";"2";"0";"457181";"391207"
"V4mis2";"SILVA (only NR);Eukaryota;Amorphea;Obazoa;Opisthokonta;Nucletmycea;Fungi;Dikarya;Ascomycota;Pezizomycotina;Sordariomycetes;Meliolales;Meliolaceae;";"0.0";"0";"2";"2";"0";"2";"0";"457181";"391207"
"V4mis2";"SILVA (only NR);Eukaryota;Amorphea;Obazoa;Opisthokonta;Nucletmycea;Fungi;Dikarya;Ascomycota;Pezizomycotina;Sordariomycetes;Meliolales;Meliolaceae;Meliola;";"0.0";"0";"2";"2";"0";"2";"0";"457181";"391207"
"V4mis2";"SILVA (only NR);Eukaryota;Amorphea;Obazoa;Opisthokonta;Nucletmycea;Fungi;Dikarya;Ascomycota;Pezizomycotina;Sordariomycetes;Microascales;";"1.2";"14.4";"83";"83";"1";"82";"0";"457100";"391206"
"V4mis2";"SILVA (only NR);Eukaryota;Amorphea;Obazoa;Opisthokonta;Nucletmycea;Fungi;Dikarya;Ascomycota;Pezizomycotina;Sordariomycetes;Microascales;Cephalotrichiella;";"0.0";"0";"1";"1";"0";"1";"0";"457182";"391207"
"V4mis2";"SILVA (only NR);Eukaryota;Amorphea;Obazoa;Opisthokonta;Nucletmycea;Fungi;Dikarya;Ascomycota;Pezizomycotina;Sordariomycetes;Microascales;Ceratocystidaceae;";"0.0";"0";"6";"6";"0";"6";"0";"457177";"391207"
"V4mis2";"SILVA (only NR);Eukaryota;Amorphea;Obazoa;Opisthokonta;Nucletmycea;Fungi;Dikarya;Ascomycota;Pezizomycotina;Sordariomycetes;Microascales;Ceratocystidaceae;Ambrosiella;";"0.0";"0";"2";"2";"0";"2";"0";"457181";"391207"
"V4mis2";"SILVA (only NR);Eukaryota;Amorphea;Obazoa;Opisthokonta;Nucletmycea;Fungi;Dikarya;Ascomycota;Pezizomycotina;Sordariomycetes;Microascales;Ceratocystidaceae;Ceratocystis;";"0.0";"0";"1";"1";"0";"1";"0";"457182";"391207"
"V4mis2";"SILVA (only NR);Eukaryota;Amorphea;Obazoa;Opisthokonta;Nucletmycea;Fungi;Dikarya;Ascomycota;Pezizomycotina;Sordariomycetes;Microascales;Ceratocystidaceae;Huntiella;";"0.0";"0";"1";"1";"0";"1";"0";"457182";"391207"
"V4mis2";"SILVA (only NR);Eukaryota;Amorphea;Obazoa;Opisthokonta;Nucletmycea;Fungi;Dikarya;Ascomycota;Pezizomycotina;Sordariomycetes;Microascales;Ceratocystidaceae;Phialophoropsis;";"0.0";"0";"1";"1";"0";"1";"0";"457182";"391207"
"V4mis2";"SILVA (only NR);Eukaryota;Amorphea;Obazoa;Opisthokonta;Nucletmycea;Fungi;Dikarya;Ascomycota;Pezizomycotina;Sordariomycetes;Microascales;Graphiaceae;";"0.0";"0";"14";"14";"0";"14";"0";"457169";"391207"
"V4mis2";"SILVA (only NR);Eukaryota;Amorphea;Obazoa;Opisthokonta;Nucletmycea;Fungi;Dikarya;Ascomycota;Pezizomycotina;Sordariomycetes;Microascales;Graphiaceae;Graphium;";"0.0";"0";"14";"14";"0";"14";"0";"457169";"391207"
"V4mis2";"SILVA (only NR);Eukaryota;Amorphea;Obazoa;Opisthokonta;Nucletmycea;Fungi;Dikarya;Ascomycota;Pezizomycotina;Sordariomycetes;Microascales;Halosphaeriaceae;";"0.0";"0";"32";"32";"0";"32";"0";"457151";"391207"
"V4mis2";"SILVA (only NR);Eukaryota;Amorphea;Obazoa;Opisthokonta;Nucletmycea;Fungi;Dikarya;Ascomycota;Pezizomycotina;Sordariomycetes;Microascales;Halosphaeriaceae;Cirrenalia;";"0.0";"0";"2";"2";"0";"2";"0";"457181";"391207"
"V4mis2";"SILVA (only NR);Eukaryota;Amorphea;Obazoa;Opisthokonta;Nucletmycea;Fungi;Dikarya;Ascomycota;Pezizomycotina;Sordariomycetes;Microascales;Halosphaeriaceae;Corollospora;";"0.0";"0";"12";"12";"0";"12";"0";"457171";"391207"
"V4mis2";"SILVA (only NR);Eukaryota;Amorphea;Obazoa;Opisthokonta;Nucletmycea;Fungi;Dikarya;Ascomycota;Pezizomycotina;Sordariomycetes;Microascales;Halosphaeriaceae;Halosarpheia;";"0.0";"0";"1";"1";"0";"1";"0";"457182";"391207"
"V4mis2";"SILVA (only NR);Eukaryota;Amorphea;Obazoa;Opisthokonta;Nucletmycea;Fungi;Dikarya;Ascomycota;Pezizomycotina;Sordariomycetes;Microascales;Halosphaeriaceae;Lignincola;";"0.0";"0";"1";"1";"0";"1";"0";"457182";"391207"
"V4mis2";"SILVA (only NR);Eukaryota;Amorphea;Obazoa;Opisthokonta;Nucletmycea;Fungi;Dikarya;Ascomycota;Pezizomycotina;Sordariomycetes;Microascales;Halosphaeriaceae;Magnisphaera;";"0.0";"0";"1";"1";"0";"1";"0";"457182";"391207"
"V4mis2";"SILVA (only NR);Eukaryota;Amorphea;Obazoa;Opisthokonta;Nucletmycea;Fungi;Dikarya;Ascomycota;Pezizomycotina;Sordariomycetes;Microascales;Halosphaeriaceae;Natantispora;";"0.0";"0";"3";"3";"0";"3";"0";"457180";"391207"
"V4mis2";"SILVA (only NR);Eukaryota;Amorphea;Obazoa;Opisthokonta;Nucletmycea;Fungi;Dikarya;Ascomycota;Pezizomycotina;Sordariomycetes;Microascales;Halosphaeriaceae;Oceanitis;";"0.0";"0";"1";"1";"0";"1";"0";"457182";"391207"
"V4mis2";"SILVA (only NR);Eukaryota;Amorphea;Obazoa;Opisthokonta;Nucletmycea;Fungi;Dikarya;Ascomycota;Pezizomycotina;Sordariomycetes;Microascales;Halosphaeriaceae;Panorbis;";"0.0";"0";"2";"2";"0";"2";"0";"457181";"391207"
"V4mis2";"SILVA (only NR);Eukaryota;Amorphea;Obazoa;Opisthokonta;Nucletmycea;Fungi;Dikarya;Ascomycota;Pezizomycotina;Sordariomycetes;Microascales;Halosphaeriaceae;Phaeonectriella;";"0.0";"0";"1";"1";"0";"1";"0";"457182";"391207"
"V4mis2";"SILVA (only NR);Eukaryota;Amorphea;Obazoa;Opisthokonta;Nucletmycea;Fungi;Dikarya;Ascomycota;Pezizomycotina;Sordariomycetes;Microascales;Halosphaeriaceae;Sigmoidea;";"0.0";"0";"1";"1";"0";"1";"0";"457182";"391207"
"V4mis2";"SILVA (only NR);Eukaryota;Amorphea;Obazoa;Opisthokonta;Nucletmycea;Fungi;Dikarya;Ascomycota;Pezizomycotina;Sordariomycetes;Microascales;Halosphaeriaceae;Trichocladium;";"0.0";"0";"1";"1";"0";"1";"0";"457182";"391207"
"V4mis2";"SILVA (only NR);Eukaryota;Amorphea;Obazoa;Opisthokonta;Nucletmycea;Fungi;Dikarya;Ascomycota;Pezizomycotina;Sordariomycetes;Microascales;Incertae Sedis;";"0.0";"0";"2";"2";"0";"2";"0";"457181";"391207"
"V4mis2";"SILVA (only NR);Eukaryota;Amorphea;Obazoa;Opisthokonta;Nucletmycea;Fungi;Dikarya;Ascomycota;Pezizomycotina;Sordariomycetes;Microascales;Incertae Sedis;Gabarnaudia;";"0.0";"0";"1";"1";"0";"1";"0";"457182";"391207"
"V4mis2";"SILVA (only NR);Eukaryota;Amorphea;Obazoa;Opisthokonta;Nucletmycea;Fungi;Dikarya;Ascomycota;Pezizomycotina;Sordariomycetes;Microascales;Incertae Sedis;Sphaeronaemella;";"0.0";"0";"1";"1";"0";"1";"0";"457182";"391207"
"V4mis2";"SILVA (only NR);Eukaryota;Amorphea;Obazoa;Opisthokonta;Nucletmycea;Fungi;Dikarya;Ascomycota;Pezizomycotina;Sordariomycetes;Microascales;Knoxdaviesia;";"0.0";"0";"1";"1";"0";"1";"0";"457182";"391207"
"V4mis2";"SILVA (only NR);Eukaryota;Amorphea;Obazoa;Opisthokonta;Nucletmycea;Fungi;Dikarya;Ascomycota;Pezizomycotina;Sordariomycetes;Microascales;Microascaceae;";"4.3";"14.4";"23";"23";"1";"22";"0";"457160";"391206"
"V4mis2";"SILVA (only NR);Eukaryota;Amorphea;Obazoa;Opisthokonta;Nucletmycea;Fungi;Dikarya;Ascomycota;Pezizomycotina;Sordariomycetes;Microascales;Microascaceae;Basipetospora;";"100.0";"14.4";"1";"1";"1";"0";"0";"457182";"391206"
"V4mis2";"SILVA (only NR);Eukaryota;Amorphea;Obazoa;Opisthokonta;Nucletmycea;Fungi;Dikarya;Ascomycota;Pezizomycotina;Sordariomycetes;Microascales;Microascaceae;Brachyconidiellopsis;";"0.0";"0";"1";"1";"0";"1";"0";"457182";"391207"
"V4mis2";"SILVA (only NR);Eukaryota;Amorphea;Obazoa;Opisthokonta;Nucletmycea;Fungi;Dikarya;Ascomycota;Pezizomycotina;Sordariomycetes;Microascales;Microascaceae;Doratomyces;";"0.0";"0";"2";"2";"0";"2";"0";"457181";"391207"
"V4mis2";"SILVA (only NR);Eukaryota;Amorphea;Obazoa;Opisthokonta;Nucletmycea;Fungi;Dikarya;Ascomycota;Pezizomycotina;Sordariomycetes;Microascales;Microascaceae;Lomentospora;";"0.0";"0";"2";"2";"0";"2";"0";"457181";"391207"
"V4mis2";"SILVA (only NR);Eukaryota;Amorphea;Obazoa;Opisthokonta;Nucletmycea;Fungi;Dikarya;Ascomycota;Pezizomycotina;Sordariomycetes;Microascales;Microascaceae;Microascus;";"0.0";"0";"3";"3";"0";"3";"0";"457180";"391207"
"V4mis2";"SILVA (only NR);Eukaryota;Amorphea;Obazoa;Opisthokonta;Nucletmycea;Fungi;Dikarya;Ascomycota;Pezizomycotina;Sordariomycetes;Microascales;Microascaceae;Parascedosporium;";"0.0";"0";"5";"5";"0";"5";"0";"457178";"391207"
"V4mis2";"SILVA (only NR);Eukaryota;Amorphea;Obazoa;Opisthokonta;Nucletmycea;Fungi;Dikarya;Ascomycota;Pezizomycotina;Sordariomycetes;Microascales;Microascaceae;Petriella;";"0.0";"0";"2";"2";"0";"2";"0";"457181";"391207"
"V4mis2";"SILVA (only NR);Eukaryota;Amorphea;Obazoa;Opisthokonta;Nucletmycea;Fungi;Dikarya;Ascomycota;Pezizomycotina;Sordariomycetes;Microascales;Microascaceae;Pseudallescheria;";"0.0";"0";"1";"1";"0";"1";"0";"457182";"391207"
"V4mis2";"SILVA (only NR);Eukaryota;Amorphea;Obazoa;Opisthokonta;Nucletmycea;Fungi;Dikarya;Ascomycota;Pezizomycotina;Sordariomycetes;Microascales;Microascaceae;Scedosporium;";"0.0";"0";"2";"2";"0";"2";"0";"457181";"391207"
"V4mis2";"SILVA (only NR);Eukaryota;Amorphea;Obazoa;Opisthokonta;Nucletmycea;Fungi;Dikarya;Ascomycota;Pezizomycotina;Sordariomycetes;Microascales;Microascaceae;Scopulariopsis;";"0.0";"0";"1";"1";"0";"1";"0";"457182";"391207"
"V4mis2";"SILVA (only NR);Eukaryota;Amorphea;Obazoa;Opisthokonta;Nucletmycea;Fungi;Dikarya;Ascomycota;Pezizomycotina;Sordariomycetes;Microascales;Tubakiella;";"0.0";"0";"1";"1";"0";"1";"0";"457182";"391207"
"V4mis2";"SILVA (only NR);Eukaryota;Amorphea;Obazoa;Opisthokonta;Nucletmycea;Fungi;Dikarya;Ascomycota;Pezizomycotina;Sordariomycetes;Microascales;uncultured;";"0.0";"0";"2";"2";"0";"2";"0";"457181";"391207"
"V4mis2";"SILVA (only NR);Eukaryota;Amorphea;Obazoa;Opisthokonta;Nucletmycea;Fungi;Dikarya;Ascomycota;Pezizomycotina;Sordariomycetes;Myrmecridiales;";"0.0";"0";"2";"2";"0";"2";"0";"457181";"391207"
"V4mis2";"SILVA (only NR);Eukaryota;Amorphea;Obazoa;Opisthokonta;Nucletmycea;Fungi;Dikarya;Ascomycota;Pezizomycotina;Sordariomycetes;Myrmecridiales;Myrmecridiaceae;";"0.0";"0";"2";"2";"0";"2";"0";"457181";"391207"
"V4mis2";"SILVA (only NR);Eukaryota;Amorphea;Obazoa;Opisthokonta;Nucletmycea;Fungi;Dikarya;Ascomycota;Pezizomycotina;Sordariomycetes;Myrmecridiales;Myrmecridiaceae;Myrmecridium;";"0.0";"0";"2";"2";"0";"2";"0";"457181";"391207"
"V4mis2";"SILVA (only NR);Eukaryota;Amorphea;Obazoa;Opisthokonta;Nucletmycea;Fungi;Dikarya;Ascomycota;Pezizomycotina;Sordariomycetes;Ophiostomatales;";"0.0";"0";"39";"39";"0";"39";"0";"457144";"391207"
"V4mis2";"SILVA (only NR);Eukaryota;Amorphea;Obazoa;Opisthokonta;Nucletmycea;Fungi;Dikarya;Ascomycota;Pezizomycotina;Sordariomycetes;Ophiostomatales;Ophiostomataceae;";"0.0";"0";"39";"39";"0";"39";"0";"457144";"391207"
"V4mis2";"SILVA (only NR);Eukaryota;Amorphea;Obazoa;Opisthokonta;Nucletmycea;Fungi;Dikarya;Ascomycota;Pezizomycotina;Sordariomycetes;Ophiostomatales;Ophiostomataceae;Ceratocystiopsis;";"0.0";"0";"4";"4";"0";"4";"0";"457179";"391207"
"V4mis2";"SILVA (only NR);Eukaryota;Amorphea;Obazoa;Opisthokonta;Nucletmycea;Fungi;Dikarya;Ascomycota;Pezizomycotina;Sordariomycetes;Ophiostomatales;Ophiostomataceae;Fragosphaeria;";"0.0";"0";"2";"2";"0";"2";"0";"457181";"391207"
"V4mis2";"SILVA (only NR);Eukaryota;Amorphea;Obazoa;Opisthokonta;Nucletmycea;Fungi;Dikarya;Ascomycota;Pezizomycotina;Sordariomycetes;Ophiostomatales;Ophiostomataceae;Graphilbum;";"0.0";"0";"1";"1";"0";"1";"0";"457182";"391207"
"V4mis2";"SILVA (only NR);Eukaryota;Amorphea;Obazoa;Opisthokonta;Nucletmycea;Fungi;Dikarya;Ascomycota;Pezizomycotina;Sordariomycetes;Ophiostomatales;Ophiostomataceae;Grosmannia;";"0.0";"0";"4";"4";"0";"4";"0";"457179";"391207"
"V4mis2";"SILVA (only NR);Eukaryota;Amorphea;Obazoa;Opisthokonta;Nucletmycea;Fungi;Dikarya;Ascomycota;Pezizomycotina;Sordariomycetes;Ophiostomatales;Ophiostomataceae;Leptographium;";"0.0";"0";"1";"1";"0";"1";"0";"457182";"391207"
"V4mis2";"SILVA (only NR);Eukaryota;Amorphea;Obazoa;Opisthokonta;Nucletmycea;Fungi;Dikarya;Ascomycota;Pezizomycotina;Sordariomycetes;Ophiostomatales;Ophiostomataceae;Ophiostoma;";"0.0";"0";"10";"10";"0";"10";"0";"457173";"391207"
"V4mis2";"SILVA (only NR);Eukaryota;Amorphea;Obazoa;Opisthokonta;Nucletmycea;Fungi;Dikarya;Ascomycota;Pezizomycotina;Sordariomycetes;Ophiostomatales;Ophiostomataceae;Pesotum;";"0.0";"0";"1";"1";"0";"1";"0";"457182";"391207"
"V4mis2";"SILVA (only NR);Eukaryota;Amorphea;Obazoa;Opisthokonta;Nucletmycea;Fungi;Dikarya;Ascomycota;Pezizomycotina;Sordariomycetes;Ophiostomatales;Ophiostomataceae;Raffaelea;";"0.0";"0";"11";"11";"0";"11";"0";"457172";"391207"
"V4mis2";"SILVA (only NR);Eukaryota;Amorphea;Obazoa;Opisthokonta;Nucletmycea;Fungi;Dikarya;Ascomycota;Pezizomycotina;Sordariomycetes;Ophiostomatales;Ophiostomataceae;Sporothrix;";"0.0";"0";"2";"2";"0";"2";"0";"457181";"391207"
"V4mis2";"SILVA (only NR);Eukaryota;Amorphea;Obazoa;Opisthokonta;Nucletmycea;Fungi;Dikarya;Ascomycota;Pezizomycotina;Sordariomycetes;Phomatosporaceae;";"0.0";"0";"1";"1";"0";"1";"0";"457182";"391207"
"V4mis2";"SILVA (only NR);Eukaryota;Amorphea;Obazoa;Opisthokonta;Nucletmycea;Fungi;Dikarya;Ascomycota;Pezizomycotina;Sordariomycetes;Phomatosporaceae;Lanspora;";"0.0";"0";"1";"1";"0";"1";"0";"457182";"391207"
"V4mis2";"SILVA (only NR);Eukaryota;Amorphea;Obazoa;Opisthokonta;Nucletmycea;Fungi;Dikarya;Ascomycota;Pezizomycotina;Sordariomycetes;Phyllachorales;";"0.0";"0";"2";"2";"0";"2";"0";"457181";"391207"
"V4mis2";"SILVA (only NR);Eukaryota;Amorphea;Obazoa;Opisthokonta;Nucletmycea;Fungi;Dikarya;Ascomycota;Pezizomycotina;Sordariomycetes;Phyllachorales;Phyllachoraceae;";"0.0";"0";"2";"2";"0";"2";"0";"457181";"391207"
"V4mis2";"SILVA (only NR);Eukaryota;Amorphea;Obazoa;Opisthokonta;Nucletmycea;Fungi;Dikarya;Ascomycota;Pezizomycotina;Sordariomycetes;Phyllachorales;Phyllachoraceae;Haloguignardia;";"0.0";"0";"1";"1";"0";"1";"0";"457182";"391207"
"V4mis2";"SILVA (only NR);Eukaryota;Amorphea;Obazoa;Opisthokonta;Nucletmycea;Fungi;Dikarya;Ascomycota;Pezizomycotina;Sordariomycetes;Phyllachorales;Phyllachoraceae;Phyllachora;";"0.0";"0";"1";"1";"0";"1";"0";"457182";"391207"
"V4mis2";"SILVA (only NR);Eukaryota;Amorphea;Obazoa;Opisthokonta;Nucletmycea;Fungi;Dikarya;Ascomycota;Pezizomycotina;Sordariomycetes;Pisorisporiales;";"0.0";"0";"1";"1";"0";"1";"0";"457182";"391207"
"V4mis2";"SILVA (only NR);Eukaryota;Amorphea;Obazoa;Opisthokonta;Nucletmycea;Fungi;Dikarya;Ascomycota;Pezizomycotina;Sordariomycetes;Pisorisporiales;Incertae Sedis;";"0.0";"0";"1";"1";"0";"1";"0";"457182";"391207"
"V4mis2";"SILVA (only NR);Eukaryota;Amorphea;Obazoa;Opisthokonta;Nucletmycea;Fungi;Dikarya;Ascomycota;Pezizomycotina;Sordariomycetes;Pisorisporiales;Incertae Sedis;Achroceratosphaeria;";"0.0";"0";"1";"1";"0";"1";"0";"457182";"391207"
"V4mis2";"SILVA (only NR);Eukaryota;Amorphea;Obazoa;Opisthokonta;Nucletmycea;Fungi;Dikarya;Ascomycota;Pezizomycotina;Sordariomycetes;Pleurotheciales;";"0.0";"0";"8";"8";"0";"8";"0";"457175";"391207"
"V4mis2";"SILVA (only NR);Eukaryota;Amorphea;Obazoa;Opisthokonta;Nucletmycea;Fungi;Dikarya;Ascomycota;Pezizomycotina;Sordariomycetes;Pleurotheciales;Pleurotheciaceae;";"0.0";"0";"8";"8";"0";"8";"0";"457175";"391207"
"V4mis2";"SILVA (only NR);Eukaryota;Amorphea;Obazoa;Opisthokonta;Nucletmycea;Fungi;Dikarya;Ascomycota;Pezizomycotina;Sordariomycetes;Pleurotheciales;Pleurotheciaceae;Parafuscospora;";"0.0";"0";"1";"1";"0";"1";"0";"457182";"391207"
"V4mis2";"SILVA (only NR);Eukaryota;Amorphea;Obazoa;Opisthokonta;Nucletmycea;Fungi;Dikarya;Ascomycota;Pezizomycotina;Sordariomycetes;Pleurotheciales;Pleurotheciaceae;Phaeoisaria;";"0.0";"0";"1";"1";"0";"1";"0";"457182";"391207"
"V4mis2";"SILVA (only NR);Eukaryota;Amorphea;Obazoa;Opisthokonta;Nucletmycea;Fungi;Dikarya;Ascomycota;Pezizomycotina;Sordariomycetes;Pleurotheciales;Pleurotheciaceae;Plagiascoma;";"0.0";"0";"1";"1";"0";"1";"0";"457182";"391207"
"V4mis2";"SILVA (only NR);Eukaryota;Amorphea;Obazoa;Opisthokonta;Nucletmycea;Fungi;Dikarya;Ascomycota;Pezizomycotina;Sordariomycetes;Pleurotheciales;Pleurotheciaceae;Pleurotheciella;";"0.0";"0";"1";"1";"0";"1";"0";"457182";"391207"
"V4mis2";"SILVA (only NR);Eukaryota;Amorphea;Obazoa;Opisthokonta;Nucletmycea;Fungi;Dikarya;Ascomycota;Pezizomycotina;Sordariomycetes;Pleurotheciales;Pleurotheciaceae;Pleurothecium;";"0.0";"0";"4";"4";"0";"4";"0";"457179";"391207"
"V4mis2";"SILVA (only NR);Eukaryota;Amorphea;Obazoa;Opisthokonta;Nucletmycea;Fungi;Dikarya;Ascomycota;Pezizomycotina;Sordariomycetes;Pontogeneia;";"0.0";"0";"1";"1";"0";"1";"0";"457182";"391207"
"V4mis2";"SILVA (only NR);Eukaryota;Amorphea;Obazoa;Opisthokonta;Nucletmycea;Fungi;Dikarya;Ascomycota;Pezizomycotina;Sordariomycetes;Savoryellales;";"0.0";"0";"10";"10";"0";"10";"0";"457173";"391207"
"V4mis2";"SILVA (only NR);Eukaryota;Amorphea;Obazoa;Opisthokonta;Nucletmycea;Fungi;Dikarya;Ascomycota;Pezizomycotina;Sordariomycetes;Savoryellales;Incertae Sedis;";"0.0";"0";"10";"10";"0";"10";"0";"457173";"391207"
"V4mis2";"SILVA (only NR);Eukaryota;Amorphea;Obazoa;Opisthokonta;Nucletmycea;Fungi;Dikarya;Ascomycota;Pezizomycotina;Sordariomycetes;Savoryellales;Incertae Sedis;Ascotaiwania;";"0.0";"0";"2";"2";"0";"2";"0";"457181";"391207"
"V4mis2";"SILVA (only NR);Eukaryota;Amorphea;Obazoa;Opisthokonta;Nucletmycea;Fungi;Dikarya;Ascomycota;Pezizomycotina;Sordariomycetes;Savoryellales;Incertae Sedis;Savoryella;";"0.0";"0";"8";"8";"0";"8";"0";"457175";"391207"
"V4mis2";"SILVA (only NR);Eukaryota;Amorphea;Obazoa;Opisthokonta;Nucletmycea;Fungi;Dikarya;Ascomycota;Pezizomycotina;Sordariomycetes;Sordariales;";"0.0";"0";"49";"49";"0";"49";"0";"457134";"391207"
"V4mis2";"SILVA (only NR);Eukaryota;Amorphea;Obazoa;Opisthokonta;Nucletmycea;Fungi;Dikarya;Ascomycota;Pezizomycotina;Sordariomycetes;Sordariales;Cephalothecaceae;";"0.0";"0";"8";"8";"0";"8";"0";"457175";"391207"
"V4mis2";"SILVA (only NR);Eukaryota;Amorphea;Obazoa;Opisthokonta;Nucletmycea;Fungi;Dikarya;Ascomycota;Pezizomycotina;Sordariomycetes;Sordariales;Cephalothecaceae;Albertiniella;";"0.0";"0";"2";"2";"0";"2";"0";"457181";"391207"
"V4mis2";"SILVA (only NR);Eukaryota;Amorphea;Obazoa;Opisthokonta;Nucletmycea;Fungi;Dikarya;Ascomycota;Pezizomycotina;Sordariomycetes;Sordariales;Cephalothecaceae;Cephalotheca;";"0.0";"0";"2";"2";"0";"2";"0";"457181";"391207"
"V4mis2";"SILVA (only NR);Eukaryota;Amorphea;Obazoa;Opisthokonta;Nucletmycea;Fungi;Dikarya;Ascomycota;Pezizomycotina;Sordariomycetes;Sordariales;Cephalothecaceae;Phialemonium;";"0.0";"0";"4";"4";"0";"4";"0";"457179";"391207"
"V4mis2";"SILVA (only NR);Eukaryota;Amorphea;Obazoa;Opisthokonta;Nucletmycea;Fungi;Dikarya;Ascomycota;Pezizomycotina;Sordariomycetes;Sordariales;Chaetomiaceae;";"0.0";"0";"25";"25";"0";"25";"0";"457158";"391207"
"V4mis2";"SILVA (only NR);Eukaryota;Amorphea;Obazoa;Opisthokonta;Nucletmycea;Fungi;Dikarya;Ascomycota;Pezizomycotina;Sordariomycetes;Sordariales;Chaetomiaceae;Chaetomium;";"0.0";"0";"17";"17";"0";"17";"0";"457166";"391207"
"V4mis2";"SILVA (only NR);Eukaryota;Amorphea;Obazoa;Opisthokonta;Nucletmycea;Fungi;Dikarya;Ascomycota;Pezizomycotina;Sordariomycetes;Sordariales;Chaetomiaceae;Corynascus;";"0.0";"0";"1";"1";"0";"1";"0";"457182";"391207"
"V4mis2";"SILVA (only NR);Eukaryota;Amorphea;Obazoa;Opisthokonta;Nucletmycea;Fungi;Dikarya;Ascomycota;Pezizomycotina;Sordariomycetes;Sordariales;Chaetomiaceae;Humicola;";"0.0";"0";"2";"2";"0";"2";"0";"457181";"391207"
"V4mis2";"SILVA (only NR);Eukaryota;Amorphea;Obazoa;Opisthokonta;Nucletmycea;Fungi;Dikarya;Ascomycota;Pezizomycotina;Sordariomycetes;Sordariales;Chaetomiaceae;Melanocarpus;";"0.0";"0";"1";"1";"0";"1";"0";"457182";"391207"
"V4mis2";"SILVA (only NR);Eukaryota;Amorphea;Obazoa;Opisthokonta;Nucletmycea;Fungi;Dikarya;Ascomycota;Pezizomycotina;Sordariomycetes;Sordariales;Chaetomiaceae;Remersonia;";"0.0";"0";"1";"1";"0";"1";"0";"457182";"391207"
"V4mis2";"SILVA (only NR);Eukaryota;Amorphea;Obazoa;Opisthokonta;Nucletmycea;Fungi;Dikarya;Ascomycota;Pezizomycotina;Sordariomycetes;Sordariales;Chaetomiaceae;Thielavia;";"0.0";"0";"1";"1";"0";"1";"0";"457182";"391207"
"V4mis2";"SILVA (only NR);Eukaryota;Amorphea;Obazoa;Opisthokonta;Nucletmycea;Fungi;Dikarya;Ascomycota;Pezizomycotina;Sordariomycetes;Sordariales;Incertae Sedis;";"0.0";"0";"4";"4";"0";"4";"0";"457179";"391207"
"V4mis2";"SILVA (only NR);Eukaryota;Amorphea;Obazoa;Opisthokonta;Nucletmycea;Fungi;Dikarya;Ascomycota;Pezizomycotina;Sordariomycetes;Sordariales;Incertae Sedis;Kionochaeta;";"0.0";"0";"4";"4";"0";"4";"0";"457179";"391207"
"V4mis2";"SILVA (only NR);Eukaryota;Amorphea;Obazoa;Opisthokonta;Nucletmycea;Fungi;Dikarya;Ascomycota;Pezizomycotina;Sordariomycetes;Sordariales;Lasiosphaeriaceae;";"0.0";"0";"3";"3";"0";"3";"0";"457180";"391207"
"V4mis2";"SILVA (only NR);Eukaryota;Amorphea;Obazoa;Opisthokonta;Nucletmycea;Fungi;Dikarya;Ascomycota;Pezizomycotina;Sordariomycetes;Sordariales;Lasiosphaeriaceae;Ascovaginospora;";"0.0";"0";"1";"1";"0";"1";"0";"457182";"391207"
"V4mis2";"SILVA (only NR);Eukaryota;Amorphea;Obazoa;Opisthokonta;Nucletmycea;Fungi;Dikarya;Ascomycota;Pezizomycotina;Sordariomycetes;Sordariales;Lasiosphaeriaceae;Podospora;";"0.0";"0";"2";"2";"0";"2";"0";"457181";"391207"
"V4mis2";"SILVA (only NR);Eukaryota;Amorphea;Obazoa;Opisthokonta;Nucletmycea;Fungi;Dikarya;Ascomycota;Pezizomycotina;Sordariomycetes;Sordariales;Sordariaceae;";"0.0";"0";"3";"3";"0";"3";"0";"457180";"391207"
"V4mis2";"SILVA (only NR);Eukaryota;Amorphea;Obazoa;Opisthokonta;Nucletmycea;Fungi;Dikarya;Ascomycota;Pezizomycotina;Sordariomycetes;Sordariales;Sordariaceae;Neurospora;";"0.0";"0";"2";"2";"0";"2";"0";"457181";"391207"
"V4mis2";"SILVA (only NR);Eukaryota;Amorphea;Obazoa;Opisthokonta;Nucletmycea;Fungi;Dikarya;Ascomycota;Pezizomycotina;Sordariomycetes;Sordariales;Sordariaceae;Sordaria;";"0.0";"0";"1";"1";"0";"1";"0";"457182";"391207"
"V4mis2";"SILVA (only NR);Eukaryota;Amorphea;Obazoa;Opisthokonta;Nucletmycea;Fungi;Dikarya;Ascomycota;Pezizomycotina;Sordariomycetes;Sordariales;uncultured;";"0.0";"0";"4";"4";"0";"4";"0";"457179";"391207"
"V4mis2";"SILVA (only NR);Eukaryota;Amorphea;Obazoa;Opisthokonta;Nucletmycea;Fungi;Dikarya;Ascomycota;Pezizomycotina;Sordariomycetes;Togniniales;";"0.0";"0";"10";"10";"0";"10";"0";"457173";"391207"
"V4mis2";"SILVA (only NR);Eukaryota;Amorphea;Obazoa;Opisthokonta;Nucletmycea;Fungi;Dikarya;Ascomycota;Pezizomycotina;Sordariomycetes;Togniniales;Togniniaceae;";"0.0";"0";"10";"10";"0";"10";"0";"457173";"391207"
"V4mis2";"SILVA (only NR);Eukaryota;Amorphea;Obazoa;Opisthokonta;Nucletmycea;Fungi;Dikarya;Ascomycota;Pezizomycotina;Sordariomycetes;Togniniales;Togniniaceae;Phaeoacremonium;";"0.0";"0";"10";"10";"0";"10";"0";"457173";"391207"
"V4mis2";"SILVA (only NR);Eukaryota;Amorphea;Obazoa;Opisthokonta;Nucletmycea;Fungi;Dikarya;Ascomycota;Pezizomycotina;Sordariomycetes;Torpedosporales;";"0.0";"0";"4";"4";"0";"4";"0";"457179";"391207"
"V4mis2";"SILVA (only NR);Eukaryota;Amorphea;Obazoa;Opisthokonta;Nucletmycea;Fungi;Dikarya;Ascomycota;Pezizomycotina;Sordariomycetes;Torpedosporales;Torpedosporaceae;";"0.0";"0";"4";"4";"0";"4";"0";"457179";"391207"
"V4mis2";"SILVA (only NR);Eukaryota;Amorphea;Obazoa;Opisthokonta;Nucletmycea;Fungi;Dikarya;Ascomycota;Pezizomycotina;Sordariomycetes;Torpedosporales;Torpedosporaceae;Torpedospora;";"0.0";"0";"4";"4";"0";"4";"0";"457179";"391207"
"V4mis2";"SILVA (only NR);Eukaryota;Amorphea;Obazoa;Opisthokonta;Nucletmycea;Fungi;Dikarya;Ascomycota;Pezizomycotina;Sordariomycetes;Xylariales;";"0.0";"0";"114";"114";"0";"114";"0";"457069";"391207"
"V4mis2";"SILVA (only NR);Eukaryota;Amorphea;Obazoa;Opisthokonta;Nucletmycea;Fungi;Dikarya;Ascomycota;Pezizomycotina;Sordariomycetes;Xylariales;Amphisphaeriaceae;";"0.0";"0";"4";"4";"0";"4";"0";"457179";"391207"
"V4mis2";"SILVA (only NR);Eukaryota;Amorphea;Obazoa;Opisthokonta;Nucletmycea;Fungi;Dikarya;Ascomycota;Pezizomycotina;Sordariomycetes;Xylariales;Amphisphaeriaceae;Amphisphaeria;";"0.0";"0";"2";"2";"0";"2";"0";"457181";"391207"
"V4mis2";"SILVA (only NR);Eukaryota;Amorphea;Obazoa;Opisthokonta;Nucletmycea;Fungi;Dikarya;Ascomycota;Pezizomycotina;Sordariomycetes;Xylariales;Amphisphaeriaceae;Pestalosphaeria;";"0.0";"0";"1";"1";"0";"1";"0";"457182";"391207"
"V4mis2";"SILVA (only NR);Eukaryota;Amorphea;Obazoa;Opisthokonta;Nucletmycea;Fungi;Dikarya;Ascomycota;Pezizomycotina;Sordariomycetes;Xylariales;Amphisphaeriaceae;Pestalotia;";"0.0";"0";"1";"1";"0";"1";"0";"457182";"391207"
"V4mis2";"SILVA (only NR);Eukaryota;Amorphea;Obazoa;Opisthokonta;Nucletmycea;Fungi;Dikarya;Ascomycota;Pezizomycotina;Sordariomycetes;Xylariales;Apiosporaceae;";"0.0";"0";"42";"42";"0";"42";"0";"457141";"391207"
"V4mis2";"SILVA (only NR);Eukaryota;Amorphea;Obazoa;Opisthokonta;Nucletmycea;Fungi;Dikarya;Ascomycota;Pezizomycotina;Sordariomycetes;Xylariales;Apiosporaceae;Arthrinium;";"0.0";"0";"42";"42";"0";"42";"0";"457141";"391207"
"V4mis2";"SILVA (only NR);Eukaryota;Amorphea;Obazoa;Opisthokonta;Nucletmycea;Fungi;Dikarya;Ascomycota;Pezizomycotina;Sordariomycetes;Xylariales;Cainia;";"0.0";"0";"1";"1";"0";"1";"0";"457182";"391207"
"V4mis2";"SILVA (only NR);Eukaryota;Amorphea;Obazoa;Opisthokonta;Nucletmycea;Fungi;Dikarya;Ascomycota;Pezizomycotina;Sordariomycetes;Xylariales;Circinotrichum;";"0.0";"0";"1";"1";"0";"1";"0";"457182";"391207"
"V4mis2";"SILVA (only NR);Eukaryota;Amorphea;Obazoa;Opisthokonta;Nucletmycea;Fungi;Dikarya;Ascomycota;Pezizomycotina;Sordariomycetes;Xylariales;Diatrypaceae;";"0.0";"0";"8";"8";"0";"8";"0";"457175";"391207"
"V4mis2";"SILVA (only NR);Eukaryota;Amorphea;Obazoa;Opisthokonta;Nucletmycea;Fungi;Dikarya;Ascomycota;Pezizomycotina;Sordariomycetes;Xylariales;Diatrypaceae;Cryptovalsa;";"0.0";"0";"1";"1";"0";"1";"0";"457182";"391207"
"V4mis2";"SILVA (only NR);Eukaryota;Amorphea;Obazoa;Opisthokonta;Nucletmycea;Fungi;Dikarya;Ascomycota;Pezizomycotina;Sordariomycetes;Xylariales;Diatrypaceae;Diatrype;";"0.0";"0";"2";"2";"0";"2";"0";"457181";"391207"
"V4mis2";"SILVA (only NR);Eukaryota;Amorphea;Obazoa;Opisthokonta;Nucletmycea;Fungi;Dikarya;Ascomycota;Pezizomycotina;Sordariomycetes;Xylariales;Diatrypaceae;Eutypa;";"0.0";"0";"1";"1";"0";"1";"0";"457182";"391207"
"V4mis2";"SILVA (only NR);Eukaryota;Amorphea;Obazoa;Opisthokonta;Nucletmycea;Fungi;Dikarya;Ascomycota;Pezizomycotina;Sordariomycetes;Xylariales;Diatrypaceae;Melanospora;";"0.0";"0";"2";"2";"0";"2";"0";"457181";"391207"
"V4mis2";"SILVA (only NR);Eukaryota;Amorphea;Obazoa;Opisthokonta;Nucletmycea;Fungi;Dikarya;Ascomycota;Pezizomycotina;Sordariomycetes;Xylariales;Diatrypaceae;Sphaerodes;";"0.0";"0";"1";"1";"0";"1";"0";"457182";"391207"
"V4mis2";"SILVA (only NR);Eukaryota;Amorphea;Obazoa;Opisthokonta;Nucletmycea;Fungi;Dikarya;Ascomycota;Pezizomycotina;Sordariomycetes;Xylariales;Diatrypasimilis;";"0.0";"0";"1";"1";"0";"1";"0";"457182";"391207"
"V4mis2";"SILVA (only NR);Eukaryota;Amorphea;Obazoa;Opisthokonta;Nucletmycea;Fungi;Dikarya;Ascomycota;Pezizomycotina;Sordariomycetes;Xylariales;Hyponectria;";"0.0";"0";"2";"2";"0";"2";"0";"457181";"391207"
"V4mis2";"SILVA (only NR);Eukaryota;Amorphea;Obazoa;Opisthokonta;Nucletmycea;Fungi;Dikarya;Ascomycota;Pezizomycotina;Sordariomycetes;Xylariales;Incertae Sedis;";"0.0";"0";"4";"4";"0";"4";"0";"457179";"391207"
"V4mis2";"SILVA (only NR);Eukaryota;Amorphea;Obazoa;Opisthokonta;Nucletmycea;Fungi;Dikarya;Ascomycota;Pezizomycotina;Sordariomycetes;Xylariales;Incertae Sedis;Dicyma;";"0.0";"0";"1";"1";"0";"1";"0";"457182";"391207"
"V4mis2";"SILVA (only NR);Eukaryota;Amorphea;Obazoa;Opisthokonta;Nucletmycea;Fungi;Dikarya;Ascomycota;Pezizomycotina;Sordariomycetes;Xylariales;Incertae Sedis;Phialemoniopsis;";"0.0";"0";"1";"1";"0";"1";"0";"457182";"391207"
"V4mis2";"SILVA (only NR);Eukaryota;Amorphea;Obazoa;Opisthokonta;Nucletmycea;Fungi;Dikarya;Ascomycota;Pezizomycotina;Sordariomycetes;Xylariales;Incertae Sedis;Surculiseries;";"0.0";"0";"2";"2";"0";"2";"0";"457181";"391207"
"V4mis2";"SILVA (only NR);Eukaryota;Amorphea;Obazoa;Opisthokonta;Nucletmycea;Fungi;Dikarya;Ascomycota;Pezizomycotina;Sordariomycetes;Xylariales;Liberomyces;";"0.0";"0";"1";"1";"0";"1";"0";"457182";"391207"
"V4mis2";"SILVA (only NR);Eukaryota;Amorphea;Obazoa;Opisthokonta;Nucletmycea;Fungi;Dikarya;Ascomycota;Pezizomycotina;Sordariomycetes;Xylariales;Sporocadaceae;";"0.0";"0";"5";"5";"0";"5";"0";"457178";"391207"
"V4mis2";"SILVA (only NR);Eukaryota;Amorphea;Obazoa;Opisthokonta;Nucletmycea;Fungi;Dikarya;Ascomycota;Pezizomycotina;Sordariomycetes;Xylariales;Sporocadaceae;Pestalotiopsis;";"0.0";"0";"2";"2";"0";"2";"0";"457181";"391207"
"V4mis2";"SILVA (only NR);Eukaryota;Amorphea;Obazoa;Opisthokonta;Nucletmycea;Fungi;Dikarya;Ascomycota;Pezizomycotina;Sordariomycetes;Xylariales;Sporocadaceae;Seiridium;";"0.0";"0";"2";"2";"0";"2";"0";"457181";"391207"
"V4mis2";"SILVA (only NR);Eukaryota;Amorphea;Obazoa;Opisthokonta;Nucletmycea;Fungi;Dikarya;Ascomycota;Pezizomycotina;Sordariomycetes;Xylariales;Sporocadaceae;Truncatella;";"0.0";"0";"1";"1";"0";"1";"0";"457182";"391207"
"V4mis2";"SILVA (only NR);Eukaryota;Amorphea;Obazoa;Opisthokonta;Nucletmycea;Fungi;Dikarya;Ascomycota;Pezizomycotina;Sordariomycetes;Xylariales;Xylariaceae;";"0.0";"0";"38";"38";"0";"38";"0";"457145";"391207"
"V4mis2";"SILVA (only NR);Eukaryota;Amorphea;Obazoa;Opisthokonta;Nucletmycea;Fungi;Dikarya;Ascomycota;Pezizomycotina;Sordariomycetes;Xylariales;Xylariaceae;Anthostomella;";"0.0";"0";"1";"1";"0";"1";"0";"457182";"391207"
"V4mis2";"SILVA (only NR);Eukaryota;Amorphea;Obazoa;Opisthokonta;Nucletmycea;Fungi;Dikarya;Ascomycota;Pezizomycotina;Sordariomycetes;Xylariales;Xylariaceae;Ascotricha;";"0.0";"0";"3";"3";"0";"3";"0";"457180";"391207"
"V4mis2";"SILVA (only NR);Eukaryota;Amorphea;Obazoa;Opisthokonta;Nucletmycea;Fungi;Dikarya;Ascomycota;Pezizomycotina;Sordariomycetes;Xylariales;Xylariaceae;Barrmaelia;";"0.0";"0";"1";"1";"0";"1";"0";"457182";"391207"
"V4mis2";"SILVA (only NR);Eukaryota;Amorphea;Obazoa;Opisthokonta;Nucletmycea;Fungi;Dikarya;Ascomycota;Pezizomycotina;Sordariomycetes;Xylariales;Xylariaceae;Biscogniauxia;";"0.0";"0";"1";"1";"0";"1";"0";"457182";"391207"
"V4mis2";"SILVA (only NR);Eukaryota;Amorphea;Obazoa;Opisthokonta;Nucletmycea;Fungi;Dikarya;Ascomycota;Pezizomycotina;Sordariomycetes;Xylariales;Xylariaceae;Geniculisynnema;";"0.0";"0";"1";"1";"0";"1";"0";"457182";"391207"
"V4mis2";"SILVA (only NR);Eukaryota;Amorphea;Obazoa;Opisthokonta;Nucletmycea;Fungi;Dikarya;Ascomycota;Pezizomycotina;Sordariomycetes;Xylariales;Xylariaceae;Hypoxylon;";"0.0";"0";"11";"11";"0";"11";"0";"457172";"391207"
"V4mis2";"SILVA (only NR);Eukaryota;Amorphea;Obazoa;Opisthokonta;Nucletmycea;Fungi;Dikarya;Ascomycota;Pezizomycotina;Sordariomycetes;Xylariales;Xylariaceae;Kretzschmaria;";"0.0";"0";"1";"1";"0";"1";"0";"457182";"391207"
"V4mis2";"SILVA (only NR);Eukaryota;Amorphea;Obazoa;Opisthokonta;Nucletmycea;Fungi;Dikarya;Ascomycota;Pezizomycotina;Sordariomycetes;Xylariales;Xylariaceae;Muscodor;";"0.0";"0";"4";"4";"0";"4";"0";"457179";"391207"
"V4mis2";"SILVA (only NR);Eukaryota;Amorphea;Obazoa;Opisthokonta;Nucletmycea;Fungi;Dikarya;Ascomycota;Pezizomycotina;Sordariomycetes;Xylariales;Xylariaceae;Rosellinia;";"0.0";"0";"1";"1";"0";"1";"0";"457182";"391207"
"V4mis2";"SILVA (only NR);Eukaryota;Amorphea;Obazoa;Opisthokonta;Nucletmycea;Fungi;Dikarya;Ascomycota;Pezizomycotina;Sordariomycetes;Xylariales;Xylariaceae;Xylaria;";"0.0";"0";"7";"7";"0";"7";"0";"457176";"391207"
"V4mis2";"SILVA (only NR);Eukaryota;Amorphea;Obazoa;Opisthokonta;Nucletmycea;Fungi;Dikarya;Ascomycota;Pezizomycotina;Sordariomycetes;Xylariales;Xylariaceae;artificial;";"0.0";"0";"1";"1";"0";"1";"0";"457182";"391207"
"V4mis2";"SILVA (only NR);Eukaryota;Amorphea;Obazoa;Opisthokonta;Nucletmycea;Fungi;Dikarya;Ascomycota;Pezizomycotina;Sordariomycetes;uncultured;";"0.0";"0";"6";"6";"0";"6";"0";"457177";"391207"
"V4mis2";"SILVA (only NR);Eukaryota;Amorphea;Obazoa;Opisthokonta;Nucletmycea;Fungi;Dikarya;Ascomycota;Pezizomycotina;Xylobotryomycetes;";"0.0";"0";"3";"3";"0";"3";"0";"457180";"391207"
"V4mis2";"SILVA (only NR);Eukaryota;Amorphea;Obazoa;Opisthokonta;Nucletmycea;Fungi;Dikarya;Ascomycota;Pezizomycotina;Xylobotryomycetes;Xylobotryales;";"0.0";"0";"3";"3";"0";"3";"0";"457180";"391207"
"V4mis2";"SILVA (only NR);Eukaryota;Amorphea;Obazoa;Opisthokonta;Nucletmycea;Fungi;Dikarya;Ascomycota;Pezizomycotina;Xylobotryomycetes;Xylobotryales;Cirrosporium;";"0.0";"0";"1";"1";"0";"1";"0";"457182";"391207"
"V4mis2";"SILVA (only NR);Eukaryota;Amorphea;Obazoa;Opisthokonta;Nucletmycea;Fungi;Dikarya;Ascomycota;Pezizomycotina;Xylobotryomycetes;Xylobotryales;Xylobotryum;";"0.0";"0";"1";"1";"0";"1";"0";"457182";"391207"
"V4mis2";"SILVA (only NR);Eukaryota;Amorphea;Obazoa;Opisthokonta;Nucletmycea;Fungi;Dikarya;Ascomycota;Pezizomycotina;Xylonomycetes;";"0.0";"0";"5";"5";"0";"5";"0";"457178";"391207"
"V4mis2";"SILVA (only NR);Eukaryota;Amorphea;Obazoa;Opisthokonta;Nucletmycea;Fungi;Dikarya;Ascomycota;Pezizomycotina;Xylonomycetes;Incertae Sedis;";"0.0";"0";"4";"4";"0";"4";"0";"457179";"391207"
"V4mis2";"SILVA (only NR);Eukaryota;Amorphea;Obazoa;Opisthokonta;Nucletmycea;Fungi;Dikarya;Ascomycota;Pezizomycotina;Xylonomycetes;Incertae Sedis;Incertae Sedis;";"0.0";"0";"4";"4";"0";"4";"0";"457179";"391207"
"V4mis2";"SILVA (only NR);Eukaryota;Amorphea;Obazoa;Opisthokonta;Nucletmycea;Fungi;Dikarya;Ascomycota;Pezizomycotina;Xylonomycetes;Incertae Sedis;Incertae Sedis;Symbiotaphrina;";"0.0";"0";"4";"4";"0";"4";"0";"457179";"391207"
"V4mis2";"SILVA (only NR);Eukaryota;Amorphea;Obazoa;Opisthokonta;Nucletmycea;Fungi;Dikarya;Ascomycota;Pezizomycotina;Xylonomycetes;Xylonomycetales;";"0.0";"0";"1";"1";"0";"1";"0";"457182";"391207"
"V4mis2";"SILVA (only NR);Eukaryota;Amorphea;Obazoa;Opisthokonta;Nucletmycea;Fungi;Dikarya;Ascomycota;Pezizomycotina;Xylonomycetes;Xylonomycetales;Xylonomycetaceae;";"0.0";"0";"1";"1";"0";"1";"0";"457182";"391207"
"V4mis2";"SILVA (only NR);Eukaryota;Amorphea;Obazoa;Opisthokonta;Nucletmycea;Fungi;Dikarya;Ascomycota;Pezizomycotina;Xylonomycetes;Xylonomycetales;Xylonomycetaceae;Xylona;";"0.0";"0";"1";"1";"0";"1";"0";"457182";"391207"
"V4mis2";"SILVA (only NR);Eukaryota;Amorphea;Obazoa;Opisthokonta;Nucletmycea;Fungi;Dikarya;Ascomycota;Pezizomycotina;uncultured;";"0.0";"0";"8";"7";"0";"7";"1";"457176";"391207"
"V4mis2";"SILVA (only NR);Eukaryota;Amorphea;Obazoa;Opisthokonta;Nucletmycea;Fungi;Dikarya;Ascomycota;Saccharomycotina;";"1.6";"14.2";"1418";"1416";"23";"1393";"2";"455767";"391184"
"V4mis2";"SILVA (only NR);Eukaryota;Amorphea;Obazoa;Opisthokonta;Nucletmycea;Fungi;Dikarya;Ascomycota;Saccharomycotina;Saccharomycetes;";"1.6";"14.2";"1418";"1416";"23";"1393";"2";"455767";"391184"
"V4mis2";"SILVA (only NR);Eukaryota;Amorphea;Obazoa;Opisthokonta;Nucletmycea;Fungi;Dikarya;Ascomycota;Saccharomycotina;Saccharomycetes;Saccharomycetales;";"1.6";"14.2";"1418";"1416";"23";"1393";"2";"455767";"391184"
"V4mis2";"SILVA (only NR);Eukaryota;Amorphea;Obazoa;Opisthokonta;Nucletmycea;Fungi;Dikarya;Ascomycota;Saccharomycotina;Saccharomycetes;Saccharomycetales;Alloascoideaceae;";"0.0";"0";"2";"2";"0";"2";"0";"457181";"391207"
"V4mis2";"SILVA (only NR);Eukaryota;Amorphea;Obazoa;Opisthokonta;Nucletmycea;Fungi;Dikarya;Ascomycota;Saccharomycotina;Saccharomycetes;Saccharomycetales;Alloascoideaceae;Alloascoidea;";"0.0";"0";"2";"2";"0";"2";"0";"457181";"391207"
"V4mis2";"SILVA (only NR);Eukaryota;Amorphea;Obazoa;Opisthokonta;Nucletmycea;Fungi;Dikarya;Ascomycota;Saccharomycotina;Saccharomycetes;Saccharomycetales;Ascoideaceae;";"0.0";"0";"4";"4";"0";"4";"0";"457179";"391207"
"V4mis2";"SILVA (only NR);Eukaryota;Amorphea;Obazoa;Opisthokonta;Nucletmycea;Fungi;Dikarya;Ascomycota;Saccharomycotina;Saccharomycetes;Saccharomycetales;Ascoideaceae;Ascoidea;";"0.0";"0";"2";"2";"0";"2";"0";"457181";"391207"
"V4mis2";"SILVA (only NR);Eukaryota;Amorphea;Obazoa;Opisthokonta;Nucletmycea;Fungi;Dikarya;Ascomycota;Saccharomycotina;Saccharomycetes;Saccharomycetales;Candida;";"0.0";"0";"4";"4";"0";"4";"0";"457179";"391207"
"V4mis2";"SILVA (only NR);Eukaryota;Amorphea;Obazoa;Opisthokonta;Nucletmycea;Fungi;Dikarya;Ascomycota;Saccharomycotina;Saccharomycetes;Saccharomycetales;Cephaloascus;";"0.0";"0";"1";"1";"0";"1";"0";"457182";"391207"
"V4mis2";"SILVA (only NR);Eukaryota;Amorphea;Obazoa;Opisthokonta;Nucletmycea;Fungi;Dikarya;Ascomycota;Saccharomycotina;Saccharomycetes;Saccharomycetales;Debaryomycetaceae;";"2.6";"14.4";"314";"312";"8";"304";"2";"456871";"391199"
"V4mis2";"SILVA (only NR);Eukaryota;Amorphea;Obazoa;Opisthokonta;Nucletmycea;Fungi;Dikarya;Ascomycota;Saccharomycotina;Saccharomycetes;Saccharomycetales;Debaryomycetaceae;Babjeviella;";"0.0";"0";"3";"3";"0";"3";"0";"457180";"391207"
"V4mis2";"SILVA (only NR);Eukaryota;Amorphea;Obazoa;Opisthokonta;Nucletmycea;Fungi;Dikarya;Ascomycota;Saccharomycotina;Saccharomycetes;Saccharomycetales;Debaryomycetaceae;Candida glaebosa clade;";"0.0";"0";"13";"13";"0";"13";"0";"457170";"391207"
"V4mis2";"SILVA (only NR);Eukaryota;Amorphea;Obazoa;Opisthokonta;Nucletmycea;Fungi;Dikarya;Ascomycota;Saccharomycotina;Saccharomycetes;Saccharomycetales;Debaryomycetaceae;Candida kruisii clade;";"0.0";"0";"5";"5";"0";"5";"0";"457178";"391207"
"V4mis2";"SILVA (only NR);Eukaryota;Amorphea;Obazoa;Opisthokonta;Nucletmycea;Fungi;Dikarya;Ascomycota;Saccharomycotina;Saccharomycetes;Saccharomycetales;Debaryomycetaceae;Candida tanzawaensis clade;";"0.0";"0";"9";"9";"0";"9";"0";"457174";"391207"
"V4mis2";"SILVA (only NR);Eukaryota;Amorphea;Obazoa;Opisthokonta;Nucletmycea;Fungi;Dikarya;Ascomycota;Saccharomycotina;Saccharomycetes;Saccharomycetales;Debaryomycetaceae;Candida-Lodderomyces clade;";"10.8";"14.4";"65";"65";"7";"58";"0";"457118";"391200"
"V4mis2";"SILVA (only NR);Eukaryota;Amorphea;Obazoa;Opisthokonta;Nucletmycea;Fungi;Dikarya;Ascomycota;Saccharomycotina;Saccharomycetes;Saccharomycetales;Debaryomycetaceae;Debaryomyces;";"0.0";"0";"38";"36";"0";"36";"2";"457147";"391207"
"V4mis2";"SILVA (only NR);Eukaryota;Amorphea;Obazoa;Opisthokonta;Nucletmycea;Fungi;Dikarya;Ascomycota;Saccharomycotina;Saccharomycetes;Saccharomycetales;Debaryomycetaceae;Hypopichia-Candida clade;";"0.0";"0";"13";"13";"0";"13";"0";"457170";"391207"
"V4mis2";"SILVA (only NR);Eukaryota;Amorphea;Obazoa;Opisthokonta;Nucletmycea;Fungi;Dikarya;Ascomycota;Saccharomycotina;Saccharomycetes;Saccharomycetales;Debaryomycetaceae;Kurtzmaniella-Candida clade;";"0.0";"0";"24";"24";"0";"24";"0";"457159";"391207"
"V4mis2";"SILVA (only NR);Eukaryota;Amorphea;Obazoa;Opisthokonta;Nucletmycea;Fungi;Dikarya;Ascomycota;Saccharomycotina;Saccharomycetes;Saccharomycetales;Debaryomycetaceae;Meyerozyma-Candida clade;";"2.9";"14.4";"34";"34";"1";"33";"0";"457149";"391206"
"V4mis2";"SILVA (only NR);Eukaryota;Amorphea;Obazoa;Opisthokonta;Nucletmycea;Fungi;Dikarya;Ascomycota;Saccharomycotina;Saccharomycetes;Saccharomycetales;Debaryomycetaceae;Millerozyma;";"0.0";"0";"4";"4";"0";"4";"0";"457179";"391207"
"V4mis2";"SILVA (only NR);Eukaryota;Amorphea;Obazoa;Opisthokonta;Nucletmycea;Fungi;Dikarya;Ascomycota;Saccharomycotina;Saccharomycetes;Saccharomycetales;Debaryomycetaceae;Peterozyma;";"0.0";"0";"2";"2";"0";"2";"0";"457181";"391207"
"V4mis2";"SILVA (only NR);Eukaryota;Amorphea;Obazoa;Opisthokonta;Nucletmycea;Fungi;Dikarya;Ascomycota;Saccharomycotina;Saccharomycetes;Saccharomycetales;Debaryomycetaceae;Priceomyces;";"0.0";"0";"8";"8";"0";"8";"0";"457175";"391207"
"V4mis2";"SILVA (only NR);Eukaryota;Amorphea;Obazoa;Opisthokonta;Nucletmycea;Fungi;Dikarya;Ascomycota;Saccharomycotina;Saccharomycetes;Saccharomycetales;Debaryomycetaceae;Scheffersomyces;";"0.0";"0";"34";"34";"0";"34";"0";"457149";"391207"
"V4mis2";"SILVA (only NR);Eukaryota;Amorphea;Obazoa;Opisthokonta;Nucletmycea;Fungi;Dikarya;Ascomycota;Saccharomycotina;Saccharomycetes;Saccharomycetales;Debaryomycetaceae;Schwanniomyces;";"0.0";"0";"12";"12";"0";"12";"0";"457171";"391207"
"V4mis2";"SILVA (only NR);Eukaryota;Amorphea;Obazoa;Opisthokonta;Nucletmycea;Fungi;Dikarya;Ascomycota;Saccharomycotina;Saccharomycetes;Saccharomycetales;Debaryomycetaceae;Spathospora;";"0.0";"0";"6";"6";"0";"6";"0";"457177";"391207"
"V4mis2";"SILVA (only NR);Eukaryota;Amorphea;Obazoa;Opisthokonta;Nucletmycea;Fungi;Dikarya;Ascomycota;Saccharomycotina;Saccharomycetes;Saccharomycetales;Debaryomycetaceae;Yamadazyma-Candida clade;";"0.0";"0";"44";"44";"0";"44";"0";"457139";"391207"
"V4mis2";"SILVA (only NR);Eukaryota;Amorphea;Obazoa;Opisthokonta;Nucletmycea;Fungi;Dikarya;Ascomycota;Saccharomycotina;Saccharomycetes;Saccharomycetales;Dipodascaceae;";"1.7";"14.4";"60";"60";"1";"59";"0";"457123";"391206"
"V4mis2";"SILVA (only NR);Eukaryota;Amorphea;Obazoa;Opisthokonta;Nucletmycea;Fungi;Dikarya;Ascomycota;Saccharomycotina;Saccharomycetes;Saccharomycetales;Dipodascaceae;Dipodascus;";"0.0";"0";"10";"10";"0";"10";"0";"457173";"391207"
"V4mis2";"SILVA (only NR);Eukaryota;Amorphea;Obazoa;Opisthokonta;Nucletmycea;Fungi;Dikarya;Ascomycota;Saccharomycotina;Saccharomycetes;Saccharomycetales;Dipodascaceae;Galactomyces;";"0.0";"0";"5";"5";"0";"5";"0";"457178";"391207"
"V4mis2";"SILVA (only NR);Eukaryota;Amorphea;Obazoa;Opisthokonta;Nucletmycea;Fungi;Dikarya;Ascomycota;Saccharomycotina;Saccharomycetes;Saccharomycetales;Dipodascaceae;Geotrichum;";"0.0";"0";"13";"13";"0";"13";"0";"457170";"391207"
"V4mis2";"SILVA (only NR);Eukaryota;Amorphea;Obazoa;Opisthokonta;Nucletmycea;Fungi;Dikarya;Ascomycota;Saccharomycotina;Saccharomycetes;Saccharomycetales;Dipodascaceae;Magnusiomyces;";"0.0";"0";"8";"8";"0";"8";"0";"457175";"391207"
"V4mis2";"SILVA (only NR);Eukaryota;Amorphea;Obazoa;Opisthokonta;Nucletmycea;Fungi;Dikarya;Ascomycota;Saccharomycotina;Saccharomycetes;Saccharomycetales;Dipodascaceae;Saprochaete;";"0.0";"0";"4";"4";"0";"4";"0";"457179";"391207"
"V4mis2";"SILVA (only NR);Eukaryota;Amorphea;Obazoa;Opisthokonta;Nucletmycea;Fungi;Dikarya;Ascomycota;Saccharomycotina;Saccharomycetes;Saccharomycetales;Dipodascaceae;Yarrowia;";"5.0";"14.4";"20";"20";"1";"19";"0";"457163";"391206"
"V4mis2";"SILVA (only NR);Eukaryota;Amorphea;Obazoa;Opisthokonta;Nucletmycea;Fungi;Dikarya;Ascomycota;Saccharomycotina;Saccharomycetes;Saccharomycetales;Endomycetaceae;";"0.0";"0";"2";"2";"0";"2";"0";"457181";"391207"
"V4mis2";"SILVA (only NR);Eukaryota;Amorphea;Obazoa;Opisthokonta;Nucletmycea;Fungi;Dikarya;Ascomycota;Saccharomycotina;Saccharomycetes;Saccharomycetales;Endomycetaceae;Endomyces;";"0.0";"0";"2";"2";"0";"2";"0";"457181";"391207"
"V4mis2";"SILVA (only NR);Eukaryota;Amorphea;Obazoa;Opisthokonta;Nucletmycea;Fungi;Dikarya;Ascomycota;Saccharomycotina;Saccharomycetes;Saccharomycetales;Incertae Sedis;";"6.0";"14.4";"116";"116";"7";"109";"0";"457067";"391200"
"V4mis2";"SILVA (only NR);Eukaryota;Amorphea;Obazoa;Opisthokonta;Nucletmycea;Fungi;Dikarya;Ascomycota;Saccharomycotina;Saccharomycetes;Saccharomycetales;Incertae Sedis;Ambrosiozyma;";"0.0";"0";"16";"16";"0";"16";"0";"457167";"391207"
"V4mis2";"SILVA (only NR);Eukaryota;Amorphea;Obazoa;Opisthokonta;Nucletmycea;Fungi;Dikarya;Ascomycota;Saccharomycotina;Saccharomycetes;Saccharomycetales;Incertae Sedis;Candida;";"13.2";"14.4";"53";"53";"7";"46";"0";"457130";"391200"
"V4mis2";"SILVA (only NR);Eukaryota;Amorphea;Obazoa;Opisthokonta;Nucletmycea;Fungi;Dikarya;Ascomycota;Saccharomycotina;Saccharomycetes;Saccharomycetales;Incertae Sedis;Kuraishia;";"0.0";"0";"10";"10";"0";"10";"0";"457173";"391207"
"V4mis2";"SILVA (only NR);Eukaryota;Amorphea;Obazoa;Opisthokonta;Nucletmycea;Fungi;Dikarya;Ascomycota;Saccharomycotina;Saccharomycetes;Saccharomycetales;Incertae Sedis;Middelhovenomyces;";"0.0";"0";"8";"8";"0";"8";"0";"457175";"391207"
"V4mis2";"SILVA (only NR);Eukaryota;Amorphea;Obazoa;Opisthokonta;Nucletmycea;Fungi;Dikarya;Ascomycota;Saccharomycotina;Saccharomycetes;Saccharomycetales;Incertae Sedis;Nadsonia;";"0.0";"0";"2";"2";"0";"2";"0";"457181";"391207"
"V4mis2";"SILVA (only NR);Eukaryota;Amorphea;Obazoa;Opisthokonta;Nucletmycea;Fungi;Dikarya;Ascomycota;Saccharomycotina;Saccharomycetes;Saccharomycetales;Incertae Sedis;Starmerella-Candida clade;";"0.0";"0";"27";"27";"0";"27";"0";"457156";"391207"
"V4mis2";"SILVA (only NR);Eukaryota;Amorphea;Obazoa;Opisthokonta;Nucletmycea;Fungi;Dikarya;Ascomycota;Saccharomycotina;Saccharomycetes;Saccharomycetales;Lipomycetaceae;";"3.2";"14.4";"31";"31";"1";"30";"0";"457152";"391206"
"V4mis2";"SILVA (only NR);Eukaryota;Amorphea;Obazoa;Opisthokonta;Nucletmycea;Fungi;Dikarya;Ascomycota;Saccharomycotina;Saccharomycetes;Saccharomycetales;Lipomycetaceae;Dipodascopsis;";"0.0";"0";"4";"4";"0";"4";"0";"457179";"391207"
"V4mis2";"SILVA (only NR);Eukaryota;Amorphea;Obazoa;Opisthokonta;Nucletmycea;Fungi;Dikarya;Ascomycota;Saccharomycotina;Saccharomycetes;Saccharomycetales;Lipomycetaceae;Lipomyces;";"6.7";"14.4";"15";"15";"1";"14";"0";"457168";"391206"
"V4mis2";"SILVA (only NR);Eukaryota;Amorphea;Obazoa;Opisthokonta;Nucletmycea;Fungi;Dikarya;Ascomycota;Saccharomycotina;Saccharomycetes;Saccharomycetales;Lipomycetaceae;Myxozyma;";"0.0";"0";"12";"12";"0";"12";"0";"457171";"391207"
"V4mis2";"SILVA (only NR);Eukaryota;Amorphea;Obazoa;Opisthokonta;Nucletmycea;Fungi;Dikarya;Ascomycota;Saccharomycotina;Saccharomycetes;Saccharomycetales;Metschnikowiaceae;";"0.0";"0";"94";"94";"0";"94";"0";"457089";"391207"
"V4mis2";"SILVA (only NR);Eukaryota;Amorphea;Obazoa;Opisthokonta;Nucletmycea;Fungi;Dikarya;Ascomycota;Saccharomycotina;Saccharomycetes;Saccharomycetales;Metschnikowiaceae;Aciculoconidium;";"0.0";"0";"1";"1";"0";"1";"0";"457182";"391207"
"V4mis2";"SILVA (only NR);Eukaryota;Amorphea;Obazoa;Opisthokonta;Nucletmycea;Fungi;Dikarya;Ascomycota;Saccharomycotina;Saccharomycetes;Saccharomycetales;Metschnikowiaceae;Clavispora-Candida clade;";"0.0";"0";"38";"38";"0";"38";"0";"457145";"391207"
"V4mis2";"SILVA (only NR);Eukaryota;Amorphea;Obazoa;Opisthokonta;Nucletmycea;Fungi;Dikarya;Ascomycota;Saccharomycotina;Saccharomycetes;Saccharomycetales;Metschnikowiaceae;Danielozyma;";"0.0";"0";"2";"2";"0";"2";"0";"457181";"391207"
"V4mis2";"SILVA (only NR);Eukaryota;Amorphea;Obazoa;Opisthokonta;Nucletmycea;Fungi;Dikarya;Ascomycota;Saccharomycotina;Saccharomycetes;Saccharomycetales;Metschnikowiaceae;Kodamaea-Candida clade;";"0.0";"0";"6";"6";"0";"6";"0";"457177";"391207"
"V4mis2";"SILVA (only NR);Eukaryota;Amorphea;Obazoa;Opisthokonta;Nucletmycea;Fungi;Dikarya;Ascomycota;Saccharomycotina;Saccharomycetes;Saccharomycetales;Metschnikowiaceae;Kodamaea;";"0.0";"0";"7";"7";"0";"7";"0";"457176";"391207"
"V4mis2";"SILVA (only NR);Eukaryota;Amorphea;Obazoa;Opisthokonta;Nucletmycea;Fungi;Dikarya;Ascomycota;Saccharomycotina;Saccharomycetes;Saccharomycetales;Metschnikowiaceae;Metschnikowia;";"0.0";"0";"38";"38";"0";"38";"0";"457145";"391207"
"V4mis2";"SILVA (only NR);Eukaryota;Amorphea;Obazoa;Opisthokonta;Nucletmycea;Fungi;Dikarya;Ascomycota;Saccharomycotina;Saccharomycetes;Saccharomycetales;Phaffomycetaceae;";"0.6";"14.4";"168";"168";"1";"167";"0";"457015";"391206"
"V4mis2";"SILVA (only NR);Eukaryota;Amorphea;Obazoa;Opisthokonta;Nucletmycea;Fungi;Dikarya;Ascomycota;Saccharomycotina;Saccharomycetes;Saccharomycetales;Phaffomycetaceae;Barnettozyma-Candida clade;";"0.0";"0";"14";"14";"0";"14";"0";"457169";"391207"
"V4mis2";"SILVA (only NR);Eukaryota;Amorphea;Obazoa;Opisthokonta;Nucletmycea;Fungi;Dikarya;Ascomycota;Saccharomycotina;Saccharomycetes;Saccharomycetales;Phaffomycetaceae;Cyberlindnera-Candida clade;";"0.0";"0";"43";"43";"0";"43";"0";"457140";"391207"
"V4mis2";"SILVA (only NR);Eukaryota;Amorphea;Obazoa;Opisthokonta;Nucletmycea;Fungi;Dikarya;Ascomycota;Saccharomycotina;Saccharomycetes;Saccharomycetales;Phaffomycetaceae;Cyberlindnera;";"0.0";"0";"2";"2";"0";"2";"0";"457181";"391207"
"V4mis2";"SILVA (only NR);Eukaryota;Amorphea;Obazoa;Opisthokonta;Nucletmycea;Fungi;Dikarya;Ascomycota;Saccharomycotina;Saccharomycetes;Saccharomycetales;Phaffomycetaceae;Deakozyma;";"0.0";"0";"1";"1";"0";"1";"0";"457182";"391207"
"V4mis2";"SILVA (only NR);Eukaryota;Amorphea;Obazoa;Opisthokonta;Nucletmycea;Fungi;Dikarya;Ascomycota;Saccharomycotina;Saccharomycetes;Saccharomycetales;Phaffomycetaceae;Komagataella;";"0.0";"0";"21";"21";"0";"21";"0";"457162";"391207"
"V4mis2";"SILVA (only NR);Eukaryota;Amorphea;Obazoa;Opisthokonta;Nucletmycea;Fungi;Dikarya;Ascomycota;Saccharomycotina;Saccharomycetes;Saccharomycetales;Phaffomycetaceae;Phaffomyces;";"0.0";"0";"11";"11";"0";"11";"0";"457172";"391207"
"V4mis2";"SILVA (only NR);Eukaryota;Amorphea;Obazoa;Opisthokonta;Nucletmycea;Fungi;Dikarya;Ascomycota;Saccharomycotina;Saccharomycetes;Saccharomycetales;Phaffomycetaceae;Starmera-Candida clade;";"0.0";"0";"14";"14";"0";"14";"0";"457169";"391207"
"V4mis2";"SILVA (only NR);Eukaryota;Amorphea;Obazoa;Opisthokonta;Nucletmycea;Fungi;Dikarya;Ascomycota;Saccharomycotina;Saccharomycetes;Saccharomycetales;Phaffomycetaceae;Starmera;";"0.0";"0";"1";"1";"0";"1";"0";"457182";"391207"
"V4mis2";"SILVA (only NR);Eukaryota;Amorphea;Obazoa;Opisthokonta;Nucletmycea;Fungi;Dikarya;Ascomycota;Saccharomycotina;Saccharomycetes;Saccharomycetales;Phaffomycetaceae;Wickerhamomyces-Candida clade;";"0.0";"0";"37";"37";"0";"37";"0";"457146";"391207"
"V4mis2";"SILVA (only NR);Eukaryota;Amorphea;Obazoa;Opisthokonta;Nucletmycea;Fungi;Dikarya;Ascomycota;Saccharomycotina;Saccharomycetes;Saccharomycetales;Phaffomycetaceae;Wickerhamomyces;";"0.0";"0";"18";"18";"0";"18";"0";"457165";"391207"
"V4mis2";"SILVA (only NR);Eukaryota;Amorphea;Obazoa;Opisthokonta;Nucletmycea;Fungi;Dikarya;Ascomycota;Saccharomycotina;Saccharomycetes;Saccharomycetales;Pichiaceae;";"0.0";"0";"219";"219";"0";"219";"0";"456964";"391207"
"V4mis2";"SILVA (only NR);Eukaryota;Amorphea;Obazoa;Opisthokonta;Nucletmycea;Fungi;Dikarya;Ascomycota;Saccharomycotina;Saccharomycetes;Saccharomycetales;Pichiaceae;Brettanomyces;";"0.0";"0";"19";"19";"0";"19";"0";"457164";"391207"
"V4mis2";"SILVA (only NR);Eukaryota;Amorphea;Obazoa;Opisthokonta;Nucletmycea;Fungi;Dikarya;Ascomycota;Saccharomycotina;Saccharomycetes;Saccharomycetales;Pichiaceae;Kregervanrija;";"0.0";"0";"4";"4";"0";"4";"0";"457179";"391207"
"V4mis2";"SILVA (only NR);Eukaryota;Amorphea;Obazoa;Opisthokonta;Nucletmycea;Fungi;Dikarya;Ascomycota;Saccharomycotina;Saccharomycetes;Saccharomycetales;Pichiaceae;Martiniozyma;";"0.0";"0";"4";"4";"0";"4";"0";"457179";"391207"
"V4mis2";"SILVA (only NR);Eukaryota;Amorphea;Obazoa;Opisthokonta;Nucletmycea;Fungi;Dikarya;Ascomycota;Saccharomycotina;Saccharomycetes;Saccharomycetales;Pichiaceae;Nakazawaea;";"0.0";"0";"22";"22";"0";"22";"0";"457161";"391207"
"V4mis2";"SILVA (only NR);Eukaryota;Amorphea;Obazoa;Opisthokonta;Nucletmycea;Fungi;Dikarya;Ascomycota;Saccharomycotina;Saccharomycetes;Saccharomycetales;Pichiaceae;Ogataea-Candida clade;";"0.0";"0";"72";"72";"0";"72";"0";"457111";"391207"
"V4mis2";"SILVA (only NR);Eukaryota;Amorphea;Obazoa;Opisthokonta;Nucletmycea;Fungi;Dikarya;Ascomycota;Saccharomycotina;Saccharomycetes;Saccharomycetales;Pichiaceae;Pichia;";"0.0";"0";"77";"77";"0";"77";"0";"457106";"391207"
"V4mis2";"SILVA (only NR);Eukaryota;Amorphea;Obazoa;Opisthokonta;Nucletmycea;Fungi;Dikarya;Ascomycota;Saccharomycotina;Saccharomycetes;Saccharomycetales;Pichiaceae;Saturnispora;";"0.0";"0";"19";"19";"0";"19";"0";"457164";"391207"
"V4mis2";"SILVA (only NR);Eukaryota;Amorphea;Obazoa;Opisthokonta;Nucletmycea;Fungi;Dikarya;Ascomycota;Saccharomycotina;Saccharomycetes;Saccharomycetales;Saccharomycetaceae;";"0.0";"0";"268";"268";"0";"268";"0";"456915";"391207"
"V4mis2";"SILVA (only NR);Eukaryota;Amorphea;Obazoa;Opisthokonta;Nucletmycea;Fungi;Dikarya;Ascomycota;Saccharomycotina;Saccharomycetes;Saccharomycetales;Saccharomycetaceae;Citeromyces;";"0.0";"0";"9";"9";"0";"9";"0";"457174";"391207"
"V4mis2";"SILVA (only NR);Eukaryota;Amorphea;Obazoa;Opisthokonta;Nucletmycea;Fungi;Dikarya;Ascomycota;Saccharomycotina;Saccharomycetes;Saccharomycetales;Saccharomycetaceae;Cyniclomyces;";"0.0";"0";"1";"1";"0";"1";"0";"457182";"391207"
"V4mis2";"SILVA (only NR);Eukaryota;Amorphea;Obazoa;Opisthokonta;Nucletmycea;Fungi;Dikarya;Ascomycota;Saccharomycotina;Saccharomycetes;Saccharomycetales;Saccharomycetaceae;Eremothecium;";"0.0";"0";"13";"13";"0";"13";"0";"457170";"391207"
"V4mis2";"SILVA (only NR);Eukaryota;Amorphea;Obazoa;Opisthokonta;Nucletmycea;Fungi;Dikarya;Ascomycota;Saccharomycotina;Saccharomycetes;Saccharomycetales;Saccharomycetaceae;Hagleromyces;";"0.0";"0";"1";"1";"0";"1";"0";"457182";"391207"
"V4mis2";"SILVA (only NR);Eukaryota;Amorphea;Obazoa;Opisthokonta;Nucletmycea;Fungi;Dikarya;Ascomycota;Saccharomycotina;Saccharomycetes;Saccharomycetales;Saccharomycetaceae;Issatchenkia;";"0.0";"0";"2";"2";"0";"2";"0";"457181";"391207"
"V4mis2";"SILVA (only NR);Eukaryota;Amorphea;Obazoa;Opisthokonta;Nucletmycea;Fungi;Dikarya;Ascomycota;Saccharomycotina;Saccharomycetes;Saccharomycetales;Saccharomycetaceae;Kazachstania-Candida clade;";"0.0";"0";"29";"29";"0";"29";"0";"457154";"391207"
"V4mis2";"SILVA (only NR);Eukaryota;Amorphea;Obazoa;Opisthokonta;Nucletmycea;Fungi;Dikarya;Ascomycota;Saccharomycotina;Saccharomycetes;Saccharomycetales;Saccharomycetaceae;Kazachstania;";"0.0";"0";"35";"35";"0";"35";"0";"457148";"391207"
"V4mis2";"SILVA (only NR);Eukaryota;Amorphea;Obazoa;Opisthokonta;Nucletmycea;Fungi;Dikarya;Ascomycota;Saccharomycotina;Saccharomycetes;Saccharomycetales;Saccharomycetaceae;Kluyveromyces;";"0.0";"0";"23";"23";"0";"23";"0";"457160";"391207"
"V4mis2";"SILVA (only NR);Eukaryota;Amorphea;Obazoa;Opisthokonta;Nucletmycea;Fungi;Dikarya;Ascomycota;Saccharomycotina;Saccharomycetes;Saccharomycetales;Saccharomycetaceae;Lachancea;";"0.0";"0";"16";"16";"0";"16";"0";"457167";"391207"
"V4mis2";"SILVA (only NR);Eukaryota;Amorphea;Obazoa;Opisthokonta;Nucletmycea;Fungi;Dikarya;Ascomycota;Saccharomycotina;Saccharomycetes;Saccharomycetales;Saccharomycetaceae;Macrorhabdus;";"0.0";"0";"1";"1";"0";"1";"0";"457182";"391207"
"V4mis2";"SILVA (only NR);Eukaryota;Amorphea;Obazoa;Opisthokonta;Nucletmycea;Fungi;Dikarya;Ascomycota;Saccharomycotina;Saccharomycetes;Saccharomycetales;Saccharomycetaceae;Nakaseomyces-Candida clade;";"0.0";"0";"9";"9";"0";"9";"0";"457174";"391207"
"V4mis2";"SILVA (only NR);Eukaryota;Amorphea;Obazoa;Opisthokonta;Nucletmycea;Fungi;Dikarya;Ascomycota;Saccharomycotina;Saccharomycetes;Saccharomycetales;Saccharomycetaceae;Nakaseomyces;";"0.0";"0";"1";"1";"0";"1";"0";"457182";"391207"
"V4mis2";"SILVA (only NR);Eukaryota;Amorphea;Obazoa;Opisthokonta;Nucletmycea;Fungi;Dikarya;Ascomycota;Saccharomycotina;Saccharomycetes;Saccharomycetales;Saccharomycetaceae;Naumovozyma;";"0.0";"0";"6";"6";"0";"6";"0";"457177";"391207"
"V4mis2";"SILVA (only NR);Eukaryota;Amorphea;Obazoa;Opisthokonta;Nucletmycea;Fungi;Dikarya;Ascomycota;Saccharomycotina;Saccharomycetes;Saccharomycetales;Saccharomycetaceae;Pachysolen;";"0.0";"0";"3";"3";"0";"3";"0";"457180";"391207"
"V4mis2";"SILVA (only NR);Eukaryota;Amorphea;Obazoa;Opisthokonta;Nucletmycea;Fungi;Dikarya;Ascomycota;Saccharomycotina;Saccharomycetes;Saccharomycetales;Saccharomycetaceae;Saccharomyces;";"0.0";"0";"49";"49";"0";"49";"0";"457134";"391207"
"V4mis2";"SILVA (only NR);Eukaryota;Amorphea;Obazoa;Opisthokonta;Nucletmycea;Fungi;Dikarya;Ascomycota;Saccharomycotina;Saccharomycetes;Saccharomycetales;Saccharomycetaceae;Tetrapisispora;";"0.0";"0";"15";"15";"0";"15";"0";"457168";"391207"
"V4mis2";"SILVA (only NR);Eukaryota;Amorphea;Obazoa;Opisthokonta;Nucletmycea;Fungi;Dikarya;Ascomycota;Saccharomycotina;Saccharomycetes;Saccharomycetales;Saccharomycetaceae;Torulaspora;";"0.0";"0";"12";"12";"0";"12";"0";"457171";"391207"
"V4mis2";"SILVA (only NR);Eukaryota;Amorphea;Obazoa;Opisthokonta;Nucletmycea;Fungi;Dikarya;Ascomycota;Saccharomycotina;Saccharomycetes;Saccharomycetales;Saccharomycetaceae;Vanderwaltozyma;";"0.0";"0";"11";"11";"0";"11";"0";"457172";"391207"
"V4mis2";"SILVA (only NR);Eukaryota;Amorphea;Obazoa;Opisthokonta;Nucletmycea;Fungi;Dikarya;Ascomycota;Saccharomycotina;Saccharomycetes;Saccharomycetales;Saccharomycetaceae;Yueomyces;";"0.0";"0";"4";"4";"0";"4";"0";"457179";"391207"
"V4mis2";"SILVA (only NR);Eukaryota;Amorphea;Obazoa;Opisthokonta;Nucletmycea;Fungi;Dikarya;Ascomycota;Saccharomycotina;Saccharomycetes;Saccharomycetales;Saccharomycetaceae;Zygosaccharomyces;";"0.0";"0";"26";"26";"0";"26";"0";"457157";"391207"
"V4mis2";"SILVA (only NR);Eukaryota;Amorphea;Obazoa;Opisthokonta;Nucletmycea;Fungi;Dikarya;Ascomycota;Saccharomycotina;Saccharomycetes;Saccharomycetales;Saccharomycetaceae;Zygotorulaspora;";"0.0";"0";"2";"2";"0";"2";"0";"457181";"391207"
"V4mis2";"SILVA (only NR);Eukaryota;Amorphea;Obazoa;Opisthokonta;Nucletmycea;Fungi;Dikarya;Ascomycota;Saccharomycotina;Saccharomycetes;Saccharomycetales;Saccharomycodaceae;";"0.0";"0";"16";"16";"0";"16";"0";"457167";"391207"
"V4mis2";"SILVA (only NR);Eukaryota;Amorphea;Obazoa;Opisthokonta;Nucletmycea;Fungi;Dikarya;Ascomycota;Saccharomycotina;Saccharomycetes;Saccharomycetales;Saccharomycodaceae;Hanseniaspora;";"0.0";"0";"12";"12";"0";"12";"0";"457171";"391207"
"V4mis2";"SILVA (only NR);Eukaryota;Amorphea;Obazoa;Opisthokonta;Nucletmycea;Fungi;Dikarya;Ascomycota;Saccharomycotina;Saccharomycetes;Saccharomycetales;Saccharomycodaceae;Saccharomycodes;";"0.0";"0";"4";"4";"0";"4";"0";"457179";"391207"
"V4mis2";"SILVA (only NR);Eukaryota;Amorphea;Obazoa;Opisthokonta;Nucletmycea;Fungi;Dikarya;Ascomycota;Saccharomycotina;Saccharomycetes;Saccharomycetales;Saccharomycopsidaceae;";"0.0";"0";"25";"25";"0";"25";"0";"457158";"391207"
"V4mis2";"SILVA (only NR);Eukaryota;Amorphea;Obazoa;Opisthokonta;Nucletmycea;Fungi;Dikarya;Ascomycota;Saccharomycotina;Saccharomycetes;Saccharomycetales;Saccharomycopsidaceae;Saccharomycopsis;";"0.0";"0";"25";"25";"0";"25";"0";"457158";"391207"
"V4mis2";"SILVA (only NR);Eukaryota;Amorphea;Obazoa;Opisthokonta;Nucletmycea;Fungi;Dikarya;Ascomycota;Saccharomycotina;Saccharomycetes;Saccharomycetales;Sporopachydermia;";"0.0";"0";"1";"1";"0";"1";"0";"457182";"391207"
"V4mis2";"SILVA (only NR);Eukaryota;Amorphea;Obazoa;Opisthokonta;Nucletmycea;Fungi;Dikarya;Ascomycota;Saccharomycotina;Saccharomycetes;Saccharomycetales;Trichomonascaceae;";"3.8";"14.4";"79";"79";"3";"76";"0";"457104";"391204"
"V4mis2";"SILVA (only NR);Eukaryota;Amorphea;Obazoa;Opisthokonta;Nucletmycea;Fungi;Dikarya;Ascomycota;Saccharomycotina;Saccharomycetes;Saccharomycetales;Trichomonascaceae;BG02-7-13-27C-2-1;";"0.0";"0";"2";"2";"0";"2";"0";"457181";"391207"
"V4mis2";"SILVA (only NR);Eukaryota;Amorphea;Obazoa;Opisthokonta;Nucletmycea;Fungi;Dikarya;Ascomycota;Saccharomycotina;Saccharomycetes;Saccharomycetales;Trichomonascaceae;Blastobotrys;";"0.0";"0";"5";"5";"0";"5";"0";"457178";"391207"
"V4mis2";"SILVA (only NR);Eukaryota;Amorphea;Obazoa;Opisthokonta;Nucletmycea;Fungi;Dikarya;Ascomycota;Saccharomycotina;Saccharomycetes;Saccharomycetales;Trichomonascaceae;JCM8259;";"0.0";"0";"6";"6";"0";"6";"0";"457177";"391207"
"V4mis2";"SILVA (only NR);Eukaryota;Amorphea;Obazoa;Opisthokonta;Nucletmycea;Fungi;Dikarya;Ascomycota;Saccharomycotina;Saccharomycetes;Saccharomycetales;Trichomonascaceae;Spencermartinsiella;";"0.0";"0";"7";"7";"0";"7";"0";"457176";"391207"
"V4mis2";"SILVA (only NR);Eukaryota;Amorphea;Obazoa;Opisthokonta;Nucletmycea;Fungi;Dikarya;Ascomycota;Saccharomycotina;Saccharomycetes;Saccharomycetales;Trichomonascaceae;Sugiyamaella;";"0.0";"0";"19";"19";"0";"19";"0";"457164";"391207"
"V4mis2";"SILVA (only NR);Eukaryota;Amorphea;Obazoa;Opisthokonta;Nucletmycea;Fungi;Dikarya;Ascomycota;Saccharomycotina;Saccharomycetes;Saccharomycetales;Trichomonascaceae;Trichomonascus;";"0.0";"0";"18";"18";"0";"18";"0";"457165";"391207"
"V4mis2";"SILVA (only NR);Eukaryota;Amorphea;Obazoa;Opisthokonta;Nucletmycea;Fungi;Dikarya;Ascomycota;Saccharomycotina;Saccharomycetes;Saccharomycetales;Trichomonascaceae;Wicherhamiella-Candida clade;";"17.6";"14.4";"17";"17";"3";"14";"0";"457166";"391204"
"V4mis2";"SILVA (only NR);Eukaryota;Amorphea;Obazoa;Opisthokonta;Nucletmycea;Fungi;Dikarya;Ascomycota;Saccharomycotina;Saccharomycetes;Saccharomycetales;Trichomonascaceae;Zygoascus-Candida clade;";"0.0";"0";"5";"5";"0";"5";"0";"457178";"391207"
"V4mis2";"SILVA (only NR);Eukaryota;Amorphea;Obazoa;Opisthokonta;Nucletmycea;Fungi;Dikarya;Ascomycota;Saccharomycotina;Saccharomycetes;Saccharomycetales;Trigonopsidaceae;";"20.0";"14.4";"5";"5";"1";"4";"0";"457178";"391206"
"V4mis2";"SILVA (only NR);Eukaryota;Amorphea;Obazoa;Opisthokonta;Nucletmycea;Fungi;Dikarya;Ascomycota;Saccharomycotina;Saccharomycetes;Saccharomycetales;Trigonopsidaceae;Botryozyma;";"0.0";"0";"1";"1";"0";"1";"0";"457182";"391207"
"V4mis2";"SILVA (only NR);Eukaryota;Amorphea;Obazoa;Opisthokonta;Nucletmycea;Fungi;Dikarya;Ascomycota;Saccharomycotina;Saccharomycetes;Saccharomycetales;Trigonopsidaceae;Tortispora;";"100.0";"14.4";"1";"1";"1";"0";"0";"457182";"391206"
"V4mis2";"SILVA (only NR);Eukaryota;Amorphea;Obazoa;Opisthokonta;Nucletmycea;Fungi;Dikarya;Ascomycota;Saccharomycotina;Saccharomycetes;Saccharomycetales;Trigonopsidaceae;Trigonopsis;";"0.0";"0";"3";"3";"0";"3";"0";"457180";"391207"
"V4mis2";"SILVA (only NR);Eukaryota;Amorphea;Obazoa;Opisthokonta;Nucletmycea;Fungi;Dikarya;Ascomycota;Saccharomycotina;Saccharomycetes;Saccharomycetales;Wickerhamia;";"0.0";"0";"1";"1";"0";"1";"0";"457182";"391207"
"V4mis2";"SILVA (only NR);Eukaryota;Amorphea;Obazoa;Opisthokonta;Nucletmycea;Fungi;Dikarya;Ascomycota;Taphrinomycotina;";"7.5";"14.4";"68";"67";"5";"62";"1";"457116";"391202"
"V4mis2";"SILVA (only NR);Eukaryota;Amorphea;Obazoa;Opisthokonta;Nucletmycea;Fungi;Dikarya;Ascomycota;Taphrinomycotina;Archaeorhizomycetes;";"66.7";"14.4";"3";"3";"2";"1";"0";"457180";"391205"
"V4mis2";"SILVA (only NR);Eukaryota;Amorphea;Obazoa;Opisthokonta;Nucletmycea;Fungi;Dikarya;Ascomycota;Taphrinomycotina;Archaeorhizomycetes;Archaeorhizomycetales;";"66.7";"14.4";"3";"3";"2";"1";"0";"457180";"391205"
"V4mis2";"SILVA (only NR);Eukaryota;Amorphea;Obazoa;Opisthokonta;Nucletmycea;Fungi;Dikarya;Ascomycota;Taphrinomycotina;Archaeorhizomycetes;Archaeorhizomycetales;Archaeorhizomycetaceae;";"66.7";"14.4";"3";"3";"2";"1";"0";"457180";"391205"
"V4mis2";"SILVA (only NR);Eukaryota;Amorphea;Obazoa;Opisthokonta;Nucletmycea;Fungi;Dikarya;Ascomycota;Taphrinomycotina;Archaeorhizomycetes;Archaeorhizomycetales;Archaeorhizomycetaceae;Archaeorhizomyces;";"66.7";"14.4";"3";"3";"2";"1";"0";"457180";"391205"
"V4mis2";"SILVA (only NR);Eukaryota;Amorphea;Obazoa;Opisthokonta;Nucletmycea;Fungi;Dikarya;Ascomycota;Taphrinomycotina;Incertae Sedis;";"100.0";"14.4";"3";"3";"3";"0";"0";"457180";"391204"
"V4mis2";"SILVA (only NR);Eukaryota;Amorphea;Obazoa;Opisthokonta;Nucletmycea;Fungi;Dikarya;Ascomycota;Taphrinomycotina;Incertae Sedis;Incertae Sedis;";"100.0";"14.4";"3";"3";"3";"0";"0";"457180";"391204"
"V4mis2";"SILVA (only NR);Eukaryota;Amorphea;Obazoa;Opisthokonta;Nucletmycea;Fungi;Dikarya;Ascomycota;Taphrinomycotina;Incertae Sedis;Incertae Sedis;Incertae Sedis;";"100.0";"14.4";"3";"3";"3";"0";"0";"457180";"391204"
"V4mis2";"SILVA (only NR);Eukaryota;Amorphea;Obazoa;Opisthokonta;Nucletmycea;Fungi;Dikarya;Ascomycota;Taphrinomycotina;Incertae Sedis;Incertae Sedis;Incertae Sedis;Saitoella;";"100.0";"14.4";"3";"3";"3";"0";"0";"457180";"391204"
"V4mis2";"SILVA (only NR);Eukaryota;Amorphea;Obazoa;Opisthokonta;Nucletmycea;Fungi;Dikarya;Ascomycota;Taphrinomycotina;Neolectomycetes;";"0.0";"0";"1";"1";"0";"1";"0";"457182";"391207"
"V4mis2";"SILVA (only NR);Eukaryota;Amorphea;Obazoa;Opisthokonta;Nucletmycea;Fungi;Dikarya;Ascomycota;Taphrinomycotina;Neolectomycetes;Neolectales;";"0.0";"0";"1";"1";"0";"1";"0";"457182";"391207"
"V4mis2";"SILVA (only NR);Eukaryota;Amorphea;Obazoa;Opisthokonta;Nucletmycea;Fungi;Dikarya;Ascomycota;Taphrinomycotina;Neolectomycetes;Neolectales;Neolectaceae;";"0.0";"0";"1";"1";"0";"1";"0";"457182";"391207"
"V4mis2";"SILVA (only NR);Eukaryota;Amorphea;Obazoa;Opisthokonta;Nucletmycea;Fungi;Dikarya;Ascomycota;Taphrinomycotina;Neolectomycetes;Neolectales;Neolectaceae;Neolecta;";"0.0";"0";"1";"1";"0";"1";"0";"457182";"391207"
"V4mis2";"SILVA (only NR);Eukaryota;Amorphea;Obazoa;Opisthokonta;Nucletmycea;Fungi;Dikarya;Ascomycota;Taphrinomycotina;Pneumocystidomycetes;";"0.0";"0";"6";"6";"0";"6";"0";"457177";"391207"
"V4mis2";"SILVA (only NR);Eukaryota;Amorphea;Obazoa;Opisthokonta;Nucletmycea;Fungi;Dikarya;Ascomycota;Taphrinomycotina;Pneumocystidomycetes;Pneumocystidales;";"0.0";"0";"6";"6";"0";"6";"0";"457177";"391207"
"V4mis2";"SILVA (only NR);Eukaryota;Amorphea;Obazoa;Opisthokonta;Nucletmycea;Fungi;Dikarya;Ascomycota;Taphrinomycotina;Pneumocystidomycetes;Pneumocystidales;Pneumocystidaceae;";"0.0";"0";"6";"6";"0";"6";"0";"457177";"391207"
"V4mis2";"SILVA (only NR);Eukaryota;Amorphea;Obazoa;Opisthokonta;Nucletmycea;Fungi;Dikarya;Ascomycota;Taphrinomycotina;Pneumocystidomycetes;Pneumocystidales;Pneumocystidaceae;Pneumocystis;";"0.0";"0";"6";"6";"0";"6";"0";"457177";"391207"
"V4mis2";"SILVA (only NR);Eukaryota;Amorphea;Obazoa;Opisthokonta;Nucletmycea;Fungi;Dikarya;Ascomycota;Taphrinomycotina;Schizosaccharomycetes;";"0.0";"0";"26";"26";"0";"26";"0";"457157";"391207"
"V4mis2";"SILVA (only NR);Eukaryota;Amorphea;Obazoa;Opisthokonta;Nucletmycea;Fungi;Dikarya;Ascomycota;Taphrinomycotina;Schizosaccharomycetes;Schizosaccharomycetales;";"0.0";"0";"26";"26";"0";"26";"0";"457157";"391207"
"V4mis2";"SILVA (only NR);Eukaryota;Amorphea;Obazoa;Opisthokonta;Nucletmycea;Fungi;Dikarya;Ascomycota;Taphrinomycotina;Schizosaccharomycetes;Schizosaccharomycetales;Schizosaccharomycetaceae;";"0.0";"0";"26";"26";"0";"26";"0";"457157";"391207"
"V4mis2";"SILVA (only NR);Eukaryota;Amorphea;Obazoa;Opisthokonta;Nucletmycea;Fungi;Dikarya;Ascomycota;Taphrinomycotina;Schizosaccharomycetes;Schizosaccharomycetales;Schizosaccharomycetaceae;Schizosaccharomyces;";"0.0";"0";"26";"26";"0";"26";"0";"457157";"391207"
"V4mis2";"SILVA (only NR);Eukaryota;Amorphea;Obazoa;Opisthokonta;Nucletmycea;Fungi;Dikarya;Ascomycota;Taphrinomycotina;Taphrinomycetes;";"0.0";"0";"29";"28";"0";"28";"1";"457155";"391207"
"V4mis2";"SILVA (only NR);Eukaryota;Amorphea;Obazoa;Opisthokonta;Nucletmycea;Fungi;Dikarya;Ascomycota;Taphrinomycotina;Taphrinomycetes;Taphrinales;";"0.0";"0";"29";"28";"0";"28";"1";"457155";"391207"
"V4mis2";"SILVA (only NR);Eukaryota;Amorphea;Obazoa;Opisthokonta;Nucletmycea;Fungi;Dikarya;Ascomycota;Taphrinomycotina;Taphrinomycetes;Taphrinales;Protomycetaceae;";"0.0";"0";"4";"4";"0";"4";"0";"457179";"391207"
"V4mis2";"SILVA (only NR);Eukaryota;Amorphea;Obazoa;Opisthokonta;Nucletmycea;Fungi;Dikarya;Ascomycota;Taphrinomycotina;Taphrinomycetes;Taphrinales;Protomycetaceae;Protomyces;";"0.0";"0";"4";"4";"0";"4";"0";"457179";"391207"
"V4mis2";"SILVA (only NR);Eukaryota;Amorphea;Obazoa;Opisthokonta;Nucletmycea;Fungi;Dikarya;Ascomycota;Taphrinomycotina;Taphrinomycetes;Taphrinales;Taphrinaceae;";"0.0";"0";"23";"23";"0";"23";"0";"457160";"391207"
"V4mis2";"SILVA (only NR);Eukaryota;Amorphea;Obazoa;Opisthokonta;Nucletmycea;Fungi;Dikarya;Ascomycota;Taphrinomycotina;Taphrinomycetes;Taphrinales;Taphrinaceae;Taphrina;";"0.0";"0";"23";"23";"0";"23";"0";"457160";"391207"
"V4mis2";"SILVA (only NR);Eukaryota;Amorphea;Obazoa;Opisthokonta;Nucletmycea;Fungi;Dikarya;Basidiomycota;";"45.2";"14.2";"2538";"2521";"1140";"1381";"17";"454662";"390067"
"V4mis2";"SILVA (only NR);Eukaryota;Amorphea;Obazoa;Opisthokonta;Nucletmycea;Fungi;Dikarya;Basidiomycota;Agaricomycotina;";"39.9";"14.3";"1366";"1353";"540";"813";"13";"455830";"390667"
"V4mis2";"SILVA (only NR);Eukaryota;Amorphea;Obazoa;Opisthokonta;Nucletmycea;Fungi;Dikarya;Basidiomycota;Agaricomycotina;Agaricomycetes;";"8.3";"14.3";"864";"851";"71";"780";"13";"456332";"391136"
"V4mis2";"SILVA (only NR);Eukaryota;Amorphea;Obazoa;Opisthokonta;Nucletmycea;Fungi;Dikarya;Basidiomycota;Agaricomycotina;Agaricomycetes;Agaricales;";"10.0";"14.4";"303";"301";"30";"271";"2";"456882";"391177"
"V4mis2";"SILVA (only NR);Eukaryota;Amorphea;Obazoa;Opisthokonta;Nucletmycea;Fungi;Dikarya;Basidiomycota;Agaricomycotina;Agaricomycetes;Agaricales;Agaricaceae;";"9.1";"14.4";"11";"11";"1";"10";"0";"457172";"391206"
"V4mis2";"SILVA (only NR);Eukaryota;Amorphea;Obazoa;Opisthokonta;Nucletmycea;Fungi;Dikarya;Basidiomycota;Agaricomycotina;Agaricomycetes;Agaricales;Agaricaceae;Agaricus;";"25.0";"14.4";"4";"4";"1";"3";"0";"457179";"391206"
"V4mis2";"SILVA (only NR);Eukaryota;Amorphea;Obazoa;Opisthokonta;Nucletmycea;Fungi;Dikarya;Basidiomycota;Agaricomycotina;Agaricomycetes;Agaricales;Agaricaceae;Leucoagaricus;";"0.0";"0";"5";"5";"0";"5";"0";"457178";"391207"
"V4mis2";"SILVA (only NR);Eukaryota;Amorphea;Obazoa;Opisthokonta;Nucletmycea;Fungi;Dikarya;Basidiomycota;Agaricomycotina;Agaricomycetes;Agaricales;Agaricaceae;Macrolepiota;";"0.0";"0";"1";"1";"0";"1";"0";"457182";"391207"
"V4mis2";"SILVA (only NR);Eukaryota;Amorphea;Obazoa;Opisthokonta;Nucletmycea;Fungi;Dikarya;Basidiomycota;Agaricomycotina;Agaricomycetes;Agaricales;Agrocybe;";"0.0";"0";"1";"1";"0";"1";"0";"457182";"391207"
"V4mis2";"SILVA (only NR);Eukaryota;Amorphea;Obazoa;Opisthokonta;Nucletmycea;Fungi;Dikarya;Basidiomycota;Agaricomycotina;Agaricomycetes;Agaricales;Amanitaceae;";"25.0";"14.4";"8";"8";"2";"6";"0";"457175";"391205"
"V4mis2";"SILVA (only NR);Eukaryota;Amorphea;Obazoa;Opisthokonta;Nucletmycea;Fungi;Dikarya;Basidiomycota;Agaricomycotina;Agaricomycetes;Agaricales;Amanitaceae;Amanita;";"25.0";"14.4";"8";"8";"2";"6";"0";"457175";"391205"
"V4mis2";"SILVA (only NR);Eukaryota;Amorphea;Obazoa;Opisthokonta;Nucletmycea;Fungi;Dikarya;Basidiomycota;Agaricomycotina;Agaricomycetes;Agaricales;Ampulloclitocybe;";"0.0";"0";"1";"1";"0";"1";"0";"457182";"391207"
"V4mis2";"SILVA (only NR);Eukaryota;Amorphea;Obazoa;Opisthokonta;Nucletmycea;Fungi;Dikarya;Basidiomycota;Agaricomycotina;Agaricomycetes;Agaricales;Baeospora;";"0.0";"0";"1";"1";"0";"1";"0";"457182";"391207"
"V4mis2";"SILVA (only NR);Eukaryota;Amorphea;Obazoa;Opisthokonta;Nucletmycea;Fungi;Dikarya;Basidiomycota;Agaricomycotina;Agaricomycetes;Agaricales;Bolbitiaceae;";"0.0";"0";"3";"3";"0";"3";"0";"457180";"391207"
"V4mis2";"SILVA (only NR);Eukaryota;Amorphea;Obazoa;Opisthokonta;Nucletmycea;Fungi;Dikarya;Basidiomycota;Agaricomycotina;Agaricomycetes;Agaricales;Bolbitiaceae;Conocybe;";"0.0";"0";"3";"3";"0";"3";"0";"457180";"391207"
"V4mis2";"SILVA (only NR);Eukaryota;Amorphea;Obazoa;Opisthokonta;Nucletmycea;Fungi;Dikarya;Basidiomycota;Agaricomycotina;Agaricomycetes;Agaricales;Bolbitius;";"0.0";"0";"2";"2";"0";"2";"0";"457181";"391207"
"V4mis2";"SILVA (only NR);Eukaryota;Amorphea;Obazoa;Opisthokonta;Nucletmycea;Fungi;Dikarya;Basidiomycota;Agaricomycotina;Agaricomycetes;Agaricales;Calathella;";"0.0";"0";"1";"1";"0";"1";"0";"457182";"391207"
"V4mis2";"SILVA (only NR);Eukaryota;Amorphea;Obazoa;Opisthokonta;Nucletmycea;Fungi;Dikarya;Basidiomycota;Agaricomycotina;Agaricomycetes;Agaricales;Calvatia;";"0.0";"0";"1";"1";"0";"1";"0";"457182";"391207"
"V4mis2";"SILVA (only NR);Eukaryota;Amorphea;Obazoa;Opisthokonta;Nucletmycea;Fungi;Dikarya;Basidiomycota;Agaricomycotina;Agaricomycetes;Agaricales;Catathelasma;";"0.0";"0";"1";"1";"0";"1";"0";"457182";"391207"
"V4mis2";"SILVA (only NR);Eukaryota;Amorphea;Obazoa;Opisthokonta;Nucletmycea;Fungi;Dikarya;Basidiomycota;Agaricomycotina;Agaricomycetes;Agaricales;Chamaeota;";"0.0";"0";"1";"1";"0";"1";"0";"457182";"391207"
"V4mis2";"SILVA (only NR);Eukaryota;Amorphea;Obazoa;Opisthokonta;Nucletmycea;Fungi;Dikarya;Basidiomycota;Agaricomycotina;Agaricomycetes;Agaricales;Chlorophyllum;";"0.0";"0";"1";"1";"0";"1";"0";"457182";"391207"
"V4mis2";"SILVA (only NR);Eukaryota;Amorphea;Obazoa;Opisthokonta;Nucletmycea;Fungi;Dikarya;Basidiomycota;Agaricomycotina;Agaricomycetes;Agaricales;Chondrostereum;";"0.0";"0";"1";"1";"0";"1";"0";"457182";"391207"
"V4mis2";"SILVA (only NR);Eukaryota;Amorphea;Obazoa;Opisthokonta;Nucletmycea;Fungi;Dikarya;Basidiomycota;Agaricomycotina;Agaricomycetes;Agaricales;Chromosera;";"0.0";"0";"1";"1";"0";"1";"0";"457182";"391207"
"V4mis2";"SILVA (only NR);Eukaryota;Amorphea;Obazoa;Opisthokonta;Nucletmycea;Fungi;Dikarya;Basidiomycota;Agaricomycotina;Agaricomycetes;Agaricales;Chrysomphalina;";"0.0";"0";"2";"2";"0";"2";"0";"457181";"391207"
"V4mis2";"SILVA (only NR);Eukaryota;Amorphea;Obazoa;Opisthokonta;Nucletmycea;Fungi;Dikarya;Basidiomycota;Agaricomycotina;Agaricomycetes;Agaricales;Clavaria;";"0.0";"0";"1";"1";"0";"1";"0";"457182";"391207"
"V4mis2";"SILVA (only NR);Eukaryota;Amorphea;Obazoa;Opisthokonta;Nucletmycea;Fungi;Dikarya;Basidiomycota;Agaricomycotina;Agaricomycetes;Agaricales;Clitocybe;";"0.0";"0";"2";"2";"0";"2";"0";"457181";"391207"
"V4mis2";"SILVA (only NR);Eukaryota;Amorphea;Obazoa;Opisthokonta;Nucletmycea;Fungi;Dikarya;Basidiomycota;Agaricomycotina;Agaricomycetes;Agaricales;Coprinopsis;";"50.0";"14.4";"2";"2";"1";"1";"0";"457181";"391206"
"V4mis2";"SILVA (only NR);Eukaryota;Amorphea;Obazoa;Opisthokonta;Nucletmycea;Fungi;Dikarya;Basidiomycota;Agaricomycotina;Agaricomycetes;Agaricales;Corneriella;";"0.0";"0";"1";"1";"0";"1";"0";"457182";"391207"
"V4mis2";"SILVA (only NR);Eukaryota;Amorphea;Obazoa;Opisthokonta;Nucletmycea;Fungi;Dikarya;Basidiomycota;Agaricomycotina;Agaricomycetes;Agaricales;Cortinariaceae;";"0.0";"0";"4";"4";"0";"4";"0";"457179";"391207"
"V4mis2";"SILVA (only NR);Eukaryota;Amorphea;Obazoa;Opisthokonta;Nucletmycea;Fungi;Dikarya;Basidiomycota;Agaricomycotina;Agaricomycetes;Agaricales;Cortinariaceae;Cortinarius;";"0.0";"0";"4";"4";"0";"4";"0";"457179";"391207"
"V4mis2";"SILVA (only NR);Eukaryota;Amorphea;Obazoa;Opisthokonta;Nucletmycea;Fungi;Dikarya;Basidiomycota;Agaricomycotina;Agaricomycetes;Agaricales;Crepidotaceae;";"100.0";"14.4";"2";"2";"2";"0";"0";"457181";"391205"
"V4mis2";"SILVA (only NR);Eukaryota;Amorphea;Obazoa;Opisthokonta;Nucletmycea;Fungi;Dikarya;Basidiomycota;Agaricomycotina;Agaricomycetes;Agaricales;Crepidotaceae;Crepidotus;";"100.0";"14.4";"1";"1";"1";"0";"0";"457182";"391206"
"V4mis2";"SILVA (only NR);Eukaryota;Amorphea;Obazoa;Opisthokonta;Nucletmycea;Fungi;Dikarya;Basidiomycota;Agaricomycotina;Agaricomycetes;Agaricales;Cuphophyllus;";"0.0";"0";"1";"1";"0";"1";"0";"457182";"391207"
"V4mis2";"SILVA (only NR);Eukaryota;Amorphea;Obazoa;Opisthokonta;Nucletmycea;Fungi;Dikarya;Basidiomycota;Agaricomycotina;Agaricomycetes;Agaricales;Cyathus;";"0.0";"0";"1";"1";"0";"1";"0";"457182";"391207"
"V4mis2";"SILVA (only NR);Eukaryota;Amorphea;Obazoa;Opisthokonta;Nucletmycea;Fungi;Dikarya;Basidiomycota;Agaricomycotina;Agaricomycetes;Agaricales;Cyphellaceae;";"0.0";"0";"3";"3";"0";"3";"0";"457180";"391207"
"V4mis2";"SILVA (only NR);Eukaryota;Amorphea;Obazoa;Opisthokonta;Nucletmycea;Fungi;Dikarya;Basidiomycota;Agaricomycotina;Agaricomycetes;Agaricales;Cyphellaceae;Cyphellopsis;";"0.0";"0";"1";"1";"0";"1";"0";"457182";"391207"
"V4mis2";"SILVA (only NR);Eukaryota;Amorphea;Obazoa;Opisthokonta;Nucletmycea;Fungi;Dikarya;Basidiomycota;Agaricomycotina;Agaricomycetes;Agaricales;Cyphellaceae;Globulicium;";"0.0";"0";"1";"1";"0";"1";"0";"457182";"391207"
"V4mis2";"SILVA (only NR);Eukaryota;Amorphea;Obazoa;Opisthokonta;Nucletmycea;Fungi;Dikarya;Basidiomycota;Agaricomycotina;Agaricomycetes;Agaricales;Cyphellaceae;Halocyphina;";"0.0";"0";"1";"1";"0";"1";"0";"457182";"391207"
"V4mis2";"SILVA (only NR);Eukaryota;Amorphea;Obazoa;Opisthokonta;Nucletmycea;Fungi;Dikarya;Basidiomycota;Agaricomycotina;Agaricomycetes;Agaricales;Cystoderma;";"0.0";"0";"1";"1";"0";"1";"0";"457182";"391207"
"V4mis2";"SILVA (only NR);Eukaryota;Amorphea;Obazoa;Opisthokonta;Nucletmycea;Fungi;Dikarya;Basidiomycota;Agaricomycotina;Agaricomycetes;Agaricales;Entolomataceae;";"0.0";"0";"9";"9";"0";"9";"0";"457174";"391207"
"V4mis2";"SILVA (only NR);Eukaryota;Amorphea;Obazoa;Opisthokonta;Nucletmycea;Fungi;Dikarya;Basidiomycota;Agaricomycotina;Agaricomycetes;Agaricales;Entolomataceae;Clitopilus;";"0.0";"0";"2";"2";"0";"2";"0";"457181";"391207"
"V4mis2";"SILVA (only NR);Eukaryota;Amorphea;Obazoa;Opisthokonta;Nucletmycea;Fungi;Dikarya;Basidiomycota;Agaricomycotina;Agaricomycetes;Agaricales;Entolomataceae;Entoloma;";"0.0";"0";"4";"4";"0";"4";"0";"457179";"391207"
"V4mis2";"SILVA (only NR);Eukaryota;Amorphea;Obazoa;Opisthokonta;Nucletmycea;Fungi;Dikarya;Basidiomycota;Agaricomycotina;Agaricomycetes;Agaricales;Entolomataceae;Rhodocybe;";"0.0";"0";"1";"1";"0";"1";"0";"457182";"391207"
"V4mis2";"SILVA (only NR);Eukaryota;Amorphea;Obazoa;Opisthokonta;Nucletmycea;Fungi;Dikarya;Basidiomycota;Agaricomycotina;Agaricomycetes;Agaricales;Entolomataceae;Rhodocybella;";"0.0";"0";"1";"1";"0";"1";"0";"457182";"391207"
"V4mis2";"SILVA (only NR);Eukaryota;Amorphea;Obazoa;Opisthokonta;Nucletmycea;Fungi;Dikarya;Basidiomycota;Agaricomycotina;Agaricomycetes;Agaricales;Entolomataceae;Richoniella;";"0.0";"0";"1";"1";"0";"1";"0";"457182";"391207"
"V4mis2";"SILVA (only NR);Eukaryota;Amorphea;Obazoa;Opisthokonta;Nucletmycea;Fungi;Dikarya;Basidiomycota;Agaricomycotina;Agaricomycetes;Agaricales;Favolaschia;";"0.0";"0";"1";"1";"0";"1";"0";"457182";"391207"
"V4mis2";"SILVA (only NR);Eukaryota;Amorphea;Obazoa;Opisthokonta;Nucletmycea;Fungi;Dikarya;Basidiomycota;Agaricomycotina;Agaricomycetes;Agaricales;Fistulinaceae;";"0.0";"0";"4";"4";"0";"4";"0";"457179";"391207"
"V4mis2";"SILVA (only NR);Eukaryota;Amorphea;Obazoa;Opisthokonta;Nucletmycea;Fungi;Dikarya;Basidiomycota;Agaricomycotina;Agaricomycetes;Agaricales;Fistulinaceae;Fistulina;";"0.0";"0";"4";"4";"0";"4";"0";"457179";"391207"
"V4mis2";"SILVA (only NR);Eukaryota;Amorphea;Obazoa;Opisthokonta;Nucletmycea;Fungi;Dikarya;Basidiomycota;Agaricomycotina;Agaricomycetes;Agaricales;Galerina;";"0.0";"0";"1";"1";"0";"1";"0";"457182";"391207"
"V4mis2";"SILVA (only NR);Eukaryota;Amorphea;Obazoa;Opisthokonta;Nucletmycea;Fungi;Dikarya;Basidiomycota;Agaricomycotina;Agaricomycetes;Agaricales;Guyanagarika;";"0.0";"0";"1";"1";"0";"1";"0";"457182";"391207"
"V4mis2";"SILVA (only NR);Eukaryota;Amorphea;Obazoa;Opisthokonta;Nucletmycea;Fungi;Dikarya;Basidiomycota;Agaricomycotina;Agaricomycetes;Agaricales;Hebeloma;";"0.0";"0";"1";"1";"0";"1";"0";"457182";"391207"
"V4mis2";"SILVA (only NR);Eukaryota;Amorphea;Obazoa;Opisthokonta;Nucletmycea;Fungi;Dikarya;Basidiomycota;Agaricomycotina;Agaricomycetes;Agaricales;Henningsomyces;";"0.0";"0";"1";"1";"0";"1";"0";"457182";"391207"
"V4mis2";"SILVA (only NR);Eukaryota;Amorphea;Obazoa;Opisthokonta;Nucletmycea;Fungi;Dikarya;Basidiomycota;Agaricomycotina;Agaricomycetes;Agaricales;Hodophilus;";"0.0";"0";"1";"1";"0";"1";"0";"457182";"391207"
"V4mis2";"SILVA (only NR);Eukaryota;Amorphea;Obazoa;Opisthokonta;Nucletmycea;Fungi;Dikarya;Basidiomycota;Agaricomycotina;Agaricomycetes;Agaricales;Hohenbuehelia;";"0.0";"0";"1";"1";"0";"1";"0";"457182";"391207"
"V4mis2";"SILVA (only NR);Eukaryota;Amorphea;Obazoa;Opisthokonta;Nucletmycea;Fungi;Dikarya;Basidiomycota;Agaricomycotina;Agaricomycetes;Agaricales;Hygrophoraceae;";"0.0";"0";"29";"29";"0";"29";"0";"457154";"391207"
"V4mis2";"SILVA (only NR);Eukaryota;Amorphea;Obazoa;Opisthokonta;Nucletmycea;Fungi;Dikarya;Basidiomycota;Agaricomycotina;Agaricomycetes;Agaricales;Hygrophoraceae;Dictyonema;";"0.0";"0";"3";"3";"0";"3";"0";"457180";"391207"
"V4mis2";"SILVA (only NR);Eukaryota;Amorphea;Obazoa;Opisthokonta;Nucletmycea;Fungi;Dikarya;Basidiomycota;Agaricomycotina;Agaricomycetes;Agaricales;Hygrophoraceae;Gliophorus;";"0.0";"0";"5";"5";"0";"5";"0";"457178";"391207"
"V4mis2";"SILVA (only NR);Eukaryota;Amorphea;Obazoa;Opisthokonta;Nucletmycea;Fungi;Dikarya;Basidiomycota;Agaricomycotina;Agaricomycetes;Agaricales;Hygrophoraceae;Humidicutis;";"0.0";"0";"2";"2";"0";"2";"0";"457181";"391207"
"V4mis2";"SILVA (only NR);Eukaryota;Amorphea;Obazoa;Opisthokonta;Nucletmycea;Fungi;Dikarya;Basidiomycota;Agaricomycotina;Agaricomycetes;Agaricales;Hygrophoraceae;Hygroaster;";"0.0";"0";"2";"2";"0";"2";"0";"457181";"391207"
"V4mis2";"SILVA (only NR);Eukaryota;Amorphea;Obazoa;Opisthokonta;Nucletmycea;Fungi;Dikarya;Basidiomycota;Agaricomycotina;Agaricomycetes;Agaricales;Hygrophoraceae;Hygrocybe;";"0.0";"0";"11";"11";"0";"11";"0";"457172";"391207"
"V4mis2";"SILVA (only NR);Eukaryota;Amorphea;Obazoa;Opisthokonta;Nucletmycea;Fungi;Dikarya;Basidiomycota;Agaricomycotina;Agaricomycetes;Agaricales;Hygrophoraceae;Hygrophorus;";"0.0";"0";"5";"5";"0";"5";"0";"457178";"391207"
"V4mis2";"SILVA (only NR);Eukaryota;Amorphea;Obazoa;Opisthokonta;Nucletmycea;Fungi;Dikarya;Basidiomycota;Agaricomycotina;Agaricomycetes;Agaricales;Hygrophoraceae;Typhula;";"0.0";"0";"1";"1";"0";"1";"0";"457182";"391207"
"V4mis2";"SILVA (only NR);Eukaryota;Amorphea;Obazoa;Opisthokonta;Nucletmycea;Fungi;Dikarya;Basidiomycota;Agaricomycotina;Agaricomycetes;Agaricales;Incertae Sedis;";"0.0";"0";"1";"1";"0";"1";"0";"457182";"391207"
"V4mis2";"SILVA (only NR);Eukaryota;Amorphea;Obazoa;Opisthokonta;Nucletmycea;Fungi;Dikarya;Basidiomycota;Agaricomycotina;Agaricomycetes;Agaricales;Incertae Sedis;Dendrothele;";"0.0";"0";"1";"1";"0";"1";"0";"457182";"391207"
"V4mis2";"SILVA (only NR);Eukaryota;Amorphea;Obazoa;Opisthokonta;Nucletmycea;Fungi;Dikarya;Basidiomycota;Agaricomycotina;Agaricomycetes;Agaricales;Inocybaceae;";"100.0";"14.4";"5";"5";"5";"0";"0";"457178";"391202"
"V4mis2";"SILVA (only NR);Eukaryota;Amorphea;Obazoa;Opisthokonta;Nucletmycea;Fungi;Dikarya;Basidiomycota;Agaricomycotina;Agaricomycetes;Agaricales;Inocybaceae;Inocybe;";"100.0";"14.4";"5";"5";"5";"0";"0";"457178";"391202"
"V4mis2";"SILVA (only NR);Eukaryota;Amorphea;Obazoa;Opisthokonta;Nucletmycea;Fungi;Dikarya;Basidiomycota;Agaricomycotina;Agaricomycetes;Agaricales;Limnoperdon;";"0.0";"0";"1";"1";"0";"1";"0";"457182";"391207"
"V4mis2";"SILVA (only NR);Eukaryota;Amorphea;Obazoa;Opisthokonta;Nucletmycea;Fungi;Dikarya;Basidiomycota;Agaricomycotina;Agaricomycetes;Agaricales;Lyophyllaceae;";"0.0";"0";"4";"4";"0";"4";"0";"457179";"391207"
"V4mis2";"SILVA (only NR);Eukaryota;Amorphea;Obazoa;Opisthokonta;Nucletmycea;Fungi;Dikarya;Basidiomycota;Agaricomycotina;Agaricomycetes;Agaricales;Lyophyllaceae;Asterophora;";"0.0";"0";"3";"3";"0";"3";"0";"457180";"391207"
"V4mis2";"SILVA (only NR);Eukaryota;Amorphea;Obazoa;Opisthokonta;Nucletmycea;Fungi;Dikarya;Basidiomycota;Agaricomycotina;Agaricomycetes;Agaricales;Lyophyllaceae;Hypsizygus;";"0.0";"0";"1";"1";"0";"1";"0";"457182";"391207"
"V4mis2";"SILVA (only NR);Eukaryota;Amorphea;Obazoa;Opisthokonta;Nucletmycea;Fungi;Dikarya;Basidiomycota;Agaricomycotina;Agaricomycetes;Agaricales;Lyophyllum;";"0.0";"0";"2";"2";"0";"2";"0";"457181";"391207"
"V4mis2";"SILVA (only NR);Eukaryota;Amorphea;Obazoa;Opisthokonta;Nucletmycea;Fungi;Dikarya;Basidiomycota;Agaricomycotina;Agaricomycetes;Agaricales;Marasmiaceae;";"26.7";"14.4";"15";"15";"4";"11";"0";"457168";"391203"
"V4mis2";"SILVA (only NR);Eukaryota;Amorphea;Obazoa;Opisthokonta;Nucletmycea;Fungi;Dikarya;Basidiomycota;Agaricomycotina;Agaricomycetes;Agaricales;Marasmiaceae;Campanella;";"0.0";"0";"1";"1";"0";"1";"0";"457182";"391207"
"V4mis2";"SILVA (only NR);Eukaryota;Amorphea;Obazoa;Opisthokonta;Nucletmycea;Fungi;Dikarya;Basidiomycota;Agaricomycotina;Agaricomycetes;Agaricales;Marasmiaceae;Chaetocalathus;";"0.0";"0";"1";"1";"0";"1";"0";"457182";"391207"
"V4mis2";"SILVA (only NR);Eukaryota;Amorphea;Obazoa;Opisthokonta;Nucletmycea;Fungi;Dikarya;Basidiomycota;Agaricomycotina;Agaricomycetes;Agaricales;Marasmiaceae;Crinipellis;";"0.0";"0";"1";"1";"0";"1";"0";"457182";"391207"
"V4mis2";"SILVA (only NR);Eukaryota;Amorphea;Obazoa;Opisthokonta;Nucletmycea;Fungi;Dikarya;Basidiomycota;Agaricomycotina;Agaricomycetes;Agaricales;Marasmiaceae;Marasmius;";"0.0";"0";"3";"3";"0";"3";"0";"457180";"391207"
"V4mis2";"SILVA (only NR);Eukaryota;Amorphea;Obazoa;Opisthokonta;Nucletmycea;Fungi;Dikarya;Basidiomycota;Agaricomycotina;Agaricomycetes;Agaricales;Marasmiaceae;Moniliophthora;";"0.0";"0";"2";"2";"0";"2";"0";"457181";"391207"
"V4mis2";"SILVA (only NR);Eukaryota;Amorphea;Obazoa;Opisthokonta;Nucletmycea;Fungi;Dikarya;Basidiomycota;Agaricomycotina;Agaricomycetes;Agaricales;Marasmiaceae;Neocampanella;";"0.0";"0";"1";"1";"0";"1";"0";"457182";"391207"
"V4mis2";"SILVA (only NR);Eukaryota;Amorphea;Obazoa;Opisthokonta;Nucletmycea;Fungi;Dikarya;Basidiomycota;Agaricomycotina;Agaricomycetes;Agaricales;Marasmiaceae;uncultured;";"80.0";"14.4";"5";"5";"4";"1";"0";"457178";"391203"
"V4mis2";"SILVA (only NR);Eukaryota;Amorphea;Obazoa;Opisthokonta;Nucletmycea;Fungi;Dikarya;Basidiomycota;Agaricomycotina;Agaricomycetes;Agaricales;Megacollybia;";"0.0";"0";"1";"1";"0";"1";"0";"457182";"391207"
"V4mis2";"SILVA (only NR);Eukaryota;Amorphea;Obazoa;Opisthokonta;Nucletmycea;Fungi;Dikarya;Basidiomycota;Agaricomycotina;Agaricomycetes;Agaricales;Mycocalia;";"0.0";"0";"1";"1";"0";"1";"0";"457182";"391207"
"V4mis2";"SILVA (only NR);Eukaryota;Amorphea;Obazoa;Opisthokonta;Nucletmycea;Fungi;Dikarya;Basidiomycota;Agaricomycotina;Agaricomycetes;Agaricales;Neohygrocybe;";"0.0";"0";"3";"3";"0";"3";"0";"457180";"391207"
"V4mis2";"SILVA (only NR);Eukaryota;Amorphea;Obazoa;Opisthokonta;Nucletmycea;Fungi;Dikarya;Basidiomycota;Agaricomycotina;Agaricomycetes;Agaricales;Nia;";"0.0";"0";"1";"1";"0";"1";"0";"457182";"391207"
"V4mis2";"SILVA (only NR);Eukaryota;Amorphea;Obazoa;Opisthokonta;Nucletmycea;Fungi;Dikarya;Basidiomycota;Agaricomycotina;Agaricomycetes;Agaricales;Nidula;";"0.0";"0";"1";"1";"0";"1";"0";"457182";"391207"
"V4mis2";"SILVA (only NR);Eukaryota;Amorphea;Obazoa;Opisthokonta;Nucletmycea;Fungi;Dikarya;Basidiomycota;Agaricomycotina;Agaricomycetes;Agaricales;Omphalotaceae;";"0.0";"0";"9";"8";"0";"8";"1";"457175";"391207"
"V4mis2";"SILVA (only NR);Eukaryota;Amorphea;Obazoa;Opisthokonta;Nucletmycea;Fungi;Dikarya;Basidiomycota;Agaricomycotina;Agaricomycetes;Agaricales;Omphalotaceae;Collybia;";"0.0";"0";"1";"1";"0";"1";"0";"457182";"391207"
"V4mis2";"SILVA (only NR);Eukaryota;Amorphea;Obazoa;Opisthokonta;Nucletmycea;Fungi;Dikarya;Basidiomycota;Agaricomycotina;Agaricomycetes;Agaricales;Omphalotaceae;Gymnopus;";"0.0";"0";"2";"2";"0";"2";"0";"457181";"391207"
"V4mis2";"SILVA (only NR);Eukaryota;Amorphea;Obazoa;Opisthokonta;Nucletmycea;Fungi;Dikarya;Basidiomycota;Agaricomycotina;Agaricomycetes;Agaricales;Omphalotaceae;Lentinula;";"0.0";"0";"3";"2";"0";"2";"1";"457181";"391207"
"V4mis2";"SILVA (only NR);Eukaryota;Amorphea;Obazoa;Opisthokonta;Nucletmycea;Fungi;Dikarya;Basidiomycota;Agaricomycotina;Agaricomycetes;Agaricales;Omphalotaceae;Omphalotus;";"0.0";"0";"1";"1";"0";"1";"0";"457182";"391207"
"V4mis2";"SILVA (only NR);Eukaryota;Amorphea;Obazoa;Opisthokonta;Nucletmycea;Fungi;Dikarya;Basidiomycota;Agaricomycotina;Agaricomycetes;Agaricales;Omphalotaceae;uncultured;";"0.0";"0";"2";"2";"0";"2";"0";"457181";"391207"
"V4mis2";"SILVA (only NR);Eukaryota;Amorphea;Obazoa;Opisthokonta;Nucletmycea;Fungi;Dikarya;Basidiomycota;Agaricomycotina;Agaricomycetes;Agaricales;Pholiotina;";"0.0";"0";"1";"1";"0";"1";"0";"457182";"391207"
"V4mis2";"SILVA (only NR);Eukaryota;Amorphea;Obazoa;Opisthokonta;Nucletmycea;Fungi;Dikarya;Basidiomycota;Agaricomycotina;Agaricomycetes;Agaricales;Physalacriaceae;";"0.0";"0";"7";"7";"0";"7";"0";"457176";"391207"
"V4mis2";"SILVA (only NR);Eukaryota;Amorphea;Obazoa;Opisthokonta;Nucletmycea;Fungi;Dikarya;Basidiomycota;Agaricomycotina;Agaricomycetes;Agaricales;Physalacriaceae;Armillaria;";"0.0";"0";"1";"1";"0";"1";"0";"457182";"391207"
"V4mis2";"SILVA (only NR);Eukaryota;Amorphea;Obazoa;Opisthokonta;Nucletmycea;Fungi;Dikarya;Basidiomycota;Agaricomycotina;Agaricomycetes;Agaricales;Physalacriaceae;Cylindrobasidium;";"0.0";"0";"1";"1";"0";"1";"0";"457182";"391207"
"V4mis2";"SILVA (only NR);Eukaryota;Amorphea;Obazoa;Opisthokonta;Nucletmycea;Fungi;Dikarya;Basidiomycota;Agaricomycotina;Agaricomycetes;Agaricales;Physalacriaceae;Flammulina;";"0.0";"0";"2";"2";"0";"2";"0";"457181";"391207"
"V4mis2";"SILVA (only NR);Eukaryota;Amorphea;Obazoa;Opisthokonta;Nucletmycea;Fungi;Dikarya;Basidiomycota;Agaricomycotina;Agaricomycetes;Agaricales;Physalacriaceae;Hymenopellis;";"0.0";"0";"1";"1";"0";"1";"0";"457182";"391207"
"V4mis2";"SILVA (only NR);Eukaryota;Amorphea;Obazoa;Opisthokonta;Nucletmycea;Fungi;Dikarya;Basidiomycota;Agaricomycotina;Agaricomycetes;Agaricales;Physalacriaceae;Mycotribulus;";"0.0";"0";"1";"1";"0";"1";"0";"457182";"391207"
"V4mis2";"SILVA (only NR);Eukaryota;Amorphea;Obazoa;Opisthokonta;Nucletmycea;Fungi;Dikarya;Basidiomycota;Agaricomycotina;Agaricomycetes;Agaricales;Physalacriaceae;Physalacria;";"0.0";"0";"1";"1";"0";"1";"0";"457182";"391207"
"V4mis2";"SILVA (only NR);Eukaryota;Amorphea;Obazoa;Opisthokonta;Nucletmycea;Fungi;Dikarya;Basidiomycota;Agaricomycotina;Agaricomycetes;Agaricales;Pleuroflammula;";"100.0";"14.4";"1";"1";"1";"0";"0";"457182";"391206"
"V4mis2";"SILVA (only NR);Eukaryota;Amorphea;Obazoa;Opisthokonta;Nucletmycea;Fungi;Dikarya;Basidiomycota;Agaricomycotina;Agaricomycetes;Agaricales;Pleurotaceae;";"0.0";"0";"8";"8";"0";"8";"0";"457175";"391207"
"V4mis2";"SILVA (only NR);Eukaryota;Amorphea;Obazoa;Opisthokonta;Nucletmycea;Fungi;Dikarya;Basidiomycota;Agaricomycotina;Agaricomycetes;Agaricales;Pleurotaceae;Pleurotus;";"0.0";"0";"8";"8";"0";"8";"0";"457175";"391207"
"V4mis2";"SILVA (only NR);Eukaryota;Amorphea;Obazoa;Opisthokonta;Nucletmycea;Fungi;Dikarya;Basidiomycota;Agaricomycotina;Agaricomycetes;Agaricales;Pleurotopsis;";"0.0";"0";"1";"1";"0";"1";"0";"457182";"391207"
"V4mis2";"SILVA (only NR);Eukaryota;Amorphea;Obazoa;Opisthokonta;Nucletmycea;Fungi;Dikarya;Basidiomycota;Agaricomycotina;Agaricomycetes;Agaricales;Plicaturopsis;";"0.0";"0";"1";"1";"0";"1";"0";"457182";"391207"
"V4mis2";"SILVA (only NR);Eukaryota;Amorphea;Obazoa;Opisthokonta;Nucletmycea;Fungi;Dikarya;Basidiomycota;Agaricomycotina;Agaricomycetes;Agaricales;Pluteaceae;";"0.0";"0";"9";"9";"0";"9";"0";"457174";"391207"
"V4mis2";"SILVA (only NR);Eukaryota;Amorphea;Obazoa;Opisthokonta;Nucletmycea;Fungi;Dikarya;Basidiomycota;Agaricomycotina;Agaricomycetes;Agaricales;Pluteaceae;Pluteus;";"0.0";"0";"4";"4";"0";"4";"0";"457179";"391207"
"V4mis2";"SILVA (only NR);Eukaryota;Amorphea;Obazoa;Opisthokonta;Nucletmycea;Fungi;Dikarya;Basidiomycota;Agaricomycotina;Agaricomycetes;Agaricales;Pluteaceae;Volvariella;";"0.0";"0";"5";"5";"0";"5";"0";"457178";"391207"
"V4mis2";"SILVA (only NR);Eukaryota;Amorphea;Obazoa;Opisthokonta;Nucletmycea;Fungi;Dikarya;Basidiomycota;Agaricomycotina;Agaricomycetes;Agaricales;Psathyrellaceae;";"50.0";"14.4";"2";"2";"1";"1";"0";"457181";"391206"
"V4mis2";"SILVA (only NR);Eukaryota;Amorphea;Obazoa;Opisthokonta;Nucletmycea;Fungi;Dikarya;Basidiomycota;Agaricomycotina;Agaricomycetes;Agaricales;Psathyrellaceae;Psathyrella;";"50.0";"14.4";"2";"2";"1";"1";"0";"457181";"391206"
"V4mis2";"SILVA (only NR);Eukaryota;Amorphea;Obazoa;Opisthokonta;Nucletmycea;Fungi;Dikarya;Basidiomycota;Agaricomycotina;Agaricomycetes;Agaricales;Pseudoomphalina;";"0.0";"0";"1";"1";"0";"1";"0";"457182";"391207"
"V4mis2";"SILVA (only NR);Eukaryota;Amorphea;Obazoa;Opisthokonta;Nucletmycea;Fungi;Dikarya;Basidiomycota;Agaricomycotina;Agaricomycetes;Agaricales;Pseudotricholoma;";"0.0";"0";"1";"1";"0";"1";"0";"457182";"391207"
"V4mis2";"SILVA (only NR);Eukaryota;Amorphea;Obazoa;Opisthokonta;Nucletmycea;Fungi;Dikarya;Basidiomycota;Agaricomycotina;Agaricomycetes;Agaricales;Pterulaceae;";"0.0";"0";"3";"3";"0";"3";"0";"457180";"391207"
"V4mis2";"SILVA (only NR);Eukaryota;Amorphea;Obazoa;Opisthokonta;Nucletmycea;Fungi;Dikarya;Basidiomycota;Agaricomycotina;Agaricomycetes;Agaricales;Pterulaceae;Aphanobasidium;";"0.0";"0";"1";"1";"0";"1";"0";"457182";"391207"
"V4mis2";"SILVA (only NR);Eukaryota;Amorphea;Obazoa;Opisthokonta;Nucletmycea;Fungi;Dikarya;Basidiomycota;Agaricomycotina;Agaricomycetes;Agaricales;Pterulaceae;Pterula;";"0.0";"0";"1";"1";"0";"1";"0";"457182";"391207"
"V4mis2";"SILVA (only NR);Eukaryota;Amorphea;Obazoa;Opisthokonta;Nucletmycea;Fungi;Dikarya;Basidiomycota;Agaricomycotina;Agaricomycetes;Agaricales;Rugosomyces;";"0.0";"0";"1";"1";"0";"1";"0";"457182";"391207"
"V4mis2";"SILVA (only NR);Eukaryota;Amorphea;Obazoa;Opisthokonta;Nucletmycea;Fungi;Dikarya;Basidiomycota;Agaricomycotina;Agaricomycetes;Agaricales;Sarcomyxa;";"0.0";"0";"1";"1";"0";"1";"0";"457182";"391207"
"V4mis2";"SILVA (only NR);Eukaryota;Amorphea;Obazoa;Opisthokonta;Nucletmycea;Fungi;Dikarya;Basidiomycota;Agaricomycotina;Agaricomycetes;Agaricales;Schizophyllaceae;";"20.0";"14.4";"5";"5";"1";"4";"0";"457178";"391206"
"V4mis2";"SILVA (only NR);Eukaryota;Amorphea;Obazoa;Opisthokonta;Nucletmycea;Fungi;Dikarya;Basidiomycota;Agaricomycotina;Agaricomycetes;Agaricales;Schizophyllaceae;Grifola;";"0.0";"0";"2";"2";"0";"2";"0";"457181";"391207"
"V4mis2";"SILVA (only NR);Eukaryota;Amorphea;Obazoa;Opisthokonta;Nucletmycea;Fungi;Dikarya;Basidiomycota;Agaricomycotina;Agaricomycetes;Agaricales;Schizophyllaceae;Schizophyllum;";"33.3";"14.4";"3";"3";"1";"2";"0";"457180";"391206"
"V4mis2";"SILVA (only NR);Eukaryota;Amorphea;Obazoa;Opisthokonta;Nucletmycea;Fungi;Dikarya;Basidiomycota;Agaricomycotina;Agaricomycetes;Agaricales;Serendipita;";"0.0";"0";"1";"1";"0";"1";"0";"457182";"391207"
"V4mis2";"SILVA (only NR);Eukaryota;Amorphea;Obazoa;Opisthokonta;Nucletmycea;Fungi;Dikarya;Basidiomycota;Agaricomycotina;Agaricomycetes;Agaricales;Stephanospora;";"0.0";"0";"1";"1";"0";"1";"0";"457182";"391207"
"V4mis2";"SILVA (only NR);Eukaryota;Amorphea;Obazoa;Opisthokonta;Nucletmycea;Fungi;Dikarya;Basidiomycota;Agaricomycotina;Agaricomycetes;Agaricales;Stropharia;";"0.0";"0";"2";"2";"0";"2";"0";"457181";"391207"
"V4mis2";"SILVA (only NR);Eukaryota;Amorphea;Obazoa;Opisthokonta;Nucletmycea;Fungi;Dikarya;Basidiomycota;Agaricomycotina;Agaricomycetes;Agaricales;Strophariaceae;";"0.0";"0";"3";"3";"0";"3";"0";"457180";"391207"
"V4mis2";"SILVA (only NR);Eukaryota;Amorphea;Obazoa;Opisthokonta;Nucletmycea;Fungi;Dikarya;Basidiomycota;Agaricomycotina;Agaricomycetes;Agaricales;Strophariaceae;Phaeomarasmius;";"0.0";"0";"1";"1";"0";"1";"0";"457182";"391207"
"V4mis2";"SILVA (only NR);Eukaryota;Amorphea;Obazoa;Opisthokonta;Nucletmycea;Fungi;Dikarya;Basidiomycota;Agaricomycotina;Agaricomycetes;Agaricales;Strophariaceae;Tubaria;";"0.0";"0";"2";"2";"0";"2";"0";"457181";"391207"
"V4mis2";"SILVA (only NR);Eukaryota;Amorphea;Obazoa;Opisthokonta;Nucletmycea;Fungi;Dikarya;Basidiomycota;Agaricomycotina;Agaricomycetes;Agaricales;Tephrocybe;";"0.0";"0";"1";"1";"0";"1";"0";"457182";"391207"
"V4mis2";"SILVA (only NR);Eukaryota;Amorphea;Obazoa;Opisthokonta;Nucletmycea;Fungi;Dikarya;Basidiomycota;Agaricomycotina;Agaricomycetes;Agaricales;Termitomyces;";"0.0";"0";"1";"1";"0";"1";"0";"457182";"391207"
"V4mis2";"SILVA (only NR);Eukaryota;Amorphea;Obazoa;Opisthokonta;Nucletmycea;Fungi;Dikarya;Basidiomycota;Agaricomycotina;Agaricomycetes;Agaricales;Tricholoma;";"0.0";"0";"1";"1";"0";"1";"0";"457182";"391207"
"V4mis2";"SILVA (only NR);Eukaryota;Amorphea;Obazoa;Opisthokonta;Nucletmycea;Fungi;Dikarya;Basidiomycota;Agaricomycotina;Agaricomycetes;Agaricales;Tricholomataceae;";"1.9";"14.4";"54";"54";"1";"53";"0";"457129";"391206"
"V4mis2";"SILVA (only NR);Eukaryota;Amorphea;Obazoa;Opisthokonta;Nucletmycea;Fungi;Dikarya;Basidiomycota;Agaricomycotina;Agaricomycetes;Agaricales;Tricholomataceae;Albomagister;";"0.0";"0";"1";"1";"0";"1";"0";"457182";"391207"
"V4mis2";"SILVA (only NR);Eukaryota;Amorphea;Obazoa;Opisthokonta;Nucletmycea;Fungi;Dikarya;Basidiomycota;Agaricomycotina;Agaricomycetes;Agaricales;Tricholomataceae;Alloclavaria;";"0.0";"0";"1";"1";"0";"1";"0";"457182";"391207"
"V4mis2";"SILVA (only NR);Eukaryota;Amorphea;Obazoa;Opisthokonta;Nucletmycea;Fungi;Dikarya;Basidiomycota;Agaricomycotina;Agaricomycetes;Agaricales;Tricholomataceae;Callistosporium;";"0.0";"0";"1";"1";"0";"1";"0";"457182";"391207"
"V4mis2";"SILVA (only NR);Eukaryota;Amorphea;Obazoa;Opisthokonta;Nucletmycea;Fungi;Dikarya;Basidiomycota;Agaricomycotina;Agaricomycetes;Agaricales;Tricholomataceae;Camarophyllopsis;";"0.0";"0";"1";"1";"0";"1";"0";"457182";"391207"
"V4mis2";"SILVA (only NR);Eukaryota;Amorphea;Obazoa;Opisthokonta;Nucletmycea;Fungi;Dikarya;Basidiomycota;Agaricomycotina;Agaricomycetes;Agaricales;Tricholomataceae;Camarophyllus;";"0.0";"0";"2";"2";"0";"2";"0";"457181";"391207"
"V4mis2";"SILVA (only NR);Eukaryota;Amorphea;Obazoa;Opisthokonta;Nucletmycea;Fungi;Dikarya;Basidiomycota;Agaricomycotina;Agaricomycetes;Agaricales;Tricholomataceae;Cheimonophyllum;";"0.0";"0";"1";"1";"0";"1";"0";"457182";"391207"
"V4mis2";"SILVA (only NR);Eukaryota;Amorphea;Obazoa;Opisthokonta;Nucletmycea;Fungi;Dikarya;Basidiomycota;Agaricomycotina;Agaricomycetes;Agaricales;Tricholomataceae;Cleistocybe;";"0.0";"0";"1";"1";"0";"1";"0";"457182";"391207"
"V4mis2";"SILVA (only NR);Eukaryota;Amorphea;Obazoa;Opisthokonta;Nucletmycea;Fungi;Dikarya;Basidiomycota;Agaricomycotina;Agaricomycetes;Agaricales;Tricholomataceae;Cystostereum;";"0.0";"0";"1";"1";"0";"1";"0";"457182";"391207"
"V4mis2";"SILVA (only NR);Eukaryota;Amorphea;Obazoa;Opisthokonta;Nucletmycea;Fungi;Dikarya;Basidiomycota;Agaricomycotina;Agaricomycetes;Agaricales;Tricholomataceae;Dendrocollybia;";"0.0";"0";"1";"1";"0";"1";"0";"457182";"391207"
"V4mis2";"SILVA (only NR);Eukaryota;Amorphea;Obazoa;Opisthokonta;Nucletmycea;Fungi;Dikarya;Basidiomycota;Agaricomycotina;Agaricomycetes;Agaricales;Tricholomataceae;Granulobasidium;";"0.0";"0";"1";"1";"0";"1";"0";"457182";"391207"
"V4mis2";"SILVA (only NR);Eukaryota;Amorphea;Obazoa;Opisthokonta;Nucletmycea;Fungi;Dikarya;Basidiomycota;Agaricomycotina;Agaricomycetes;Agaricales;Tricholomataceae;Hemimycena;";"0.0";"0";"1";"1";"0";"1";"0";"457182";"391207"
"V4mis2";"SILVA (only NR);Eukaryota;Amorphea;Obazoa;Opisthokonta;Nucletmycea;Fungi;Dikarya;Basidiomycota;Agaricomycotina;Agaricomycetes;Agaricales;Tricholomataceae;Hydropus;";"0.0";"0";"2";"2";"0";"2";"0";"457181";"391207"
"V4mis2";"SILVA (only NR);Eukaryota;Amorphea;Obazoa;Opisthokonta;Nucletmycea;Fungi;Dikarya;Basidiomycota;Agaricomycotina;Agaricomycetes;Agaricales;Tricholomataceae;Infundibulicybe;";"0.0";"0";"1";"1";"0";"1";"0";"457182";"391207"
"V4mis2";"SILVA (only NR);Eukaryota;Amorphea;Obazoa;Opisthokonta;Nucletmycea;Fungi;Dikarya;Basidiomycota;Agaricomycotina;Agaricomycetes;Agaricales;Tricholomataceae;Lachnella;";"0.0";"0";"1";"1";"0";"1";"0";"457182";"391207"
"V4mis2";"SILVA (only NR);Eukaryota;Amorphea;Obazoa;Opisthokonta;Nucletmycea;Fungi;Dikarya;Basidiomycota;Agaricomycotina;Agaricomycetes;Agaricales;Tricholomataceae;Laetiporus;";"0.0";"0";"1";"1";"0";"1";"0";"457182";"391207"
"V4mis2";"SILVA (only NR);Eukaryota;Amorphea;Obazoa;Opisthokonta;Nucletmycea;Fungi;Dikarya;Basidiomycota;Agaricomycotina;Agaricomycetes;Agaricales;Tricholomataceae;Leucopaxillus;";"0.0";"0";"3";"3";"0";"3";"0";"457180";"391207"
"V4mis2";"SILVA (only NR);Eukaryota;Amorphea;Obazoa;Opisthokonta;Nucletmycea;Fungi;Dikarya;Basidiomycota;Agaricomycotina;Agaricomycetes;Agaricales;Tricholomataceae;Lichenomphalia;";"0.0";"0";"3";"3";"0";"3";"0";"457180";"391207"
"V4mis2";"SILVA (only NR);Eukaryota;Amorphea;Obazoa;Opisthokonta;Nucletmycea;Fungi;Dikarya;Basidiomycota;Agaricomycotina;Agaricomycetes;Agaricales;Tricholomataceae;Melanoleuca;";"0.0";"0";"1";"1";"0";"1";"0";"457182";"391207"
"V4mis2";"SILVA (only NR);Eukaryota;Amorphea;Obazoa;Opisthokonta;Nucletmycea;Fungi;Dikarya;Basidiomycota;Agaricomycotina;Agaricomycetes;Agaricales;Tricholomataceae;Mycena;";"0.0";"0";"3";"3";"0";"3";"0";"457180";"391207"
"V4mis2";"SILVA (only NR);Eukaryota;Amorphea;Obazoa;Opisthokonta;Nucletmycea;Fungi;Dikarya;Basidiomycota;Agaricomycotina;Agaricomycetes;Agaricales;Tricholomataceae;Panellus;";"0.0";"0";"1";"1";"0";"1";"0";"457182";"391207"
"V4mis2";"SILVA (only NR);Eukaryota;Amorphea;Obazoa;Opisthokonta;Nucletmycea;Fungi;Dikarya;Basidiomycota;Agaricomycotina;Agaricomycetes;Agaricales;Tricholomataceae;Phyllotopsis;";"0.0";"0";"1";"1";"0";"1";"0";"457182";"391207"
"V4mis2";"SILVA (only NR);Eukaryota;Amorphea;Obazoa;Opisthokonta;Nucletmycea;Fungi;Dikarya;Basidiomycota;Agaricomycotina;Agaricomycetes;Agaricales;Tricholomataceae;Pleurocybella;";"0.0";"0";"1";"1";"0";"1";"0";"457182";"391207"
"V4mis2";"SILVA (only NR);Eukaryota;Amorphea;Obazoa;Opisthokonta;Nucletmycea;Fungi;Dikarya;Basidiomycota;Agaricomycotina;Agaricomycetes;Agaricales;Tricholomataceae;Pogonoloma;";"0.0";"0";"1";"1";"0";"1";"0";"457182";"391207"
"V4mis2";"SILVA (only NR);Eukaryota;Amorphea;Obazoa;Opisthokonta;Nucletmycea;Fungi;Dikarya;Basidiomycota;Agaricomycotina;Agaricomycetes;Agaricales;Tricholomataceae;Porpoloma;";"0.0";"0";"1";"1";"0";"1";"0";"457182";"391207"
"V4mis2";"SILVA (only NR);Eukaryota;Amorphea;Obazoa;Opisthokonta;Nucletmycea;Fungi;Dikarya;Basidiomycota;Agaricomycotina;Agaricomycetes;Agaricales;Tricholomataceae;Porpolomopsis;";"0.0";"0";"1";"1";"0";"1";"0";"457182";"391207"
"V4mis2";"SILVA (only NR);Eukaryota;Amorphea;Obazoa;Opisthokonta;Nucletmycea;Fungi;Dikarya;Basidiomycota;Agaricomycotina;Agaricomycetes;Agaricales;Tricholomataceae;Pseudoarmillariella;";"0.0";"0";"1";"1";"0";"1";"0";"457182";"391207"
"V4mis2";"SILVA (only NR);Eukaryota;Amorphea;Obazoa;Opisthokonta;Nucletmycea;Fungi;Dikarya;Basidiomycota;Agaricomycotina;Agaricomycetes;Agaricales;Tricholomataceae;Pseudobaeospora;";"0.0";"0";"2";"2";"0";"2";"0";"457181";"391207"
"V4mis2";"SILVA (only NR);Eukaryota;Amorphea;Obazoa;Opisthokonta;Nucletmycea;Fungi;Dikarya;Basidiomycota;Agaricomycotina;Agaricomycetes;Agaricales;Tricholomataceae;Pseudoclitocybe;";"0.0";"0";"1";"1";"0";"1";"0";"457182";"391207"
"V4mis2";"SILVA (only NR);Eukaryota;Amorphea;Obazoa;Opisthokonta;Nucletmycea;Fungi;Dikarya;Basidiomycota;Agaricomycotina;Agaricomycetes;Agaricales;Tricholomataceae;Pseudolaccaria;";"0.0";"0";"1";"1";"0";"1";"0";"457182";"391207"
"V4mis2";"SILVA (only NR);Eukaryota;Amorphea;Obazoa;Opisthokonta;Nucletmycea;Fungi;Dikarya;Basidiomycota;Agaricomycotina;Agaricomycetes;Agaricales;Tricholomataceae;Singerocybe;";"0.0";"0";"1";"1";"0";"1";"0";"457182";"391207"
"V4mis2";"SILVA (only NR);Eukaryota;Amorphea;Obazoa;Opisthokonta;Nucletmycea;Fungi;Dikarya;Basidiomycota;Agaricomycotina;Agaricomycetes;Agaricales;Tricholomataceae;Squamanita;";"0.0";"0";"1";"1";"0";"1";"0";"457182";"391207"
"V4mis2";"SILVA (only NR);Eukaryota;Amorphea;Obazoa;Opisthokonta;Nucletmycea;Fungi;Dikarya;Basidiomycota;Agaricomycotina;Agaricomycetes;Agaricales;Tricholomataceae;Tricholoma;";"0.0";"0";"5";"5";"0";"5";"0";"457178";"391207"
"V4mis2";"SILVA (only NR);Eukaryota;Amorphea;Obazoa;Opisthokonta;Nucletmycea;Fungi;Dikarya;Basidiomycota;Agaricomycotina;Agaricomycetes;Agaricales;Tricholomataceae;Tricholomopsis;";"0.0";"0";"1";"1";"0";"1";"0";"457182";"391207"
"V4mis2";"SILVA (only NR);Eukaryota;Amorphea;Obazoa;Opisthokonta;Nucletmycea;Fungi;Dikarya;Basidiomycota;Agaricomycotina;Agaricomycetes;Agaricales;Tulostoma;";"0.0";"0";"1";"1";"0";"1";"0";"457182";"391207"
"V4mis2";"SILVA (only NR);Eukaryota;Amorphea;Obazoa;Opisthokonta;Nucletmycea;Fungi;Dikarya;Basidiomycota;Agaricomycotina;Agaricomycetes;Agaricales;Verrucospora;";"0.0";"0";"1";"1";"0";"1";"0";"457182";"391207"
"V4mis2";"SILVA (only NR);Eukaryota;Amorphea;Obazoa;Opisthokonta;Nucletmycea;Fungi;Dikarya;Basidiomycota;Agaricomycotina;Agaricomycetes;Agaricales;uncultured;";"45.5";"14.4";"22";"22";"10";"12";"0";"457161";"391197"
"V4mis2";"SILVA (only NR);Eukaryota;Amorphea;Obazoa;Opisthokonta;Nucletmycea;Fungi;Dikarya;Basidiomycota;Agaricomycotina;Agaricomycetes;Amylocorticiales;";"0.0";"0";"4";"4";"0";"4";"0";"457179";"391207"
"V4mis2";"SILVA (only NR);Eukaryota;Amorphea;Obazoa;Opisthokonta;Nucletmycea;Fungi;Dikarya;Basidiomycota;Agaricomycotina;Agaricomycetes;Amylocorticiales;Amylocorticiaceae;";"0.0";"0";"4";"4";"0";"4";"0";"457179";"391207"
"V4mis2";"SILVA (only NR);Eukaryota;Amorphea;Obazoa;Opisthokonta;Nucletmycea;Fungi;Dikarya;Basidiomycota;Agaricomycotina;Agaricomycetes;Amylocorticiales;Amylocorticiaceae;Amylocorticium;";"0.0";"0";"2";"2";"0";"2";"0";"457181";"391207"
"V4mis2";"SILVA (only NR);Eukaryota;Amorphea;Obazoa;Opisthokonta;Nucletmycea;Fungi;Dikarya;Basidiomycota;Agaricomycotina;Agaricomycetes;Amylocorticiales;Amylocorticiaceae;Anomoloma;";"0.0";"0";"1";"1";"0";"1";"0";"457182";"391207"
"V4mis2";"SILVA (only NR);Eukaryota;Amorphea;Obazoa;Opisthokonta;Nucletmycea;Fungi;Dikarya;Basidiomycota;Agaricomycotina;Agaricomycetes;Amylocorticiales;Amylocorticiaceae;Anomoporia;";"0.0";"0";"1";"1";"0";"1";"0";"457182";"391207"
"V4mis2";"SILVA (only NR);Eukaryota;Amorphea;Obazoa;Opisthokonta;Nucletmycea;Fungi;Dikarya;Basidiomycota;Agaricomycotina;Agaricomycetes;Atheliales;";"0.0";"0";"3";"3";"0";"3";"0";"457180";"391207"
"V4mis2";"SILVA (only NR);Eukaryota;Amorphea;Obazoa;Opisthokonta;Nucletmycea;Fungi;Dikarya;Basidiomycota;Agaricomycotina;Agaricomycetes;Atheliales;Atheliaceae;";"0.0";"0";"3";"3";"0";"3";"0";"457180";"391207"
"V4mis2";"SILVA (only NR);Eukaryota;Amorphea;Obazoa;Opisthokonta;Nucletmycea;Fungi;Dikarya;Basidiomycota;Agaricomycotina;Agaricomycetes;Atheliales;Atheliaceae;Athelia;";"0.0";"0";"2";"2";"0";"2";"0";"457181";"391207"
"V4mis2";"SILVA (only NR);Eukaryota;Amorphea;Obazoa;Opisthokonta;Nucletmycea;Fungi;Dikarya;Basidiomycota;Agaricomycotina;Agaricomycetes;Atheliales;Atheliaceae;Piloderma;";"0.0";"0";"1";"1";"0";"1";"0";"457182";"391207"
"V4mis2";"SILVA (only NR);Eukaryota;Amorphea;Obazoa;Opisthokonta;Nucletmycea;Fungi;Dikarya;Basidiomycota;Agaricomycotina;Agaricomycetes;Auriculariales;";"3.8";"14.4";"26";"26";"1";"25";"0";"457157";"391206"
"V4mis2";"SILVA (only NR);Eukaryota;Amorphea;Obazoa;Opisthokonta;Nucletmycea;Fungi;Dikarya;Basidiomycota;Agaricomycotina;Agaricomycetes;Auriculariales;Auriculariaceae;";"0.0";"0";"14";"14";"0";"14";"0";"457169";"391207"
"V4mis2";"SILVA (only NR);Eukaryota;Amorphea;Obazoa;Opisthokonta;Nucletmycea;Fungi;Dikarya;Basidiomycota;Agaricomycotina;Agaricomycetes;Auriculariales;Auriculariaceae;Auricularia;";"0.0";"0";"14";"14";"0";"14";"0";"457169";"391207"
"V4mis2";"SILVA (only NR);Eukaryota;Amorphea;Obazoa;Opisthokonta;Nucletmycea;Fungi;Dikarya;Basidiomycota;Agaricomycotina;Agaricomycetes;Auriculariales;Exidiaceae;";"0.0";"0";"5";"5";"0";"5";"0";"457178";"391207"
"V4mis2";"SILVA (only NR);Eukaryota;Amorphea;Obazoa;Opisthokonta;Nucletmycea;Fungi;Dikarya;Basidiomycota;Agaricomycotina;Agaricomycetes;Auriculariales;Exidiaceae;Exidia;";"0.0";"0";"3";"3";"0";"3";"0";"457180";"391207"
"V4mis2";"SILVA (only NR);Eukaryota;Amorphea;Obazoa;Opisthokonta;Nucletmycea;Fungi;Dikarya;Basidiomycota;Agaricomycotina;Agaricomycetes;Auriculariales;Exidiaceae;Exidiopsis;";"0.0";"0";"1";"1";"0";"1";"0";"457182";"391207"
"V4mis2";"SILVA (only NR);Eukaryota;Amorphea;Obazoa;Opisthokonta;Nucletmycea;Fungi;Dikarya;Basidiomycota;Agaricomycotina;Agaricomycetes;Auriculariales;Hyaloriaceae;";"0.0";"0";"6";"6";"0";"6";"0";"457177";"391207"
"V4mis2";"SILVA (only NR);Eukaryota;Amorphea;Obazoa;Opisthokonta;Nucletmycea;Fungi;Dikarya;Basidiomycota;Agaricomycotina;Agaricomycetes;Auriculariales;Hyaloriaceae;Pseudohydnum;";"0.0";"0";"2";"2";"0";"2";"0";"457181";"391207"
"V4mis2";"SILVA (only NR);Eukaryota;Amorphea;Obazoa;Opisthokonta;Nucletmycea;Fungi;Dikarya;Basidiomycota;Agaricomycotina;Agaricomycetes;Auriculariales;Hyaloriaceae;Tremiscus;";"0.0";"0";"4";"4";"0";"4";"0";"457179";"391207"
"V4mis2";"SILVA (only NR);Eukaryota;Amorphea;Obazoa;Opisthokonta;Nucletmycea;Fungi;Dikarya;Basidiomycota;Agaricomycotina;Agaricomycetes;Boletales;";"0.0";"0";"55";"53";"0";"53";"2";"457130";"391207"
"V4mis2";"SILVA (only NR);Eukaryota;Amorphea;Obazoa;Opisthokonta;Nucletmycea;Fungi;Dikarya;Basidiomycota;Agaricomycotina;Agaricomycetes;Boletales;Boletaceae;";"0.0";"0";"9";"9";"0";"9";"0";"457174";"391207"
"V4mis2";"SILVA (only NR);Eukaryota;Amorphea;Obazoa;Opisthokonta;Nucletmycea;Fungi;Dikarya;Basidiomycota;Agaricomycotina;Agaricomycetes;Boletales;Boletaceae;Aureoboletus;";"0.0";"0";"1";"1";"0";"1";"0";"457182";"391207"
"V4mis2";"SILVA (only NR);Eukaryota;Amorphea;Obazoa;Opisthokonta;Nucletmycea;Fungi;Dikarya;Basidiomycota;Agaricomycotina;Agaricomycetes;Boletales;Boletaceae;Boletellus;";"0.0";"0";"1";"1";"0";"1";"0";"457182";"391207"
"V4mis2";"SILVA (only NR);Eukaryota;Amorphea;Obazoa;Opisthokonta;Nucletmycea;Fungi;Dikarya;Basidiomycota;Agaricomycotina;Agaricomycetes;Boletales;Boletaceae;Boletus;";"0.0";"0";"3";"3";"0";"3";"0";"457180";"391207"
"V4mis2";"SILVA (only NR);Eukaryota;Amorphea;Obazoa;Opisthokonta;Nucletmycea;Fungi;Dikarya;Basidiomycota;Agaricomycotina;Agaricomycetes;Boletales;Boletaceae;Chalciporus;";"0.0";"0";"1";"1";"0";"1";"0";"457182";"391207"
"V4mis2";"SILVA (only NR);Eukaryota;Amorphea;Obazoa;Opisthokonta;Nucletmycea;Fungi;Dikarya;Basidiomycota;Agaricomycotina;Agaricomycetes;Boletales;Boletaceae;Strobilomyces;";"0.0";"0";"1";"1";"0";"1";"0";"457182";"391207"
"V4mis2";"SILVA (only NR);Eukaryota;Amorphea;Obazoa;Opisthokonta;Nucletmycea;Fungi;Dikarya;Basidiomycota;Agaricomycotina;Agaricomycetes;Boletales;Boletaceae;Tylopilus;";"0.0";"0";"1";"1";"0";"1";"0";"457182";"391207"
"V4mis2";"SILVA (only NR);Eukaryota;Amorphea;Obazoa;Opisthokonta;Nucletmycea;Fungi;Dikarya;Basidiomycota;Agaricomycotina;Agaricomycetes;Boletales;Boletinellaceae;";"0.0";"0";"2";"2";"0";"2";"0";"457181";"391207"
"V4mis2";"SILVA (only NR);Eukaryota;Amorphea;Obazoa;Opisthokonta;Nucletmycea;Fungi;Dikarya;Basidiomycota;Agaricomycotina;Agaricomycetes;Boletales;Boletinellaceae;Boletinellus;";"0.0";"0";"1";"1";"0";"1";"0";"457182";"391207"
"V4mis2";"SILVA (only NR);Eukaryota;Amorphea;Obazoa;Opisthokonta;Nucletmycea;Fungi;Dikarya;Basidiomycota;Agaricomycotina;Agaricomycetes;Boletales;Boletinellaceae;Phlebopus;";"0.0";"0";"1";"1";"0";"1";"0";"457182";"391207"
"V4mis2";"SILVA (only NR);Eukaryota;Amorphea;Obazoa;Opisthokonta;Nucletmycea;Fungi;Dikarya;Basidiomycota;Agaricomycotina;Agaricomycetes;Boletales;Calostoma;";"0.0";"0";"2";"2";"0";"2";"0";"457181";"391207"
"V4mis2";"SILVA (only NR);Eukaryota;Amorphea;Obazoa;Opisthokonta;Nucletmycea;Fungi;Dikarya;Basidiomycota;Agaricomycotina;Agaricomycetes;Boletales;Coniophoraceae;";"0.0";"0";"5";"5";"0";"5";"0";"457178";"391207"
"V4mis2";"SILVA (only NR);Eukaryota;Amorphea;Obazoa;Opisthokonta;Nucletmycea;Fungi;Dikarya;Basidiomycota;Agaricomycotina;Agaricomycetes;Boletales;Coniophoraceae;Coniophora;";"0.0";"0";"4";"4";"0";"4";"0";"457179";"391207"
"V4mis2";"SILVA (only NR);Eukaryota;Amorphea;Obazoa;Opisthokonta;Nucletmycea;Fungi;Dikarya;Basidiomycota;Agaricomycotina;Agaricomycetes;Boletales;Coniophoraceae;Gyrodontium;";"0.0";"0";"1";"1";"0";"1";"0";"457182";"391207"
"V4mis2";"SILVA (only NR);Eukaryota;Amorphea;Obazoa;Opisthokonta;Nucletmycea;Fungi;Dikarya;Basidiomycota;Agaricomycotina;Agaricomycetes;Boletales;Gomphidiaceae;";"0.0";"0";"2";"1";"0";"1";"1";"457182";"391207"
"V4mis2";"SILVA (only NR);Eukaryota;Amorphea;Obazoa;Opisthokonta;Nucletmycea;Fungi;Dikarya;Basidiomycota;Agaricomycotina;Agaricomycetes;Boletales;Gomphidiaceae;Gomphidius;";"0.0";"0";"2";"1";"0";"1";"1";"457182";"391207"
"V4mis2";"SILVA (only NR);Eukaryota;Amorphea;Obazoa;Opisthokonta;Nucletmycea;Fungi;Dikarya;Basidiomycota;Agaricomycotina;Agaricomycetes;Boletales;Gyroporus;";"0.0";"0";"1";"1";"0";"1";"0";"457182";"391207"
"V4mis2";"SILVA (only NR);Eukaryota;Amorphea;Obazoa;Opisthokonta;Nucletmycea;Fungi;Dikarya;Basidiomycota;Agaricomycotina;Agaricomycetes;Boletales;Hygrophoropsis;";"0.0";"0";"1";"1";"0";"1";"0";"457182";"391207"
"V4mis2";"SILVA (only NR);Eukaryota;Amorphea;Obazoa;Opisthokonta;Nucletmycea;Fungi;Dikarya;Basidiomycota;Agaricomycotina;Agaricomycetes;Boletales;Incertae Sedis;";"0.0";"0";"3";"3";"0";"3";"0";"457180";"391207"
"V4mis2";"SILVA (only NR);Eukaryota;Amorphea;Obazoa;Opisthokonta;Nucletmycea;Fungi;Dikarya;Basidiomycota;Agaricomycotina;Agaricomycetes;Boletales;Incertae Sedis;Leucogyrophana;";"0.0";"0";"3";"3";"0";"3";"0";"457180";"391207"
"V4mis2";"SILVA (only NR);Eukaryota;Amorphea;Obazoa;Opisthokonta;Nucletmycea;Fungi;Dikarya;Basidiomycota;Agaricomycotina;Agaricomycetes;Boletales;Melanogaster;";"0.0";"0";"1";"1";"0";"1";"0";"457182";"391207"
"V4mis2";"SILVA (only NR);Eukaryota;Amorphea;Obazoa;Opisthokonta;Nucletmycea;Fungi;Dikarya;Basidiomycota;Agaricomycotina;Agaricomycetes;Boletales;Paxillaceae;";"0.0";"0";"3";"3";"0";"3";"0";"457180";"391207"
"V4mis2";"SILVA (only NR);Eukaryota;Amorphea;Obazoa;Opisthokonta;Nucletmycea;Fungi;Dikarya;Basidiomycota;Agaricomycotina;Agaricomycetes;Boletales;Paxillaceae;Hydnomerulius;";"0.0";"0";"1";"1";"0";"1";"0";"457182";"391207"
"V4mis2";"SILVA (only NR);Eukaryota;Amorphea;Obazoa;Opisthokonta;Nucletmycea;Fungi;Dikarya;Basidiomycota;Agaricomycotina;Agaricomycetes;Boletales;Paxillaceae;Paxillus;";"0.0";"0";"2";"2";"0";"2";"0";"457181";"391207"
"V4mis2";"SILVA (only NR);Eukaryota;Amorphea;Obazoa;Opisthokonta;Nucletmycea;Fungi;Dikarya;Basidiomycota;Agaricomycotina;Agaricomycetes;Boletales;Phylloporus;";"0.0";"0";"1";"1";"0";"1";"0";"457182";"391207"
"V4mis2";"SILVA (only NR);Eukaryota;Amorphea;Obazoa;Opisthokonta;Nucletmycea;Fungi;Dikarya;Basidiomycota;Agaricomycotina;Agaricomycetes;Boletales;Pisolithus;";"0.0";"0";"1";"1";"0";"1";"0";"457182";"391207"
"V4mis2";"SILVA (only NR);Eukaryota;Amorphea;Obazoa;Opisthokonta;Nucletmycea;Fungi;Dikarya;Basidiomycota;Agaricomycotina;Agaricomycetes;Boletales;Rhizopogonaceae;";"0.0";"0";"2";"2";"0";"2";"0";"457181";"391207"
"V4mis2";"SILVA (only NR);Eukaryota;Amorphea;Obazoa;Opisthokonta;Nucletmycea;Fungi;Dikarya;Basidiomycota;Agaricomycotina;Agaricomycetes;Boletales;Rhizopogonaceae;Rhizopogon;";"0.0";"0";"2";"2";"0";"2";"0";"457181";"391207"
"V4mis2";"SILVA (only NR);Eukaryota;Amorphea;Obazoa;Opisthokonta;Nucletmycea;Fungi;Dikarya;Basidiomycota;Agaricomycotina;Agaricomycetes;Boletales;Sclerodermataceae;";"0.0";"0";"2";"2";"0";"2";"0";"457181";"391207"
"V4mis2";"SILVA (only NR);Eukaryota;Amorphea;Obazoa;Opisthokonta;Nucletmycea;Fungi;Dikarya;Basidiomycota;Agaricomycotina;Agaricomycetes;Boletales;Sclerodermataceae;Scleroderma;";"0.0";"0";"2";"2";"0";"2";"0";"457181";"391207"
"V4mis2";"SILVA (only NR);Eukaryota;Amorphea;Obazoa;Opisthokonta;Nucletmycea;Fungi;Dikarya;Basidiomycota;Agaricomycotina;Agaricomycetes;Boletales;Serpulaceae;";"0.0";"0";"7";"7";"0";"7";"0";"457176";"391207"
"V4mis2";"SILVA (only NR);Eukaryota;Amorphea;Obazoa;Opisthokonta;Nucletmycea;Fungi;Dikarya;Basidiomycota;Agaricomycotina;Agaricomycetes;Boletales;Serpulaceae;Serpula;";"0.0";"0";"7";"7";"0";"7";"0";"457176";"391207"
"V4mis2";"SILVA (only NR);Eukaryota;Amorphea;Obazoa;Opisthokonta;Nucletmycea;Fungi;Dikarya;Basidiomycota;Agaricomycotina;Agaricomycetes;Boletales;Suillaceae;";"0.0";"0";"2";"1";"0";"1";"1";"457182";"391207"
"V4mis2";"SILVA (only NR);Eukaryota;Amorphea;Obazoa;Opisthokonta;Nucletmycea;Fungi;Dikarya;Basidiomycota;Agaricomycotina;Agaricomycetes;Boletales;Suillaceae;Suillus;";"0.0";"0";"2";"1";"0";"1";"1";"457182";"391207"
"V4mis2";"SILVA (only NR);Eukaryota;Amorphea;Obazoa;Opisthokonta;Nucletmycea;Fungi;Dikarya;Basidiomycota;Agaricomycotina;Agaricomycetes;Boletales;Tapinella;";"0.0";"0";"1";"1";"0";"1";"0";"457182";"391207"
"V4mis2";"SILVA (only NR);Eukaryota;Amorphea;Obazoa;Opisthokonta;Nucletmycea;Fungi;Dikarya;Basidiomycota;Agaricomycotina;Agaricomycetes;Boletales;Tapinellaceae;";"0.0";"0";"3";"3";"0";"3";"0";"457180";"391207"
"V4mis2";"SILVA (only NR);Eukaryota;Amorphea;Obazoa;Opisthokonta;Nucletmycea;Fungi;Dikarya;Basidiomycota;Agaricomycotina;Agaricomycetes;Boletales;Tapinellaceae;Pseudomerulius;";"0.0";"0";"1";"1";"0";"1";"0";"457182";"391207"
"V4mis2";"SILVA (only NR);Eukaryota;Amorphea;Obazoa;Opisthokonta;Nucletmycea;Fungi;Dikarya;Basidiomycota;Agaricomycotina;Agaricomycetes;Boletales;Tapinellaceae;Tapinella;";"0.0";"0";"2";"2";"0";"2";"0";"457181";"391207"
"V4mis2";"SILVA (only NR);Eukaryota;Amorphea;Obazoa;Opisthokonta;Nucletmycea;Fungi;Dikarya;Basidiomycota;Agaricomycotina;Agaricomycetes;Boletales;Truncocolumella;";"0.0";"0";"1";"1";"0";"1";"0";"457182";"391207"
"V4mis2";"SILVA (only NR);Eukaryota;Amorphea;Obazoa;Opisthokonta;Nucletmycea;Fungi;Dikarya;Basidiomycota;Agaricomycotina;Agaricomycetes;Boletales;uncultured;";"0.0";"0";"5";"5";"0";"5";"0";"457178";"391207"
"V4mis2";"SILVA (only NR);Eukaryota;Amorphea;Obazoa;Opisthokonta;Nucletmycea;Fungi;Dikarya;Basidiomycota;Agaricomycotina;Agaricomycetes;Cantharellales;";"36.1";"14.4";"37";"36";"13";"23";"1";"457147";"391194"
"V4mis2";"SILVA (only NR);Eukaryota;Amorphea;Obazoa;Opisthokonta;Nucletmycea;Fungi;Dikarya;Basidiomycota;Agaricomycotina;Agaricomycetes;Cantharellales;Botryobasidiaceae;";"0.0";"0";"5";"5";"0";"5";"0";"457178";"391207"
"V4mis2";"SILVA (only NR);Eukaryota;Amorphea;Obazoa;Opisthokonta;Nucletmycea;Fungi;Dikarya;Basidiomycota;Agaricomycotina;Agaricomycetes;Cantharellales;Botryobasidiaceae;Botryobasidium;";"0.0";"0";"4";"4";"0";"4";"0";"457179";"391207"
"V4mis2";"SILVA (only NR);Eukaryota;Amorphea;Obazoa;Opisthokonta;Nucletmycea;Fungi;Dikarya;Basidiomycota;Agaricomycotina;Agaricomycetes;Cantharellales;Botryobasidiaceae;Botryohypochnus;";"0.0";"0";"1";"1";"0";"1";"0";"457182";"391207"
"V4mis2";"SILVA (only NR);Eukaryota;Amorphea;Obazoa;Opisthokonta;Nucletmycea;Fungi;Dikarya;Basidiomycota;Agaricomycotina;Agaricomycetes;Cantharellales;Cantharellaceae;";"100.0";"14.4";"6";"6";"6";"0";"0";"457177";"391201"
"V4mis2";"SILVA (only NR);Eukaryota;Amorphea;Obazoa;Opisthokonta;Nucletmycea;Fungi;Dikarya;Basidiomycota;Agaricomycotina;Agaricomycetes;Cantharellales;Cantharellaceae;Cantharellus;";"100.0";"14.4";"4";"4";"4";"0";"0";"457179";"391203"
"V4mis2";"SILVA (only NR);Eukaryota;Amorphea;Obazoa;Opisthokonta;Nucletmycea;Fungi;Dikarya;Basidiomycota;Agaricomycotina;Agaricomycetes;Cantharellales;Cantharellaceae;Craterellus;";"100.0";"14.4";"2";"2";"2";"0";"0";"457181";"391205"
"V4mis2";"SILVA (only NR);Eukaryota;Amorphea;Obazoa;Opisthokonta;Nucletmycea;Fungi;Dikarya;Basidiomycota;Agaricomycotina;Agaricomycetes;Cantharellales;Ceratobasidiaceae;";"0.0";"0";"11";"11";"0";"11";"0";"457172";"391207"
"V4mis2";"SILVA (only NR);Eukaryota;Amorphea;Obazoa;Opisthokonta;Nucletmycea;Fungi;Dikarya;Basidiomycota;Agaricomycotina;Agaricomycetes;Cantharellales;Ceratobasidiaceae;Ceratobasidium;";"0.0";"0";"1";"1";"0";"1";"0";"457182";"391207"
"V4mis2";"SILVA (only NR);Eukaryota;Amorphea;Obazoa;Opisthokonta;Nucletmycea;Fungi;Dikarya;Basidiomycota;Agaricomycotina;Agaricomycetes;Cantharellales;Ceratobasidiaceae;Rhizoctonia;";"0.0";"0";"5";"5";"0";"5";"0";"457178";"391207"
"V4mis2";"SILVA (only NR);Eukaryota;Amorphea;Obazoa;Opisthokonta;Nucletmycea;Fungi;Dikarya;Basidiomycota;Agaricomycotina;Agaricomycetes;Cantharellales;Ceratobasidiaceae;Thanatephorus;";"0.0";"0";"3";"3";"0";"3";"0";"457180";"391207"
"V4mis2";"SILVA (only NR);Eukaryota;Amorphea;Obazoa;Opisthokonta;Nucletmycea;Fungi;Dikarya;Basidiomycota;Agaricomycotina;Agaricomycetes;Cantharellales;Clavulinaceae;";"33.3";"14.4";"7";"6";"2";"4";"1";"457177";"391205"
"V4mis2";"SILVA (only NR);Eukaryota;Amorphea;Obazoa;Opisthokonta;Nucletmycea;Fungi;Dikarya;Basidiomycota;Agaricomycotina;Agaricomycetes;Cantharellales;Clavulinaceae;Clavulicium;";"66.7";"14.4";"3";"3";"2";"1";"0";"457180";"391205"
"V4mis2";"SILVA (only NR);Eukaryota;Amorphea;Obazoa;Opisthokonta;Nucletmycea;Fungi;Dikarya;Basidiomycota;Agaricomycotina;Agaricomycetes;Cantharellales;Clavulinaceae;Clavulina;";"0.0";"0";"1";"1";"0";"1";"0";"457182";"391207"
"V4mis2";"SILVA (only NR);Eukaryota;Amorphea;Obazoa;Opisthokonta;Nucletmycea;Fungi;Dikarya;Basidiomycota;Agaricomycotina;Agaricomycetes;Cantharellales;Clavulinaceae;Multiclavula;";"0.0";"0";"2";"1";"0";"1";"1";"457182";"391207"
"V4mis2";"SILVA (only NR);Eukaryota;Amorphea;Obazoa;Opisthokonta;Nucletmycea;Fungi;Dikarya;Basidiomycota;Agaricomycotina;Agaricomycetes;Cantharellales;Hydnum;";"0.0";"0";"1";"1";"0";"1";"0";"457182";"391207"
"V4mis2";"SILVA (only NR);Eukaryota;Amorphea;Obazoa;Opisthokonta;Nucletmycea;Fungi;Dikarya;Basidiomycota;Agaricomycotina;Agaricomycetes;Cantharellales;Incertae Sedis;";"33.3";"14.4";"3";"3";"1";"2";"0";"457180";"391206"
"V4mis2";"SILVA (only NR);Eukaryota;Amorphea;Obazoa;Opisthokonta;Nucletmycea;Fungi;Dikarya;Basidiomycota;Agaricomycotina;Agaricomycetes;Cantharellales;Incertae Sedis;Burgella;";"0.0";"0";"1";"1";"0";"1";"0";"457182";"391207"
"V4mis2";"SILVA (only NR);Eukaryota;Amorphea;Obazoa;Opisthokonta;Nucletmycea;Fungi;Dikarya;Basidiomycota;Agaricomycotina;Agaricomycetes;Cantharellales;Incertae Sedis;Marchandiobasidium;";"0.0";"0";"1";"1";"0";"1";"0";"457182";"391207"
"V4mis2";"SILVA (only NR);Eukaryota;Amorphea;Obazoa;Opisthokonta;Nucletmycea;Fungi;Dikarya;Basidiomycota;Agaricomycotina;Agaricomycetes;Cantharellales;Incertae Sedis;Minimedusa;";"100.0";"14.4";"1";"1";"1";"0";"0";"457182";"391206"
"V4mis2";"SILVA (only NR);Eukaryota;Amorphea;Obazoa;Opisthokonta;Nucletmycea;Fungi;Dikarya;Basidiomycota;Agaricomycotina;Agaricomycetes;Cantharellales;Tulasnellaceae;";"100.0";"14.4";"4";"4";"4";"0";"0";"457179";"391203"
"V4mis2";"SILVA (only NR);Eukaryota;Amorphea;Obazoa;Opisthokonta;Nucletmycea;Fungi;Dikarya;Basidiomycota;Agaricomycotina;Agaricomycetes;Cantharellales;Tulasnellaceae;Tulasnella;";"100.0";"14.4";"4";"4";"4";"0";"0";"457179";"391203"
"V4mis2";"SILVA (only NR);Eukaryota;Amorphea;Obazoa;Opisthokonta;Nucletmycea;Fungi;Dikarya;Basidiomycota;Agaricomycotina;Agaricomycetes;Corticiales;";"6.4";"14.4";"78";"78";"5";"73";"0";"457105";"391202"
"V4mis2";"SILVA (only NR);Eukaryota;Amorphea;Obazoa;Opisthokonta;Nucletmycea;Fungi;Dikarya;Basidiomycota;Agaricomycotina;Agaricomycetes;Corticiales;Corticiaceae;";"6.6";"14.4";"76";"76";"5";"71";"0";"457107";"391202"
"V4mis2";"SILVA (only NR);Eukaryota;Amorphea;Obazoa;Opisthokonta;Nucletmycea;Fungi;Dikarya;Basidiomycota;Agaricomycotina;Agaricomycetes;Corticiales;Corticiaceae;Acantholichen;";"0.0";"0";"2";"2";"0";"2";"0";"457181";"391207"
"V4mis2";"SILVA (only NR);Eukaryota;Amorphea;Obazoa;Opisthokonta;Nucletmycea;Fungi;Dikarya;Basidiomycota;Agaricomycotina;Agaricomycetes;Corticiales;Corticiaceae;Candelabrochaete;";"0.0";"0";"1";"1";"0";"1";"0";"457182";"391207"
"V4mis2";"SILVA (only NR);Eukaryota;Amorphea;Obazoa;Opisthokonta;Nucletmycea;Fungi;Dikarya;Basidiomycota;Agaricomycotina;Agaricomycetes;Corticiales;Corticiaceae;Dentocorticium;";"0.0";"0";"1";"1";"0";"1";"0";"457182";"391207"
"V4mis2";"SILVA (only NR);Eukaryota;Amorphea;Obazoa;Opisthokonta;Nucletmycea;Fungi;Dikarya;Basidiomycota;Agaricomycotina;Agaricomycetes;Corticiales;Corticiaceae;Fibricium;";"0.0";"0";"1";"1";"0";"1";"0";"457182";"391207"
"V4mis2";"SILVA (only NR);Eukaryota;Amorphea;Obazoa;Opisthokonta;Nucletmycea;Fungi;Dikarya;Basidiomycota;Agaricomycotina;Agaricomycetes;Corticiales;Corticiaceae;Haplotrichum;";"0.0";"0";"1";"1";"0";"1";"0";"457182";"391207"
"V4mis2";"SILVA (only NR);Eukaryota;Amorphea;Obazoa;Opisthokonta;Nucletmycea;Fungi;Dikarya;Basidiomycota;Agaricomycotina;Agaricomycetes;Corticiales;Corticiaceae;Hyphodontia;";"0.0";"0";"11";"11";"0";"11";"0";"457172";"391207"
"V4mis2";"SILVA (only NR);Eukaryota;Amorphea;Obazoa;Opisthokonta;Nucletmycea;Fungi;Dikarya;Basidiomycota;Agaricomycotina;Agaricomycetes;Corticiales;Corticiaceae;Hypochnicium;";"0.0";"0";"1";"1";"0";"1";"0";"457182";"391207"
"V4mis2";"SILVA (only NR);Eukaryota;Amorphea;Obazoa;Opisthokonta;Nucletmycea;Fungi;Dikarya;Basidiomycota;Agaricomycotina;Agaricomycetes;Corticiales;Corticiaceae;Laetisaria;";"100.0";"14.4";"1";"1";"1";"0";"0";"457182";"391206"
"V4mis2";"SILVA (only NR);Eukaryota;Amorphea;Obazoa;Opisthokonta;Nucletmycea;Fungi;Dikarya;Basidiomycota;Agaricomycotina;Agaricomycetes;Corticiales;Corticiaceae;Limonomyces;";"0.0";"0";"3";"3";"0";"3";"0";"457180";"391207"
"V4mis2";"SILVA (only NR);Eukaryota;Amorphea;Obazoa;Opisthokonta;Nucletmycea;Fungi;Dikarya;Basidiomycota;Agaricomycotina;Agaricomycetes;Corticiales;Corticiaceae;Lindtneria;";"0.0";"0";"1";"1";"0";"1";"0";"457182";"391207"
"V4mis2";"SILVA (only NR);Eukaryota;Amorphea;Obazoa;Opisthokonta;Nucletmycea;Fungi;Dikarya;Basidiomycota;Agaricomycotina;Agaricomycetes;Corticiales;Corticiaceae;Odonticium;";"0.0";"0";"1";"1";"0";"1";"0";"457182";"391207"
"V4mis2";"SILVA (only NR);Eukaryota;Amorphea;Obazoa;Opisthokonta;Nucletmycea;Fungi;Dikarya;Basidiomycota;Agaricomycotina;Agaricomycetes;Corticiales;Corticiaceae;Peniophorella;";"0.0";"0";"5";"5";"0";"5";"0";"457178";"391207"
"V4mis2";"SILVA (only NR);Eukaryota;Amorphea;Obazoa;Opisthokonta;Nucletmycea;Fungi;Dikarya;Basidiomycota;Agaricomycotina;Agaricomycetes;Corticiales;Corticiaceae;Phlebia;";"0.0";"0";"14";"14";"0";"14";"0";"457169";"391207"
"V4mis2";"SILVA (only NR);Eukaryota;Amorphea;Obazoa;Opisthokonta;Nucletmycea;Fungi;Dikarya;Basidiomycota;Agaricomycotina;Agaricomycetes;Corticiales;Corticiaceae;Pulcherricium;";"0.0";"0";"1";"1";"0";"1";"0";"457182";"391207"
"V4mis2";"SILVA (only NR);Eukaryota;Amorphea;Obazoa;Opisthokonta;Nucletmycea;Fungi;Dikarya;Basidiomycota;Agaricomycotina;Agaricomycetes;Corticiales;Corticiaceae;Repetobasidium;";"100.0";"14.4";"1";"1";"1";"0";"0";"457182";"391206"
"V4mis2";"SILVA (only NR);Eukaryota;Amorphea;Obazoa;Opisthokonta;Nucletmycea;Fungi;Dikarya;Basidiomycota;Agaricomycotina;Agaricomycetes;Corticiales;Corticiaceae;Rhizochaete;";"0.0";"0";"1";"1";"0";"1";"0";"457182";"391207"
"V4mis2";"SILVA (only NR);Eukaryota;Amorphea;Obazoa;Opisthokonta;Nucletmycea;Fungi;Dikarya;Basidiomycota;Agaricomycotina;Agaricomycetes;Corticiales;Corticiaceae;Rogersella;";"0.0";"0";"1";"1";"0";"1";"0";"457182";"391207"
"V4mis2";"SILVA (only NR);Eukaryota;Amorphea;Obazoa;Opisthokonta;Nucletmycea;Fungi;Dikarya;Basidiomycota;Agaricomycotina;Agaricomycetes;Corticiales;Corticiaceae;Schizopora;";"100.0";"14.4";"1";"1";"1";"0";"0";"457182";"391206"
"V4mis2";"SILVA (only NR);Eukaryota;Amorphea;Obazoa;Opisthokonta;Nucletmycea;Fungi;Dikarya;Basidiomycota;Agaricomycotina;Agaricomycetes;Corticiales;Corticiaceae;Sistotrema;";"8.7";"14.4";"23";"23";"2";"21";"0";"457160";"391205"
"V4mis2";"SILVA (only NR);Eukaryota;Amorphea;Obazoa;Opisthokonta;Nucletmycea;Fungi;Dikarya;Basidiomycota;Agaricomycotina;Agaricomycetes;Corticiales;Dendrocorticium;";"0.0";"0";"1";"1";"0";"1";"0";"457182";"391207"
"V4mis2";"SILVA (only NR);Eukaryota;Amorphea;Obazoa;Opisthokonta;Nucletmycea;Fungi;Dikarya;Basidiomycota;Agaricomycotina;Agaricomycetes;Corticiales;Vuilleminia;";"0.0";"0";"1";"1";"0";"1";"0";"457182";"391207"
"V4mis2";"SILVA (only NR);Eukaryota;Amorphea;Obazoa;Opisthokonta;Nucletmycea;Fungi;Dikarya;Basidiomycota;Agaricomycotina;Agaricomycetes;Geastrales;";"0.0";"0";"2";"2";"0";"2";"0";"457181";"391207"
"V4mis2";"SILVA (only NR);Eukaryota;Amorphea;Obazoa;Opisthokonta;Nucletmycea;Fungi;Dikarya;Basidiomycota;Agaricomycotina;Agaricomycetes;Geastrales;Geastraceae;";"0.0";"0";"2";"2";"0";"2";"0";"457181";"391207"
"V4mis2";"SILVA (only NR);Eukaryota;Amorphea;Obazoa;Opisthokonta;Nucletmycea;Fungi;Dikarya;Basidiomycota;Agaricomycotina;Agaricomycetes;Geastrales;Geastraceae;Geastrum;";"0.0";"0";"1";"1";"0";"1";"0";"457182";"391207"
"V4mis2";"SILVA (only NR);Eukaryota;Amorphea;Obazoa;Opisthokonta;Nucletmycea;Fungi;Dikarya;Basidiomycota;Agaricomycotina;Agaricomycetes;Geastrales;Geastraceae;Sphaerobolus;";"0.0";"0";"1";"1";"0";"1";"0";"457182";"391207"
"V4mis2";"SILVA (only NR);Eukaryota;Amorphea;Obazoa;Opisthokonta;Nucletmycea;Fungi;Dikarya;Basidiomycota;Agaricomycotina;Agaricomycetes;Gloeophyllales;";"0.0";"0";"8";"8";"0";"8";"0";"457175";"391207"
"V4mis2";"SILVA (only NR);Eukaryota;Amorphea;Obazoa;Opisthokonta;Nucletmycea;Fungi;Dikarya;Basidiomycota;Agaricomycotina;Agaricomycetes;Gloeophyllales;Gloeophyllaceae;";"0.0";"0";"8";"8";"0";"8";"0";"457175";"391207"
"V4mis2";"SILVA (only NR);Eukaryota;Amorphea;Obazoa;Opisthokonta;Nucletmycea;Fungi;Dikarya;Basidiomycota;Agaricomycotina;Agaricomycetes;Gloeophyllales;Gloeophyllaceae;Gloeophyllum;";"0.0";"0";"3";"3";"0";"3";"0";"457180";"391207"
"V4mis2";"SILVA (only NR);Eukaryota;Amorphea;Obazoa;Opisthokonta;Nucletmycea;Fungi;Dikarya;Basidiomycota;Agaricomycotina;Agaricomycetes;Gloeophyllales;Gloeophyllaceae;Griseoporia;";"0.0";"0";"1";"1";"0";"1";"0";"457182";"391207"
"V4mis2";"SILVA (only NR);Eukaryota;Amorphea;Obazoa;Opisthokonta;Nucletmycea;Fungi;Dikarya;Basidiomycota;Agaricomycotina;Agaricomycetes;Gloeophyllales;Gloeophyllaceae;Neolentinus;";"0.0";"0";"1";"1";"0";"1";"0";"457182";"391207"
"V4mis2";"SILVA (only NR);Eukaryota;Amorphea;Obazoa;Opisthokonta;Nucletmycea;Fungi;Dikarya;Basidiomycota;Agaricomycotina;Agaricomycetes;Gloeophyllales;Gloeophyllaceae;Veluticeps;";"0.0";"0";"3";"3";"0";"3";"0";"457180";"391207"
"V4mis2";"SILVA (only NR);Eukaryota;Amorphea;Obazoa;Opisthokonta;Nucletmycea;Fungi;Dikarya;Basidiomycota;Agaricomycotina;Agaricomycetes;Gomphales;";"0.0";"0";"5";"5";"0";"5";"0";"457178";"391207"
"V4mis2";"SILVA (only NR);Eukaryota;Amorphea;Obazoa;Opisthokonta;Nucletmycea;Fungi;Dikarya;Basidiomycota;Agaricomycotina;Agaricomycetes;Gomphales;Gautieria;";"0.0";"0";"1";"1";"0";"1";"0";"457182";"391207"
"V4mis2";"SILVA (only NR);Eukaryota;Amorphea;Obazoa;Opisthokonta;Nucletmycea;Fungi;Dikarya;Basidiomycota;Agaricomycotina;Agaricomycetes;Gomphales;Gomphaceae;";"0.0";"0";"4";"4";"0";"4";"0";"457179";"391207"
"V4mis2";"SILVA (only NR);Eukaryota;Amorphea;Obazoa;Opisthokonta;Nucletmycea;Fungi;Dikarya;Basidiomycota;Agaricomycotina;Agaricomycetes;Gomphales;Gomphaceae;Clavariadelphus;";"0.0";"0";"1";"1";"0";"1";"0";"457182";"391207"
"V4mis2";"SILVA (only NR);Eukaryota;Amorphea;Obazoa;Opisthokonta;Nucletmycea;Fungi;Dikarya;Basidiomycota;Agaricomycotina;Agaricomycetes;Gomphales;Gomphaceae;Kavinia;";"0.0";"0";"1";"1";"0";"1";"0";"457182";"391207"
"V4mis2";"SILVA (only NR);Eukaryota;Amorphea;Obazoa;Opisthokonta;Nucletmycea;Fungi;Dikarya;Basidiomycota;Agaricomycotina;Agaricomycetes;Gomphales;Gomphaceae;Ramaria;";"0.0";"0";"2";"2";"0";"2";"0";"457181";"391207"
"V4mis2";"SILVA (only NR);Eukaryota;Amorphea;Obazoa;Opisthokonta;Nucletmycea;Fungi;Dikarya;Basidiomycota;Agaricomycotina;Agaricomycetes;Hymenochaetales;";"47.4";"14.4";"19";"19";"9";"10";"0";"457164";"391198"
"V4mis2";"SILVA (only NR);Eukaryota;Amorphea;Obazoa;Opisthokonta;Nucletmycea;Fungi;Dikarya;Basidiomycota;Agaricomycotina;Agaricomycetes;Hymenochaetales;Basidioradulum;";"0.0";"0";"1";"1";"0";"1";"0";"457182";"391207"
"V4mis2";"SILVA (only NR);Eukaryota;Amorphea;Obazoa;Opisthokonta;Nucletmycea;Fungi;Dikarya;Basidiomycota;Agaricomycotina;Agaricomycetes;Hymenochaetales;Coltricia;";"100.0";"14.4";"1";"1";"1";"0";"0";"457182";"391206"
"V4mis2";"SILVA (only NR);Eukaryota;Amorphea;Obazoa;Opisthokonta;Nucletmycea;Fungi;Dikarya;Basidiomycota;Agaricomycotina;Agaricomycetes;Hymenochaetales;Hymenochaetaceae;";"72.7";"14.4";"11";"11";"8";"3";"0";"457172";"391199"
"V4mis2";"SILVA (only NR);Eukaryota;Amorphea;Obazoa;Opisthokonta;Nucletmycea;Fungi;Dikarya;Basidiomycota;Agaricomycotina;Agaricomycetes;Hymenochaetales;Hymenochaetaceae;Fomitiporia;";"100.0";"14.4";"1";"1";"1";"0";"0";"457182";"391206"
"V4mis2";"SILVA (only NR);Eukaryota;Amorphea;Obazoa;Opisthokonta;Nucletmycea;Fungi;Dikarya;Basidiomycota;Agaricomycotina;Agaricomycetes;Hymenochaetales;Hymenochaetaceae;Hydnochaete;";"100.0";"14.4";"1";"1";"1";"0";"0";"457182";"391206"
"V4mis2";"SILVA (only NR);Eukaryota;Amorphea;Obazoa;Opisthokonta;Nucletmycea;Fungi;Dikarya;Basidiomycota;Agaricomycotina;Agaricomycetes;Hymenochaetales;Hymenochaetaceae;Hymenochaetopsis;";"0.0";"0";"1";"1";"0";"1";"0";"457182";"391207"
"V4mis2";"SILVA (only NR);Eukaryota;Amorphea;Obazoa;Opisthokonta;Nucletmycea;Fungi;Dikarya;Basidiomycota;Agaricomycotina;Agaricomycetes;Hymenochaetales;Hymenochaetaceae;Inonotus;";"100.0";"14.4";"1";"1";"1";"0";"0";"457182";"391206"
"V4mis2";"SILVA (only NR);Eukaryota;Amorphea;Obazoa;Opisthokonta;Nucletmycea;Fungi;Dikarya;Basidiomycota;Agaricomycotina;Agaricomycetes;Hymenochaetales;Hymenochaetaceae;Phaeolus;";"100.0";"14.4";"1";"1";"1";"0";"0";"457182";"391206"
"V4mis2";"SILVA (only NR);Eukaryota;Amorphea;Obazoa;Opisthokonta;Nucletmycea;Fungi;Dikarya;Basidiomycota;Agaricomycotina;Agaricomycetes;Hymenochaetales;Hymenochaetaceae;Phellinus;";"0.0";"0";"2";"2";"0";"2";"0";"457181";"391207"
"V4mis2";"SILVA (only NR);Eukaryota;Amorphea;Obazoa;Opisthokonta;Nucletmycea;Fungi;Dikarya;Basidiomycota;Agaricomycotina;Agaricomycetes;Hymenochaetales;Hymenochaetaceae;Sanghuangporus;";"100.0";"14.4";"1";"1";"1";"0";"0";"457182";"391206"
"V4mis2";"SILVA (only NR);Eukaryota;Amorphea;Obazoa;Opisthokonta;Nucletmycea;Fungi;Dikarya;Basidiomycota;Agaricomycotina;Agaricomycetes;Hymenochaetales;Hymenochaetaceae;Tropicoporus;";"100.0";"14.4";"2";"2";"2";"0";"0";"457181";"391205"
"V4mis2";"SILVA (only NR);Eukaryota;Amorphea;Obazoa;Opisthokonta;Nucletmycea;Fungi;Dikarya;Basidiomycota;Agaricomycotina;Agaricomycetes;Hymenochaetales;Schizoporaceae;";"0.0";"0";"2";"2";"0";"2";"0";"457181";"391207"
"V4mis2";"SILVA (only NR);Eukaryota;Amorphea;Obazoa;Opisthokonta;Nucletmycea;Fungi;Dikarya;Basidiomycota;Agaricomycotina;Agaricomycetes;Hymenochaetales;Schizoporaceae;Xylodon;";"0.0";"0";"2";"2";"0";"2";"0";"457181";"391207"
"V4mis2";"SILVA (only NR);Eukaryota;Amorphea;Obazoa;Opisthokonta;Nucletmycea;Fungi;Dikarya;Basidiomycota;Agaricomycotina;Agaricomycetes;Hymenochaetales;Tubulicrinaceae;";"0.0";"0";"3";"3";"0";"3";"0";"457180";"391207"
"V4mis2";"SILVA (only NR);Eukaryota;Amorphea;Obazoa;Opisthokonta;Nucletmycea;Fungi;Dikarya;Basidiomycota;Agaricomycotina;Agaricomycetes;Hymenochaetales;Tubulicrinaceae;Tubulicrinis;";"0.0";"0";"3";"3";"0";"3";"0";"457180";"391207"
"V4mis2";"SILVA (only NR);Eukaryota;Amorphea;Obazoa;Opisthokonta;Nucletmycea;Fungi;Dikarya;Basidiomycota;Agaricomycotina;Agaricomycetes;Incertae Sedis;";"33.3";"14.4";"6";"6";"2";"4";"0";"457177";"391205"
"V4mis2";"SILVA (only NR);Eukaryota;Amorphea;Obazoa;Opisthokonta;Nucletmycea;Fungi;Dikarya;Basidiomycota;Agaricomycotina;Agaricomycetes;Incertae Sedis;Incertae Sedis;";"0.0";"0";"2";"2";"0";"2";"0";"457181";"391207"
"V4mis2";"SILVA (only NR);Eukaryota;Amorphea;Obazoa;Opisthokonta;Nucletmycea;Fungi;Dikarya;Basidiomycota;Agaricomycotina;Agaricomycetes;Incertae Sedis;Incertae Sedis;Giulia;";"0.0";"0";"1";"1";"0";"1";"0";"457182";"391207"
"V4mis2";"SILVA (only NR);Eukaryota;Amorphea;Obazoa;Opisthokonta;Nucletmycea;Fungi;Dikarya;Basidiomycota;Agaricomycotina;Agaricomycetes;Incertae Sedis;Incertae Sedis;Tremellodendropsis;";"0.0";"0";"1";"1";"0";"1";"0";"457182";"391207"
"V4mis2";"SILVA (only NR);Eukaryota;Amorphea;Obazoa;Opisthokonta;Nucletmycea;Fungi;Dikarya;Basidiomycota;Agaricomycotina;Agaricomycetes;Incertae Sedis;Resinicium;";"0.0";"0";"2";"2";"0";"2";"0";"457181";"391207"
"V4mis2";"SILVA (only NR);Eukaryota;Amorphea;Obazoa;Opisthokonta;Nucletmycea;Fungi;Dikarya;Basidiomycota;Agaricomycotina;Agaricomycetes;Incertae Sedis;Stereopsidaceae;";"100.0";"14.4";"2";"2";"2";"0";"0";"457181";"391205"
"V4mis2";"SILVA (only NR);Eukaryota;Amorphea;Obazoa;Opisthokonta;Nucletmycea;Fungi;Dikarya;Basidiomycota;Agaricomycotina;Agaricomycetes;Incertae Sedis;Stereopsidaceae;Stereopsis;";"100.0";"14.4";"2";"2";"2";"0";"0";"457181";"391205"
"V4mis2";"SILVA (only NR);Eukaryota;Amorphea;Obazoa;Opisthokonta;Nucletmycea;Fungi;Dikarya;Basidiomycota;Agaricomycotina;Agaricomycetes;Jaapiales;";"0.0";"0";"1";"1";"0";"1";"0";"457182";"391207"
"V4mis2";"SILVA (only NR);Eukaryota;Amorphea;Obazoa;Opisthokonta;Nucletmycea;Fungi;Dikarya;Basidiomycota;Agaricomycotina;Agaricomycetes;Jaapiales;Jaapiaceae;";"0.0";"0";"1";"1";"0";"1";"0";"457182";"391207"
"V4mis2";"SILVA (only NR);Eukaryota;Amorphea;Obazoa;Opisthokonta;Nucletmycea;Fungi;Dikarya;Basidiomycota;Agaricomycotina;Agaricomycetes;Jaapiales;Jaapiaceae;Jaapia;";"0.0";"0";"1";"1";"0";"1";"0";"457182";"391207"
"V4mis2";"SILVA (only NR);Eukaryota;Amorphea;Obazoa;Opisthokonta;Nucletmycea;Fungi;Dikarya;Basidiomycota;Agaricomycotina;Agaricomycetes;Lepidostromatales;";"0.0";"0";"2";"2";"0";"2";"0";"457181";"391207"
"V4mis2";"SILVA (only NR);Eukaryota;Amorphea;Obazoa;Opisthokonta;Nucletmycea;Fungi;Dikarya;Basidiomycota;Agaricomycotina;Agaricomycetes;Lepidostromatales;Lepidostromataceae;";"0.0";"0";"2";"2";"0";"2";"0";"457181";"391207"
"V4mis2";"SILVA (only NR);Eukaryota;Amorphea;Obazoa;Opisthokonta;Nucletmycea;Fungi;Dikarya;Basidiomycota;Agaricomycotina;Agaricomycetes;Lepidostromatales;Lepidostromataceae;Lepidostroma;";"0.0";"0";"2";"2";"0";"2";"0";"457181";"391207"
"V4mis2";"SILVA (only NR);Eukaryota;Amorphea;Obazoa;Opisthokonta;Nucletmycea;Fungi;Dikarya;Basidiomycota;Agaricomycotina;Agaricomycetes;Parmastomyces;";"0.0";"0";"1";"1";"0";"1";"0";"457182";"391207"
"V4mis2";"SILVA (only NR);Eukaryota;Amorphea;Obazoa;Opisthokonta;Nucletmycea;Fungi;Dikarya;Basidiomycota;Agaricomycotina;Agaricomycetes;Phallales;";"0.0";"0";"2";"2";"0";"2";"0";"457181";"391207"
"V4mis2";"SILVA (only NR);Eukaryota;Amorphea;Obazoa;Opisthokonta;Nucletmycea;Fungi;Dikarya;Basidiomycota;Agaricomycotina;Agaricomycetes;Phallales;Clathraceae;";"0.0";"0";"1";"1";"0";"1";"0";"457182";"391207"
"V4mis2";"SILVA (only NR);Eukaryota;Amorphea;Obazoa;Opisthokonta;Nucletmycea;Fungi;Dikarya;Basidiomycota;Agaricomycotina;Agaricomycetes;Phallales;Clathraceae;Pseudocolus;";"0.0";"0";"1";"1";"0";"1";"0";"457182";"391207"
"V4mis2";"SILVA (only NR);Eukaryota;Amorphea;Obazoa;Opisthokonta;Nucletmycea;Fungi;Dikarya;Basidiomycota;Agaricomycotina;Agaricomycetes;Phallales;Phallaceae;";"0.0";"0";"1";"1";"0";"1";"0";"457182";"391207"
"V4mis2";"SILVA (only NR);Eukaryota;Amorphea;Obazoa;Opisthokonta;Nucletmycea;Fungi;Dikarya;Basidiomycota;Agaricomycotina;Agaricomycetes;Phallales;Phallaceae;Phallus;";"0.0";"0";"1";"1";"0";"1";"0";"457182";"391207"
"V4mis2";"SILVA (only NR);Eukaryota;Amorphea;Obazoa;Opisthokonta;Nucletmycea;Fungi;Dikarya;Basidiomycota;Agaricomycotina;Agaricomycetes;Polyporales;";"1.3";"14.4";"156";"149";"2";"147";"7";"457034";"391205"
"V4mis2";"SILVA (only NR);Eukaryota;Amorphea;Obazoa;Opisthokonta;Nucletmycea;Fungi;Dikarya;Basidiomycota;Agaricomycotina;Agaricomycetes;Polyporales;Adustoporia;";"0.0";"0";"1";"1";"0";"1";"0";"457182";"391207"
"V4mis2";"SILVA (only NR);Eukaryota;Amorphea;Obazoa;Opisthokonta;Nucletmycea;Fungi;Dikarya;Basidiomycota;Agaricomycotina;Agaricomycetes;Polyporales;Amylocystis;";"0.0";"0";"1";"1";"0";"1";"0";"457182";"391207"
"V4mis2";"SILVA (only NR);Eukaryota;Amorphea;Obazoa;Opisthokonta;Nucletmycea;Fungi;Dikarya;Basidiomycota;Agaricomycotina;Agaricomycetes;Polyporales;Antrodiella;";"0.0";"0";"1";"1";"0";"1";"0";"457182";"391207"
"V4mis2";"SILVA (only NR);Eukaryota;Amorphea;Obazoa;Opisthokonta;Nucletmycea;Fungi;Dikarya;Basidiomycota;Agaricomycotina;Agaricomycetes;Polyporales;Auriporia;";"0.0";"0";"1";"1";"0";"1";"0";"457182";"391207"
"V4mis2";"SILVA (only NR);Eukaryota;Amorphea;Obazoa;Opisthokonta;Nucletmycea;Fungi;Dikarya;Basidiomycota;Agaricomycotina;Agaricomycetes;Polyporales;Brunneoporus;";"0.0";"0";"1";"1";"0";"1";"0";"457182";"391207"
"V4mis2";"SILVA (only NR);Eukaryota;Amorphea;Obazoa;Opisthokonta;Nucletmycea;Fungi;Dikarya;Basidiomycota;Agaricomycotina;Agaricomycetes;Polyporales;Ceriporiopsis;";"0.0";"0";"1";"1";"0";"1";"0";"457182";"391207"
"V4mis2";"SILVA (only NR);Eukaryota;Amorphea;Obazoa;Opisthokonta;Nucletmycea;Fungi;Dikarya;Basidiomycota;Agaricomycotina;Agaricomycetes;Polyporales;Climacodon;";"0.0";"0";"2";"2";"0";"2";"0";"457181";"391207"
"V4mis2";"SILVA (only NR);Eukaryota;Amorphea;Obazoa;Opisthokonta;Nucletmycea;Fungi;Dikarya;Basidiomycota;Agaricomycotina;Agaricomycetes;Polyporales;Coriolaceae;";"0.0";"0";"14";"10";"0";"10";"4";"457173";"391207"
"V4mis2";"SILVA (only NR);Eukaryota;Amorphea;Obazoa;Opisthokonta;Nucletmycea;Fungi;Dikarya;Basidiomycota;Agaricomycotina;Agaricomycetes;Polyporales;Coriolaceae;Abortiporus;";"0.0";"0";"1";"1";"0";"1";"0";"457182";"391207"
"V4mis2";"SILVA (only NR);Eukaryota;Amorphea;Obazoa;Opisthokonta;Nucletmycea;Fungi;Dikarya;Basidiomycota;Agaricomycotina;Agaricomycetes;Polyporales;Coriolaceae;Coriolopsis;";"0.0";"0";"8";"4";"0";"4";"4";"457179";"391207"
"V4mis2";"SILVA (only NR);Eukaryota;Amorphea;Obazoa;Opisthokonta;Nucletmycea;Fungi;Dikarya;Basidiomycota;Agaricomycotina;Agaricomycetes;Polyporales;Coriolaceae;Meripilus;";"0.0";"0";"1";"1";"0";"1";"0";"457182";"391207"
"V4mis2";"SILVA (only NR);Eukaryota;Amorphea;Obazoa;Opisthokonta;Nucletmycea;Fungi;Dikarya;Basidiomycota;Agaricomycotina;Agaricomycetes;Polyporales;Coriolaceae;Oxyporus;";"0.0";"0";"1";"1";"0";"1";"0";"457182";"391207"
"V4mis2";"SILVA (only NR);Eukaryota;Amorphea;Obazoa;Opisthokonta;Nucletmycea;Fungi;Dikarya;Basidiomycota;Agaricomycotina;Agaricomycetes;Polyporales;Coriolaceae;Rigidoporus;";"0.0";"0";"3";"3";"0";"3";"0";"457180";"391207"
"V4mis2";"SILVA (only NR);Eukaryota;Amorphea;Obazoa;Opisthokonta;Nucletmycea;Fungi;Dikarya;Basidiomycota;Agaricomycotina;Agaricomycetes;Polyporales;Dacryobolus;";"0.0";"0";"1";"1";"0";"1";"0";"457182";"391207"
"V4mis2";"SILVA (only NR);Eukaryota;Amorphea;Obazoa;Opisthokonta;Nucletmycea;Fungi;Dikarya;Basidiomycota;Agaricomycotina;Agaricomycetes;Polyporales;Daedalea;";"0.0";"0";"1";"1";"0";"1";"0";"457182";"391207"
"V4mis2";"SILVA (only NR);Eukaryota;Amorphea;Obazoa;Opisthokonta;Nucletmycea;Fungi;Dikarya;Basidiomycota;Agaricomycotina;Agaricomycetes;Polyporales;Donkia;";"0.0";"0";"1";"1";"0";"1";"0";"457182";"391207"
"V4mis2";"SILVA (only NR);Eukaryota;Amorphea;Obazoa;Opisthokonta;Nucletmycea;Fungi;Dikarya;Basidiomycota;Agaricomycotina;Agaricomycetes;Polyporales;Donkioporia;";"0.0";"0";"1";"1";"0";"1";"0";"457182";"391207"
"V4mis2";"SILVA (only NR);Eukaryota;Amorphea;Obazoa;Opisthokonta;Nucletmycea;Fungi;Dikarya;Basidiomycota;Agaricomycotina;Agaricomycetes;Polyporales;Emmia;";"0.0";"0";"1";"1";"0";"1";"0";"457182";"391207"
"V4mis2";"SILVA (only NR);Eukaryota;Amorphea;Obazoa;Opisthokonta;Nucletmycea;Fungi;Dikarya;Basidiomycota;Agaricomycotina;Agaricomycetes;Polyporales;Flaviporus;";"0.0";"0";"1";"1";"0";"1";"0";"457182";"391207"
"V4mis2";"SILVA (only NR);Eukaryota;Amorphea;Obazoa;Opisthokonta;Nucletmycea;Fungi;Dikarya;Basidiomycota;Agaricomycotina;Agaricomycetes;Polyporales;Fomes;";"0.0";"0";"1";"1";"0";"1";"0";"457182";"391207"
"V4mis2";"SILVA (only NR);Eukaryota;Amorphea;Obazoa;Opisthokonta;Nucletmycea;Fungi;Dikarya;Basidiomycota;Agaricomycotina;Agaricomycetes;Polyporales;Fomitopsidaceae;";"0.0";"0";"1";"1";"0";"1";"0";"457182";"391207"
"V4mis2";"SILVA (only NR);Eukaryota;Amorphea;Obazoa;Opisthokonta;Nucletmycea;Fungi;Dikarya;Basidiomycota;Agaricomycotina;Agaricomycetes;Polyporales;Fomitopsidaceae;Antrodia;";"0.0";"0";"1";"1";"0";"1";"0";"457182";"391207"
"V4mis2";"SILVA (only NR);Eukaryota;Amorphea;Obazoa;Opisthokonta;Nucletmycea;Fungi;Dikarya;Basidiomycota;Agaricomycotina;Agaricomycetes;Polyporales;Fomitopsis;";"0.0";"0";"2";"2";"0";"2";"0";"457181";"391207"
"V4mis2";"SILVA (only NR);Eukaryota;Amorphea;Obazoa;Opisthokonta;Nucletmycea;Fungi;Dikarya;Basidiomycota;Agaricomycotina;Agaricomycetes;Polyporales;Ganoderma;";"0.0";"0";"2";"2";"0";"2";"0";"457181";"391207"
"V4mis2";"SILVA (only NR);Eukaryota;Amorphea;Obazoa;Opisthokonta;Nucletmycea;Fungi;Dikarya;Basidiomycota;Agaricomycotina;Agaricomycetes;Polyporales;Hyphodermella;";"0.0";"0";"1";"1";"0";"1";"0";"457182";"391207"
"V4mis2";"SILVA (only NR);Eukaryota;Amorphea;Obazoa;Opisthokonta;Nucletmycea;Fungi;Dikarya;Basidiomycota;Agaricomycotina;Agaricomycetes;Polyporales;Incertae Sedis;";"0.0";"0";"41";"41";"0";"41";"0";"457142";"391207"
"V4mis2";"SILVA (only NR);Eukaryota;Amorphea;Obazoa;Opisthokonta;Nucletmycea;Fungi;Dikarya;Basidiomycota;Agaricomycotina;Agaricomycetes;Polyporales;Incertae Sedis;Burgoa;";"0.0";"0";"2";"2";"0";"2";"0";"457181";"391207"
"V4mis2";"SILVA (only NR);Eukaryota;Amorphea;Obazoa;Opisthokonta;Nucletmycea;Fungi;Dikarya;Basidiomycota;Agaricomycotina;Agaricomycetes;Polyporales;Incertae Sedis;Diplomitoporus;";"0.0";"0";"4";"4";"0";"4";"0";"457179";"391207"
"V4mis2";"SILVA (only NR);Eukaryota;Amorphea;Obazoa;Opisthokonta;Nucletmycea;Fungi;Dikarya;Basidiomycota;Agaricomycotina;Agaricomycetes;Polyporales;Incertae Sedis;Gelatoporiaceae;";"0.0";"0";"1";"1";"0";"1";"0";"457182";"391207"
"V4mis2";"SILVA (only NR);Eukaryota;Amorphea;Obazoa;Opisthokonta;Nucletmycea;Fungi;Dikarya;Basidiomycota;Agaricomycotina;Agaricomycetes;Polyporales;Incertae Sedis;Gelatoporiaceae;Gelatoporia;";"0.0";"0";"1";"1";"0";"1";"0";"457182";"391207"
"V4mis2";"SILVA (only NR);Eukaryota;Amorphea;Obazoa;Opisthokonta;Nucletmycea;Fungi;Dikarya;Basidiomycota;Agaricomycotina;Agaricomycetes;Polyporales;Incertae Sedis;Marchandiomyces;";"0.0";"0";"7";"7";"0";"7";"0";"457176";"391207"
"V4mis2";"SILVA (only NR);Eukaryota;Amorphea;Obazoa;Opisthokonta;Nucletmycea;Fungi;Dikarya;Basidiomycota;Agaricomycotina;Agaricomycetes;Polyporales;Incertae Sedis;Melanoporia;";"0.0";"0";"1";"1";"0";"1";"0";"457182";"391207"
"V4mis2";"SILVA (only NR);Eukaryota;Amorphea;Obazoa;Opisthokonta;Nucletmycea;Fungi;Dikarya;Basidiomycota;Agaricomycotina;Agaricomycetes;Polyporales;Incertae Sedis;Oligoporus;";"0.0";"0";"1";"1";"0";"1";"0";"457182";"391207"
"V4mis2";"SILVA (only NR);Eukaryota;Amorphea;Obazoa;Opisthokonta;Nucletmycea;Fungi;Dikarya;Basidiomycota;Agaricomycotina;Agaricomycetes;Polyporales;Incertae Sedis;Steccherinum;";"0.0";"0";"1";"1";"0";"1";"0";"457182";"391207"
"V4mis2";"SILVA (only NR);Eukaryota;Amorphea;Obazoa;Opisthokonta;Nucletmycea;Fungi;Dikarya;Basidiomycota;Agaricomycotina;Agaricomycetes;Polyporales;Incertae Sedis;Taiwanofungus;";"0.0";"0";"3";"3";"0";"3";"0";"457180";"391207"
"V4mis2";"SILVA (only NR);Eukaryota;Amorphea;Obazoa;Opisthokonta;Nucletmycea;Fungi;Dikarya;Basidiomycota;Agaricomycotina;Agaricomycetes;Polyporales;Incertae Sedis;Trametes;";"0.0";"0";"12";"12";"0";"12";"0";"457171";"391207"
"V4mis2";"SILVA (only NR);Eukaryota;Amorphea;Obazoa;Opisthokonta;Nucletmycea;Fungi;Dikarya;Basidiomycota;Agaricomycotina;Agaricomycetes;Polyporales;Incertae Sedis;Tretopileus;";"0.0";"0";"1";"1";"0";"1";"0";"457182";"391207"
"V4mis2";"SILVA (only NR);Eukaryota;Amorphea;Obazoa;Opisthokonta;Nucletmycea;Fungi;Dikarya;Basidiomycota;Agaricomycotina;Agaricomycetes;Polyporales;Incertae Sedis;Trichaptum;";"0.0";"0";"6";"6";"0";"6";"0";"457177";"391207"
"V4mis2";"SILVA (only NR);Eukaryota;Amorphea;Obazoa;Opisthokonta;Nucletmycea;Fungi;Dikarya;Basidiomycota;Agaricomycotina;Agaricomycetes;Polyporales;Irpex;";"0.0";"0";"1";"1";"0";"1";"0";"457182";"391207"
"V4mis2";"SILVA (only NR);Eukaryota;Amorphea;Obazoa;Opisthokonta;Nucletmycea;Fungi;Dikarya;Basidiomycota;Agaricomycotina;Agaricomycetes;Polyporales;Irpicaceae;";"0.0";"0";"5";"5";"0";"5";"0";"457178";"391207"
"V4mis2";"SILVA (only NR);Eukaryota;Amorphea;Obazoa;Opisthokonta;Nucletmycea;Fungi;Dikarya;Basidiomycota;Agaricomycotina;Agaricomycetes;Polyporales;Irpicaceae;Ceriporia;";"0.0";"0";"4";"4";"0";"4";"0";"457179";"391207"
"V4mis2";"SILVA (only NR);Eukaryota;Amorphea;Obazoa;Opisthokonta;Nucletmycea;Fungi;Dikarya;Basidiomycota;Agaricomycotina;Agaricomycetes;Polyporales;Irpicaceae;Leptoporus;";"0.0";"0";"1";"1";"0";"1";"0";"457182";"391207"
"V4mis2";"SILVA (only NR);Eukaryota;Amorphea;Obazoa;Opisthokonta;Nucletmycea;Fungi;Dikarya;Basidiomycota;Agaricomycotina;Agaricomycetes;Polyporales;Junghuhnia;";"0.0";"0";"1";"1";"0";"1";"0";"457182";"391207"
"V4mis2";"SILVA (only NR);Eukaryota;Amorphea;Obazoa;Opisthokonta;Nucletmycea;Fungi;Dikarya;Basidiomycota;Agaricomycotina;Agaricomycetes;Polyporales;Laetiporaceae;";"100.0";"14.4";"2";"2";"2";"0";"0";"457181";"391205"
"V4mis2";"SILVA (only NR);Eukaryota;Amorphea;Obazoa;Opisthokonta;Nucletmycea;Fungi;Dikarya;Basidiomycota;Agaricomycotina;Agaricomycetes;Polyporales;Laetiporaceae;Wolfiporia;";"100.0";"14.4";"2";"2";"2";"0";"0";"457181";"391205"
"V4mis2";"SILVA (only NR);Eukaryota;Amorphea;Obazoa;Opisthokonta;Nucletmycea;Fungi;Dikarya;Basidiomycota;Agaricomycotina;Agaricomycetes;Polyporales;Lentinus;";"0.0";"0";"1";"1";"0";"1";"0";"457182";"391207"
"V4mis2";"SILVA (only NR);Eukaryota;Amorphea;Obazoa;Opisthokonta;Nucletmycea;Fungi;Dikarya;Basidiomycota;Agaricomycotina;Agaricomycetes;Polyporales;Meruliaceae;";"0.0";"0";"5";"5";"0";"5";"0";"457178";"391207"
"V4mis2";"SILVA (only NR);Eukaryota;Amorphea;Obazoa;Opisthokonta;Nucletmycea;Fungi;Dikarya;Basidiomycota;Agaricomycotina;Agaricomycetes;Polyporales;Meruliaceae;Gloeoporus;";"0.0";"0";"3";"3";"0";"3";"0";"457180";"391207"
"V4mis2";"SILVA (only NR);Eukaryota;Amorphea;Obazoa;Opisthokonta;Nucletmycea;Fungi;Dikarya;Basidiomycota;Agaricomycotina;Agaricomycetes;Polyporales;Meruliaceae;Skvortzovia;";"0.0";"0";"1";"1";"0";"1";"0";"457182";"391207"
"V4mis2";"SILVA (only NR);Eukaryota;Amorphea;Obazoa;Opisthokonta;Nucletmycea;Fungi;Dikarya;Basidiomycota;Agaricomycotina;Agaricomycetes;Polyporales;Neolentiporus;";"0.0";"0";"1";"1";"0";"1";"0";"457182";"391207"
"V4mis2";"SILVA (only NR);Eukaryota;Amorphea;Obazoa;Opisthokonta;Nucletmycea;Fungi;Dikarya;Basidiomycota;Agaricomycotina;Agaricomycetes;Polyporales;Phanerochaetaceae;";"0.0";"0";"11";"9";"0";"9";"2";"457174";"391207"
"V4mis2";"SILVA (only NR);Eukaryota;Amorphea;Obazoa;Opisthokonta;Nucletmycea;Fungi;Dikarya;Basidiomycota;Agaricomycotina;Agaricomycetes;Polyporales;Phanerochaetaceae;Bjerkandera;";"0.0";"0";"6";"6";"0";"6";"0";"457177";"391207"
"V4mis2";"SILVA (only NR);Eukaryota;Amorphea;Obazoa;Opisthokonta;Nucletmycea;Fungi;Dikarya;Basidiomycota;Agaricomycotina;Agaricomycetes;Polyporales;Phanerochaetaceae;Hapalopilus;";"0.0";"0";"1";"1";"0";"1";"0";"457182";"391207"
"V4mis2";"SILVA (only NR);Eukaryota;Amorphea;Obazoa;Opisthokonta;Nucletmycea;Fungi;Dikarya;Basidiomycota;Agaricomycotina;Agaricomycetes;Polyporales;Phanerochaetaceae;Phanerochaete;";"0.0";"0";"2";"0";"0";"0";"2";"457183";"391207"
"V4mis2";"SILVA (only NR);Eukaryota;Amorphea;Obazoa;Opisthokonta;Nucletmycea;Fungi;Dikarya;Basidiomycota;Agaricomycotina;Agaricomycetes;Polyporales;Phanerochaetaceae;Phlebiopsis;";"0.0";"0";"2";"2";"0";"2";"0";"457181";"391207"
"V4mis2";"SILVA (only NR);Eukaryota;Amorphea;Obazoa;Opisthokonta;Nucletmycea;Fungi;Dikarya;Basidiomycota;Agaricomycotina;Agaricomycetes;Polyporales;Polyporaceae;";"0.0";"0";"21";"20";"0";"20";"1";"457163";"391207"
"V4mis2";"SILVA (only NR);Eukaryota;Amorphea;Obazoa;Opisthokonta;Nucletmycea;Fungi;Dikarya;Basidiomycota;Agaricomycotina;Agaricomycetes;Polyporales;Polyporaceae;Amyloporia;";"0.0";"0";"2";"2";"0";"2";"0";"457181";"391207"
"V4mis2";"SILVA (only NR);Eukaryota;Amorphea;Obazoa;Opisthokonta;Nucletmycea;Fungi;Dikarya;Basidiomycota;Agaricomycotina;Agaricomycetes;Polyporales;Polyporaceae;Cerrena;";"0.0";"0";"3";"3";"0";"3";"0";"457180";"391207"
"V4mis2";"SILVA (only NR);Eukaryota;Amorphea;Obazoa;Opisthokonta;Nucletmycea;Fungi;Dikarya;Basidiomycota;Agaricomycotina;Agaricomycetes;Polyporales;Polyporaceae;Datronia;";"0.0";"0";"1";"1";"0";"1";"0";"457182";"391207"
"V4mis2";"SILVA (only NR);Eukaryota;Amorphea;Obazoa;Opisthokonta;Nucletmycea;Fungi;Dikarya;Basidiomycota;Agaricomycotina;Agaricomycetes;Polyporales;Polyporaceae;Fibroporia;";"0.0";"0";"2";"2";"0";"2";"0";"457181";"391207"
"V4mis2";"SILVA (only NR);Eukaryota;Amorphea;Obazoa;Opisthokonta;Nucletmycea;Fungi;Dikarya;Basidiomycota;Agaricomycotina;Agaricomycetes;Polyporales;Polyporaceae;Haploporus;";"0.0";"0";"1";"1";"0";"1";"0";"457182";"391207"
"V4mis2";"SILVA (only NR);Eukaryota;Amorphea;Obazoa;Opisthokonta;Nucletmycea;Fungi;Dikarya;Basidiomycota;Agaricomycotina;Agaricomycetes;Polyporales;Polyporaceae;Hexagonia;";"0.0";"0";"2";"2";"0";"2";"0";"457181";"391207"
"V4mis2";"SILVA (only NR);Eukaryota;Amorphea;Obazoa;Opisthokonta;Nucletmycea;Fungi;Dikarya;Basidiomycota;Agaricomycotina;Agaricomycetes;Polyporales;Polyporaceae;Lignosus;";"0.0";"0";"2";"1";"0";"1";"1";"457182";"391207"
"V4mis2";"SILVA (only NR);Eukaryota;Amorphea;Obazoa;Opisthokonta;Nucletmycea;Fungi;Dikarya;Basidiomycota;Agaricomycotina;Agaricomycetes;Polyporales;Polyporaceae;Megasporoporiella;";"0.0";"0";"1";"1";"0";"1";"0";"457182";"391207"
"V4mis2";"SILVA (only NR);Eukaryota;Amorphea;Obazoa;Opisthokonta;Nucletmycea;Fungi;Dikarya;Basidiomycota;Agaricomycotina;Agaricomycetes;Polyporales;Polyporaceae;Perenniporia;";"0.0";"0";"4";"4";"0";"4";"0";"457179";"391207"
"V4mis2";"SILVA (only NR);Eukaryota;Amorphea;Obazoa;Opisthokonta;Nucletmycea;Fungi;Dikarya;Basidiomycota;Agaricomycotina;Agaricomycetes;Polyporales;Polyporaceae;Spongipellis;";"0.0";"0";"2";"2";"0";"2";"0";"457181";"391207"
"V4mis2";"SILVA (only NR);Eukaryota;Amorphea;Obazoa;Opisthokonta;Nucletmycea;Fungi;Dikarya;Basidiomycota;Agaricomycotina;Agaricomycetes;Polyporales;Polyporus;";"0.0";"0";"1";"1";"0";"1";"0";"457182";"391207"
"V4mis2";"SILVA (only NR);Eukaryota;Amorphea;Obazoa;Opisthokonta;Nucletmycea;Fungi;Dikarya;Basidiomycota;Agaricomycotina;Agaricomycetes;Polyporales;Poria;";"0.0";"0";"1";"1";"0";"1";"0";"457182";"391207"
"V4mis2";"SILVA (only NR);Eukaryota;Amorphea;Obazoa;Opisthokonta;Nucletmycea;Fungi;Dikarya;Basidiomycota;Agaricomycotina;Agaricomycetes;Polyporales;Porostereum;";"0.0";"0";"1";"1";"0";"1";"0";"457182";"391207"
"V4mis2";"SILVA (only NR);Eukaryota;Amorphea;Obazoa;Opisthokonta;Nucletmycea;Fungi;Dikarya;Basidiomycota;Agaricomycotina;Agaricomycetes;Polyporales;Postia;";"0.0";"0";"3";"3";"0";"3";"0";"457180";"391207"
"V4mis2";"SILVA (only NR);Eukaryota;Amorphea;Obazoa;Opisthokonta;Nucletmycea;Fungi;Dikarya;Basidiomycota;Agaricomycotina;Agaricomycetes;Polyporales;Sparassidaceae;";"0.0";"0";"11";"11";"0";"11";"0";"457172";"391207"
"V4mis2";"SILVA (only NR);Eukaryota;Amorphea;Obazoa;Opisthokonta;Nucletmycea;Fungi;Dikarya;Basidiomycota;Agaricomycotina;Agaricomycetes;Polyporales;Sparassidaceae;Sparassis;";"0.0";"0";"11";"11";"0";"11";"0";"457172";"391207"
"V4mis2";"SILVA (only NR);Eukaryota;Amorphea;Obazoa;Opisthokonta;Nucletmycea;Fungi;Dikarya;Basidiomycota;Agaricomycotina;Agaricomycetes;Polyporales;Tinctoporellus;";"0.0";"0";"1";"1";"0";"1";"0";"457182";"391207"
"V4mis2";"SILVA (only NR);Eukaryota;Amorphea;Obazoa;Opisthokonta;Nucletmycea;Fungi;Dikarya;Basidiomycota;Agaricomycotina;Agaricomycetes;Polyporales;Tyromyces;";"0.0";"0";"2";"2";"0";"2";"0";"457181";"391207"
"V4mis2";"SILVA (only NR);Eukaryota;Amorphea;Obazoa;Opisthokonta;Nucletmycea;Fungi;Dikarya;Basidiomycota;Agaricomycotina;Agaricomycetes;Polyporales;[Ceraceomyces];";"0.0";"0";"1";"1";"0";"1";"0";"457182";"391207"
"V4mis2";"SILVA (only NR);Eukaryota;Amorphea;Obazoa;Opisthokonta;Nucletmycea;Fungi;Dikarya;Basidiomycota;Agaricomycotina;Agaricomycetes;Polyporales;basidiomycete;";"0.0";"0";"1";"1";"0";"1";"0";"457182";"391207"
"V4mis2";"SILVA (only NR);Eukaryota;Amorphea;Obazoa;Opisthokonta;Nucletmycea;Fungi;Dikarya;Basidiomycota;Agaricomycotina;Agaricomycetes;Polyporales;uncultured;";"0.0";"0";"4";"4";"0";"4";"0";"457179";"391207"
"V4mis2";"SILVA (only NR);Eukaryota;Amorphea;Obazoa;Opisthokonta;Nucletmycea;Fungi;Dikarya;Basidiomycota;Agaricomycotina;Agaricomycetes;Russulales;";"2.6";"14.4";"77";"76";"2";"74";"1";"457107";"391205"
"V4mis2";"SILVA (only NR);Eukaryota;Amorphea;Obazoa;Opisthokonta;Nucletmycea;Fungi;Dikarya;Basidiomycota;Agaricomycotina;Agaricomycetes;Russulales;Albatrellaceae;";"0.0";"0";"2";"2";"0";"2";"0";"457181";"391207"
"V4mis2";"SILVA (only NR);Eukaryota;Amorphea;Obazoa;Opisthokonta;Nucletmycea;Fungi;Dikarya;Basidiomycota;Agaricomycotina;Agaricomycetes;Russulales;Albatrellaceae;Albatrellus;";"0.0";"0";"2";"2";"0";"2";"0";"457181";"391207"
"V4mis2";"SILVA (only NR);Eukaryota;Amorphea;Obazoa;Opisthokonta;Nucletmycea;Fungi;Dikarya;Basidiomycota;Agaricomycotina;Agaricomycetes;Russulales;Auriscalpiaceae;";"0.0";"0";"6";"6";"0";"6";"0";"457177";"391207"
"V4mis2";"SILVA (only NR);Eukaryota;Amorphea;Obazoa;Opisthokonta;Nucletmycea;Fungi;Dikarya;Basidiomycota;Agaricomycotina;Agaricomycetes;Russulales;Auriscalpiaceae;Artomyces;";"0.0";"0";"2";"2";"0";"2";"0";"457181";"391207"
"V4mis2";"SILVA (only NR);Eukaryota;Amorphea;Obazoa;Opisthokonta;Nucletmycea;Fungi;Dikarya;Basidiomycota;Agaricomycotina;Agaricomycetes;Russulales;Auriscalpiaceae;Auriscalpium;";"0.0";"0";"2";"2";"0";"2";"0";"457181";"391207"
"V4mis2";"SILVA (only NR);Eukaryota;Amorphea;Obazoa;Opisthokonta;Nucletmycea;Fungi;Dikarya;Basidiomycota;Agaricomycotina;Agaricomycetes;Russulales;Auriscalpiaceae;Lentinellus;";"0.0";"0";"2";"2";"0";"2";"0";"457181";"391207"
"V4mis2";"SILVA (only NR);Eukaryota;Amorphea;Obazoa;Opisthokonta;Nucletmycea;Fungi;Dikarya;Basidiomycota;Agaricomycotina;Agaricomycetes;Russulales;Bondarzewiaceae;";"0.0";"0";"5";"5";"0";"5";"0";"457178";"391207"
"V4mis2";"SILVA (only NR);Eukaryota;Amorphea;Obazoa;Opisthokonta;Nucletmycea;Fungi;Dikarya;Basidiomycota;Agaricomycotina;Agaricomycetes;Russulales;Bondarzewiaceae;Bondarzewia;";"0.0";"0";"1";"1";"0";"1";"0";"457182";"391207"
"V4mis2";"SILVA (only NR);Eukaryota;Amorphea;Obazoa;Opisthokonta;Nucletmycea;Fungi;Dikarya;Basidiomycota;Agaricomycotina;Agaricomycetes;Russulales;Bondarzewiaceae;Heterobasidion;";"0.0";"0";"4";"4";"0";"4";"0";"457179";"391207"
"V4mis2";"SILVA (only NR);Eukaryota;Amorphea;Obazoa;Opisthokonta;Nucletmycea;Fungi;Dikarya;Basidiomycota;Agaricomycotina;Agaricomycetes;Russulales;Dentipellis;";"0.0";"0";"1";"1";"0";"1";"0";"457182";"391207"
"V4mis2";"SILVA (only NR);Eukaryota;Amorphea;Obazoa;Opisthokonta;Nucletmycea;Fungi;Dikarya;Basidiomycota;Agaricomycotina;Agaricomycetes;Russulales;Echinodontiaceae;";"0.0";"0";"2";"2";"0";"2";"0";"457181";"391207"
"V4mis2";"SILVA (only NR);Eukaryota;Amorphea;Obazoa;Opisthokonta;Nucletmycea;Fungi;Dikarya;Basidiomycota;Agaricomycotina;Agaricomycetes;Russulales;Echinodontiaceae;Echinodontium;";"0.0";"0";"2";"2";"0";"2";"0";"457181";"391207"
"V4mis2";"SILVA (only NR);Eukaryota;Amorphea;Obazoa;Opisthokonta;Nucletmycea;Fungi;Dikarya;Basidiomycota;Agaricomycotina;Agaricomycetes;Russulales;Haloaleurodiscus;";"100.0";"14.4";"1";"1";"1";"0";"0";"457182";"391206"
"V4mis2";"SILVA (only NR);Eukaryota;Amorphea;Obazoa;Opisthokonta;Nucletmycea;Fungi;Dikarya;Basidiomycota;Agaricomycotina;Agaricomycetes;Russulales;Hericiaceae;";"0.0";"0";"4";"4";"0";"4";"0";"457179";"391207"
"V4mis2";"SILVA (only NR);Eukaryota;Amorphea;Obazoa;Opisthokonta;Nucletmycea;Fungi;Dikarya;Basidiomycota;Agaricomycotina;Agaricomycetes;Russulales;Hericiaceae;Hericium;";"0.0";"0";"4";"4";"0";"4";"0";"457179";"391207"
"V4mis2";"SILVA (only NR);Eukaryota;Amorphea;Obazoa;Opisthokonta;Nucletmycea;Fungi;Dikarya;Basidiomycota;Agaricomycotina;Agaricomycetes;Russulales;Hyphodermataceae;";"0.0";"0";"1";"1";"0";"1";"0";"457182";"391207"
"V4mis2";"SILVA (only NR);Eukaryota;Amorphea;Obazoa;Opisthokonta;Nucletmycea;Fungi;Dikarya;Basidiomycota;Agaricomycotina;Agaricomycetes;Russulales;Hyphodermataceae;Galzinia;";"0.0";"0";"1";"1";"0";"1";"0";"457182";"391207"
"V4mis2";"SILVA (only NR);Eukaryota;Amorphea;Obazoa;Opisthokonta;Nucletmycea;Fungi;Dikarya;Basidiomycota;Agaricomycotina;Agaricomycetes;Russulales;Lachnocladiaceae;";"0.0";"0";"7";"7";"0";"7";"0";"457176";"391207"
"V4mis2";"SILVA (only NR);Eukaryota;Amorphea;Obazoa;Opisthokonta;Nucletmycea;Fungi;Dikarya;Basidiomycota;Agaricomycotina;Agaricomycetes;Russulales;Lachnocladiaceae;Asterostroma;";"0.0";"0";"1";"1";"0";"1";"0";"457182";"391207"
"V4mis2";"SILVA (only NR);Eukaryota;Amorphea;Obazoa;Opisthokonta;Nucletmycea;Fungi;Dikarya;Basidiomycota;Agaricomycotina;Agaricomycetes;Russulales;Lachnocladiaceae;Baltazaria;";"0.0";"0";"1";"1";"0";"1";"0";"457182";"391207"
"V4mis2";"SILVA (only NR);Eukaryota;Amorphea;Obazoa;Opisthokonta;Nucletmycea;Fungi;Dikarya;Basidiomycota;Agaricomycotina;Agaricomycetes;Russulales;Lachnocladiaceae;Dichostereum;";"0.0";"0";"1";"1";"0";"1";"0";"457182";"391207"
"V4mis2";"SILVA (only NR);Eukaryota;Amorphea;Obazoa;Opisthokonta;Nucletmycea;Fungi;Dikarya;Basidiomycota;Agaricomycotina;Agaricomycetes;Russulales;Lachnocladiaceae;Scytinostroma;";"0.0";"0";"2";"2";"0";"2";"0";"457181";"391207"
"V4mis2";"SILVA (only NR);Eukaryota;Amorphea;Obazoa;Opisthokonta;Nucletmycea;Fungi;Dikarya;Basidiomycota;Agaricomycotina;Agaricomycetes;Russulales;Lachnocladiaceae;Vararia;";"0.0";"0";"1";"1";"0";"1";"0";"457182";"391207"
"V4mis2";"SILVA (only NR);Eukaryota;Amorphea;Obazoa;Opisthokonta;Nucletmycea;Fungi;Dikarya;Basidiomycota;Agaricomycotina;Agaricomycetes;Russulales;Laurilia;";"0.0";"0";"1";"1";"0";"1";"0";"457182";"391207"
"V4mis2";"SILVA (only NR);Eukaryota;Amorphea;Obazoa;Opisthokonta;Nucletmycea;Fungi;Dikarya;Basidiomycota;Agaricomycotina;Agaricomycetes;Russulales;Laxitextum;";"0.0";"0";"1";"1";"0";"1";"0";"457182";"391207"
"V4mis2";"SILVA (only NR);Eukaryota;Amorphea;Obazoa;Opisthokonta;Nucletmycea;Fungi;Dikarya;Basidiomycota;Agaricomycotina;Agaricomycetes;Russulales;Peniophora;";"0.0";"0";"1";"1";"0";"1";"0";"457182";"391207"
"V4mis2";"SILVA (only NR);Eukaryota;Amorphea;Obazoa;Opisthokonta;Nucletmycea;Fungi;Dikarya;Basidiomycota;Agaricomycotina;Agaricomycetes;Russulales;Podoscyphaceae;";"0.0";"0";"4";"4";"0";"4";"0";"457179";"391207"
"V4mis2";"SILVA (only NR);Eukaryota;Amorphea;Obazoa;Opisthokonta;Nucletmycea;Fungi;Dikarya;Basidiomycota;Agaricomycotina;Agaricomycetes;Russulales;Podoscyphaceae;Cymatoderma;";"0.0";"0";"1";"1";"0";"1";"0";"457182";"391207"
"V4mis2";"SILVA (only NR);Eukaryota;Amorphea;Obazoa;Opisthokonta;Nucletmycea;Fungi;Dikarya;Basidiomycota;Agaricomycotina;Agaricomycetes;Russulales;Podoscyphaceae;Podoscypha;";"0.0";"0";"3";"3";"0";"3";"0";"457180";"391207"
"V4mis2";"SILVA (only NR);Eukaryota;Amorphea;Obazoa;Opisthokonta;Nucletmycea;Fungi;Dikarya;Basidiomycota;Agaricomycotina;Agaricomycetes;Russulales;Russulaceae;";"7.7";"14.4";"14";"13";"1";"12";"1";"457170";"391206"
"V4mis2";"SILVA (only NR);Eukaryota;Amorphea;Obazoa;Opisthokonta;Nucletmycea;Fungi;Dikarya;Basidiomycota;Agaricomycotina;Agaricomycetes;Russulales;Russulaceae;Lactarius;";"20.0";"14.4";"6";"5";"1";"4";"1";"457178";"391206"
"V4mis2";"SILVA (only NR);Eukaryota;Amorphea;Obazoa;Opisthokonta;Nucletmycea;Fungi;Dikarya;Basidiomycota;Agaricomycotina;Agaricomycetes;Russulales;Russulaceae;Russula;";"0.0";"0";"8";"8";"0";"8";"0";"457175";"391207"
"V4mis2";"SILVA (only NR);Eukaryota;Amorphea;Obazoa;Opisthokonta;Nucletmycea;Fungi;Dikarya;Basidiomycota;Agaricomycotina;Agaricomycetes;Russulales;Stereaceae;";"0.0";"0";"20";"20";"0";"20";"0";"457163";"391207"
"V4mis2";"SILVA (only NR);Eukaryota;Amorphea;Obazoa;Opisthokonta;Nucletmycea;Fungi;Dikarya;Basidiomycota;Agaricomycotina;Agaricomycetes;Russulales;Stereaceae;Aleurobotrys;";"0.0";"0";"1";"1";"0";"1";"0";"457182";"391207"
"V4mis2";"SILVA (only NR);Eukaryota;Amorphea;Obazoa;Opisthokonta;Nucletmycea;Fungi;Dikarya;Basidiomycota;Agaricomycotina;Agaricomycetes;Russulales;Stereaceae;Amylostereum;";"0.0";"0";"3";"3";"0";"3";"0";"457180";"391207"
"V4mis2";"SILVA (only NR);Eukaryota;Amorphea;Obazoa;Opisthokonta;Nucletmycea;Fungi;Dikarya;Basidiomycota;Agaricomycotina;Agaricomycetes;Russulales;Stereaceae;Boreostereum;";"0.0";"0";"1";"1";"0";"1";"0";"457182";"391207"
"V4mis2";"SILVA (only NR);Eukaryota;Amorphea;Obazoa;Opisthokonta;Nucletmycea;Fungi;Dikarya;Basidiomycota;Agaricomycotina;Agaricomycetes;Russulales;Stereaceae;Lopharia;";"0.0";"0";"2";"2";"0";"2";"0";"457181";"391207"
"V4mis2";"SILVA (only NR);Eukaryota;Amorphea;Obazoa;Opisthokonta;Nucletmycea;Fungi;Dikarya;Basidiomycota;Agaricomycotina;Agaricomycetes;Russulales;Stereaceae;Megalocystidium;";"0.0";"0";"1";"1";"0";"1";"0";"457182";"391207"
"V4mis2";"SILVA (only NR);Eukaryota;Amorphea;Obazoa;Opisthokonta;Nucletmycea;Fungi;Dikarya;Basidiomycota;Agaricomycotina;Agaricomycetes;Russulales;Stereaceae;Stereum;";"0.0";"0";"3";"3";"0";"3";"0";"457180";"391207"
"V4mis2";"SILVA (only NR);Eukaryota;Amorphea;Obazoa;Opisthokonta;Nucletmycea;Fungi;Dikarya;Basidiomycota;Agaricomycotina;Agaricomycetes;Russulales;Stereaceae;Xylobolus;";"0.0";"0";"2";"2";"0";"2";"0";"457181";"391207"
"V4mis2";"SILVA (only NR);Eukaryota;Amorphea;Obazoa;Opisthokonta;Nucletmycea;Fungi;Dikarya;Basidiomycota;Agaricomycotina;Agaricomycetes;Russulales;Stereaceae;uncultured;";"0.0";"0";"6";"6";"0";"6";"0";"457177";"391207"
"V4mis2";"SILVA (only NR);Eukaryota;Amorphea;Obazoa;Opisthokonta;Nucletmycea;Fungi;Dikarya;Basidiomycota;Agaricomycotina;Agaricomycetes;Russulales;Xenasma;";"0.0";"0";"1";"1";"0";"1";"0";"457182";"391207"
"V4mis2";"SILVA (only NR);Eukaryota;Amorphea;Obazoa;Opisthokonta;Nucletmycea;Fungi;Dikarya;Basidiomycota;Agaricomycotina;Agaricomycetes;Russulales;uncultured;";"0.0";"0";"2";"2";"0";"2";"0";"457181";"391207"
"V4mis2";"SILVA (only NR);Eukaryota;Amorphea;Obazoa;Opisthokonta;Nucletmycea;Fungi;Dikarya;Basidiomycota;Agaricomycotina;Agaricomycetes;Sebacinales;";"0.0";"0";"7";"7";"0";"7";"0";"457176";"391207"
"V4mis2";"SILVA (only NR);Eukaryota;Amorphea;Obazoa;Opisthokonta;Nucletmycea;Fungi;Dikarya;Basidiomycota;Agaricomycotina;Agaricomycetes;Sebacinales;Chaetospermum;";"0.0";"0";"1";"1";"0";"1";"0";"457182";"391207"
"V4mis2";"SILVA (only NR);Eukaryota;Amorphea;Obazoa;Opisthokonta;Nucletmycea;Fungi;Dikarya;Basidiomycota;Agaricomycotina;Agaricomycetes;Sebacinales;Sebacinaceae;";"0.0";"0";"6";"6";"0";"6";"0";"457177";"391207"
"V4mis2";"SILVA (only NR);Eukaryota;Amorphea;Obazoa;Opisthokonta;Nucletmycea;Fungi;Dikarya;Basidiomycota;Agaricomycotina;Agaricomycetes;Sebacinales;Sebacinaceae;Craterocolla;";"0.0";"0";"1";"1";"0";"1";"0";"457182";"391207"
"V4mis2";"SILVA (only NR);Eukaryota;Amorphea;Obazoa;Opisthokonta;Nucletmycea;Fungi;Dikarya;Basidiomycota;Agaricomycotina;Agaricomycetes;Sebacinales;Sebacinaceae;Sebacina;";"0.0";"0";"4";"4";"0";"4";"0";"457179";"391207"
"V4mis2";"SILVA (only NR);Eukaryota;Amorphea;Obazoa;Opisthokonta;Nucletmycea;Fungi;Dikarya;Basidiomycota;Agaricomycotina;Agaricomycetes;Thelephorales;";"5.6";"14.4";"18";"18";"1";"17";"0";"457165";"391206"
"V4mis2";"SILVA (only NR);Eukaryota;Amorphea;Obazoa;Opisthokonta;Nucletmycea;Fungi;Dikarya;Basidiomycota;Agaricomycotina;Agaricomycetes;Thelephorales;Boletopsis;";"0.0";"0";"1";"1";"0";"1";"0";"457182";"391207"
"V4mis2";"SILVA (only NR);Eukaryota;Amorphea;Obazoa;Opisthokonta;Nucletmycea;Fungi;Dikarya;Basidiomycota;Agaricomycotina;Agaricomycetes;Thelephorales;Thelephoraceae;";"0.0";"0";"5";"5";"0";"5";"0";"457178";"391207"
"V4mis2";"SILVA (only NR);Eukaryota;Amorphea;Obazoa;Opisthokonta;Nucletmycea;Fungi;Dikarya;Basidiomycota;Agaricomycotina;Agaricomycetes;Thelephorales;Thelephoraceae;Hydnellum;";"0.0";"0";"2";"2";"0";"2";"0";"457181";"391207"
"V4mis2";"SILVA (only NR);Eukaryota;Amorphea;Obazoa;Opisthokonta;Nucletmycea;Fungi;Dikarya;Basidiomycota;Agaricomycotina;Agaricomycetes;Thelephorales;Thelephoraceae;Polyozellus;";"0.0";"0";"1";"1";"0";"1";"0";"457182";"391207"
"V4mis2";"SILVA (only NR);Eukaryota;Amorphea;Obazoa;Opisthokonta;Nucletmycea;Fungi;Dikarya;Basidiomycota;Agaricomycotina;Agaricomycetes;Thelephorales;Thelephoraceae;Sarcodon;";"0.0";"0";"1";"1";"0";"1";"0";"457182";"391207"
"V4mis2";"SILVA (only NR);Eukaryota;Amorphea;Obazoa;Opisthokonta;Nucletmycea;Fungi;Dikarya;Basidiomycota;Agaricomycotina;Agaricomycetes;Thelephorales;uncultured;";"0.0";"0";"9";"9";"0";"9";"0";"457174";"391207"
"V4mis2";"SILVA (only NR);Eukaryota;Amorphea;Obazoa;Opisthokonta;Nucletmycea;Fungi;Dikarya;Basidiomycota;Agaricomycotina;Agaricomycetes;Trechisporales;";"0.0";"0";"2";"2";"0";"2";"0";"457181";"391207"
"V4mis2";"SILVA (only NR);Eukaryota;Amorphea;Obazoa;Opisthokonta;Nucletmycea;Fungi;Dikarya;Basidiomycota;Agaricomycotina;Agaricomycetes;Trechisporales;Hydnodontaceae;";"0.0";"0";"2";"2";"0";"2";"0";"457181";"391207"
"V4mis2";"SILVA (only NR);Eukaryota;Amorphea;Obazoa;Opisthokonta;Nucletmycea;Fungi;Dikarya;Basidiomycota;Agaricomycotina;Agaricomycetes;Trechisporales;Hydnodontaceae;Trechispora;";"0.0";"0";"2";"2";"0";"2";"0";"457181";"391207"
"V4mis2";"SILVA (only NR);Eukaryota;Amorphea;Obazoa;Opisthokonta;Nucletmycea;Fungi;Dikarya;Basidiomycota;Agaricomycotina;Agaricomycetes;uncultured;";"0.0";"0";"13";"13";"0";"13";"0";"457170";"391207"
"V4mis2";"SILVA (only NR);Eukaryota;Amorphea;Obazoa;Opisthokonta;Nucletmycea;Fungi;Dikarya;Basidiomycota;Agaricomycotina;Dacrymycetes;";"88.0";"14.4";"50";"50";"44";"6";"0";"457133";"391163"
"V4mis2";"SILVA (only NR);Eukaryota;Amorphea;Obazoa;Opisthokonta;Nucletmycea;Fungi;Dikarya;Basidiomycota;Agaricomycotina;Dacrymycetes;Dacrymycetales;";"88.0";"14.4";"50";"50";"44";"6";"0";"457133";"391163"
"V4mis2";"SILVA (only NR);Eukaryota;Amorphea;Obazoa;Opisthokonta;Nucletmycea;Fungi;Dikarya;Basidiomycota;Agaricomycotina;Dacrymycetes;Dacrymycetales;Cerinomycetaceae;";"85.7";"14.4";"7";"7";"6";"1";"0";"457176";"391201"
"V4mis2";"SILVA (only NR);Eukaryota;Amorphea;Obazoa;Opisthokonta;Nucletmycea;Fungi;Dikarya;Basidiomycota;Agaricomycotina;Dacrymycetes;Dacrymycetales;Cerinomycetaceae;Cerinomyces;";"85.7";"14.4";"7";"7";"6";"1";"0";"457176";"391201"
"V4mis2";"SILVA (only NR);Eukaryota;Amorphea;Obazoa;Opisthokonta;Nucletmycea;Fungi;Dikarya;Basidiomycota;Agaricomycotina;Dacrymycetes;Dacrymycetales;Dacrymycetaceae;";"88.1";"14.4";"42";"42";"37";"5";"0";"457141";"391170"
"V4mis2";"SILVA (only NR);Eukaryota;Amorphea;Obazoa;Opisthokonta;Nucletmycea;Fungi;Dikarya;Basidiomycota;Agaricomycotina;Dacrymycetes;Dacrymycetales;Dacrymycetaceae;Calocera;";"100.0";"14.4";"4";"4";"4";"0";"0";"457179";"391203"
"V4mis2";"SILVA (only NR);Eukaryota;Amorphea;Obazoa;Opisthokonta;Nucletmycea;Fungi;Dikarya;Basidiomycota;Agaricomycotina;Dacrymycetes;Dacrymycetales;Dacrymycetaceae;Dacrymyces;";"83.3";"14.4";"30";"30";"25";"5";"0";"457153";"391182"
"V4mis2";"SILVA (only NR);Eukaryota;Amorphea;Obazoa;Opisthokonta;Nucletmycea;Fungi;Dikarya;Basidiomycota;Agaricomycotina;Dacrymycetes;Dacrymycetales;Dacrymycetaceae;Dacryopinax;";"100.0";"14.4";"1";"1";"1";"0";"0";"457182";"391206"
"V4mis2";"SILVA (only NR);Eukaryota;Amorphea;Obazoa;Opisthokonta;Nucletmycea;Fungi;Dikarya;Basidiomycota;Agaricomycotina;Dacrymycetes;Dacrymycetales;Dacrymycetaceae;Ditiola;";"100.0";"14.4";"1";"1";"1";"0";"0";"457182";"391206"
"V4mis2";"SILVA (only NR);Eukaryota;Amorphea;Obazoa;Opisthokonta;Nucletmycea;Fungi;Dikarya;Basidiomycota;Agaricomycotina;Dacrymycetes;Dacrymycetales;Dacrymycetaceae;Femsjonia;";"100.0";"14.4";"1";"1";"1";"0";"0";"457182";"391206"
"V4mis2";"SILVA (only NR);Eukaryota;Amorphea;Obazoa;Opisthokonta;Nucletmycea;Fungi;Dikarya;Basidiomycota;Agaricomycotina;Dacrymycetes;Dacrymycetales;Dacrymycetaceae;Guepiniopsis;";"100.0";"14.4";"1";"1";"1";"0";"0";"457182";"391206"
"V4mis2";"SILVA (only NR);Eukaryota;Amorphea;Obazoa;Opisthokonta;Nucletmycea;Fungi;Dikarya;Basidiomycota;Agaricomycotina;Dacrymycetes;Dacrymycetales;Dacrymycetaceae;Heterotextus;";"100.0";"14.4";"2";"2";"2";"0";"0";"457181";"391205"
"V4mis2";"SILVA (only NR);Eukaryota;Amorphea;Obazoa;Opisthokonta;Nucletmycea;Fungi;Dikarya;Basidiomycota;Agaricomycotina;Geminibasidiomycetes;";"100.0";"14.4";"2";"2";"2";"0";"0";"457181";"391205"
"V4mis2";"SILVA (only NR);Eukaryota;Amorphea;Obazoa;Opisthokonta;Nucletmycea;Fungi;Dikarya;Basidiomycota;Agaricomycotina;Geminibasidiomycetes;Geminibasidiales;";"100.0";"14.4";"2";"2";"2";"0";"0";"457181";"391205"
"V4mis2";"SILVA (only NR);Eukaryota;Amorphea;Obazoa;Opisthokonta;Nucletmycea;Fungi;Dikarya;Basidiomycota;Agaricomycotina;Geminibasidiomycetes;Geminibasidiales;Geminibasidiaceae;";"100.0";"14.4";"2";"2";"2";"0";"0";"457181";"391205"
"V4mis2";"SILVA (only NR);Eukaryota;Amorphea;Obazoa;Opisthokonta;Nucletmycea;Fungi;Dikarya;Basidiomycota;Agaricomycotina;Geminibasidiomycetes;Geminibasidiales;Geminibasidiaceae;Basidioascus;";"100.0";"14.4";"1";"1";"1";"0";"0";"457182";"391206"
"V4mis2";"SILVA (only NR);Eukaryota;Amorphea;Obazoa;Opisthokonta;Nucletmycea;Fungi;Dikarya;Basidiomycota;Agaricomycotina;Geminibasidiomycetes;Geminibasidiales;Geminibasidiaceae;Geminibasidium;";"100.0";"14.4";"1";"1";"1";"0";"0";"457182";"391206"
"V4mis2";"SILVA (only NR);Eukaryota;Amorphea;Obazoa;Opisthokonta;Nucletmycea;Fungi;Dikarya;Basidiomycota;Agaricomycotina;Tremellomycetes;";"94.1";"14.4";"444";"444";"418";"26";"0";"456739";"390789"
"V4mis2";"SILVA (only NR);Eukaryota;Amorphea;Obazoa;Opisthokonta;Nucletmycea;Fungi;Dikarya;Basidiomycota;Agaricomycotina;Tremellomycetes;Cystofilobasidiales;";"36.7";"14.4";"30";"30";"11";"19";"0";"457153";"391196"
"V4mis2";"SILVA (only NR);Eukaryota;Amorphea;Obazoa;Opisthokonta;Nucletmycea;Fungi;Dikarya;Basidiomycota;Agaricomycotina;Tremellomycetes;Cystofilobasidiales;Cystofilobasidiaceae;";"100.0";"14.4";"11";"11";"11";"0";"0";"457172";"391196"
"V4mis2";"SILVA (only NR);Eukaryota;Amorphea;Obazoa;Opisthokonta;Nucletmycea;Fungi;Dikarya;Basidiomycota;Agaricomycotina;Tremellomycetes;Cystofilobasidiales;Cystofilobasidiaceae;Cystofilobasidium;";"100.0";"14.4";"11";"11";"11";"0";"0";"457172";"391196"
"V4mis2";"SILVA (only NR);Eukaryota;Amorphea;Obazoa;Opisthokonta;Nucletmycea;Fungi;Dikarya;Basidiomycota;Agaricomycotina;Tremellomycetes;Cystofilobasidiales;Mrakiaceae;";"0.0";"0";"19";"19";"0";"19";"0";"457164";"391207"
"V4mis2";"SILVA (only NR);Eukaryota;Amorphea;Obazoa;Opisthokonta;Nucletmycea;Fungi;Dikarya;Basidiomycota;Agaricomycotina;Tremellomycetes;Cystofilobasidiales;Mrakiaceae;Itersonilia;";"0.0";"0";"3";"3";"0";"3";"0";"457180";"391207"
"V4mis2";"SILVA (only NR);Eukaryota;Amorphea;Obazoa;Opisthokonta;Nucletmycea;Fungi;Dikarya;Basidiomycota;Agaricomycotina;Tremellomycetes;Cystofilobasidiales;Mrakiaceae;Mrakia;";"0.0";"0";"6";"6";"0";"6";"0";"457177";"391207"
"V4mis2";"SILVA (only NR);Eukaryota;Amorphea;Obazoa;Opisthokonta;Nucletmycea;Fungi;Dikarya;Basidiomycota;Agaricomycotina;Tremellomycetes;Cystofilobasidiales;Mrakiaceae;Phaffia;";"0.0";"0";"1";"1";"0";"1";"0";"457182";"391207"
"V4mis2";"SILVA (only NR);Eukaryota;Amorphea;Obazoa;Opisthokonta;Nucletmycea;Fungi;Dikarya;Basidiomycota;Agaricomycotina;Tremellomycetes;Cystofilobasidiales;Mrakiaceae;Tausonia;";"0.0";"0";"1";"1";"0";"1";"0";"457182";"391207"
"V4mis2";"SILVA (only NR);Eukaryota;Amorphea;Obazoa;Opisthokonta;Nucletmycea;Fungi;Dikarya;Basidiomycota;Agaricomycotina;Tremellomycetes;Cystofilobasidiales;Mrakiaceae;Udeniomyces;";"0.0";"0";"4";"4";"0";"4";"0";"457179";"391207"
"V4mis2";"SILVA (only NR);Eukaryota;Amorphea;Obazoa;Opisthokonta;Nucletmycea;Fungi;Dikarya;Basidiomycota;Agaricomycotina;Tremellomycetes;Cystofilobasidiales;Mrakiaceae;Xanthophyllomyces;";"0.0";"0";"1";"1";"0";"1";"0";"457182";"391207"
"V4mis2";"SILVA (only NR);Eukaryota;Amorphea;Obazoa;Opisthokonta;Nucletmycea;Fungi;Dikarya;Basidiomycota;Agaricomycotina;Tremellomycetes;Filobasidiales;";"98.1";"14.4";"106";"106";"104";"2";"0";"457077";"391103"
"V4mis2";"SILVA (only NR);Eukaryota;Amorphea;Obazoa;Opisthokonta;Nucletmycea;Fungi;Dikarya;Basidiomycota;Agaricomycotina;Tremellomycetes;Filobasidiales;Filobasidiaceae;";"97.9";"14.4";"94";"94";"92";"2";"0";"457089";"391115"
"V4mis2";"SILVA (only NR);Eukaryota;Amorphea;Obazoa;Opisthokonta;Nucletmycea;Fungi;Dikarya;Basidiomycota;Agaricomycotina;Tremellomycetes;Filobasidiales;Filobasidiaceae;Filobasidium;";"100.0";"14.4";"12";"12";"12";"0";"0";"457171";"391195"
"V4mis2";"SILVA (only NR);Eukaryota;Amorphea;Obazoa;Opisthokonta;Nucletmycea;Fungi;Dikarya;Basidiomycota;Agaricomycotina;Tremellomycetes;Filobasidiales;Filobasidiaceae;Goffeauzyma;";"100.0";"14.4";"7";"7";"7";"0";"0";"457176";"391200"
"V4mis2";"SILVA (only NR);Eukaryota;Amorphea;Obazoa;Opisthokonta;Nucletmycea;Fungi;Dikarya;Basidiomycota;Agaricomycotina;Tremellomycetes;Filobasidiales;Filobasidiaceae;Heterocephalacria;";"90.0";"14.4";"10";"10";"9";"1";"0";"457173";"391198"
"V4mis2";"SILVA (only NR);Eukaryota;Amorphea;Obazoa;Opisthokonta;Nucletmycea;Fungi;Dikarya;Basidiomycota;Agaricomycotina;Tremellomycetes;Filobasidiales;Filobasidiaceae;Naganishia;";"100.0";"14.4";"54";"54";"54";"0";"0";"457129";"391153"
"V4mis2";"SILVA (only NR);Eukaryota;Amorphea;Obazoa;Opisthokonta;Nucletmycea;Fungi;Dikarya;Basidiomycota;Agaricomycotina;Tremellomycetes;Filobasidiales;Filobasidiaceae;[Cryptococcus];";"100.0";"14.4";"1";"1";"1";"0";"0";"457182";"391206"
"V4mis2";"SILVA (only NR);Eukaryota;Amorphea;Obazoa;Opisthokonta;Nucletmycea;Fungi;Dikarya;Basidiomycota;Agaricomycotina;Tremellomycetes;Filobasidiales;Filobasidiaceae;uncultured;";"87.5";"14.4";"8";"8";"7";"1";"0";"457175";"391200"
"V4mis2";"SILVA (only NR);Eukaryota;Amorphea;Obazoa;Opisthokonta;Nucletmycea;Fungi;Dikarya;Basidiomycota;Agaricomycotina;Tremellomycetes;Filobasidiales;Piskurozymaceae;";"100.0";"14.4";"11";"11";"11";"0";"0";"457172";"391196"
"V4mis2";"SILVA (only NR);Eukaryota;Amorphea;Obazoa;Opisthokonta;Nucletmycea;Fungi;Dikarya;Basidiomycota;Agaricomycotina;Tremellomycetes;Filobasidiales;Piskurozymaceae;Piskurozyma;";"100.0";"14.4";"3";"3";"3";"0";"0";"457180";"391204"
"V4mis2";"SILVA (only NR);Eukaryota;Amorphea;Obazoa;Opisthokonta;Nucletmycea;Fungi;Dikarya;Basidiomycota;Agaricomycotina;Tremellomycetes;Filobasidiales;Piskurozymaceae;Solicoccozyma;";"100.0";"14.4";"8";"8";"8";"0";"0";"457175";"391199"
"V4mis2";"SILVA (only NR);Eukaryota;Amorphea;Obazoa;Opisthokonta;Nucletmycea;Fungi;Dikarya;Basidiomycota;Agaricomycotina;Tremellomycetes;Holtermanniales;";"100.0";"14.4";"2";"2";"2";"0";"0";"457181";"391205"
"V4mis2";"SILVA (only NR);Eukaryota;Amorphea;Obazoa;Opisthokonta;Nucletmycea;Fungi;Dikarya;Basidiomycota;Agaricomycotina;Tremellomycetes;Holtermanniales;Incertae Sedis;";"100.0";"14.4";"2";"2";"2";"0";"0";"457181";"391205"
"V4mis2";"SILVA (only NR);Eukaryota;Amorphea;Obazoa;Opisthokonta;Nucletmycea;Fungi;Dikarya;Basidiomycota;Agaricomycotina;Tremellomycetes;Holtermanniales;Incertae Sedis;Holtermanniella;";"100.0";"14.4";"2";"2";"2";"0";"0";"457181";"391205"
"V4mis2";"SILVA (only NR);Eukaryota;Amorphea;Obazoa;Opisthokonta;Nucletmycea;Fungi;Dikarya;Basidiomycota;Agaricomycotina;Tremellomycetes;Tremellales;";"97.6";"14.4";"209";"209";"204";"5";"0";"456974";"391003"
"V4mis2";"SILVA (only NR);Eukaryota;Amorphea;Obazoa;Opisthokonta;Nucletmycea;Fungi;Dikarya;Basidiomycota;Agaricomycotina;Tremellomycetes;Tremellales;Bulleraceae;";"100.0";"14.4";"9";"9";"9";"0";"0";"457174";"391198"
"V4mis2";"SILVA (only NR);Eukaryota;Amorphea;Obazoa;Opisthokonta;Nucletmycea;Fungi;Dikarya;Basidiomycota;Agaricomycotina;Tremellomycetes;Tremellales;Bulleraceae;Bullera;";"100.0";"14.4";"7";"7";"7";"0";"0";"457176";"391200"
"V4mis2";"SILVA (only NR);Eukaryota;Amorphea;Obazoa;Opisthokonta;Nucletmycea;Fungi;Dikarya;Basidiomycota;Agaricomycotina;Tremellomycetes;Tremellales;Bulleraceae;Pseudotremella;";"100.0";"14.4";"2";"2";"2";"0";"0";"457181";"391205"
"V4mis2";"SILVA (only NR);Eukaryota;Amorphea;Obazoa;Opisthokonta;Nucletmycea;Fungi;Dikarya;Basidiomycota;Agaricomycotina;Tremellomycetes;Tremellales;Bulleribasidiaceae;";"96.8";"14.4";"62";"62";"60";"2";"0";"457121";"391147"
"V4mis2";"SILVA (only NR);Eukaryota;Amorphea;Obazoa;Opisthokonta;Nucletmycea;Fungi;Dikarya;Basidiomycota;Agaricomycotina;Tremellomycetes;Tremellales;Bulleribasidiaceae;Bulleribasidium;";"100.0";"14.4";"9";"9";"9";"0";"0";"457174";"391198"
"V4mis2";"SILVA (only NR);Eukaryota;Amorphea;Obazoa;Opisthokonta;Nucletmycea;Fungi;Dikarya;Basidiomycota;Agaricomycotina;Tremellomycetes;Tremellales;Bulleribasidiaceae;Derxomyces;";"95.5";"14.4";"22";"22";"21";"1";"0";"457161";"391186"
"V4mis2";"SILVA (only NR);Eukaryota;Amorphea;Obazoa;Opisthokonta;Nucletmycea;Fungi;Dikarya;Basidiomycota;Agaricomycotina;Tremellomycetes;Tremellales;Bulleribasidiaceae;Dioszegia;";"100.0";"14.4";"9";"9";"9";"0";"0";"457174";"391198"
"V4mis2";"SILVA (only NR);Eukaryota;Amorphea;Obazoa;Opisthokonta;Nucletmycea;Fungi;Dikarya;Basidiomycota;Agaricomycotina;Tremellomycetes;Tremellales;Bulleribasidiaceae;Hannaella;";"100.0";"14.4";"10";"10";"10";"0";"0";"457173";"391197"
"V4mis2";"SILVA (only NR);Eukaryota;Amorphea;Obazoa;Opisthokonta;Nucletmycea;Fungi;Dikarya;Basidiomycota;Agaricomycotina;Tremellomycetes;Tremellales;Bulleribasidiaceae;Nielozyma;";"100.0";"14.4";"1";"1";"1";"0";"0";"457182";"391206"
"V4mis2";"SILVA (only NR);Eukaryota;Amorphea;Obazoa;Opisthokonta;Nucletmycea;Fungi;Dikarya;Basidiomycota;Agaricomycotina;Tremellomycetes;Tremellales;Bulleribasidiaceae;Vishniacozyma;";"90.9";"14.4";"11";"11";"10";"1";"0";"457172";"391197"
"V4mis2";"SILVA (only NR);Eukaryota;Amorphea;Obazoa;Opisthokonta;Nucletmycea;Fungi;Dikarya;Basidiomycota;Agaricomycotina;Tremellomycetes;Tremellales;Carcinomycetaceae;";"100.0";"14.4";"6";"6";"6";"0";"0";"457177";"391201"
"V4mis2";"SILVA (only NR);Eukaryota;Amorphea;Obazoa;Opisthokonta;Nucletmycea;Fungi;Dikarya;Basidiomycota;Agaricomycotina;Tremellomycetes;Tremellales;Carcinomycetaceae;Carcinomyces;";"100.0";"14.4";"6";"6";"6";"0";"0";"457177";"391201"
"V4mis2";"SILVA (only NR);Eukaryota;Amorphea;Obazoa;Opisthokonta;Nucletmycea;Fungi;Dikarya;Basidiomycota;Agaricomycotina;Tremellomycetes;Tremellales;Cryptococcaceae;";"92.3";"14.4";"26";"26";"24";"2";"0";"457157";"391183"
"V4mis2";"SILVA (only NR);Eukaryota;Amorphea;Obazoa;Opisthokonta;Nucletmycea;Fungi;Dikarya;Basidiomycota;Agaricomycotina;Tremellomycetes;Tremellales;Cryptococcaceae;Cryptococcus;";"91.7";"14.4";"24";"24";"22";"2";"0";"457159";"391185"
"V4mis2";"SILVA (only NR);Eukaryota;Amorphea;Obazoa;Opisthokonta;Nucletmycea;Fungi;Dikarya;Basidiomycota;Agaricomycotina;Tremellomycetes;Tremellales;Cryptococcaceae;Kwoniella;";"100.0";"14.4";"2";"2";"2";"0";"0";"457181";"391205"
"V4mis2";"SILVA (only NR);Eukaryota;Amorphea;Obazoa;Opisthokonta;Nucletmycea;Fungi;Dikarya;Basidiomycota;Agaricomycotina;Tremellomycetes;Tremellales;Cuniculitremaceae;";"100.0";"14.4";"27";"27";"27";"0";"0";"457156";"391180"
"V4mis2";"SILVA (only NR);Eukaryota;Amorphea;Obazoa;Opisthokonta;Nucletmycea;Fungi;Dikarya;Basidiomycota;Agaricomycotina;Tremellomycetes;Tremellales;Cuniculitremaceae;Fellomyces;";"100.0";"14.4";"4";"4";"4";"0";"0";"457179";"391203"
"V4mis2";"SILVA (only NR);Eukaryota;Amorphea;Obazoa;Opisthokonta;Nucletmycea;Fungi;Dikarya;Basidiomycota;Agaricomycotina;Tremellomycetes;Tremellales;Cuniculitremaceae;Kockovaella;";"100.0";"14.4";"23";"23";"23";"0";"0";"457160";"391184"
"V4mis2";"SILVA (only NR);Eukaryota;Amorphea;Obazoa;Opisthokonta;Nucletmycea;Fungi;Dikarya;Basidiomycota;Agaricomycotina;Tremellomycetes;Tremellales;Dimennazyma;";"100.0";"14.4";"1";"1";"1";"0";"0";"457182";"391206"
"V4mis2";"SILVA (only NR);Eukaryota;Amorphea;Obazoa;Opisthokonta;Nucletmycea;Fungi;Dikarya;Basidiomycota;Agaricomycotina;Tremellomycetes;Tremellales;Genolevuria;";"100.0";"14.4";"1";"1";"1";"0";"0";"457182";"391206"
"V4mis2";"SILVA (only NR);Eukaryota;Amorphea;Obazoa;Opisthokonta;Nucletmycea;Fungi;Dikarya;Basidiomycota;Agaricomycotina;Tremellomycetes;Tremellales;Phaeotremellaceae;";"100.0";"14.4";"3";"3";"3";"0";"0";"457180";"391204"
"V4mis2";"SILVA (only NR);Eukaryota;Amorphea;Obazoa;Opisthokonta;Nucletmycea;Fungi;Dikarya;Basidiomycota;Agaricomycotina;Tremellomycetes;Tremellales;Phaeotremellaceae;Phaeotremella;";"100.0";"14.4";"3";"3";"3";"0";"0";"457180";"391204"
"V4mis2";"SILVA (only NR);Eukaryota;Amorphea;Obazoa;Opisthokonta;Nucletmycea;Fungi;Dikarya;Basidiomycota;Agaricomycotina;Tremellomycetes;Tremellales;Rhynchogastrema;";"100.0";"14.4";"1";"1";"1";"0";"0";"457182";"391206"
"V4mis2";"SILVA (only NR);Eukaryota;Amorphea;Obazoa;Opisthokonta;Nucletmycea;Fungi;Dikarya;Basidiomycota;Agaricomycotina;Tremellomycetes;Tremellales;Rhynchogastremataceae;";"100.0";"14.4";"16";"16";"16";"0";"0";"457167";"391191"
"V4mis2";"SILVA (only NR);Eukaryota;Amorphea;Obazoa;Opisthokonta;Nucletmycea;Fungi;Dikarya;Basidiomycota;Agaricomycotina;Tremellomycetes;Tremellales;Rhynchogastremataceae;Papiliotrema;";"100.0";"14.4";"12";"12";"12";"0";"0";"457171";"391195"
"V4mis2";"SILVA (only NR);Eukaryota;Amorphea;Obazoa;Opisthokonta;Nucletmycea;Fungi;Dikarya;Basidiomycota;Agaricomycotina;Tremellomycetes;Tremellales;Rhynchogastremataceae;Rhynchogastrema;";"100.0";"14.4";"3";"3";"3";"0";"0";"457180";"391204"
"V4mis2";"SILVA (only NR);Eukaryota;Amorphea;Obazoa;Opisthokonta;Nucletmycea;Fungi;Dikarya;Basidiomycota;Agaricomycotina;Tremellomycetes;Tremellales;Sirobasidiaceae;";"88.9";"14.4";"9";"9";"8";"1";"0";"457174";"391199"
"V4mis2";"SILVA (only NR);Eukaryota;Amorphea;Obazoa;Opisthokonta;Nucletmycea;Fungi;Dikarya;Basidiomycota;Agaricomycotina;Tremellomycetes;Tremellales;Sirobasidiaceae;Fibulobasidium;";"66.7";"14.4";"3";"3";"2";"1";"0";"457180";"391205"
"V4mis2";"SILVA (only NR);Eukaryota;Amorphea;Obazoa;Opisthokonta;Nucletmycea;Fungi;Dikarya;Basidiomycota;Agaricomycotina;Tremellomycetes;Tremellales;Sirobasidiaceae;Sirobasidium;";"100.0";"14.4";"6";"6";"6";"0";"0";"457177";"391201"
"V4mis2";"SILVA (only NR);Eukaryota;Amorphea;Obazoa;Opisthokonta;Nucletmycea;Fungi;Dikarya;Basidiomycota;Agaricomycotina;Tremellomycetes;Tremellales;Sterigmatosporidium;";"100.0";"14.4";"1";"1";"1";"0";"0";"457182";"391206"
"V4mis2";"SILVA (only NR);Eukaryota;Amorphea;Obazoa;Opisthokonta;Nucletmycea;Fungi;Dikarya;Basidiomycota;Agaricomycotina;Tremellomycetes;Tremellales;Sugitazyma;";"100.0";"14.4";"1";"1";"1";"0";"0";"457182";"391206"
"V4mis2";"SILVA (only NR);Eukaryota;Amorphea;Obazoa;Opisthokonta;Nucletmycea;Fungi;Dikarya;Basidiomycota;Agaricomycotina;Tremellomycetes;Tremellales;Syzygosporaceae;";"100.0";"14.4";"2";"2";"2";"0";"0";"457181";"391205"
"V4mis2";"SILVA (only NR);Eukaryota;Amorphea;Obazoa;Opisthokonta;Nucletmycea;Fungi;Dikarya;Basidiomycota;Agaricomycotina;Tremellomycetes;Tremellales;Syzygosporaceae;Syzygospora;";"100.0";"14.4";"2";"2";"2";"0";"0";"457181";"391205"
"V4mis2";"SILVA (only NR);Eukaryota;Amorphea;Obazoa;Opisthokonta;Nucletmycea;Fungi;Dikarya;Basidiomycota;Agaricomycotina;Tremellomycetes;Tremellales;Tremellaceae;";"100.0";"14.4";"26";"26";"26";"0";"0";"457157";"391181"
"V4mis2";"SILVA (only NR);Eukaryota;Amorphea;Obazoa;Opisthokonta;Nucletmycea;Fungi;Dikarya;Basidiomycota;Agaricomycotina;Tremellomycetes;Tremellales;Tremellaceae;Biatoropsis;";"100.0";"14.4";"1";"1";"1";"0";"0";"457182";"391206"
"V4mis2";"SILVA (only NR);Eukaryota;Amorphea;Obazoa;Opisthokonta;Nucletmycea;Fungi;Dikarya;Basidiomycota;Agaricomycotina;Tremellomycetes;Tremellales;Tremellaceae;Tremella;";"100.0";"14.4";"25";"25";"25";"0";"0";"457158";"391182"
"V4mis2";"SILVA (only NR);Eukaryota;Amorphea;Obazoa;Opisthokonta;Nucletmycea;Fungi;Dikarya;Basidiomycota;Agaricomycotina;Tremellomycetes;Tremellales;Trimorphomycetaceae;";"100.0";"14.4";"6";"6";"6";"0";"0";"457177";"391201"
"V4mis2";"SILVA (only NR);Eukaryota;Amorphea;Obazoa;Opisthokonta;Nucletmycea;Fungi;Dikarya;Basidiomycota;Agaricomycotina;Tremellomycetes;Tremellales;Trimorphomycetaceae;Saitozyma;";"100.0";"14.4";"4";"4";"4";"0";"0";"457179";"391203"
"V4mis2";"SILVA (only NR);Eukaryota;Amorphea;Obazoa;Opisthokonta;Nucletmycea;Fungi;Dikarya;Basidiomycota;Agaricomycotina;Tremellomycetes;Tremellales;Trimorphomycetaceae;Trimorphomyces;";"100.0";"14.4";"2";"2";"2";"0";"0";"457181";"391205"
"V4mis2";"SILVA (only NR);Eukaryota;Amorphea;Obazoa;Opisthokonta;Nucletmycea;Fungi;Dikarya;Basidiomycota;Agaricomycotina;Tremellomycetes;Tremellales;uncultured;";"100.0";"14.4";"7";"7";"7";"0";"0";"457176";"391200"
"V4mis2";"SILVA (only NR);Eukaryota;Amorphea;Obazoa;Opisthokonta;Nucletmycea;Fungi;Dikarya;Basidiomycota;Agaricomycotina;Tremellomycetes;Trichosporonales;";"100.0";"14.4";"92";"92";"92";"0";"0";"457091";"391115"
"V4mis2";"SILVA (only NR);Eukaryota;Amorphea;Obazoa;Opisthokonta;Nucletmycea;Fungi;Dikarya;Basidiomycota;Agaricomycotina;Tremellomycetes;Trichosporonales;Cryptotrichosporon;";"100.0";"14.4";"1";"1";"1";"0";"0";"457182";"391206"
"V4mis2";"SILVA (only NR);Eukaryota;Amorphea;Obazoa;Opisthokonta;Nucletmycea;Fungi;Dikarya;Basidiomycota;Agaricomycotina;Tremellomycetes;Trichosporonales;Tetragoniomycetaceae;";"100.0";"14.4";"1";"1";"1";"0";"0";"457182";"391206"
"V4mis2";"SILVA (only NR);Eukaryota;Amorphea;Obazoa;Opisthokonta;Nucletmycea;Fungi;Dikarya;Basidiomycota;Agaricomycotina;Tremellomycetes;Trichosporonales;Tetragoniomycetaceae;Bandonia;";"100.0";"14.4";"1";"1";"1";"0";"0";"457182";"391206"
"V4mis2";"SILVA (only NR);Eukaryota;Amorphea;Obazoa;Opisthokonta;Nucletmycea;Fungi;Dikarya;Basidiomycota;Agaricomycotina;Tremellomycetes;Trichosporonales;Trichosporonaceae;";"100.0";"14.4";"88";"88";"88";"0";"0";"457095";"391119"
"V4mis2";"SILVA (only NR);Eukaryota;Amorphea;Obazoa;Opisthokonta;Nucletmycea;Fungi;Dikarya;Basidiomycota;Agaricomycotina;Tremellomycetes;Trichosporonales;Trichosporonaceae;Apiotrichum;";"100.0";"14.4";"38";"38";"38";"0";"0";"457145";"391169"
"V4mis2";"SILVA (only NR);Eukaryota;Amorphea;Obazoa;Opisthokonta;Nucletmycea;Fungi;Dikarya;Basidiomycota;Agaricomycotina;Tremellomycetes;Trichosporonales;Trichosporonaceae;Cutaneotrichosporon;";"100.0";"14.4";"12";"12";"12";"0";"0";"457171";"391195"
"V4mis2";"SILVA (only NR);Eukaryota;Amorphea;Obazoa;Opisthokonta;Nucletmycea;Fungi;Dikarya;Basidiomycota;Agaricomycotina;Tremellomycetes;Trichosporonales;Trichosporonaceae;Haglerozyma;";"100.0";"14.4";"1";"1";"1";"0";"0";"457182";"391206"
"V4mis2";"SILVA (only NR);Eukaryota;Amorphea;Obazoa;Opisthokonta;Nucletmycea;Fungi;Dikarya;Basidiomycota;Agaricomycotina;Tremellomycetes;Trichosporonales;Trichosporonaceae;Trichosporon;";"100.0";"14.4";"24";"24";"24";"0";"0";"457159";"391183"
"V4mis2";"SILVA (only NR);Eukaryota;Amorphea;Obazoa;Opisthokonta;Nucletmycea;Fungi;Dikarya;Basidiomycota;Agaricomycotina;Tremellomycetes;Trichosporonales;Trichosporonaceae;Vanrija;";"100.0";"14.4";"13";"13";"13";"0";"0";"457170";"391194"
"V4mis2";"SILVA (only NR);Eukaryota;Amorphea;Obazoa;Opisthokonta;Nucletmycea;Fungi;Dikarya;Basidiomycota;Agaricomycotina;Wallemiomycetes;";"83.3";"14.4";"6";"6";"5";"1";"0";"457177";"391202"
"V4mis2";"SILVA (only NR);Eukaryota;Amorphea;Obazoa;Opisthokonta;Nucletmycea;Fungi;Dikarya;Basidiomycota;Agaricomycotina;Wallemiomycetes;Wallemiales;";"83.3";"14.4";"6";"6";"5";"1";"0";"457177";"391202"
"V4mis2";"SILVA (only NR);Eukaryota;Amorphea;Obazoa;Opisthokonta;Nucletmycea;Fungi;Dikarya;Basidiomycota;Agaricomycotina;Wallemiomycetes;Wallemiales;Incertae Sedis;";"83.3";"14.4";"6";"6";"5";"1";"0";"457177";"391202"
"V4mis2";"SILVA (only NR);Eukaryota;Amorphea;Obazoa;Opisthokonta;Nucletmycea;Fungi;Dikarya;Basidiomycota;Agaricomycotina;Wallemiomycetes;Wallemiales;Incertae Sedis;Wallemia;";"83.3";"14.4";"6";"6";"5";"1";"0";"457177";"391202"
"V4mis2";"SILVA (only NR);Eukaryota;Amorphea;Obazoa;Opisthokonta;Nucletmycea;Fungi;Dikarya;Basidiomycota;Pucciniomycotina;";"27.1";"14.4";"570";"569";"154";"415";"1";"456614";"391053"
"V4mis2";"SILVA (only NR);Eukaryota;Amorphea;Obazoa;Opisthokonta;Nucletmycea;Fungi;Dikarya;Basidiomycota;Pucciniomycotina;Agaricostilbomycetes;";"70.8";"14.4";"48";"48";"34";"14";"0";"457135";"391173"
"V4mis2";"SILVA (only NR);Eukaryota;Amorphea;Obazoa;Opisthokonta;Nucletmycea;Fungi;Dikarya;Basidiomycota;Pucciniomycotina;Agaricostilbomycetes;Agaricostilbales;";"73.9";"14.4";"46";"46";"34";"12";"0";"457137";"391173"
"V4mis2";"SILVA (only NR);Eukaryota;Amorphea;Obazoa;Opisthokonta;Nucletmycea;Fungi;Dikarya;Basidiomycota;Pucciniomycotina;Agaricostilbomycetes;Agaricostilbales;Agaricostilbaceae;";"81.8";"14.4";"11";"11";"9";"2";"0";"457172";"391198"
"V4mis2";"SILVA (only NR);Eukaryota;Amorphea;Obazoa;Opisthokonta;Nucletmycea;Fungi;Dikarya;Basidiomycota;Pucciniomycotina;Agaricostilbomycetes;Agaricostilbales;Agaricostilbaceae;Pseudobensingtonia;";"33.3";"14.4";"3";"3";"1";"2";"0";"457180";"391206"
"V4mis2";"SILVA (only NR);Eukaryota;Amorphea;Obazoa;Opisthokonta;Nucletmycea;Fungi;Dikarya;Basidiomycota;Pucciniomycotina;Agaricostilbomycetes;Agaricostilbales;Agaricostilbaceae;Sterigmatomyces;";"100.0";"14.4";"8";"8";"8";"0";"0";"457175";"391199"
"V4mis2";"SILVA (only NR);Eukaryota;Amorphea;Obazoa;Opisthokonta;Nucletmycea;Fungi;Dikarya;Basidiomycota;Pucciniomycotina;Agaricostilbomycetes;Agaricostilbales;Chionosphaeraceae;";"75.0";"14.4";"12";"12";"9";"3";"0";"457171";"391198"
"V4mis2";"SILVA (only NR);Eukaryota;Amorphea;Obazoa;Opisthokonta;Nucletmycea;Fungi;Dikarya;Basidiomycota;Pucciniomycotina;Agaricostilbomycetes;Agaricostilbales;Chionosphaeraceae;Ballistosporomyces;";"100.0";"14.4";"4";"4";"4";"0";"0";"457179";"391203"
"V4mis2";"SILVA (only NR);Eukaryota;Amorphea;Obazoa;Opisthokonta;Nucletmycea;Fungi;Dikarya;Basidiomycota;Pucciniomycotina;Agaricostilbomycetes;Agaricostilbales;Chionosphaeraceae;Chionosphaera;";"33.3";"14.4";"3";"3";"1";"2";"0";"457180";"391206"
"V4mis2";"SILVA (only NR);Eukaryota;Amorphea;Obazoa;Opisthokonta;Nucletmycea;Fungi;Dikarya;Basidiomycota;Pucciniomycotina;Agaricostilbomycetes;Agaricostilbales;Chionosphaeraceae;Cystobasidiopsis;";"100.0";"14.4";"1";"1";"1";"0";"0";"457182";"391206"
"V4mis2";"SILVA (only NR);Eukaryota;Amorphea;Obazoa;Opisthokonta;Nucletmycea;Fungi;Dikarya;Basidiomycota;Pucciniomycotina;Agaricostilbomycetes;Agaricostilbales;Chionosphaeraceae;Kurtzmanomyces;";"66.7";"14.4";"3";"3";"2";"1";"0";"457180";"391205"
"V4mis2";"SILVA (only NR);Eukaryota;Amorphea;Obazoa;Opisthokonta;Nucletmycea;Fungi;Dikarya;Basidiomycota;Pucciniomycotina;Agaricostilbomycetes;Agaricostilbales;Incertae Sedis;";"100.0";"14.4";"2";"2";"2";"0";"0";"457181";"391205"
"V4mis2";"SILVA (only NR);Eukaryota;Amorphea;Obazoa;Opisthokonta;Nucletmycea;Fungi;Dikarya;Basidiomycota;Pucciniomycotina;Agaricostilbomycetes;Agaricostilbales;Incertae Sedis;Jianyunia;";"100.0";"14.4";"2";"2";"2";"0";"0";"457181";"391205"
"V4mis2";"SILVA (only NR);Eukaryota;Amorphea;Obazoa;Opisthokonta;Nucletmycea;Fungi;Dikarya;Basidiomycota;Pucciniomycotina;Agaricostilbomycetes;Agaricostilbales;Kondoaceae;";"50.0";"14.4";"14";"14";"7";"7";"0";"457169";"391200"
"V4mis2";"SILVA (only NR);Eukaryota;Amorphea;Obazoa;Opisthokonta;Nucletmycea;Fungi;Dikarya;Basidiomycota;Pucciniomycotina;Agaricostilbomycetes;Agaricostilbales;Kondoaceae;Bensingtonia;";"0.0";"0";"3";"3";"0";"3";"0";"457180";"391207"
"V4mis2";"SILVA (only NR);Eukaryota;Amorphea;Obazoa;Opisthokonta;Nucletmycea;Fungi;Dikarya;Basidiomycota;Pucciniomycotina;Agaricostilbomycetes;Agaricostilbales;Kondoaceae;Kondoa;";"60.0";"14.4";"10";"10";"6";"4";"0";"457173";"391201"
"V4mis2";"SILVA (only NR);Eukaryota;Amorphea;Obazoa;Opisthokonta;Nucletmycea;Fungi;Dikarya;Basidiomycota;Pucciniomycotina;Agaricostilbomycetes;Agaricostilbales;Ruineniaceae;";"100.0";"14.4";"6";"6";"6";"0";"0";"457177";"391201"
"V4mis2";"SILVA (only NR);Eukaryota;Amorphea;Obazoa;Opisthokonta;Nucletmycea;Fungi;Dikarya;Basidiomycota;Pucciniomycotina;Agaricostilbomycetes;Agaricostilbales;Ruineniaceae;Ruinenia;";"100.0";"14.4";"6";"6";"6";"0";"0";"457177";"391201"
"V4mis2";"SILVA (only NR);Eukaryota;Amorphea;Obazoa;Opisthokonta;Nucletmycea;Fungi;Dikarya;Basidiomycota;Pucciniomycotina;Agaricostilbomycetes;Incertae Sedis;";"0.0";"0";"2";"2";"0";"2";"0";"457181";"391207"
"V4mis2";"SILVA (only NR);Eukaryota;Amorphea;Obazoa;Opisthokonta;Nucletmycea;Fungi;Dikarya;Basidiomycota;Pucciniomycotina;Agaricostilbomycetes;Incertae Sedis;Incertae Sedis;";"0.0";"0";"2";"2";"0";"2";"0";"457181";"391207"
"V4mis2";"SILVA (only NR);Eukaryota;Amorphea;Obazoa;Opisthokonta;Nucletmycea;Fungi;Dikarya;Basidiomycota;Pucciniomycotina;Agaricostilbomycetes;Incertae Sedis;Incertae Sedis;[Sporobolomyces] group;";"0.0";"0";"2";"2";"0";"2";"0";"457181";"391207"
"V4mis2";"SILVA (only NR);Eukaryota;Amorphea;Obazoa;Opisthokonta;Nucletmycea;Fungi;Dikarya;Basidiomycota;Pucciniomycotina;Atractiellomycetes;";"0.0";"0";"9";"9";"0";"9";"0";"457174";"391207"
"V4mis2";"SILVA (only NR);Eukaryota;Amorphea;Obazoa;Opisthokonta;Nucletmycea;Fungi;Dikarya;Basidiomycota;Pucciniomycotina;Atractiellomycetes;Atractiellales;";"0.0";"0";"9";"9";"0";"9";"0";"457174";"391207"
"V4mis2";"SILVA (only NR);Eukaryota;Amorphea;Obazoa;Opisthokonta;Nucletmycea;Fungi;Dikarya;Basidiomycota;Pucciniomycotina;Atractiellomycetes;Atractiellales;Atractidochium;";"0.0";"0";"1";"1";"0";"1";"0";"457182";"391207"
"V4mis2";"SILVA (only NR);Eukaryota;Amorphea;Obazoa;Opisthokonta;Nucletmycea;Fungi;Dikarya;Basidiomycota;Pucciniomycotina;Atractiellomycetes;Atractiellales;Atractiella;";"0.0";"0";"1";"1";"0";"1";"0";"457182";"391207"
"V4mis2";"SILVA (only NR);Eukaryota;Amorphea;Obazoa;Opisthokonta;Nucletmycea;Fungi;Dikarya;Basidiomycota;Pucciniomycotina;Atractiellomycetes;Atractiellales;Helicogloea;";"0.0";"0";"1";"1";"0";"1";"0";"457182";"391207"
"V4mis2";"SILVA (only NR);Eukaryota;Amorphea;Obazoa;Opisthokonta;Nucletmycea;Fungi;Dikarya;Basidiomycota;Pucciniomycotina;Atractiellomycetes;Atractiellales;Hobsonia;";"0.0";"0";"1";"1";"0";"1";"0";"457182";"391207"
"V4mis2";"SILVA (only NR);Eukaryota;Amorphea;Obazoa;Opisthokonta;Nucletmycea;Fungi;Dikarya;Basidiomycota;Pucciniomycotina;Atractiellomycetes;Atractiellales;Neogloea;";"0.0";"0";"2";"2";"0";"2";"0";"457181";"391207"
"V4mis2";"SILVA (only NR);Eukaryota;Amorphea;Obazoa;Opisthokonta;Nucletmycea;Fungi;Dikarya;Basidiomycota;Pucciniomycotina;Atractiellomycetes;Atractiellales;Phleogena;";"0.0";"0";"1";"1";"0";"1";"0";"457182";"391207"
"V4mis2";"SILVA (only NR);Eukaryota;Amorphea;Obazoa;Opisthokonta;Nucletmycea;Fungi;Dikarya;Basidiomycota;Pucciniomycotina;Atractiellomycetes;Atractiellales;Proceropycnis;";"0.0";"0";"1";"1";"0";"1";"0";"457182";"391207"
"V4mis2";"SILVA (only NR);Eukaryota;Amorphea;Obazoa;Opisthokonta;Nucletmycea;Fungi;Dikarya;Basidiomycota;Pucciniomycotina;Classiculomycetes;";"0.0";"0";"3";"3";"0";"3";"0";"457180";"391207"
"V4mis2";"SILVA (only NR);Eukaryota;Amorphea;Obazoa;Opisthokonta;Nucletmycea;Fungi;Dikarya;Basidiomycota;Pucciniomycotina;Classiculomycetes;Classiculales;";"0.0";"0";"3";"3";"0";"3";"0";"457180";"391207"
"V4mis2";"SILVA (only NR);Eukaryota;Amorphea;Obazoa;Opisthokonta;Nucletmycea;Fungi;Dikarya;Basidiomycota;Pucciniomycotina;Classiculomycetes;Classiculales;Classiculaceae;";"0.0";"0";"3";"3";"0";"3";"0";"457180";"391207"
"V4mis2";"SILVA (only NR);Eukaryota;Amorphea;Obazoa;Opisthokonta;Nucletmycea;Fungi;Dikarya;Basidiomycota;Pucciniomycotina;Classiculomycetes;Classiculales;Classiculaceae;Classicula;";"0.0";"0";"2";"2";"0";"2";"0";"457181";"391207"
"V4mis2";"SILVA (only NR);Eukaryota;Amorphea;Obazoa;Opisthokonta;Nucletmycea;Fungi;Dikarya;Basidiomycota;Pucciniomycotina;Classiculomycetes;Classiculales;Classiculaceae;Jaculispora;";"0.0";"0";"1";"1";"0";"1";"0";"457182";"391207"
"V4mis2";"SILVA (only NR);Eukaryota;Amorphea;Obazoa;Opisthokonta;Nucletmycea;Fungi;Dikarya;Basidiomycota;Pucciniomycotina;Cystobasidiomycetes;";"14.5";"14.4";"70";"69";"10";"59";"1";"457114";"391197"
"V4mis2";"SILVA (only NR);Eukaryota;Amorphea;Obazoa;Opisthokonta;Nucletmycea;Fungi;Dikarya;Basidiomycota;Pucciniomycotina;Cystobasidiomycetes;Cyphobasidiales;";"0.0";"0";"1";"1";"0";"1";"0";"457182";"391207"
"V4mis2";"SILVA (only NR);Eukaryota;Amorphea;Obazoa;Opisthokonta;Nucletmycea;Fungi;Dikarya;Basidiomycota;Pucciniomycotina;Cystobasidiomycetes;Cyphobasidiales;Cyphobasidiaceae;";"0.0";"0";"1";"1";"0";"1";"0";"457182";"391207"
"V4mis2";"SILVA (only NR);Eukaryota;Amorphea;Obazoa;Opisthokonta;Nucletmycea;Fungi;Dikarya;Basidiomycota;Pucciniomycotina;Cystobasidiomycetes;Cyphobasidiales;Cyphobasidiaceae;Cyphobasidium;";"0.0";"0";"1";"1";"0";"1";"0";"457182";"391207"
"V4mis2";"SILVA (only NR);Eukaryota;Amorphea;Obazoa;Opisthokonta;Nucletmycea;Fungi;Dikarya;Basidiomycota;Pucciniomycotina;Cystobasidiomycetes;Cystobasidiales;";"0.0";"0";"9";"9";"0";"9";"0";"457174";"391207"
"V4mis2";"SILVA (only NR);Eukaryota;Amorphea;Obazoa;Opisthokonta;Nucletmycea;Fungi;Dikarya;Basidiomycota;Pucciniomycotina;Cystobasidiomycetes;Cystobasidiales;Cystobasidiaceae;";"0.0";"0";"7";"7";"0";"7";"0";"457176";"391207"
"V4mis2";"SILVA (only NR);Eukaryota;Amorphea;Obazoa;Opisthokonta;Nucletmycea;Fungi;Dikarya;Basidiomycota;Pucciniomycotina;Cystobasidiomycetes;Cystobasidiales;Cystobasidiaceae;Cystobasidium;";"0.0";"0";"7";"7";"0";"7";"0";"457176";"391207"
"V4mis2";"SILVA (only NR);Eukaryota;Amorphea;Obazoa;Opisthokonta;Nucletmycea;Fungi;Dikarya;Basidiomycota;Pucciniomycotina;Cystobasidiomycetes;Cystobasidiales;Incertae Sedis;";"0.0";"0";"2";"2";"0";"2";"0";"457181";"391207"
"V4mis2";"SILVA (only NR);Eukaryota;Amorphea;Obazoa;Opisthokonta;Nucletmycea;Fungi;Dikarya;Basidiomycota;Pucciniomycotina;Cystobasidiomycetes;Cystobasidiales;Incertae Sedis;Occultifur;";"0.0";"0";"2";"2";"0";"2";"0";"457181";"391207"
"V4mis2";"SILVA (only NR);Eukaryota;Amorphea;Obazoa;Opisthokonta;Nucletmycea;Fungi;Dikarya;Basidiomycota;Pucciniomycotina;Cystobasidiomycetes;Erythrobasidiales;";"0.0";"0";"20";"20";"0";"20";"0";"457163";"391207"
"V4mis2";"SILVA (only NR);Eukaryota;Amorphea;Obazoa;Opisthokonta;Nucletmycea;Fungi;Dikarya;Basidiomycota;Pucciniomycotina;Cystobasidiomycetes;Erythrobasidiales;Erythrobasidiaceae;";"0.0";"0";"18";"18";"0";"18";"0";"457165";"391207"
"V4mis2";"SILVA (only NR);Eukaryota;Amorphea;Obazoa;Opisthokonta;Nucletmycea;Fungi;Dikarya;Basidiomycota;Pucciniomycotina;Cystobasidiomycetes;Erythrobasidiales;Erythrobasidiaceae;Bannoa;";"0.0";"0";"14";"14";"0";"14";"0";"457169";"391207"
"V4mis2";"SILVA (only NR);Eukaryota;Amorphea;Obazoa;Opisthokonta;Nucletmycea;Fungi;Dikarya;Basidiomycota;Pucciniomycotina;Cystobasidiomycetes;Erythrobasidiales;Erythrobasidiaceae;Erythrobasidium;";"0.0";"0";"4";"4";"0";"4";"0";"457179";"391207"
"V4mis2";"SILVA (only NR);Eukaryota;Amorphea;Obazoa;Opisthokonta;Nucletmycea;Fungi;Dikarya;Basidiomycota;Pucciniomycotina;Cystobasidiomycetes;Erythrobasidiales;Incertae Sedis;";"0.0";"0";"2";"2";"0";"2";"0";"457181";"391207"
"V4mis2";"SILVA (only NR);Eukaryota;Amorphea;Obazoa;Opisthokonta;Nucletmycea;Fungi;Dikarya;Basidiomycota;Pucciniomycotina;Cystobasidiomycetes;Erythrobasidiales;Incertae Sedis;Hasegawazyma;";"0.0";"0";"2";"2";"0";"2";"0";"457181";"391207"
"V4mis2";"SILVA (only NR);Eukaryota;Amorphea;Obazoa;Opisthokonta;Nucletmycea;Fungi;Dikarya;Basidiomycota;Pucciniomycotina;Cystobasidiomycetes;Incertae Sedis;";"23.5";"14.4";"35";"34";"8";"26";"1";"457149";"391199"
"V4mis2";"SILVA (only NR);Eukaryota;Amorphea;Obazoa;Opisthokonta;Nucletmycea;Fungi;Dikarya;Basidiomycota;Pucciniomycotina;Cystobasidiomycetes;Incertae Sedis;Incertae Sedis;";"23.5";"14.4";"35";"34";"8";"26";"1";"457149";"391199"
"V4mis2";"SILVA (only NR);Eukaryota;Amorphea;Obazoa;Opisthokonta;Nucletmycea;Fungi;Dikarya;Basidiomycota;Pucciniomycotina;Cystobasidiomycetes;Incertae Sedis;Incertae Sedis;Buckleyzyma;";"88.9";"14.4";"9";"9";"8";"1";"0";"457174";"391199"
"V4mis2";"SILVA (only NR);Eukaryota;Amorphea;Obazoa;Opisthokonta;Nucletmycea;Fungi;Dikarya;Basidiomycota;Pucciniomycotina;Cystobasidiomycetes;Incertae Sedis;Incertae Sedis;Cyrenella;";"0.0";"0";"1";"1";"0";"1";"0";"457182";"391207"
"V4mis2";"SILVA (only NR);Eukaryota;Amorphea;Obazoa;Opisthokonta;Nucletmycea;Fungi;Dikarya;Basidiomycota;Pucciniomycotina;Cystobasidiomycetes;Incertae Sedis;Incertae Sedis;Microsporomyces;";"0.0";"0";"2";"2";"0";"2";"0";"457181";"391207"
"V4mis2";"SILVA (only NR);Eukaryota;Amorphea;Obazoa;Opisthokonta;Nucletmycea;Fungi;Dikarya;Basidiomycota;Pucciniomycotina;Cystobasidiomycetes;Incertae Sedis;Incertae Sedis;Sakaguchia;";"0.0";"0";"7";"7";"0";"7";"0";"457176";"391207"
"V4mis2";"SILVA (only NR);Eukaryota;Amorphea;Obazoa;Opisthokonta;Nucletmycea;Fungi;Dikarya;Basidiomycota;Pucciniomycotina;Cystobasidiomycetes;Incertae Sedis;Incertae Sedis;Symmetrospora;";"0.0";"0";"9";"8";"0";"8";"1";"457175";"391207"
"V4mis2";"SILVA (only NR);Eukaryota;Amorphea;Obazoa;Opisthokonta;Nucletmycea;Fungi;Dikarya;Basidiomycota;Pucciniomycotina;Cystobasidiomycetes;Incertae Sedis;Incertae Sedis;uncultured;";"0.0";"0";"3";"3";"0";"3";"0";"457180";"391207"
"V4mis2";"SILVA (only NR);Eukaryota;Amorphea;Obazoa;Opisthokonta;Nucletmycea;Fungi;Dikarya;Basidiomycota;Pucciniomycotina;Cystobasidiomycetes;Naohideales;";"100.0";"14.4";"2";"2";"2";"0";"0";"457181";"391205"
"V4mis2";"SILVA (only NR);Eukaryota;Amorphea;Obazoa;Opisthokonta;Nucletmycea;Fungi;Dikarya;Basidiomycota;Pucciniomycotina;Cystobasidiomycetes;Naohideales;Naohideaceae;";"100.0";"14.4";"2";"2";"2";"0";"0";"457181";"391205"
"V4mis2";"SILVA (only NR);Eukaryota;Amorphea;Obazoa;Opisthokonta;Nucletmycea;Fungi;Dikarya;Basidiomycota;Pucciniomycotina;Cystobasidiomycetes;Naohideales;Naohideaceae;Naohidea;";"100.0";"14.4";"2";"2";"2";"0";"0";"457181";"391205"
"V4mis2";"SILVA (only NR);Eukaryota;Amorphea;Obazoa;Opisthokonta;Nucletmycea;Fungi;Dikarya;Basidiomycota;Pucciniomycotina;Microbotryomycetes;";"38.1";"14.4";"236";"236";"90";"146";"0";"456947";"391117"
"V4mis2";"SILVA (only NR);Eukaryota;Amorphea;Obazoa;Opisthokonta;Nucletmycea;Fungi;Dikarya;Basidiomycota;Pucciniomycotina;Microbotryomycetes;Heterogastridiales;";"0.0";"0";"1";"1";"0";"1";"0";"457182";"391207"
"V4mis2";"SILVA (only NR);Eukaryota;Amorphea;Obazoa;Opisthokonta;Nucletmycea;Fungi;Dikarya;Basidiomycota;Pucciniomycotina;Microbotryomycetes;Heterogastridiales;Heterogastridiaceae;";"0.0";"0";"1";"1";"0";"1";"0";"457182";"391207"
"V4mis2";"SILVA (only NR);Eukaryota;Amorphea;Obazoa;Opisthokonta;Nucletmycea;Fungi;Dikarya;Basidiomycota;Pucciniomycotina;Microbotryomycetes;Heterogastridiales;Heterogastridiaceae;Heterogastridium;";"0.0";"0";"1";"1";"0";"1";"0";"457182";"391207"
"V4mis2";"SILVA (only NR);Eukaryota;Amorphea;Obazoa;Opisthokonta;Nucletmycea;Fungi;Dikarya;Basidiomycota;Pucciniomycotina;Microbotryomycetes;Incertae Sedis;";"20.0";"14.4";"40";"40";"8";"32";"0";"457143";"391199"
"V4mis2";"SILVA (only NR);Eukaryota;Amorphea;Obazoa;Opisthokonta;Nucletmycea;Fungi;Dikarya;Basidiomycota;Pucciniomycotina;Microbotryomycetes;Incertae Sedis;Chrysozymaceae;";"16.0";"14.4";"25";"25";"4";"21";"0";"457158";"391203"
"V4mis2";"SILVA (only NR);Eukaryota;Amorphea;Obazoa;Opisthokonta;Nucletmycea;Fungi;Dikarya;Basidiomycota;Pucciniomycotina;Microbotryomycetes;Incertae Sedis;Chrysozymaceae;Bannozyma;";"0.0";"0";"2";"2";"0";"2";"0";"457181";"391207"
"V4mis2";"SILVA (only NR);Eukaryota;Amorphea;Obazoa;Opisthokonta;Nucletmycea;Fungi;Dikarya;Basidiomycota;Pucciniomycotina;Microbotryomycetes;Incertae Sedis;Chrysozymaceae;Chrysozyma;";"0.0";"0";"2";"2";"0";"2";"0";"457181";"391207"
"V4mis2";"SILVA (only NR);Eukaryota;Amorphea;Obazoa;Opisthokonta;Nucletmycea;Fungi;Dikarya;Basidiomycota;Pucciniomycotina;Microbotryomycetes;Incertae Sedis;Chrysozymaceae;Fellozyma;";"0.0";"0";"1";"1";"0";"1";"0";"457182";"391207"
"V4mis2";"SILVA (only NR);Eukaryota;Amorphea;Obazoa;Opisthokonta;Nucletmycea;Fungi;Dikarya;Basidiomycota;Pucciniomycotina;Microbotryomycetes;Incertae Sedis;Chrysozymaceae;Hamamotoa;";"0.0";"0";"2";"2";"0";"2";"0";"457181";"391207"
"V4mis2";"SILVA (only NR);Eukaryota;Amorphea;Obazoa;Opisthokonta;Nucletmycea;Fungi;Dikarya;Basidiomycota;Pucciniomycotina;Microbotryomycetes;Incertae Sedis;Chrysozymaceae;Oberwinklerozyma;";"0.0";"0";"2";"2";"0";"2";"0";"457181";"391207"
"V4mis2";"SILVA (only NR);Eukaryota;Amorphea;Obazoa;Opisthokonta;Nucletmycea;Fungi;Dikarya;Basidiomycota;Pucciniomycotina;Microbotryomycetes;Incertae Sedis;Chrysozymaceae;Pseudohyphozyma;";"0.0";"0";"1";"1";"0";"1";"0";"457182";"391207"
"V4mis2";"SILVA (only NR);Eukaryota;Amorphea;Obazoa;Opisthokonta;Nucletmycea;Fungi;Dikarya;Basidiomycota;Pucciniomycotina;Microbotryomycetes;Incertae Sedis;Chrysozymaceae;Sampaiozyma;";"100.0";"14.4";"2";"2";"2";"0";"0";"457181";"391205"
"V4mis2";"SILVA (only NR);Eukaryota;Amorphea;Obazoa;Opisthokonta;Nucletmycea;Fungi;Dikarya;Basidiomycota;Pucciniomycotina;Microbotryomycetes;Incertae Sedis;Chrysozymaceae;Slooffia;";"0.0";"0";"3";"3";"0";"3";"0";"457180";"391207"
"V4mis2";"SILVA (only NR);Eukaryota;Amorphea;Obazoa;Opisthokonta;Nucletmycea;Fungi;Dikarya;Basidiomycota;Pucciniomycotina;Microbotryomycetes;Incertae Sedis;Chrysozymaceae;Spencerozyma;";"0.0";"0";"1";"1";"0";"1";"0";"457182";"391207"
"V4mis2";"SILVA (only NR);Eukaryota;Amorphea;Obazoa;Opisthokonta;Nucletmycea;Fungi;Dikarya;Basidiomycota;Pucciniomycotina;Microbotryomycetes;Incertae Sedis;Chrysozymaceae;Trigonosporomyces;";"100.0";"14.4";"1";"1";"1";"0";"0";"457182";"391206"
"V4mis2";"SILVA (only NR);Eukaryota;Amorphea;Obazoa;Opisthokonta;Nucletmycea;Fungi;Dikarya;Basidiomycota;Pucciniomycotina;Microbotryomycetes;Incertae Sedis;Chrysozymaceae;Udeniozyma;";"0.0";"0";"1";"1";"0";"1";"0";"457182";"391207"
"V4mis2";"SILVA (only NR);Eukaryota;Amorphea;Obazoa;Opisthokonta;Nucletmycea;Fungi;Dikarya;Basidiomycota;Pucciniomycotina;Microbotryomycetes;Incertae Sedis;Chrysozymaceae;Vonarxula;";"0.0";"0";"1";"1";"0";"1";"0";"457182";"391207"
"V4mis2";"SILVA (only NR);Eukaryota;Amorphea;Obazoa;Opisthokonta;Nucletmycea;Fungi;Dikarya;Basidiomycota;Pucciniomycotina;Microbotryomycetes;Incertae Sedis;Chrysozymaceae;Yunzhangia;";"0.0";"0";"2";"2";"0";"2";"0";"457181";"391207"
"V4mis2";"SILVA (only NR);Eukaryota;Amorphea;Obazoa;Opisthokonta;Nucletmycea;Fungi;Dikarya;Basidiomycota;Pucciniomycotina;Microbotryomycetes;Incertae Sedis;Incertae Sedis;";"26.7";"14.4";"15";"15";"4";"11";"0";"457168";"391203"
"V4mis2";"SILVA (only NR);Eukaryota;Amorphea;Obazoa;Opisthokonta;Nucletmycea;Fungi;Dikarya;Basidiomycota;Pucciniomycotina;Microbotryomycetes;Incertae Sedis;Incertae Sedis;Colacogloea;";"36.4";"14.4";"11";"11";"4";"7";"0";"457172";"391203"
"V4mis2";"SILVA (only NR);Eukaryota;Amorphea;Obazoa;Opisthokonta;Nucletmycea;Fungi;Dikarya;Basidiomycota;Pucciniomycotina;Microbotryomycetes;Incertae Sedis;Incertae Sedis;Curvibasidium;";"0.0";"0";"3";"3";"0";"3";"0";"457180";"391207"
"V4mis2";"SILVA (only NR);Eukaryota;Amorphea;Obazoa;Opisthokonta;Nucletmycea;Fungi;Dikarya;Basidiomycota;Pucciniomycotina;Microbotryomycetes;Incertae Sedis;Incertae Sedis;Reniforma;";"0.0";"0";"1";"1";"0";"1";"0";"457182";"391207"
"V4mis2";"SILVA (only NR);Eukaryota;Amorphea;Obazoa;Opisthokonta;Nucletmycea;Fungi;Dikarya;Basidiomycota;Pucciniomycotina;Microbotryomycetes;Kriegeriales;";"0.0";"0";"11";"11";"0";"11";"0";"457172";"391207"
"V4mis2";"SILVA (only NR);Eukaryota;Amorphea;Obazoa;Opisthokonta;Nucletmycea;Fungi;Dikarya;Basidiomycota;Pucciniomycotina;Microbotryomycetes;Kriegeriales;Camptobasidiaceae;";"0.0";"0";"4";"4";"0";"4";"0";"457179";"391207"
"V4mis2";"SILVA (only NR);Eukaryota;Amorphea;Obazoa;Opisthokonta;Nucletmycea;Fungi;Dikarya;Basidiomycota;Pucciniomycotina;Microbotryomycetes;Kriegeriales;Camptobasidiaceae;Camptobasidium;";"0.0";"0";"3";"3";"0";"3";"0";"457180";"391207"
"V4mis2";"SILVA (only NR);Eukaryota;Amorphea;Obazoa;Opisthokonta;Nucletmycea;Fungi;Dikarya;Basidiomycota;Pucciniomycotina;Microbotryomycetes;Kriegeriales;Kriegeriaceae;";"0.0";"0";"6";"6";"0";"6";"0";"457177";"391207"
"V4mis2";"SILVA (only NR);Eukaryota;Amorphea;Obazoa;Opisthokonta;Nucletmycea;Fungi;Dikarya;Basidiomycota;Pucciniomycotina;Microbotryomycetes;Kriegeriales;Kriegeriaceae;Kriegeria;";"0.0";"0";"1";"1";"0";"1";"0";"457182";"391207"
"V4mis2";"SILVA (only NR);Eukaryota;Amorphea;Obazoa;Opisthokonta;Nucletmycea;Fungi;Dikarya;Basidiomycota;Pucciniomycotina;Microbotryomycetes;Kriegeriales;Kriegeriaceae;Phenoliferia;";"0.0";"0";"2";"2";"0";"2";"0";"457181";"391207"
"V4mis2";"SILVA (only NR);Eukaryota;Amorphea;Obazoa;Opisthokonta;Nucletmycea;Fungi;Dikarya;Basidiomycota;Pucciniomycotina;Microbotryomycetes;Kriegeriales;Kriegeriaceae;Yamadamyces;";"0.0";"0";"1";"1";"0";"1";"0";"457182";"391207"
"V4mis2";"SILVA (only NR);Eukaryota;Amorphea;Obazoa;Opisthokonta;Nucletmycea;Fungi;Dikarya;Basidiomycota;Pucciniomycotina;Microbotryomycetes;Leucosporidiales;";"0.0";"0";"10";"10";"0";"10";"0";"457173";"391207"
"V4mis2";"SILVA (only NR);Eukaryota;Amorphea;Obazoa;Opisthokonta;Nucletmycea;Fungi;Dikarya;Basidiomycota;Pucciniomycotina;Microbotryomycetes;Leucosporidiales;Leucosporidiaceae;";"0.0";"0";"10";"10";"0";"10";"0";"457173";"391207"
"V4mis2";"SILVA (only NR);Eukaryota;Amorphea;Obazoa;Opisthokonta;Nucletmycea;Fungi;Dikarya;Basidiomycota;Pucciniomycotina;Microbotryomycetes;Leucosporidiales;Leucosporidiaceae;Leucosporidium;";"0.0";"0";"10";"10";"0";"10";"0";"457173";"391207"
"V4mis2";"SILVA (only NR);Eukaryota;Amorphea;Obazoa;Opisthokonta;Nucletmycea;Fungi;Dikarya;Basidiomycota;Pucciniomycotina;Microbotryomycetes;Microbotryales;";"4.7";"14.4";"64";"64";"3";"61";"0";"457119";"391204"
"V4mis2";"SILVA (only NR);Eukaryota;Amorphea;Obazoa;Opisthokonta;Nucletmycea;Fungi;Dikarya;Basidiomycota;Pucciniomycotina;Microbotryomycetes;Microbotryales;Microbotryaceae;";"4.9";"14.4";"61";"61";"3";"58";"0";"457122";"391204"
"V4mis2";"SILVA (only NR);Eukaryota;Amorphea;Obazoa;Opisthokonta;Nucletmycea;Fungi;Dikarya;Basidiomycota;Pucciniomycotina;Microbotryomycetes;Microbotryales;Microbotryaceae;Microbotryum;";"5.0";"14.4";"60";"60";"3";"57";"0";"457123";"391204"
"V4mis2";"SILVA (only NR);Eukaryota;Amorphea;Obazoa;Opisthokonta;Nucletmycea;Fungi;Dikarya;Basidiomycota;Pucciniomycotina;Microbotryomycetes;Microbotryales;Microbotryaceae;Sphacelotheca;";"0.0";"0";"1";"1";"0";"1";"0";"457182";"391207"
"V4mis2";"SILVA (only NR);Eukaryota;Amorphea;Obazoa;Opisthokonta;Nucletmycea;Fungi;Dikarya;Basidiomycota;Pucciniomycotina;Microbotryomycetes;Microbotryales;Ustilentylomataceae;";"0.0";"0";"3";"3";"0";"3";"0";"457180";"391207"
"V4mis2";"SILVA (only NR);Eukaryota;Amorphea;Obazoa;Opisthokonta;Nucletmycea;Fungi;Dikarya;Basidiomycota;Pucciniomycotina;Microbotryomycetes;Microbotryales;Ustilentylomataceae;Ustilentyloma;";"0.0";"0";"3";"3";"0";"3";"0";"457180";"391207"
"V4mis2";"SILVA (only NR);Eukaryota;Amorphea;Obazoa;Opisthokonta;Nucletmycea;Fungi;Dikarya;Basidiomycota;Pucciniomycotina;Microbotryomycetes;Sporidiobolales;";"74.5";"14.4";"106";"106";"79";"27";"0";"457077";"391128"
"V4mis2";"SILVA (only NR);Eukaryota;Amorphea;Obazoa;Opisthokonta;Nucletmycea;Fungi;Dikarya;Basidiomycota;Pucciniomycotina;Microbotryomycetes;Sporidiobolales;Sporidiobolaceae;";"74.5";"14.4";"106";"106";"79";"27";"0";"457077";"391128"
"V4mis2";"SILVA (only NR);Eukaryota;Amorphea;Obazoa;Opisthokonta;Nucletmycea;Fungi;Dikarya;Basidiomycota;Pucciniomycotina;Microbotryomycetes;Sporidiobolales;Sporidiobolaceae;Rhodosporidiobolus;";"88.9";"14.4";"9";"9";"8";"1";"0";"457174";"391199"
"V4mis2";"SILVA (only NR);Eukaryota;Amorphea;Obazoa;Opisthokonta;Nucletmycea;Fungi;Dikarya;Basidiomycota;Pucciniomycotina;Microbotryomycetes;Sporidiobolales;Sporidiobolaceae;Rhodotorula;";"81.9";"14.4";"83";"83";"68";"15";"0";"457100";"391139"
"V4mis2";"SILVA (only NR);Eukaryota;Amorphea;Obazoa;Opisthokonta;Nucletmycea;Fungi;Dikarya;Basidiomycota;Pucciniomycotina;Microbotryomycetes;Sporidiobolales;Sporidiobolaceae;Sporidiobolus;";"0.0";"0";"2";"2";"0";"2";"0";"457181";"391207"
"V4mis2";"SILVA (only NR);Eukaryota;Amorphea;Obazoa;Opisthokonta;Nucletmycea;Fungi;Dikarya;Basidiomycota;Pucciniomycotina;Microbotryomycetes;Sporidiobolales;Sporidiobolaceae;Sporobolomyces;";"0.0";"0";"8";"8";"0";"8";"0";"457175";"391207"
"V4mis2";"SILVA (only NR);Eukaryota;Amorphea;Obazoa;Opisthokonta;Nucletmycea;Fungi;Dikarya;Basidiomycota;Pucciniomycotina;Microbotryomycetes;Sporidiobolales;Sporidiobolaceae;uncultured;";"75.0";"14.4";"4";"4";"3";"1";"0";"457179";"391204"
"V4mis2";"SILVA (only NR);Eukaryota;Amorphea;Obazoa;Opisthokonta;Nucletmycea;Fungi;Dikarya;Basidiomycota;Pucciniomycotina;Microbotryomycetes;uncultured;";"0.0";"0";"2";"2";"0";"2";"0";"457181";"391207"
"V4mis2";"SILVA (only NR);Eukaryota;Amorphea;Obazoa;Opisthokonta;Nucletmycea;Fungi;Dikarya;Basidiomycota;Pucciniomycotina;Mixiomycetes;";"50.0";"14.4";"2";"2";"1";"1";"0";"457181";"391206"
"V4mis2";"SILVA (only NR);Eukaryota;Amorphea;Obazoa;Opisthokonta;Nucletmycea;Fungi;Dikarya;Basidiomycota;Pucciniomycotina;Mixiomycetes;Mixiales;";"50.0";"14.4";"2";"2";"1";"1";"0";"457181";"391206"
"V4mis2";"SILVA (only NR);Eukaryota;Amorphea;Obazoa;Opisthokonta;Nucletmycea;Fungi;Dikarya;Basidiomycota;Pucciniomycotina;Mixiomycetes;Mixiales;Mixiaceae;";"50.0";"14.4";"2";"2";"1";"1";"0";"457181";"391206"
"V4mis2";"SILVA (only NR);Eukaryota;Amorphea;Obazoa;Opisthokonta;Nucletmycea;Fungi;Dikarya;Basidiomycota;Pucciniomycotina;Mixiomycetes;Mixiales;Mixiaceae;Mixia;";"50.0";"14.4";"2";"2";"1";"1";"0";"457181";"391206"
"V4mis2";"SILVA (only NR);Eukaryota;Amorphea;Obazoa;Opisthokonta;Nucletmycea;Fungi;Dikarya;Basidiomycota;Pucciniomycotina;Pucciniomycetes;";"0.6";"14.4";"181";"181";"1";"180";"0";"457002";"391206"
"V4mis2";"SILVA (only NR);Eukaryota;Amorphea;Obazoa;Opisthokonta;Nucletmycea;Fungi;Dikarya;Basidiomycota;Pucciniomycotina;Pucciniomycetes;Helicobasidiales;";"0.0";"0";"2";"2";"0";"2";"0";"457181";"391207"
"V4mis2";"SILVA (only NR);Eukaryota;Amorphea;Obazoa;Opisthokonta;Nucletmycea;Fungi;Dikarya;Basidiomycota;Pucciniomycotina;Pucciniomycetes;Helicobasidiales;Helicobasidiaceae;";"0.0";"0";"2";"2";"0";"2";"0";"457181";"391207"
"V4mis2";"SILVA (only NR);Eukaryota;Amorphea;Obazoa;Opisthokonta;Nucletmycea;Fungi;Dikarya;Basidiomycota;Pucciniomycotina;Pucciniomycetes;Helicobasidiales;Helicobasidiaceae;Helicobasidium;";"0.0";"0";"2";"2";"0";"2";"0";"457181";"391207"
"V4mis2";"SILVA (only NR);Eukaryota;Amorphea;Obazoa;Opisthokonta;Nucletmycea;Fungi;Dikarya;Basidiomycota;Pucciniomycotina;Pucciniomycetes;Platygloeaceae;";"0.0";"0";"4";"4";"0";"4";"0";"457179";"391207"
"V4mis2";"SILVA (only NR);Eukaryota;Amorphea;Obazoa;Opisthokonta;Nucletmycea;Fungi;Dikarya;Basidiomycota;Pucciniomycotina;Pucciniomycetes;Platygloeaceae;Insolibasidium;";"0.0";"0";"1";"1";"0";"1";"0";"457182";"391207"
"V4mis2";"SILVA (only NR);Eukaryota;Amorphea;Obazoa;Opisthokonta;Nucletmycea;Fungi;Dikarya;Basidiomycota;Pucciniomycotina;Pucciniomycetes;Platygloeaceae;Jola;";"0.0";"0";"1";"1";"0";"1";"0";"457182";"391207"
"V4mis2";"SILVA (only NR);Eukaryota;Amorphea;Obazoa;Opisthokonta;Nucletmycea;Fungi;Dikarya;Basidiomycota;Pucciniomycotina;Pucciniomycetes;Platygloeaceae;Platygloea;";"0.0";"0";"1";"1";"0";"1";"0";"457182";"391207"
"V4mis2";"SILVA (only NR);Eukaryota;Amorphea;Obazoa;Opisthokonta;Nucletmycea;Fungi;Dikarya;Basidiomycota;Pucciniomycotina;Pucciniomycetes;Pucciniales;";"0.6";"14.4";"166";"166";"1";"165";"0";"457017";"391206"
"V4mis2";"SILVA (only NR);Eukaryota;Amorphea;Obazoa;Opisthokonta;Nucletmycea;Fungi;Dikarya;Basidiomycota;Pucciniomycotina;Pucciniomycetes;Pucciniales;Achrotelium;";"0.0";"0";"1";"1";"0";"1";"0";"457182";"391207"
"V4mis2";"SILVA (only NR);Eukaryota;Amorphea;Obazoa;Opisthokonta;Nucletmycea;Fungi;Dikarya;Basidiomycota;Pucciniomycotina;Pucciniomycetes;Pucciniales;Aecidium;";"0.0";"0";"2";"2";"0";"2";"0";"457181";"391207"
"V4mis2";"SILVA (only NR);Eukaryota;Amorphea;Obazoa;Opisthokonta;Nucletmycea;Fungi;Dikarya;Basidiomycota;Pucciniomycotina;Pucciniomycetes;Pucciniales;Blastospora;";"0.0";"0";"1";"1";"0";"1";"0";"457182";"391207"
"V4mis2";"SILVA (only NR);Eukaryota;Amorphea;Obazoa;Opisthokonta;Nucletmycea;Fungi;Dikarya;Basidiomycota;Pucciniomycotina;Pucciniomycetes;Pucciniales;Coleosporiaceae;";"0.0";"0";"3";"3";"0";"3";"0";"457180";"391207"
"V4mis2";"SILVA (only NR);Eukaryota;Amorphea;Obazoa;Opisthokonta;Nucletmycea;Fungi;Dikarya;Basidiomycota;Pucciniomycotina;Pucciniomycetes;Pucciniales;Coleosporiaceae;Chrysomyxa;";"0.0";"0";"1";"1";"0";"1";"0";"457182";"391207"
"V4mis2";"SILVA (only NR);Eukaryota;Amorphea;Obazoa;Opisthokonta;Nucletmycea;Fungi;Dikarya;Basidiomycota;Pucciniomycotina;Pucciniomycetes;Pucciniales;Coleosporiaceae;Coleosporium;";"0.0";"0";"2";"2";"0";"2";"0";"457181";"391207"
"V4mis2";"SILVA (only NR);Eukaryota;Amorphea;Obazoa;Opisthokonta;Nucletmycea;Fungi;Dikarya;Basidiomycota;Pucciniomycotina;Pucciniomycetes;Pucciniales;Cronartium;";"0.0";"0";"1";"1";"0";"1";"0";"457182";"391207"
"V4mis2";"SILVA (only NR);Eukaryota;Amorphea;Obazoa;Opisthokonta;Nucletmycea;Fungi;Dikarya;Basidiomycota;Pucciniomycotina;Pucciniomycetes;Pucciniales;Dasturella;";"0.0";"0";"1";"1";"0";"1";"0";"457182";"391207"
"V4mis2";"SILVA (only NR);Eukaryota;Amorphea;Obazoa;Opisthokonta;Nucletmycea;Fungi;Dikarya;Basidiomycota;Pucciniomycotina;Pucciniomycetes;Pucciniales;Hemileia;";"0.0";"0";"1";"1";"0";"1";"0";"457182";"391207"
"V4mis2";"SILVA (only NR);Eukaryota;Amorphea;Obazoa;Opisthokonta;Nucletmycea;Fungi;Dikarya;Basidiomycota;Pucciniomycotina;Pucciniomycetes;Pucciniales;Incertae Sedis;";"0.0";"0";"2";"2";"0";"2";"0";"457181";"391207"
"V4mis2";"SILVA (only NR);Eukaryota;Amorphea;Obazoa;Opisthokonta;Nucletmycea;Fungi;Dikarya;Basidiomycota;Pucciniomycotina;Pucciniomycetes;Pucciniales;Incertae Sedis;Caeoma;";"0.0";"0";"1";"1";"0";"1";"0";"457182";"391207"
"V4mis2";"SILVA (only NR);Eukaryota;Amorphea;Obazoa;Opisthokonta;Nucletmycea;Fungi;Dikarya;Basidiomycota;Pucciniomycotina;Pucciniomycetes;Pucciniales;Incertae Sedis;Uredo;";"0.0";"0";"1";"1";"0";"1";"0";"457182";"391207"
"V4mis2";"SILVA (only NR);Eukaryota;Amorphea;Obazoa;Opisthokonta;Nucletmycea;Fungi;Dikarya;Basidiomycota;Pucciniomycotina;Pucciniomycetes;Pucciniales;Macruropyxis;";"0.0";"0";"1";"1";"0";"1";"0";"457182";"391207"
"V4mis2";"SILVA (only NR);Eukaryota;Amorphea;Obazoa;Opisthokonta;Nucletmycea;Fungi;Dikarya;Basidiomycota;Pucciniomycotina;Pucciniomycetes;Pucciniales;Melampsoraceae;";"0.0";"0";"5";"5";"0";"5";"0";"457178";"391207"
"V4mis2";"SILVA (only NR);Eukaryota;Amorphea;Obazoa;Opisthokonta;Nucletmycea;Fungi;Dikarya;Basidiomycota;Pucciniomycotina;Pucciniomycetes;Pucciniales;Melampsoraceae;Melampsora;";"0.0";"0";"5";"5";"0";"5";"0";"457178";"391207"
"V4mis2";"SILVA (only NR);Eukaryota;Amorphea;Obazoa;Opisthokonta;Nucletmycea;Fungi;Dikarya;Basidiomycota;Pucciniomycotina;Pucciniomycetes;Pucciniales;Mikronegeriaceae;";"0.0";"0";"1";"1";"0";"1";"0";"457182";"391207"
"V4mis2";"SILVA (only NR);Eukaryota;Amorphea;Obazoa;Opisthokonta;Nucletmycea;Fungi;Dikarya;Basidiomycota;Pucciniomycotina;Pucciniomycetes;Pucciniales;Mikronegeriaceae;Mikronegeria;";"0.0";"0";"1";"1";"0";"1";"0";"457182";"391207"
"V4mis2";"SILVA (only NR);Eukaryota;Amorphea;Obazoa;Opisthokonta;Nucletmycea;Fungi;Dikarya;Basidiomycota;Pucciniomycotina;Pucciniomycetes;Pucciniales;Milesina;";"0.0";"0";"1";"1";"0";"1";"0";"457182";"391207"
"V4mis2";"SILVA (only NR);Eukaryota;Amorphea;Obazoa;Opisthokonta;Nucletmycea;Fungi;Dikarya;Basidiomycota;Pucciniomycotina;Pucciniomycetes;Pucciniales;Nyssopsora;";"0.0";"0";"1";"1";"0";"1";"0";"457182";"391207"
"V4mis2";"SILVA (only NR);Eukaryota;Amorphea;Obazoa;Opisthokonta;Nucletmycea;Fungi;Dikarya;Basidiomycota;Pucciniomycotina;Pucciniomycetes;Pucciniales;Olivea;";"100.0";"14.4";"1";"1";"1";"0";"0";"457182";"391206"
"V4mis2";"SILVA (only NR);Eukaryota;Amorphea;Obazoa;Opisthokonta;Nucletmycea;Fungi;Dikarya;Basidiomycota;Pucciniomycotina;Pucciniomycetes;Pucciniales;Phakopsora;";"0.0";"0";"3";"3";"0";"3";"0";"457180";"391207"
"V4mis2";"SILVA (only NR);Eukaryota;Amorphea;Obazoa;Opisthokonta;Nucletmycea;Fungi;Dikarya;Basidiomycota;Pucciniomycotina;Pucciniomycetes;Pucciniales;Phakopsoraceae;";"0.0";"0";"2";"2";"0";"2";"0";"457181";"391207"
"V4mis2";"SILVA (only NR);Eukaryota;Amorphea;Obazoa;Opisthokonta;Nucletmycea;Fungi;Dikarya;Basidiomycota;Pucciniomycotina;Pucciniomycetes;Pucciniales;Phakopsoraceae;Prospodium;";"0.0";"0";"2";"2";"0";"2";"0";"457181";"391207"
"V4mis2";"SILVA (only NR);Eukaryota;Amorphea;Obazoa;Opisthokonta;Nucletmycea;Fungi;Dikarya;Basidiomycota;Pucciniomycotina;Pucciniomycetes;Pucciniales;Phragmidiaceae;";"0.0";"0";"68";"68";"0";"68";"0";"457115";"391207"
"V4mis2";"SILVA (only NR);Eukaryota;Amorphea;Obazoa;Opisthokonta;Nucletmycea;Fungi;Dikarya;Basidiomycota;Pucciniomycotina;Pucciniomycetes;Pucciniales;Phragmidiaceae;Gymnoconia;";"0.0";"0";"1";"1";"0";"1";"0";"457182";"391207"
"V4mis2";"SILVA (only NR);Eukaryota;Amorphea;Obazoa;Opisthokonta;Nucletmycea;Fungi;Dikarya;Basidiomycota;Pucciniomycotina;Pucciniomycetes;Pucciniales;Phragmidiaceae;Hamaspora;";"0.0";"0";"1";"1";"0";"1";"0";"457182";"391207"
"V4mis2";"SILVA (only NR);Eukaryota;Amorphea;Obazoa;Opisthokonta;Nucletmycea;Fungi;Dikarya;Basidiomycota;Pucciniomycotina;Pucciniomycetes;Pucciniales;Phragmidiaceae;Kuehneola;";"0.0";"0";"2";"2";"0";"2";"0";"457181";"391207"
"V4mis2";"SILVA (only NR);Eukaryota;Amorphea;Obazoa;Opisthokonta;Nucletmycea;Fungi;Dikarya;Basidiomycota;Pucciniomycotina;Pucciniomycetes;Pucciniales;Phragmidiaceae;Phragmidium;";"0.0";"0";"63";"63";"0";"63";"0";"457120";"391207"
"V4mis2";"SILVA (only NR);Eukaryota;Amorphea;Obazoa;Opisthokonta;Nucletmycea;Fungi;Dikarya;Basidiomycota;Pucciniomycotina;Pucciniomycetes;Pucciniales;Physopella;";"0.0";"0";"1";"1";"0";"1";"0";"457182";"391207"
"V4mis2";"SILVA (only NR);Eukaryota;Amorphea;Obazoa;Opisthokonta;Nucletmycea;Fungi;Dikarya;Basidiomycota;Pucciniomycotina;Pucciniomycetes;Pucciniales;Pileolaria;";"0.0";"0";"1";"1";"0";"1";"0";"457182";"391207"
"V4mis2";"SILVA (only NR);Eukaryota;Amorphea;Obazoa;Opisthokonta;Nucletmycea;Fungi;Dikarya;Basidiomycota;Pucciniomycotina;Pucciniomycetes;Pucciniales;Pileolariaceae;";"0.0";"0";"1";"1";"0";"1";"0";"457182";"391207"
"V4mis2";"SILVA (only NR);Eukaryota;Amorphea;Obazoa;Opisthokonta;Nucletmycea;Fungi;Dikarya;Basidiomycota;Pucciniomycotina;Pucciniomycetes;Pucciniales;Pileolariaceae;Uromycladium;";"0.0";"0";"1";"1";"0";"1";"0";"457182";"391207"
"V4mis2";"SILVA (only NR);Eukaryota;Amorphea;Obazoa;Opisthokonta;Nucletmycea;Fungi;Dikarya;Basidiomycota;Pucciniomycotina;Pucciniomycetes;Pucciniales;Porotenus;";"0.0";"0";"1";"1";"0";"1";"0";"457182";"391207"
"V4mis2";"SILVA (only NR);Eukaryota;Amorphea;Obazoa;Opisthokonta;Nucletmycea;Fungi;Dikarya;Basidiomycota;Pucciniomycotina;Pucciniomycetes;Pucciniales;Pucciniaceae;";"0.0";"0";"44";"44";"0";"44";"0";"457139";"391207"
"V4mis2";"SILVA (only NR);Eukaryota;Amorphea;Obazoa;Opisthokonta;Nucletmycea;Fungi;Dikarya;Basidiomycota;Pucciniomycotina;Pucciniomycetes;Pucciniales;Pucciniaceae;Allodus;";"0.0";"0";"1";"1";"0";"1";"0";"457182";"391207"
"V4mis2";"SILVA (only NR);Eukaryota;Amorphea;Obazoa;Opisthokonta;Nucletmycea;Fungi;Dikarya;Basidiomycota;Pucciniomycotina;Pucciniomycetes;Pucciniales;Pucciniaceae;Ceratocoma;";"0.0";"0";"1";"1";"0";"1";"0";"457182";"391207"
"V4mis2";"SILVA (only NR);Eukaryota;Amorphea;Obazoa;Opisthokonta;Nucletmycea;Fungi;Dikarya;Basidiomycota;Pucciniomycotina;Pucciniomycetes;Pucciniales;Pucciniaceae;Gymnosporangium;";"0.0";"0";"6";"6";"0";"6";"0";"457177";"391207"
"V4mis2";"SILVA (only NR);Eukaryota;Amorphea;Obazoa;Opisthokonta;Nucletmycea;Fungi;Dikarya;Basidiomycota;Pucciniomycotina;Pucciniomycetes;Pucciniales;Pucciniaceae;Puccinia;";"0.0";"0";"31";"31";"0";"31";"0";"457152";"391207"
"V4mis2";"SILVA (only NR);Eukaryota;Amorphea;Obazoa;Opisthokonta;Nucletmycea;Fungi;Dikarya;Basidiomycota;Pucciniomycotina;Pucciniomycetes;Pucciniales;Pucciniaceae;Puccorchidium;";"0.0";"0";"3";"3";"0";"3";"0";"457180";"391207"
"V4mis2";"SILVA (only NR);Eukaryota;Amorphea;Obazoa;Opisthokonta;Nucletmycea;Fungi;Dikarya;Basidiomycota;Pucciniomycotina;Pucciniomycetes;Pucciniales;Pucciniaceae;Uromyces;";"0.0";"0";"1";"1";"0";"1";"0";"457182";"391207"
"V4mis2";"SILVA (only NR);Eukaryota;Amorphea;Obazoa;Opisthokonta;Nucletmycea;Fungi;Dikarya;Basidiomycota;Pucciniomycotina;Pucciniomycetes;Pucciniales;Pucciniastraceae;";"0.0";"0";"9";"9";"0";"9";"0";"457174";"391207"
"V4mis2";"SILVA (only NR);Eukaryota;Amorphea;Obazoa;Opisthokonta;Nucletmycea;Fungi;Dikarya;Basidiomycota;Pucciniomycotina;Pucciniomycetes;Pucciniales;Pucciniastraceae;Hyalopsora;";"0.0";"0";"3";"3";"0";"3";"0";"457180";"391207"
"V4mis2";"SILVA (only NR);Eukaryota;Amorphea;Obazoa;Opisthokonta;Nucletmycea;Fungi;Dikarya;Basidiomycota;Pucciniomycotina;Pucciniomycetes;Pucciniales;Pucciniastraceae;Melampsorella;";"0.0";"0";"1";"1";"0";"1";"0";"457182";"391207"
"V4mis2";"SILVA (only NR);Eukaryota;Amorphea;Obazoa;Opisthokonta;Nucletmycea;Fungi;Dikarya;Basidiomycota;Pucciniomycotina;Pucciniomycetes;Pucciniales;Pucciniastraceae;Naohidemyces;";"0.0";"0";"1";"1";"0";"1";"0";"457182";"391207"
"V4mis2";"SILVA (only NR);Eukaryota;Amorphea;Obazoa;Opisthokonta;Nucletmycea;Fungi;Dikarya;Basidiomycota;Pucciniomycotina;Pucciniomycetes;Pucciniales;Pucciniastraceae;Pucciniastrum;";"0.0";"0";"2";"2";"0";"2";"0";"457181";"391207"
"V4mis2";"SILVA (only NR);Eukaryota;Amorphea;Obazoa;Opisthokonta;Nucletmycea;Fungi;Dikarya;Basidiomycota;Pucciniomycotina;Pucciniomycetes;Pucciniales;Pucciniastraceae;Thekopsora;";"0.0";"0";"2";"2";"0";"2";"0";"457181";"391207"
"V4mis2";"SILVA (only NR);Eukaryota;Amorphea;Obazoa;Opisthokonta;Nucletmycea;Fungi;Dikarya;Basidiomycota;Pucciniomycotina;Pucciniomycetes;Pucciniales;Racospermyces;";"0.0";"0";"1";"1";"0";"1";"0";"457182";"391207"
"V4mis2";"SILVA (only NR);Eukaryota;Amorphea;Obazoa;Opisthokonta;Nucletmycea;Fungi;Dikarya;Basidiomycota;Pucciniomycotina;Pucciniomycetes;Pucciniales;Raveneliaceae;";"0.0";"0";"4";"4";"0";"4";"0";"457179";"391207"
"V4mis2";"SILVA (only NR);Eukaryota;Amorphea;Obazoa;Opisthokonta;Nucletmycea;Fungi;Dikarya;Basidiomycota;Pucciniomycotina;Pucciniomycetes;Pucciniales;Raveneliaceae;Diorchidium;";"0.0";"0";"1";"1";"0";"1";"0";"457182";"391207"
"V4mis2";"SILVA (only NR);Eukaryota;Amorphea;Obazoa;Opisthokonta;Nucletmycea;Fungi;Dikarya;Basidiomycota;Pucciniomycotina;Pucciniomycetes;Pucciniales;Raveneliaceae;Ravenelia;";"0.0";"0";"1";"1";"0";"1";"0";"457182";"391207"
"V4mis2";"SILVA (only NR);Eukaryota;Amorphea;Obazoa;Opisthokonta;Nucletmycea;Fungi;Dikarya;Basidiomycota;Pucciniomycotina;Pucciniomycetes;Pucciniales;Raveneliaceae;Sphenospora;";"0.0";"0";"2";"2";"0";"2";"0";"457181";"391207"
"V4mis2";"SILVA (only NR);Eukaryota;Amorphea;Obazoa;Opisthokonta;Nucletmycea;Fungi;Dikarya;Basidiomycota;Pucciniomycotina;Pucciniomycetes;Pucciniales;Sphenorchidium;";"0.0";"0";"1";"1";"0";"1";"0";"457182";"391207"
"V4mis2";"SILVA (only NR);Eukaryota;Amorphea;Obazoa;Opisthokonta;Nucletmycea;Fungi;Dikarya;Basidiomycota;Pucciniomycotina;Pucciniomycetes;Pucciniales;Trachyspora;";"0.0";"0";"1";"1";"0";"1";"0";"457182";"391207"
"V4mis2";"SILVA (only NR);Eukaryota;Amorphea;Obazoa;Opisthokonta;Nucletmycea;Fungi;Dikarya;Basidiomycota;Pucciniomycotina;Pucciniomycetes;Pucciniales;Uropyxidaceae;";"0.0";"0";"5";"5";"0";"5";"0";"457178";"391207"
"V4mis2";"SILVA (only NR);Eukaryota;Amorphea;Obazoa;Opisthokonta;Nucletmycea;Fungi;Dikarya;Basidiomycota;Pucciniomycotina;Pucciniomycetes;Pucciniales;Uropyxidaceae;Dasyspora;";"0.0";"0";"2";"2";"0";"2";"0";"457181";"391207"
"V4mis2";"SILVA (only NR);Eukaryota;Amorphea;Obazoa;Opisthokonta;Nucletmycea;Fungi;Dikarya;Basidiomycota;Pucciniomycotina;Pucciniomycetes;Pucciniales;Uropyxidaceae;Leucotelium;";"0.0";"0";"1";"1";"0";"1";"0";"457182";"391207"
"V4mis2";"SILVA (only NR);Eukaryota;Amorphea;Obazoa;Opisthokonta;Nucletmycea;Fungi;Dikarya;Basidiomycota;Pucciniomycotina;Pucciniomycetes;Pucciniales;Uropyxidaceae;Tranzschelia;";"0.0";"0";"2";"2";"0";"2";"0";"457181";"391207"
"V4mis2";"SILVA (only NR);Eukaryota;Amorphea;Obazoa;Opisthokonta;Nucletmycea;Fungi;Dikarya;Basidiomycota;Pucciniomycotina;Pucciniomycetes;Septobasidiales;";"0.0";"0";"2";"2";"0";"2";"0";"457181";"391207"
"V4mis2";"SILVA (only NR);Eukaryota;Amorphea;Obazoa;Opisthokonta;Nucletmycea;Fungi;Dikarya;Basidiomycota;Pucciniomycotina;Pucciniomycetes;Septobasidiales;Septobasidiaceae;";"0.0";"0";"2";"2";"0";"2";"0";"457181";"391207"
"V4mis2";"SILVA (only NR);Eukaryota;Amorphea;Obazoa;Opisthokonta;Nucletmycea;Fungi;Dikarya;Basidiomycota;Pucciniomycotina;Pucciniomycetes;Septobasidiales;Septobasidiaceae;Septobasidium;";"0.0";"0";"2";"2";"0";"2";"0";"457181";"391207"
"V4mis2";"SILVA (only NR);Eukaryota;Amorphea;Obazoa;Opisthokonta;Nucletmycea;Fungi;Dikarya;Basidiomycota;Pucciniomycotina;Spiculogloeomycetes;";"100.0";"14.4";"6";"6";"6";"0";"0";"457177";"391201"
"V4mis2";"SILVA (only NR);Eukaryota;Amorphea;Obazoa;Opisthokonta;Nucletmycea;Fungi;Dikarya;Basidiomycota;Pucciniomycotina;Spiculogloeomycetes;Spiculogloeales;";"100.0";"14.4";"6";"6";"6";"0";"0";"457177";"391201"
"V4mis2";"SILVA (only NR);Eukaryota;Amorphea;Obazoa;Opisthokonta;Nucletmycea;Fungi;Dikarya;Basidiomycota;Pucciniomycotina;Spiculogloeomycetes;Spiculogloeales;Spiculogloeaceae;";"100.0";"14.4";"6";"6";"6";"0";"0";"457177";"391201"
"V4mis2";"SILVA (only NR);Eukaryota;Amorphea;Obazoa;Opisthokonta;Nucletmycea;Fungi;Dikarya;Basidiomycota;Pucciniomycotina;Spiculogloeomycetes;Spiculogloeales;Spiculogloeaceae;Mycogloea;";"100.0";"14.4";"1";"1";"1";"0";"0";"457182";"391206"
"V4mis2";"SILVA (only NR);Eukaryota;Amorphea;Obazoa;Opisthokonta;Nucletmycea;Fungi;Dikarya;Basidiomycota;Pucciniomycotina;Spiculogloeomycetes;Spiculogloeales;Spiculogloeaceae;Phyllozyma;";"100.0";"14.4";"4";"4";"4";"0";"0";"457179";"391203"
"V4mis2";"SILVA (only NR);Eukaryota;Amorphea;Obazoa;Opisthokonta;Nucletmycea;Fungi;Dikarya;Basidiomycota;Pucciniomycotina;Tritirachiomycetes;";"100.0";"14.4";"11";"11";"11";"0";"0";"457172";"391196"
"V4mis2";"SILVA (only NR);Eukaryota;Amorphea;Obazoa;Opisthokonta;Nucletmycea;Fungi;Dikarya;Basidiomycota;Pucciniomycotina;Tritirachiomycetes;Tritirachiales;";"100.0";"14.4";"11";"11";"11";"0";"0";"457172";"391196"
"V4mis2";"SILVA (only NR);Eukaryota;Amorphea;Obazoa;Opisthokonta;Nucletmycea;Fungi;Dikarya;Basidiomycota;Pucciniomycotina;Tritirachiomycetes;Tritirachiales;Tritirachiaceae;";"100.0";"14.4";"11";"11";"11";"0";"0";"457172";"391196"
"V4mis2";"SILVA (only NR);Eukaryota;Amorphea;Obazoa;Opisthokonta;Nucletmycea;Fungi;Dikarya;Basidiomycota;Pucciniomycotina;Tritirachiomycetes;Tritirachiales;Tritirachiaceae;Paratritirachium;";"100.0";"14.4";"2";"2";"2";"0";"0";"457181";"391205"
"V4mis2";"SILVA (only NR);Eukaryota;Amorphea;Obazoa;Opisthokonta;Nucletmycea;Fungi;Dikarya;Basidiomycota;Pucciniomycotina;Tritirachiomycetes;Tritirachiales;Tritirachiaceae;Tritirachium;";"100.0";"14.4";"9";"9";"9";"0";"0";"457174";"391198"
"V4mis2";"SILVA (only NR);Eukaryota;Amorphea;Obazoa;Opisthokonta;Nucletmycea;Fungi;Dikarya;Basidiomycota;Pucciniomycotina;uncultured;";"0.0";"0";"2";"2";"0";"2";"0";"457181";"391207"
"V4mis2";"SILVA (only NR);Eukaryota;Amorphea;Obazoa;Opisthokonta;Nucletmycea;Fungi;Dikarya;Basidiomycota;Ustilaginomycotina;";"75.3";"14.4";"594";"591";"445";"146";"3";"456592";"390762"
"V4mis2";"SILVA (only NR);Eukaryota;Amorphea;Obazoa;Opisthokonta;Nucletmycea;Fungi;Dikarya;Basidiomycota;Ustilaginomycotina;Exobasidiomycetes;";"57.7";"14.4";"52";"52";"30";"22";"0";"457131";"391177"
"V4mis2";"SILVA (only NR);Eukaryota;Amorphea;Obazoa;Opisthokonta;Nucletmycea;Fungi;Dikarya;Basidiomycota;Ustilaginomycotina;Exobasidiomycetes;Ceraceosorales;";"100.0";"14.4";"2";"2";"2";"0";"0";"457181";"391205"
"V4mis2";"SILVA (only NR);Eukaryota;Amorphea;Obazoa;Opisthokonta;Nucletmycea;Fungi;Dikarya;Basidiomycota;Ustilaginomycotina;Exobasidiomycetes;Ceraceosorales;Ceraceosoraceae;";"100.0";"14.4";"2";"2";"2";"0";"0";"457181";"391205"
"V4mis2";"SILVA (only NR);Eukaryota;Amorphea;Obazoa;Opisthokonta;Nucletmycea;Fungi;Dikarya;Basidiomycota;Ustilaginomycotina;Exobasidiomycetes;Ceraceosorales;Ceraceosoraceae;Ceraceosorus;";"100.0";"14.4";"2";"2";"2";"0";"0";"457181";"391205"
"V4mis2";"SILVA (only NR);Eukaryota;Amorphea;Obazoa;Opisthokonta;Nucletmycea;Fungi;Dikarya;Basidiomycota;Ustilaginomycotina;Exobasidiomycetes;Doassansiales;";"100.0";"14.4";"2";"2";"2";"0";"0";"457181";"391205"
"V4mis2";"SILVA (only NR);Eukaryota;Amorphea;Obazoa;Opisthokonta;Nucletmycea;Fungi;Dikarya;Basidiomycota;Ustilaginomycotina;Exobasidiomycetes;Doassansiales;Heterodoassansia;";"100.0";"14.4";"1";"1";"1";"0";"0";"457182";"391206"
"V4mis2";"SILVA (only NR);Eukaryota;Amorphea;Obazoa;Opisthokonta;Nucletmycea;Fungi;Dikarya;Basidiomycota;Ustilaginomycotina;Exobasidiomycetes;Doassansiales;Rhamphospora;";"100.0";"14.4";"1";"1";"1";"0";"0";"457182";"391206"
"V4mis2";"SILVA (only NR);Eukaryota;Amorphea;Obazoa;Opisthokonta;Nucletmycea;Fungi;Dikarya;Basidiomycota;Ustilaginomycotina;Exobasidiomycetes;Entylomatales;";"0.0";"0";"8";"8";"0";"8";"0";"457175";"391207"
"V4mis2";"SILVA (only NR);Eukaryota;Amorphea;Obazoa;Opisthokonta;Nucletmycea;Fungi;Dikarya;Basidiomycota;Ustilaginomycotina;Exobasidiomycetes;Entylomatales;Entylomataceae;";"0.0";"0";"1";"1";"0";"1";"0";"457182";"391207"
"V4mis2";"SILVA (only NR);Eukaryota;Amorphea;Obazoa;Opisthokonta;Nucletmycea;Fungi;Dikarya;Basidiomycota;Ustilaginomycotina;Exobasidiomycetes;Entylomatales;Entylomataceae;Entyloma;";"0.0";"0";"1";"1";"0";"1";"0";"457182";"391207"
"V4mis2";"SILVA (only NR);Eukaryota;Amorphea;Obazoa;Opisthokonta;Nucletmycea;Fungi;Dikarya;Basidiomycota;Ustilaginomycotina;Exobasidiomycetes;Entylomatales;Incertae Sedis;";"0.0";"0";"7";"7";"0";"7";"0";"457176";"391207"
"V4mis2";"SILVA (only NR);Eukaryota;Amorphea;Obazoa;Opisthokonta;Nucletmycea;Fungi;Dikarya;Basidiomycota;Ustilaginomycotina;Exobasidiomycetes;Entylomatales;Incertae Sedis;Tilletiopsis;";"0.0";"0";"7";"7";"0";"7";"0";"457176";"391207"
"V4mis2";"SILVA (only NR);Eukaryota;Amorphea;Obazoa;Opisthokonta;Nucletmycea;Fungi;Dikarya;Basidiomycota;Ustilaginomycotina;Exobasidiomycetes;Exobasidiales;";"100.0";"14.4";"10";"10";"10";"0";"0";"457173";"391197"
"V4mis2";"SILVA (only NR);Eukaryota;Amorphea;Obazoa;Opisthokonta;Nucletmycea;Fungi;Dikarya;Basidiomycota;Ustilaginomycotina;Exobasidiomycetes;Exobasidiales;Acaromyces;";"100.0";"14.4";"1";"1";"1";"0";"0";"457182";"391206"
"V4mis2";"SILVA (only NR);Eukaryota;Amorphea;Obazoa;Opisthokonta;Nucletmycea;Fungi;Dikarya;Basidiomycota;Ustilaginomycotina;Exobasidiomycetes;Exobasidiales;Brachybasidiaceae;";"100.0";"14.4";"3";"3";"3";"0";"0";"457180";"391204"
"V4mis2";"SILVA (only NR);Eukaryota;Amorphea;Obazoa;Opisthokonta;Nucletmycea;Fungi;Dikarya;Basidiomycota;Ustilaginomycotina;Exobasidiomycetes;Exobasidiales;Brachybasidiaceae;Dicellomyces;";"100.0";"14.4";"1";"1";"1";"0";"0";"457182";"391206"
"V4mis2";"SILVA (only NR);Eukaryota;Amorphea;Obazoa;Opisthokonta;Nucletmycea;Fungi;Dikarya;Basidiomycota;Ustilaginomycotina;Exobasidiomycetes;Exobasidiales;Brachybasidiaceae;Meira;";"100.0";"14.4";"1";"1";"1";"0";"0";"457182";"391206"
"V4mis2";"SILVA (only NR);Eukaryota;Amorphea;Obazoa;Opisthokonta;Nucletmycea;Fungi;Dikarya;Basidiomycota;Ustilaginomycotina;Exobasidiomycetes;Exobasidiales;Exobasidiaceae;";"100.0";"14.4";"4";"4";"4";"0";"0";"457179";"391203"
"V4mis2";"SILVA (only NR);Eukaryota;Amorphea;Obazoa;Opisthokonta;Nucletmycea;Fungi;Dikarya;Basidiomycota;Ustilaginomycotina;Exobasidiomycetes;Exobasidiales;Exobasidiaceae;Exobasidium;";"100.0";"14.4";"4";"4";"4";"0";"0";"457179";"391203"
"V4mis2";"SILVA (only NR);Eukaryota;Amorphea;Obazoa;Opisthokonta;Nucletmycea;Fungi;Dikarya;Basidiomycota;Ustilaginomycotina;Exobasidiomycetes;Exobasidiales;Graphiola;";"100.0";"14.4";"1";"1";"1";"0";"0";"457182";"391206"
"V4mis2";"SILVA (only NR);Eukaryota;Amorphea;Obazoa;Opisthokonta;Nucletmycea;Fungi;Dikarya;Basidiomycota;Ustilaginomycotina;Exobasidiomycetes;Georgefischeriales;";"66.7";"14.4";"12";"12";"8";"4";"0";"457171";"391199"
"V4mis2";"SILVA (only NR);Eukaryota;Amorphea;Obazoa;Opisthokonta;Nucletmycea;Fungi;Dikarya;Basidiomycota;Ustilaginomycotina;Exobasidiomycetes;Georgefischeriales;Georgefischeriaceae;";"100.0";"14.4";"2";"2";"2";"0";"0";"457181";"391205"
"V4mis2";"SILVA (only NR);Eukaryota;Amorphea;Obazoa;Opisthokonta;Nucletmycea;Fungi;Dikarya;Basidiomycota;Ustilaginomycotina;Exobasidiomycetes;Georgefischeriales;Georgefischeriaceae;Georgefischeria;";"100.0";"14.4";"1";"1";"1";"0";"0";"457182";"391206"
"V4mis2";"SILVA (only NR);Eukaryota;Amorphea;Obazoa;Opisthokonta;Nucletmycea;Fungi;Dikarya;Basidiomycota;Ustilaginomycotina;Exobasidiomycetes;Georgefischeriales;Gjaerumiaceae;";"0.0";"0";"3";"3";"0";"3";"0";"457180";"391207"
"V4mis2";"SILVA (only NR);Eukaryota;Amorphea;Obazoa;Opisthokonta;Nucletmycea;Fungi;Dikarya;Basidiomycota;Ustilaginomycotina;Exobasidiomycetes;Georgefischeriales;Gjaerumiaceae;Gjaerumia;";"0.0";"0";"3";"3";"0";"3";"0";"457180";"391207"
"V4mis2";"SILVA (only NR);Eukaryota;Amorphea;Obazoa;Opisthokonta;Nucletmycea;Fungi;Dikarya;Basidiomycota;Ustilaginomycotina;Exobasidiomycetes;Georgefischeriales;Tilletiariaceae;";"85.7";"14.4";"7";"7";"6";"1";"0";"457176";"391201"
"V4mis2";"SILVA (only NR);Eukaryota;Amorphea;Obazoa;Opisthokonta;Nucletmycea;Fungi;Dikarya;Basidiomycota;Ustilaginomycotina;Exobasidiomycetes;Georgefischeriales;Tilletiariaceae;Phragmotaenium;";"80.0";"14.4";"5";"5";"4";"1";"0";"457178";"391203"
"V4mis2";"SILVA (only NR);Eukaryota;Amorphea;Obazoa;Opisthokonta;Nucletmycea;Fungi;Dikarya;Basidiomycota;Ustilaginomycotina;Exobasidiomycetes;Georgefischeriales;Tilletiariaceae;Tilletiaria;";"100.0";"14.4";"2";"2";"2";"0";"0";"457181";"391205"
"V4mis2";"SILVA (only NR);Eukaryota;Amorphea;Obazoa;Opisthokonta;Nucletmycea;Fungi;Dikarya;Basidiomycota;Ustilaginomycotina;Exobasidiomycetes;Microstromatales;";"100.0";"14.4";"8";"8";"8";"0";"0";"457175";"391199"
"V4mis2";"SILVA (only NR);Eukaryota;Amorphea;Obazoa;Opisthokonta;Nucletmycea;Fungi;Dikarya;Basidiomycota;Ustilaginomycotina;Exobasidiomycetes;Microstromatales;Incertae Sedis;";"100.0";"14.4";"2";"2";"2";"0";"0";"457181";"391205"
"V4mis2";"SILVA (only NR);Eukaryota;Amorphea;Obazoa;Opisthokonta;Nucletmycea;Fungi;Dikarya;Basidiomycota;Ustilaginomycotina;Exobasidiomycetes;Microstromatales;Incertae Sedis;Sympodiomycopsis;";"100.0";"14.4";"2";"2";"2";"0";"0";"457181";"391205"
"V4mis2";"SILVA (only NR);Eukaryota;Amorphea;Obazoa;Opisthokonta;Nucletmycea;Fungi;Dikarya;Basidiomycota;Ustilaginomycotina;Exobasidiomycetes;Microstromatales;Jaminaea;";"100.0";"14.4";"1";"1";"1";"0";"0";"457182";"391206"
"V4mis2";"SILVA (only NR);Eukaryota;Amorphea;Obazoa;Opisthokonta;Nucletmycea;Fungi;Dikarya;Basidiomycota;Ustilaginomycotina;Exobasidiomycetes;Microstromatales;Microstromataceae;";"100.0";"14.4";"3";"3";"3";"0";"0";"457180";"391204"
"V4mis2";"SILVA (only NR);Eukaryota;Amorphea;Obazoa;Opisthokonta;Nucletmycea;Fungi;Dikarya;Basidiomycota;Ustilaginomycotina;Exobasidiomycetes;Microstromatales;Microstromataceae;Microstroma;";"100.0";"14.4";"3";"3";"3";"0";"0";"457180";"391204"
"V4mis2";"SILVA (only NR);Eukaryota;Amorphea;Obazoa;Opisthokonta;Nucletmycea;Fungi;Dikarya;Basidiomycota;Ustilaginomycotina;Exobasidiomycetes;Microstromatales;Quambalaria;";"100.0";"14.4";"1";"1";"1";"0";"0";"457182";"391206"
"V4mis2";"SILVA (only NR);Eukaryota;Amorphea;Obazoa;Opisthokonta;Nucletmycea;Fungi;Dikarya;Basidiomycota;Ustilaginomycotina;Exobasidiomycetes;Robbauerales;";"0.0";"0";"3";"3";"0";"3";"0";"457180";"391207"
"V4mis2";"SILVA (only NR);Eukaryota;Amorphea;Obazoa;Opisthokonta;Nucletmycea;Fungi;Dikarya;Basidiomycota;Ustilaginomycotina;Exobasidiomycetes;Robbauerales;Robbaueraceae;";"0.0";"0";"3";"3";"0";"3";"0";"457180";"391207"
"V4mis2";"SILVA (only NR);Eukaryota;Amorphea;Obazoa;Opisthokonta;Nucletmycea;Fungi;Dikarya;Basidiomycota;Ustilaginomycotina;Exobasidiomycetes;Robbauerales;Robbaueraceae;Robbauera;";"0.0";"0";"3";"3";"0";"3";"0";"457180";"391207"
"V4mis2";"SILVA (only NR);Eukaryota;Amorphea;Obazoa;Opisthokonta;Nucletmycea;Fungi;Dikarya;Basidiomycota;Ustilaginomycotina;Exobasidiomycetes;Tilletiales;";"0.0";"0";"6";"6";"0";"6";"0";"457177";"391207"
"V4mis2";"SILVA (only NR);Eukaryota;Amorphea;Obazoa;Opisthokonta;Nucletmycea;Fungi;Dikarya;Basidiomycota;Ustilaginomycotina;Exobasidiomycetes;Tilletiales;Tilletiaceae;";"0.0";"0";"6";"6";"0";"6";"0";"457177";"391207"
"V4mis2";"SILVA (only NR);Eukaryota;Amorphea;Obazoa;Opisthokonta;Nucletmycea;Fungi;Dikarya;Basidiomycota;Ustilaginomycotina;Exobasidiomycetes;Tilletiales;Tilletiaceae;Erratomyces;";"0.0";"0";"1";"1";"0";"1";"0";"457182";"391207"
"V4mis2";"SILVA (only NR);Eukaryota;Amorphea;Obazoa;Opisthokonta;Nucletmycea;Fungi;Dikarya;Basidiomycota;Ustilaginomycotina;Exobasidiomycetes;Tilletiales;Tilletiaceae;Salmacisia;";"0.0";"0";"1";"1";"0";"1";"0";"457182";"391207"
"V4mis2";"SILVA (only NR);Eukaryota;Amorphea;Obazoa;Opisthokonta;Nucletmycea;Fungi;Dikarya;Basidiomycota;Ustilaginomycotina;Exobasidiomycetes;Tilletiales;Tilletiaceae;Tilletia;";"0.0";"0";"4";"4";"0";"4";"0";"457179";"391207"
"V4mis2";"SILVA (only NR);Eukaryota;Amorphea;Obazoa;Opisthokonta;Nucletmycea;Fungi;Dikarya;Basidiomycota;Ustilaginomycotina;Malasseziomycetes;";"75.5";"14.4";"496";"493";"372";"121";"3";"456690";"390835"
"V4mis2";"SILVA (only NR);Eukaryota;Amorphea;Obazoa;Opisthokonta;Nucletmycea;Fungi;Dikarya;Basidiomycota;Ustilaginomycotina;Malasseziomycetes;Malasseziales;";"75.5";"14.4";"496";"493";"372";"121";"3";"456690";"390835"
"V4mis2";"SILVA (only NR);Eukaryota;Amorphea;Obazoa;Opisthokonta;Nucletmycea;Fungi;Dikarya;Basidiomycota;Ustilaginomycotina;Malasseziomycetes;Malasseziales;Malasseziaceae;";"75.5";"14.4";"496";"493";"372";"121";"3";"456690";"390835"
"V4mis2";"SILVA (only NR);Eukaryota;Amorphea;Obazoa;Opisthokonta;Nucletmycea;Fungi;Dikarya;Basidiomycota;Ustilaginomycotina;Malasseziomycetes;Malasseziales;Malasseziaceae;Malassezia;";"75.5";"14.4";"496";"493";"372";"121";"3";"456690";"390835"
"V4mis2";"SILVA (only NR);Eukaryota;Amorphea;Obazoa;Opisthokonta;Nucletmycea;Fungi;Dikarya;Basidiomycota;Ustilaginomycotina;Moniliellomycetes;";"100.0";"14.4";"6";"6";"6";"0";"0";"457177";"391201"
"V4mis2";"SILVA (only NR);Eukaryota;Amorphea;Obazoa;Opisthokonta;Nucletmycea;Fungi;Dikarya;Basidiomycota;Ustilaginomycotina;Moniliellomycetes;Moniliellales;";"100.0";"14.4";"6";"6";"6";"0";"0";"457177";"391201"
"V4mis2";"SILVA (only NR);Eukaryota;Amorphea;Obazoa;Opisthokonta;Nucletmycea;Fungi;Dikarya;Basidiomycota;Ustilaginomycotina;Moniliellomycetes;Moniliellales;Moniliellaceae;";"100.0";"14.4";"6";"6";"6";"0";"0";"457177";"391201"
"V4mis2";"SILVA (only NR);Eukaryota;Amorphea;Obazoa;Opisthokonta;Nucletmycea;Fungi;Dikarya;Basidiomycota;Ustilaginomycotina;Moniliellomycetes;Moniliellales;Moniliellaceae;Moniliella;";"100.0";"14.4";"6";"6";"6";"0";"0";"457177";"391201"
"V4mis2";"SILVA (only NR);Eukaryota;Amorphea;Obazoa;Opisthokonta;Nucletmycea;Fungi;Dikarya;Basidiomycota;Ustilaginomycotina;Ustilaginomycetes;";"92.5";"14.4";"40";"40";"37";"3";"0";"457143";"391170"
"V4mis2";"SILVA (only NR);Eukaryota;Amorphea;Obazoa;Opisthokonta;Nucletmycea;Fungi;Dikarya;Basidiomycota;Ustilaginomycotina;Ustilaginomycetes;Urocystidales;";"100.0";"14.4";"3";"3";"3";"0";"0";"457180";"391204"
"V4mis2";"SILVA (only NR);Eukaryota;Amorphea;Obazoa;Opisthokonta;Nucletmycea;Fungi;Dikarya;Basidiomycota;Ustilaginomycotina;Ustilaginomycetes;Urocystidales;Fereydounia;";"100.0";"14.4";"1";"1";"1";"0";"0";"457182";"391206"
"V4mis2";"SILVA (only NR);Eukaryota;Amorphea;Obazoa;Opisthokonta;Nucletmycea;Fungi;Dikarya;Basidiomycota;Ustilaginomycotina;Ustilaginomycetes;Urocystidales;Melanotaeniaceae;";"100.0";"14.4";"2";"2";"2";"0";"0";"457181";"391205"
"V4mis2";"SILVA (only NR);Eukaryota;Amorphea;Obazoa;Opisthokonta;Nucletmycea;Fungi;Dikarya;Basidiomycota;Ustilaginomycotina;Ustilaginomycetes;Urocystidales;Melanotaeniaceae;Melanotaenium;";"100.0";"14.4";"2";"2";"2";"0";"0";"457181";"391205"
"V4mis2";"SILVA (only NR);Eukaryota;Amorphea;Obazoa;Opisthokonta;Nucletmycea;Fungi;Dikarya;Basidiomycota;Ustilaginomycotina;Ustilaginomycetes;Ustilaginales;";"94.4";"14.4";"36";"36";"34";"2";"0";"457147";"391173"
"V4mis2";"SILVA (only NR);Eukaryota;Amorphea;Obazoa;Opisthokonta;Nucletmycea;Fungi;Dikarya;Basidiomycota;Ustilaginomycotina;Ustilaginomycetes;Ustilaginales;Anthracoideaceae;";"100.0";"14.4";"2";"2";"2";"0";"0";"457181";"391205"
"V4mis2";"SILVA (only NR);Eukaryota;Amorphea;Obazoa;Opisthokonta;Nucletmycea;Fungi;Dikarya;Basidiomycota;Ustilaginomycotina;Ustilaginomycetes;Ustilaginales;Anthracoideaceae;Anthracoidea;";"100.0";"14.4";"2";"2";"2";"0";"0";"457181";"391205"
"V4mis2";"SILVA (only NR);Eukaryota;Amorphea;Obazoa;Opisthokonta;Nucletmycea;Fungi;Dikarya;Basidiomycota;Ustilaginomycotina;Ustilaginomycetes;Ustilaginales;Ustilaginaceae;";"94.1";"14.4";"34";"34";"32";"2";"0";"457149";"391175"
"V4mis2";"SILVA (only NR);Eukaryota;Amorphea;Obazoa;Opisthokonta;Nucletmycea;Fungi;Dikarya;Basidiomycota;Ustilaginomycotina;Ustilaginomycetes;Ustilaginales;Ustilaginaceae;Anthracocystis;";"100.0";"14.4";"1";"1";"1";"0";"0";"457182";"391206"
"V4mis2";"SILVA (only NR);Eukaryota;Amorphea;Obazoa;Opisthokonta;Nucletmycea;Fungi;Dikarya;Basidiomycota;Ustilaginomycotina;Ustilaginomycetes;Ustilaginales;Ustilaginaceae;Cintractia;";"100.0";"14.4";"1";"1";"1";"0";"0";"457182";"391206"
"V4mis2";"SILVA (only NR);Eukaryota;Amorphea;Obazoa;Opisthokonta;Nucletmycea;Fungi;Dikarya;Basidiomycota;Ustilaginomycotina;Ustilaginomycetes;Ustilaginales;Ustilaginaceae;Farysia;";"100.0";"14.4";"2";"2";"2";"0";"0";"457181";"391205"
"V4mis2";"SILVA (only NR);Eukaryota;Amorphea;Obazoa;Opisthokonta;Nucletmycea;Fungi;Dikarya;Basidiomycota;Ustilaginomycotina;Ustilaginomycetes;Ustilaginales;Ustilaginaceae;Leucocintractia;";"100.0";"14.4";"1";"1";"1";"0";"0";"457182";"391206"
"V4mis2";"SILVA (only NR);Eukaryota;Amorphea;Obazoa;Opisthokonta;Nucletmycea;Fungi;Dikarya;Basidiomycota;Ustilaginomycotina;Ustilaginomycetes;Ustilaginales;Ustilaginaceae;Melanopsichium;";"100.0";"14.4";"5";"5";"5";"0";"0";"457178";"391202"
"V4mis2";"SILVA (only NR);Eukaryota;Amorphea;Obazoa;Opisthokonta;Nucletmycea;Fungi;Dikarya;Basidiomycota;Ustilaginomycotina;Ustilaginomycetes;Ustilaginales;Ustilaginaceae;Moesziomyces;";"100.0";"14.4";"2";"2";"2";"0";"0";"457181";"391205"
"V4mis2";"SILVA (only NR);Eukaryota;Amorphea;Obazoa;Opisthokonta;Nucletmycea;Fungi;Dikarya;Basidiomycota;Ustilaginomycotina;Ustilaginomycetes;Ustilaginales;Ustilaginaceae;Pseudozyma;";"100.0";"14.4";"2";"2";"2";"0";"0";"457181";"391205"
"V4mis2";"SILVA (only NR);Eukaryota;Amorphea;Obazoa;Opisthokonta;Nucletmycea;Fungi;Dikarya;Basidiomycota;Ustilaginomycotina;Ustilaginomycetes;Ustilaginales;Ustilaginaceae;Schizonella;";"100.0";"14.4";"3";"3";"3";"0";"0";"457180";"391204"
"V4mis2";"SILVA (only NR);Eukaryota;Amorphea;Obazoa;Opisthokonta;Nucletmycea;Fungi;Dikarya;Basidiomycota;Ustilaginomycotina;Ustilaginomycetes;Ustilaginales;Ustilaginaceae;Sporisorium;";"85.7";"14.4";"7";"7";"6";"1";"0";"457176";"391201"
"V4mis2";"SILVA (only NR);Eukaryota;Amorphea;Obazoa;Opisthokonta;Nucletmycea;Fungi;Dikarya;Basidiomycota;Ustilaginomycotina;Ustilaginomycetes;Ustilaginales;Ustilaginaceae;Testicularia;";"0.0";"0";"1";"1";"0";"1";"0";"457182";"391207"
"V4mis2";"SILVA (only NR);Eukaryota;Amorphea;Obazoa;Opisthokonta;Nucletmycea;Fungi;Dikarya;Basidiomycota;Ustilaginomycotina;Ustilaginomycetes;Ustilaginales;Ustilaginaceae;Tranzscheliella;";"100.0";"14.4";"1";"1";"1";"0";"0";"457182";"391206"
"V4mis2";"SILVA (only NR);Eukaryota;Amorphea;Obazoa;Opisthokonta;Nucletmycea;Fungi;Dikarya;Basidiomycota;Ustilaginomycotina;Ustilaginomycetes;Ustilaginales;Ustilaginaceae;Ustanciosporium;";"100.0";"14.4";"1";"1";"1";"0";"0";"457182";"391206"
"V4mis2";"SILVA (only NR);Eukaryota;Amorphea;Obazoa;Opisthokonta;Nucletmycea;Fungi;Dikarya;Basidiomycota;Ustilaginomycotina;Ustilaginomycetes;Ustilaginales;Ustilaginaceae;Ustilago;";"100.0";"14.4";"6";"6";"6";"0";"0";"457177";"391201"
"V4mis2";"SILVA (only NR);Eukaryota;Amorphea;Obazoa;Opisthokonta;Nucletmycea;Fungi;Dikarya;Basidiomycota;Ustilaginomycotina;Ustilaginomycetes;Violaceomycetales;";"0.0";"0";"1";"1";"0";"1";"0";"457182";"391207"
"V4mis2";"SILVA (only NR);Eukaryota;Amorphea;Obazoa;Opisthokonta;Nucletmycea;Fungi;Dikarya;Basidiomycota;Ustilaginomycotina;Ustilaginomycetes;Violaceomycetales;Violaceomycetaceae;";"0.0";"0";"1";"1";"0";"1";"0";"457182";"391207"
"V4mis2";"SILVA (only NR);Eukaryota;Amorphea;Obazoa;Opisthokonta;Nucletmycea;Fungi;Dikarya;Basidiomycota;Ustilaginomycotina;Ustilaginomycetes;Violaceomycetales;Violaceomycetaceae;Violaceomyces;";"0.0";"0";"1";"1";"0";"1";"0";"457182";"391207"
"V4mis2";"SILVA (only NR);Eukaryota;Amorphea;Obazoa;Opisthokonta;Nucletmycea;Fungi;Dikarya;Basidiomycota;uncultured;";"0.0";"0";"2";"2";"0";"2";"0";"457181";"391207"
"V4mis2";"SILVA (only NR);Eukaryota;Amorphea;Obazoa;Opisthokonta;Nucletmycea;Fungi;Dikarya;Dikarya Incertae Sedis;";"0.0";"0";"2";"2";"0";"2";"0";"457181";"391207"
"V4mis2";"SILVA (only NR);Eukaryota;Amorphea;Obazoa;Opisthokonta;Nucletmycea;Fungi;Dikarya;Dikarya Incertae Sedis;Entorrhizomycetes;";"0.0";"0";"2";"2";"0";"2";"0";"457181";"391207"
"V4mis2";"SILVA (only NR);Eukaryota;Amorphea;Obazoa;Opisthokonta;Nucletmycea;Fungi;Dikarya;Dikarya Incertae Sedis;Entorrhizomycetes;Entorrhizales;";"0.0";"0";"2";"2";"0";"2";"0";"457181";"391207"
"V4mis2";"SILVA (only NR);Eukaryota;Amorphea;Obazoa;Opisthokonta;Nucletmycea;Fungi;Dikarya;Dikarya Incertae Sedis;Entorrhizomycetes;Entorrhizales;Entorrhizaceae;";"0.0";"0";"2";"2";"0";"2";"0";"457181";"391207"
"V4mis2";"SILVA (only NR);Eukaryota;Amorphea;Obazoa;Opisthokonta;Nucletmycea;Fungi;Dikarya;Dikarya Incertae Sedis;Entorrhizomycetes;Entorrhizales;Entorrhizaceae;Entorrhiza;";"0.0";"0";"2";"2";"0";"2";"0";"457181";"391207"
"V4mis2";"SILVA (only NR);Eukaryota;Amorphea;Obazoa;Opisthokonta;Nucletmycea;Fungi;Incertae Sedis;";"0.0";"0";"3";"3";"0";"3";"0";"457180";"391207"
"V4mis2";"SILVA (only NR);Eukaryota;Amorphea;Obazoa;Opisthokonta;Nucletmycea;Fungi;Incertae Sedis;Incertae Sedis;";"0.0";"0";"3";"3";"0";"3";"0";"457180";"391207"
"V4mis2";"SILVA (only NR);Eukaryota;Amorphea;Obazoa;Opisthokonta;Nucletmycea;Fungi;Incertae Sedis;Incertae Sedis;Incertae Sedis;";"0.0";"0";"3";"3";"0";"3";"0";"457180";"391207"
"V4mis2";"SILVA (only NR);Eukaryota;Amorphea;Obazoa;Opisthokonta;Nucletmycea;Fungi;Incertae Sedis;Incertae Sedis;Incertae Sedis;Incertae Sedis;";"0.0";"0";"3";"3";"0";"3";"0";"457180";"391207"
"V4mis2";"SILVA (only NR);Eukaryota;Amorphea;Obazoa;Opisthokonta;Nucletmycea;Fungi;Incertae Sedis;Incertae Sedis;Incertae Sedis;Incertae Sedis;Incertae Sedis;";"0.0";"0";"3";"3";"0";"3";"0";"457180";"391207"
"V4mis2";"SILVA (only NR);Eukaryota;Amorphea;Obazoa;Opisthokonta;Nucletmycea;Fungi;Incertae Sedis;Incertae Sedis;Incertae Sedis;Incertae Sedis;Incertae Sedis;Nephridiophaga;";"0.0";"0";"3";"3";"0";"3";"0";"457180";"391207"
"V4mis2";"SILVA (only NR);Eukaryota;Amorphea;Obazoa;Opisthokonta;Nucletmycea;Fungi;LKM15;";"72.7";"14.4";"23";"22";"16";"6";"1";"457161";"391191"
"V4mis2";"SILVA (only NR);Eukaryota;Amorphea;Obazoa;Opisthokonta;Nucletmycea;Fungi;Microsporidia;";"22.9";"14.4";"70";"70";"16";"54";"0";"457113";"391191"
"V4mis2";"SILVA (only NR);Eukaryota;Amorphea;Obazoa;Opisthokonta;Nucletmycea;Fungi;Microsporidia;Amblyosporidae;";"7.5";"14.4";"40";"40";"3";"37";"0";"457143";"391204"
"V4mis2";"SILVA (only NR);Eukaryota;Amorphea;Obazoa;Opisthokonta;Nucletmycea;Fungi;Microsporidia;Amblyosporidae;Amblyospora;";"9.7";"14.4";"31";"31";"3";"28";"0";"457152";"391204"
"V4mis2";"SILVA (only NR);Eukaryota;Amorphea;Obazoa;Opisthokonta;Nucletmycea;Fungi;Microsporidia;Amblyosporidae;Andreanna;";"0.0";"0";"1";"1";"0";"1";"0";"457182";"391207"
"V4mis2";"SILVA (only NR);Eukaryota;Amorphea;Obazoa;Opisthokonta;Nucletmycea;Fungi;Microsporidia;Amblyosporidae;Berwaldia;";"0.0";"0";"1";"1";"0";"1";"0";"457182";"391207"
"V4mis2";"SILVA (only NR);Eukaryota;Amorphea;Obazoa;Opisthokonta;Nucletmycea;Fungi;Microsporidia;Amblyosporidae;Intrapredatorus;";"0.0";"0";"1";"1";"0";"1";"0";"457182";"391207"
"V4mis2";"SILVA (only NR);Eukaryota;Amorphea;Obazoa;Opisthokonta;Nucletmycea;Fungi;Microsporidia;Amblyosporidae;Novothelohania;";"0.0";"0";"1";"1";"0";"1";"0";"457182";"391207"
"V4mis2";"SILVA (only NR);Eukaryota;Amorphea;Obazoa;Opisthokonta;Nucletmycea;Fungi;Microsporidia;Amblyosporidae;Parathelohania;";"0.0";"0";"4";"4";"0";"4";"0";"457179";"391207"
"V4mis2";"SILVA (only NR);Eukaryota;Amorphea;Obazoa;Opisthokonta;Nucletmycea;Fungi;Microsporidia;Amblyosporidae;Takaokaspora;";"0.0";"0";"1";"1";"0";"1";"0";"457182";"391207"
"V4mis2";"SILVA (only NR);Eukaryota;Amorphea;Obazoa;Opisthokonta;Nucletmycea;Fungi;Microsporidia;Caudosporidae;";"0.0";"0";"1";"1";"0";"1";"0";"457182";"391207"
"V4mis2";"SILVA (only NR);Eukaryota;Amorphea;Obazoa;Opisthokonta;Nucletmycea;Fungi;Microsporidia;Caudosporidae;Culicosporella;";"0.0";"0";"1";"1";"0";"1";"0";"457182";"391207"
"V4mis2";"SILVA (only NR);Eukaryota;Amorphea;Obazoa;Opisthokonta;Nucletmycea;Fungi;Microsporidia;Culicosporidae;";"0.0";"0";"1";"1";"0";"1";"0";"457182";"391207"
"V4mis2";"SILVA (only NR);Eukaryota;Amorphea;Obazoa;Opisthokonta;Nucletmycea;Fungi;Microsporidia;Culicosporidae;Edhazardia;";"0.0";"0";"1";"1";"0";"1";"0";"457182";"391207"
"V4mis2";"SILVA (only NR);Eukaryota;Amorphea;Obazoa;Opisthokonta;Nucletmycea;Fungi;Microsporidia;Gurleyidae;";"0.0";"0";"3";"3";"0";"3";"0";"457180";"391207"
"V4mis2";"SILVA (only NR);Eukaryota;Amorphea;Obazoa;Opisthokonta;Nucletmycea;Fungi;Microsporidia;Gurleyidae;Gurleya;";"0.0";"0";"1";"1";"0";"1";"0";"457182";"391207"
"V4mis2";"SILVA (only NR);Eukaryota;Amorphea;Obazoa;Opisthokonta;Nucletmycea;Fungi;Microsporidia;Gurleyidae;Hazardia;";"0.0";"0";"2";"2";"0";"2";"0";"457181";"391207"
"V4mis2";"SILVA (only NR);Eukaryota;Amorphea;Obazoa;Opisthokonta;Nucletmycea;Fungi;Microsporidia;Incertae Sedis;";"33.3";"14.4";"6";"6";"2";"4";"0";"457177";"391205"
"V4mis2";"SILVA (only NR);Eukaryota;Amorphea;Obazoa;Opisthokonta;Nucletmycea;Fungi;Microsporidia;Incertae Sedis;Binucleata;";"0.0";"0";"1";"1";"0";"1";"0";"457182";"391207"
"V4mis2";"SILVA (only NR);Eukaryota;Amorphea;Obazoa;Opisthokonta;Nucletmycea;Fungi;Microsporidia;Incertae Sedis;Lanatospora;";"0.0";"0";"1";"1";"0";"1";"0";"457182";"391207"
"V4mis2";"SILVA (only NR);Eukaryota;Amorphea;Obazoa;Opisthokonta;Nucletmycea;Fungi;Microsporidia;Incertae Sedis;Neoperezia;";"100.0";"14.4";"2";"2";"2";"0";"0";"457181";"391205"
"V4mis2";"SILVA (only NR);Eukaryota;Amorphea;Obazoa;Opisthokonta;Nucletmycea;Fungi;Microsporidia;Incertae Sedis;Senoma;";"0.0";"0";"1";"1";"0";"1";"0";"457182";"391207"
"V4mis2";"SILVA (only NR);Eukaryota;Amorphea;Obazoa;Opisthokonta;Nucletmycea;Fungi;Microsporidia;Incertae Sedis;Trichotosporea;";"0.0";"0";"1";"1";"0";"1";"0";"457182";"391207"
"V4mis2";"SILVA (only NR);Eukaryota;Amorphea;Obazoa;Opisthokonta;Nucletmycea;Fungi;Microsporidia;Mrazekiidae;";"75.0";"14.4";"4";"4";"3";"1";"0";"457179";"391204"
"V4mis2";"SILVA (only NR);Eukaryota;Amorphea;Obazoa;Opisthokonta;Nucletmycea;Fungi;Microsporidia;Mrazekiidae;Bacillidium;";"50.0";"14.4";"2";"2";"1";"1";"0";"457181";"391206"
"V4mis2";"SILVA (only NR);Eukaryota;Amorphea;Obazoa;Opisthokonta;Nucletmycea;Fungi;Microsporidia;Mrazekiidae;Schroedera;";"100.0";"14.4";"2";"2";"2";"0";"0";"457181";"391205"
"V4mis2";"SILVA (only NR);Eukaryota;Amorphea;Obazoa;Opisthokonta;Nucletmycea;Fungi;Microsporidia;Pseudonosematidae;";"80.0";"14.4";"5";"5";"4";"1";"0";"457178";"391203"
"V4mis2";"SILVA (only NR);Eukaryota;Amorphea;Obazoa;Opisthokonta;Nucletmycea;Fungi;Microsporidia;Pseudonosematidae;Bryonosema;";"66.7";"14.4";"3";"3";"2";"1";"0";"457180";"391205"
"V4mis2";"SILVA (only NR);Eukaryota;Amorphea;Obazoa;Opisthokonta;Nucletmycea;Fungi;Microsporidia;Pseudonosematidae;Pseudonosema;";"100.0";"14.4";"1";"1";"1";"0";"0";"457182";"391206"
"V4mis2";"SILVA (only NR);Eukaryota;Amorphea;Obazoa;Opisthokonta;Nucletmycea;Fungi;Microsporidia;Pseudonosematidae;Trichonosema;";"100.0";"14.4";"1";"1";"1";"0";"0";"457182";"391206"
"V4mis2";"SILVA (only NR);Eukaryota;Amorphea;Obazoa;Opisthokonta;Nucletmycea;Fungi;Microsporidia;Thelohaniidae;";"100.0";"14.4";"1";"1";"1";"0";"0";"457182";"391206"
"V4mis2";"SILVA (only NR);Eukaryota;Amorphea;Obazoa;Opisthokonta;Nucletmycea;Fungi;Microsporidia;Thelohaniidae;Hyalinocysta;";"100.0";"14.4";"1";"1";"1";"0";"0";"457182";"391206"
"V4mis2";"SILVA (only NR);Eukaryota;Amorphea;Obazoa;Opisthokonta;Nucletmycea;Fungi;Microsporidia;Tuzetiidae;";"66.7";"14.4";"3";"3";"2";"1";"0";"457180";"391205"
"V4mis2";"SILVA (only NR);Eukaryota;Amorphea;Obazoa;Opisthokonta;Nucletmycea;Fungi;Microsporidia;Tuzetiidae;Janacekia;";"100.0";"14.4";"2";"2";"2";"0";"0";"457181";"391205"
"V4mis2";"SILVA (only NR);Eukaryota;Amorphea;Obazoa;Opisthokonta;Nucletmycea;Fungi;Microsporidia;Tuzetiidae;Marssoniella;";"0.0";"0";"1";"1";"0";"1";"0";"457182";"391207"
"V4mis2";"SILVA (only NR);Eukaryota;Amorphea;Obazoa;Opisthokonta;Nucletmycea;Fungi;Mucoromycota;";"28.2";"14.3";"752";"746";"210";"536";"6";"456437";"390997"
"V4mis2";"SILVA (only NR);Eukaryota;Amorphea;Obazoa;Opisthokonta;Nucletmycea;Fungi;Mucoromycota;Glomeromycotina;";"0.0";"0";"433";"427";"0";"427";"6";"456756";"391207"
"V4mis2";"SILVA (only NR);Eukaryota;Amorphea;Obazoa;Opisthokonta;Nucletmycea;Fungi;Mucoromycota;Glomeromycotina;Glomeromycetes;";"0.0";"0";"433";"427";"0";"427";"6";"456756";"391207"
"V4mis2";"SILVA (only NR);Eukaryota;Amorphea;Obazoa;Opisthokonta;Nucletmycea;Fungi;Mucoromycota;Glomeromycotina;Glomeromycetes;Archaeosporales;";"0.0";"0";"31";"31";"0";"31";"0";"457152";"391207"
"V4mis2";"SILVA (only NR);Eukaryota;Amorphea;Obazoa;Opisthokonta;Nucletmycea;Fungi;Mucoromycota;Glomeromycotina;Glomeromycetes;Archaeosporales;Ambisporaceae;";"0.0";"0";"10";"10";"0";"10";"0";"457173";"391207"
"V4mis2";"SILVA (only NR);Eukaryota;Amorphea;Obazoa;Opisthokonta;Nucletmycea;Fungi;Mucoromycota;Glomeromycotina;Glomeromycetes;Archaeosporales;Ambisporaceae;Ambispora;";"0.0";"0";"10";"10";"0";"10";"0";"457173";"391207"
"V4mis2";"SILVA (only NR);Eukaryota;Amorphea;Obazoa;Opisthokonta;Nucletmycea;Fungi;Mucoromycota;Glomeromycotina;Glomeromycetes;Archaeosporales;Archaeosporaceae;";"0.0";"0";"19";"19";"0";"19";"0";"457164";"391207"
"V4mis2";"SILVA (only NR);Eukaryota;Amorphea;Obazoa;Opisthokonta;Nucletmycea;Fungi;Mucoromycota;Glomeromycotina;Glomeromycetes;Archaeosporales;Archaeosporaceae;Archaeospora;";"0.0";"0";"3";"3";"0";"3";"0";"457180";"391207"
"V4mis2";"SILVA (only NR);Eukaryota;Amorphea;Obazoa;Opisthokonta;Nucletmycea;Fungi;Mucoromycota;Glomeromycotina;Glomeromycetes;Archaeosporales;Geosiphonaceae;";"0.0";"0";"2";"2";"0";"2";"0";"457181";"391207"
"V4mis2";"SILVA (only NR);Eukaryota;Amorphea;Obazoa;Opisthokonta;Nucletmycea;Fungi;Mucoromycota;Glomeromycotina;Glomeromycetes;Archaeosporales;Geosiphonaceae;Geosiphon;";"0.0";"0";"2";"2";"0";"2";"0";"457181";"391207"
"V4mis2";"SILVA (only NR);Eukaryota;Amorphea;Obazoa;Opisthokonta;Nucletmycea;Fungi;Mucoromycota;Glomeromycotina;Glomeromycetes;Diversisporales;";"0.0";"0";"86";"86";"0";"86";"0";"457097";"391207"
"V4mis2";"SILVA (only NR);Eukaryota;Amorphea;Obazoa;Opisthokonta;Nucletmycea;Fungi;Mucoromycota;Glomeromycotina;Glomeromycetes;Diversisporales;Acaulosporaceae;";"0.0";"0";"23";"23";"0";"23";"0";"457160";"391207"
"V4mis2";"SILVA (only NR);Eukaryota;Amorphea;Obazoa;Opisthokonta;Nucletmycea;Fungi;Mucoromycota;Glomeromycotina;Glomeromycetes;Diversisporales;Acaulosporaceae;Acaulospora;";"0.0";"0";"23";"23";"0";"23";"0";"457160";"391207"
"V4mis2";"SILVA (only NR);Eukaryota;Amorphea;Obazoa;Opisthokonta;Nucletmycea;Fungi;Mucoromycota;Glomeromycotina;Glomeromycetes;Diversisporales;Diversisporaceae;";"0.0";"0";"11";"11";"0";"11";"0";"457172";"391207"
"V4mis2";"SILVA (only NR);Eukaryota;Amorphea;Obazoa;Opisthokonta;Nucletmycea;Fungi;Mucoromycota;Glomeromycotina;Glomeromycetes;Diversisporales;Diversisporaceae;Diversispora;";"0.0";"0";"9";"9";"0";"9";"0";"457174";"391207"
"V4mis2";"SILVA (only NR);Eukaryota;Amorphea;Obazoa;Opisthokonta;Nucletmycea;Fungi;Mucoromycota;Glomeromycotina;Glomeromycetes;Diversisporales;Diversisporaceae;Otospora;";"0.0";"0";"1";"1";"0";"1";"0";"457182";"391207"
"V4mis2";"SILVA (only NR);Eukaryota;Amorphea;Obazoa;Opisthokonta;Nucletmycea;Fungi;Mucoromycota;Glomeromycotina;Glomeromycetes;Diversisporales;Diversisporaceae;Redeckera;";"0.0";"0";"1";"1";"0";"1";"0";"457182";"391207"
"V4mis2";"SILVA (only NR);Eukaryota;Amorphea;Obazoa;Opisthokonta;Nucletmycea;Fungi;Mucoromycota;Glomeromycotina;Glomeromycetes;Diversisporales;Entrophospora;";"0.0";"0";"1";"1";"0";"1";"0";"457182";"391207"
"V4mis2";"SILVA (only NR);Eukaryota;Amorphea;Obazoa;Opisthokonta;Nucletmycea;Fungi;Mucoromycota;Glomeromycotina;Glomeromycetes;Diversisporales;Gigasporaceae;";"0.0";"0";"37";"37";"0";"37";"0";"457146";"391207"
"V4mis2";"SILVA (only NR);Eukaryota;Amorphea;Obazoa;Opisthokonta;Nucletmycea;Fungi;Mucoromycota;Glomeromycotina;Glomeromycetes;Diversisporales;Gigasporaceae;Cetraspora;";"0.0";"0";"2";"2";"0";"2";"0";"457181";"391207"
"V4mis2";"SILVA (only NR);Eukaryota;Amorphea;Obazoa;Opisthokonta;Nucletmycea;Fungi;Mucoromycota;Glomeromycotina;Glomeromycetes;Diversisporales;Gigasporaceae;Dentiscutata;";"0.0";"0";"4";"4";"0";"4";"0";"457179";"391207"
"V4mis2";"SILVA (only NR);Eukaryota;Amorphea;Obazoa;Opisthokonta;Nucletmycea;Fungi;Mucoromycota;Glomeromycotina;Glomeromycetes;Diversisporales;Gigasporaceae;Gigaspora;";"0.0";"0";"13";"13";"0";"13";"0";"457170";"391207"
"V4mis2";"SILVA (only NR);Eukaryota;Amorphea;Obazoa;Opisthokonta;Nucletmycea;Fungi;Mucoromycota;Glomeromycotina;Glomeromycetes;Diversisporales;Gigasporaceae;Racocetra;";"0.0";"0";"3";"3";"0";"3";"0";"457180";"391207"
"V4mis2";"SILVA (only NR);Eukaryota;Amorphea;Obazoa;Opisthokonta;Nucletmycea;Fungi;Mucoromycota;Glomeromycotina;Glomeromycetes;Diversisporales;Gigasporaceae;Scutellospora;";"0.0";"0";"14";"14";"0";"14";"0";"457169";"391207"
"V4mis2";"SILVA (only NR);Eukaryota;Amorphea;Obazoa;Opisthokonta;Nucletmycea;Fungi;Mucoromycota;Glomeromycotina;Glomeromycetes;Diversisporales;Pacispora;";"0.0";"0";"3";"3";"0";"3";"0";"457180";"391207"
"V4mis2";"SILVA (only NR);Eukaryota;Amorphea;Obazoa;Opisthokonta;Nucletmycea;Fungi;Mucoromycota;Glomeromycotina;Glomeromycetes;Diversisporales;Sacculosporaceae;";"0.0";"0";"3";"3";"0";"3";"0";"457180";"391207"
"V4mis2";"SILVA (only NR);Eukaryota;Amorphea;Obazoa;Opisthokonta;Nucletmycea;Fungi;Mucoromycota;Glomeromycotina;Glomeromycetes;Diversisporales;Sacculosporaceae;Sacculospora;";"0.0";"0";"3";"3";"0";"3";"0";"457180";"391207"
"V4mis2";"SILVA (only NR);Eukaryota;Amorphea;Obazoa;Opisthokonta;Nucletmycea;Fungi;Mucoromycota;Glomeromycotina;Glomeromycetes;Glomerales;";"0.0";"0";"257";"251";"0";"251";"6";"456932";"391207"
"V4mis2";"SILVA (only NR);Eukaryota;Amorphea;Obazoa;Opisthokonta;Nucletmycea;Fungi;Mucoromycota;Glomeromycotina;Glomeromycetes;Glomerales;Claroideoglomeraceae;";"0.0";"0";"11";"10";"0";"10";"1";"457173";"391207"
"V4mis2";"SILVA (only NR);Eukaryota;Amorphea;Obazoa;Opisthokonta;Nucletmycea;Fungi;Mucoromycota;Glomeromycotina;Glomeromycetes;Glomerales;Claroideoglomeraceae;Claroideoglomus;";"0.0";"0";"11";"10";"0";"10";"1";"457173";"391207"
"V4mis2";"SILVA (only NR);Eukaryota;Amorphea;Obazoa;Opisthokonta;Nucletmycea;Fungi;Mucoromycota;Glomeromycotina;Glomeromycetes;Glomerales;Glomeraceae;";"0.0";"0";"220";"215";"0";"215";"5";"456968";"391207"
"V4mis2";"SILVA (only NR);Eukaryota;Amorphea;Obazoa;Opisthokonta;Nucletmycea;Fungi;Mucoromycota;Glomeromycotina;Glomeromycetes;Glomerales;Glomeraceae;Funneliformis;";"0.0";"0";"13";"13";"0";"13";"0";"457170";"391207"
"V4mis2";"SILVA (only NR);Eukaryota;Amorphea;Obazoa;Opisthokonta;Nucletmycea;Fungi;Mucoromycota;Glomeromycotina;Glomeromycetes;Glomerales;Glomeraceae;Glomus;";"0.0";"0";"130";"125";"0";"125";"5";"457058";"391207"
"V4mis2";"SILVA (only NR);Eukaryota;Amorphea;Obazoa;Opisthokonta;Nucletmycea;Fungi;Mucoromycota;Glomeromycotina;Glomeromycetes;Glomerales;Glomeraceae;Rhizophagus;";"0.0";"0";"62";"62";"0";"62";"0";"457121";"391207"
"V4mis2";"SILVA (only NR);Eukaryota;Amorphea;Obazoa;Opisthokonta;Nucletmycea;Fungi;Mucoromycota;Glomeromycotina;Glomeromycetes;Glomerales;Glomeraceae;Sclerocystis;";"0.0";"0";"4";"4";"0";"4";"0";"457179";"391207"
"V4mis2";"SILVA (only NR);Eukaryota;Amorphea;Obazoa;Opisthokonta;Nucletmycea;Fungi;Mucoromycota;Glomeromycotina;Glomeromycetes;Glomerales;Glomeraceae;Septoglomus;";"0.0";"0";"9";"9";"0";"9";"0";"457174";"391207"
"V4mis2";"SILVA (only NR);Eukaryota;Amorphea;Obazoa;Opisthokonta;Nucletmycea;Fungi;Mucoromycota;Glomeromycotina;Glomeromycetes;Glomerales;uncultured;";"0.0";"0";"23";"23";"0";"23";"0";"457160";"391207"
"V4mis2";"SILVA (only NR);Eukaryota;Amorphea;Obazoa;Opisthokonta;Nucletmycea;Fungi;Mucoromycota;Glomeromycotina;Glomeromycetes;Paraglomerales;";"0.0";"0";"2";"2";"0";"2";"0";"457181";"391207"
"V4mis2";"SILVA (only NR);Eukaryota;Amorphea;Obazoa;Opisthokonta;Nucletmycea;Fungi;Mucoromycota;Glomeromycotina;Glomeromycetes;Paraglomerales;Paraglomeraceae;";"0.0";"0";"2";"2";"0";"2";"0";"457181";"391207"
"V4mis2";"SILVA (only NR);Eukaryota;Amorphea;Obazoa;Opisthokonta;Nucletmycea;Fungi;Mucoromycota;Glomeromycotina;Glomeromycetes;Paraglomerales;Paraglomeraceae;Paraglomus;";"0.0";"0";"2";"2";"0";"2";"0";"457181";"391207"
"V4mis2";"SILVA (only NR);Eukaryota;Amorphea;Obazoa;Opisthokonta;Nucletmycea;Fungi;Mucoromycota;Glomeromycotina;Glomeromycetes;uncultured;";"0.0";"0";"32";"32";"0";"32";"0";"457151";"391207"
"V4mis2";"SILVA (only NR);Eukaryota;Amorphea;Obazoa;Opisthokonta;Nucletmycea;Fungi;Mucoromycota;Mortierellomycotina;";"0.0";"0";"55";"55";"0";"55";"0";"457128";"391207"
"V4mis2";"SILVA (only NR);Eukaryota;Amorphea;Obazoa;Opisthokonta;Nucletmycea;Fungi;Mucoromycota;Mortierellomycotina;Incertae Sedis;";"0.0";"0";"55";"55";"0";"55";"0";"457128";"391207"
"V4mis2";"SILVA (only NR);Eukaryota;Amorphea;Obazoa;Opisthokonta;Nucletmycea;Fungi;Mucoromycota;Mortierellomycotina;Incertae Sedis;Mortierellales;";"0.0";"0";"55";"55";"0";"55";"0";"457128";"391207"
"V4mis2";"SILVA (only NR);Eukaryota;Amorphea;Obazoa;Opisthokonta;Nucletmycea;Fungi;Mucoromycota;Mortierellomycotina;Incertae Sedis;Mortierellales;Modicella;";"0.0";"0";"1";"1";"0";"1";"0";"457182";"391207"
"V4mis2";"SILVA (only NR);Eukaryota;Amorphea;Obazoa;Opisthokonta;Nucletmycea;Fungi;Mucoromycota;Mortierellomycotina;Incertae Sedis;Mortierellales;Mortierellaceae;";"0.0";"0";"45";"45";"0";"45";"0";"457138";"391207"
"V4mis2";"SILVA (only NR);Eukaryota;Amorphea;Obazoa;Opisthokonta;Nucletmycea;Fungi;Mucoromycota;Mortierellomycotina;Incertae Sedis;Mortierellales;Mortierellaceae;Mortierella;";"0.0";"0";"45";"45";"0";"45";"0";"457138";"391207"
"V4mis2";"SILVA (only NR);Eukaryota;Amorphea;Obazoa;Opisthokonta;Nucletmycea;Fungi;Mucoromycota;Mortierellomycotina;Incertae Sedis;Mortierellales;uncultured;";"0.0";"0";"5";"5";"0";"5";"0";"457178";"391207"
"V4mis2";"SILVA (only NR);Eukaryota;Amorphea;Obazoa;Opisthokonta;Nucletmycea;Fungi;Mucoromycota;Mucoromycotina;";"79.5";"14.4";"264";"264";"210";"54";"0";"456919";"390997"
"V4mis2";"SILVA (only NR);Eukaryota;Amorphea;Obazoa;Opisthokonta;Nucletmycea;Fungi;Mucoromycota;Mucoromycotina;Incertae Sedis;";"79.5";"14.4";"264";"264";"210";"54";"0";"456919";"390997"
"V4mis2";"SILVA (only NR);Eukaryota;Amorphea;Obazoa;Opisthokonta;Nucletmycea;Fungi;Mucoromycota;Mucoromycotina;Incertae Sedis;Endogonales;";"0.0";"0";"39";"39";"0";"39";"0";"457144";"391207"
"V4mis2";"SILVA (only NR);Eukaryota;Amorphea;Obazoa;Opisthokonta;Nucletmycea;Fungi;Mucoromycota;Mucoromycotina;Incertae Sedis;Endogonales;Endogonaceae;";"0.0";"0";"39";"39";"0";"39";"0";"457144";"391207"
"V4mis2";"SILVA (only NR);Eukaryota;Amorphea;Obazoa;Opisthokonta;Nucletmycea;Fungi;Mucoromycota;Mucoromycotina;Incertae Sedis;Endogonales;Endogonaceae;Endogone;";"0.0";"0";"22";"22";"0";"22";"0";"457161";"391207"
"V4mis2";"SILVA (only NR);Eukaryota;Amorphea;Obazoa;Opisthokonta;Nucletmycea;Fungi;Mucoromycota;Mucoromycotina;Incertae Sedis;Endogonales;Endogonaceae;uncultured;";"0.0";"0";"17";"17";"0";"17";"0";"457166";"391207"
"V4mis2";"SILVA (only NR);Eukaryota;Amorphea;Obazoa;Opisthokonta;Nucletmycea;Fungi;Mucoromycota;Mucoromycotina;Incertae Sedis;Mucorales;";"96.3";"14.4";"218";"218";"210";"8";"0";"456965";"390997"
"V4mis2";"SILVA (only NR);Eukaryota;Amorphea;Obazoa;Opisthokonta;Nucletmycea;Fungi;Mucoromycota;Mucoromycotina;Incertae Sedis;Mucorales;Apophysomyces;";"100.0";"14.4";"1";"1";"1";"0";"0";"457182";"391206"
"V4mis2";"SILVA (only NR);Eukaryota;Amorphea;Obazoa;Opisthokonta;Nucletmycea;Fungi;Mucoromycota;Mucoromycotina;Incertae Sedis;Mucorales;Backusellaceae;";"100.0";"14.4";"3";"3";"3";"0";"0";"457180";"391204"
"V4mis2";"SILVA (only NR);Eukaryota;Amorphea;Obazoa;Opisthokonta;Nucletmycea;Fungi;Mucoromycota;Mucoromycotina;Incertae Sedis;Mucorales;Backusellaceae;Backusella;";"100.0";"14.4";"3";"3";"3";"0";"0";"457180";"391204"
"V4mis2";"SILVA (only NR);Eukaryota;Amorphea;Obazoa;Opisthokonta;Nucletmycea;Fungi;Mucoromycota;Mucoromycotina;Incertae Sedis;Mucorales;Chaetocladiaceae;";"100.0";"14.4";"2";"2";"2";"0";"0";"457181";"391205"
"V4mis2";"SILVA (only NR);Eukaryota;Amorphea;Obazoa;Opisthokonta;Nucletmycea;Fungi;Mucoromycota;Mucoromycotina;Incertae Sedis;Mucorales;Chaetocladiaceae;Chaetocladium;";"100.0";"14.4";"2";"2";"2";"0";"0";"457181";"391205"
"V4mis2";"SILVA (only NR);Eukaryota;Amorphea;Obazoa;Opisthokonta;Nucletmycea;Fungi;Mucoromycota;Mucoromycotina;Incertae Sedis;Mucorales;Choanephoraceae;";"100.0";"14.4";"10";"10";"10";"0";"0";"457173";"391197"
"V4mis2";"SILVA (only NR);Eukaryota;Amorphea;Obazoa;Opisthokonta;Nucletmycea;Fungi;Mucoromycota;Mucoromycotina;Incertae Sedis;Mucorales;Choanephoraceae;Blakeslea;";"100.0";"14.4";"1";"1";"1";"0";"0";"457182";"391206"
"V4mis2";"SILVA (only NR);Eukaryota;Amorphea;Obazoa;Opisthokonta;Nucletmycea;Fungi;Mucoromycota;Mucoromycotina;Incertae Sedis;Mucorales;Choanephoraceae;Choanephora;";"100.0";"14.4";"1";"1";"1";"0";"0";"457182";"391206"
"V4mis2";"SILVA (only NR);Eukaryota;Amorphea;Obazoa;Opisthokonta;Nucletmycea;Fungi;Mucoromycota;Mucoromycotina;Incertae Sedis;Mucorales;Choanephoraceae;Gilbertella;";"100.0";"14.4";"1";"1";"1";"0";"0";"457182";"391206"
"V4mis2";"SILVA (only NR);Eukaryota;Amorphea;Obazoa;Opisthokonta;Nucletmycea;Fungi;Mucoromycota;Mucoromycotina;Incertae Sedis;Mucorales;Choanephoraceae;Poitrasia;";"100.0";"14.4";"1";"1";"1";"0";"0";"457182";"391206"
"V4mis2";"SILVA (only NR);Eukaryota;Amorphea;Obazoa;Opisthokonta;Nucletmycea;Fungi;Mucoromycota;Mucoromycotina;Incertae Sedis;Mucorales;Choanephoraceae;uncultured;";"100.0";"14.4";"6";"6";"6";"0";"0";"457177";"391201"
"V4mis2";"SILVA (only NR);Eukaryota;Amorphea;Obazoa;Opisthokonta;Nucletmycea;Fungi;Mucoromycota;Mucoromycotina;Incertae Sedis;Mucorales;Cunninghamellaceae;";"96.0";"14.4";"25";"25";"24";"1";"0";"457158";"391183"
"V4mis2";"SILVA (only NR);Eukaryota;Amorphea;Obazoa;Opisthokonta;Nucletmycea;Fungi;Mucoromycota;Mucoromycotina;Incertae Sedis;Mucorales;Cunninghamellaceae;Absidia;";"100.0";"14.4";"10";"10";"10";"0";"0";"457173";"391197"
"V4mis2";"SILVA (only NR);Eukaryota;Amorphea;Obazoa;Opisthokonta;Nucletmycea;Fungi;Mucoromycota;Mucoromycotina;Incertae Sedis;Mucorales;Cunninghamellaceae;Chlamydoabsidia;";"100.0";"14.4";"2";"2";"2";"0";"0";"457181";"391205"
"V4mis2";"SILVA (only NR);Eukaryota;Amorphea;Obazoa;Opisthokonta;Nucletmycea;Fungi;Mucoromycota;Mucoromycotina;Incertae Sedis;Mucorales;Cunninghamellaceae;Cunninghamella;";"100.0";"14.4";"4";"4";"4";"0";"0";"457179";"391203"
"V4mis2";"SILVA (only NR);Eukaryota;Amorphea;Obazoa;Opisthokonta;Nucletmycea;Fungi;Mucoromycota;Mucoromycotina;Incertae Sedis;Mucorales;Cunninghamellaceae;Gongronella;";"100.0";"14.4";"4";"4";"4";"0";"0";"457179";"391203"
"V4mis2";"SILVA (only NR);Eukaryota;Amorphea;Obazoa;Opisthokonta;Nucletmycea;Fungi;Mucoromycota;Mucoromycotina;Incertae Sedis;Mucorales;Cunninghamellaceae;Halteromyces;";"100.0";"14.4";"1";"1";"1";"0";"0";"457182";"391206"
"V4mis2";"SILVA (only NR);Eukaryota;Amorphea;Obazoa;Opisthokonta;Nucletmycea;Fungi;Mucoromycota;Mucoromycotina;Incertae Sedis;Mucorales;Cunninghamellaceae;Hesseltinella;";"66.7";"14.4";"3";"3";"2";"1";"0";"457180";"391205"
"V4mis2";"SILVA (only NR);Eukaryota;Amorphea;Obazoa;Opisthokonta;Nucletmycea;Fungi;Mucoromycota;Mucoromycotina;Incertae Sedis;Mucorales;Kirkomyces;";"100.0";"14.4";"1";"1";"1";"0";"0";"457182";"391206"
"V4mis2";"SILVA (only NR);Eukaryota;Amorphea;Obazoa;Opisthokonta;Nucletmycea;Fungi;Mucoromycota;Mucoromycotina;Incertae Sedis;Mucorales;Lichtheimiaceae;";"96.4";"14.4";"28";"28";"27";"1";"0";"457155";"391180"
"V4mis2";"SILVA (only NR);Eukaryota;Amorphea;Obazoa;Opisthokonta;Nucletmycea;Fungi;Mucoromycota;Mucoromycotina;Incertae Sedis;Mucorales;Lichtheimiaceae;Circinella;";"85.7";"14.4";"7";"7";"6";"1";"0";"457176";"391201"
"V4mis2";"SILVA (only NR);Eukaryota;Amorphea;Obazoa;Opisthokonta;Nucletmycea;Fungi;Mucoromycota;Mucoromycotina;Incertae Sedis;Mucorales;Lichtheimiaceae;Dichotomocladium;";"100.0";"14.4";"1";"1";"1";"0";"0";"457182";"391206"
"V4mis2";"SILVA (only NR);Eukaryota;Amorphea;Obazoa;Opisthokonta;Nucletmycea;Fungi;Mucoromycota;Mucoromycotina;Incertae Sedis;Mucorales;Lichtheimiaceae;Fennellomyces;";"100.0";"14.4";"1";"1";"1";"0";"0";"457182";"391206"
"V4mis2";"SILVA (only NR);Eukaryota;Amorphea;Obazoa;Opisthokonta;Nucletmycea;Fungi;Mucoromycota;Mucoromycotina;Incertae Sedis;Mucorales;Lichtheimiaceae;Lichtheimia;";"100.0";"14.4";"4";"4";"4";"0";"0";"457179";"391203"
"V4mis2";"SILVA (only NR);Eukaryota;Amorphea;Obazoa;Opisthokonta;Nucletmycea;Fungi;Mucoromycota;Mucoromycotina;Incertae Sedis;Mucorales;Lichtheimiaceae;Phascolomyces;";"100.0";"14.4";"1";"1";"1";"0";"0";"457182";"391206"
"V4mis2";"SILVA (only NR);Eukaryota;Amorphea;Obazoa;Opisthokonta;Nucletmycea;Fungi;Mucoromycota;Mucoromycotina;Incertae Sedis;Mucorales;Lichtheimiaceae;Rhizomucor;";"100.0";"14.4";"7";"7";"7";"0";"0";"457176";"391200"
"V4mis2";"SILVA (only NR);Eukaryota;Amorphea;Obazoa;Opisthokonta;Nucletmycea;Fungi;Mucoromycota;Mucoromycotina;Incertae Sedis;Mucorales;Lichtheimiaceae;Thamnostylum;";"100.0";"14.4";"4";"4";"4";"0";"0";"457179";"391203"
"V4mis2";"SILVA (only NR);Eukaryota;Amorphea;Obazoa;Opisthokonta;Nucletmycea;Fungi;Mucoromycota;Mucoromycotina;Incertae Sedis;Mucorales;Lichtheimiaceae;Thermomucor;";"100.0";"14.4";"1";"1";"1";"0";"0";"457182";"391206"
"V4mis2";"SILVA (only NR);Eukaryota;Amorphea;Obazoa;Opisthokonta;Nucletmycea;Fungi;Mucoromycota;Mucoromycotina;Incertae Sedis;Mucorales;Lichtheimiaceae;Zychaea;";"100.0";"14.4";"1";"1";"1";"0";"0";"457182";"391206"
"V4mis2";"SILVA (only NR);Eukaryota;Amorphea;Obazoa;Opisthokonta;Nucletmycea;Fungi;Mucoromycota;Mucoromycotina;Incertae Sedis;Mucorales;Mucoraceae;";"95.7";"14.4";"70";"70";"67";"3";"0";"457113";"391140"
"V4mis2";"SILVA (only NR);Eukaryota;Amorphea;Obazoa;Opisthokonta;Nucletmycea;Fungi;Mucoromycota;Mucoromycotina;Incertae Sedis;Mucorales;Mucoraceae;Actinomucor;";"100.0";"14.4";"1";"1";"1";"0";"0";"457182";"391206"
"V4mis2";"SILVA (only NR);Eukaryota;Amorphea;Obazoa;Opisthokonta;Nucletmycea;Fungi;Mucoromycota;Mucoromycotina;Incertae Sedis;Mucorales;Mucoraceae;Ambomucor;";"100.0";"14.4";"1";"1";"1";"0";"0";"457182";"391206"
"V4mis2";"SILVA (only NR);Eukaryota;Amorphea;Obazoa;Opisthokonta;Nucletmycea;Fungi;Mucoromycota;Mucoromycotina;Incertae Sedis;Mucorales;Mucoraceae;Benjaminiella;";"100.0";"14.4";"1";"1";"1";"0";"0";"457182";"391206"
"V4mis2";"SILVA (only NR);Eukaryota;Amorphea;Obazoa;Opisthokonta;Nucletmycea;Fungi;Mucoromycota;Mucoromycotina;Incertae Sedis;Mucorales;Mucoraceae;Circinomucor;";"100.0";"14.4";"1";"1";"1";"0";"0";"457182";"391206"
"V4mis2";"SILVA (only NR);Eukaryota;Amorphea;Obazoa;Opisthokonta;Nucletmycea;Fungi;Mucoromycota;Mucoromycotina;Incertae Sedis;Mucorales;Mucoraceae;Cokeromyces;";"100.0";"14.4";"2";"2";"2";"0";"0";"457181";"391205"
"V4mis2";"SILVA (only NR);Eukaryota;Amorphea;Obazoa;Opisthokonta;Nucletmycea;Fungi;Mucoromycota;Mucoromycotina;Incertae Sedis;Mucorales;Mucoraceae;Dicranophora;";"100.0";"14.4";"1";"1";"1";"0";"0";"457182";"391206"
"V4mis2";"SILVA (only NR);Eukaryota;Amorphea;Obazoa;Opisthokonta;Nucletmycea;Fungi;Mucoromycota;Mucoromycotina;Incertae Sedis;Mucorales;Mucoraceae;Ellisomyces;";"100.0";"14.4";"1";"1";"1";"0";"0";"457182";"391206"
"V4mis2";"SILVA (only NR);Eukaryota;Amorphea;Obazoa;Opisthokonta;Nucletmycea;Fungi;Mucoromycota;Mucoromycotina;Incertae Sedis;Mucorales;Mucoraceae;Hyphomucor;";"100.0";"14.4";"1";"1";"1";"0";"0";"457182";"391206"
"V4mis2";"SILVA (only NR);Eukaryota;Amorphea;Obazoa;Opisthokonta;Nucletmycea;Fungi;Mucoromycota;Mucoromycotina;Incertae Sedis;Mucorales;Mucoraceae;Mucor;";"94.2";"14.4";"52";"52";"49";"3";"0";"457131";"391158"
"V4mis2";"SILVA (only NR);Eukaryota;Amorphea;Obazoa;Opisthokonta;Nucletmycea;Fungi;Mucoromycota;Mucoromycotina;Incertae Sedis;Mucorales;Mucoraceae;Parasitella;";"100.0";"14.4";"3";"3";"3";"0";"0";"457180";"391204"
"V4mis2";"SILVA (only NR);Eukaryota;Amorphea;Obazoa;Opisthokonta;Nucletmycea;Fungi;Mucoromycota;Mucoromycotina;Incertae Sedis;Mucorales;Mucoraceae;Pilaira;";"100.0";"14.4";"3";"3";"3";"0";"0";"457180";"391204"
"V4mis2";"SILVA (only NR);Eukaryota;Amorphea;Obazoa;Opisthokonta;Nucletmycea;Fungi;Mucoromycota;Mucoromycotina;Incertae Sedis;Mucorales;Mucoraceae;Pirella;";"100.0";"14.4";"1";"1";"1";"0";"0";"457182";"391206"
"V4mis2";"SILVA (only NR);Eukaryota;Amorphea;Obazoa;Opisthokonta;Nucletmycea;Fungi;Mucoromycota;Mucoromycotina;Incertae Sedis;Mucorales;Mucoraceae;Thamnidium;";"100.0";"14.4";"1";"1";"1";"0";"0";"457182";"391206"
"V4mis2";"SILVA (only NR);Eukaryota;Amorphea;Obazoa;Opisthokonta;Nucletmycea;Fungi;Mucoromycota;Mucoromycotina;Incertae Sedis;Mucorales;Mycotyphaceae;";"100.0";"14.4";"3";"3";"3";"0";"0";"457180";"391204"
"V4mis2";"SILVA (only NR);Eukaryota;Amorphea;Obazoa;Opisthokonta;Nucletmycea;Fungi;Mucoromycota;Mucoromycotina;Incertae Sedis;Mucorales;Mycotyphaceae;Mycotypha;";"100.0";"14.4";"3";"3";"3";"0";"0";"457180";"391204"
"V4mis2";"SILVA (only NR);Eukaryota;Amorphea;Obazoa;Opisthokonta;Nucletmycea;Fungi;Mucoromycota;Mucoromycotina;Incertae Sedis;Mucorales;Phycomycetaceae;";"100.0";"14.4";"3";"3";"3";"0";"0";"457180";"391204"
"V4mis2";"SILVA (only NR);Eukaryota;Amorphea;Obazoa;Opisthokonta;Nucletmycea;Fungi;Mucoromycota;Mucoromycotina;Incertae Sedis;Mucorales;Phycomycetaceae;Phycomyces;";"100.0";"14.4";"2";"2";"2";"0";"0";"457181";"391205"
"V4mis2";"SILVA (only NR);Eukaryota;Amorphea;Obazoa;Opisthokonta;Nucletmycea;Fungi;Mucoromycota;Mucoromycotina;Incertae Sedis;Mucorales;Phycomycetaceae;Spinellus;";"100.0";"14.4";"1";"1";"1";"0";"0";"457182";"391206"
"V4mis2";"SILVA (only NR);Eukaryota;Amorphea;Obazoa;Opisthokonta;Nucletmycea;Fungi;Mucoromycota;Mucoromycotina;Incertae Sedis;Mucorales;Pilobolaceae;";"100.0";"14.4";"17";"17";"17";"0";"0";"457166";"391190"
"V4mis2";"SILVA (only NR);Eukaryota;Amorphea;Obazoa;Opisthokonta;Nucletmycea;Fungi;Mucoromycota;Mucoromycotina;Incertae Sedis;Mucorales;Pilobolaceae;Pilobolus;";"100.0";"14.4";"14";"14";"14";"0";"0";"457169";"391193"
"V4mis2";"SILVA (only NR);Eukaryota;Amorphea;Obazoa;Opisthokonta;Nucletmycea;Fungi;Mucoromycota;Mucoromycotina;Incertae Sedis;Mucorales;Pilobolaceae;Utharomyces;";"100.0";"14.4";"3";"3";"3";"0";"0";"457180";"391204"
"V4mis2";"SILVA (only NR);Eukaryota;Amorphea;Obazoa;Opisthokonta;Nucletmycea;Fungi;Mucoromycota;Mucoromycotina;Incertae Sedis;Mucorales;Protomycocladus;";"100.0";"14.4";"1";"1";"1";"0";"0";"457182";"391206"
"V4mis2";"SILVA (only NR);Eukaryota;Amorphea;Obazoa;Opisthokonta;Nucletmycea;Fungi;Mucoromycota;Mucoromycotina;Incertae Sedis;Mucorales;Radiomyces;";"100.0";"14.4";"1";"1";"1";"0";"0";"457182";"391206"
"V4mis2";"SILVA (only NR);Eukaryota;Amorphea;Obazoa;Opisthokonta;Nucletmycea;Fungi;Mucoromycota;Mucoromycotina;Incertae Sedis;Mucorales;Rhizopodaceae;";"100.0";"14.4";"45";"45";"45";"0";"0";"457138";"391162"
"V4mis2";"SILVA (only NR);Eukaryota;Amorphea;Obazoa;Opisthokonta;Nucletmycea;Fungi;Mucoromycota;Mucoromycotina;Incertae Sedis;Mucorales;Rhizopodaceae;Amylomyces;";"100.0";"14.4";"4";"4";"4";"0";"0";"457179";"391203"
"V4mis2";"SILVA (only NR);Eukaryota;Amorphea;Obazoa;Opisthokonta;Nucletmycea;Fungi;Mucoromycota;Mucoromycotina;Incertae Sedis;Mucorales;Rhizopodaceae;Rhizopus;";"100.0";"14.4";"39";"39";"39";"0";"0";"457144";"391168"
"V4mis2";"SILVA (only NR);Eukaryota;Amorphea;Obazoa;Opisthokonta;Nucletmycea;Fungi;Mucoromycota;Mucoromycotina;Incertae Sedis;Mucorales;Rhizopodaceae;Sporodiniella;";"100.0";"14.4";"1";"1";"1";"0";"0";"457182";"391206"
"V4mis2";"SILVA (only NR);Eukaryota;Amorphea;Obazoa;Opisthokonta;Nucletmycea;Fungi;Mucoromycota;Mucoromycotina;Incertae Sedis;Mucorales;Rhizopodaceae;Syzygites;";"100.0";"14.4";"1";"1";"1";"0";"0";"457182";"391206"
"V4mis2";"SILVA (only NR);Eukaryota;Amorphea;Obazoa;Opisthokonta;Nucletmycea;Fungi;Mucoromycota;Mucoromycotina;Incertae Sedis;Mucorales;Saksenaea;";"100.0";"14.4";"1";"1";"1";"0";"0";"457182";"391206"
"V4mis2";"SILVA (only NR);Eukaryota;Amorphea;Obazoa;Opisthokonta;Nucletmycea;Fungi;Mucoromycota;Mucoromycotina;Incertae Sedis;Mucorales;Syncephalastraceae;";"50.0";"14.4";"4";"4";"2";"2";"0";"457179";"391205"
"V4mis2";"SILVA (only NR);Eukaryota;Amorphea;Obazoa;Opisthokonta;Nucletmycea;Fungi;Mucoromycota;Mucoromycotina;Incertae Sedis;Mucorales;Syncephalastraceae;Syncephalastrum;";"50.0";"14.4";"4";"4";"2";"2";"0";"457179";"391205"
"V4mis2";"SILVA (only NR);Eukaryota;Amorphea;Obazoa;Opisthokonta;Nucletmycea;Fungi;Mucoromycota;Mucoromycotina;Incertae Sedis;Umbelopsidales;";"0.0";"0";"4";"4";"0";"4";"0";"457179";"391207"
"V4mis2";"SILVA (only NR);Eukaryota;Amorphea;Obazoa;Opisthokonta;Nucletmycea;Fungi;Mucoromycota;Mucoromycotina;Incertae Sedis;Umbelopsidales;Umbelopsidaceae;";"0.0";"0";"4";"4";"0";"4";"0";"457179";"391207"
"V4mis2";"SILVA (only NR);Eukaryota;Amorphea;Obazoa;Opisthokonta;Nucletmycea;Fungi;Mucoromycota;Mucoromycotina;Incertae Sedis;Umbelopsidales;Umbelopsidaceae;Umbelopsis;";"0.0";"0";"4";"4";"0";"4";"0";"457179";"391207"
"V4mis2";"SILVA (only NR);Eukaryota;Amorphea;Obazoa;Opisthokonta;Nucletmycea;Fungi;Neocallimastigomycota;";"15.0";"14.4";"21";"20";"3";"17";"1";"457163";"391204"
"V4mis2";"SILVA (only NR);Eukaryota;Amorphea;Obazoa;Opisthokonta;Nucletmycea;Fungi;Neocallimastigomycota;Incertae Sedis;";"15.0";"14.4";"21";"20";"3";"17";"1";"457163";"391204"
"V4mis2";"SILVA (only NR);Eukaryota;Amorphea;Obazoa;Opisthokonta;Nucletmycea;Fungi;Neocallimastigomycota;Incertae Sedis;Neocallimastigomycetes;";"15.0";"14.4";"21";"20";"3";"17";"1";"457163";"391204"
"V4mis2";"SILVA (only NR);Eukaryota;Amorphea;Obazoa;Opisthokonta;Nucletmycea;Fungi;Neocallimastigomycota;Incertae Sedis;Neocallimastigomycetes;Neocallimastigales;";"15.0";"14.4";"21";"20";"3";"17";"1";"457163";"391204"
"V4mis2";"SILVA (only NR);Eukaryota;Amorphea;Obazoa;Opisthokonta;Nucletmycea;Fungi;Neocallimastigomycota;Incertae Sedis;Neocallimastigomycetes;Neocallimastigales;Neocallimastigaceae;";"15.0";"14.4";"21";"20";"3";"17";"1";"457163";"391204"
"V4mis2";"SILVA (only NR);Eukaryota;Amorphea;Obazoa;Opisthokonta;Nucletmycea;Fungi;Neocallimastigomycota;Incertae Sedis;Neocallimastigomycetes;Neocallimastigales;Neocallimastigaceae;Cyllamyces;";"0.0";"0";"2";"2";"0";"2";"0";"457181";"391207"
"V4mis2";"SILVA (only NR);Eukaryota;Amorphea;Obazoa;Opisthokonta;Nucletmycea;Fungi;Neocallimastigomycota;Incertae Sedis;Neocallimastigomycetes;Neocallimastigales;Neocallimastigaceae;Neocallimastix;";"0.0";"0";"2";"2";"0";"2";"0";"457181";"391207"
"V4mis2";"SILVA (only NR);Eukaryota;Amorphea;Obazoa;Opisthokonta;Nucletmycea;Fungi;Neocallimastigomycota;Incertae Sedis;Neocallimastigomycetes;Neocallimastigales;Neocallimastigaceae;Pecoramyces;";"0.0";"0";"5";"4";"0";"4";"1";"457179";"391207"
"V4mis2";"SILVA (only NR);Eukaryota;Amorphea;Obazoa;Opisthokonta;Nucletmycea;Fungi;Neocallimastigomycota;Incertae Sedis;Neocallimastigomycetes;Neocallimastigales;Neocallimastigaceae;Piromyces;";"0.0";"0";"1";"1";"0";"1";"0";"457182";"391207"
"V4mis2";"SILVA (only NR);Eukaryota;Amorphea;Obazoa;Opisthokonta;Nucletmycea;Fungi;Neocallimastigomycota;Incertae Sedis;Neocallimastigomycetes;Neocallimastigales;Neocallimastigaceae;uncultured;";"75.0";"14.4";"4";"4";"3";"1";"0";"457179";"391204"
"V4mis2";"SILVA (only NR);Eukaryota;Amorphea;Obazoa;Opisthokonta;Nucletmycea;Fungi;Zoopagomycota;";"87.0";"14.4";"209";"207";"180";"27";"2";"456976";"391027"
"V4mis2";"SILVA (only NR);Eukaryota;Amorphea;Obazoa;Opisthokonta;Nucletmycea;Fungi;Zoopagomycota;Entomophthoromycotina;";"72.5";"14.4";"52";"51";"37";"14";"1";"457132";"391170"
"V4mis2";"SILVA (only NR);Eukaryota;Amorphea;Obazoa;Opisthokonta;Nucletmycea;Fungi;Zoopagomycota;Entomophthoromycotina;Basidiobolomycetes;";"0.0";"0";"7";"6";"0";"6";"1";"457177";"391207"
"V4mis2";"SILVA (only NR);Eukaryota;Amorphea;Obazoa;Opisthokonta;Nucletmycea;Fungi;Zoopagomycota;Entomophthoromycotina;Basidiobolomycetes;Basidiobolales;";"0.0";"0";"7";"6";"0";"6";"1";"457177";"391207"
"V4mis2";"SILVA (only NR);Eukaryota;Amorphea;Obazoa;Opisthokonta;Nucletmycea;Fungi;Zoopagomycota;Entomophthoromycotina;Basidiobolomycetes;Basidiobolales;Basidiobolaceae;";"0.0";"0";"7";"6";"0";"6";"1";"457177";"391207"
"V4mis2";"SILVA (only NR);Eukaryota;Amorphea;Obazoa;Opisthokonta;Nucletmycea;Fungi;Zoopagomycota;Entomophthoromycotina;Basidiobolomycetes;Basidiobolales;Basidiobolaceae;Basidiobolus;";"0.0";"0";"6";"5";"0";"5";"1";"457178";"391207"
"V4mis2";"SILVA (only NR);Eukaryota;Amorphea;Obazoa;Opisthokonta;Nucletmycea;Fungi;Zoopagomycota;Entomophthoromycotina;Basidiobolomycetes;Basidiobolales;Basidiobolaceae;Schizangiella;";"0.0";"0";"1";"1";"0";"1";"0";"457182";"391207"
"V4mis2";"SILVA (only NR);Eukaryota;Amorphea;Obazoa;Opisthokonta;Nucletmycea;Fungi;Zoopagomycota;Entomophthoromycotina;Entomophthoromycetes;";"82.2";"14.4";"45";"45";"37";"8";"0";"457138";"391170"
"V4mis2";"SILVA (only NR);Eukaryota;Amorphea;Obazoa;Opisthokonta;Nucletmycea;Fungi;Zoopagomycota;Entomophthoromycotina;Entomophthoromycetes;Entomophthorales;";"82.2";"14.4";"45";"45";"37";"8";"0";"457138";"391170"
"V4mis2";"SILVA (only NR);Eukaryota;Amorphea;Obazoa;Opisthokonta;Nucletmycea;Fungi;Zoopagomycota;Entomophthoromycotina;Entomophthoromycetes;Entomophthorales;Ancylistaceae;";"92.3";"14.4";"13";"13";"12";"1";"0";"457170";"391195"
"V4mis2";"SILVA (only NR);Eukaryota;Amorphea;Obazoa;Opisthokonta;Nucletmycea;Fungi;Zoopagomycota;Entomophthoromycotina;Entomophthoromycetes;Entomophthorales;Ancylistaceae;Conidiobolus;";"92.3";"14.4";"13";"13";"12";"1";"0";"457170";"391195"
"V4mis2";"SILVA (only NR);Eukaryota;Amorphea;Obazoa;Opisthokonta;Nucletmycea;Fungi;Zoopagomycota;Entomophthoromycotina;Entomophthoromycetes;Entomophthorales;Entomophthoraceae;";"82.1";"14.4";"28";"28";"23";"5";"0";"457155";"391184"
"V4mis2";"SILVA (only NR);Eukaryota;Amorphea;Obazoa;Opisthokonta;Nucletmycea;Fungi;Zoopagomycota;Entomophthoromycotina;Entomophthoromycetes;Entomophthorales;Entomophthoraceae;Entomophaga;";"100.0";"14.4";"1";"1";"1";"0";"0";"457182";"391206"
"V4mis2";"SILVA (only NR);Eukaryota;Amorphea;Obazoa;Opisthokonta;Nucletmycea;Fungi;Zoopagomycota;Entomophthoromycotina;Entomophthoromycetes;Entomophthorales;Entomophthoraceae;Entomophthora;";"83.3";"14.4";"6";"6";"5";"1";"0";"457177";"391202"
"V4mis2";"SILVA (only NR);Eukaryota;Amorphea;Obazoa;Opisthokonta;Nucletmycea;Fungi;Zoopagomycota;Entomophthoromycotina;Entomophthoromycetes;Entomophthorales;Entomophthoraceae;Erynia;";"100.0";"14.4";"3";"3";"3";"0";"0";"457180";"391204"
"V4mis2";"SILVA (only NR);Eukaryota;Amorphea;Obazoa;Opisthokonta;Nucletmycea;Fungi;Zoopagomycota;Entomophthoromycotina;Entomophthoromycetes;Entomophthorales;Entomophthoraceae;Eryniopsis;";"50.0";"14.4";"2";"2";"1";"1";"0";"457181";"391206"
"V4mis2";"SILVA (only NR);Eukaryota;Amorphea;Obazoa;Opisthokonta;Nucletmycea;Fungi;Zoopagomycota;Entomophthoromycotina;Entomophthoromycetes;Entomophthorales;Entomophthoraceae;Furia;";"100.0";"14.4";"3";"3";"3";"0";"0";"457180";"391204"
"V4mis2";"SILVA (only NR);Eukaryota;Amorphea;Obazoa;Opisthokonta;Nucletmycea;Fungi;Zoopagomycota;Entomophthoromycotina;Entomophthoromycetes;Entomophthorales;Entomophthoraceae;Pandora;";"100.0";"14.4";"5";"5";"5";"0";"0";"457178";"391202"
"V4mis2";"SILVA (only NR);Eukaryota;Amorphea;Obazoa;Opisthokonta;Nucletmycea;Fungi;Zoopagomycota;Entomophthoromycotina;Entomophthoromycetes;Entomophthorales;Entomophthoraceae;Strongwellsea;";"0.0";"0";"1";"1";"0";"1";"0";"457182";"391207"
"V4mis2";"SILVA (only NR);Eukaryota;Amorphea;Obazoa;Opisthokonta;Nucletmycea;Fungi;Zoopagomycota;Entomophthoromycotina;Entomophthoromycetes;Entomophthorales;Entomophthoraceae;Zoophthora;";"66.7";"14.4";"6";"6";"4";"2";"0";"457177";"391203"
"V4mis2";"SILVA (only NR);Eukaryota;Amorphea;Obazoa;Opisthokonta;Nucletmycea;Fungi;Zoopagomycota;Entomophthoromycotina;Entomophthoromycetes;Entomophthorales;uncultured;";"50.0";"14.4";"4";"4";"2";"2";"0";"457179";"391205"
"V4mis2";"SILVA (only NR);Eukaryota;Amorphea;Obazoa;Opisthokonta;Nucletmycea;Fungi;Zoopagomycota;Kickxellomycotina;";"95.3";"14.4";"127";"127";"121";"6";"0";"457056";"391086"
"V4mis2";"SILVA (only NR);Eukaryota;Amorphea;Obazoa;Opisthokonta;Nucletmycea;Fungi;Zoopagomycota;Kickxellomycotina;Incertae Sedis;";"95.3";"14.4";"127";"127";"121";"6";"0";"457056";"391086"
"V4mis2";"SILVA (only NR);Eukaryota;Amorphea;Obazoa;Opisthokonta;Nucletmycea;Fungi;Zoopagomycota;Kickxellomycotina;Incertae Sedis;Harpellales;";"100.0";"14.4";"89";"89";"89";"0";"0";"457094";"391118"
"V4mis2";"SILVA (only NR);Eukaryota;Amorphea;Obazoa;Opisthokonta;Nucletmycea;Fungi;Zoopagomycota;Kickxellomycotina;Incertae Sedis;Harpellales;Furculomyces;";"100.0";"14.4";"2";"2";"2";"0";"0";"457181";"391205"
"V4mis2";"SILVA (only NR);Eukaryota;Amorphea;Obazoa;Opisthokonta;Nucletmycea;Fungi;Zoopagomycota;Kickxellomycotina;Incertae Sedis;Harpellales;Harpellaceae;";"100.0";"14.4";"9";"9";"9";"0";"0";"457174";"391198"
"V4mis2";"SILVA (only NR);Eukaryota;Amorphea;Obazoa;Opisthokonta;Nucletmycea;Fungi;Zoopagomycota;Kickxellomycotina;Incertae Sedis;Harpellales;Harpellaceae;Harpella;";"100.0";"14.4";"4";"4";"4";"0";"0";"457179";"391203"
"V4mis2";"SILVA (only NR);Eukaryota;Amorphea;Obazoa;Opisthokonta;Nucletmycea;Fungi;Zoopagomycota;Kickxellomycotina;Incertae Sedis;Harpellales;Harpellaceae;Legeriomyces;";"100.0";"14.4";"1";"1";"1";"0";"0";"457182";"391206"
"V4mis2";"SILVA (only NR);Eukaryota;Amorphea;Obazoa;Opisthokonta;Nucletmycea;Fungi;Zoopagomycota;Kickxellomycotina;Incertae Sedis;Harpellales;Harpellaceae;Stachylina;";"100.0";"14.4";"1";"1";"1";"0";"0";"457182";"391206"
"V4mis2";"SILVA (only NR);Eukaryota;Amorphea;Obazoa;Opisthokonta;Nucletmycea;Fungi;Zoopagomycota;Kickxellomycotina;Incertae Sedis;Harpellales;Legeriomycetaceae;";"100.0";"14.4";"76";"76";"76";"0";"0";"457107";"391131"
"V4mis2";"SILVA (only NR);Eukaryota;Amorphea;Obazoa;Opisthokonta;Nucletmycea;Fungi;Zoopagomycota;Kickxellomycotina;Incertae Sedis;Harpellales;Legeriomycetaceae;Barbatospora;";"100.0";"14.4";"1";"1";"1";"0";"0";"457182";"391206"
"V4mis2";"SILVA (only NR);Eukaryota;Amorphea;Obazoa;Opisthokonta;Nucletmycea;Fungi;Zoopagomycota;Kickxellomycotina;Incertae Sedis;Harpellales;Legeriomycetaceae;Bojamyces;";"100.0";"14.4";"1";"1";"1";"0";"0";"457182";"391206"
"V4mis2";"SILVA (only NR);Eukaryota;Amorphea;Obazoa;Opisthokonta;Nucletmycea;Fungi;Zoopagomycota;Kickxellomycotina;Incertae Sedis;Harpellales;Legeriomycetaceae;Capniomyces;";"100.0";"14.4";"2";"2";"2";"0";"0";"457181";"391205"
"V4mis2";"SILVA (only NR);Eukaryota;Amorphea;Obazoa;Opisthokonta;Nucletmycea;Fungi;Zoopagomycota;Kickxellomycotina;Incertae Sedis;Harpellales;Legeriomycetaceae;Coleopteromyces;";"100.0";"14.4";"1";"1";"1";"0";"0";"457182";"391206"
"V4mis2";"SILVA (only NR);Eukaryota;Amorphea;Obazoa;Opisthokonta;Nucletmycea;Fungi;Zoopagomycota;Kickxellomycotina;Incertae Sedis;Harpellales;Legeriomycetaceae;Genistelloides;";"100.0";"14.4";"5";"5";"5";"0";"0";"457178";"391202"
"V4mis2";"SILVA (only NR);Eukaryota;Amorphea;Obazoa;Opisthokonta;Nucletmycea;Fungi;Zoopagomycota;Kickxellomycotina;Incertae Sedis;Harpellales;Legeriomycetaceae;Genistellospora;";"100.0";"14.4";"1";"1";"1";"0";"0";"457182";"391206"
"V4mis2";"SILVA (only NR);Eukaryota;Amorphea;Obazoa;Opisthokonta;Nucletmycea;Fungi;Zoopagomycota;Kickxellomycotina;Incertae Sedis;Harpellales;Legeriomycetaceae;Graminella;";"100.0";"14.4";"1";"1";"1";"0";"0";"457182";"391206"
"V4mis2";"SILVA (only NR);Eukaryota;Amorphea;Obazoa;Opisthokonta;Nucletmycea;Fungi;Zoopagomycota;Kickxellomycotina;Incertae Sedis;Harpellales;Legeriomycetaceae;Lancisporomyces;";"100.0";"14.4";"2";"2";"2";"0";"0";"457181";"391205"
"V4mis2";"SILVA (only NR);Eukaryota;Amorphea;Obazoa;Opisthokonta;Nucletmycea;Fungi;Zoopagomycota;Kickxellomycotina;Incertae Sedis;Harpellales;Legeriomycetaceae;Legerioides;";"100.0";"14.4";"1";"1";"1";"0";"0";"457182";"391206"
"V4mis2";"SILVA (only NR);Eukaryota;Amorphea;Obazoa;Opisthokonta;Nucletmycea;Fungi;Zoopagomycota;Kickxellomycotina;Incertae Sedis;Harpellales;Legeriomycetaceae;Orphella;";"100.0";"14.4";"5";"5";"5";"0";"0";"457178";"391202"
"V4mis2";"SILVA (only NR);Eukaryota;Amorphea;Obazoa;Opisthokonta;Nucletmycea;Fungi;Zoopagomycota;Kickxellomycotina;Incertae Sedis;Harpellales;Legeriomycetaceae;Pennella;";"100.0";"14.4";"1";"1";"1";"0";"0";"457182";"391206"
"V4mis2";"SILVA (only NR);Eukaryota;Amorphea;Obazoa;Opisthokonta;Nucletmycea;Fungi;Zoopagomycota;Kickxellomycotina;Incertae Sedis;Harpellales;Legeriomycetaceae;Plecopteromyces;";"100.0";"14.4";"3";"3";"3";"0";"0";"457180";"391204"
"V4mis2";"SILVA (only NR);Eukaryota;Amorphea;Obazoa;Opisthokonta;Nucletmycea;Fungi;Zoopagomycota;Kickxellomycotina;Incertae Sedis;Harpellales;Legeriomycetaceae;Pteromaktron;";"100.0";"14.4";"1";"1";"1";"0";"0";"457182";"391206"
"V4mis2";"SILVA (only NR);Eukaryota;Amorphea;Obazoa;Opisthokonta;Nucletmycea;Fungi;Zoopagomycota;Kickxellomycotina;Incertae Sedis;Harpellales;Legeriomycetaceae;Smittium;";"100.0";"14.4";"39";"39";"39";"0";"0";"457144";"391168"
"V4mis2";"SILVA (only NR);Eukaryota;Amorphea;Obazoa;Opisthokonta;Nucletmycea;Fungi;Zoopagomycota;Kickxellomycotina;Incertae Sedis;Harpellales;Legeriomycetaceae;Spartiella;";"100.0";"14.4";"1";"1";"1";"0";"0";"457182";"391206"
"V4mis2";"SILVA (only NR);Eukaryota;Amorphea;Obazoa;Opisthokonta;Nucletmycea;Fungi;Zoopagomycota;Kickxellomycotina;Incertae Sedis;Harpellales;Legeriomycetaceae;Zancudomyces;";"100.0";"14.4";"3";"3";"3";"0";"0";"457180";"391204"
"V4mis2";"SILVA (only NR);Eukaryota;Amorphea;Obazoa;Opisthokonta;Nucletmycea;Fungi;Zoopagomycota;Kickxellomycotina;Incertae Sedis;Harpellales;Legeriomycetaceae;Zygopolaris;";"100.0";"14.4";"1";"1";"1";"0";"0";"457182";"391206"
"V4mis2";"SILVA (only NR);Eukaryota;Amorphea;Obazoa;Opisthokonta;Nucletmycea;Fungi;Zoopagomycota;Kickxellomycotina;Incertae Sedis;Harpellales;Pseudoharpella;";"100.0";"14.4";"1";"1";"1";"0";"0";"457182";"391206"
"V4mis2";"SILVA (only NR);Eukaryota;Amorphea;Obazoa;Opisthokonta;Nucletmycea;Fungi;Zoopagomycota;Kickxellomycotina;Incertae Sedis;Kickxellales;";"82.4";"14.4";"34";"34";"28";"6";"0";"457149";"391179"
"V4mis2";"SILVA (only NR);Eukaryota;Amorphea;Obazoa;Opisthokonta;Nucletmycea;Fungi;Zoopagomycota;Kickxellomycotina;Incertae Sedis;Kickxellales;Kickxellaceae;";"82.4";"14.4";"34";"34";"28";"6";"0";"457149";"391179"
"V4mis2";"SILVA (only NR);Eukaryota;Amorphea;Obazoa;Opisthokonta;Nucletmycea;Fungi;Zoopagomycota;Kickxellomycotina;Incertae Sedis;Kickxellales;Kickxellaceae;Coemansia;";"75.0";"14.4";"16";"16";"12";"4";"0";"457167";"391195"
"V4mis2";"SILVA (only NR);Eukaryota;Amorphea;Obazoa;Opisthokonta;Nucletmycea;Fungi;Zoopagomycota;Kickxellomycotina;Incertae Sedis;Kickxellales;Kickxellaceae;Dipsacomyces;";"100.0";"14.4";"1";"1";"1";"0";"0";"457182";"391206"
"V4mis2";"SILVA (only NR);Eukaryota;Amorphea;Obazoa;Opisthokonta;Nucletmycea;Fungi;Zoopagomycota;Kickxellomycotina;Incertae Sedis;Kickxellales;Kickxellaceae;Kickxella;";"100.0";"14.4";"1";"1";"1";"0";"0";"457182";"391206"
"V4mis2";"SILVA (only NR);Eukaryota;Amorphea;Obazoa;Opisthokonta;Nucletmycea;Fungi;Zoopagomycota;Kickxellomycotina;Incertae Sedis;Kickxellales;Kickxellaceae;Linderina;";"100.0";"14.4";"4";"4";"4";"0";"0";"457179";"391203"
"V4mis2";"SILVA (only NR);Eukaryota;Amorphea;Obazoa;Opisthokonta;Nucletmycea;Fungi;Zoopagomycota;Kickxellomycotina;Incertae Sedis;Kickxellales;Kickxellaceae;Martensiomyces;";"100.0";"14.4";"1";"1";"1";"0";"0";"457182";"391206"
"V4mis2";"SILVA (only NR);Eukaryota;Amorphea;Obazoa;Opisthokonta;Nucletmycea;Fungi;Zoopagomycota;Kickxellomycotina;Incertae Sedis;Kickxellales;Kickxellaceae;Mycoemilia;";"100.0";"14.4";"1";"1";"1";"0";"0";"457182";"391206"
"V4mis2";"SILVA (only NR);Eukaryota;Amorphea;Obazoa;Opisthokonta;Nucletmycea;Fungi;Zoopagomycota;Kickxellomycotina;Incertae Sedis;Kickxellales;Kickxellaceae;Myconymphaea;";"0.0";"0";"1";"1";"0";"1";"0";"457182";"391207"
"V4mis2";"SILVA (only NR);Eukaryota;Amorphea;Obazoa;Opisthokonta;Nucletmycea;Fungi;Zoopagomycota;Kickxellomycotina;Incertae Sedis;Kickxellales;Kickxellaceae;Pinnaticoemansia;";"100.0";"14.4";"1";"1";"1";"0";"0";"457182";"391206"
"V4mis2";"SILVA (only NR);Eukaryota;Amorphea;Obazoa;Opisthokonta;Nucletmycea;Fungi;Zoopagomycota;Kickxellomycotina;Incertae Sedis;Kickxellales;Kickxellaceae;Ramicandelaber;";"100.0";"14.4";"4";"4";"4";"0";"0";"457179";"391203"
"V4mis2";"SILVA (only NR);Eukaryota;Amorphea;Obazoa;Opisthokonta;Nucletmycea;Fungi;Zoopagomycota;Kickxellomycotina;Incertae Sedis;Kickxellales;Kickxellaceae;Spirodactylon;";"0.0";"0";"1";"1";"0";"1";"0";"457182";"391207"
"V4mis2";"SILVA (only NR);Eukaryota;Amorphea;Obazoa;Opisthokonta;Nucletmycea;Fungi;Zoopagomycota;Kickxellomycotina;Incertae Sedis;Kickxellales;Kickxellaceae;Spiromyces;";"100.0";"14.4";"2";"2";"2";"0";"0";"457181";"391205"
"V4mis2";"SILVA (only NR);Eukaryota;Amorphea;Obazoa;Opisthokonta;Nucletmycea;Fungi;Zoopagomycota;Zoopagomycotina;";"75.0";"14.4";"29";"28";"21";"7";"1";"457155";"391186"
"V4mis2";"SILVA (only NR);Eukaryota;Amorphea;Obazoa;Opisthokonta;Nucletmycea;Fungi;Zoopagomycota;Zoopagomycotina;Incertae Sedis;";"75.0";"14.4";"29";"28";"21";"7";"1";"457155";"391186"
"V4mis2";"SILVA (only NR);Eukaryota;Amorphea;Obazoa;Opisthokonta;Nucletmycea;Fungi;Zoopagomycota;Zoopagomycotina;Incertae Sedis;Zoopagales;";"75.0";"14.4";"29";"28";"21";"7";"1";"457155";"391186"
"V4mis2";"SILVA (only NR);Eukaryota;Amorphea;Obazoa;Opisthokonta;Nucletmycea;Fungi;Zoopagomycota;Zoopagomycotina;Incertae Sedis;Zoopagales;Acaulopage;";"33.3";"14.4";"3";"3";"1";"2";"0";"457180";"391206"
"V4mis2";"SILVA (only NR);Eukaryota;Amorphea;Obazoa;Opisthokonta;Nucletmycea;Fungi;Zoopagomycota;Zoopagomycotina;Incertae Sedis;Zoopagales;Cochlonema;";"0.0";"0";"1";"1";"0";"1";"0";"457182";"391207"
"V4mis2";"SILVA (only NR);Eukaryota;Amorphea;Obazoa;Opisthokonta;Nucletmycea;Fungi;Zoopagomycota;Zoopagomycotina;Incertae Sedis;Zoopagales;Kuzuhaea;";"100.0";"14.4";"1";"1";"1";"0";"0";"457182";"391206"
"V4mis2";"SILVA (only NR);Eukaryota;Amorphea;Obazoa;Opisthokonta;Nucletmycea;Fungi;Zoopagomycota;Zoopagomycotina;Incertae Sedis;Zoopagales;Piptocephalidaceae;";"100.0";"14.4";"6";"6";"6";"0";"0";"457177";"391201"
"V4mis2";"SILVA (only NR);Eukaryota;Amorphea;Obazoa;Opisthokonta;Nucletmycea;Fungi;Zoopagomycota;Zoopagomycotina;Incertae Sedis;Zoopagales;Piptocephalidaceae;Piptocephalis;";"100.0";"14.4";"6";"6";"6";"0";"0";"457177";"391201"
"V4mis2";"SILVA (only NR);Eukaryota;Amorphea;Obazoa;Opisthokonta;Nucletmycea;Fungi;Zoopagomycota;Zoopagomycotina;Incertae Sedis;Zoopagales;Rhopalomyces;";"100.0";"14.4";"1";"1";"1";"0";"0";"457182";"391206"
"V4mis2";"SILVA (only NR);Eukaryota;Amorphea;Obazoa;Opisthokonta;Nucletmycea;Fungi;Zoopagomycota;Zoopagomycotina;Incertae Sedis;Zoopagales;Sigmoideomycetaceae;";"100.0";"14.4";"1";"1";"1";"0";"0";"457182";"391206"
"V4mis2";"SILVA (only NR);Eukaryota;Amorphea;Obazoa;Opisthokonta;Nucletmycea;Fungi;Zoopagomycota;Zoopagomycotina;Incertae Sedis;Zoopagales;Sigmoideomycetaceae;Thamnocephalis;";"100.0";"14.4";"1";"1";"1";"0";"0";"457182";"391206"
"V4mis2";"SILVA (only NR);Eukaryota;Amorphea;Obazoa;Opisthokonta;Nucletmycea;Fungi;Zoopagomycota;Zoopagomycotina;Incertae Sedis;Zoopagales;Stylopage;";"100.0";"14.4";"1";"1";"1";"0";"0";"457182";"391206"
"V4mis2";"SILVA (only NR);Eukaryota;Amorphea;Obazoa;Opisthokonta;Nucletmycea;Fungi;Zoopagomycota;Zoopagomycotina;Incertae Sedis;Zoopagales;Syncephalis;";"100.0";"14.4";"1";"1";"1";"0";"0";"457182";"391206"
"V4mis2";"SILVA (only NR);Eukaryota;Amorphea;Obazoa;Opisthokonta;Nucletmycea;Fungi;Zoopagomycota;Zoopagomycotina;Incertae Sedis;Zoopagales;Zoophagus;";"0.0";"0";"1";"1";"0";"1";"0";"457182";"391207"
"V4mis2";"SILVA (only NR);Eukaryota;Amorphea;Obazoa;Opisthokonta;Nucletmycea;Fungi;uncultured;";"26.9";"14.4";"27";"26";"7";"19";"1";"457157";"391200"
"V4mis2";"SILVA (only NR);Eukaryota;Amorphea;Obazoa;Opisthokonta;Nucletmycea;Nucleariidae and Fonticula group;";"0.0";"0";"29";"28";"0";"28";"1";"457155";"391207"
"V4mis2";"SILVA (only NR);Eukaryota;Amorphea;Obazoa;Opisthokonta;Nucletmycea;Nucleariidae and Fonticula group;Fonticula;";"0.0";"0";"1";"1";"0";"1";"0";"457182";"391207"
"V4mis2";"SILVA (only NR);Eukaryota;Amorphea;Obazoa;Opisthokonta;Nucletmycea;Nucleariidae and Fonticula group;Nucleariidae;";"0.0";"0";"28";"27";"0";"27";"1";"457156";"391207"
"V4mis2";"SILVA (only NR);Eukaryota;Amorphea;Obazoa;Opisthokonta;Nucletmycea;Nucleariidae and Fonticula group;Nucleariidae;Nuclearia;";"0.0";"0";"28";"27";"0";"27";"1";"457156";"391207"
"V4mis2";"SILVA (only NR);Eukaryota;Archaeplastida;";"15.7";"13.3";"7535";"7476";"1177";"6299";"59";"449707";"390030"
"V4mis2";"SILVA (only NR);Eukaryota;Archaeplastida;Chloroplastida;";"17.1";"13.4";"6646";"6591";"1128";"5463";"55";"450592";"390079"
"V4mis2";"SILVA (only NR);Eukaryota;Archaeplastida;Chloroplastida;Charophyta;";"1.5";"13.6";"4738";"4717";"69";"4648";"21";"452466";"391138"
"V4mis2";"SILVA (only NR);Eukaryota;Archaeplastida;Chloroplastida;Charophyta;Amb-18S-504;";"28.6";"14.4";"7";"7";"2";"5";"0";"457176";"391205"
"V4mis2";"SILVA (only NR);Eukaryota;Archaeplastida;Chloroplastida;Charophyta;Chlorokybophyceae;";"0.0";"0";"1";"1";"0";"1";"0";"457182";"391207"
"V4mis2";"SILVA (only NR);Eukaryota;Archaeplastida;Chloroplastida;Charophyta;Chlorokybophyceae;Chlorokybus;";"0.0";"0";"1";"1";"0";"1";"0";"457182";"391207"
"V4mis2";"SILVA (only NR);Eukaryota;Archaeplastida;Chloroplastida;Charophyta;Klebsormidiophyceae;";"0.0";"0";"8";"8";"0";"8";"0";"457175";"391207"
"V4mis2";"SILVA (only NR);Eukaryota;Archaeplastida;Chloroplastida;Charophyta;Klebsormidiophyceae;Klebsormidiales;";"0.0";"0";"5";"5";"0";"5";"0";"457178";"391207"
"V4mis2";"SILVA (only NR);Eukaryota;Archaeplastida;Chloroplastida;Charophyta;Klebsormidiophyceae;Klebsormidiales;Entransia;";"0.0";"0";"1";"1";"0";"1";"0";"457182";"391207"
"V4mis2";"SILVA (only NR);Eukaryota;Archaeplastida;Chloroplastida;Charophyta;Klebsormidiophyceae;Klebsormidiales;Hormidiella;";"0.0";"0";"1";"1";"0";"1";"0";"457182";"391207"
"V4mis2";"SILVA (only NR);Eukaryota;Archaeplastida;Chloroplastida;Charophyta;Klebsormidiophyceae;Klebsormidiales;Klebsormidium;";"0.0";"0";"3";"3";"0";"3";"0";"457180";"391207"
"V4mis2";"SILVA (only NR);Eukaryota;Archaeplastida;Chloroplastida;Charophyta;Mesostigmatophyceae;";"0.0";"0";"1";"1";"0";"1";"0";"457182";"391207"
"V4mis2";"SILVA (only NR);Eukaryota;Archaeplastida;Chloroplastida;Charophyta;Mesostigmatophyceae;Mesostigma;";"0.0";"0";"1";"1";"0";"1";"0";"457182";"391207"
"V4mis2";"SILVA (only NR);Eukaryota;Archaeplastida;Chloroplastida;Charophyta;Phragmoplastophyta;";"1.4";"13.6";"4720";"4699";"67";"4632";"21";"452484";"391140"
"V4mis2";"SILVA (only NR);Eukaryota;Archaeplastida;Chloroplastida;Charophyta;Phragmoplastophyta;Coleochaetophyceae;";"8.3";"14.4";"12";"12";"1";"11";"0";"457171";"391206"
"V4mis2";"SILVA (only NR);Eukaryota;Archaeplastida;Chloroplastida;Charophyta;Phragmoplastophyta;Coleochaetophyceae;Chaetosphaeridiales;";"16.7";"14.4";"6";"6";"1";"5";"0";"457177";"391206"
"V4mis2";"SILVA (only NR);Eukaryota;Archaeplastida;Chloroplastida;Charophyta;Phragmoplastophyta;Coleochaetophyceae;Chaetosphaeridiales;Chaetosphaeridium;";"16.7";"14.4";"6";"6";"1";"5";"0";"457177";"391206"
"V4mis2";"SILVA (only NR);Eukaryota;Archaeplastida;Chloroplastida;Charophyta;Phragmoplastophyta;Coleochaetophyceae;Coleochaete;";"0.0";"0";"6";"6";"0";"6";"0";"457177";"391207"
"V4mis2";"SILVA (only NR);Eukaryota;Archaeplastida;Chloroplastida;Charophyta;Phragmoplastophyta;Streptophyta;";"0.9";"13.6";"4538";"4517";"42";"4475";"21";"452666";"391165"
"V4mis2";"SILVA (only NR);Eukaryota;Archaeplastida;Chloroplastida;Charophyta;Phragmoplastophyta;Streptophyta;Charophyceae;";"0.0";"0";"36";"36";"0";"36";"0";"457147";"391207"
"V4mis2";"SILVA (only NR);Eukaryota;Archaeplastida;Chloroplastida;Charophyta;Phragmoplastophyta;Streptophyta;Charophyceae;Charales;";"0.0";"0";"36";"36";"0";"36";"0";"457147";"391207"
"V4mis2";"SILVA (only NR);Eukaryota;Archaeplastida;Chloroplastida;Charophyta;Phragmoplastophyta;Streptophyta;Charophyceae;Charales;Chara;";"0.0";"0";"28";"28";"0";"28";"0";"457155";"391207"
"V4mis2";"SILVA (only NR);Eukaryota;Archaeplastida;Chloroplastida;Charophyta;Phragmoplastophyta;Streptophyta;Charophyceae;Charales;Lychnothamnus;";"0.0";"0";"1";"1";"0";"1";"0";"457182";"391207"
"V4mis2";"SILVA (only NR);Eukaryota;Archaeplastida;Chloroplastida;Charophyta;Phragmoplastophyta;Streptophyta;Charophyceae;Charales;Nitellaceae;";"0.0";"0";"6";"6";"0";"6";"0";"457177";"391207"
"V4mis2";"SILVA (only NR);Eukaryota;Archaeplastida;Chloroplastida;Charophyta;Phragmoplastophyta;Streptophyta;Charophyceae;Charales;Nitellaceae;Nitella;";"0.0";"0";"4";"4";"0";"4";"0";"457179";"391207"
"V4mis2";"SILVA (only NR);Eukaryota;Archaeplastida;Chloroplastida;Charophyta;Phragmoplastophyta;Streptophyta;Charophyceae;Charales;Nitellaceae;Tolypella;";"0.0";"0";"2";"2";"0";"2";"0";"457181";"391207"
"V4mis2";"SILVA (only NR);Eukaryota;Archaeplastida;Chloroplastida;Charophyta;Phragmoplastophyta;Streptophyta;Charophyceae;Charales;Nitellopsis;";"0.0";"0";"1";"1";"0";"1";"0";"457182";"391207"
"V4mis2";"SILVA (only NR);Eukaryota;Archaeplastida;Chloroplastida;Charophyta;Phragmoplastophyta;Streptophyta;Embryophyta;";"0.9";"13.6";"4502";"4481";"42";"4439";"21";"452702";"391165"
"V4mis2";"SILVA (only NR);Eukaryota;Archaeplastida;Chloroplastida;Charophyta;Phragmoplastophyta;Streptophyta;Embryophyta;Anthocerotophyta;";"0.0";"0";"13";"13";"0";"13";"0";"457170";"391207"
"V4mis2";"SILVA (only NR);Eukaryota;Archaeplastida;Chloroplastida;Charophyta;Phragmoplastophyta;Streptophyta;Embryophyta;Anthocerotophyta;Anthocerotales;";"0.0";"0";"2";"2";"0";"2";"0";"457181";"391207"
"V4mis2";"SILVA (only NR);Eukaryota;Archaeplastida;Chloroplastida;Charophyta;Phragmoplastophyta;Streptophyta;Embryophyta;Anthocerotophyta;Anthocerotales;Anthoceros;";"0.0";"0";"1";"1";"0";"1";"0";"457182";"391207"
"V4mis2";"SILVA (only NR);Eukaryota;Archaeplastida;Chloroplastida;Charophyta;Phragmoplastophyta;Streptophyta;Embryophyta;Anthocerotophyta;Anthocerotales;Folioceros;";"0.0";"0";"1";"1";"0";"1";"0";"457182";"391207"
"V4mis2";"SILVA (only NR);Eukaryota;Archaeplastida;Chloroplastida;Charophyta;Phragmoplastophyta;Streptophyta;Embryophyta;Anthocerotophyta;Dendrocerotales;";"0.0";"0";"7";"7";"0";"7";"0";"457176";"391207"
"V4mis2";"SILVA (only NR);Eukaryota;Archaeplastida;Chloroplastida;Charophyta;Phragmoplastophyta;Streptophyta;Embryophyta;Anthocerotophyta;Dendrocerotales;Megaceros;";"0.0";"0";"2";"2";"0";"2";"0";"457181";"391207"
"V4mis2";"SILVA (only NR);Eukaryota;Archaeplastida;Chloroplastida;Charophyta;Phragmoplastophyta;Streptophyta;Embryophyta;Anthocerotophyta;Dendrocerotales;Nothoceros;";"0.0";"0";"3";"3";"0";"3";"0";"457180";"391207"
"V4mis2";"SILVA (only NR);Eukaryota;Archaeplastida;Chloroplastida;Charophyta;Phragmoplastophyta;Streptophyta;Embryophyta;Anthocerotophyta;Dendrocerotales;Phaeomegaceros;";"0.0";"0";"2";"2";"0";"2";"0";"457181";"391207"
"V4mis2";"SILVA (only NR);Eukaryota;Archaeplastida;Chloroplastida;Charophyta;Phragmoplastophyta;Streptophyta;Embryophyta;Anthocerotophyta;Notothyladales;";"0.0";"0";"3";"3";"0";"3";"0";"457180";"391207"
"V4mis2";"SILVA (only NR);Eukaryota;Archaeplastida;Chloroplastida;Charophyta;Phragmoplastophyta;Streptophyta;Embryophyta;Anthocerotophyta;Notothyladales;Notothylas;";"0.0";"0";"1";"1";"0";"1";"0";"457182";"391207"
"V4mis2";"SILVA (only NR);Eukaryota;Archaeplastida;Chloroplastida;Charophyta;Phragmoplastophyta;Streptophyta;Embryophyta;Anthocerotophyta;Notothyladales;Phaeoceros;";"0.0";"0";"2";"2";"0";"2";"0";"457181";"391207"
"V4mis2";"SILVA (only NR);Eukaryota;Archaeplastida;Chloroplastida;Charophyta;Phragmoplastophyta;Streptophyta;Embryophyta;Anthocerotophyta;Phymatocerotales;";"0.0";"0";"1";"1";"0";"1";"0";"457182";"391207"
"V4mis2";"SILVA (only NR);Eukaryota;Archaeplastida;Chloroplastida;Charophyta;Phragmoplastophyta;Streptophyta;Embryophyta;Anthocerotophyta;Phymatocerotales;Phymatoceros;";"0.0";"0";"1";"1";"0";"1";"0";"457182";"391207"
"V4mis2";"SILVA (only NR);Eukaryota;Archaeplastida;Chloroplastida;Charophyta;Phragmoplastophyta;Streptophyta;Embryophyta;Bryophyta;";"0.0";"0";"93";"93";"0";"93";"0";"457090";"391207"
"V4mis2";"SILVA (only NR);Eukaryota;Archaeplastida;Chloroplastida;Charophyta;Phragmoplastophyta;Streptophyta;Embryophyta;Bryophyta;Andreaeales;";"0.0";"0";"2";"2";"0";"2";"0";"457181";"391207"
"V4mis2";"SILVA (only NR);Eukaryota;Archaeplastida;Chloroplastida;Charophyta;Phragmoplastophyta;Streptophyta;Embryophyta;Bryophyta;Andreaeales;Andreaeaceae;";"0.0";"0";"2";"2";"0";"2";"0";"457181";"391207"
"V4mis2";"SILVA (only NR);Eukaryota;Archaeplastida;Chloroplastida;Charophyta;Phragmoplastophyta;Streptophyta;Embryophyta;Bryophyta;Andreaeales;Andreaeaceae;Andreaea;";"0.0";"0";"2";"2";"0";"2";"0";"457181";"391207"
"V4mis2";"SILVA (only NR);Eukaryota;Archaeplastida;Chloroplastida;Charophyta;Phragmoplastophyta;Streptophyta;Embryophyta;Bryophyta;Bryales;";"0.0";"0";"13";"13";"0";"13";"0";"457170";"391207"
"V4mis2";"SILVA (only NR);Eukaryota;Archaeplastida;Chloroplastida;Charophyta;Phragmoplastophyta;Streptophyta;Embryophyta;Bryophyta;Bryales;Bryum;";"0.0";"0";"1";"1";"0";"1";"0";"457182";"391207"
"V4mis2";"SILVA (only NR);Eukaryota;Archaeplastida;Chloroplastida;Charophyta;Phragmoplastophyta;Streptophyta;Embryophyta;Bryophyta;Bryales;Cinclidium;";"0.0";"0";"1";"1";"0";"1";"0";"457182";"391207"
"V4mis2";"SILVA (only NR);Eukaryota;Archaeplastida;Chloroplastida;Charophyta;Phragmoplastophyta;Streptophyta;Embryophyta;Bryophyta;Bryales;Leptostomum;";"0.0";"0";"1";"1";"0";"1";"0";"457182";"391207"
"V4mis2";"SILVA (only NR);Eukaryota;Archaeplastida;Chloroplastida;Charophyta;Phragmoplastophyta;Streptophyta;Embryophyta;Bryophyta;Bryales;Leucolepis;";"0.0";"0";"1";"1";"0";"1";"0";"457182";"391207"
"V4mis2";"SILVA (only NR);Eukaryota;Archaeplastida;Chloroplastida;Charophyta;Phragmoplastophyta;Streptophyta;Embryophyta;Bryophyta;Bryales;Mielichhoferia;";"0.0";"0";"1";"1";"0";"1";"0";"457182";"391207"
"V4mis2";"SILVA (only NR);Eukaryota;Archaeplastida;Chloroplastida;Charophyta;Phragmoplastophyta;Streptophyta;Embryophyta;Bryophyta;Bryales;Mnium;";"0.0";"0";"1";"1";"0";"1";"0";"457182";"391207"
"V4mis2";"SILVA (only NR);Eukaryota;Archaeplastida;Chloroplastida;Charophyta;Phragmoplastophyta;Streptophyta;Embryophyta;Bryophyta;Bryales;Plagiobryoides;";"0.0";"0";"1";"1";"0";"1";"0";"457182";"391207"
"V4mis2";"SILVA (only NR);Eukaryota;Archaeplastida;Chloroplastida;Charophyta;Phragmoplastophyta;Streptophyta;Embryophyta;Bryophyta;Bryales;Plagiomnium;";"0.0";"0";"1";"1";"0";"1";"0";"457182";"391207"
"V4mis2";"SILVA (only NR);Eukaryota;Archaeplastida;Chloroplastida;Charophyta;Phragmoplastophyta;Streptophyta;Embryophyta;Bryophyta;Bryales;Pohlia;";"0.0";"0";"2";"2";"0";"2";"0";"457181";"391207"
"V4mis2";"SILVA (only NR);Eukaryota;Archaeplastida;Chloroplastida;Charophyta;Phragmoplastophyta;Streptophyta;Embryophyta;Bryophyta;Bryales;Rosulabryum;";"0.0";"0";"1";"1";"0";"1";"0";"457182";"391207"
"V4mis2";"SILVA (only NR);Eukaryota;Archaeplastida;Chloroplastida;Charophyta;Phragmoplastophyta;Streptophyta;Embryophyta;Bryophyta;Bryales;Scouleria;";"0.0";"0";"1";"1";"0";"1";"0";"457182";"391207"
"V4mis2";"SILVA (only NR);Eukaryota;Archaeplastida;Chloroplastida;Charophyta;Phragmoplastophyta;Streptophyta;Embryophyta;Bryophyta;Bryoxiphiales;";"0.0";"0";"1";"1";"0";"1";"0";"457182";"391207"
"V4mis2";"SILVA (only NR);Eukaryota;Archaeplastida;Chloroplastida;Charophyta;Phragmoplastophyta;Streptophyta;Embryophyta;Bryophyta;Bryoxiphiales;Bryoxiphium;";"0.0";"0";"1";"1";"0";"1";"0";"457182";"391207"
"V4mis2";"SILVA (only NR);Eukaryota;Archaeplastida;Chloroplastida;Charophyta;Phragmoplastophyta;Streptophyta;Embryophyta;Bryophyta;Dicranales;";"0.0";"0";"7";"7";"0";"7";"0";"457176";"391207"
"V4mis2";"SILVA (only NR);Eukaryota;Archaeplastida;Chloroplastida;Charophyta;Phragmoplastophyta;Streptophyta;Embryophyta;Bryophyta;Dicranales;Archidium;";"0.0";"0";"1";"1";"0";"1";"0";"457182";"391207"
"V4mis2";"SILVA (only NR);Eukaryota;Archaeplastida;Chloroplastida;Charophyta;Phragmoplastophyta;Streptophyta;Embryophyta;Bryophyta;Dicranales;Calymperes;";"0.0";"0";"1";"1";"0";"1";"0";"457182";"391207"
"V4mis2";"SILVA (only NR);Eukaryota;Archaeplastida;Chloroplastida;Charophyta;Phragmoplastophyta;Streptophyta;Embryophyta;Bryophyta;Dicranales;Fissidens;";"0.0";"0";"2";"2";"0";"2";"0";"457181";"391207"
"V4mis2";"SILVA (only NR);Eukaryota;Archaeplastida;Chloroplastida;Charophyta;Phragmoplastophyta;Streptophyta;Embryophyta;Bryophyta;Dicranales;Leucobryum;";"0.0";"0";"1";"1";"0";"1";"0";"457182";"391207"
"V4mis2";"SILVA (only NR);Eukaryota;Archaeplastida;Chloroplastida;Charophyta;Phragmoplastophyta;Streptophyta;Embryophyta;Bryophyta;Dicranales;Micromitrium;";"0.0";"0";"1";"1";"0";"1";"0";"457182";"391207"
"V4mis2";"SILVA (only NR);Eukaryota;Archaeplastida;Chloroplastida;Charophyta;Phragmoplastophyta;Streptophyta;Embryophyta;Bryophyta;Dicranales;Syrrhopodon;";"0.0";"0";"1";"1";"0";"1";"0";"457182";"391207"
"V4mis2";"SILVA (only NR);Eukaryota;Archaeplastida;Chloroplastida;Charophyta;Phragmoplastophyta;Streptophyta;Embryophyta;Bryophyta;Diphysciales;";"0.0";"0";"1";"1";"0";"1";"0";"457182";"391207"
"V4mis2";"SILVA (only NR);Eukaryota;Archaeplastida;Chloroplastida;Charophyta;Phragmoplastophyta;Streptophyta;Embryophyta;Bryophyta;Diphysciales;Theriotia;";"0.0";"0";"1";"1";"0";"1";"0";"457182";"391207"
"V4mis2";"SILVA (only NR);Eukaryota;Archaeplastida;Chloroplastida;Charophyta;Phragmoplastophyta;Streptophyta;Embryophyta;Bryophyta;Encalyptales;";"0.0";"0";"5";"5";"0";"5";"0";"457178";"391207"
"V4mis2";"SILVA (only NR);Eukaryota;Archaeplastida;Chloroplastida;Charophyta;Phragmoplastophyta;Streptophyta;Embryophyta;Bryophyta;Encalyptales;Bryobrittonia;";"0.0";"0";"1";"1";"0";"1";"0";"457182";"391207"
"V4mis2";"SILVA (only NR);Eukaryota;Archaeplastida;Chloroplastida;Charophyta;Phragmoplastophyta;Streptophyta;Embryophyta;Bryophyta;Encalyptales;Encalyptaceae;";"0.0";"0";"4";"4";"0";"4";"0";"457179";"391207"
"V4mis2";"SILVA (only NR);Eukaryota;Archaeplastida;Chloroplastida;Charophyta;Phragmoplastophyta;Streptophyta;Embryophyta;Bryophyta;Encalyptales;Encalyptaceae;Encalypta;";"0.0";"0";"4";"4";"0";"4";"0";"457179";"391207"
"V4mis2";"SILVA (only NR);Eukaryota;Archaeplastida;Chloroplastida;Charophyta;Phragmoplastophyta;Streptophyta;Embryophyta;Bryophyta;Eurhynchium;";"0.0";"0";"1";"1";"0";"1";"0";"457182";"391207"
"V4mis2";"SILVA (only NR);Eukaryota;Archaeplastida;Chloroplastida;Charophyta;Phragmoplastophyta;Streptophyta;Embryophyta;Bryophyta;Funariales;";"0.0";"0";"5";"5";"0";"5";"0";"457178";"391207"
"V4mis2";"SILVA (only NR);Eukaryota;Archaeplastida;Chloroplastida;Charophyta;Phragmoplastophyta;Streptophyta;Embryophyta;Bryophyta;Funariales;Aphanorrhegma;";"0.0";"0";"1";"1";"0";"1";"0";"457182";"391207"
"V4mis2";"SILVA (only NR);Eukaryota;Archaeplastida;Chloroplastida;Charophyta;Phragmoplastophyta;Streptophyta;Embryophyta;Bryophyta;Funariales;Chamaebryum;";"0.0";"0";"1";"1";"0";"1";"0";"457182";"391207"
"V4mis2";"SILVA (only NR);Eukaryota;Archaeplastida;Chloroplastida;Charophyta;Phragmoplastophyta;Streptophyta;Embryophyta;Bryophyta;Funariales;Physcomitrella;";"0.0";"0";"2";"2";"0";"2";"0";"457181";"391207"
"V4mis2";"SILVA (only NR);Eukaryota;Archaeplastida;Chloroplastida;Charophyta;Phragmoplastophyta;Streptophyta;Embryophyta;Bryophyta;Funariales;Physcomitrium;";"0.0";"0";"1";"1";"0";"1";"0";"457182";"391207"
"V4mis2";"SILVA (only NR);Eukaryota;Archaeplastida;Chloroplastida;Charophyta;Phragmoplastophyta;Streptophyta;Embryophyta;Bryophyta;Gigaspermum;";"0.0";"0";"1";"1";"0";"1";"0";"457182";"391207"
"V4mis2";"SILVA (only NR);Eukaryota;Archaeplastida;Chloroplastida;Charophyta;Phragmoplastophyta;Streptophyta;Embryophyta;Bryophyta;Grimmiales;";"0.0";"0";"5";"5";"0";"5";"0";"457178";"391207"
"V4mis2";"SILVA (only NR);Eukaryota;Archaeplastida;Chloroplastida;Charophyta;Phragmoplastophyta;Streptophyta;Embryophyta;Bryophyta;Grimmiales;Drummondia;";"0.0";"0";"1";"1";"0";"1";"0";"457182";"391207"
"V4mis2";"SILVA (only NR);Eukaryota;Archaeplastida;Chloroplastida;Charophyta;Phragmoplastophyta;Streptophyta;Embryophyta;Bryophyta;Grimmiales;Grimmia;";"0.0";"0";"1";"1";"0";"1";"0";"457182";"391207"
"V4mis2";"SILVA (only NR);Eukaryota;Archaeplastida;Chloroplastida;Charophyta;Phragmoplastophyta;Streptophyta;Embryophyta;Bryophyta;Grimmiales;Ptychomitrium;";"0.0";"0";"2";"2";"0";"2";"0";"457181";"391207"
"V4mis2";"SILVA (only NR);Eukaryota;Archaeplastida;Chloroplastida;Charophyta;Phragmoplastophyta;Streptophyta;Embryophyta;Bryophyta;Hedwigiales;";"0.0";"0";"2";"2";"0";"2";"0";"457181";"391207"
"V4mis2";"SILVA (only NR);Eukaryota;Archaeplastida;Chloroplastida;Charophyta;Phragmoplastophyta;Streptophyta;Embryophyta;Bryophyta;Hedwigiales;Hedwigia;";"0.0";"0";"1";"1";"0";"1";"0";"457182";"391207"
"V4mis2";"SILVA (only NR);Eukaryota;Archaeplastida;Chloroplastida;Charophyta;Phragmoplastophyta;Streptophyta;Embryophyta;Bryophyta;Hedwigiales;Rhacocarpus;";"0.0";"0";"1";"1";"0";"1";"0";"457182";"391207"
"V4mis2";"SILVA (only NR);Eukaryota;Archaeplastida;Chloroplastida;Charophyta;Phragmoplastophyta;Streptophyta;Embryophyta;Bryophyta;Hypnales;";"0.0";"0";"2";"2";"0";"2";"0";"457181";"391207"
"V4mis2";"SILVA (only NR);Eukaryota;Archaeplastida;Chloroplastida;Charophyta;Phragmoplastophyta;Streptophyta;Embryophyta;Bryophyta;Hypnales;Buckiella;";"0.0";"0";"1";"1";"0";"1";"0";"457182";"391207"
"V4mis2";"SILVA (only NR);Eukaryota;Archaeplastida;Chloroplastida;Charophyta;Phragmoplastophyta;Streptophyta;Embryophyta;Bryophyta;Hypnales;Fontinalis;";"0.0";"0";"1";"1";"0";"1";"0";"457182";"391207"
"V4mis2";"SILVA (only NR);Eukaryota;Archaeplastida;Chloroplastida;Charophyta;Phragmoplastophyta;Streptophyta;Embryophyta;Bryophyta;Hypnodendrales;";"0.0";"0";"3";"3";"0";"3";"0";"457180";"391207"
"V4mis2";"SILVA (only NR);Eukaryota;Archaeplastida;Chloroplastida;Charophyta;Phragmoplastophyta;Streptophyta;Embryophyta;Bryophyta;Hypnodendrales;Bescherellia;";"0.0";"0";"1";"1";"0";"1";"0";"457182";"391207"
"V4mis2";"SILVA (only NR);Eukaryota;Archaeplastida;Chloroplastida;Charophyta;Phragmoplastophyta;Streptophyta;Embryophyta;Bryophyta;Hypnodendrales;Mniodendron;";"0.0";"0";"1";"1";"0";"1";"0";"457182";"391207"
"V4mis2";"SILVA (only NR);Eukaryota;Archaeplastida;Chloroplastida;Charophyta;Phragmoplastophyta;Streptophyta;Embryophyta;Bryophyta;Hypnodendrales;Racopilum;";"0.0";"0";"1";"1";"0";"1";"0";"457182";"391207"
"V4mis2";"SILVA (only NR);Eukaryota;Archaeplastida;Chloroplastida;Charophyta;Phragmoplastophyta;Streptophyta;Embryophyta;Bryophyta;Orthotrichales;";"0.0";"0";"4";"4";"0";"4";"0";"457179";"391207"
"V4mis2";"SILVA (only NR);Eukaryota;Archaeplastida;Chloroplastida;Charophyta;Phragmoplastophyta;Streptophyta;Embryophyta;Bryophyta;Orthotrichales;Niphotrichum;";"0.0";"0";"1";"1";"0";"1";"0";"457182";"391207"
"V4mis2";"SILVA (only NR);Eukaryota;Archaeplastida;Chloroplastida;Charophyta;Phragmoplastophyta;Streptophyta;Embryophyta;Bryophyta;Orthotrichales;Orthotrichum;";"0.0";"0";"2";"2";"0";"2";"0";"457181";"391207"
"V4mis2";"SILVA (only NR);Eukaryota;Archaeplastida;Chloroplastida;Charophyta;Phragmoplastophyta;Streptophyta;Embryophyta;Bryophyta;Orthotrichales;Ulota;";"0.0";"0";"1";"1";"0";"1";"0";"457182";"391207"
"V4mis2";"SILVA (only NR);Eukaryota;Archaeplastida;Chloroplastida;Charophyta;Phragmoplastophyta;Streptophyta;Embryophyta;Bryophyta;Polytrichales;";"0.0";"0";"18";"18";"0";"18";"0";"457165";"391207"
"V4mis2";"SILVA (only NR);Eukaryota;Archaeplastida;Chloroplastida;Charophyta;Phragmoplastophyta;Streptophyta;Embryophyta;Bryophyta;Polytrichales;Atrichum;";"0.0";"0";"2";"2";"0";"2";"0";"457181";"391207"
"V4mis2";"SILVA (only NR);Eukaryota;Archaeplastida;Chloroplastida;Charophyta;Phragmoplastophyta;Streptophyta;Embryophyta;Bryophyta;Polytrichales;Dawsonia;";"0.0";"0";"1";"1";"0";"1";"0";"457182";"391207"
"V4mis2";"SILVA (only NR);Eukaryota;Archaeplastida;Chloroplastida;Charophyta;Phragmoplastophyta;Streptophyta;Embryophyta;Bryophyta;Polytrichales;Lyellia;";"0.0";"0";"1";"1";"0";"1";"0";"457182";"391207"
"V4mis2";"SILVA (only NR);Eukaryota;Archaeplastida;Chloroplastida;Charophyta;Phragmoplastophyta;Streptophyta;Embryophyta;Bryophyta;Polytrichales;Notoligotrichum;";"0.0";"0";"1";"1";"0";"1";"0";"457182";"391207"
"V4mis2";"SILVA (only NR);Eukaryota;Archaeplastida;Chloroplastida;Charophyta;Phragmoplastophyta;Streptophyta;Embryophyta;Bryophyta;Polytrichales;Pogonatum;";"0.0";"0";"7";"7";"0";"7";"0";"457176";"391207"
"V4mis2";"SILVA (only NR);Eukaryota;Archaeplastida;Chloroplastida;Charophyta;Phragmoplastophyta;Streptophyta;Embryophyta;Bryophyta;Polytrichales;Polytrichadelphus;";"0.0";"0";"1";"1";"0";"1";"0";"457182";"391207"
"V4mis2";"SILVA (only NR);Eukaryota;Archaeplastida;Chloroplastida;Charophyta;Phragmoplastophyta;Streptophyta;Embryophyta;Bryophyta;Polytrichales;Polytrichum;";"0.0";"0";"2";"2";"0";"2";"0";"457181";"391207"
"V4mis2";"SILVA (only NR);Eukaryota;Archaeplastida;Chloroplastida;Charophyta;Phragmoplastophyta;Streptophyta;Embryophyta;Bryophyta;Pottiales;";"0.0";"0";"4";"4";"0";"4";"0";"457179";"391207"
"V4mis2";"SILVA (only NR);Eukaryota;Archaeplastida;Chloroplastida;Charophyta;Phragmoplastophyta;Streptophyta;Embryophyta;Bryophyta;Pottiales;Pottia;";"0.0";"0";"3";"3";"0";"3";"0";"457180";"391207"
"V4mis2";"SILVA (only NR);Eukaryota;Archaeplastida;Chloroplastida;Charophyta;Phragmoplastophyta;Streptophyta;Embryophyta;Bryophyta;Pottiales;Syntrichia;";"0.0";"0";"1";"1";"0";"1";"0";"457182";"391207"
"V4mis2";"SILVA (only NR);Eukaryota;Archaeplastida;Chloroplastida;Charophyta;Phragmoplastophyta;Streptophyta;Embryophyta;Bryophyta;Sphagnales;";"0.0";"0";"2";"2";"0";"2";"0";"457181";"391207"
"V4mis2";"SILVA (only NR);Eukaryota;Archaeplastida;Chloroplastida;Charophyta;Phragmoplastophyta;Streptophyta;Embryophyta;Bryophyta;Sphagnales;Sphagnum;";"0.0";"0";"2";"2";"0";"2";"0";"457181";"391207"
"V4mis2";"SILVA (only NR);Eukaryota;Archaeplastida;Chloroplastida;Charophyta;Phragmoplastophyta;Streptophyta;Embryophyta;Bryophyta;Splachnales;";"0.0";"0";"1";"1";"0";"1";"0";"457182";"391207"
"V4mis2";"SILVA (only NR);Eukaryota;Archaeplastida;Chloroplastida;Charophyta;Phragmoplastophyta;Streptophyta;Embryophyta;Bryophyta;Splachnales;Splachnum;";"0.0";"0";"1";"1";"0";"1";"0";"457182";"391207"
"V4mis2";"SILVA (only NR);Eukaryota;Archaeplastida;Chloroplastida;Charophyta;Phragmoplastophyta;Streptophyta;Embryophyta;Bryophyta;Takakiales;";"0.0";"0";"1";"1";"0";"1";"0";"457182";"391207"
"V4mis2";"SILVA (only NR);Eukaryota;Archaeplastida;Chloroplastida;Charophyta;Phragmoplastophyta;Streptophyta;Embryophyta;Bryophyta;Takakiales;Takakia;";"0.0";"0";"1";"1";"0";"1";"0";"457182";"391207"
"V4mis2";"SILVA (only NR);Eukaryota;Archaeplastida;Chloroplastida;Charophyta;Phragmoplastophyta;Streptophyta;Embryophyta;Bryophyta;Tetraphidales;";"0.0";"0";"2";"2";"0";"2";"0";"457181";"391207"
"V4mis2";"SILVA (only NR);Eukaryota;Archaeplastida;Chloroplastida;Charophyta;Phragmoplastophyta;Streptophyta;Embryophyta;Bryophyta;Tetraphidales;Tetraphis;";"0.0";"0";"2";"2";"0";"2";"0";"457181";"391207"
"V4mis2";"SILVA (only NR);Eukaryota;Archaeplastida;Chloroplastida;Charophyta;Phragmoplastophyta;Streptophyta;Embryophyta;Bryophyta;Timmiales;";"0.0";"0";"1";"1";"0";"1";"0";"457182";"391207"
"V4mis2";"SILVA (only NR);Eukaryota;Archaeplastida;Chloroplastida;Charophyta;Phragmoplastophyta;Streptophyta;Embryophyta;Bryophyta;Timmiales;Timmia;";"0.0";"0";"1";"1";"0";"1";"0";"457182";"391207"
"V4mis2";"SILVA (only NR);Eukaryota;Archaeplastida;Chloroplastida;Charophyta;Phragmoplastophyta;Streptophyta;Embryophyta;Buxbaumiales;";"0.0";"0";"1";"1";"0";"1";"0";"457182";"391207"
"V4mis2";"SILVA (only NR);Eukaryota;Archaeplastida;Chloroplastida;Charophyta;Phragmoplastophyta;Streptophyta;Embryophyta;Buxbaumiales;Buxbaumia;";"0.0";"0";"1";"1";"0";"1";"0";"457182";"391207"
"V4mis2";"SILVA (only NR);Eukaryota;Archaeplastida;Chloroplastida;Charophyta;Phragmoplastophyta;Streptophyta;Embryophyta;Marchantiophyta;";"0.0";"0";"47";"47";"0";"47";"0";"457136";"391207"
"V4mis2";"SILVA (only NR);Eukaryota;Archaeplastida;Chloroplastida;Charophyta;Phragmoplastophyta;Streptophyta;Embryophyta;Marchantiophyta;Blasiales;";"0.0";"0";"2";"2";"0";"2";"0";"457181";"391207"
"V4mis2";"SILVA (only NR);Eukaryota;Archaeplastida;Chloroplastida;Charophyta;Phragmoplastophyta;Streptophyta;Embryophyta;Marchantiophyta;Blasiales;Blasia;";"0.0";"0";"2";"2";"0";"2";"0";"457181";"391207"
"V4mis2";"SILVA (only NR);Eukaryota;Archaeplastida;Chloroplastida;Charophyta;Phragmoplastophyta;Streptophyta;Embryophyta;Marchantiophyta;Calobryales;";"0.0";"0";"4";"4";"0";"4";"0";"457179";"391207"
"V4mis2";"SILVA (only NR);Eukaryota;Archaeplastida;Chloroplastida;Charophyta;Phragmoplastophyta;Streptophyta;Embryophyta;Marchantiophyta;Calobryales;Haplomitrium;";"0.0";"0";"4";"4";"0";"4";"0";"457179";"391207"
"V4mis2";"SILVA (only NR);Eukaryota;Archaeplastida;Chloroplastida;Charophyta;Phragmoplastophyta;Streptophyta;Embryophyta;Marchantiophyta;Fossombroniales;";"0.0";"0";"2";"2";"0";"2";"0";"457181";"391207"
"V4mis2";"SILVA (only NR);Eukaryota;Archaeplastida;Chloroplastida;Charophyta;Phragmoplastophyta;Streptophyta;Embryophyta;Marchantiophyta;Fossombroniales;Fossombronia;";"0.0";"0";"1";"1";"0";"1";"0";"457182";"391207"
"V4mis2";"SILVA (only NR);Eukaryota;Archaeplastida;Chloroplastida;Charophyta;Phragmoplastophyta;Streptophyta;Embryophyta;Marchantiophyta;Fossombroniales;Petalophyllum;";"0.0";"0";"1";"1";"0";"1";"0";"457182";"391207"
"V4mis2";"SILVA (only NR);Eukaryota;Archaeplastida;Chloroplastida;Charophyta;Phragmoplastophyta;Streptophyta;Embryophyta;Marchantiophyta;Jungermanniales;";"0.0";"0";"7";"7";"0";"7";"0";"457176";"391207"
"V4mis2";"SILVA (only NR);Eukaryota;Archaeplastida;Chloroplastida;Charophyta;Phragmoplastophyta;Streptophyta;Embryophyta;Marchantiophyta;Jungermanniales;Jungermannia;";"0.0";"0";"1";"1";"0";"1";"0";"457182";"391207"
"V4mis2";"SILVA (only NR);Eukaryota;Archaeplastida;Chloroplastida;Charophyta;Phragmoplastophyta;Streptophyta;Embryophyta;Marchantiophyta;Jungermanniales;Lepidozia;";"0.0";"0";"1";"1";"0";"1";"0";"457182";"391207"
"V4mis2";"SILVA (only NR);Eukaryota;Archaeplastida;Chloroplastida;Charophyta;Phragmoplastophyta;Streptophyta;Embryophyta;Marchantiophyta;Jungermanniales;Lophozia;";"0.0";"0";"1";"1";"0";"1";"0";"457182";"391207"
"V4mis2";"SILVA (only NR);Eukaryota;Archaeplastida;Chloroplastida;Charophyta;Phragmoplastophyta;Streptophyta;Embryophyta;Marchantiophyta;Jungermanniales;Marsupella;";"0.0";"0";"1";"1";"0";"1";"0";"457182";"391207"
"V4mis2";"SILVA (only NR);Eukaryota;Archaeplastida;Chloroplastida;Charophyta;Phragmoplastophyta;Streptophyta;Embryophyta;Marchantiophyta;Jungermanniales;Nowellia;";"0.0";"0";"1";"1";"0";"1";"0";"457182";"391207"
"V4mis2";"SILVA (only NR);Eukaryota;Archaeplastida;Chloroplastida;Charophyta;Phragmoplastophyta;Streptophyta;Embryophyta;Marchantiophyta;Jungermanniales;Odontoschisma;";"0.0";"0";"1";"1";"0";"1";"0";"457182";"391207"
"V4mis2";"SILVA (only NR);Eukaryota;Archaeplastida;Chloroplastida;Charophyta;Phragmoplastophyta;Streptophyta;Embryophyta;Marchantiophyta;Jungermanniales;Tylimanthus;";"0.0";"0";"1";"1";"0";"1";"0";"457182";"391207"
"V4mis2";"SILVA (only NR);Eukaryota;Archaeplastida;Chloroplastida;Charophyta;Phragmoplastophyta;Streptophyta;Embryophyta;Marchantiophyta;Lunulariales;";"0.0";"0";"1";"1";"0";"1";"0";"457182";"391207"
"V4mis2";"SILVA (only NR);Eukaryota;Archaeplastida;Chloroplastida;Charophyta;Phragmoplastophyta;Streptophyta;Embryophyta;Marchantiophyta;Lunulariales;Lunularia;";"0.0";"0";"1";"1";"0";"1";"0";"457182";"391207"
"V4mis2";"SILVA (only NR);Eukaryota;Archaeplastida;Chloroplastida;Charophyta;Phragmoplastophyta;Streptophyta;Embryophyta;Marchantiophyta;Marchantiales;";"0.0";"0";"12";"12";"0";"12";"0";"457171";"391207"
"V4mis2";"SILVA (only NR);Eukaryota;Archaeplastida;Chloroplastida;Charophyta;Phragmoplastophyta;Streptophyta;Embryophyta;Marchantiophyta;Marchantiales;Conocephalum;";"0.0";"0";"2";"2";"0";"2";"0";"457181";"391207"
"V4mis2";"SILVA (only NR);Eukaryota;Archaeplastida;Chloroplastida;Charophyta;Phragmoplastophyta;Streptophyta;Embryophyta;Marchantiophyta;Marchantiales;Dumortiera;";"0.0";"0";"1";"1";"0";"1";"0";"457182";"391207"
"V4mis2";"SILVA (only NR);Eukaryota;Archaeplastida;Chloroplastida;Charophyta;Phragmoplastophyta;Streptophyta;Embryophyta;Marchantiophyta;Marchantiales;Marchantia;";"0.0";"0";"1";"1";"0";"1";"0";"457182";"391207"
"V4mis2";"SILVA (only NR);Eukaryota;Archaeplastida;Chloroplastida;Charophyta;Phragmoplastophyta;Streptophyta;Embryophyta;Marchantiophyta;Marchantiales;Monoclea;";"0.0";"0";"2";"2";"0";"2";"0";"457181";"391207"
"V4mis2";"SILVA (only NR);Eukaryota;Archaeplastida;Chloroplastida;Charophyta;Phragmoplastophyta;Streptophyta;Embryophyta;Marchantiophyta;Marchantiales;Plagiochasma;";"0.0";"0";"1";"1";"0";"1";"0";"457182";"391207"
"V4mis2";"SILVA (only NR);Eukaryota;Archaeplastida;Chloroplastida;Charophyta;Phragmoplastophyta;Streptophyta;Embryophyta;Marchantiophyta;Marchantiales;Reboulia;";"0.0";"0";"2";"2";"0";"2";"0";"457181";"391207"
"V4mis2";"SILVA (only NR);Eukaryota;Archaeplastida;Chloroplastida;Charophyta;Phragmoplastophyta;Streptophyta;Embryophyta;Marchantiophyta;Marchantiales;Riccia;";"0.0";"0";"2";"2";"0";"2";"0";"457181";"391207"
"V4mis2";"SILVA (only NR);Eukaryota;Archaeplastida;Chloroplastida;Charophyta;Phragmoplastophyta;Streptophyta;Embryophyta;Marchantiophyta;Marchantiales;Targionia;";"0.0";"0";"1";"1";"0";"1";"0";"457182";"391207"
"V4mis2";"SILVA (only NR);Eukaryota;Archaeplastida;Chloroplastida;Charophyta;Phragmoplastophyta;Streptophyta;Embryophyta;Marchantiophyta;Metzgeriales;";"0.0";"0";"4";"4";"0";"4";"0";"457179";"391207"
"V4mis2";"SILVA (only NR);Eukaryota;Archaeplastida;Chloroplastida;Charophyta;Phragmoplastophyta;Streptophyta;Embryophyta;Marchantiophyta;Metzgeriales;Aneura;";"0.0";"0";"1";"1";"0";"1";"0";"457182";"391207"
"V4mis2";"SILVA (only NR);Eukaryota;Archaeplastida;Chloroplastida;Charophyta;Phragmoplastophyta;Streptophyta;Embryophyta;Marchantiophyta;Metzgeriales;Metzgeria;";"0.0";"0";"2";"2";"0";"2";"0";"457181";"391207"
"V4mis2";"SILVA (only NR);Eukaryota;Archaeplastida;Chloroplastida;Charophyta;Phragmoplastophyta;Streptophyta;Embryophyta;Marchantiophyta;Metzgeriales;Moerckia;";"0.0";"0";"1";"1";"0";"1";"0";"457182";"391207"
"V4mis2";"SILVA (only NR);Eukaryota;Archaeplastida;Chloroplastida;Charophyta;Phragmoplastophyta;Streptophyta;Embryophyta;Marchantiophyta;Neohodgsoniales;";"0.0";"0";"1";"1";"0";"1";"0";"457182";"391207"
"V4mis2";"SILVA (only NR);Eukaryota;Archaeplastida;Chloroplastida;Charophyta;Phragmoplastophyta;Streptophyta;Embryophyta;Marchantiophyta;Neohodgsoniales;Neohodgsonia;";"0.0";"0";"1";"1";"0";"1";"0";"457182";"391207"
"V4mis2";"SILVA (only NR);Eukaryota;Archaeplastida;Chloroplastida;Charophyta;Phragmoplastophyta;Streptophyta;Embryophyta;Marchantiophyta;Pallaviciniales;";"0.0";"0";"4";"4";"0";"4";"0";"457179";"391207"
"V4mis2";"SILVA (only NR);Eukaryota;Archaeplastida;Chloroplastida;Charophyta;Phragmoplastophyta;Streptophyta;Embryophyta;Marchantiophyta;Pallaviciniales;Hymenophyton;";"0.0";"0";"1";"1";"0";"1";"0";"457182";"391207"
"V4mis2";"SILVA (only NR);Eukaryota;Archaeplastida;Chloroplastida;Charophyta;Phragmoplastophyta;Streptophyta;Embryophyta;Marchantiophyta;Pallaviciniales;Pallavicinia;";"0.0";"0";"1";"1";"0";"1";"0";"457182";"391207"
"V4mis2";"SILVA (only NR);Eukaryota;Archaeplastida;Chloroplastida;Charophyta;Phragmoplastophyta;Streptophyta;Embryophyta;Marchantiophyta;Pallaviciniales;Symphyogyna;";"0.0";"0";"2";"2";"0";"2";"0";"457181";"391207"
"V4mis2";"SILVA (only NR);Eukaryota;Archaeplastida;Chloroplastida;Charophyta;Phragmoplastophyta;Streptophyta;Embryophyta;Marchantiophyta;Porellales;";"0.0";"0";"5";"5";"0";"5";"0";"457178";"391207"
"V4mis2";"SILVA (only NR);Eukaryota;Archaeplastida;Chloroplastida;Charophyta;Phragmoplastophyta;Streptophyta;Embryophyta;Marchantiophyta;Porellales;Cheilolejeunea;";"0.0";"0";"1";"1";"0";"1";"0";"457182";"391207"
"V4mis2";"SILVA (only NR);Eukaryota;Archaeplastida;Chloroplastida;Charophyta;Phragmoplastophyta;Streptophyta;Embryophyta;Marchantiophyta;Porellales;Frullania;";"0.0";"0";"1";"1";"0";"1";"0";"457182";"391207"
"V4mis2";"SILVA (only NR);Eukaryota;Archaeplastida;Chloroplastida;Charophyta;Phragmoplastophyta;Streptophyta;Embryophyta;Marchantiophyta;Porellales;Lejeunea;";"0.0";"0";"1";"1";"0";"1";"0";"457182";"391207"
"V4mis2";"SILVA (only NR);Eukaryota;Archaeplastida;Chloroplastida;Charophyta;Phragmoplastophyta;Streptophyta;Embryophyta;Marchantiophyta;Porellales;Porella;";"0.0";"0";"2";"2";"0";"2";"0";"457181";"391207"
"V4mis2";"SILVA (only NR);Eukaryota;Archaeplastida;Chloroplastida;Charophyta;Phragmoplastophyta;Streptophyta;Embryophyta;Marchantiophyta;Sphaerocarpales;";"0.0";"0";"3";"3";"0";"3";"0";"457180";"391207"
"V4mis2";"SILVA (only NR);Eukaryota;Archaeplastida;Chloroplastida;Charophyta;Phragmoplastophyta;Streptophyta;Embryophyta;Marchantiophyta;Sphaerocarpales;Riella;";"0.0";"0";"1";"1";"0";"1";"0";"457182";"391207"
"V4mis2";"SILVA (only NR);Eukaryota;Archaeplastida;Chloroplastida;Charophyta;Phragmoplastophyta;Streptophyta;Embryophyta;Marchantiophyta;Sphaerocarpales;Sphaerocarpos;";"0.0";"0";"2";"2";"0";"2";"0";"457181";"391207"
"V4mis2";"SILVA (only NR);Eukaryota;Archaeplastida;Chloroplastida;Charophyta;Phragmoplastophyta;Streptophyta;Embryophyta;Marchantiophyta;Treubiales;";"0.0";"0";"1";"1";"0";"1";"0";"457182";"391207"
"V4mis2";"SILVA (only NR);Eukaryota;Archaeplastida;Chloroplastida;Charophyta;Phragmoplastophyta;Streptophyta;Embryophyta;Marchantiophyta;Treubiales;Treubia;";"0.0";"0";"1";"1";"0";"1";"0";"457182";"391207"
"V4mis2";"SILVA (only NR);Eukaryota;Archaeplastida;Chloroplastida;Charophyta;Phragmoplastophyta;Streptophyta;Embryophyta;Tracheophyta;";"0.9";"13.6";"4341";"4320";"40";"4280";"21";"452863";"391167"
"V4mis2";"SILVA (only NR);Eukaryota;Archaeplastida;Chloroplastida;Charophyta;Phragmoplastophyta;Streptophyta;Embryophyta;Tracheophyta;Lycopodiophyta;";"0.0";"0";"21";"20";"0";"20";"1";"457163";"391207"
"V4mis2";"SILVA (only NR);Eukaryota;Archaeplastida;Chloroplastida;Charophyta;Phragmoplastophyta;Streptophyta;Embryophyta;Tracheophyta;Lycopodiophyta;Isoetales;";"0.0";"0";"2";"2";"0";"2";"0";"457181";"391207"
"V4mis2";"SILVA (only NR);Eukaryota;Archaeplastida;Chloroplastida;Charophyta;Phragmoplastophyta;Streptophyta;Embryophyta;Tracheophyta;Lycopodiophyta;Isoetales;Isoetaceae;";"0.0";"0";"2";"2";"0";"2";"0";"457181";"391207"
"V4mis2";"SILVA (only NR);Eukaryota;Archaeplastida;Chloroplastida;Charophyta;Phragmoplastophyta;Streptophyta;Embryophyta;Tracheophyta;Lycopodiophyta;Isoetales;Isoetaceae;Isoetes;";"0.0";"0";"2";"2";"0";"2";"0";"457181";"391207"
"V4mis2";"SILVA (only NR);Eukaryota;Archaeplastida;Chloroplastida;Charophyta;Phragmoplastophyta;Streptophyta;Embryophyta;Tracheophyta;Lycopodiophyta;Lycopodiales;";"0.0";"0";"4";"4";"0";"4";"0";"457179";"391207"
"V4mis2";"SILVA (only NR);Eukaryota;Archaeplastida;Chloroplastida;Charophyta;Phragmoplastophyta;Streptophyta;Embryophyta;Tracheophyta;Lycopodiophyta;Lycopodiales;Diphasiastrum;";"0.0";"0";"1";"1";"0";"1";"0";"457182";"391207"
"V4mis2";"SILVA (only NR);Eukaryota;Archaeplastida;Chloroplastida;Charophyta;Phragmoplastophyta;Streptophyta;Embryophyta;Tracheophyta;Lycopodiophyta;Lycopodiales;Lycopodiella;";"0.0";"0";"1";"1";"0";"1";"0";"457182";"391207"
"V4mis2";"SILVA (only NR);Eukaryota;Archaeplastida;Chloroplastida;Charophyta;Phragmoplastophyta;Streptophyta;Embryophyta;Tracheophyta;Lycopodiophyta;Lycopodiales;Lycopodium;";"0.0";"0";"1";"1";"0";"1";"0";"457182";"391207"
"V4mis2";"SILVA (only NR);Eukaryota;Archaeplastida;Chloroplastida;Charophyta;Phragmoplastophyta;Streptophyta;Embryophyta;Tracheophyta;Lycopodiophyta;Lycopodiales;Phlegmariurus;";"0.0";"0";"1";"1";"0";"1";"0";"457182";"391207"
"V4mis2";"SILVA (only NR);Eukaryota;Archaeplastida;Chloroplastida;Charophyta;Phragmoplastophyta;Streptophyta;Embryophyta;Tracheophyta;Lycopodiophyta;Selaginellales;";"0.0";"0";"15";"14";"0";"14";"1";"457169";"391207"
"V4mis2";"SILVA (only NR);Eukaryota;Archaeplastida;Chloroplastida;Charophyta;Phragmoplastophyta;Streptophyta;Embryophyta;Tracheophyta;Lycopodiophyta;Selaginellales;Selaginella;";"0.0";"0";"15";"14";"0";"14";"1";"457169";"391207"
"V4mis2";"SILVA (only NR);Eukaryota;Archaeplastida;Chloroplastida;Charophyta;Phragmoplastophyta;Streptophyta;Embryophyta;Tracheophyta;Monilophyta;";"0.0";"0";"43";"43";"0";"43";"0";"457140";"391207"
"V4mis2";"SILVA (only NR);Eukaryota;Archaeplastida;Chloroplastida;Charophyta;Phragmoplastophyta;Streptophyta;Embryophyta;Tracheophyta;Monilophyta;Anemia;";"0.0";"0";"1";"1";"0";"1";"0";"457182";"391207"
"V4mis2";"SILVA (only NR);Eukaryota;Archaeplastida;Chloroplastida;Charophyta;Phragmoplastophyta;Streptophyta;Embryophyta;Tracheophyta;Monilophyta;Cyatheales;";"0.0";"0";"2";"2";"0";"2";"0";"457181";"391207"
"V4mis2";"SILVA (only NR);Eukaryota;Archaeplastida;Chloroplastida;Charophyta;Phragmoplastophyta;Streptophyta;Embryophyta;Tracheophyta;Monilophyta;Cyatheales;Cyathea;";"0.0";"0";"1";"1";"0";"1";"0";"457182";"391207"
"V4mis2";"SILVA (only NR);Eukaryota;Archaeplastida;Chloroplastida;Charophyta;Phragmoplastophyta;Streptophyta;Embryophyta;Tracheophyta;Monilophyta;Cyatheales;Metaxya;";"0.0";"0";"1";"1";"0";"1";"0";"457182";"391207"
"V4mis2";"SILVA (only NR);Eukaryota;Archaeplastida;Chloroplastida;Charophyta;Phragmoplastophyta;Streptophyta;Embryophyta;Tracheophyta;Monilophyta;Equisetales;";"0.0";"0";"2";"2";"0";"2";"0";"457181";"391207"
"V4mis2";"SILVA (only NR);Eukaryota;Archaeplastida;Chloroplastida;Charophyta;Phragmoplastophyta;Streptophyta;Embryophyta;Tracheophyta;Monilophyta;Equisetales;Equisetaceae;";"0.0";"0";"2";"2";"0";"2";"0";"457181";"391207"
"V4mis2";"SILVA (only NR);Eukaryota;Archaeplastida;Chloroplastida;Charophyta;Phragmoplastophyta;Streptophyta;Embryophyta;Tracheophyta;Monilophyta;Equisetales;Equisetaceae;Equisetum;";"0.0";"0";"2";"2";"0";"2";"0";"457181";"391207"
"V4mis2";"SILVA (only NR);Eukaryota;Archaeplastida;Chloroplastida;Charophyta;Phragmoplastophyta;Streptophyta;Embryophyta;Tracheophyta;Monilophyta;Gleicheniales;";"0.0";"0";"4";"4";"0";"4";"0";"457179";"391207"
"V4mis2";"SILVA (only NR);Eukaryota;Archaeplastida;Chloroplastida;Charophyta;Phragmoplastophyta;Streptophyta;Embryophyta;Tracheophyta;Monilophyta;Gleicheniales;Cheiropleuria;";"0.0";"0";"1";"1";"0";"1";"0";"457182";"391207"
"V4mis2";"SILVA (only NR);Eukaryota;Archaeplastida;Chloroplastida;Charophyta;Phragmoplastophyta;Streptophyta;Embryophyta;Tracheophyta;Monilophyta;Gleicheniales;Dicranopteris;";"0.0";"0";"1";"1";"0";"1";"0";"457182";"391207"
"V4mis2";"SILVA (only NR);Eukaryota;Archaeplastida;Chloroplastida;Charophyta;Phragmoplastophyta;Streptophyta;Embryophyta;Tracheophyta;Monilophyta;Gleicheniales;Gleichenia;";"0.0";"0";"1";"1";"0";"1";"0";"457182";"391207"
"V4mis2";"SILVA (only NR);Eukaryota;Archaeplastida;Chloroplastida;Charophyta;Phragmoplastophyta;Streptophyta;Embryophyta;Tracheophyta;Monilophyta;Gleicheniales;Phanerosorus;";"0.0";"0";"1";"1";"0";"1";"0";"457182";"391207"
"V4mis2";"SILVA (only NR);Eukaryota;Archaeplastida;Chloroplastida;Charophyta;Phragmoplastophyta;Streptophyta;Embryophyta;Tracheophyta;Monilophyta;Hymenophyllales;";"0.0";"0";"2";"2";"0";"2";"0";"457181";"391207"
"V4mis2";"SILVA (only NR);Eukaryota;Archaeplastida;Chloroplastida;Charophyta;Phragmoplastophyta;Streptophyta;Embryophyta;Tracheophyta;Monilophyta;Hymenophyllales;Hymenophyllum;";"0.0";"0";"1";"1";"0";"1";"0";"457182";"391207"
"V4mis2";"SILVA (only NR);Eukaryota;Archaeplastida;Chloroplastida;Charophyta;Phragmoplastophyta;Streptophyta;Embryophyta;Tracheophyta;Monilophyta;Hymenophyllales;Vandenboschia;";"0.0";"0";"1";"1";"0";"1";"0";"457182";"391207"
"V4mis2";"SILVA (only NR);Eukaryota;Archaeplastida;Chloroplastida;Charophyta;Phragmoplastophyta;Streptophyta;Embryophyta;Tracheophyta;Monilophyta;Marattiales;";"0.0";"0";"4";"4";"0";"4";"0";"457179";"391207"
"V4mis2";"SILVA (only NR);Eukaryota;Archaeplastida;Chloroplastida;Charophyta;Phragmoplastophyta;Streptophyta;Embryophyta;Tracheophyta;Monilophyta;Marattiales;Angiopteris;";"0.0";"0";"1";"1";"0";"1";"0";"457182";"391207"
"V4mis2";"SILVA (only NR);Eukaryota;Archaeplastida;Chloroplastida;Charophyta;Phragmoplastophyta;Streptophyta;Embryophyta;Tracheophyta;Monilophyta;Marattiales;Danaea;";"0.0";"0";"2";"2";"0";"2";"0";"457181";"391207"
"V4mis2";"SILVA (only NR);Eukaryota;Archaeplastida;Chloroplastida;Charophyta;Phragmoplastophyta;Streptophyta;Embryophyta;Tracheophyta;Monilophyta;Marattiales;Ptisana;";"0.0";"0";"1";"1";"0";"1";"0";"457182";"391207"
"V4mis2";"SILVA (only NR);Eukaryota;Archaeplastida;Chloroplastida;Charophyta;Phragmoplastophyta;Streptophyta;Embryophyta;Tracheophyta;Monilophyta;Ophioglossales;";"0.0";"0";"4";"4";"0";"4";"0";"457179";"391207"
"V4mis2";"SILVA (only NR);Eukaryota;Archaeplastida;Chloroplastida;Charophyta;Phragmoplastophyta;Streptophyta;Embryophyta;Tracheophyta;Monilophyta;Ophioglossales;Botrypus;";"0.0";"0";"1";"1";"0";"1";"0";"457182";"391207"
"V4mis2";"SILVA (only NR);Eukaryota;Archaeplastida;Chloroplastida;Charophyta;Phragmoplastophyta;Streptophyta;Embryophyta;Tracheophyta;Monilophyta;Ophioglossales;Helminthostachys;";"0.0";"0";"1";"1";"0";"1";"0";"457182";"391207"
"V4mis2";"SILVA (only NR);Eukaryota;Archaeplastida;Chloroplastida;Charophyta;Phragmoplastophyta;Streptophyta;Embryophyta;Tracheophyta;Monilophyta;Ophioglossales;Ophioglossum;";"0.0";"0";"1";"1";"0";"1";"0";"457182";"391207"
"V4mis2";"SILVA (only NR);Eukaryota;Archaeplastida;Chloroplastida;Charophyta;Phragmoplastophyta;Streptophyta;Embryophyta;Tracheophyta;Monilophyta;Osmundales;";"0.0";"0";"2";"2";"0";"2";"0";"457181";"391207"
"V4mis2";"SILVA (only NR);Eukaryota;Archaeplastida;Chloroplastida;Charophyta;Phragmoplastophyta;Streptophyta;Embryophyta;Tracheophyta;Monilophyta;Osmundales;Osmundastrum;";"0.0";"0";"2";"2";"0";"2";"0";"457181";"391207"
"V4mis2";"SILVA (only NR);Eukaryota;Archaeplastida;Chloroplastida;Charophyta;Phragmoplastophyta;Streptophyta;Embryophyta;Tracheophyta;Monilophyta;Polypodiales;";"0.0";"0";"9";"9";"0";"9";"0";"457174";"391207"
"V4mis2";"SILVA (only NR);Eukaryota;Archaeplastida;Chloroplastida;Charophyta;Phragmoplastophyta;Streptophyta;Embryophyta;Tracheophyta;Monilophyta;Polypodiales;Adiantum;";"0.0";"0";"1";"1";"0";"1";"0";"457182";"391207"
"V4mis2";"SILVA (only NR);Eukaryota;Archaeplastida;Chloroplastida;Charophyta;Phragmoplastophyta;Streptophyta;Embryophyta;Tracheophyta;Monilophyta;Polypodiales;Asplenium;";"0.0";"0";"1";"1";"0";"1";"0";"457182";"391207"
"V4mis2";"SILVA (only NR);Eukaryota;Archaeplastida;Chloroplastida;Charophyta;Phragmoplastophyta;Streptophyta;Embryophyta;Tracheophyta;Monilophyta;Polypodiales;Dryopteris;";"0.0";"0";"1";"1";"0";"1";"0";"457182";"391207"
"V4mis2";"SILVA (only NR);Eukaryota;Archaeplastida;Chloroplastida;Charophyta;Phragmoplastophyta;Streptophyta;Embryophyta;Tracheophyta;Monilophyta;Polypodiales;Lindsaea;";"0.0";"0";"1";"1";"0";"1";"0";"457182";"391207"
"V4mis2";"SILVA (only NR);Eukaryota;Archaeplastida;Chloroplastida;Charophyta;Phragmoplastophyta;Streptophyta;Embryophyta;Tracheophyta;Monilophyta;Polypodiales;Lonchitis;";"0.0";"0";"1";"1";"0";"1";"0";"457182";"391207"
"V4mis2";"SILVA (only NR);Eukaryota;Archaeplastida;Chloroplastida;Charophyta;Phragmoplastophyta;Streptophyta;Embryophyta;Tracheophyta;Monilophyta;Polypodiales;Odontosoria;";"0.0";"0";"1";"1";"0";"1";"0";"457182";"391207"
"V4mis2";"SILVA (only NR);Eukaryota;Archaeplastida;Chloroplastida;Charophyta;Phragmoplastophyta;Streptophyta;Embryophyta;Tracheophyta;Monilophyta;Polypodiales;Polypodium;";"0.0";"0";"1";"1";"0";"1";"0";"457182";"391207"
"V4mis2";"SILVA (only NR);Eukaryota;Archaeplastida;Chloroplastida;Charophyta;Phragmoplastophyta;Streptophyta;Embryophyta;Tracheophyta;Monilophyta;Polypodiales;Pteridium;";"0.0";"0";"1";"1";"0";"1";"0";"457182";"391207"
"V4mis2";"SILVA (only NR);Eukaryota;Archaeplastida;Chloroplastida;Charophyta;Phragmoplastophyta;Streptophyta;Embryophyta;Tracheophyta;Monilophyta;Polypodiales;Vittaria;";"0.0";"0";"1";"1";"0";"1";"0";"457182";"391207"
"V4mis2";"SILVA (only NR);Eukaryota;Archaeplastida;Chloroplastida;Charophyta;Phragmoplastophyta;Streptophyta;Embryophyta;Tracheophyta;Monilophyta;Psilotales;";"0.0";"0";"4";"4";"0";"4";"0";"457179";"391207"
"V4mis2";"SILVA (only NR);Eukaryota;Archaeplastida;Chloroplastida;Charophyta;Phragmoplastophyta;Streptophyta;Embryophyta;Tracheophyta;Monilophyta;Psilotales;Psilotum;";"0.0";"0";"3";"3";"0";"3";"0";"457180";"391207"
"V4mis2";"SILVA (only NR);Eukaryota;Archaeplastida;Chloroplastida;Charophyta;Phragmoplastophyta;Streptophyta;Embryophyta;Tracheophyta;Monilophyta;Psilotales;Tmesipteris;";"0.0";"0";"1";"1";"0";"1";"0";"457182";"391207"
"V4mis2";"SILVA (only NR);Eukaryota;Archaeplastida;Chloroplastida;Charophyta;Phragmoplastophyta;Streptophyta;Embryophyta;Tracheophyta;Monilophyta;Salviniales;";"0.0";"0";"5";"5";"0";"5";"0";"457178";"391207"
"V4mis2";"SILVA (only NR);Eukaryota;Archaeplastida;Chloroplastida;Charophyta;Phragmoplastophyta;Streptophyta;Embryophyta;Tracheophyta;Monilophyta;Salviniales;Azolla;";"0.0";"0";"1";"1";"0";"1";"0";"457182";"391207"
"V4mis2";"SILVA (only NR);Eukaryota;Archaeplastida;Chloroplastida;Charophyta;Phragmoplastophyta;Streptophyta;Embryophyta;Tracheophyta;Monilophyta;Salviniales;Marsilea;";"0.0";"0";"2";"2";"0";"2";"0";"457181";"391207"
"V4mis2";"SILVA (only NR);Eukaryota;Archaeplastida;Chloroplastida;Charophyta;Phragmoplastophyta;Streptophyta;Embryophyta;Tracheophyta;Monilophyta;Salviniales;Pilularia;";"0.0";"0";"1";"1";"0";"1";"0";"457182";"391207"
"V4mis2";"SILVA (only NR);Eukaryota;Archaeplastida;Chloroplastida;Charophyta;Phragmoplastophyta;Streptophyta;Embryophyta;Tracheophyta;Monilophyta;Salviniales;Salvinia;";"0.0";"0";"1";"1";"0";"1";"0";"457182";"391207"
"V4mis2";"SILVA (only NR);Eukaryota;Archaeplastida;Chloroplastida;Charophyta;Phragmoplastophyta;Streptophyta;Embryophyta;Tracheophyta;Monilophyta;Schizaeales;";"0.0";"0";"2";"2";"0";"2";"0";"457181";"391207"
"V4mis2";"SILVA (only NR);Eukaryota;Archaeplastida;Chloroplastida;Charophyta;Phragmoplastophyta;Streptophyta;Embryophyta;Tracheophyta;Monilophyta;Schizaeales;Lygodium;";"0.0";"0";"1";"1";"0";"1";"0";"457182";"391207"
"V4mis2";"SILVA (only NR);Eukaryota;Archaeplastida;Chloroplastida;Charophyta;Phragmoplastophyta;Streptophyta;Embryophyta;Tracheophyta;Monilophyta;Schizaeales;Schizaea;";"0.0";"0";"1";"1";"0";"1";"0";"457182";"391207"
"V4mis2";"SILVA (only NR);Eukaryota;Archaeplastida;Chloroplastida;Charophyta;Phragmoplastophyta;Streptophyta;Embryophyta;Tracheophyta;Spermatophyta;";"0.9";"13.6";"4277";"4257";"40";"4217";"20";"452926";"391167"
"V4mis2";"SILVA (only NR);Eukaryota;Archaeplastida;Chloroplastida;Charophyta;Phragmoplastophyta;Streptophyta;Embryophyta;Tracheophyta;Spermatophyta;Cycadophyta;";"0.0";"0";"9";"9";"0";"9";"0";"457174";"391207"
"V4mis2";"SILVA (only NR);Eukaryota;Archaeplastida;Chloroplastida;Charophyta;Phragmoplastophyta;Streptophyta;Embryophyta;Tracheophyta;Spermatophyta;Cycadophyta;Cycadales;";"0.0";"0";"9";"9";"0";"9";"0";"457174";"391207"
"V4mis2";"SILVA (only NR);Eukaryota;Archaeplastida;Chloroplastida;Charophyta;Phragmoplastophyta;Streptophyta;Embryophyta;Tracheophyta;Spermatophyta;Cycadophyta;Cycadales;Bowenia;";"0.0";"0";"1";"1";"0";"1";"0";"457182";"391207"
"V4mis2";"SILVA (only NR);Eukaryota;Archaeplastida;Chloroplastida;Charophyta;Phragmoplastophyta;Streptophyta;Embryophyta;Tracheophyta;Spermatophyta;Cycadophyta;Cycadales;Ceratozamia;";"0.0";"0";"1";"1";"0";"1";"0";"457182";"391207"
"V4mis2";"SILVA (only NR);Eukaryota;Archaeplastida;Chloroplastida;Charophyta;Phragmoplastophyta;Streptophyta;Embryophyta;Tracheophyta;Spermatophyta;Cycadophyta;Cycadales;Cycas;";"0.0";"0";"1";"1";"0";"1";"0";"457182";"391207"
"V4mis2";"SILVA (only NR);Eukaryota;Archaeplastida;Chloroplastida;Charophyta;Phragmoplastophyta;Streptophyta;Embryophyta;Tracheophyta;Spermatophyta;Cycadophyta;Cycadales;Dioon;";"0.0";"0";"1";"1";"0";"1";"0";"457182";"391207"
"V4mis2";"SILVA (only NR);Eukaryota;Archaeplastida;Chloroplastida;Charophyta;Phragmoplastophyta;Streptophyta;Embryophyta;Tracheophyta;Spermatophyta;Cycadophyta;Cycadales;Encephalartos;";"0.0";"0";"1";"1";"0";"1";"0";"457182";"391207"
"V4mis2";"SILVA (only NR);Eukaryota;Archaeplastida;Chloroplastida;Charophyta;Phragmoplastophyta;Streptophyta;Embryophyta;Tracheophyta;Spermatophyta;Cycadophyta;Cycadales;Lepidozamia;";"0.0";"0";"1";"1";"0";"1";"0";"457182";"391207"
"V4mis2";"SILVA (only NR);Eukaryota;Archaeplastida;Chloroplastida;Charophyta;Phragmoplastophyta;Streptophyta;Embryophyta;Tracheophyta;Spermatophyta;Cycadophyta;Cycadales;Macrozamia;";"0.0";"0";"1";"1";"0";"1";"0";"457182";"391207"
"V4mis2";"SILVA (only NR);Eukaryota;Archaeplastida;Chloroplastida;Charophyta;Phragmoplastophyta;Streptophyta;Embryophyta;Tracheophyta;Spermatophyta;Cycadophyta;Cycadales;Stangeria;";"0.0";"0";"1";"1";"0";"1";"0";"457182";"391207"
"V4mis2";"SILVA (only NR);Eukaryota;Archaeplastida;Chloroplastida;Charophyta;Phragmoplastophyta;Streptophyta;Embryophyta;Tracheophyta;Spermatophyta;Cycadophyta;Cycadales;Zamia;";"0.0";"0";"1";"1";"0";"1";"0";"457182";"391207"
"V4mis2";"SILVA (only NR);Eukaryota;Archaeplastida;Chloroplastida;Charophyta;Phragmoplastophyta;Streptophyta;Embryophyta;Tracheophyta;Spermatophyta;Ginkgoidae;";"0.0";"0";"1";"1";"0";"1";"0";"457182";"391207"
"V4mis2";"SILVA (only NR);Eukaryota;Archaeplastida;Chloroplastida;Charophyta;Phragmoplastophyta;Streptophyta;Embryophyta;Tracheophyta;Spermatophyta;Ginkgoidae;Ginkgoales;";"0.0";"0";"1";"1";"0";"1";"0";"457182";"391207"
"V4mis2";"SILVA (only NR);Eukaryota;Archaeplastida;Chloroplastida;Charophyta;Phragmoplastophyta;Streptophyta;Embryophyta;Tracheophyta;Spermatophyta;Ginkgoidae;Ginkgoales;Ginkgo;";"0.0";"0";"1";"1";"0";"1";"0";"457182";"391207"
"V4mis2";"SILVA (only NR);Eukaryota;Archaeplastida;Chloroplastida;Charophyta;Phragmoplastophyta;Streptophyta;Embryophyta;Tracheophyta;Spermatophyta;Gnetophyta;";"0.0";"0";"8";"8";"0";"8";"0";"457175";"391207"
"V4mis2";"SILVA (only NR);Eukaryota;Archaeplastida;Chloroplastida;Charophyta;Phragmoplastophyta;Streptophyta;Embryophyta;Tracheophyta;Spermatophyta;Gnetophyta;Ephedra;";"0.0";"0";"1";"1";"0";"1";"0";"457182";"391207"
"V4mis2";"SILVA (only NR);Eukaryota;Archaeplastida;Chloroplastida;Charophyta;Phragmoplastophyta;Streptophyta;Embryophyta;Tracheophyta;Spermatophyta;Gnetophyta;Gnetales;";"0.0";"0";"6";"6";"0";"6";"0";"457177";"391207"
"V4mis2";"SILVA (only NR);Eukaryota;Archaeplastida;Chloroplastida;Charophyta;Phragmoplastophyta;Streptophyta;Embryophyta;Tracheophyta;Spermatophyta;Gnetophyta;Gnetales;Gnetaceae;";"0.0";"0";"6";"6";"0";"6";"0";"457177";"391207"
"V4mis2";"SILVA (only NR);Eukaryota;Archaeplastida;Chloroplastida;Charophyta;Phragmoplastophyta;Streptophyta;Embryophyta;Tracheophyta;Spermatophyta;Gnetophyta;Gnetales;Gnetaceae;Gnetum;";"0.0";"0";"6";"6";"0";"6";"0";"457177";"391207"
"V4mis2";"SILVA (only NR);Eukaryota;Archaeplastida;Chloroplastida;Charophyta;Phragmoplastophyta;Streptophyta;Embryophyta;Tracheophyta;Spermatophyta;Gnetophyta;Welwitschiales;";"0.0";"0";"1";"1";"0";"1";"0";"457182";"391207"
"V4mis2";"SILVA (only NR);Eukaryota;Archaeplastida;Chloroplastida;Charophyta;Phragmoplastophyta;Streptophyta;Embryophyta;Tracheophyta;Spermatophyta;Gnetophyta;Welwitschiales;Welwitschia;";"0.0";"0";"1";"1";"0";"1";"0";"457182";"391207"
"V4mis2";"SILVA (only NR);Eukaryota;Archaeplastida;Chloroplastida;Charophyta;Phragmoplastophyta;Streptophyta;Embryophyta;Tracheophyta;Spermatophyta;Magnoliophyta;";"1.1";"13.8";"3572";"3559";"38";"3521";"13";"453624";"391169"
"V4mis2";"SILVA (only NR);Eukaryota;Archaeplastida;Chloroplastida;Charophyta;Phragmoplastophyta;Streptophyta;Embryophyta;Tracheophyta;Spermatophyta;Magnoliophyta;Amborellales;";"0.0";"0";"10";"10";"0";"10";"0";"457173";"391207"
"V4mis2";"SILVA (only NR);Eukaryota;Archaeplastida;Chloroplastida;Charophyta;Phragmoplastophyta;Streptophyta;Embryophyta;Tracheophyta;Spermatophyta;Magnoliophyta;Amborellales;Amborella;";"0.0";"0";"10";"10";"0";"10";"0";"457173";"391207"
"V4mis2";"SILVA (only NR);Eukaryota;Archaeplastida;Chloroplastida;Charophyta;Phragmoplastophyta;Streptophyta;Embryophyta;Tracheophyta;Spermatophyta;Magnoliophyta;Apiales;";"0.0";"0";"13";"13";"0";"13";"0";"457170";"391207"
"V4mis2";"SILVA (only NR);Eukaryota;Archaeplastida;Chloroplastida;Charophyta;Phragmoplastophyta;Streptophyta;Embryophyta;Tracheophyta;Spermatophyta;Magnoliophyta;Apiales;Azorella;";"0.0";"0";"1";"1";"0";"1";"0";"457182";"391207"
"V4mis2";"SILVA (only NR);Eukaryota;Archaeplastida;Chloroplastida;Charophyta;Phragmoplastophyta;Streptophyta;Embryophyta;Tracheophyta;Spermatophyta;Magnoliophyta;Apiales;Billardiera;";"0.0";"0";"1";"1";"0";"1";"0";"457182";"391207"
"V4mis2";"SILVA (only NR);Eukaryota;Archaeplastida;Chloroplastida;Charophyta;Phragmoplastophyta;Streptophyta;Embryophyta;Tracheophyta;Spermatophyta;Magnoliophyta;Apiales;Bupleurum;";"0.0";"0";"1";"1";"0";"1";"0";"457182";"391207"
"V4mis2";"SILVA (only NR);Eukaryota;Archaeplastida;Chloroplastida;Charophyta;Phragmoplastophyta;Streptophyta;Embryophyta;Tracheophyta;Spermatophyta;Magnoliophyta;Apiales;Cnidium;";"0.0";"0";"1";"1";"0";"1";"0";"457182";"391207"
"V4mis2";"SILVA (only NR);Eukaryota;Archaeplastida;Chloroplastida;Charophyta;Phragmoplastophyta;Streptophyta;Embryophyta;Tracheophyta;Spermatophyta;Magnoliophyta;Apiales;Daucus;";"0.0";"0";"1";"1";"0";"1";"0";"457182";"391207"
"V4mis2";"SILVA (only NR);Eukaryota;Archaeplastida;Chloroplastida;Charophyta;Phragmoplastophyta;Streptophyta;Embryophyta;Tracheophyta;Spermatophyta;Magnoliophyta;Apiales;Heracleum;";"0.0";"0";"1";"1";"0";"1";"0";"457182";"391207"
"V4mis2";"SILVA (only NR);Eukaryota;Archaeplastida;Chloroplastida;Charophyta;Phragmoplastophyta;Streptophyta;Embryophyta;Tracheophyta;Spermatophyta;Magnoliophyta;Apiales;Mackinlaya;";"0.0";"0";"1";"1";"0";"1";"0";"457182";"391207"
"V4mis2";"SILVA (only NR);Eukaryota;Archaeplastida;Chloroplastida;Charophyta;Phragmoplastophyta;Streptophyta;Embryophyta;Tracheophyta;Spermatophyta;Magnoliophyta;Apiales;Melanophylla;";"0.0";"0";"1";"1";"0";"1";"0";"457182";"391207"
"V4mis2";"SILVA (only NR);Eukaryota;Archaeplastida;Chloroplastida;Charophyta;Phragmoplastophyta;Streptophyta;Embryophyta;Tracheophyta;Spermatophyta;Magnoliophyta;Apiales;Panax;";"0.0";"0";"3";"3";"0";"3";"0";"457180";"391207"
"V4mis2";"SILVA (only NR);Eukaryota;Archaeplastida;Chloroplastida;Charophyta;Phragmoplastophyta;Streptophyta;Embryophyta;Tracheophyta;Spermatophyta;Magnoliophyta;Apiales;Peucedanum;";"0.0";"0";"1";"1";"0";"1";"0";"457182";"391207"
"V4mis2";"SILVA (only NR);Eukaryota;Archaeplastida;Chloroplastida;Charophyta;Phragmoplastophyta;Streptophyta;Embryophyta;Tracheophyta;Spermatophyta;Magnoliophyta;Apiales;Pimpinella;";"0.0";"0";"1";"1";"0";"1";"0";"457182";"391207"
"V4mis2";"SILVA (only NR);Eukaryota;Archaeplastida;Chloroplastida;Charophyta;Phragmoplastophyta;Streptophyta;Embryophyta;Tracheophyta;Spermatophyta;Magnoliophyta;Aquifoliales;";"0.0";"0";"5";"5";"0";"5";"0";"457178";"391207"
"V4mis2";"SILVA (only NR);Eukaryota;Archaeplastida;Chloroplastida;Charophyta;Phragmoplastophyta;Streptophyta;Embryophyta;Tracheophyta;Spermatophyta;Magnoliophyta;Aquifoliales;Cardiopteris;";"0.0";"0";"1";"1";"0";"1";"0";"457182";"391207"
"V4mis2";"SILVA (only NR);Eukaryota;Archaeplastida;Chloroplastida;Charophyta;Phragmoplastophyta;Streptophyta;Embryophyta;Tracheophyta;Spermatophyta;Magnoliophyta;Aquifoliales;Gonocaryum;";"0.0";"0";"1";"1";"0";"1";"0";"457182";"391207"
"V4mis2";"SILVA (only NR);Eukaryota;Archaeplastida;Chloroplastida;Charophyta;Phragmoplastophyta;Streptophyta;Embryophyta;Tracheophyta;Spermatophyta;Magnoliophyta;Aquifoliales;Helwingia;";"0.0";"0";"1";"1";"0";"1";"0";"457182";"391207"
"V4mis2";"SILVA (only NR);Eukaryota;Archaeplastida;Chloroplastida;Charophyta;Phragmoplastophyta;Streptophyta;Embryophyta;Tracheophyta;Spermatophyta;Magnoliophyta;Aquifoliales;Ilex;";"0.0";"0";"1";"1";"0";"1";"0";"457182";"391207"
"V4mis2";"SILVA (only NR);Eukaryota;Archaeplastida;Chloroplastida;Charophyta;Phragmoplastophyta;Streptophyta;Embryophyta;Tracheophyta;Spermatophyta;Magnoliophyta;Aquifoliales;Phyllonoma;";"0.0";"0";"1";"1";"0";"1";"0";"457182";"391207"
"V4mis2";"SILVA (only NR);Eukaryota;Archaeplastida;Chloroplastida;Charophyta;Phragmoplastophyta;Streptophyta;Embryophyta;Tracheophyta;Spermatophyta;Magnoliophyta;Asterales;";"0.0";"0";"80";"80";"0";"80";"0";"457103";"391207"
"V4mis2";"SILVA (only NR);Eukaryota;Archaeplastida;Chloroplastida;Charophyta;Phragmoplastophyta;Streptophyta;Embryophyta;Tracheophyta;Spermatophyta;Magnoliophyta;Asterales;Alseuosmia;";"0.0";"0";"1";"1";"0";"1";"0";"457182";"391207"
"V4mis2";"SILVA (only NR);Eukaryota;Archaeplastida;Chloroplastida;Charophyta;Phragmoplastophyta;Streptophyta;Embryophyta;Tracheophyta;Spermatophyta;Magnoliophyta;Asterales;Atractylodes;";"0.0";"0";"1";"1";"0";"1";"0";"457182";"391207"
"V4mis2";"SILVA (only NR);Eukaryota;Archaeplastida;Chloroplastida;Charophyta;Phragmoplastophyta;Streptophyta;Embryophyta;Tracheophyta;Spermatophyta;Magnoliophyta;Asterales;Barnadesia;";"0.0";"0";"1";"1";"0";"1";"0";"457182";"391207"
"V4mis2";"SILVA (only NR);Eukaryota;Archaeplastida;Chloroplastida;Charophyta;Phragmoplastophyta;Streptophyta;Embryophyta;Tracheophyta;Spermatophyta;Magnoliophyta;Asterales;Campanula;";"0.0";"0";"1";"1";"0";"1";"0";"457182";"391207"
"V4mis2";"SILVA (only NR);Eukaryota;Archaeplastida;Chloroplastida;Charophyta;Phragmoplastophyta;Streptophyta;Embryophyta;Tracheophyta;Spermatophyta;Magnoliophyta;Asterales;Carpodetus;";"0.0";"0";"1";"1";"0";"1";"0";"457182";"391207"
"V4mis2";"SILVA (only NR);Eukaryota;Archaeplastida;Chloroplastida;Charophyta;Phragmoplastophyta;Streptophyta;Embryophyta;Tracheophyta;Spermatophyta;Magnoliophyta;Asterales;Codonopsis;";"0.0";"0";"1";"1";"0";"1";"0";"457182";"391207"
"V4mis2";"SILVA (only NR);Eukaryota;Archaeplastida;Chloroplastida;Charophyta;Phragmoplastophyta;Streptophyta;Embryophyta;Tracheophyta;Spermatophyta;Magnoliophyta;Asterales;Cynara;";"0.0";"0";"3";"3";"0";"3";"0";"457180";"391207"
"V4mis2";"SILVA (only NR);Eukaryota;Archaeplastida;Chloroplastida;Charophyta;Phragmoplastophyta;Streptophyta;Embryophyta;Tracheophyta;Spermatophyta;Magnoliophyta;Asterales;Dahlia;";"0.0";"0";"1";"1";"0";"1";"0";"457182";"391207"
"V4mis2";"SILVA (only NR);Eukaryota;Archaeplastida;Chloroplastida;Charophyta;Phragmoplastophyta;Streptophyta;Embryophyta;Tracheophyta;Spermatophyta;Magnoliophyta;Asterales;Donatia;";"0.0";"0";"1";"1";"0";"1";"0";"457182";"391207"
"V4mis2";"SILVA (only NR);Eukaryota;Archaeplastida;Chloroplastida;Charophyta;Phragmoplastophyta;Streptophyta;Embryophyta;Tracheophyta;Spermatophyta;Magnoliophyta;Asterales;Helianthus;";"0.0";"0";"58";"58";"0";"58";"0";"457125";"391207"
"V4mis2";"SILVA (only NR);Eukaryota;Archaeplastida;Chloroplastida;Charophyta;Phragmoplastophyta;Streptophyta;Embryophyta;Tracheophyta;Spermatophyta;Magnoliophyta;Asterales;Heliopsis;";"0.0";"0";"1";"1";"0";"1";"0";"457182";"391207"
"V4mis2";"SILVA (only NR);Eukaryota;Archaeplastida;Chloroplastida;Charophyta;Phragmoplastophyta;Streptophyta;Embryophyta;Tracheophyta;Spermatophyta;Magnoliophyta;Asterales;Lactuca;";"0.0";"0";"1";"1";"0";"1";"0";"457182";"391207"
"V4mis2";"SILVA (only NR);Eukaryota;Archaeplastida;Chloroplastida;Charophyta;Phragmoplastophyta;Streptophyta;Embryophyta;Tracheophyta;Spermatophyta;Magnoliophyta;Asterales;Lobelia;";"0.0";"0";"1";"1";"0";"1";"0";"457182";"391207"
"V4mis2";"SILVA (only NR);Eukaryota;Archaeplastida;Chloroplastida;Charophyta;Phragmoplastophyta;Streptophyta;Embryophyta;Tracheophyta;Spermatophyta;Magnoliophyta;Asterales;Megalodonta;";"0.0";"0";"1";"1";"0";"1";"0";"457182";"391207"
"V4mis2";"SILVA (only NR);Eukaryota;Archaeplastida;Chloroplastida;Charophyta;Phragmoplastophyta;Streptophyta;Embryophyta;Tracheophyta;Spermatophyta;Magnoliophyta;Asterales;Menyanthes;";"0.0";"0";"1";"1";"0";"1";"0";"457182";"391207"
"V4mis2";"SILVA (only NR);Eukaryota;Archaeplastida;Chloroplastida;Charophyta;Phragmoplastophyta;Streptophyta;Embryophyta;Tracheophyta;Spermatophyta;Magnoliophyta;Asterales;Myodocarpus;";"0.0";"0";"1";"1";"0";"1";"0";"457182";"391207"
"V4mis2";"SILVA (only NR);Eukaryota;Archaeplastida;Chloroplastida;Charophyta;Phragmoplastophyta;Streptophyta;Embryophyta;Tracheophyta;Spermatophyta;Magnoliophyta;Asterales;Nymphoides;";"0.0";"0";"1";"1";"0";"1";"0";"457182";"391207"
"V4mis2";"SILVA (only NR);Eukaryota;Archaeplastida;Chloroplastida;Charophyta;Phragmoplastophyta;Streptophyta;Embryophyta;Tracheophyta;Spermatophyta;Magnoliophyta;Asterales;Pentaphragma;";"0.0";"0";"1";"1";"0";"1";"0";"457182";"391207"
"V4mis2";"SILVA (only NR);Eukaryota;Archaeplastida;Chloroplastida;Charophyta;Phragmoplastophyta;Streptophyta;Embryophyta;Tracheophyta;Spermatophyta;Magnoliophyta;Asterales;Roussea;";"0.0";"0";"1";"1";"0";"1";"0";"457182";"391207"
"V4mis2";"SILVA (only NR);Eukaryota;Archaeplastida;Chloroplastida;Charophyta;Phragmoplastophyta;Streptophyta;Embryophyta;Tracheophyta;Spermatophyta;Magnoliophyta;Asterales;Rudbeckia;";"0.0";"0";"1";"1";"0";"1";"0";"457182";"391207"
"V4mis2";"SILVA (only NR);Eukaryota;Archaeplastida;Chloroplastida;Charophyta;Phragmoplastophyta;Streptophyta;Embryophyta;Tracheophyta;Spermatophyta;Magnoliophyta;Asterales;Stylidium;";"0.0";"0";"1";"1";"0";"1";"0";"457182";"391207"
"V4mis2";"SILVA (only NR);Eukaryota;Archaeplastida;Chloroplastida;Charophyta;Phragmoplastophyta;Streptophyta;Embryophyta;Tracheophyta;Spermatophyta;Magnoliophyta;Austrobaileyales;";"0.0";"0";"2";"2";"0";"2";"0";"457181";"391207"
"V4mis2";"SILVA (only NR);Eukaryota;Archaeplastida;Chloroplastida;Charophyta;Phragmoplastophyta;Streptophyta;Embryophyta;Tracheophyta;Spermatophyta;Magnoliophyta;Austrobaileyales;Austrobaileya;";"0.0";"0";"1";"1";"0";"1";"0";"457182";"391207"
"V4mis2";"SILVA (only NR);Eukaryota;Archaeplastida;Chloroplastida;Charophyta;Phragmoplastophyta;Streptophyta;Embryophyta;Tracheophyta;Spermatophyta;Magnoliophyta;Austrobaileyales;Kadsura;";"0.0";"0";"1";"1";"0";"1";"0";"457182";"391207"
"V4mis2";"SILVA (only NR);Eukaryota;Archaeplastida;Chloroplastida;Charophyta;Phragmoplastophyta;Streptophyta;Embryophyta;Tracheophyta;Spermatophyta;Magnoliophyta;Berberidopsidales;";"0.0";"0";"1";"1";"0";"1";"0";"457182";"391207"
"V4mis2";"SILVA (only NR);Eukaryota;Archaeplastida;Chloroplastida;Charophyta;Phragmoplastophyta;Streptophyta;Embryophyta;Tracheophyta;Spermatophyta;Magnoliophyta;Berberidopsidales;Aextoxicon;";"0.0";"0";"1";"1";"0";"1";"0";"457182";"391207"
"V4mis2";"SILVA (only NR);Eukaryota;Archaeplastida;Chloroplastida;Charophyta;Phragmoplastophyta;Streptophyta;Embryophyta;Tracheophyta;Spermatophyta;Magnoliophyta;Boraginales;";"0.0";"0";"6";"6";"0";"6";"0";"457177";"391207"
"V4mis2";"SILVA (only NR);Eukaryota;Archaeplastida;Chloroplastida;Charophyta;Phragmoplastophyta;Streptophyta;Embryophyta;Tracheophyta;Spermatophyta;Magnoliophyta;Boraginales;Borago;";"0.0";"0";"1";"1";"0";"1";"0";"457182";"391207"
"V4mis2";"SILVA (only NR);Eukaryota;Archaeplastida;Chloroplastida;Charophyta;Phragmoplastophyta;Streptophyta;Embryophyta;Tracheophyta;Spermatophyta;Magnoliophyta;Boraginales;Cryptantha;";"0.0";"0";"1";"1";"0";"1";"0";"457182";"391207"
"V4mis2";"SILVA (only NR);Eukaryota;Archaeplastida;Chloroplastida;Charophyta;Phragmoplastophyta;Streptophyta;Embryophyta;Tracheophyta;Spermatophyta;Magnoliophyta;Boraginales;Ehretia;";"0.0";"0";"1";"1";"0";"1";"0";"457182";"391207"
"V4mis2";"SILVA (only NR);Eukaryota;Archaeplastida;Chloroplastida;Charophyta;Phragmoplastophyta;Streptophyta;Embryophyta;Tracheophyta;Spermatophyta;Magnoliophyta;Boraginales;Ellisia;";"0.0";"0";"1";"1";"0";"1";"0";"457182";"391207"
"V4mis2";"SILVA (only NR);Eukaryota;Archaeplastida;Chloroplastida;Charophyta;Phragmoplastophyta;Streptophyta;Embryophyta;Tracheophyta;Spermatophyta;Magnoliophyta;Boraginales;Lithospermum;";"0.0";"0";"1";"1";"0";"1";"0";"457182";"391207"
"V4mis2";"SILVA (only NR);Eukaryota;Archaeplastida;Chloroplastida;Charophyta;Phragmoplastophyta;Streptophyta;Embryophyta;Tracheophyta;Spermatophyta;Magnoliophyta;Boraginales;Pholisma;";"0.0";"0";"1";"1";"0";"1";"0";"457182";"391207"
"V4mis2";"SILVA (only NR);Eukaryota;Archaeplastida;Chloroplastida;Charophyta;Phragmoplastophyta;Streptophyta;Embryophyta;Tracheophyta;Spermatophyta;Magnoliophyta;Brassicales;";"0.0";"0";"232";"230";"0";"230";"2";"456953";"391207"
"V4mis2";"SILVA (only NR);Eukaryota;Archaeplastida;Chloroplastida;Charophyta;Phragmoplastophyta;Streptophyta;Embryophyta;Tracheophyta;Spermatophyta;Magnoliophyta;Brassicales;Aethionema;";"0.0";"0";"1";"1";"0";"1";"0";"457182";"391207"
"V4mis2";"SILVA (only NR);Eukaryota;Archaeplastida;Chloroplastida;Charophyta;Phragmoplastophyta;Streptophyta;Embryophyta;Tracheophyta;Spermatophyta;Magnoliophyta;Brassicales;Arabidopsis;";"0.0";"0";"99";"99";"0";"99";"0";"457084";"391207"
"V4mis2";"SILVA (only NR);Eukaryota;Archaeplastida;Chloroplastida;Charophyta;Phragmoplastophyta;Streptophyta;Embryophyta;Tracheophyta;Spermatophyta;Magnoliophyta;Brassicales;Arabis;";"0.0";"0";"1";"1";"0";"1";"0";"457182";"391207"
"V4mis2";"SILVA (only NR);Eukaryota;Archaeplastida;Chloroplastida;Charophyta;Phragmoplastophyta;Streptophyta;Embryophyta;Tracheophyta;Spermatophyta;Magnoliophyta;Brassicales;Batis;";"0.0";"0";"1";"1";"0";"1";"0";"457182";"391207"
"V4mis2";"SILVA (only NR);Eukaryota;Archaeplastida;Chloroplastida;Charophyta;Phragmoplastophyta;Streptophyta;Embryophyta;Tracheophyta;Spermatophyta;Magnoliophyta;Brassicales;Brassica;";"0.0";"0";"86";"86";"0";"86";"0";"457097";"391207"
"V4mis2";"SILVA (only NR);Eukaryota;Archaeplastida;Chloroplastida;Charophyta;Phragmoplastophyta;Streptophyta;Embryophyta;Tracheophyta;Spermatophyta;Magnoliophyta;Brassicales;Camelina;";"0.0";"0";"2";"2";"0";"2";"0";"457181";"391207"
"V4mis2";"SILVA (only NR);Eukaryota;Archaeplastida;Chloroplastida;Charophyta;Phragmoplastophyta;Streptophyta;Embryophyta;Tracheophyta;Spermatophyta;Magnoliophyta;Brassicales;Capparis;";"0.0";"0";"1";"1";"0";"1";"0";"457182";"391207"
"V4mis2";"SILVA (only NR);Eukaryota;Archaeplastida;Chloroplastida;Charophyta;Phragmoplastophyta;Streptophyta;Embryophyta;Tracheophyta;Spermatophyta;Magnoliophyta;Brassicales;Carica;";"0.0";"0";"1";"1";"0";"1";"0";"457182";"391207"
"V4mis2";"SILVA (only NR);Eukaryota;Archaeplastida;Chloroplastida;Charophyta;Phragmoplastophyta;Streptophyta;Embryophyta;Tracheophyta;Spermatophyta;Magnoliophyta;Brassicales;Chorispora;";"0.0";"0";"1";"1";"0";"1";"0";"457182";"391207"
"V4mis2";"SILVA (only NR);Eukaryota;Archaeplastida;Chloroplastida;Charophyta;Phragmoplastophyta;Streptophyta;Embryophyta;Tracheophyta;Spermatophyta;Magnoliophyta;Brassicales;Cleome;";"0.0";"0";"1";"1";"0";"1";"0";"457182";"391207"
"V4mis2";"SILVA (only NR);Eukaryota;Archaeplastida;Chloroplastida;Charophyta;Phragmoplastophyta;Streptophyta;Embryophyta;Tracheophyta;Spermatophyta;Magnoliophyta;Brassicales;Cleomella;";"0.0";"0";"1";"1";"0";"1";"0";"457182";"391207"
"V4mis2";"SILVA (only NR);Eukaryota;Archaeplastida;Chloroplastida;Charophyta;Phragmoplastophyta;Streptophyta;Embryophyta;Tracheophyta;Spermatophyta;Magnoliophyta;Brassicales;Conringia;";"0.0";"0";"6";"6";"0";"6";"0";"457177";"391207"
"V4mis2";"SILVA (only NR);Eukaryota;Archaeplastida;Chloroplastida;Charophyta;Phragmoplastophyta;Streptophyta;Embryophyta;Tracheophyta;Spermatophyta;Magnoliophyta;Brassicales;Descurainia;";"0.0";"0";"1";"1";"0";"1";"0";"457182";"391207"
"V4mis2";"SILVA (only NR);Eukaryota;Archaeplastida;Chloroplastida;Charophyta;Phragmoplastophyta;Streptophyta;Embryophyta;Tracheophyta;Spermatophyta;Magnoliophyta;Brassicales;Eutrema;";"0.0";"0";"1";"1";"0";"1";"0";"457182";"391207"
"V4mis2";"SILVA (only NR);Eukaryota;Archaeplastida;Chloroplastida;Charophyta;Phragmoplastophyta;Streptophyta;Embryophyta;Tracheophyta;Spermatophyta;Magnoliophyta;Brassicales;Floerkea;";"0.0";"0";"1";"1";"0";"1";"0";"457182";"391207"
"V4mis2";"SILVA (only NR);Eukaryota;Archaeplastida;Chloroplastida;Charophyta;Phragmoplastophyta;Streptophyta;Embryophyta;Tracheophyta;Spermatophyta;Magnoliophyta;Brassicales;Gyrostemon;";"0.0";"0";"1";"1";"0";"1";"0";"457182";"391207"
"V4mis2";"SILVA (only NR);Eukaryota;Archaeplastida;Chloroplastida;Charophyta;Phragmoplastophyta;Streptophyta;Embryophyta;Tracheophyta;Spermatophyta;Magnoliophyta;Brassicales;Koeberlinia;";"0.0";"0";"1";"1";"0";"1";"0";"457182";"391207"
"V4mis2";"SILVA (only NR);Eukaryota;Archaeplastida;Chloroplastida;Charophyta;Phragmoplastophyta;Streptophyta;Embryophyta;Tracheophyta;Spermatophyta;Magnoliophyta;Brassicales;Lepidium;";"0.0";"0";"1";"1";"0";"1";"0";"457182";"391207"
"V4mis2";"SILVA (only NR);Eukaryota;Archaeplastida;Chloroplastida;Charophyta;Phragmoplastophyta;Streptophyta;Embryophyta;Tracheophyta;Spermatophyta;Magnoliophyta;Brassicales;Moringa;";"0.0";"0";"1";"1";"0";"1";"0";"457182";"391207"
"V4mis2";"SILVA (only NR);Eukaryota;Archaeplastida;Chloroplastida;Charophyta;Phragmoplastophyta;Streptophyta;Embryophyta;Tracheophyta;Spermatophyta;Magnoliophyta;Brassicales;Nasturtium;";"0.0";"0";"2";"2";"0";"2";"0";"457181";"391207"
"V4mis2";"SILVA (only NR);Eukaryota;Archaeplastida;Chloroplastida;Charophyta;Phragmoplastophyta;Streptophyta;Embryophyta;Tracheophyta;Spermatophyta;Magnoliophyta;Brassicales;Noccaea;";"0.0";"0";"1";"1";"0";"1";"0";"457182";"391207"
"V4mis2";"SILVA (only NR);Eukaryota;Archaeplastida;Chloroplastida;Charophyta;Phragmoplastophyta;Streptophyta;Embryophyta;Tracheophyta;Spermatophyta;Magnoliophyta;Brassicales;Pentadiplandra;";"0.0";"0";"1";"1";"0";"1";"0";"457182";"391207"
"V4mis2";"SILVA (only NR);Eukaryota;Archaeplastida;Chloroplastida;Charophyta;Phragmoplastophyta;Streptophyta;Embryophyta;Tracheophyta;Spermatophyta;Magnoliophyta;Brassicales;Physaria;";"0.0";"0";"1";"1";"0";"1";"0";"457182";"391207"
"V4mis2";"SILVA (only NR);Eukaryota;Archaeplastida;Chloroplastida;Charophyta;Phragmoplastophyta;Streptophyta;Embryophyta;Tracheophyta;Spermatophyta;Magnoliophyta;Brassicales;Raphanus;";"0.0";"0";"1";"1";"0";"1";"0";"457182";"391207"
"V4mis2";"SILVA (only NR);Eukaryota;Archaeplastida;Chloroplastida;Charophyta;Phragmoplastophyta;Streptophyta;Embryophyta;Tracheophyta;Spermatophyta;Magnoliophyta;Brassicales;Reseda;";"0.0";"0";"1";"1";"0";"1";"0";"457182";"391207"
"V4mis2";"SILVA (only NR);Eukaryota;Archaeplastida;Chloroplastida;Charophyta;Phragmoplastophyta;Streptophyta;Embryophyta;Tracheophyta;Spermatophyta;Magnoliophyta;Brassicales;Salvadora;";"0.0";"0";"1";"1";"0";"1";"0";"457182";"391207"
"V4mis2";"SILVA (only NR);Eukaryota;Archaeplastida;Chloroplastida;Charophyta;Phragmoplastophyta;Streptophyta;Embryophyta;Tracheophyta;Spermatophyta;Magnoliophyta;Brassicales;Schrenkiella;";"0.0";"0";"1";"1";"0";"1";"0";"457182";"391207"
"V4mis2";"SILVA (only NR);Eukaryota;Archaeplastida;Chloroplastida;Charophyta;Phragmoplastophyta;Streptophyta;Embryophyta;Tracheophyta;Spermatophyta;Magnoliophyta;Brassicales;Sinapis;";"0.0";"0";"1";"1";"0";"1";"0";"457182";"391207"
"V4mis2";"SILVA (only NR);Eukaryota;Archaeplastida;Chloroplastida;Charophyta;Phragmoplastophyta;Streptophyta;Embryophyta;Tracheophyta;Spermatophyta;Magnoliophyta;Brassicales;Tarenaya;";"0.0";"0";"11";"9";"0";"9";"2";"457174";"391207"
"V4mis2";"SILVA (only NR);Eukaryota;Archaeplastida;Chloroplastida;Charophyta;Phragmoplastophyta;Streptophyta;Embryophyta;Tracheophyta;Spermatophyta;Magnoliophyta;Brassicales;Thlaspi;";"0.0";"0";"2";"2";"0";"2";"0";"457181";"391207"
"V4mis2";"SILVA (only NR);Eukaryota;Archaeplastida;Chloroplastida;Charophyta;Phragmoplastophyta;Streptophyta;Embryophyta;Tracheophyta;Spermatophyta;Magnoliophyta;Brassicales;Tropaeolum;";"0.0";"0";"1";"1";"0";"1";"0";"457182";"391207"
"V4mis2";"SILVA (only NR);Eukaryota;Archaeplastida;Chloroplastida;Charophyta;Phragmoplastophyta;Streptophyta;Embryophyta;Tracheophyta;Spermatophyta;Magnoliophyta;Bruniales;";"0.0";"0";"1";"1";"0";"1";"0";"457182";"391207"
"V4mis2";"SILVA (only NR);Eukaryota;Archaeplastida;Chloroplastida;Charophyta;Phragmoplastophyta;Streptophyta;Embryophyta;Tracheophyta;Spermatophyta;Magnoliophyta;Bruniales;Berzelia;";"0.0";"0";"1";"1";"0";"1";"0";"457182";"391207"
"V4mis2";"SILVA (only NR);Eukaryota;Archaeplastida;Chloroplastida;Charophyta;Phragmoplastophyta;Streptophyta;Embryophyta;Tracheophyta;Spermatophyta;Magnoliophyta;Buxales;";"0.0";"0";"3";"3";"0";"3";"0";"457180";"391207"
"V4mis2";"SILVA (only NR);Eukaryota;Archaeplastida;Chloroplastida;Charophyta;Phragmoplastophyta;Streptophyta;Embryophyta;Tracheophyta;Spermatophyta;Magnoliophyta;Buxales;Buxus;";"0.0";"0";"1";"1";"0";"1";"0";"457182";"391207"
"V4mis2";"SILVA (only NR);Eukaryota;Archaeplastida;Chloroplastida;Charophyta;Phragmoplastophyta;Streptophyta;Embryophyta;Tracheophyta;Spermatophyta;Magnoliophyta;Buxales;Didymeles;";"0.0";"0";"1";"1";"0";"1";"0";"457182";"391207"
"V4mis2";"SILVA (only NR);Eukaryota;Archaeplastida;Chloroplastida;Charophyta;Phragmoplastophyta;Streptophyta;Embryophyta;Tracheophyta;Spermatophyta;Magnoliophyta;Buxales;Sarcococca;";"0.0";"0";"1";"1";"0";"1";"0";"457182";"391207"
"V4mis2";"SILVA (only NR);Eukaryota;Archaeplastida;Chloroplastida;Charophyta;Phragmoplastophyta;Streptophyta;Embryophyta;Tracheophyta;Spermatophyta;Magnoliophyta;Canellales;";"0.0";"0";"3";"3";"0";"3";"0";"457180";"391207"
"V4mis2";"SILVA (only NR);Eukaryota;Archaeplastida;Chloroplastida;Charophyta;Phragmoplastophyta;Streptophyta;Embryophyta;Tracheophyta;Spermatophyta;Magnoliophyta;Canellales;Canella;";"0.0";"0";"1";"1";"0";"1";"0";"457182";"391207"
"V4mis2";"SILVA (only NR);Eukaryota;Archaeplastida;Chloroplastida;Charophyta;Phragmoplastophyta;Streptophyta;Embryophyta;Tracheophyta;Spermatophyta;Magnoliophyta;Canellales;Cinnamodendron;";"0.0";"0";"1";"1";"0";"1";"0";"457182";"391207"
"V4mis2";"SILVA (only NR);Eukaryota;Archaeplastida;Chloroplastida;Charophyta;Phragmoplastophyta;Streptophyta;Embryophyta;Tracheophyta;Spermatophyta;Magnoliophyta;Canellales;Takhtajania;";"0.0";"0";"1";"1";"0";"1";"0";"457182";"391207"
"V4mis2";"SILVA (only NR);Eukaryota;Archaeplastida;Chloroplastida;Charophyta;Phragmoplastophyta;Streptophyta;Embryophyta;Tracheophyta;Spermatophyta;Magnoliophyta;Caryophyllales;";"0.0";"0";"106";"106";"0";"106";"0";"457077";"391207"
"V4mis2";"SILVA (only NR);Eukaryota;Archaeplastida;Chloroplastida;Charophyta;Phragmoplastophyta;Streptophyta;Embryophyta;Tracheophyta;Spermatophyta;Magnoliophyta;Caryophyllales;Aegialitis;";"0.0";"0";"1";"1";"0";"1";"0";"457182";"391207"
"V4mis2";"SILVA (only NR);Eukaryota;Archaeplastida;Chloroplastida;Charophyta;Phragmoplastophyta;Streptophyta;Embryophyta;Tracheophyta;Spermatophyta;Magnoliophyta;Caryophyllales;Aldrovanda;";"0.0";"0";"1";"1";"0";"1";"0";"457182";"391207"
"V4mis2";"SILVA (only NR);Eukaryota;Archaeplastida;Chloroplastida;Charophyta;Phragmoplastophyta;Streptophyta;Embryophyta;Tracheophyta;Spermatophyta;Magnoliophyta;Caryophyllales;Amaranthus;";"0.0";"0";"1";"1";"0";"1";"0";"457182";"391207"
"V4mis2";"SILVA (only NR);Eukaryota;Archaeplastida;Chloroplastida;Charophyta;Phragmoplastophyta;Streptophyta;Embryophyta;Tracheophyta;Spermatophyta;Magnoliophyta;Caryophyllales;Ancistrocladus;";"0.0";"0";"1";"1";"0";"1";"0";"457182";"391207"
"V4mis2";"SILVA (only NR);Eukaryota;Archaeplastida;Chloroplastida;Charophyta;Phragmoplastophyta;Streptophyta;Embryophyta;Tracheophyta;Spermatophyta;Magnoliophyta;Caryophyllales;Asteropeia;";"0.0";"0";"1";"1";"0";"1";"0";"457182";"391207"
"V4mis2";"SILVA (only NR);Eukaryota;Archaeplastida;Chloroplastida;Charophyta;Phragmoplastophyta;Streptophyta;Embryophyta;Tracheophyta;Spermatophyta;Magnoliophyta;Caryophyllales;Beta;";"0.0";"0";"10";"10";"0";"10";"0";"457173";"391207"
"V4mis2";"SILVA (only NR);Eukaryota;Archaeplastida;Chloroplastida;Charophyta;Phragmoplastophyta;Streptophyta;Embryophyta;Tracheophyta;Spermatophyta;Magnoliophyta;Caryophyllales;Chenopodium;";"0.0";"0";"12";"12";"0";"12";"0";"457171";"391207"
"V4mis2";"SILVA (only NR);Eukaryota;Archaeplastida;Chloroplastida;Charophyta;Phragmoplastophyta;Streptophyta;Embryophyta;Tracheophyta;Spermatophyta;Magnoliophyta;Caryophyllales;Coccoloba;";"0.0";"0";"1";"1";"0";"1";"0";"457182";"391207"
"V4mis2";"SILVA (only NR);Eukaryota;Archaeplastida;Chloroplastida;Charophyta;Phragmoplastophyta;Streptophyta;Embryophyta;Tracheophyta;Spermatophyta;Magnoliophyta;Caryophyllales;Delosperma;";"0.0";"0";"1";"1";"0";"1";"0";"457182";"391207"
"V4mis2";"SILVA (only NR);Eukaryota;Archaeplastida;Chloroplastida;Charophyta;Phragmoplastophyta;Streptophyta;Embryophyta;Tracheophyta;Spermatophyta;Magnoliophyta;Caryophyllales;Dianthus;";"0.0";"0";"3";"3";"0";"3";"0";"457180";"391207"
"V4mis2";"SILVA (only NR);Eukaryota;Archaeplastida;Chloroplastida;Charophyta;Phragmoplastophyta;Streptophyta;Embryophyta;Tracheophyta;Spermatophyta;Magnoliophyta;Caryophyllales;Dionaea;";"0.0";"0";"1";"1";"0";"1";"0";"457182";"391207"
"V4mis2";"SILVA (only NR);Eukaryota;Archaeplastida;Chloroplastida;Charophyta;Phragmoplastophyta;Streptophyta;Embryophyta;Tracheophyta;Spermatophyta;Magnoliophyta;Caryophyllales;Drosera;";"0.0";"0";"10";"10";"0";"10";"0";"457173";"391207"
"V4mis2";"SILVA (only NR);Eukaryota;Archaeplastida;Chloroplastida;Charophyta;Phragmoplastophyta;Streptophyta;Embryophyta;Tracheophyta;Spermatophyta;Magnoliophyta;Caryophyllales;Drosophyllum;";"0.0";"0";"1";"1";"0";"1";"0";"457182";"391207"
"V4mis2";"SILVA (only NR);Eukaryota;Archaeplastida;Chloroplastida;Charophyta;Phragmoplastophyta;Streptophyta;Embryophyta;Tracheophyta;Spermatophyta;Magnoliophyta;Caryophyllales;Fagopyrum;";"0.0";"0";"2";"2";"0";"2";"0";"457181";"391207"
"V4mis2";"SILVA (only NR);Eukaryota;Archaeplastida;Chloroplastida;Charophyta;Phragmoplastophyta;Streptophyta;Embryophyta;Tracheophyta;Spermatophyta;Magnoliophyta;Caryophyllales;Fallopia;";"0.0";"0";"1";"1";"0";"1";"0";"457182";"391207"
"V4mis2";"SILVA (only NR);Eukaryota;Archaeplastida;Chloroplastida;Charophyta;Phragmoplastophyta;Streptophyta;Embryophyta;Tracheophyta;Spermatophyta;Magnoliophyta;Caryophyllales;Frankenia;";"0.0";"0";"1";"1";"0";"1";"0";"457182";"391207"
"V4mis2";"SILVA (only NR);Eukaryota;Archaeplastida;Chloroplastida;Charophyta;Phragmoplastophyta;Streptophyta;Embryophyta;Tracheophyta;Spermatophyta;Magnoliophyta;Caryophyllales;Limeum;";"0.0";"0";"1";"1";"0";"1";"0";"457182";"391207"
"V4mis2";"SILVA (only NR);Eukaryota;Archaeplastida;Chloroplastida;Charophyta;Phragmoplastophyta;Streptophyta;Embryophyta;Tracheophyta;Spermatophyta;Magnoliophyta;Caryophyllales;Limonium;";"0.0";"0";"2";"2";"0";"2";"0";"457181";"391207"
"V4mis2";"SILVA (only NR);Eukaryota;Archaeplastida;Chloroplastida;Charophyta;Phragmoplastophyta;Streptophyta;Embryophyta;Tracheophyta;Spermatophyta;Magnoliophyta;Caryophyllales;Mirabilis;";"0.0";"0";"1";"1";"0";"1";"0";"457182";"391207"
"V4mis2";"SILVA (only NR);Eukaryota;Archaeplastida;Chloroplastida;Charophyta;Phragmoplastophyta;Streptophyta;Embryophyta;Tracheophyta;Spermatophyta;Magnoliophyta;Caryophyllales;Mollugo;";"0.0";"0";"1";"1";"0";"1";"0";"457182";"391207"
"V4mis2";"SILVA (only NR);Eukaryota;Archaeplastida;Chloroplastida;Charophyta;Phragmoplastophyta;Streptophyta;Embryophyta;Tracheophyta;Spermatophyta;Magnoliophyta;Caryophyllales;Nepenthes;";"0.0";"0";"1";"1";"0";"1";"0";"457182";"391207"
"V4mis2";"SILVA (only NR);Eukaryota;Archaeplastida;Chloroplastida;Charophyta;Phragmoplastophyta;Streptophyta;Embryophyta;Tracheophyta;Spermatophyta;Magnoliophyta;Caryophyllales;Opuntia;";"0.0";"0";"28";"28";"0";"28";"0";"457155";"391207"
"V4mis2";"SILVA (only NR);Eukaryota;Archaeplastida;Chloroplastida;Charophyta;Phragmoplastophyta;Streptophyta;Embryophyta;Tracheophyta;Spermatophyta;Magnoliophyta;Caryophyllales;Persicaria;";"0.0";"0";"6";"6";"0";"6";"0";"457177";"391207"
"V4mis2";"SILVA (only NR);Eukaryota;Archaeplastida;Chloroplastida;Charophyta;Phragmoplastophyta;Streptophyta;Embryophyta;Tracheophyta;Spermatophyta;Magnoliophyta;Caryophyllales;Phaulothamnus;";"0.0";"0";"1";"1";"0";"1";"0";"457182";"391207"
"V4mis2";"SILVA (only NR);Eukaryota;Archaeplastida;Chloroplastida;Charophyta;Phragmoplastophyta;Streptophyta;Embryophyta;Tracheophyta;Spermatophyta;Magnoliophyta;Caryophyllales;Phytolacca;";"0.0";"0";"1";"1";"0";"1";"0";"457182";"391207"
"V4mis2";"SILVA (only NR);Eukaryota;Archaeplastida;Chloroplastida;Charophyta;Phragmoplastophyta;Streptophyta;Embryophyta;Tracheophyta;Spermatophyta;Magnoliophyta;Caryophyllales;Plumbago;";"0.0";"0";"1";"1";"0";"1";"0";"457182";"391207"
"V4mis2";"SILVA (only NR);Eukaryota;Archaeplastida;Chloroplastida;Charophyta;Phragmoplastophyta;Streptophyta;Embryophyta;Tracheophyta;Spermatophyta;Magnoliophyta;Caryophyllales;Rhabdodendron;";"0.0";"0";"1";"1";"0";"1";"0";"457182";"391207"
"V4mis2";"SILVA (only NR);Eukaryota;Archaeplastida;Chloroplastida;Charophyta;Phragmoplastophyta;Streptophyta;Embryophyta;Tracheophyta;Spermatophyta;Magnoliophyta;Caryophyllales;Rheum;";"0.0";"0";"1";"1";"0";"1";"0";"457182";"391207"
"V4mis2";"SILVA (only NR);Eukaryota;Archaeplastida;Chloroplastida;Charophyta;Phragmoplastophyta;Streptophyta;Embryophyta;Tracheophyta;Spermatophyta;Magnoliophyta;Caryophyllales;Rivina;";"0.0";"0";"1";"1";"0";"1";"0";"457182";"391207"
"V4mis2";"SILVA (only NR);Eukaryota;Archaeplastida;Chloroplastida;Charophyta;Phragmoplastophyta;Streptophyta;Embryophyta;Tracheophyta;Spermatophyta;Magnoliophyta;Caryophyllales;Rumex;";"0.0";"0";"2";"2";"0";"2";"0";"457181";"391207"
"V4mis2";"SILVA (only NR);Eukaryota;Archaeplastida;Chloroplastida;Charophyta;Phragmoplastophyta;Streptophyta;Embryophyta;Tracheophyta;Spermatophyta;Magnoliophyta;Caryophyllales;Sarcobatus;";"0.0";"0";"1";"1";"0";"1";"0";"457182";"391207"
"V4mis2";"SILVA (only NR);Eukaryota;Archaeplastida;Chloroplastida;Charophyta;Phragmoplastophyta;Streptophyta;Embryophyta;Tracheophyta;Spermatophyta;Magnoliophyta;Caryophyllales;Silene;";"0.0";"0";"5";"5";"0";"5";"0";"457178";"391207"
"V4mis2";"SILVA (only NR);Eukaryota;Archaeplastida;Chloroplastida;Charophyta;Phragmoplastophyta;Streptophyta;Embryophyta;Tracheophyta;Spermatophyta;Magnoliophyta;Caryophyllales;Simmondsia;";"0.0";"0";"1";"1";"0";"1";"0";"457182";"391207"
"V4mis2";"SILVA (only NR);Eukaryota;Archaeplastida;Chloroplastida;Charophyta;Phragmoplastophyta;Streptophyta;Embryophyta;Tracheophyta;Spermatophyta;Magnoliophyta;Caryophyllales;Stellaria;";"0.0";"0";"1";"1";"0";"1";"0";"457182";"391207"
"V4mis2";"SILVA (only NR);Eukaryota;Archaeplastida;Chloroplastida;Charophyta;Phragmoplastophyta;Streptophyta;Embryophyta;Tracheophyta;Spermatophyta;Magnoliophyta;Caryophyllales;Tamarix;";"0.0";"0";"1";"1";"0";"1";"0";"457182";"391207"
"V4mis2";"SILVA (only NR);Eukaryota;Archaeplastida;Chloroplastida;Charophyta;Phragmoplastophyta;Streptophyta;Embryophyta;Tracheophyta;Spermatophyta;Magnoliophyta;Caryophyllales;Triphyophyllum;";"0.0";"0";"1";"1";"0";"1";"0";"457182";"391207"
"V4mis2";"SILVA (only NR);Eukaryota;Archaeplastida;Chloroplastida;Charophyta;Phragmoplastophyta;Streptophyta;Embryophyta;Tracheophyta;Spermatophyta;Magnoliophyta;Celastrales;";"0.0";"0";"14";"14";"0";"14";"0";"457169";"391207"
"V4mis2";"SILVA (only NR);Eukaryota;Archaeplastida;Chloroplastida;Charophyta;Phragmoplastophyta;Streptophyta;Embryophyta;Tracheophyta;Spermatophyta;Magnoliophyta;Celastrales;Canotia;";"0.0";"0";"1";"1";"0";"1";"0";"457182";"391207"
"V4mis2";"SILVA (only NR);Eukaryota;Archaeplastida;Chloroplastida;Charophyta;Phragmoplastophyta;Streptophyta;Embryophyta;Tracheophyta;Spermatophyta;Magnoliophyta;Celastrales;Celastrus;";"0.0";"0";"1";"1";"0";"1";"0";"457182";"391207"
"V4mis2";"SILVA (only NR);Eukaryota;Archaeplastida;Chloroplastida;Charophyta;Phragmoplastophyta;Streptophyta;Embryophyta;Tracheophyta;Spermatophyta;Magnoliophyta;Celastrales;Dicarpellum;";"0.0";"0";"1";"1";"0";"1";"0";"457182";"391207"
"V4mis2";"SILVA (only NR);Eukaryota;Archaeplastida;Chloroplastida;Charophyta;Phragmoplastophyta;Streptophyta;Embryophyta;Tracheophyta;Spermatophyta;Magnoliophyta;Celastrales;Euonymus;";"0.0";"0";"1";"1";"0";"1";"0";"457182";"391207"
"V4mis2";"SILVA (only NR);Eukaryota;Archaeplastida;Chloroplastida;Charophyta;Phragmoplastophyta;Streptophyta;Embryophyta;Tracheophyta;Spermatophyta;Magnoliophyta;Celastrales;Gymnosporia;";"0.0";"0";"1";"1";"0";"1";"0";"457182";"391207"
"V4mis2";"SILVA (only NR);Eukaryota;Archaeplastida;Chloroplastida;Charophyta;Phragmoplastophyta;Streptophyta;Embryophyta;Tracheophyta;Spermatophyta;Magnoliophyta;Celastrales;Lepidobotrys;";"0.0";"0";"1";"1";"0";"1";"0";"457182";"391207"
"V4mis2";"SILVA (only NR);Eukaryota;Archaeplastida;Chloroplastida;Charophyta;Phragmoplastophyta;Streptophyta;Embryophyta;Tracheophyta;Spermatophyta;Magnoliophyta;Celastrales;Lepuropetalon;";"0.0";"0";"1";"1";"0";"1";"0";"457182";"391207"
"V4mis2";"SILVA (only NR);Eukaryota;Archaeplastida;Chloroplastida;Charophyta;Phragmoplastophyta;Streptophyta;Embryophyta;Tracheophyta;Spermatophyta;Magnoliophyta;Celastrales;Mortonia;";"0.0";"0";"1";"1";"0";"1";"0";"457182";"391207"
"V4mis2";"SILVA (only NR);Eukaryota;Archaeplastida;Chloroplastida;Charophyta;Phragmoplastophyta;Streptophyta;Embryophyta;Tracheophyta;Spermatophyta;Magnoliophyta;Celastrales;Parnassia;";"0.0";"0";"1";"1";"0";"1";"0";"457182";"391207"
"V4mis2";"SILVA (only NR);Eukaryota;Archaeplastida;Chloroplastida;Charophyta;Phragmoplastophyta;Streptophyta;Embryophyta;Tracheophyta;Spermatophyta;Magnoliophyta;Celastrales;Plagiopteron;";"0.0";"0";"1";"1";"0";"1";"0";"457182";"391207"
"V4mis2";"SILVA (only NR);Eukaryota;Archaeplastida;Chloroplastida;Charophyta;Phragmoplastophyta;Streptophyta;Embryophyta;Tracheophyta;Spermatophyta;Magnoliophyta;Celastrales;Ruptiliocarpon;";"0.0";"0";"1";"1";"0";"1";"0";"457182";"391207"
"V4mis2";"SILVA (only NR);Eukaryota;Archaeplastida;Chloroplastida;Charophyta;Phragmoplastophyta;Streptophyta;Embryophyta;Tracheophyta;Spermatophyta;Magnoliophyta;Celastrales;Siphonodon;";"0.0";"0";"1";"1";"0";"1";"0";"457182";"391207"
"V4mis2";"SILVA (only NR);Eukaryota;Archaeplastida;Chloroplastida;Charophyta;Phragmoplastophyta;Streptophyta;Embryophyta;Tracheophyta;Spermatophyta;Magnoliophyta;Celastrales;Stackhousia;";"0.0";"0";"1";"1";"0";"1";"0";"457182";"391207"
"V4mis2";"SILVA (only NR);Eukaryota;Archaeplastida;Chloroplastida;Charophyta;Phragmoplastophyta;Streptophyta;Embryophyta;Tracheophyta;Spermatophyta;Magnoliophyta;Celastrales;Zinowiewia;";"0.0";"0";"1";"1";"0";"1";"0";"457182";"391207"
"V4mis2";"SILVA (only NR);Eukaryota;Archaeplastida;Chloroplastida;Charophyta;Phragmoplastophyta;Streptophyta;Embryophyta;Tracheophyta;Spermatophyta;Magnoliophyta;Ceratophyllales;";"0.0";"0";"1";"1";"0";"1";"0";"457182";"391207"
"V4mis2";"SILVA (only NR);Eukaryota;Archaeplastida;Chloroplastida;Charophyta;Phragmoplastophyta;Streptophyta;Embryophyta;Tracheophyta;Spermatophyta;Magnoliophyta;Ceratophyllales;Ceratophyllum;";"0.0";"0";"1";"1";"0";"1";"0";"457182";"391207"
"V4mis2";"SILVA (only NR);Eukaryota;Archaeplastida;Chloroplastida;Charophyta;Phragmoplastophyta;Streptophyta;Embryophyta;Tracheophyta;Spermatophyta;Magnoliophyta;Chloranthales;";"0.0";"0";"3";"3";"0";"3";"0";"457180";"391207"
"V4mis2";"SILVA (only NR);Eukaryota;Archaeplastida;Chloroplastida;Charophyta;Phragmoplastophyta;Streptophyta;Embryophyta;Tracheophyta;Spermatophyta;Magnoliophyta;Chloranthales;Chloranthus;";"0.0";"0";"1";"1";"0";"1";"0";"457182";"391207"
"V4mis2";"SILVA (only NR);Eukaryota;Archaeplastida;Chloroplastida;Charophyta;Phragmoplastophyta;Streptophyta;Embryophyta;Tracheophyta;Spermatophyta;Magnoliophyta;Chloranthales;Hedyosmum;";"0.0";"0";"1";"1";"0";"1";"0";"457182";"391207"
"V4mis2";"SILVA (only NR);Eukaryota;Archaeplastida;Chloroplastida;Charophyta;Phragmoplastophyta;Streptophyta;Embryophyta;Tracheophyta;Spermatophyta;Magnoliophyta;Chloranthales;Sarcandra;";"0.0";"0";"1";"1";"0";"1";"0";"457182";"391207"
"V4mis2";"SILVA (only NR);Eukaryota;Archaeplastida;Chloroplastida;Charophyta;Phragmoplastophyta;Streptophyta;Embryophyta;Tracheophyta;Spermatophyta;Magnoliophyta;Cornales;";"0.0";"0";"4";"4";"0";"4";"0";"457179";"391207"
"V4mis2";"SILVA (only NR);Eukaryota;Archaeplastida;Chloroplastida;Charophyta;Phragmoplastophyta;Streptophyta;Embryophyta;Tracheophyta;Spermatophyta;Magnoliophyta;Cornales;Alangium;";"0.0";"0";"1";"1";"0";"1";"0";"457182";"391207"
"V4mis2";"SILVA (only NR);Eukaryota;Archaeplastida;Chloroplastida;Charophyta;Phragmoplastophyta;Streptophyta;Embryophyta;Tracheophyta;Spermatophyta;Magnoliophyta;Cornales;Hydrostachys;";"0.0";"0";"1";"1";"0";"1";"0";"457182";"391207"
"V4mis2";"SILVA (only NR);Eukaryota;Archaeplastida;Chloroplastida;Charophyta;Phragmoplastophyta;Streptophyta;Embryophyta;Tracheophyta;Spermatophyta;Magnoliophyta;Cornales;Nasa;";"0.0";"0";"1";"1";"0";"1";"0";"457182";"391207"
"V4mis2";"SILVA (only NR);Eukaryota;Archaeplastida;Chloroplastida;Charophyta;Phragmoplastophyta;Streptophyta;Embryophyta;Tracheophyta;Spermatophyta;Magnoliophyta;Cornales;Philadelphus;";"0.0";"0";"1";"1";"0";"1";"0";"457182";"391207"
"V4mis2";"SILVA (only NR);Eukaryota;Archaeplastida;Chloroplastida;Charophyta;Phragmoplastophyta;Streptophyta;Embryophyta;Tracheophyta;Spermatophyta;Magnoliophyta;Crossosomatales;";"0.0";"0";"4";"4";"0";"4";"0";"457179";"391207"
"V4mis2";"SILVA (only NR);Eukaryota;Archaeplastida;Chloroplastida;Charophyta;Phragmoplastophyta;Streptophyta;Embryophyta;Tracheophyta;Spermatophyta;Magnoliophyta;Crossosomatales;Aphloia;";"0.0";"0";"1";"1";"0";"1";"0";"457182";"391207"
"V4mis2";"SILVA (only NR);Eukaryota;Archaeplastida;Chloroplastida;Charophyta;Phragmoplastophyta;Streptophyta;Embryophyta;Tracheophyta;Spermatophyta;Magnoliophyta;Crossosomatales;Crossosoma;";"0.0";"0";"1";"1";"0";"1";"0";"457182";"391207"
"V4mis2";"SILVA (only NR);Eukaryota;Archaeplastida;Chloroplastida;Charophyta;Phragmoplastophyta;Streptophyta;Embryophyta;Tracheophyta;Spermatophyta;Magnoliophyta;Crossosomatales;Stachyurus;";"0.0";"0";"1";"1";"0";"1";"0";"457182";"391207"
"V4mis2";"SILVA (only NR);Eukaryota;Archaeplastida;Chloroplastida;Charophyta;Phragmoplastophyta;Streptophyta;Embryophyta;Tracheophyta;Spermatophyta;Magnoliophyta;Crossosomatales;Strasburgeria;";"0.0";"0";"1";"1";"0";"1";"0";"457182";"391207"
"V4mis2";"SILVA (only NR);Eukaryota;Archaeplastida;Chloroplastida;Charophyta;Phragmoplastophyta;Streptophyta;Embryophyta;Tracheophyta;Spermatophyta;Magnoliophyta;Cucurbitales;";"0.0";"0";"292";"291";"0";"291";"1";"456892";"391207"
"V4mis2";"SILVA (only NR);Eukaryota;Archaeplastida;Chloroplastida;Charophyta;Phragmoplastophyta;Streptophyta;Embryophyta;Tracheophyta;Spermatophyta;Magnoliophyta;Cucurbitales;Abobra;";"0.0";"0";"1";"1";"0";"1";"0";"457182";"391207"
"V4mis2";"SILVA (only NR);Eukaryota;Archaeplastida;Chloroplastida;Charophyta;Phragmoplastophyta;Streptophyta;Embryophyta;Tracheophyta;Spermatophyta;Magnoliophyta;Cucurbitales;Anisophyllea;";"0.0";"0";"1";"1";"0";"1";"0";"457182";"391207"
"V4mis2";"SILVA (only NR);Eukaryota;Archaeplastida;Chloroplastida;Charophyta;Phragmoplastophyta;Streptophyta;Embryophyta;Tracheophyta;Spermatophyta;Magnoliophyta;Cucurbitales;Apodanthes;";"0.0";"0";"1";"1";"0";"1";"0";"457182";"391207"
"V4mis2";"SILVA (only NR);Eukaryota;Archaeplastida;Chloroplastida;Charophyta;Phragmoplastophyta;Streptophyta;Embryophyta;Tracheophyta;Spermatophyta;Magnoliophyta;Cucurbitales;Begonia;";"0.0";"0";"10";"10";"0";"10";"0";"457173";"391207"
"V4mis2";"SILVA (only NR);Eukaryota;Archaeplastida;Chloroplastida;Charophyta;Phragmoplastophyta;Streptophyta;Embryophyta;Tracheophyta;Spermatophyta;Magnoliophyta;Cucurbitales;Cephalopentandra;";"0.0";"0";"1";"1";"0";"1";"0";"457182";"391207"
"V4mis2";"SILVA (only NR);Eukaryota;Archaeplastida;Chloroplastida;Charophyta;Phragmoplastophyta;Streptophyta;Embryophyta;Tracheophyta;Spermatophyta;Magnoliophyta;Cucurbitales;Citrullus;";"0.0";"0";"2";"2";"0";"2";"0";"457181";"391207"
"V4mis2";"SILVA (only NR);Eukaryota;Archaeplastida;Chloroplastida;Charophyta;Phragmoplastophyta;Streptophyta;Embryophyta;Tracheophyta;Spermatophyta;Magnoliophyta;Cucurbitales;Coccinia;";"0.0";"0";"1";"1";"0";"1";"0";"457182";"391207"
"V4mis2";"SILVA (only NR);Eukaryota;Archaeplastida;Chloroplastida;Charophyta;Phragmoplastophyta;Streptophyta;Embryophyta;Tracheophyta;Spermatophyta;Magnoliophyta;Cucurbitales;Combretocarpus;";"0.0";"0";"1";"1";"0";"1";"0";"457182";"391207"
"V4mis2";"SILVA (only NR);Eukaryota;Archaeplastida;Chloroplastida;Charophyta;Phragmoplastophyta;Streptophyta;Embryophyta;Tracheophyta;Spermatophyta;Magnoliophyta;Cucurbitales;Corallocarpus;";"0.0";"0";"1";"1";"0";"1";"0";"457182";"391207"
"V4mis2";"SILVA (only NR);Eukaryota;Archaeplastida;Chloroplastida;Charophyta;Phragmoplastophyta;Streptophyta;Embryophyta;Tracheophyta;Spermatophyta;Magnoliophyta;Cucurbitales;Coriaria;";"0.0";"0";"2";"2";"0";"2";"0";"457181";"391207"
"V4mis2";"SILVA (only NR);Eukaryota;Archaeplastida;Chloroplastida;Charophyta;Phragmoplastophyta;Streptophyta;Embryophyta;Tracheophyta;Spermatophyta;Magnoliophyta;Cucurbitales;Corynocarpus;";"0.0";"0";"1";"1";"0";"1";"0";"457182";"391207"
"V4mis2";"SILVA (only NR);Eukaryota;Archaeplastida;Chloroplastida;Charophyta;Phragmoplastophyta;Streptophyta;Embryophyta;Tracheophyta;Spermatophyta;Magnoliophyta;Cucurbitales;Cucumis;";"0.0";"0";"246";"245";"0";"245";"1";"456938";"391207"
"V4mis2";"SILVA (only NR);Eukaryota;Archaeplastida;Chloroplastida;Charophyta;Phragmoplastophyta;Streptophyta;Embryophyta;Tracheophyta;Spermatophyta;Magnoliophyta;Cucurbitales;Datisca;";"0.0";"0";"2";"2";"0";"2";"0";"457181";"391207"
"V4mis2";"SILVA (only NR);Eukaryota;Archaeplastida;Chloroplastida;Charophyta;Phragmoplastophyta;Streptophyta;Embryophyta;Tracheophyta;Spermatophyta;Magnoliophyta;Cucurbitales;Ecballium;";"0.0";"0";"1";"1";"0";"1";"0";"457182";"391207"
"V4mis2";"SILVA (only NR);Eukaryota;Archaeplastida;Chloroplastida;Charophyta;Phragmoplastophyta;Streptophyta;Embryophyta;Tracheophyta;Spermatophyta;Magnoliophyta;Cucurbitales;Gurania;";"0.0";"0";"1";"1";"0";"1";"0";"457182";"391207"
"V4mis2";"SILVA (only NR);Eukaryota;Archaeplastida;Chloroplastida;Charophyta;Phragmoplastophyta;Streptophyta;Embryophyta;Tracheophyta;Spermatophyta;Magnoliophyta;Cucurbitales;Gynostemma;";"0.0";"0";"1";"1";"0";"1";"0";"457182";"391207"
"V4mis2";"SILVA (only NR);Eukaryota;Archaeplastida;Chloroplastida;Charophyta;Phragmoplastophyta;Streptophyta;Embryophyta;Tracheophyta;Spermatophyta;Magnoliophyta;Cucurbitales;Hillebrandia;";"0.0";"0";"1";"1";"0";"1";"0";"457182";"391207"
"V4mis2";"SILVA (only NR);Eukaryota;Archaeplastida;Chloroplastida;Charophyta;Phragmoplastophyta;Streptophyta;Embryophyta;Tracheophyta;Spermatophyta;Magnoliophyta;Cucurbitales;Lagenaria;";"0.0";"0";"2";"2";"0";"2";"0";"457181";"391207"
"V4mis2";"SILVA (only NR);Eukaryota;Archaeplastida;Chloroplastida;Charophyta;Phragmoplastophyta;Streptophyta;Embryophyta;Tracheophyta;Spermatophyta;Magnoliophyta;Cucurbitales;Luffa;";"0.0";"0";"1";"1";"0";"1";"0";"457182";"391207"
"V4mis2";"SILVA (only NR);Eukaryota;Archaeplastida;Chloroplastida;Charophyta;Phragmoplastophyta;Streptophyta;Embryophyta;Tracheophyta;Spermatophyta;Magnoliophyta;Cucurbitales;Marah;";"0.0";"0";"1";"1";"0";"1";"0";"457182";"391207"
"V4mis2";"SILVA (only NR);Eukaryota;Archaeplastida;Chloroplastida;Charophyta;Phragmoplastophyta;Streptophyta;Embryophyta;Tracheophyta;Spermatophyta;Magnoliophyta;Cucurbitales;Neoalsomitra;";"0.0";"0";"1";"1";"0";"1";"0";"457182";"391207"
"V4mis2";"SILVA (only NR);Eukaryota;Archaeplastida;Chloroplastida;Charophyta;Phragmoplastophyta;Streptophyta;Embryophyta;Tracheophyta;Spermatophyta;Magnoliophyta;Cucurbitales;Octomeles;";"0.0";"0";"1";"1";"0";"1";"0";"457182";"391207"
"V4mis2";"SILVA (only NR);Eukaryota;Archaeplastida;Chloroplastida;Charophyta;Phragmoplastophyta;Streptophyta;Embryophyta;Tracheophyta;Spermatophyta;Magnoliophyta;Cucurbitales;Pilostyles;";"0.0";"0";"8";"8";"0";"8";"0";"457175";"391207"
"V4mis2";"SILVA (only NR);Eukaryota;Archaeplastida;Chloroplastida;Charophyta;Phragmoplastophyta;Streptophyta;Embryophyta;Tracheophyta;Spermatophyta;Magnoliophyta;Cucurbitales;Symbegonia;";"0.0";"0";"1";"1";"0";"1";"0";"457182";"391207"
"V4mis2";"SILVA (only NR);Eukaryota;Archaeplastida;Chloroplastida;Charophyta;Phragmoplastophyta;Streptophyta;Embryophyta;Tracheophyta;Spermatophyta;Magnoliophyta;Cucurbitales;Tetrameles;";"0.0";"0";"1";"1";"0";"1";"0";"457182";"391207"
"V4mis2";"SILVA (only NR);Eukaryota;Archaeplastida;Chloroplastida;Charophyta;Phragmoplastophyta;Streptophyta;Embryophyta;Tracheophyta;Spermatophyta;Magnoliophyta;Cucurbitales;Trochomeria;";"0.0";"0";"1";"1";"0";"1";"0";"457182";"391207"
"V4mis2";"SILVA (only NR);Eukaryota;Archaeplastida;Chloroplastida;Charophyta;Phragmoplastophyta;Streptophyta;Embryophyta;Tracheophyta;Spermatophyta;Magnoliophyta;Cucurbitales;Xerosicyos;";"0.0";"0";"1";"1";"0";"1";"0";"457182";"391207"
"V4mis2";"SILVA (only NR);Eukaryota;Archaeplastida;Chloroplastida;Charophyta;Phragmoplastophyta;Streptophyta;Embryophyta;Tracheophyta;Spermatophyta;Magnoliophyta;Dilleniales;";"0.0";"0";"4";"4";"0";"4";"0";"457179";"391207"
"V4mis2";"SILVA (only NR);Eukaryota;Archaeplastida;Chloroplastida;Charophyta;Phragmoplastophyta;Streptophyta;Embryophyta;Tracheophyta;Spermatophyta;Magnoliophyta;Dilleniales;Dillenia;";"0.0";"0";"1";"1";"0";"1";"0";"457182";"391207"
"V4mis2";"SILVA (only NR);Eukaryota;Archaeplastida;Chloroplastida;Charophyta;Phragmoplastophyta;Streptophyta;Embryophyta;Tracheophyta;Spermatophyta;Magnoliophyta;Dilleniales;Hibbertia;";"0.0";"0";"1";"1";"0";"1";"0";"457182";"391207"
"V4mis2";"SILVA (only NR);Eukaryota;Archaeplastida;Chloroplastida;Charophyta;Phragmoplastophyta;Streptophyta;Embryophyta;Tracheophyta;Spermatophyta;Magnoliophyta;Dilleniales;Schumacheria;";"0.0";"0";"1";"1";"0";"1";"0";"457182";"391207"
"V4mis2";"SILVA (only NR);Eukaryota;Archaeplastida;Chloroplastida;Charophyta;Phragmoplastophyta;Streptophyta;Embryophyta;Tracheophyta;Spermatophyta;Magnoliophyta;Dilleniales;Tetracera;";"0.0";"0";"1";"1";"0";"1";"0";"457182";"391207"
"V4mis2";"SILVA (only NR);Eukaryota;Archaeplastida;Chloroplastida;Charophyta;Phragmoplastophyta;Streptophyta;Embryophyta;Tracheophyta;Spermatophyta;Magnoliophyta;Dipsacales;";"0.0";"0";"2";"2";"0";"2";"0";"457181";"391207"
"V4mis2";"SILVA (only NR);Eukaryota;Archaeplastida;Chloroplastida;Charophyta;Phragmoplastophyta;Streptophyta;Embryophyta;Tracheophyta;Spermatophyta;Magnoliophyta;Dipsacales;Lonicera;";"0.0";"0";"1";"1";"0";"1";"0";"457182";"391207"
"V4mis2";"SILVA (only NR);Eukaryota;Archaeplastida;Chloroplastida;Charophyta;Phragmoplastophyta;Streptophyta;Embryophyta;Tracheophyta;Spermatophyta;Magnoliophyta;Dipsacales;Valeriana;";"0.0";"0";"1";"1";"0";"1";"0";"457182";"391207"
"V4mis2";"SILVA (only NR);Eukaryota;Archaeplastida;Chloroplastida;Charophyta;Phragmoplastophyta;Streptophyta;Embryophyta;Tracheophyta;Spermatophyta;Magnoliophyta;Ericales;";"0.0";"0";"49";"49";"0";"49";"0";"457134";"391207"
"V4mis2";"SILVA (only NR);Eukaryota;Archaeplastida;Chloroplastida;Charophyta;Phragmoplastophyta;Streptophyta;Embryophyta;Tracheophyta;Spermatophyta;Magnoliophyta;Ericales;Actinidia;";"0.0";"0";"6";"6";"0";"6";"0";"457177";"391207"
"V4mis2";"SILVA (only NR);Eukaryota;Archaeplastida;Chloroplastida;Charophyta;Phragmoplastophyta;Streptophyta;Embryophyta;Tracheophyta;Spermatophyta;Magnoliophyta;Ericales;Anagallis;";"0.0";"0";"1";"1";"0";"1";"0";"457182";"391207"
"V4mis2";"SILVA (only NR);Eukaryota;Archaeplastida;Chloroplastida;Charophyta;Phragmoplastophyta;Streptophyta;Embryophyta;Tracheophyta;Spermatophyta;Magnoliophyta;Ericales;Androsace;";"0.0";"0";"1";"1";"0";"1";"0";"457182";"391207"
"V4mis2";"SILVA (only NR);Eukaryota;Archaeplastida;Chloroplastida;Charophyta;Phragmoplastophyta;Streptophyta;Embryophyta;Tracheophyta;Spermatophyta;Magnoliophyta;Ericales;Arbutus;";"0.0";"0";"1";"1";"0";"1";"0";"457182";"391207"
"V4mis2";"SILVA (only NR);Eukaryota;Archaeplastida;Chloroplastida;Charophyta;Phragmoplastophyta;Streptophyta;Embryophyta;Tracheophyta;Spermatophyta;Magnoliophyta;Ericales;Ardisia;";"0.0";"0";"1";"1";"0";"1";"0";"457182";"391207"
"V4mis2";"SILVA (only NR);Eukaryota;Archaeplastida;Chloroplastida;Charophyta;Phragmoplastophyta;Streptophyta;Embryophyta;Tracheophyta;Spermatophyta;Magnoliophyta;Ericales;Bonplandia;";"0.0";"0";"1";"1";"0";"1";"0";"457182";"391207"
"V4mis2";"SILVA (only NR);Eukaryota;Archaeplastida;Chloroplastida;Charophyta;Phragmoplastophyta;Streptophyta;Embryophyta;Tracheophyta;Spermatophyta;Magnoliophyta;Ericales;Calluna;";"0.0";"0";"1";"1";"0";"1";"0";"457182";"391207"
"V4mis2";"SILVA (only NR);Eukaryota;Archaeplastida;Chloroplastida;Charophyta;Phragmoplastophyta;Streptophyta;Embryophyta;Tracheophyta;Spermatophyta;Magnoliophyta;Ericales;Camellia;";"0.0";"0";"1";"1";"0";"1";"0";"457182";"391207"
"V4mis2";"SILVA (only NR);Eukaryota;Archaeplastida;Chloroplastida;Charophyta;Phragmoplastophyta;Streptophyta;Embryophyta;Tracheophyta;Spermatophyta;Magnoliophyta;Ericales;Cantua;";"0.0";"0";"1";"1";"0";"1";"0";"457182";"391207"
"V4mis2";"SILVA (only NR);Eukaryota;Archaeplastida;Chloroplastida;Charophyta;Phragmoplastophyta;Streptophyta;Embryophyta;Tracheophyta;Spermatophyta;Magnoliophyta;Ericales;Ceratiola;";"0.0";"0";"1";"1";"0";"1";"0";"457182";"391207"
"V4mis2";"SILVA (only NR);Eukaryota;Archaeplastida;Chloroplastida;Charophyta;Phragmoplastophyta;Streptophyta;Embryophyta;Tracheophyta;Spermatophyta;Magnoliophyta;Ericales;Chamaedaphne;";"0.0";"0";"1";"1";"0";"1";"0";"457182";"391207"
"V4mis2";"SILVA (only NR);Eukaryota;Archaeplastida;Chloroplastida;Charophyta;Phragmoplastophyta;Streptophyta;Embryophyta;Tracheophyta;Spermatophyta;Magnoliophyta;Ericales;Clavija;";"0.0";"0";"1";"1";"0";"1";"0";"457182";"391207"
"V4mis2";"SILVA (only NR);Eukaryota;Archaeplastida;Chloroplastida;Charophyta;Phragmoplastophyta;Streptophyta;Embryophyta;Tracheophyta;Spermatophyta;Magnoliophyta;Ericales;Clethra;";"0.0";"0";"1";"1";"0";"1";"0";"457182";"391207"
"V4mis2";"SILVA (only NR);Eukaryota;Archaeplastida;Chloroplastida;Charophyta;Phragmoplastophyta;Streptophyta;Embryophyta;Tracheophyta;Spermatophyta;Magnoliophyta;Ericales;Cosmelia;";"0.0";"0";"1";"1";"0";"1";"0";"457182";"391207"
"V4mis2";"SILVA (only NR);Eukaryota;Archaeplastida;Chloroplastida;Charophyta;Phragmoplastophyta;Streptophyta;Embryophyta;Tracheophyta;Spermatophyta;Magnoliophyta;Ericales;Couroupita;";"0.0";"0";"1";"1";"0";"1";"0";"457182";"391207"
"V4mis2";"SILVA (only NR);Eukaryota;Archaeplastida;Chloroplastida;Charophyta;Phragmoplastophyta;Streptophyta;Embryophyta;Tracheophyta;Spermatophyta;Magnoliophyta;Ericales;Cyrilla;";"0.0";"0";"1";"1";"0";"1";"0";"457182";"391207"
"V4mis2";"SILVA (only NR);Eukaryota;Archaeplastida;Chloroplastida;Charophyta;Phragmoplastophyta;Streptophyta;Embryophyta;Tracheophyta;Spermatophyta;Magnoliophyta;Ericales;Diospyros;";"0.0";"0";"2";"2";"0";"2";"0";"457181";"391207"
"V4mis2";"SILVA (only NR);Eukaryota;Archaeplastida;Chloroplastida;Charophyta;Phragmoplastophyta;Streptophyta;Embryophyta;Tracheophyta;Spermatophyta;Magnoliophyta;Ericales;Dracophyllum;";"0.0";"0";"1";"1";"0";"1";"0";"457182";"391207"
"V4mis2";"SILVA (only NR);Eukaryota;Archaeplastida;Chloroplastida;Charophyta;Phragmoplastophyta;Streptophyta;Embryophyta;Tracheophyta;Spermatophyta;Magnoliophyta;Ericales;Fouquieria;";"0.0";"0";"1";"1";"0";"1";"0";"457182";"391207"
"V4mis2";"SILVA (only NR);Eukaryota;Archaeplastida;Chloroplastida;Charophyta;Phragmoplastophyta;Streptophyta;Embryophyta;Tracheophyta;Spermatophyta;Magnoliophyta;Ericales;Galax;";"0.0";"0";"1";"1";"0";"1";"0";"457182";"391207"
"V4mis2";"SILVA (only NR);Eukaryota;Archaeplastida;Chloroplastida;Charophyta;Phragmoplastophyta;Streptophyta;Embryophyta;Tracheophyta;Spermatophyta;Magnoliophyta;Ericales;Gaultheria;";"0.0";"0";"1";"1";"0";"1";"0";"457182";"391207"
"V4mis2";"SILVA (only NR);Eukaryota;Archaeplastida;Chloroplastida;Charophyta;Phragmoplastophyta;Streptophyta;Embryophyta;Tracheophyta;Spermatophyta;Magnoliophyta;Ericales;Gilia;";"0.0";"0";"1";"1";"0";"1";"0";"457182";"391207"
"V4mis2";"SILVA (only NR);Eukaryota;Archaeplastida;Chloroplastida;Charophyta;Phragmoplastophyta;Streptophyta;Embryophyta;Tracheophyta;Spermatophyta;Magnoliophyta;Ericales;Halesia;";"0.0";"0";"1";"1";"0";"1";"0";"457182";"391207"
"V4mis2";"SILVA (only NR);Eukaryota;Archaeplastida;Chloroplastida;Charophyta;Phragmoplastophyta;Streptophyta;Embryophyta;Tracheophyta;Spermatophyta;Magnoliophyta;Ericales;Impatiens;";"0.0";"0";"1";"1";"0";"1";"0";"457182";"391207"
"V4mis2";"SILVA (only NR);Eukaryota;Archaeplastida;Chloroplastida;Charophyta;Phragmoplastophyta;Streptophyta;Embryophyta;Tracheophyta;Spermatophyta;Magnoliophyta;Ericales;Maesa;";"0.0";"0";"1";"1";"0";"1";"0";"457182";"391207"
"V4mis2";"SILVA (only NR);Eukaryota;Archaeplastida;Chloroplastida;Charophyta;Phragmoplastophyta;Streptophyta;Embryophyta;Tracheophyta;Spermatophyta;Magnoliophyta;Ericales;Manilkara;";"0.0";"0";"2";"2";"0";"2";"0";"457181";"391207"
"V4mis2";"SILVA (only NR);Eukaryota;Archaeplastida;Chloroplastida;Charophyta;Phragmoplastophyta;Streptophyta;Embryophyta;Tracheophyta;Spermatophyta;Magnoliophyta;Ericales;Mitrastemon;";"0.0";"0";"1";"1";"0";"1";"0";"457182";"391207"
"V4mis2";"SILVA (only NR);Eukaryota;Archaeplastida;Chloroplastida;Charophyta;Phragmoplastophyta;Streptophyta;Embryophyta;Tracheophyta;Spermatophyta;Magnoliophyta;Ericales;Monotropa;";"0.0";"0";"1";"1";"0";"1";"0";"457182";"391207"
"V4mis2";"SILVA (only NR);Eukaryota;Archaeplastida;Chloroplastida;Charophyta;Phragmoplastophyta;Streptophyta;Embryophyta;Tracheophyta;Spermatophyta;Magnoliophyta;Ericales;Pityopus;";"0.0";"0";"1";"1";"0";"1";"0";"457182";"391207"
"V4mis2";"SILVA (only NR);Eukaryota;Archaeplastida;Chloroplastida;Charophyta;Phragmoplastophyta;Streptophyta;Embryophyta;Tracheophyta;Spermatophyta;Magnoliophyta;Ericales;Primula;";"0.0";"0";"2";"2";"0";"2";"0";"457181";"391207"
"V4mis2";"SILVA (only NR);Eukaryota;Archaeplastida;Chloroplastida;Charophyta;Phragmoplastophyta;Streptophyta;Embryophyta;Tracheophyta;Spermatophyta;Magnoliophyta;Ericales;Prionotes;";"0.0";"0";"1";"1";"0";"1";"0";"457182";"391207"
"V4mis2";"SILVA (only NR);Eukaryota;Archaeplastida;Chloroplastida;Charophyta;Phragmoplastophyta;Streptophyta;Embryophyta;Tracheophyta;Spermatophyta;Magnoliophyta;Ericales;Pyrola;";"0.0";"0";"1";"1";"0";"1";"0";"457182";"391207"
"V4mis2";"SILVA (only NR);Eukaryota;Archaeplastida;Chloroplastida;Charophyta;Phragmoplastophyta;Streptophyta;Embryophyta;Tracheophyta;Spermatophyta;Magnoliophyta;Ericales;Rhododendron;";"0.0";"0";"1";"1";"0";"1";"0";"457182";"391207"
"V4mis2";"SILVA (only NR);Eukaryota;Archaeplastida;Chloroplastida;Charophyta;Phragmoplastophyta;Streptophyta;Embryophyta;Tracheophyta;Spermatophyta;Magnoliophyta;Ericales;Sarcodes;";"0.0";"0";"1";"1";"0";"1";"0";"457182";"391207"
"V4mis2";"SILVA (only NR);Eukaryota;Archaeplastida;Chloroplastida;Charophyta;Phragmoplastophyta;Streptophyta;Embryophyta;Tracheophyta;Spermatophyta;Magnoliophyta;Ericales;Sarracenia;";"0.0";"0";"1";"1";"0";"1";"0";"457182";"391207"
"V4mis2";"SILVA (only NR);Eukaryota;Archaeplastida;Chloroplastida;Charophyta;Phragmoplastophyta;Streptophyta;Embryophyta;Tracheophyta;Spermatophyta;Magnoliophyta;Ericales;Styrax;";"0.0";"0";"2";"2";"0";"2";"0";"457181";"391207"
"V4mis2";"SILVA (only NR);Eukaryota;Archaeplastida;Chloroplastida;Charophyta;Phragmoplastophyta;Streptophyta;Embryophyta;Tracheophyta;Spermatophyta;Magnoliophyta;Ericales;Symplocos;";"0.0";"0";"1";"1";"0";"1";"0";"457182";"391207"
"V4mis2";"SILVA (only NR);Eukaryota;Archaeplastida;Chloroplastida;Charophyta;Phragmoplastophyta;Streptophyta;Embryophyta;Tracheophyta;Spermatophyta;Magnoliophyta;Ericales;Tetramerista;";"0.0";"0";"1";"1";"0";"1";"0";"457182";"391207"
"V4mis2";"SILVA (only NR);Eukaryota;Archaeplastida;Chloroplastida;Charophyta;Phragmoplastophyta;Streptophyta;Embryophyta;Tracheophyta;Spermatophyta;Magnoliophyta;Ericales;Vaccinium;";"0.0";"0";"2";"2";"0";"2";"0";"457181";"391207"
"V4mis2";"SILVA (only NR);Eukaryota;Archaeplastida;Chloroplastida;Charophyta;Phragmoplastophyta;Streptophyta;Embryophyta;Tracheophyta;Spermatophyta;Magnoliophyta;Escalloniales;";"0.0";"0";"2";"2";"0";"2";"0";"457181";"391207"
"V4mis2";"SILVA (only NR);Eukaryota;Archaeplastida;Chloroplastida;Charophyta;Phragmoplastophyta;Streptophyta;Embryophyta;Tracheophyta;Spermatophyta;Magnoliophyta;Escalloniales;Eremosyne;";"0.0";"0";"1";"1";"0";"1";"0";"457182";"391207"
"V4mis2";"SILVA (only NR);Eukaryota;Archaeplastida;Chloroplastida;Charophyta;Phragmoplastophyta;Streptophyta;Embryophyta;Tracheophyta;Spermatophyta;Magnoliophyta;Escalloniales;Escallonia;";"0.0";"0";"1";"1";"0";"1";"0";"457182";"391207"
"V4mis2";"SILVA (only NR);Eukaryota;Archaeplastida;Chloroplastida;Charophyta;Phragmoplastophyta;Streptophyta;Embryophyta;Tracheophyta;Spermatophyta;Magnoliophyta;Fabales;";"7.4";"14.4";"209";"204";"15";"189";"5";"456979";"391192"
"V4mis2";"SILVA (only NR);Eukaryota;Archaeplastida;Chloroplastida;Charophyta;Phragmoplastophyta;Streptophyta;Embryophyta;Tracheophyta;Spermatophyta;Magnoliophyta;Fabales;Ammopiptanthus;";"6.7";"14.4";"15";"15";"1";"14";"0";"457168";"391206"
"V4mis2";"SILVA (only NR);Eukaryota;Archaeplastida;Chloroplastida;Charophyta;Phragmoplastophyta;Streptophyta;Embryophyta;Tracheophyta;Spermatophyta;Magnoliophyta;Fabales;Apios;";"0.0";"0";"1";"1";"0";"1";"0";"457182";"391207"
"V4mis2";"SILVA (only NR);Eukaryota;Archaeplastida;Chloroplastida;Charophyta;Phragmoplastophyta;Streptophyta;Embryophyta;Tracheophyta;Spermatophyta;Magnoliophyta;Fabales;Arachis;";"41.9";"14.4";"31";"31";"13";"18";"0";"457152";"391194"
"V4mis2";"SILVA (only NR);Eukaryota;Archaeplastida;Chloroplastida;Charophyta;Phragmoplastophyta;Streptophyta;Embryophyta;Tracheophyta;Spermatophyta;Magnoliophyta;Fabales;Astragalus;";"0.0";"0";"4";"4";"0";"4";"0";"457179";"391207"
"V4mis2";"SILVA (only NR);Eukaryota;Archaeplastida;Chloroplastida;Charophyta;Phragmoplastophyta;Streptophyta;Embryophyta;Tracheophyta;Spermatophyta;Magnoliophyta;Fabales;Bauhinia;";"0.0";"0";"1";"1";"0";"1";"0";"457182";"391207"
"V4mis2";"SILVA (only NR);Eukaryota;Archaeplastida;Chloroplastida;Charophyta;Phragmoplastophyta;Streptophyta;Embryophyta;Tracheophyta;Spermatophyta;Magnoliophyta;Fabales;Cajanus;";"0.0";"0";"6";"6";"0";"6";"0";"457177";"391207"
"V4mis2";"SILVA (only NR);Eukaryota;Archaeplastida;Chloroplastida;Charophyta;Phragmoplastophyta;Streptophyta;Embryophyta;Tracheophyta;Spermatophyta;Magnoliophyta;Fabales;Cercis;";"0.0";"0";"1";"1";"0";"1";"0";"457182";"391207"
"V4mis2";"SILVA (only NR);Eukaryota;Archaeplastida;Chloroplastida;Charophyta;Phragmoplastophyta;Streptophyta;Embryophyta;Tracheophyta;Spermatophyta;Magnoliophyta;Fabales;Chamaecrista;";"0.0";"0";"1";"1";"0";"1";"0";"457182";"391207"
"V4mis2";"SILVA (only NR);Eukaryota;Archaeplastida;Chloroplastida;Charophyta;Phragmoplastophyta;Streptophyta;Embryophyta;Tracheophyta;Spermatophyta;Magnoliophyta;Fabales;Cicer;";"0.0";"0";"11";"11";"0";"11";"0";"457172";"391207"
"V4mis2";"SILVA (only NR);Eukaryota;Archaeplastida;Chloroplastida;Charophyta;Phragmoplastophyta;Streptophyta;Embryophyta;Tracheophyta;Spermatophyta;Magnoliophyta;Fabales;Cynometra;";"0.0";"0";"1";"1";"0";"1";"0";"457182";"391207"
"V4mis2";"SILVA (only NR);Eukaryota;Archaeplastida;Chloroplastida;Charophyta;Phragmoplastophyta;Streptophyta;Embryophyta;Tracheophyta;Spermatophyta;Magnoliophyta;Fabales;Erythrina;";"0.0";"0";"1";"1";"0";"1";"0";"457182";"391207"
"V4mis2";"SILVA (only NR);Eukaryota;Archaeplastida;Chloroplastida;Charophyta;Phragmoplastophyta;Streptophyta;Embryophyta;Tracheophyta;Spermatophyta;Magnoliophyta;Fabales;Glycine;";"0.0";"0";"2";"2";"0";"2";"0";"457181";"391207"
"V4mis2";"SILVA (only NR);Eukaryota;Archaeplastida;Chloroplastida;Charophyta;Phragmoplastophyta;Streptophyta;Embryophyta;Tracheophyta;Spermatophyta;Magnoliophyta;Fabales;Lotus;";"0.0";"0";"2";"2";"0";"2";"0";"457181";"391207"
"V4mis2";"SILVA (only NR);Eukaryota;Archaeplastida;Chloroplastida;Charophyta;Phragmoplastophyta;Streptophyta;Embryophyta;Tracheophyta;Spermatophyta;Magnoliophyta;Fabales;Lupinus;";"3.3";"14.4";"31";"30";"1";"29";"1";"457153";"391206"
"V4mis2";"SILVA (only NR);Eukaryota;Archaeplastida;Chloroplastida;Charophyta;Phragmoplastophyta;Streptophyta;Embryophyta;Tracheophyta;Spermatophyta;Magnoliophyta;Fabales;Medicago;";"0.0";"0";"10";"10";"0";"10";"0";"457173";"391207"
"V4mis2";"SILVA (only NR);Eukaryota;Archaeplastida;Chloroplastida;Charophyta;Phragmoplastophyta;Streptophyta;Embryophyta;Tracheophyta;Spermatophyta;Magnoliophyta;Fabales;Mezoneuron;";"0.0";"0";"1";"1";"0";"1";"0";"457182";"391207"
"V4mis2";"SILVA (only NR);Eukaryota;Archaeplastida;Chloroplastida;Charophyta;Phragmoplastophyta;Streptophyta;Embryophyta;Tracheophyta;Spermatophyta;Magnoliophyta;Fabales;Oxytropis;";"0.0";"0";"2";"2";"0";"2";"0";"457181";"391207"
"V4mis2";"SILVA (only NR);Eukaryota;Archaeplastida;Chloroplastida;Charophyta;Phragmoplastophyta;Streptophyta;Embryophyta;Tracheophyta;Spermatophyta;Magnoliophyta;Fabales;Phaseolus;";"0.0";"0";"36";"33";"0";"33";"3";"457150";"391207"
"V4mis2";"SILVA (only NR);Eukaryota;Archaeplastida;Chloroplastida;Charophyta;Phragmoplastophyta;Streptophyta;Embryophyta;Tracheophyta;Spermatophyta;Magnoliophyta;Fabales;Polygala;";"0.0";"0";"2";"2";"0";"2";"0";"457181";"391207"
"V4mis2";"SILVA (only NR);Eukaryota;Archaeplastida;Chloroplastida;Charophyta;Phragmoplastophyta;Streptophyta;Embryophyta;Tracheophyta;Spermatophyta;Magnoliophyta;Fabales;Robinia;";"0.0";"0";"1";"1";"0";"1";"0";"457182";"391207"
"V4mis2";"SILVA (only NR);Eukaryota;Archaeplastida;Chloroplastida;Charophyta;Phragmoplastophyta;Streptophyta;Embryophyta;Tracheophyta;Spermatophyta;Magnoliophyta;Fabales;Securidaca;";"0.0";"0";"1";"1";"0";"1";"0";"457182";"391207"
"V4mis2";"SILVA (only NR);Eukaryota;Archaeplastida;Chloroplastida;Charophyta;Phragmoplastophyta;Streptophyta;Embryophyta;Tracheophyta;Spermatophyta;Magnoliophyta;Fabales;Senna;";"0.0";"0";"1";"1";"0";"1";"0";"457182";"391207"
"V4mis2";"SILVA (only NR);Eukaryota;Archaeplastida;Chloroplastida;Charophyta;Phragmoplastophyta;Streptophyta;Embryophyta;Tracheophyta;Spermatophyta;Magnoliophyta;Fabales;Stylobasium;";"0.0";"0";"1";"1";"0";"1";"0";"457182";"391207"
"V4mis2";"SILVA (only NR);Eukaryota;Archaeplastida;Chloroplastida;Charophyta;Phragmoplastophyta;Streptophyta;Embryophyta;Tracheophyta;Spermatophyta;Magnoliophyta;Fabales;Trifolium;";"0.0";"0";"1";"1";"0";"1";"0";"457182";"391207"
"V4mis2";"SILVA (only NR);Eukaryota;Archaeplastida;Chloroplastida;Charophyta;Phragmoplastophyta;Streptophyta;Embryophyta;Tracheophyta;Spermatophyta;Magnoliophyta;Fabales;Vigna;";"0.0";"0";"44";"43";"0";"43";"1";"457140";"391207"
"V4mis2";"SILVA (only NR);Eukaryota;Archaeplastida;Chloroplastida;Charophyta;Phragmoplastophyta;Streptophyta;Embryophyta;Tracheophyta;Spermatophyta;Magnoliophyta;Fabales;Wisteria;";"0.0";"0";"1";"1";"0";"1";"0";"457182";"391207"
"V4mis2";"SILVA (only NR);Eukaryota;Archaeplastida;Chloroplastida;Charophyta;Phragmoplastophyta;Streptophyta;Embryophyta;Tracheophyta;Spermatophyta;Magnoliophyta;Fagales;";"0.0";"0";"27";"27";"0";"27";"0";"457156";"391207"
"V4mis2";"SILVA (only NR);Eukaryota;Archaeplastida;Chloroplastida;Charophyta;Phragmoplastophyta;Streptophyta;Embryophyta;Tracheophyta;Spermatophyta;Magnoliophyta;Fagales;Alnus;";"0.0";"0";"1";"1";"0";"1";"0";"457182";"391207"
"V4mis2";"SILVA (only NR);Eukaryota;Archaeplastida;Chloroplastida;Charophyta;Phragmoplastophyta;Streptophyta;Embryophyta;Tracheophyta;Spermatophyta;Magnoliophyta;Fagales;Betula;";"0.0";"0";"5";"5";"0";"5";"0";"457178";"391207"
"V4mis2";"SILVA (only NR);Eukaryota;Archaeplastida;Chloroplastida;Charophyta;Phragmoplastophyta;Streptophyta;Embryophyta;Tracheophyta;Spermatophyta;Magnoliophyta;Fagales;Carya;";"0.0";"0";"1";"1";"0";"1";"0";"457182";"391207"
"V4mis2";"SILVA (only NR);Eukaryota;Archaeplastida;Chloroplastida;Charophyta;Phragmoplastophyta;Streptophyta;Embryophyta;Tracheophyta;Spermatophyta;Magnoliophyta;Fagales;Castanea;";"0.0";"0";"2";"2";"0";"2";"0";"457181";"391207"
"V4mis2";"SILVA (only NR);Eukaryota;Archaeplastida;Chloroplastida;Charophyta;Phragmoplastophyta;Streptophyta;Embryophyta;Tracheophyta;Spermatophyta;Magnoliophyta;Fagales;Castanopsis;";"0.0";"0";"1";"1";"0";"1";"0";"457182";"391207"
"V4mis2";"SILVA (only NR);Eukaryota;Archaeplastida;Chloroplastida;Charophyta;Phragmoplastophyta;Streptophyta;Embryophyta;Tracheophyta;Spermatophyta;Magnoliophyta;Fagales;Casuarina;";"0.0";"0";"1";"1";"0";"1";"0";"457182";"391207"
"V4mis2";"SILVA (only NR);Eukaryota;Archaeplastida;Chloroplastida;Charophyta;Phragmoplastophyta;Streptophyta;Embryophyta;Tracheophyta;Spermatophyta;Magnoliophyta;Fagales;Lithocarpus;";"0.0";"0";"1";"1";"0";"1";"0";"457182";"391207"
"V4mis2";"SILVA (only NR);Eukaryota;Archaeplastida;Chloroplastida;Charophyta;Phragmoplastophyta;Streptophyta;Embryophyta;Tracheophyta;Spermatophyta;Magnoliophyta;Fagales;Myrica;";"0.0";"0";"3";"3";"0";"3";"0";"457180";"391207"
"V4mis2";"SILVA (only NR);Eukaryota;Archaeplastida;Chloroplastida;Charophyta;Phragmoplastophyta;Streptophyta;Embryophyta;Tracheophyta;Spermatophyta;Magnoliophyta;Fagales;Nothofagus;";"0.0";"0";"1";"1";"0";"1";"0";"457182";"391207"
"V4mis2";"SILVA (only NR);Eukaryota;Archaeplastida;Chloroplastida;Charophyta;Phragmoplastophyta;Streptophyta;Embryophyta;Tracheophyta;Spermatophyta;Magnoliophyta;Fagales;Quercus;";"0.0";"0";"9";"9";"0";"9";"0";"457174";"391207"
"V4mis2";"SILVA (only NR);Eukaryota;Archaeplastida;Chloroplastida;Charophyta;Phragmoplastophyta;Streptophyta;Embryophyta;Tracheophyta;Spermatophyta;Magnoliophyta;Fagales;Ticodendron;";"0.0";"0";"1";"1";"0";"1";"0";"457182";"391207"
"V4mis2";"SILVA (only NR);Eukaryota;Archaeplastida;Chloroplastida;Charophyta;Phragmoplastophyta;Streptophyta;Embryophyta;Tracheophyta;Spermatophyta;Magnoliophyta;Fagales;Trigonobalanus;";"0.0";"0";"1";"1";"0";"1";"0";"457182";"391207"
"V4mis2";"SILVA (only NR);Eukaryota;Archaeplastida;Chloroplastida;Charophyta;Phragmoplastophyta;Streptophyta;Embryophyta;Tracheophyta;Spermatophyta;Magnoliophyta;Garryales;";"0.0";"0";"2";"2";"0";"2";"0";"457181";"391207"
"V4mis2";"SILVA (only NR);Eukaryota;Archaeplastida;Chloroplastida;Charophyta;Phragmoplastophyta;Streptophyta;Embryophyta;Tracheophyta;Spermatophyta;Magnoliophyta;Garryales;Eucommia;";"0.0";"0";"1";"1";"0";"1";"0";"457182";"391207"
"V4mis2";"SILVA (only NR);Eukaryota;Archaeplastida;Chloroplastida;Charophyta;Phragmoplastophyta;Streptophyta;Embryophyta;Tracheophyta;Spermatophyta;Magnoliophyta;Garryales;Garrya;";"0.0";"0";"1";"1";"0";"1";"0";"457182";"391207"
"V4mis2";"SILVA (only NR);Eukaryota;Archaeplastida;Chloroplastida;Charophyta;Phragmoplastophyta;Streptophyta;Embryophyta;Tracheophyta;Spermatophyta;Magnoliophyta;Gentianales;";"0.0";"0";"45";"45";"0";"45";"0";"457138";"391207"
"V4mis2";"SILVA (only NR);Eukaryota;Archaeplastida;Chloroplastida;Charophyta;Phragmoplastophyta;Streptophyta;Embryophyta;Tracheophyta;Spermatophyta;Magnoliophyta;Gentianales;Asclepias;";"0.0";"0";"1";"1";"0";"1";"0";"457182";"391207"
"V4mis2";"SILVA (only NR);Eukaryota;Archaeplastida;Chloroplastida;Charophyta;Phragmoplastophyta;Streptophyta;Embryophyta;Tracheophyta;Spermatophyta;Magnoliophyta;Gentianales;Catharanthus;";"0.0";"0";"8";"8";"0";"8";"0";"457175";"391207"
"V4mis2";"SILVA (only NR);Eukaryota;Archaeplastida;Chloroplastida;Charophyta;Phragmoplastophyta;Streptophyta;Embryophyta;Tracheophyta;Spermatophyta;Magnoliophyta;Gentianales;Chelonanthus;";"0.0";"0";"1";"1";"0";"1";"0";"457182";"391207"
"V4mis2";"SILVA (only NR);Eukaryota;Archaeplastida;Chloroplastida;Charophyta;Phragmoplastophyta;Streptophyta;Embryophyta;Tracheophyta;Spermatophyta;Magnoliophyta;Gentianales;Coffea;";"0.0";"0";"1";"1";"0";"1";"0";"457182";"391207"
"V4mis2";"SILVA (only NR);Eukaryota;Archaeplastida;Chloroplastida;Charophyta;Phragmoplastophyta;Streptophyta;Embryophyta;Tracheophyta;Spermatophyta;Magnoliophyta;Gentianales;Dialypetalanthus;";"0.0";"0";"1";"1";"0";"1";"0";"457182";"391207"
"V4mis2";"SILVA (only NR);Eukaryota;Archaeplastida;Chloroplastida;Charophyta;Phragmoplastophyta;Streptophyta;Embryophyta;Tracheophyta;Spermatophyta;Magnoliophyta;Gentianales;Erithalis;";"0.0";"0";"1";"1";"0";"1";"0";"457182";"391207"
"V4mis2";"SILVA (only NR);Eukaryota;Archaeplastida;Chloroplastida;Charophyta;Phragmoplastophyta;Streptophyta;Embryophyta;Tracheophyta;Spermatophyta;Magnoliophyta;Gentianales;Exacum;";"0.0";"0";"2";"2";"0";"2";"0";"457181";"391207"
"V4mis2";"SILVA (only NR);Eukaryota;Archaeplastida;Chloroplastida;Charophyta;Phragmoplastophyta;Streptophyta;Embryophyta;Tracheophyta;Spermatophyta;Magnoliophyta;Gentianales;Exochaenium;";"0.0";"0";"2";"2";"0";"2";"0";"457181";"391207"
"V4mis2";"SILVA (only NR);Eukaryota;Archaeplastida;Chloroplastida;Charophyta;Phragmoplastophyta;Streptophyta;Embryophyta;Tracheophyta;Spermatophyta;Magnoliophyta;Gentianales;Galium;";"0.0";"0";"1";"1";"0";"1";"0";"457182";"391207"
"V4mis2";"SILVA (only NR);Eukaryota;Archaeplastida;Chloroplastida;Charophyta;Phragmoplastophyta;Streptophyta;Embryophyta;Tracheophyta;Spermatophyta;Magnoliophyta;Gentianales;Gelsemium;";"0.0";"0";"1";"1";"0";"1";"0";"457182";"391207"
"V4mis2";"SILVA (only NR);Eukaryota;Archaeplastida;Chloroplastida;Charophyta;Phragmoplastophyta;Streptophyta;Embryophyta;Tracheophyta;Spermatophyta;Magnoliophyta;Gentianales;Geniostoma;";"0.0";"0";"1";"1";"0";"1";"0";"457182";"391207"
"V4mis2";"SILVA (only NR);Eukaryota;Archaeplastida;Chloroplastida;Charophyta;Phragmoplastophyta;Streptophyta;Embryophyta;Tracheophyta;Spermatophyta;Magnoliophyta;Gentianales;Gentianella;";"0.0";"0";"1";"1";"0";"1";"0";"457182";"391207"
"V4mis2";"SILVA (only NR);Eukaryota;Archaeplastida;Chloroplastida;Charophyta;Phragmoplastophyta;Streptophyta;Embryophyta;Tracheophyta;Spermatophyta;Magnoliophyta;Gentianales;Lisianthius;";"0.0";"0";"1";"1";"0";"1";"0";"457182";"391207"
"V4mis2";"SILVA (only NR);Eukaryota;Archaeplastida;Chloroplastida;Charophyta;Phragmoplastophyta;Streptophyta;Embryophyta;Tracheophyta;Spermatophyta;Magnoliophyta;Gentianales;Lomatogonium;";"0.0";"0";"1";"1";"0";"1";"0";"457182";"391207"
"V4mis2";"SILVA (only NR);Eukaryota;Archaeplastida;Chloroplastida;Charophyta;Phragmoplastophyta;Streptophyta;Embryophyta;Tracheophyta;Spermatophyta;Magnoliophyta;Gentianales;Macrocarpaea;";"0.0";"0";"1";"1";"0";"1";"0";"457182";"391207"
"V4mis2";"SILVA (only NR);Eukaryota;Archaeplastida;Chloroplastida;Charophyta;Phragmoplastophyta;Streptophyta;Embryophyta;Tracheophyta;Spermatophyta;Magnoliophyta;Gentianales;Mitchella;";"0.0";"0";"1";"1";"0";"1";"0";"457182";"391207"
"V4mis2";"SILVA (only NR);Eukaryota;Archaeplastida;Chloroplastida;Charophyta;Phragmoplastophyta;Streptophyta;Embryophyta;Tracheophyta;Spermatophyta;Magnoliophyta;Gentianales;Neolamarckia;";"0.0";"0";"1";"1";"0";"1";"0";"457182";"391207"
"V4mis2";"SILVA (only NR);Eukaryota;Archaeplastida;Chloroplastida;Charophyta;Phragmoplastophyta;Streptophyta;Embryophyta;Tracheophyta;Spermatophyta;Magnoliophyta;Gentianales;Nertera;";"0.0";"0";"1";"1";"0";"1";"0";"457182";"391207"
"V4mis2";"SILVA (only NR);Eukaryota;Archaeplastida;Chloroplastida;Charophyta;Phragmoplastophyta;Streptophyta;Embryophyta;Tracheophyta;Spermatophyta;Magnoliophyta;Gentianales;Ophiorrhiza;";"0.0";"0";"1";"1";"0";"1";"0";"457182";"391207"
"V4mis2";"SILVA (only NR);Eukaryota;Archaeplastida;Chloroplastida;Charophyta;Phragmoplastophyta;Streptophyta;Embryophyta;Tracheophyta;Spermatophyta;Magnoliophyta;Gentianales;Orphium;";"0.0";"0";"1";"1";"0";"1";"0";"457182";"391207"
"V4mis2";"SILVA (only NR);Eukaryota;Archaeplastida;Chloroplastida;Charophyta;Phragmoplastophyta;Streptophyta;Embryophyta;Tracheophyta;Spermatophyta;Magnoliophyta;Gentianales;Pentas;";"0.0";"0";"1";"1";"0";"1";"0";"457182";"391207"
"V4mis2";"SILVA (only NR);Eukaryota;Archaeplastida;Chloroplastida;Charophyta;Phragmoplastophyta;Streptophyta;Embryophyta;Tracheophyta;Spermatophyta;Magnoliophyta;Gentianales;Rhazya;";"0.0";"0";"1";"1";"0";"1";"0";"457182";"391207"
"V4mis2";"SILVA (only NR);Eukaryota;Archaeplastida;Chloroplastida;Charophyta;Phragmoplastophyta;Streptophyta;Embryophyta;Tracheophyta;Spermatophyta;Magnoliophyta;Gentianales;Rogiera;";"0.0";"0";"1";"1";"0";"1";"0";"457182";"391207"
"V4mis2";"SILVA (only NR);Eukaryota;Archaeplastida;Chloroplastida;Charophyta;Phragmoplastophyta;Streptophyta;Embryophyta;Tracheophyta;Spermatophyta;Magnoliophyta;Gentianales;Schinziella;";"0.0";"0";"1";"1";"0";"1";"0";"457182";"391207"
"V4mis2";"SILVA (only NR);Eukaryota;Archaeplastida;Chloroplastida;Charophyta;Phragmoplastophyta;Streptophyta;Embryophyta;Tracheophyta;Spermatophyta;Magnoliophyta;Gentianales;Schultesia;";"0.0";"0";"1";"1";"0";"1";"0";"457182";"391207"
"V4mis2";"SILVA (only NR);Eukaryota;Archaeplastida;Chloroplastida;Charophyta;Phragmoplastophyta;Streptophyta;Embryophyta;Tracheophyta;Spermatophyta;Magnoliophyta;Gentianales;Spigelia;";"0.0";"0";"1";"1";"0";"1";"0";"457182";"391207"
"V4mis2";"SILVA (only NR);Eukaryota;Archaeplastida;Chloroplastida;Charophyta;Phragmoplastophyta;Streptophyta;Embryophyta;Tracheophyta;Spermatophyta;Magnoliophyta;Gentianales;Swertia;";"0.0";"0";"1";"1";"0";"1";"0";"457182";"391207"
"V4mis2";"SILVA (only NR);Eukaryota;Archaeplastida;Chloroplastida;Charophyta;Phragmoplastophyta;Streptophyta;Embryophyta;Tracheophyta;Spermatophyta;Magnoliophyta;Gentianales;Voyria;";"0.0";"0";"8";"8";"0";"8";"0";"457175";"391207"
"V4mis2";"SILVA (only NR);Eukaryota;Archaeplastida;Chloroplastida;Charophyta;Phragmoplastophyta;Streptophyta;Embryophyta;Tracheophyta;Spermatophyta;Magnoliophyta;Gentianales;Voyriella;";"0.0";"0";"1";"1";"0";"1";"0";"457182";"391207"
"V4mis2";"SILVA (only NR);Eukaryota;Archaeplastida;Chloroplastida;Charophyta;Phragmoplastophyta;Streptophyta;Embryophyta;Tracheophyta;Spermatophyta;Magnoliophyta;Geraniales;";"0.0";"0";"5";"5";"0";"5";"0";"457178";"391207"
"V4mis2";"SILVA (only NR);Eukaryota;Archaeplastida;Chloroplastida;Charophyta;Phragmoplastophyta;Streptophyta;Embryophyta;Tracheophyta;Spermatophyta;Magnoliophyta;Geraniales;Bersama;";"0.0";"0";"1";"1";"0";"1";"0";"457182";"391207"
"V4mis2";"SILVA (only NR);Eukaryota;Archaeplastida;Chloroplastida;Charophyta;Phragmoplastophyta;Streptophyta;Embryophyta;Tracheophyta;Spermatophyta;Magnoliophyta;Geraniales;Francoa;";"0.0";"0";"1";"1";"0";"1";"0";"457182";"391207"
"V4mis2";"SILVA (only NR);Eukaryota;Archaeplastida;Chloroplastida;Charophyta;Phragmoplastophyta;Streptophyta;Embryophyta;Tracheophyta;Spermatophyta;Magnoliophyta;Geraniales;Geranium;";"0.0";"0";"1";"1";"0";"1";"0";"457182";"391207"
"V4mis2";"SILVA (only NR);Eukaryota;Archaeplastida;Chloroplastida;Charophyta;Phragmoplastophyta;Streptophyta;Embryophyta;Tracheophyta;Spermatophyta;Magnoliophyta;Geraniales;Greyia;";"0.0";"0";"1";"1";"0";"1";"0";"457182";"391207"
"V4mis2";"SILVA (only NR);Eukaryota;Archaeplastida;Chloroplastida;Charophyta;Phragmoplastophyta;Streptophyta;Embryophyta;Tracheophyta;Spermatophyta;Magnoliophyta;Geraniales;Viviania;";"0.0";"0";"1";"1";"0";"1";"0";"457182";"391207"
"V4mis2";"SILVA (only NR);Eukaryota;Archaeplastida;Chloroplastida;Charophyta;Phragmoplastophyta;Streptophyta;Embryophyta;Tracheophyta;Spermatophyta;Magnoliophyta;Gunnerales;";"0.0";"0";"2";"2";"0";"2";"0";"457181";"391207"
"V4mis2";"SILVA (only NR);Eukaryota;Archaeplastida;Chloroplastida;Charophyta;Phragmoplastophyta;Streptophyta;Embryophyta;Tracheophyta;Spermatophyta;Magnoliophyta;Gunnerales;Gunnera;";"0.0";"0";"1";"1";"0";"1";"0";"457182";"391207"
"V4mis2";"SILVA (only NR);Eukaryota;Archaeplastida;Chloroplastida;Charophyta;Phragmoplastophyta;Streptophyta;Embryophyta;Tracheophyta;Spermatophyta;Magnoliophyta;Gunnerales;Myrothamnus;";"0.0";"0";"1";"1";"0";"1";"0";"457182";"391207"
"V4mis2";"SILVA (only NR);Eukaryota;Archaeplastida;Chloroplastida;Charophyta;Phragmoplastophyta;Streptophyta;Embryophyta;Tracheophyta;Spermatophyta;Magnoliophyta;Huerteales;";"0.0";"0";"1";"1";"0";"1";"0";"457182";"391207"
"V4mis2";"SILVA (only NR);Eukaryota;Archaeplastida;Chloroplastida;Charophyta;Phragmoplastophyta;Streptophyta;Embryophyta;Tracheophyta;Spermatophyta;Magnoliophyta;Huerteales;Tapiscia;";"0.0";"0";"1";"1";"0";"1";"0";"457182";"391207"
"V4mis2";"SILVA (only NR);Eukaryota;Archaeplastida;Chloroplastida;Charophyta;Phragmoplastophyta;Streptophyta;Embryophyta;Tracheophyta;Spermatophyta;Magnoliophyta;Icacinales;";"0.0";"0";"1";"1";"0";"1";"0";"457182";"391207"
"V4mis2";"SILVA (only NR);Eukaryota;Archaeplastida;Chloroplastida;Charophyta;Phragmoplastophyta;Streptophyta;Embryophyta;Tracheophyta;Spermatophyta;Magnoliophyta;Icacinales;Nothapodytes;";"0.0";"0";"1";"1";"0";"1";"0";"457182";"391207"
"V4mis2";"SILVA (only NR);Eukaryota;Archaeplastida;Chloroplastida;Charophyta;Phragmoplastophyta;Streptophyta;Embryophyta;Tracheophyta;Spermatophyta;Magnoliophyta;Incertae Sedis;";"0.0";"0";"2";"2";"0";"2";"0";"457181";"391207"
"V4mis2";"SILVA (only NR);Eukaryota;Archaeplastida;Chloroplastida;Charophyta;Phragmoplastophyta;Streptophyta;Embryophyta;Tracheophyta;Spermatophyta;Magnoliophyta;Incertae Sedis;Oncotheca;";"0.0";"0";"1";"1";"0";"1";"0";"457182";"391207"
"V4mis2";"SILVA (only NR);Eukaryota;Archaeplastida;Chloroplastida;Charophyta;Phragmoplastophyta;Streptophyta;Embryophyta;Tracheophyta;Spermatophyta;Magnoliophyta;Incertae Sedis;Vahlia;";"0.0";"0";"1";"1";"0";"1";"0";"457182";"391207"
"V4mis2";"SILVA (only NR);Eukaryota;Archaeplastida;Chloroplastida;Charophyta;Phragmoplastophyta;Streptophyta;Embryophyta;Tracheophyta;Spermatophyta;Magnoliophyta;Lamiales;";"0.0";"0";"83";"83";"0";"83";"0";"457100";"391207"
"V4mis2";"SILVA (only NR);Eukaryota;Archaeplastida;Chloroplastida;Charophyta;Phragmoplastophyta;Streptophyta;Embryophyta;Tracheophyta;Spermatophyta;Magnoliophyta;Lamiales;Aeginetia;";"0.0";"0";"1";"1";"0";"1";"0";"457182";"391207"
"V4mis2";"SILVA (only NR);Eukaryota;Archaeplastida;Chloroplastida;Charophyta;Phragmoplastophyta;Streptophyta;Embryophyta;Tracheophyta;Spermatophyta;Magnoliophyta;Lamiales;Andrographis;";"0.0";"0";"1";"1";"0";"1";"0";"457182";"391207"
"V4mis2";"SILVA (only NR);Eukaryota;Archaeplastida;Chloroplastida;Charophyta;Phragmoplastophyta;Streptophyta;Embryophyta;Tracheophyta;Spermatophyta;Magnoliophyta;Lamiales;Aphyllon;";"0.0";"0";"2";"2";"0";"2";"0";"457181";"391207"
"V4mis2";"SILVA (only NR);Eukaryota;Archaeplastida;Chloroplastida;Charophyta;Phragmoplastophyta;Streptophyta;Embryophyta;Tracheophyta;Spermatophyta;Magnoliophyta;Lamiales;Avicennia;";"0.0";"0";"1";"1";"0";"1";"0";"457182";"391207"
"V4mis2";"SILVA (only NR);Eukaryota;Archaeplastida;Chloroplastida;Charophyta;Phragmoplastophyta;Streptophyta;Embryophyta;Tracheophyta;Spermatophyta;Magnoliophyta;Lamiales;Bacopa;";"0.0";"0";"1";"1";"0";"1";"0";"457182";"391207"
"V4mis2";"SILVA (only NR);Eukaryota;Archaeplastida;Chloroplastida;Charophyta;Phragmoplastophyta;Streptophyta;Embryophyta;Tracheophyta;Spermatophyta;Magnoliophyta;Lamiales;Byblis;";"0.0";"0";"1";"1";"0";"1";"0";"457182";"391207"
"V4mis2";"SILVA (only NR);Eukaryota;Archaeplastida;Chloroplastida;Charophyta;Phragmoplastophyta;Streptophyta;Embryophyta;Tracheophyta;Spermatophyta;Magnoliophyta;Lamiales;Callitriche;";"0.0";"0";"1";"1";"0";"1";"0";"457182";"391207"
"V4mis2";"SILVA (only NR);Eukaryota;Archaeplastida;Chloroplastida;Charophyta;Phragmoplastophyta;Streptophyta;Embryophyta;Tracheophyta;Spermatophyta;Magnoliophyta;Lamiales;Castilleja;";"0.0";"0";"1";"1";"0";"1";"0";"457182";"391207"
"V4mis2";"SILVA (only NR);Eukaryota;Archaeplastida;Chloroplastida;Charophyta;Phragmoplastophyta;Streptophyta;Embryophyta;Tracheophyta;Spermatophyta;Magnoliophyta;Lamiales;Clerodendrum;";"0.0";"0";"1";"1";"0";"1";"0";"457182";"391207"
"V4mis2";"SILVA (only NR);Eukaryota;Archaeplastida;Chloroplastida;Charophyta;Phragmoplastophyta;Streptophyta;Embryophyta;Tracheophyta;Spermatophyta;Magnoliophyta;Lamiales;Conopholis;";"0.0";"0";"1";"1";"0";"1";"0";"457182";"391207"
"V4mis2";"SILVA (only NR);Eukaryota;Archaeplastida;Chloroplastida;Charophyta;Phragmoplastophyta;Streptophyta;Embryophyta;Tracheophyta;Spermatophyta;Magnoliophyta;Lamiales;Cyrtandra;";"0.0";"0";"1";"1";"0";"1";"0";"457182";"391207"
"V4mis2";"SILVA (only NR);Eukaryota;Archaeplastida;Chloroplastida;Charophyta;Phragmoplastophyta;Streptophyta;Embryophyta;Tracheophyta;Spermatophyta;Magnoliophyta;Lamiales;Digitalis;";"0.0";"0";"1";"1";"0";"1";"0";"457182";"391207"
"V4mis2";"SILVA (only NR);Eukaryota;Archaeplastida;Chloroplastida;Charophyta;Phragmoplastophyta;Streptophyta;Embryophyta;Tracheophyta;Spermatophyta;Magnoliophyta;Lamiales;Dorcoceras;";"0.0";"0";"11";"11";"0";"11";"0";"457172";"391207"
"V4mis2";"SILVA (only NR);Eukaryota;Archaeplastida;Chloroplastida;Charophyta;Phragmoplastophyta;Streptophyta;Embryophyta;Tracheophyta;Spermatophyta;Magnoliophyta;Lamiales;Drymonia;";"0.0";"0";"1";"1";"0";"1";"0";"457182";"391207"
"V4mis2";"SILVA (only NR);Eukaryota;Archaeplastida;Chloroplastida;Charophyta;Phragmoplastophyta;Streptophyta;Embryophyta;Tracheophyta;Spermatophyta;Magnoliophyta;Lamiales;Erythranthe;";"0.0";"0";"15";"15";"0";"15";"0";"457168";"391207"
"V4mis2";"SILVA (only NR);Eukaryota;Archaeplastida;Chloroplastida;Charophyta;Phragmoplastophyta;Streptophyta;Embryophyta;Tracheophyta;Spermatophyta;Magnoliophyta;Lamiales;Fraxinus;";"0.0";"0";"1";"1";"0";"1";"0";"457182";"391207"
"V4mis2";"SILVA (only NR);Eukaryota;Archaeplastida;Chloroplastida;Charophyta;Phragmoplastophyta;Streptophyta;Embryophyta;Tracheophyta;Spermatophyta;Magnoliophyta;Lamiales;Genlisea;";"0.0";"0";"1";"1";"0";"1";"0";"457182";"391207"
"V4mis2";"SILVA (only NR);Eukaryota;Archaeplastida;Chloroplastida;Charophyta;Phragmoplastophyta;Streptophyta;Embryophyta;Tracheophyta;Spermatophyta;Magnoliophyta;Lamiales;Gratiola;";"0.0";"0";"1";"1";"0";"1";"0";"457182";"391207"
"V4mis2";"SILVA (only NR);Eukaryota;Archaeplastida;Chloroplastida;Charophyta;Phragmoplastophyta;Streptophyta;Embryophyta;Tracheophyta;Spermatophyta;Magnoliophyta;Lamiales;Harveya;";"0.0";"0";"1";"1";"0";"1";"0";"457182";"391207"
"V4mis2";"SILVA (only NR);Eukaryota;Archaeplastida;Chloroplastida;Charophyta;Phragmoplastophyta;Streptophyta;Embryophyta;Tracheophyta;Spermatophyta;Magnoliophyta;Lamiales;Hyobanche;";"0.0";"0";"1";"1";"0";"1";"0";"457182";"391207"
"V4mis2";"SILVA (only NR);Eukaryota;Archaeplastida;Chloroplastida;Charophyta;Phragmoplastophyta;Streptophyta;Embryophyta;Tracheophyta;Spermatophyta;Magnoliophyta;Lamiales;Jasminum;";"0.0";"0";"1";"1";"0";"1";"0";"457182";"391207"
"V4mis2";"SILVA (only NR);Eukaryota;Archaeplastida;Chloroplastida;Charophyta;Phragmoplastophyta;Streptophyta;Embryophyta;Tracheophyta;Spermatophyta;Magnoliophyta;Lamiales;Justicia;";"0.0";"0";"1";"1";"0";"1";"0";"457182";"391207"
"V4mis2";"SILVA (only NR);Eukaryota;Archaeplastida;Chloroplastida;Charophyta;Phragmoplastophyta;Streptophyta;Embryophyta;Tracheophyta;Spermatophyta;Magnoliophyta;Lamiales;Lathraea;";"0.0";"0";"1";"1";"0";"1";"0";"457182";"391207"
"V4mis2";"SILVA (only NR);Eukaryota;Archaeplastida;Chloroplastida;Charophyta;Phragmoplastophyta;Streptophyta;Embryophyta;Tracheophyta;Spermatophyta;Magnoliophyta;Lamiales;Lindernia;";"0.0";"0";"1";"1";"0";"1";"0";"457182";"391207"
"V4mis2";"SILVA (only NR);Eukaryota;Archaeplastida;Chloroplastida;Charophyta;Phragmoplastophyta;Streptophyta;Embryophyta;Tracheophyta;Spermatophyta;Magnoliophyta;Lamiales;Mazus;";"0.0";"0";"1";"1";"0";"1";"0";"457182";"391207"
"V4mis2";"SILVA (only NR);Eukaryota;Archaeplastida;Chloroplastida;Charophyta;Phragmoplastophyta;Streptophyta;Embryophyta;Tracheophyta;Spermatophyta;Magnoliophyta;Lamiales;Melampyrum;";"0.0";"0";"1";"1";"0";"1";"0";"457182";"391207"
"V4mis2";"SILVA (only NR);Eukaryota;Archaeplastida;Chloroplastida;Charophyta;Phragmoplastophyta;Streptophyta;Embryophyta;Tracheophyta;Spermatophyta;Magnoliophyta;Lamiales;Monarda;";"0.0";"0";"1";"1";"0";"1";"0";"457182";"391207"
"V4mis2";"SILVA (only NR);Eukaryota;Archaeplastida;Chloroplastida;Charophyta;Phragmoplastophyta;Streptophyta;Embryophyta;Tracheophyta;Spermatophyta;Magnoliophyta;Lamiales;Orobanche;";"0.0";"0";"1";"1";"0";"1";"0";"457182";"391207"
"V4mis2";"SILVA (only NR);Eukaryota;Archaeplastida;Chloroplastida;Charophyta;Phragmoplastophyta;Streptophyta;Embryophyta;Tracheophyta;Spermatophyta;Magnoliophyta;Lamiales;Perilla;";"0.0";"0";"2";"2";"0";"2";"0";"457181";"391207"
"V4mis2";"SILVA (only NR);Eukaryota;Archaeplastida;Chloroplastida;Charophyta;Phragmoplastophyta;Streptophyta;Embryophyta;Tracheophyta;Spermatophyta;Magnoliophyta;Lamiales;Pinguicula;";"0.0";"0";"2";"2";"0";"2";"0";"457181";"391207"
"V4mis2";"SILVA (only NR);Eukaryota;Archaeplastida;Chloroplastida;Charophyta;Phragmoplastophyta;Streptophyta;Embryophyta;Tracheophyta;Spermatophyta;Magnoliophyta;Lamiales;Plantago;";"0.0";"0";"1";"1";"0";"1";"0";"457182";"391207"
"V4mis2";"SILVA (only NR);Eukaryota;Archaeplastida;Chloroplastida;Charophyta;Phragmoplastophyta;Streptophyta;Embryophyta;Tracheophyta;Spermatophyta;Magnoliophyta;Lamiales;Proboscidea;";"0.0";"0";"1";"1";"0";"1";"0";"457182";"391207"
"V4mis2";"SILVA (only NR);Eukaryota;Archaeplastida;Chloroplastida;Charophyta;Phragmoplastophyta;Streptophyta;Embryophyta;Tracheophyta;Spermatophyta;Magnoliophyta;Lamiales;Rehmannia;";"0.0";"0";"2";"2";"0";"2";"0";"457181";"391207"
"V4mis2";"SILVA (only NR);Eukaryota;Archaeplastida;Chloroplastida;Charophyta;Phragmoplastophyta;Streptophyta;Embryophyta;Tracheophyta;Spermatophyta;Magnoliophyta;Lamiales;Rhynchoglossum;";"0.0";"0";"1";"1";"0";"1";"0";"457182";"391207"
"V4mis2";"SILVA (only NR);Eukaryota;Archaeplastida;Chloroplastida;Charophyta;Phragmoplastophyta;Streptophyta;Embryophyta;Tracheophyta;Spermatophyta;Magnoliophyta;Lamiales;Salvia;";"0.0";"0";"1";"1";"0";"1";"0";"457182";"391207"
"V4mis2";"SILVA (only NR);Eukaryota;Archaeplastida;Chloroplastida;Charophyta;Phragmoplastophyta;Streptophyta;Embryophyta;Tracheophyta;Spermatophyta;Magnoliophyta;Lamiales;Schlegelia;";"0.0";"0";"1";"1";"0";"1";"0";"457182";"391207"
"V4mis2";"SILVA (only NR);Eukaryota;Archaeplastida;Chloroplastida;Charophyta;Phragmoplastophyta;Streptophyta;Embryophyta;Tracheophyta;Spermatophyta;Magnoliophyta;Lamiales;Scrophularia;";"0.0";"0";"1";"1";"0";"1";"0";"457182";"391207"
"V4mis2";"SILVA (only NR);Eukaryota;Archaeplastida;Chloroplastida;Charophyta;Phragmoplastophyta;Streptophyta;Embryophyta;Tracheophyta;Spermatophyta;Magnoliophyta;Lamiales;Sesamum;";"0.0";"0";"13";"13";"0";"13";"0";"457170";"391207"
"V4mis2";"SILVA (only NR);Eukaryota;Archaeplastida;Chloroplastida;Charophyta;Phragmoplastophyta;Streptophyta;Embryophyta;Tracheophyta;Spermatophyta;Magnoliophyta;Lamiales;Streptocarpus;";"0.0";"0";"1";"1";"0";"1";"0";"457182";"391207"
"V4mis2";"SILVA (only NR);Eukaryota;Archaeplastida;Chloroplastida;Charophyta;Phragmoplastophyta;Streptophyta;Embryophyta;Tracheophyta;Spermatophyta;Magnoliophyta;Lamiales;Tectona;";"0.0";"0";"1";"1";"0";"1";"0";"457182";"391207"
"V4mis2";"SILVA (only NR);Eukaryota;Archaeplastida;Chloroplastida;Charophyta;Phragmoplastophyta;Streptophyta;Embryophyta;Tracheophyta;Spermatophyta;Magnoliophyta;Lamiales;Utricularia;";"0.0";"0";"2";"2";"0";"2";"0";"457181";"391207"
"V4mis2";"SILVA (only NR);Eukaryota;Archaeplastida;Chloroplastida;Charophyta;Phragmoplastophyta;Streptophyta;Embryophyta;Tracheophyta;Spermatophyta;Magnoliophyta;Lamiales;Veronica;";"0.0";"0";"1";"1";"0";"1";"0";"457182";"391207"
"V4mis2";"SILVA (only NR);Eukaryota;Archaeplastida;Chloroplastida;Charophyta;Phragmoplastophyta;Streptophyta;Embryophyta;Tracheophyta;Spermatophyta;Magnoliophyta;Laurales;";"0.0";"0";"12";"12";"0";"12";"0";"457171";"391207"
"V4mis2";"SILVA (only NR);Eukaryota;Archaeplastida;Chloroplastida;Charophyta;Phragmoplastophyta;Streptophyta;Embryophyta;Tracheophyta;Spermatophyta;Magnoliophyta;Laurales;Calycanthus;";"0.0";"0";"1";"1";"0";"1";"0";"457182";"391207"
"V4mis2";"SILVA (only NR);Eukaryota;Archaeplastida;Chloroplastida;Charophyta;Phragmoplastophyta;Streptophyta;Embryophyta;Tracheophyta;Spermatophyta;Magnoliophyta;Laurales;Cassytha;";"0.0";"0";"1";"1";"0";"1";"0";"457182";"391207"
"V4mis2";"SILVA (only NR);Eukaryota;Archaeplastida;Chloroplastida;Charophyta;Phragmoplastophyta;Streptophyta;Embryophyta;Tracheophyta;Spermatophyta;Magnoliophyta;Laurales;Cryptocarya;";"0.0";"0";"1";"1";"0";"1";"0";"457182";"391207"
"V4mis2";"SILVA (only NR);Eukaryota;Archaeplastida;Chloroplastida;Charophyta;Phragmoplastophyta;Streptophyta;Embryophyta;Tracheophyta;Spermatophyta;Magnoliophyta;Laurales;Doryphora;";"0.0";"0";"1";"1";"0";"1";"0";"457182";"391207"
"V4mis2";"SILVA (only NR);Eukaryota;Archaeplastida;Chloroplastida;Charophyta;Phragmoplastophyta;Streptophyta;Embryophyta;Tracheophyta;Spermatophyta;Magnoliophyta;Laurales;Gomortega;";"0.0";"0";"1";"1";"0";"1";"0";"457182";"391207"
"V4mis2";"SILVA (only NR);Eukaryota;Archaeplastida;Chloroplastida;Charophyta;Phragmoplastophyta;Streptophyta;Embryophyta;Tracheophyta;Spermatophyta;Magnoliophyta;Laurales;Gyrocarpus;";"0.0";"0";"1";"1";"0";"1";"0";"457182";"391207"
"V4mis2";"SILVA (only NR);Eukaryota;Archaeplastida;Chloroplastida;Charophyta;Phragmoplastophyta;Streptophyta;Embryophyta;Tracheophyta;Spermatophyta;Magnoliophyta;Laurales;Hedycarya;";"0.0";"0";"1";"1";"0";"1";"0";"457182";"391207"
"V4mis2";"SILVA (only NR);Eukaryota;Archaeplastida;Chloroplastida;Charophyta;Phragmoplastophyta;Streptophyta;Embryophyta;Tracheophyta;Spermatophyta;Magnoliophyta;Laurales;Hernandia;";"0.0";"0";"1";"1";"0";"1";"0";"457182";"391207"
"V4mis2";"SILVA (only NR);Eukaryota;Archaeplastida;Chloroplastida;Charophyta;Phragmoplastophyta;Streptophyta;Embryophyta;Tracheophyta;Spermatophyta;Magnoliophyta;Laurales;Idiospermum;";"0.0";"0";"1";"1";"0";"1";"0";"457182";"391207"
"V4mis2";"SILVA (only NR);Eukaryota;Archaeplastida;Chloroplastida;Charophyta;Phragmoplastophyta;Streptophyta;Embryophyta;Tracheophyta;Spermatophyta;Magnoliophyta;Laurales;Laurus;";"0.0";"0";"1";"1";"0";"1";"0";"457182";"391207"
"V4mis2";"SILVA (only NR);Eukaryota;Archaeplastida;Chloroplastida;Charophyta;Phragmoplastophyta;Streptophyta;Embryophyta;Tracheophyta;Spermatophyta;Magnoliophyta;Laurales;Palmeria;";"0.0";"0";"1";"1";"0";"1";"0";"457182";"391207"
"V4mis2";"SILVA (only NR);Eukaryota;Archaeplastida;Chloroplastida;Charophyta;Phragmoplastophyta;Streptophyta;Embryophyta;Tracheophyta;Spermatophyta;Magnoliophyta;Laurales;Siparuna;";"0.0";"0";"1";"1";"0";"1";"0";"457182";"391207"
"V4mis2";"SILVA (only NR);Eukaryota;Archaeplastida;Chloroplastida;Charophyta;Phragmoplastophyta;Streptophyta;Embryophyta;Tracheophyta;Spermatophyta;Magnoliophyta;Liliopsida;";"2.1";"14.3";"671";"669";"14";"655";"2";"456514";"391193"
"V4mis2";"SILVA (only NR);Eukaryota;Archaeplastida;Chloroplastida;Charophyta;Phragmoplastophyta;Streptophyta;Embryophyta;Tracheophyta;Spermatophyta;Magnoliophyta;Liliopsida;Acorales;";"0.0";"0";"2";"2";"0";"2";"0";"457181";"391207"
"V4mis2";"SILVA (only NR);Eukaryota;Archaeplastida;Chloroplastida;Charophyta;Phragmoplastophyta;Streptophyta;Embryophyta;Tracheophyta;Spermatophyta;Magnoliophyta;Liliopsida;Acorales;Acorus;";"0.0";"0";"2";"2";"0";"2";"0";"457181";"391207"
"V4mis2";"SILVA (only NR);Eukaryota;Archaeplastida;Chloroplastida;Charophyta;Phragmoplastophyta;Streptophyta;Embryophyta;Tracheophyta;Spermatophyta;Magnoliophyta;Liliopsida;Alismatales;";"0.0";"0";"46";"46";"0";"46";"0";"457137";"391207"
"V4mis2";"SILVA (only NR);Eukaryota;Archaeplastida;Chloroplastida;Charophyta;Phragmoplastophyta;Streptophyta;Embryophyta;Tracheophyta;Spermatophyta;Magnoliophyta;Liliopsida;Alismatales;Alisma;";"0.0";"0";"1";"1";"0";"1";"0";"457182";"391207"
"V4mis2";"SILVA (only NR);Eukaryota;Archaeplastida;Chloroplastida;Charophyta;Phragmoplastophyta;Streptophyta;Embryophyta;Tracheophyta;Spermatophyta;Magnoliophyta;Liliopsida;Alismatales;Aponogeton;";"0.0";"0";"1";"1";"0";"1";"0";"457182";"391207"
"V4mis2";"SILVA (only NR);Eukaryota;Archaeplastida;Chloroplastida;Charophyta;Phragmoplastophyta;Streptophyta;Embryophyta;Tracheophyta;Spermatophyta;Magnoliophyta;Liliopsida;Alismatales;Arisaema;";"0.0";"0";"1";"1";"0";"1";"0";"457182";"391207"
"V4mis2";"SILVA (only NR);Eukaryota;Archaeplastida;Chloroplastida;Charophyta;Phragmoplastophyta;Streptophyta;Embryophyta;Tracheophyta;Spermatophyta;Magnoliophyta;Liliopsida;Alismatales;Blyxa;";"0.0";"0";"2";"2";"0";"2";"0";"457181";"391207"
"V4mis2";"SILVA (only NR);Eukaryota;Archaeplastida;Chloroplastida;Charophyta;Phragmoplastophyta;Streptophyta;Embryophyta;Tracheophyta;Spermatophyta;Magnoliophyta;Liliopsida;Alismatales;Butomus;";"0.0";"0";"1";"1";"0";"1";"0";"457182";"391207"
"V4mis2";"SILVA (only NR);Eukaryota;Archaeplastida;Chloroplastida;Charophyta;Phragmoplastophyta;Streptophyta;Embryophyta;Tracheophyta;Spermatophyta;Magnoliophyta;Liliopsida;Alismatales;Caldesia;";"0.0";"0";"1";"1";"0";"1";"0";"457182";"391207"
"V4mis2";"SILVA (only NR);Eukaryota;Archaeplastida;Chloroplastida;Charophyta;Phragmoplastophyta;Streptophyta;Embryophyta;Tracheophyta;Spermatophyta;Magnoliophyta;Liliopsida;Alismatales;Calla;";"0.0";"0";"1";"1";"0";"1";"0";"457182";"391207"
"V4mis2";"SILVA (only NR);Eukaryota;Archaeplastida;Chloroplastida;Charophyta;Phragmoplastophyta;Streptophyta;Embryophyta;Tracheophyta;Spermatophyta;Magnoliophyta;Liliopsida;Alismatales;Cymodocea;";"0.0";"0";"2";"2";"0";"2";"0";"457181";"391207"
"V4mis2";"SILVA (only NR);Eukaryota;Archaeplastida;Chloroplastida;Charophyta;Phragmoplastophyta;Streptophyta;Embryophyta;Tracheophyta;Spermatophyta;Magnoliophyta;Liliopsida;Alismatales;Echinodorus;";"0.0";"0";"1";"1";"0";"1";"0";"457182";"391207"
"V4mis2";"SILVA (only NR);Eukaryota;Archaeplastida;Chloroplastida;Charophyta;Phragmoplastophyta;Streptophyta;Embryophyta;Tracheophyta;Spermatophyta;Magnoliophyta;Liliopsida;Alismatales;Egeria;";"0.0";"0";"1";"1";"0";"1";"0";"457182";"391207"
"V4mis2";"SILVA (only NR);Eukaryota;Archaeplastida;Chloroplastida;Charophyta;Phragmoplastophyta;Streptophyta;Embryophyta;Tracheophyta;Spermatophyta;Magnoliophyta;Liliopsida;Alismatales;Enhalus;";"0.0";"0";"1";"1";"0";"1";"0";"457182";"391207"
"V4mis2";"SILVA (only NR);Eukaryota;Archaeplastida;Chloroplastida;Charophyta;Phragmoplastophyta;Streptophyta;Embryophyta;Tracheophyta;Spermatophyta;Magnoliophyta;Liliopsida;Alismatales;Gymnostachys;";"0.0";"0";"1";"1";"0";"1";"0";"457182";"391207"
"V4mis2";"SILVA (only NR);Eukaryota;Archaeplastida;Chloroplastida;Charophyta;Phragmoplastophyta;Streptophyta;Embryophyta;Tracheophyta;Spermatophyta;Magnoliophyta;Liliopsida;Alismatales;Hydrilla;";"0.0";"0";"1";"1";"0";"1";"0";"457182";"391207"
"V4mis2";"SILVA (only NR);Eukaryota;Archaeplastida;Chloroplastida;Charophyta;Phragmoplastophyta;Streptophyta;Embryophyta;Tracheophyta;Spermatophyta;Magnoliophyta;Liliopsida;Alismatales;Hydrocharis;";"0.0";"0";"1";"1";"0";"1";"0";"457182";"391207"
"V4mis2";"SILVA (only NR);Eukaryota;Archaeplastida;Chloroplastida;Charophyta;Phragmoplastophyta;Streptophyta;Embryophyta;Tracheophyta;Spermatophyta;Magnoliophyta;Liliopsida;Alismatales;Hydrocleys;";"0.0";"0";"1";"1";"0";"1";"0";"457182";"391207"
"V4mis2";"SILVA (only NR);Eukaryota;Archaeplastida;Chloroplastida;Charophyta;Phragmoplastophyta;Streptophyta;Embryophyta;Tracheophyta;Spermatophyta;Magnoliophyta;Liliopsida;Alismatales;Lemna;";"0.0";"0";"2";"2";"0";"2";"0";"457181";"391207"
"V4mis2";"SILVA (only NR);Eukaryota;Archaeplastida;Chloroplastida;Charophyta;Phragmoplastophyta;Streptophyta;Embryophyta;Tracheophyta;Spermatophyta;Magnoliophyta;Liliopsida;Alismatales;Lilaea;";"0.0";"0";"1";"1";"0";"1";"0";"457182";"391207"
"V4mis2";"SILVA (only NR);Eukaryota;Archaeplastida;Chloroplastida;Charophyta;Phragmoplastophyta;Streptophyta;Embryophyta;Tracheophyta;Spermatophyta;Magnoliophyta;Liliopsida;Alismatales;Limnocharis;";"0.0";"0";"1";"1";"0";"1";"0";"457182";"391207"
"V4mis2";"SILVA (only NR);Eukaryota;Archaeplastida;Chloroplastida;Charophyta;Phragmoplastophyta;Streptophyta;Embryophyta;Tracheophyta;Spermatophyta;Magnoliophyta;Liliopsida;Alismatales;Limnophyton;";"0.0";"0";"1";"1";"0";"1";"0";"457182";"391207"
"V4mis2";"SILVA (only NR);Eukaryota;Archaeplastida;Chloroplastida;Charophyta;Phragmoplastophyta;Streptophyta;Embryophyta;Tracheophyta;Spermatophyta;Magnoliophyta;Liliopsida;Alismatales;Najas;";"0.0";"0";"2";"2";"0";"2";"0";"457181";"391207"
"V4mis2";"SILVA (only NR);Eukaryota;Archaeplastida;Chloroplastida;Charophyta;Phragmoplastophyta;Streptophyta;Embryophyta;Tracheophyta;Spermatophyta;Magnoliophyta;Liliopsida;Alismatales;Orontium;";"0.0";"0";"1";"1";"0";"1";"0";"457182";"391207"
"V4mis2";"SILVA (only NR);Eukaryota;Archaeplastida;Chloroplastida;Charophyta;Phragmoplastophyta;Streptophyta;Embryophyta;Tracheophyta;Spermatophyta;Magnoliophyta;Liliopsida;Alismatales;Ottelia;";"0.0";"0";"1";"1";"0";"1";"0";"457182";"391207"
"V4mis2";"SILVA (only NR);Eukaryota;Archaeplastida;Chloroplastida;Charophyta;Phragmoplastophyta;Streptophyta;Embryophyta;Tracheophyta;Spermatophyta;Magnoliophyta;Liliopsida;Alismatales;Phyllospadix;";"0.0";"0";"1";"1";"0";"1";"0";"457182";"391207"
"V4mis2";"SILVA (only NR);Eukaryota;Archaeplastida;Chloroplastida;Charophyta;Phragmoplastophyta;Streptophyta;Embryophyta;Tracheophyta;Spermatophyta;Magnoliophyta;Liliopsida;Alismatales;Pistia;";"0.0";"0";"1";"1";"0";"1";"0";"457182";"391207"
"V4mis2";"SILVA (only NR);Eukaryota;Archaeplastida;Chloroplastida;Charophyta;Phragmoplastophyta;Streptophyta;Embryophyta;Tracheophyta;Spermatophyta;Magnoliophyta;Liliopsida;Alismatales;Pleea;";"0.0";"0";"1";"1";"0";"1";"0";"457182";"391207"
"V4mis2";"SILVA (only NR);Eukaryota;Archaeplastida;Chloroplastida;Charophyta;Phragmoplastophyta;Streptophyta;Embryophyta;Tracheophyta;Spermatophyta;Magnoliophyta;Liliopsida;Alismatales;Ruppia;";"0.0";"0";"1";"1";"0";"1";"0";"457182";"391207"
"V4mis2";"SILVA (only NR);Eukaryota;Archaeplastida;Chloroplastida;Charophyta;Phragmoplastophyta;Streptophyta;Embryophyta;Tracheophyta;Spermatophyta;Magnoliophyta;Liliopsida;Alismatales;Sagittaria;";"0.0";"0";"1";"1";"0";"1";"0";"457182";"391207"
"V4mis2";"SILVA (only NR);Eukaryota;Archaeplastida;Chloroplastida;Charophyta;Phragmoplastophyta;Streptophyta;Embryophyta;Tracheophyta;Spermatophyta;Magnoliophyta;Liliopsida;Alismatales;Scheuchzeria;";"0.0";"0";"1";"1";"0";"1";"0";"457182";"391207"
"V4mis2";"SILVA (only NR);Eukaryota;Archaeplastida;Chloroplastida;Charophyta;Phragmoplastophyta;Streptophyta;Embryophyta;Tracheophyta;Spermatophyta;Magnoliophyta;Liliopsida;Alismatales;Spathiphyllum;";"0.0";"0";"1";"1";"0";"1";"0";"457182";"391207"
"V4mis2";"SILVA (only NR);Eukaryota;Archaeplastida;Chloroplastida;Charophyta;Phragmoplastophyta;Streptophyta;Embryophyta;Tracheophyta;Spermatophyta;Magnoliophyta;Liliopsida;Alismatales;Spirodela;";"0.0";"0";"1";"1";"0";"1";"0";"457182";"391207"
"V4mis2";"SILVA (only NR);Eukaryota;Archaeplastida;Chloroplastida;Charophyta;Phragmoplastophyta;Streptophyta;Embryophyta;Tracheophyta;Spermatophyta;Magnoliophyta;Liliopsida;Alismatales;Stratiotes;";"0.0";"0";"1";"1";"0";"1";"0";"457182";"391207"
"V4mis2";"SILVA (only NR);Eukaryota;Archaeplastida;Chloroplastida;Charophyta;Phragmoplastophyta;Streptophyta;Embryophyta;Tracheophyta;Spermatophyta;Magnoliophyta;Liliopsida;Alismatales;Stuckenia;";"0.0";"0";"1";"1";"0";"1";"0";"457182";"391207"
"V4mis2";"SILVA (only NR);Eukaryota;Archaeplastida;Chloroplastida;Charophyta;Phragmoplastophyta;Streptophyta;Embryophyta;Tracheophyta;Spermatophyta;Magnoliophyta;Liliopsida;Alismatales;Syringodium;";"0.0";"0";"1";"1";"0";"1";"0";"457182";"391207"
"V4mis2";"SILVA (only NR);Eukaryota;Archaeplastida;Chloroplastida;Charophyta;Phragmoplastophyta;Streptophyta;Embryophyta;Tracheophyta;Spermatophyta;Magnoliophyta;Liliopsida;Alismatales;Thalassia;";"0.0";"0";"2";"2";"0";"2";"0";"457181";"391207"
"V4mis2";"SILVA (only NR);Eukaryota;Archaeplastida;Chloroplastida;Charophyta;Phragmoplastophyta;Streptophyta;Embryophyta;Tracheophyta;Spermatophyta;Magnoliophyta;Liliopsida;Alismatales;Tofieldia;";"0.0";"0";"1";"1";"0";"1";"0";"457182";"391207"
"V4mis2";"SILVA (only NR);Eukaryota;Archaeplastida;Chloroplastida;Charophyta;Phragmoplastophyta;Streptophyta;Embryophyta;Tracheophyta;Spermatophyta;Magnoliophyta;Liliopsida;Alismatales;Triglochin;";"0.0";"0";"1";"1";"0";"1";"0";"457182";"391207"
"V4mis2";"SILVA (only NR);Eukaryota;Archaeplastida;Chloroplastida;Charophyta;Phragmoplastophyta;Streptophyta;Embryophyta;Tracheophyta;Spermatophyta;Magnoliophyta;Liliopsida;Alismatales;Wolffia;";"0.0";"0";"3";"3";"0";"3";"0";"457180";"391207"
"V4mis2";"SILVA (only NR);Eukaryota;Archaeplastida;Chloroplastida;Charophyta;Phragmoplastophyta;Streptophyta;Embryophyta;Tracheophyta;Spermatophyta;Magnoliophyta;Liliopsida;Alismatales;Zannichellia;";"0.0";"0";"1";"1";"0";"1";"0";"457182";"391207"
"V4mis2";"SILVA (only NR);Eukaryota;Archaeplastida;Chloroplastida;Charophyta;Phragmoplastophyta;Streptophyta;Embryophyta;Tracheophyta;Spermatophyta;Magnoliophyta;Liliopsida;Alismatales;Zantedeschia;";"0.0";"0";"1";"1";"0";"1";"0";"457182";"391207"
"V4mis2";"SILVA (only NR);Eukaryota;Archaeplastida;Chloroplastida;Charophyta;Phragmoplastophyta;Streptophyta;Embryophyta;Tracheophyta;Spermatophyta;Magnoliophyta;Liliopsida;Arecales;";"0.0";"0";"27";"27";"0";"27";"0";"457156";"391207"
"V4mis2";"SILVA (only NR);Eukaryota;Archaeplastida;Chloroplastida;Charophyta;Phragmoplastophyta;Streptophyta;Embryophyta;Tracheophyta;Spermatophyta;Magnoliophyta;Liliopsida;Arecales;Aphandra;";"0.0";"0";"1";"1";"0";"1";"0";"457182";"391207"
"V4mis2";"SILVA (only NR);Eukaryota;Archaeplastida;Chloroplastida;Charophyta;Phragmoplastophyta;Streptophyta;Embryophyta;Tracheophyta;Spermatophyta;Magnoliophyta;Liliopsida;Arecales;Arenga;";"0.0";"0";"1";"1";"0";"1";"0";"457182";"391207"
"V4mis2";"SILVA (only NR);Eukaryota;Archaeplastida;Chloroplastida;Charophyta;Phragmoplastophyta;Streptophyta;Embryophyta;Tracheophyta;Spermatophyta;Magnoliophyta;Liliopsida;Arecales;Bentinckia;";"0.0";"0";"1";"1";"0";"1";"0";"457182";"391207"
"V4mis2";"SILVA (only NR);Eukaryota;Archaeplastida;Chloroplastida;Charophyta;Phragmoplastophyta;Streptophyta;Embryophyta;Tracheophyta;Spermatophyta;Magnoliophyta;Liliopsida;Arecales;Borassus;";"0.0";"0";"1";"1";"0";"1";"0";"457182";"391207"
"V4mis2";"SILVA (only NR);Eukaryota;Archaeplastida;Chloroplastida;Charophyta;Phragmoplastophyta;Streptophyta;Embryophyta;Tracheophyta;Spermatophyta;Magnoliophyta;Liliopsida;Arecales;Calamus;";"0.0";"0";"1";"1";"0";"1";"0";"457182";"391207"
"V4mis2";"SILVA (only NR);Eukaryota;Archaeplastida;Chloroplastida;Charophyta;Phragmoplastophyta;Streptophyta;Embryophyta;Tracheophyta;Spermatophyta;Magnoliophyta;Liliopsida;Arecales;Calyptrocalyx;";"0.0";"0";"1";"1";"0";"1";"0";"457182";"391207"
"V4mis2";"SILVA (only NR);Eukaryota;Archaeplastida;Chloroplastida;Charophyta;Phragmoplastophyta;Streptophyta;Embryophyta;Tracheophyta;Spermatophyta;Magnoliophyta;Liliopsida;Arecales;Calyptronoma;";"0.0";"0";"1";"1";"0";"1";"0";"457182";"391207"
"V4mis2";"SILVA (only NR);Eukaryota;Archaeplastida;Chloroplastida;Charophyta;Phragmoplastophyta;Streptophyta;Embryophyta;Tracheophyta;Spermatophyta;Magnoliophyta;Liliopsida;Arecales;Caryota;";"0.0";"0";"1";"1";"0";"1";"0";"457182";"391207"
"V4mis2";"SILVA (only NR);Eukaryota;Archaeplastida;Chloroplastida;Charophyta;Phragmoplastophyta;Streptophyta;Embryophyta;Tracheophyta;Spermatophyta;Magnoliophyta;Liliopsida;Arecales;Chamaedorea;";"0.0";"0";"1";"1";"0";"1";"0";"457182";"391207"
"V4mis2";"SILVA (only NR);Eukaryota;Archaeplastida;Chloroplastida;Charophyta;Phragmoplastophyta;Streptophyta;Embryophyta;Tracheophyta;Spermatophyta;Magnoliophyta;Liliopsida;Arecales;Chamaerops;";"0.0";"0";"1";"1";"0";"1";"0";"457182";"391207"
"V4mis2";"SILVA (only NR);Eukaryota;Archaeplastida;Chloroplastida;Charophyta;Phragmoplastophyta;Streptophyta;Embryophyta;Tracheophyta;Spermatophyta;Magnoliophyta;Liliopsida;Arecales;Corypha;";"0.0";"0";"1";"1";"0";"1";"0";"457182";"391207"
"V4mis2";"SILVA (only NR);Eukaryota;Archaeplastida;Chloroplastida;Charophyta;Phragmoplastophyta;Streptophyta;Embryophyta;Tracheophyta;Spermatophyta;Magnoliophyta;Liliopsida;Arecales;Dictyocaryum;";"0.0";"0";"1";"1";"0";"1";"0";"457182";"391207"
"V4mis2";"SILVA (only NR);Eukaryota;Archaeplastida;Chloroplastida;Charophyta;Phragmoplastophyta;Streptophyta;Embryophyta;Tracheophyta;Spermatophyta;Magnoliophyta;Liliopsida;Arecales;Hydriastele;";"0.0";"0";"2";"2";"0";"2";"0";"457181";"391207"
"V4mis2";"SILVA (only NR);Eukaryota;Archaeplastida;Chloroplastida;Charophyta;Phragmoplastophyta;Streptophyta;Embryophyta;Tracheophyta;Spermatophyta;Magnoliophyta;Liliopsida;Arecales;Hyophorbe;";"0.0";"0";"1";"1";"0";"1";"0";"457182";"391207"
"V4mis2";"SILVA (only NR);Eukaryota;Archaeplastida;Chloroplastida;Charophyta;Phragmoplastophyta;Streptophyta;Embryophyta;Tracheophyta;Spermatophyta;Magnoliophyta;Liliopsida;Arecales;Hyphaene;";"0.0";"0";"1";"1";"0";"1";"0";"457182";"391207"
"V4mis2";"SILVA (only NR);Eukaryota;Archaeplastida;Chloroplastida;Charophyta;Phragmoplastophyta;Streptophyta;Embryophyta;Tracheophyta;Spermatophyta;Magnoliophyta;Liliopsida;Arecales;Iriartea;";"0.0";"0";"1";"1";"0";"1";"0";"457182";"391207"
"V4mis2";"SILVA (only NR);Eukaryota;Archaeplastida;Chloroplastida;Charophyta;Phragmoplastophyta;Streptophyta;Embryophyta;Tracheophyta;Spermatophyta;Magnoliophyta;Liliopsida;Arecales;Licuala;";"0.0";"0";"1";"1";"0";"1";"0";"457182";"391207"
"V4mis2";"SILVA (only NR);Eukaryota;Archaeplastida;Chloroplastida;Charophyta;Phragmoplastophyta;Streptophyta;Embryophyta;Tracheophyta;Spermatophyta;Magnoliophyta;Liliopsida;Arecales;Orania;";"0.0";"0";"1";"1";"0";"1";"0";"457182";"391207"
"V4mis2";"SILVA (only NR);Eukaryota;Archaeplastida;Chloroplastida;Charophyta;Phragmoplastophyta;Streptophyta;Embryophyta;Tracheophyta;Spermatophyta;Magnoliophyta;Liliopsida;Arecales;Phoenix;";"0.0";"0";"3";"3";"0";"3";"0";"457180";"391207"
"V4mis2";"SILVA (only NR);Eukaryota;Archaeplastida;Chloroplastida;Charophyta;Phragmoplastophyta;Streptophyta;Embryophyta;Tracheophyta;Spermatophyta;Magnoliophyta;Liliopsida;Arecales;Phytelephas;";"0.0";"0";"1";"1";"0";"1";"0";"457182";"391207"
"V4mis2";"SILVA (only NR);Eukaryota;Archaeplastida;Chloroplastida;Charophyta;Phragmoplastophyta;Streptophyta;Embryophyta;Tracheophyta;Spermatophyta;Magnoliophyta;Liliopsida;Arecales;Ravenea;";"0.0";"0";"1";"1";"0";"1";"0";"457182";"391207"
"V4mis2";"SILVA (only NR);Eukaryota;Archaeplastida;Chloroplastida;Charophyta;Phragmoplastophyta;Streptophyta;Embryophyta;Tracheophyta;Spermatophyta;Magnoliophyta;Liliopsida;Arecales;Sabal;";"0.0";"0";"1";"1";"0";"1";"0";"457182";"391207"
"V4mis2";"SILVA (only NR);Eukaryota;Archaeplastida;Chloroplastida;Charophyta;Phragmoplastophyta;Streptophyta;Embryophyta;Tracheophyta;Spermatophyta;Magnoliophyta;Liliopsida;Arecales;Salacca;";"0.0";"0";"1";"1";"0";"1";"0";"457182";"391207"
"V4mis2";"SILVA (only NR);Eukaryota;Archaeplastida;Chloroplastida;Charophyta;Phragmoplastophyta;Streptophyta;Embryophyta;Tracheophyta;Spermatophyta;Magnoliophyta;Liliopsida;Arecales;Wendlandiella;";"0.0";"0";"1";"1";"0";"1";"0";"457182";"391207"
"V4mis2";"SILVA (only NR);Eukaryota;Archaeplastida;Chloroplastida;Charophyta;Phragmoplastophyta;Streptophyta;Embryophyta;Tracheophyta;Spermatophyta;Magnoliophyta;Liliopsida;Asparagales;";"0.0";"0";"137";"137";"0";"137";"0";"457046";"391207"
"V4mis2";"SILVA (only NR);Eukaryota;Archaeplastida;Chloroplastida;Charophyta;Phragmoplastophyta;Streptophyta;Embryophyta;Tracheophyta;Spermatophyta;Magnoliophyta;Liliopsida;Asparagales;Agapanthus;";"0.0";"0";"1";"1";"0";"1";"0";"457182";"391207"
"V4mis2";"SILVA (only NR);Eukaryota;Archaeplastida;Chloroplastida;Charophyta;Phragmoplastophyta;Streptophyta;Embryophyta;Tracheophyta;Spermatophyta;Magnoliophyta;Liliopsida;Asparagales;Allium;";"0.0";"0";"12";"12";"0";"12";"0";"457171";"391207"
"V4mis2";"SILVA (only NR);Eukaryota;Archaeplastida;Chloroplastida;Charophyta;Phragmoplastophyta;Streptophyta;Embryophyta;Tracheophyta;Spermatophyta;Magnoliophyta;Liliopsida;Asparagales;Aloe;";"0.0";"0";"1";"1";"0";"1";"0";"457182";"391207"
"V4mis2";"SILVA (only NR);Eukaryota;Archaeplastida;Chloroplastida;Charophyta;Phragmoplastophyta;Streptophyta;Embryophyta;Tracheophyta;Spermatophyta;Magnoliophyta;Liliopsida;Asparagales;Aphyllanthes;";"0.0";"0";"1";"1";"0";"1";"0";"457182";"391207"
"V4mis2";"SILVA (only NR);Eukaryota;Archaeplastida;Chloroplastida;Charophyta;Phragmoplastophyta;Streptophyta;Embryophyta;Tracheophyta;Spermatophyta;Magnoliophyta;Liliopsida;Asparagales;Apostasia;";"0.0";"0";"2";"2";"0";"2";"0";"457181";"391207"
"V4mis2";"SILVA (only NR);Eukaryota;Archaeplastida;Chloroplastida;Charophyta;Phragmoplastophyta;Streptophyta;Embryophyta;Tracheophyta;Spermatophyta;Magnoliophyta;Liliopsida;Asparagales;Asparagus;";"0.0";"0";"14";"14";"0";"14";"0";"457169";"391207"
"V4mis2";"SILVA (only NR);Eukaryota;Archaeplastida;Chloroplastida;Charophyta;Phragmoplastophyta;Streptophyta;Embryophyta;Tracheophyta;Spermatophyta;Magnoliophyta;Liliopsida;Asparagales;Aspidogyne;";"0.0";"0";"1";"1";"0";"1";"0";"457182";"391207"
"V4mis2";"SILVA (only NR);Eukaryota;Archaeplastida;Chloroplastida;Charophyta;Phragmoplastophyta;Streptophyta;Embryophyta;Tracheophyta;Spermatophyta;Magnoliophyta;Liliopsida;Asparagales;Astelia;";"0.0";"0";"1";"1";"0";"1";"0";"457182";"391207"
"V4mis2";"SILVA (only NR);Eukaryota;Archaeplastida;Chloroplastida;Charophyta;Phragmoplastophyta;Streptophyta;Embryophyta;Tracheophyta;Spermatophyta;Magnoliophyta;Liliopsida;Asparagales;Bessera;";"0.0";"0";"1";"1";"0";"1";"0";"457182";"391207"
"V4mis2";"SILVA (only NR);Eukaryota;Archaeplastida;Chloroplastida;Charophyta;Phragmoplastophyta;Streptophyta;Embryophyta;Tracheophyta;Spermatophyta;Magnoliophyta;Liliopsida;Asparagales;Blandfordia;";"0.0";"0";"1";"1";"0";"1";"0";"457182";"391207"
"V4mis2";"SILVA (only NR);Eukaryota;Archaeplastida;Chloroplastida;Charophyta;Phragmoplastophyta;Streptophyta;Embryophyta;Tracheophyta;Spermatophyta;Magnoliophyta;Liliopsida;Asparagales;Borya;";"0.0";"0";"1";"1";"0";"1";"0";"457182";"391207"
"V4mis2";"SILVA (only NR);Eukaryota;Archaeplastida;Chloroplastida;Charophyta;Phragmoplastophyta;Streptophyta;Embryophyta;Tracheophyta;Spermatophyta;Magnoliophyta;Liliopsida;Asparagales;Bulbine;";"0.0";"0";"2";"2";"0";"2";"0";"457181";"391207"
"V4mis2";"SILVA (only NR);Eukaryota;Archaeplastida;Chloroplastida;Charophyta;Phragmoplastophyta;Streptophyta;Embryophyta;Tracheophyta;Spermatophyta;Magnoliophyta;Liliopsida;Asparagales;Cephalanthera;";"0.0";"0";"2";"2";"0";"2";"0";"457181";"391207"
"V4mis2";"SILVA (only NR);Eukaryota;Archaeplastida;Chloroplastida;Charophyta;Phragmoplastophyta;Streptophyta;Embryophyta;Tracheophyta;Spermatophyta;Magnoliophyta;Liliopsida;Asparagales;Chlorophytum;";"0.0";"0";"1";"1";"0";"1";"0";"457182";"391207"
"V4mis2";"SILVA (only NR);Eukaryota;Archaeplastida;Chloroplastida;Charophyta;Phragmoplastophyta;Streptophyta;Embryophyta;Tracheophyta;Spermatophyta;Magnoliophyta;Liliopsida;Asparagales;Cleistes;";"0.0";"0";"3";"3";"0";"3";"0";"457180";"391207"
"V4mis2";"SILVA (only NR);Eukaryota;Archaeplastida;Chloroplastida;Charophyta;Phragmoplastophyta;Streptophyta;Embryophyta;Tracheophyta;Spermatophyta;Magnoliophyta;Liliopsida;Asparagales;Cleistesiopsis;";"0.0";"0";"1";"1";"0";"1";"0";"457182";"391207"
"V4mis2";"SILVA (only NR);Eukaryota;Archaeplastida;Chloroplastida;Charophyta;Phragmoplastophyta;Streptophyta;Embryophyta;Tracheophyta;Spermatophyta;Magnoliophyta;Liliopsida;Asparagales;Clematepistephium;";"0.0";"0";"1";"1";"0";"1";"0";"457182";"391207"
"V4mis2";"SILVA (only NR);Eukaryota;Archaeplastida;Chloroplastida;Charophyta;Phragmoplastophyta;Streptophyta;Embryophyta;Tracheophyta;Spermatophyta;Magnoliophyta;Liliopsida;Asparagales;Corallorhiza;";"0.0";"0";"1";"1";"0";"1";"0";"457182";"391207"
"V4mis2";"SILVA (only NR);Eukaryota;Archaeplastida;Chloroplastida;Charophyta;Phragmoplastophyta;Streptophyta;Embryophyta;Tracheophyta;Spermatophyta;Magnoliophyta;Liliopsida;Asparagales;Crinum;";"0.0";"0";"1";"1";"0";"1";"0";"457182";"391207"
"V4mis2";"SILVA (only NR);Eukaryota;Archaeplastida;Chloroplastida;Charophyta;Phragmoplastophyta;Streptophyta;Embryophyta;Tracheophyta;Spermatophyta;Magnoliophyta;Liliopsida;Asparagales;Cyanella;";"0.0";"0";"1";"1";"0";"1";"0";"457182";"391207"
"V4mis2";"SILVA (only NR);Eukaryota;Archaeplastida;Chloroplastida;Charophyta;Phragmoplastophyta;Streptophyta;Embryophyta;Tracheophyta;Spermatophyta;Magnoliophyta;Liliopsida;Asparagales;Cyclopogon;";"0.0";"0";"1";"1";"0";"1";"0";"457182";"391207"
"V4mis2";"SILVA (only NR);Eukaryota;Archaeplastida;Chloroplastida;Charophyta;Phragmoplastophyta;Streptophyta;Embryophyta;Tracheophyta;Spermatophyta;Magnoliophyta;Liliopsida;Asparagales;Cymbidium;";"0.0";"0";"1";"1";"0";"1";"0";"457182";"391207"
"V4mis2";"SILVA (only NR);Eukaryota;Archaeplastida;Chloroplastida;Charophyta;Phragmoplastophyta;Streptophyta;Embryophyta;Tracheophyta;Spermatophyta;Magnoliophyta;Liliopsida;Asparagales;Cypripedium;";"0.0";"0";"1";"1";"0";"1";"0";"457182";"391207"
"V4mis2";"SILVA (only NR);Eukaryota;Archaeplastida;Chloroplastida;Charophyta;Phragmoplastophyta;Streptophyta;Embryophyta;Tracheophyta;Spermatophyta;Magnoliophyta;Liliopsida;Asparagales;Cyrtosia;";"0.0";"0";"1";"1";"0";"1";"0";"457182";"391207"
"V4mis2";"SILVA (only NR);Eukaryota;Archaeplastida;Chloroplastida;Charophyta;Phragmoplastophyta;Streptophyta;Embryophyta;Tracheophyta;Spermatophyta;Magnoliophyta;Liliopsida;Asparagales;Dactylorhiza;";"0.0";"0";"1";"1";"0";"1";"0";"457182";"391207"
"V4mis2";"SILVA (only NR);Eukaryota;Archaeplastida;Chloroplastida;Charophyta;Phragmoplastophyta;Streptophyta;Embryophyta;Tracheophyta;Spermatophyta;Magnoliophyta;Liliopsida;Asparagales;Dasylirion;";"0.0";"0";"1";"1";"0";"1";"0";"457182";"391207"
"V4mis2";"SILVA (only NR);Eukaryota;Archaeplastida;Chloroplastida;Charophyta;Phragmoplastophyta;Streptophyta;Embryophyta;Tracheophyta;Spermatophyta;Magnoliophyta;Liliopsida;Asparagales;Dendrobium;";"0.0";"0";"1";"1";"0";"1";"0";"457182";"391207"
"V4mis2";"SILVA (only NR);Eukaryota;Archaeplastida;Chloroplastida;Charophyta;Phragmoplastophyta;Streptophyta;Embryophyta;Tracheophyta;Spermatophyta;Magnoliophyta;Liliopsida;Asparagales;Dianella;";"0.0";"0";"1";"1";"0";"1";"0";"457182";"391207"
"V4mis2";"SILVA (only NR);Eukaryota;Archaeplastida;Chloroplastida;Charophyta;Phragmoplastophyta;Streptophyta;Embryophyta;Tracheophyta;Spermatophyta;Magnoliophyta;Liliopsida;Asparagales;Dichaea;";"0.0";"0";"1";"1";"0";"1";"0";"457182";"391207"
"V4mis2";"SILVA (only NR);Eukaryota;Archaeplastida;Chloroplastida;Charophyta;Phragmoplastophyta;Streptophyta;Embryophyta;Tracheophyta;Spermatophyta;Magnoliophyta;Liliopsida;Asparagales;Dichelostemma;";"0.0";"0";"1";"1";"0";"1";"0";"457182";"391207"
"V4mis2";"SILVA (only NR);Eukaryota;Archaeplastida;Chloroplastida;Charophyta;Phragmoplastophyta;Streptophyta;Embryophyta;Tracheophyta;Spermatophyta;Magnoliophyta;Liliopsida;Asparagales;Diuris;";"0.0";"0";"1";"1";"0";"1";"0";"457182";"391207"
"V4mis2";"SILVA (only NR);Eukaryota;Archaeplastida;Chloroplastida;Charophyta;Phragmoplastophyta;Streptophyta;Embryophyta;Tracheophyta;Spermatophyta;Magnoliophyta;Liliopsida;Asparagales;Doryanthes;";"0.0";"0";"1";"1";"0";"1";"0";"457182";"391207"
"V4mis2";"SILVA (only NR);Eukaryota;Archaeplastida;Chloroplastida;Charophyta;Phragmoplastophyta;Streptophyta;Embryophyta;Tracheophyta;Spermatophyta;Magnoliophyta;Liliopsida;Asparagales;Drimia;";"0.0";"0";"1";"1";"0";"1";"0";"457182";"391207"
"V4mis2";"SILVA (only NR);Eukaryota;Archaeplastida;Chloroplastida;Charophyta;Phragmoplastophyta;Streptophyta;Embryophyta;Tracheophyta;Spermatophyta;Magnoliophyta;Liliopsida;Asparagales;Duckeella;";"0.0";"0";"2";"2";"0";"2";"0";"457181";"391207"
"V4mis2";"SILVA (only NR);Eukaryota;Archaeplastida;Chloroplastida;Charophyta;Phragmoplastophyta;Streptophyta;Embryophyta;Tracheophyta;Spermatophyta;Magnoliophyta;Liliopsida;Asparagales;Echeandia;";"0.0";"0";"1";"1";"0";"1";"0";"457182";"391207"
"V4mis2";"SILVA (only NR);Eukaryota;Archaeplastida;Chloroplastida;Charophyta;Phragmoplastophyta;Streptophyta;Embryophyta;Tracheophyta;Spermatophyta;Magnoliophyta;Liliopsida;Asparagales;Epistephium;";"0.0";"0";"2";"2";"0";"2";"0";"457181";"391207"
"V4mis2";"SILVA (only NR);Eukaryota;Archaeplastida;Chloroplastida;Charophyta;Phragmoplastophyta;Streptophyta;Embryophyta;Tracheophyta;Spermatophyta;Magnoliophyta;Liliopsida;Asparagales;Eremurus;";"0.0";"0";"1";"1";"0";"1";"0";"457182";"391207"
"V4mis2";"SILVA (only NR);Eukaryota;Archaeplastida;Chloroplastida;Charophyta;Phragmoplastophyta;Streptophyta;Embryophyta;Tracheophyta;Spermatophyta;Magnoliophyta;Liliopsida;Asparagales;Eriaxis;";"0.0";"0";"1";"1";"0";"1";"0";"457182";"391207"
"V4mis2";"SILVA (only NR);Eukaryota;Archaeplastida;Chloroplastida;Charophyta;Phragmoplastophyta;Streptophyta;Embryophyta;Tracheophyta;Spermatophyta;Magnoliophyta;Liliopsida;Asparagales;Eriospermum;";"0.0";"0";"1";"1";"0";"1";"0";"457182";"391207"
"V4mis2";"SILVA (only NR);Eukaryota;Archaeplastida;Chloroplastida;Charophyta;Phragmoplastophyta;Streptophyta;Embryophyta;Tracheophyta;Spermatophyta;Magnoliophyta;Liliopsida;Asparagales;Erythrorchis;";"0.0";"0";"1";"1";"0";"1";"0";"457182";"391207"
"V4mis2";"SILVA (only NR);Eukaryota;Archaeplastida;Chloroplastida;Charophyta;Phragmoplastophyta;Streptophyta;Embryophyta;Tracheophyta;Spermatophyta;Magnoliophyta;Liliopsida;Asparagales;Eucharis;";"0.0";"0";"1";"1";"0";"1";"0";"457182";"391207"
"V4mis2";"SILVA (only NR);Eukaryota;Archaeplastida;Chloroplastida;Charophyta;Phragmoplastophyta;Streptophyta;Embryophyta;Tracheophyta;Spermatophyta;Magnoliophyta;Liliopsida;Asparagales;Eucomis;";"0.0";"0";"1";"1";"0";"1";"0";"457182";"391207"
"V4mis2";"SILVA (only NR);Eukaryota;Archaeplastida;Chloroplastida;Charophyta;Phragmoplastophyta;Streptophyta;Embryophyta;Tracheophyta;Spermatophyta;Magnoliophyta;Liliopsida;Asparagales;Eustrephus;";"0.0";"0";"1";"1";"0";"1";"0";"457182";"391207"
"V4mis2";"SILVA (only NR);Eukaryota;Archaeplastida;Chloroplastida;Charophyta;Phragmoplastophyta;Streptophyta;Embryophyta;Tracheophyta;Spermatophyta;Magnoliophyta;Liliopsida;Asparagales;Galeola;";"0.0";"0";"1";"1";"0";"1";"0";"457182";"391207"
"V4mis2";"SILVA (only NR);Eukaryota;Archaeplastida;Chloroplastida;Charophyta;Phragmoplastophyta;Streptophyta;Embryophyta;Tracheophyta;Spermatophyta;Magnoliophyta;Liliopsida;Asparagales;Gilliesia;";"0.0";"0";"1";"1";"0";"1";"0";"457182";"391207"
"V4mis2";"SILVA (only NR);Eukaryota;Archaeplastida;Chloroplastida;Charophyta;Phragmoplastophyta;Streptophyta;Embryophyta;Tracheophyta;Spermatophyta;Magnoliophyta;Liliopsida;Asparagales;Gladiolus;";"0.0";"0";"1";"1";"0";"1";"0";"457182";"391207"
"V4mis2";"SILVA (only NR);Eukaryota;Archaeplastida;Chloroplastida;Charophyta;Phragmoplastophyta;Streptophyta;Embryophyta;Tracheophyta;Spermatophyta;Magnoliophyta;Liliopsida;Asparagales;Habenaria;";"0.0";"0";"1";"1";"0";"1";"0";"457182";"391207"
"V4mis2";"SILVA (only NR);Eukaryota;Archaeplastida;Chloroplastida;Charophyta;Phragmoplastophyta;Streptophyta;Embryophyta;Tracheophyta;Spermatophyta;Magnoliophyta;Liliopsida;Asparagales;Herreria;";"0.0";"0";"2";"2";"0";"2";"0";"457181";"391207"
"V4mis2";"SILVA (only NR);Eukaryota;Archaeplastida;Chloroplastida;Charophyta;Phragmoplastophyta;Streptophyta;Embryophyta;Tracheophyta;Spermatophyta;Magnoliophyta;Liliopsida;Asparagales;Hypoxis;";"0.0";"0";"1";"1";"0";"1";"0";"457182";"391207"
"V4mis2";"SILVA (only NR);Eukaryota;Archaeplastida;Chloroplastida;Charophyta;Phragmoplastophyta;Streptophyta;Embryophyta;Tracheophyta;Spermatophyta;Magnoliophyta;Liliopsida;Asparagales;Iris;";"0.0";"0";"1";"1";"0";"1";"0";"457182";"391207"
"V4mis2";"SILVA (only NR);Eukaryota;Archaeplastida;Chloroplastida;Charophyta;Phragmoplastophyta;Streptophyta;Embryophyta;Tracheophyta;Spermatophyta;Magnoliophyta;Liliopsida;Asparagales;Isophysis;";"0.0";"0";"1";"1";"0";"1";"0";"457182";"391207"
"V4mis2";"SILVA (only NR);Eukaryota;Archaeplastida;Chloroplastida;Charophyta;Phragmoplastophyta;Streptophyta;Embryophyta;Tracheophyta;Spermatophyta;Magnoliophyta;Liliopsida;Asparagales;Isotria;";"0.0";"0";"1";"1";"0";"1";"0";"457182";"391207"
"V4mis2";"SILVA (only NR);Eukaryota;Archaeplastida;Chloroplastida;Charophyta;Phragmoplastophyta;Streptophyta;Embryophyta;Tracheophyta;Spermatophyta;Magnoliophyta;Liliopsida;Asparagales;Ixiolirion;";"0.0";"0";"1";"1";"0";"1";"0";"457182";"391207"
"V4mis2";"SILVA (only NR);Eukaryota;Archaeplastida;Chloroplastida;Charophyta;Phragmoplastophyta;Streptophyta;Embryophyta;Tracheophyta;Spermatophyta;Magnoliophyta;Liliopsida;Asparagales;Kniphofia;";"0.0";"0";"1";"1";"0";"1";"0";"457182";"391207"
"V4mis2";"SILVA (only NR);Eukaryota;Archaeplastida;Chloroplastida;Charophyta;Phragmoplastophyta;Streptophyta;Embryophyta;Tracheophyta;Spermatophyta;Magnoliophyta;Liliopsida;Asparagales;Lanaria;";"0.0";"0";"1";"1";"0";"1";"0";"457182";"391207"
"V4mis2";"SILVA (only NR);Eukaryota;Archaeplastida;Chloroplastida;Charophyta;Phragmoplastophyta;Streptophyta;Embryophyta;Tracheophyta;Spermatophyta;Magnoliophyta;Liliopsida;Asparagales;Laxmannia;";"0.0";"0";"1";"1";"0";"1";"0";"457182";"391207"
"V4mis2";"SILVA (only NR);Eukaryota;Archaeplastida;Chloroplastida;Charophyta;Phragmoplastophyta;Streptophyta;Embryophyta;Tracheophyta;Spermatophyta;Magnoliophyta;Liliopsida;Asparagales;Lecanorchis;";"0.0";"0";"1";"1";"0";"1";"0";"457182";"391207"
"V4mis2";"SILVA (only NR);Eukaryota;Archaeplastida;Chloroplastida;Charophyta;Phragmoplastophyta;Streptophyta;Embryophyta;Tracheophyta;Spermatophyta;Magnoliophyta;Liliopsida;Asparagales;Ledebouria;";"0.0";"0";"2";"2";"0";"2";"0";"457181";"391207"
"V4mis2";"SILVA (only NR);Eukaryota;Archaeplastida;Chloroplastida;Charophyta;Phragmoplastophyta;Streptophyta;Embryophyta;Tracheophyta;Spermatophyta;Magnoliophyta;Liliopsida;Asparagales;Liriope;";"0.0";"0";"1";"1";"0";"1";"0";"457182";"391207"
"V4mis2";"SILVA (only NR);Eukaryota;Archaeplastida;Chloroplastida;Charophyta;Phragmoplastophyta;Streptophyta;Embryophyta;Tracheophyta;Spermatophyta;Magnoliophyta;Liliopsida;Asparagales;Listera;";"0.0";"0";"1";"1";"0";"1";"0";"457182";"391207"
"V4mis2";"SILVA (only NR);Eukaryota;Archaeplastida;Chloroplastida;Charophyta;Phragmoplastophyta;Streptophyta;Embryophyta;Tracheophyta;Spermatophyta;Magnoliophyta;Liliopsida;Asparagales;Lomandra;";"0.0";"0";"2";"2";"0";"2";"0";"457181";"391207"
"V4mis2";"SILVA (only NR);Eukaryota;Archaeplastida;Chloroplastida;Charophyta;Phragmoplastophyta;Streptophyta;Embryophyta;Tracheophyta;Spermatophyta;Magnoliophyta;Liliopsida;Asparagales;Lycoris;";"0.0";"0";"5";"5";"0";"5";"0";"457178";"391207"
"V4mis2";"SILVA (only NR);Eukaryota;Archaeplastida;Chloroplastida;Charophyta;Phragmoplastophyta;Streptophyta;Embryophyta;Tracheophyta;Spermatophyta;Magnoliophyta;Liliopsida;Asparagales;Milligania;";"0.0";"0";"1";"1";"0";"1";"0";"457182";"391207"
"V4mis2";"SILVA (only NR);Eukaryota;Archaeplastida;Chloroplastida;Charophyta;Phragmoplastophyta;Streptophyta;Embryophyta;Tracheophyta;Spermatophyta;Magnoliophyta;Liliopsida;Asparagales;Narcissus;";"0.0";"0";"1";"1";"0";"1";"0";"457182";"391207"
"V4mis2";"SILVA (only NR);Eukaryota;Archaeplastida;Chloroplastida;Charophyta;Phragmoplastophyta;Streptophyta;Embryophyta;Tracheophyta;Spermatophyta;Magnoliophyta;Liliopsida;Asparagales;Neottia;";"0.0";"0";"1";"1";"0";"1";"0";"457182";"391207"
"V4mis2";"SILVA (only NR);Eukaryota;Archaeplastida;Chloroplastida;Charophyta;Phragmoplastophyta;Streptophyta;Embryophyta;Tracheophyta;Spermatophyta;Magnoliophyta;Liliopsida;Asparagales;Neuwiedia;";"0.0";"0";"1";"1";"0";"1";"0";"457182";"391207"
"V4mis2";"SILVA (only NR);Eukaryota;Archaeplastida;Chloroplastida;Charophyta;Phragmoplastophyta;Streptophyta;Embryophyta;Tracheophyta;Spermatophyta;Magnoliophyta;Liliopsida;Asparagales;Oncidium;";"0.0";"0";"2";"2";"0";"2";"0";"457181";"391207"
"V4mis2";"SILVA (only NR);Eukaryota;Archaeplastida;Chloroplastida;Charophyta;Phragmoplastophyta;Streptophyta;Embryophyta;Tracheophyta;Spermatophyta;Magnoliophyta;Liliopsida;Asparagales;Orchis;";"0.0";"0";"1";"1";"0";"1";"0";"457182";"391207"
"V4mis2";"SILVA (only NR);Eukaryota;Archaeplastida;Chloroplastida;Charophyta;Phragmoplastophyta;Streptophyta;Embryophyta;Tracheophyta;Spermatophyta;Magnoliophyta;Liliopsida;Asparagales;Palmorchis;";"0.0";"0";"1";"1";"0";"1";"0";"457182";"391207"
"V4mis2";"SILVA (only NR);Eukaryota;Archaeplastida;Chloroplastida;Charophyta;Phragmoplastophyta;Streptophyta;Embryophyta;Tracheophyta;Spermatophyta;Magnoliophyta;Liliopsida;Asparagales;Paphiopedilum;";"0.0";"0";"1";"1";"0";"1";"0";"457182";"391207"
"V4mis2";"SILVA (only NR);Eukaryota;Archaeplastida;Chloroplastida;Charophyta;Phragmoplastophyta;Streptophyta;Embryophyta;Tracheophyta;Spermatophyta;Magnoliophyta;Liliopsida;Asparagales;Peliosanthes;";"0.0";"0";"2";"2";"0";"2";"0";"457181";"391207"
"V4mis2";"SILVA (only NR);Eukaryota;Archaeplastida;Chloroplastida;Charophyta;Phragmoplastophyta;Streptophyta;Embryophyta;Tracheophyta;Spermatophyta;Magnoliophyta;Liliopsida;Asparagales;Phalaenopsis;";"0.0";"0";"3";"3";"0";"3";"0";"457180";"391207"
"V4mis2";"SILVA (only NR);Eukaryota;Archaeplastida;Chloroplastida;Charophyta;Phragmoplastophyta;Streptophyta;Embryophyta;Tracheophyta;Spermatophyta;Magnoliophyta;Liliopsida;Asparagales;Phormium;";"0.0";"0";"1";"1";"0";"1";"0";"457182";"391207"
"V4mis2";"SILVA (only NR);Eukaryota;Archaeplastida;Chloroplastida;Charophyta;Phragmoplastophyta;Streptophyta;Embryophyta;Tracheophyta;Spermatophyta;Magnoliophyta;Liliopsida;Asparagales;Pogonia;";"0.0";"0";"1";"1";"0";"1";"0";"457182";"391207"
"V4mis2";"SILVA (only NR);Eukaryota;Archaeplastida;Chloroplastida;Charophyta;Phragmoplastophyta;Streptophyta;Embryophyta;Tracheophyta;Spermatophyta;Magnoliophyta;Liliopsida;Asparagales;Pogoniopsis;";"0.0";"0";"1";"1";"0";"1";"0";"457182";"391207"
"V4mis2";"SILVA (only NR);Eukaryota;Archaeplastida;Chloroplastida;Charophyta;Phragmoplastophyta;Streptophyta;Embryophyta;Tracheophyta;Spermatophyta;Magnoliophyta;Liliopsida;Asparagales;Pseudovanilla;";"0.0";"0";"1";"1";"0";"1";"0";"457182";"391207"
"V4mis2";"SILVA (only NR);Eukaryota;Archaeplastida;Chloroplastida;Charophyta;Phragmoplastophyta;Streptophyta;Embryophyta;Tracheophyta;Spermatophyta;Magnoliophyta;Liliopsida;Asparagales;Psilochilus;";"0.0";"0";"1";"1";"0";"1";"0";"457182";"391207"
"V4mis2";"SILVA (only NR);Eukaryota;Archaeplastida;Chloroplastida;Charophyta;Phragmoplastophyta;Streptophyta;Embryophyta;Tracheophyta;Spermatophyta;Magnoliophyta;Liliopsida;Asparagales;Rhizanthella;";"0.0";"0";"1";"1";"0";"1";"0";"457182";"391207"
"V4mis2";"SILVA (only NR);Eukaryota;Archaeplastida;Chloroplastida;Charophyta;Phragmoplastophyta;Streptophyta;Embryophyta;Tracheophyta;Spermatophyta;Magnoliophyta;Liliopsida;Asparagales;Rhodohypoxis;";"0.0";"0";"1";"1";"0";"1";"0";"457182";"391207"
"V4mis2";"SILVA (only NR);Eukaryota;Archaeplastida;Chloroplastida;Charophyta;Phragmoplastophyta;Streptophyta;Embryophyta;Tracheophyta;Spermatophyta;Magnoliophyta;Liliopsida;Asparagales;Ruscus;";"0.0";"0";"1";"1";"0";"1";"0";"457182";"391207"
"V4mis2";"SILVA (only NR);Eukaryota;Archaeplastida;Chloroplastida;Charophyta;Phragmoplastophyta;Streptophyta;Embryophyta;Tracheophyta;Spermatophyta;Magnoliophyta;Liliopsida;Asparagales;Sansevieria;";"0.0";"0";"1";"1";"0";"1";"0";"457182";"391207"
"V4mis2";"SILVA (only NR);Eukaryota;Archaeplastida;Chloroplastida;Charophyta;Phragmoplastophyta;Streptophyta;Embryophyta;Tracheophyta;Spermatophyta;Magnoliophyta;Liliopsida;Asparagales;Scadoxus;";"0.0";"0";"1";"1";"0";"1";"0";"457182";"391207"
"V4mis2";"SILVA (only NR);Eukaryota;Archaeplastida;Chloroplastida;Charophyta;Phragmoplastophyta;Streptophyta;Embryophyta;Tracheophyta;Spermatophyta;Magnoliophyta;Liliopsida;Asparagales;Spiranthes;";"0.0";"0";"1";"1";"0";"1";"0";"457182";"391207"
"V4mis2";"SILVA (only NR);Eukaryota;Archaeplastida;Chloroplastida;Charophyta;Phragmoplastophyta;Streptophyta;Embryophyta;Tracheophyta;Spermatophyta;Magnoliophyta;Liliopsida;Asparagales;Triphora;";"0.0";"0";"2";"2";"0";"2";"0";"457181";"391207"
"V4mis2";"SILVA (only NR);Eukaryota;Archaeplastida;Chloroplastida;Charophyta;Phragmoplastophyta;Streptophyta;Embryophyta;Tracheophyta;Spermatophyta;Magnoliophyta;Liliopsida;Asparagales;Tristagma;";"0.0";"0";"1";"1";"0";"1";"0";"457182";"391207"
"V4mis2";"SILVA (only NR);Eukaryota;Archaeplastida;Chloroplastida;Charophyta;Phragmoplastophyta;Streptophyta;Embryophyta;Tracheophyta;Spermatophyta;Magnoliophyta;Liliopsida;Asparagales;Tropidia;";"0.0";"0";"1";"1";"0";"1";"0";"457182";"391207"
"V4mis2";"SILVA (only NR);Eukaryota;Archaeplastida;Chloroplastida;Charophyta;Phragmoplastophyta;Streptophyta;Embryophyta;Tracheophyta;Spermatophyta;Magnoliophyta;Liliopsida;Asparagales;Vanilla;";"0.0";"0";"3";"3";"0";"3";"0";"457180";"391207"
"V4mis2";"SILVA (only NR);Eukaryota;Archaeplastida;Chloroplastida;Charophyta;Phragmoplastophyta;Streptophyta;Embryophyta;Tracheophyta;Spermatophyta;Magnoliophyta;Liliopsida;Asparagales;Wullschlaegelia;";"0.0";"0";"1";"1";"0";"1";"0";"457182";"391207"
"V4mis2";"SILVA (only NR);Eukaryota;Archaeplastida;Chloroplastida;Charophyta;Phragmoplastophyta;Streptophyta;Embryophyta;Tracheophyta;Spermatophyta;Magnoliophyta;Liliopsida;Asparagales;Xanthorrhoea;";"0.0";"0";"1";"1";"0";"1";"0";"457182";"391207"
"V4mis2";"SILVA (only NR);Eukaryota;Archaeplastida;Chloroplastida;Charophyta;Phragmoplastophyta;Streptophyta;Embryophyta;Tracheophyta;Spermatophyta;Magnoliophyta;Liliopsida;Asparagales;Xeronema;";"0.0";"0";"1";"1";"0";"1";"0";"457182";"391207"
"V4mis2";"SILVA (only NR);Eukaryota;Archaeplastida;Chloroplastida;Charophyta;Phragmoplastophyta;Streptophyta;Embryophyta;Tracheophyta;Spermatophyta;Magnoliophyta;Liliopsida;Asparagales;Yucca;";"0.0";"0";"1";"1";"0";"1";"0";"457182";"391207"
"V4mis2";"SILVA (only NR);Eukaryota;Archaeplastida;Chloroplastida;Charophyta;Phragmoplastophyta;Streptophyta;Embryophyta;Tracheophyta;Spermatophyta;Magnoliophyta;Liliopsida;Asparagales;Zephyra;";"0.0";"0";"1";"1";"0";"1";"0";"457182";"391207"
"V4mis2";"SILVA (only NR);Eukaryota;Archaeplastida;Chloroplastida;Charophyta;Phragmoplastophyta;Streptophyta;Embryophyta;Tracheophyta;Spermatophyta;Magnoliophyta;Liliopsida;Commelinales;";"0.0";"0";"8";"8";"0";"8";"0";"457175";"391207"
"V4mis2";"SILVA (only NR);Eukaryota;Archaeplastida;Chloroplastida;Charophyta;Phragmoplastophyta;Streptophyta;Embryophyta;Tracheophyta;Spermatophyta;Magnoliophyta;Liliopsida;Commelinales;Amischotolype;";"0.0";"0";"1";"1";"0";"1";"0";"457182";"391207"
"V4mis2";"SILVA (only NR);Eukaryota;Archaeplastida;Chloroplastida;Charophyta;Phragmoplastophyta;Streptophyta;Embryophyta;Tracheophyta;Spermatophyta;Magnoliophyta;Liliopsida;Commelinales;Anigozanthos;";"0.0";"0";"1";"1";"0";"1";"0";"457182";"391207"
"V4mis2";"SILVA (only NR);Eukaryota;Archaeplastida;Chloroplastida;Charophyta;Phragmoplastophyta;Streptophyta;Embryophyta;Tracheophyta;Spermatophyta;Magnoliophyta;Liliopsida;Commelinales;Eichhornia;";"0.0";"0";"1";"1";"0";"1";"0";"457182";"391207"
"V4mis2";"SILVA (only NR);Eukaryota;Archaeplastida;Chloroplastida;Charophyta;Phragmoplastophyta;Streptophyta;Embryophyta;Tracheophyta;Spermatophyta;Magnoliophyta;Liliopsida;Commelinales;Hanguana;";"0.0";"0";"1";"1";"0";"1";"0";"457182";"391207"
"V4mis2";"SILVA (only NR);Eukaryota;Archaeplastida;Chloroplastida;Charophyta;Phragmoplastophyta;Streptophyta;Embryophyta;Tracheophyta;Spermatophyta;Magnoliophyta;Liliopsida;Commelinales;Philydrella;";"0.0";"0";"1";"1";"0";"1";"0";"457182";"391207"
"V4mis2";"SILVA (only NR);Eukaryota;Archaeplastida;Chloroplastida;Charophyta;Phragmoplastophyta;Streptophyta;Embryophyta;Tracheophyta;Spermatophyta;Magnoliophyta;Liliopsida;Commelinales;Philydrum;";"0.0";"0";"1";"1";"0";"1";"0";"457182";"391207"
"V4mis2";"SILVA (only NR);Eukaryota;Archaeplastida;Chloroplastida;Charophyta;Phragmoplastophyta;Streptophyta;Embryophyta;Tracheophyta;Spermatophyta;Magnoliophyta;Liliopsida;Commelinales;Pontederia;";"0.0";"0";"2";"2";"0";"2";"0";"457181";"391207"
"V4mis2";"SILVA (only NR);Eukaryota;Archaeplastida;Chloroplastida;Charophyta;Phragmoplastophyta;Streptophyta;Embryophyta;Tracheophyta;Spermatophyta;Magnoliophyta;Liliopsida;Dasypogonales;";"0.0";"0";"2";"2";"0";"2";"0";"457181";"391207"
"V4mis2";"SILVA (only NR);Eukaryota;Archaeplastida;Chloroplastida;Charophyta;Phragmoplastophyta;Streptophyta;Embryophyta;Tracheophyta;Spermatophyta;Magnoliophyta;Liliopsida;Dasypogonales;Calectasia;";"0.0";"0";"1";"1";"0";"1";"0";"457182";"391207"
"V4mis2";"SILVA (only NR);Eukaryota;Archaeplastida;Chloroplastida;Charophyta;Phragmoplastophyta;Streptophyta;Embryophyta;Tracheophyta;Spermatophyta;Magnoliophyta;Liliopsida;Dasypogonales;Dasypogon;";"0.0";"0";"1";"1";"0";"1";"0";"457182";"391207"
"V4mis2";"SILVA (only NR);Eukaryota;Archaeplastida;Chloroplastida;Charophyta;Phragmoplastophyta;Streptophyta;Embryophyta;Tracheophyta;Spermatophyta;Magnoliophyta;Liliopsida;Dioscoreales;";"0.0";"0";"92";"92";"0";"92";"0";"457091";"391207"
"V4mis2";"SILVA (only NR);Eukaryota;Archaeplastida;Chloroplastida;Charophyta;Phragmoplastophyta;Streptophyta;Embryophyta;Tracheophyta;Spermatophyta;Magnoliophyta;Liliopsida;Dioscoreales;Afrothismia;";"0.0";"0";"3";"3";"0";"3";"0";"457180";"391207"
"V4mis2";"SILVA (only NR);Eukaryota;Archaeplastida;Chloroplastida;Charophyta;Phragmoplastophyta;Streptophyta;Embryophyta;Tracheophyta;Spermatophyta;Magnoliophyta;Liliopsida;Dioscoreales;Aletris;";"0.0";"0";"2";"2";"0";"2";"0";"457181";"391207"
"V4mis2";"SILVA (only NR);Eukaryota;Archaeplastida;Chloroplastida;Charophyta;Phragmoplastophyta;Streptophyta;Embryophyta;Tracheophyta;Spermatophyta;Magnoliophyta;Liliopsida;Dioscoreales;Apteria;";"0.0";"0";"1";"1";"0";"1";"0";"457182";"391207"
"V4mis2";"SILVA (only NR);Eukaryota;Archaeplastida;Chloroplastida;Charophyta;Phragmoplastophyta;Streptophyta;Embryophyta;Tracheophyta;Spermatophyta;Magnoliophyta;Liliopsida;Dioscoreales;Burmannia;";"0.0";"0";"18";"18";"0";"18";"0";"457165";"391207"
"V4mis2";"SILVA (only NR);Eukaryota;Archaeplastida;Chloroplastida;Charophyta;Phragmoplastophyta;Streptophyta;Embryophyta;Tracheophyta;Spermatophyta;Magnoliophyta;Liliopsida;Dioscoreales;Campylosiphon;";"0.0";"0";"1";"1";"0";"1";"0";"457182";"391207"
"V4mis2";"SILVA (only NR);Eukaryota;Archaeplastida;Chloroplastida;Charophyta;Phragmoplastophyta;Streptophyta;Embryophyta;Tracheophyta;Spermatophyta;Magnoliophyta;Liliopsida;Dioscoreales;Cymbocarpa;";"0.0";"0";"2";"2";"0";"2";"0";"457181";"391207"
"V4mis2";"SILVA (only NR);Eukaryota;Archaeplastida;Chloroplastida;Charophyta;Phragmoplastophyta;Streptophyta;Embryophyta;Tracheophyta;Spermatophyta;Magnoliophyta;Liliopsida;Dioscoreales;Dictyostega;";"0.0";"0";"1";"1";"0";"1";"0";"457182";"391207"
"V4mis2";"SILVA (only NR);Eukaryota;Archaeplastida;Chloroplastida;Charophyta;Phragmoplastophyta;Streptophyta;Embryophyta;Tracheophyta;Spermatophyta;Magnoliophyta;Liliopsida;Dioscoreales;Dioscorea;";"0.0";"0";"37";"37";"0";"37";"0";"457146";"391207"
"V4mis2";"SILVA (only NR);Eukaryota;Archaeplastida;Chloroplastida;Charophyta;Phragmoplastophyta;Streptophyta;Embryophyta;Tracheophyta;Spermatophyta;Magnoliophyta;Liliopsida;Dioscoreales;Gymnosiphon;";"0.0";"0";"6";"6";"0";"6";"0";"457177";"391207"
"V4mis2";"SILVA (only NR);Eukaryota;Archaeplastida;Chloroplastida;Charophyta;Phragmoplastophyta;Streptophyta;Embryophyta;Tracheophyta;Spermatophyta;Magnoliophyta;Liliopsida;Dioscoreales;Haplothismia;";"0.0";"0";"1";"1";"0";"1";"0";"457182";"391207"
"V4mis2";"SILVA (only NR);Eukaryota;Archaeplastida;Chloroplastida;Charophyta;Phragmoplastophyta;Streptophyta;Embryophyta;Tracheophyta;Spermatophyta;Magnoliophyta;Liliopsida;Dioscoreales;Hexapterella;";"0.0";"0";"1";"1";"0";"1";"0";"457182";"391207"
"V4mis2";"SILVA (only NR);Eukaryota;Archaeplastida;Chloroplastida;Charophyta;Phragmoplastophyta;Streptophyta;Embryophyta;Tracheophyta;Spermatophyta;Magnoliophyta;Liliopsida;Dioscoreales;Metanarthecium;";"0.0";"0";"1";"1";"0";"1";"0";"457182";"391207"
"V4mis2";"SILVA (only NR);Eukaryota;Archaeplastida;Chloroplastida;Charophyta;Phragmoplastophyta;Streptophyta;Embryophyta;Tracheophyta;Spermatophyta;Magnoliophyta;Liliopsida;Dioscoreales;Narthecium;";"0.0";"0";"1";"1";"0";"1";"0";"457182";"391207"
"V4mis2";"SILVA (only NR);Eukaryota;Archaeplastida;Chloroplastida;Charophyta;Phragmoplastophyta;Streptophyta;Embryophyta;Tracheophyta;Spermatophyta;Magnoliophyta;Liliopsida;Dioscoreales;Oxygyne;";"0.0";"0";"1";"1";"0";"1";"0";"457182";"391207"
"V4mis2";"SILVA (only NR);Eukaryota;Archaeplastida;Chloroplastida;Charophyta;Phragmoplastophyta;Streptophyta;Embryophyta;Tracheophyta;Spermatophyta;Magnoliophyta;Liliopsida;Dioscoreales;Tacca;";"0.0";"0";"3";"3";"0";"3";"0";"457180";"391207"
"V4mis2";"SILVA (only NR);Eukaryota;Archaeplastida;Chloroplastida;Charophyta;Phragmoplastophyta;Streptophyta;Embryophyta;Tracheophyta;Spermatophyta;Magnoliophyta;Liliopsida;Dioscoreales;Thismia;";"0.0";"0";"11";"11";"0";"11";"0";"457172";"391207"
"V4mis2";"SILVA (only NR);Eukaryota;Archaeplastida;Chloroplastida;Charophyta;Phragmoplastophyta;Streptophyta;Embryophyta;Tracheophyta;Spermatophyta;Magnoliophyta;Liliopsida;Dioscoreales;Tiputinia;";"0.0";"0";"1";"1";"0";"1";"0";"457182";"391207"
"V4mis2";"SILVA (only NR);Eukaryota;Archaeplastida;Chloroplastida;Charophyta;Phragmoplastophyta;Streptophyta;Embryophyta;Tracheophyta;Spermatophyta;Magnoliophyta;Liliopsida;Dioscoreales;Trichopus;";"0.0";"0";"1";"1";"0";"1";"0";"457182";"391207"
"V4mis2";"SILVA (only NR);Eukaryota;Archaeplastida;Chloroplastida;Charophyta;Phragmoplastophyta;Streptophyta;Embryophyta;Tracheophyta;Spermatophyta;Magnoliophyta;Liliopsida;Incertae Sedis;";"0.0";"0";"31";"31";"0";"31";"0";"457152";"391207"
"V4mis2";"SILVA (only NR);Eukaryota;Archaeplastida;Chloroplastida;Charophyta;Phragmoplastophyta;Streptophyta;Embryophyta;Tracheophyta;Spermatophyta;Magnoliophyta;Liliopsida;Incertae Sedis;Anthurium;";"0.0";"0";"1";"1";"0";"1";"0";"457182";"391207"
"V4mis2";"SILVA (only NR);Eukaryota;Archaeplastida;Chloroplastida;Charophyta;Phragmoplastophyta;Streptophyta;Embryophyta;Tracheophyta;Spermatophyta;Magnoliophyta;Liliopsida;Incertae Sedis;Astrocaryum;";"0.0";"0";"1";"1";"0";"1";"0";"457182";"391207"
"V4mis2";"SILVA (only NR);Eukaryota;Archaeplastida;Chloroplastida;Charophyta;Phragmoplastophyta;Streptophyta;Embryophyta;Tracheophyta;Spermatophyta;Magnoliophyta;Liliopsida;Incertae Sedis;Drymophloeus;";"0.0";"0";"1";"1";"0";"1";"0";"457182";"391207"
"V4mis2";"SILVA (only NR);Eukaryota;Archaeplastida;Chloroplastida;Charophyta;Phragmoplastophyta;Streptophyta;Embryophyta;Tracheophyta;Spermatophyta;Magnoliophyta;Liliopsida;Incertae Sedis;Elaeis;";"0.0";"0";"9";"9";"0";"9";"0";"457174";"391207"
"V4mis2";"SILVA (only NR);Eukaryota;Archaeplastida;Chloroplastida;Charophyta;Phragmoplastophyta;Streptophyta;Embryophyta;Tracheophyta;Spermatophyta;Magnoliophyta;Liliopsida;Incertae Sedis;Elodea;";"0.0";"0";"2";"2";"0";"2";"0";"457181";"391207"
"V4mis2";"SILVA (only NR);Eukaryota;Archaeplastida;Chloroplastida;Charophyta;Phragmoplastophyta;Streptophyta;Embryophyta;Tracheophyta;Spermatophyta;Magnoliophyta;Liliopsida;Incertae Sedis;Halodule;";"0.0";"0";"1";"1";"0";"1";"0";"457182";"391207"
"V4mis2";"SILVA (only NR);Eukaryota;Archaeplastida;Chloroplastida;Charophyta;Phragmoplastophyta;Streptophyta;Embryophyta;Tracheophyta;Spermatophyta;Magnoliophyta;Liliopsida;Incertae Sedis;Halophila;";"0.0";"0";"4";"4";"0";"4";"0";"457179";"391207"
"V4mis2";"SILVA (only NR);Eukaryota;Archaeplastida;Chloroplastida;Charophyta;Phragmoplastophyta;Streptophyta;Embryophyta;Tracheophyta;Spermatophyta;Magnoliophyta;Liliopsida;Incertae Sedis;Mauritia;";"0.0";"0";"1";"1";"0";"1";"0";"457182";"391207"
"V4mis2";"SILVA (only NR);Eukaryota;Archaeplastida;Chloroplastida;Charophyta;Phragmoplastophyta;Streptophyta;Embryophyta;Tracheophyta;Spermatophyta;Magnoliophyta;Liliopsida;Incertae Sedis;Nypa;";"0.0";"0";"1";"1";"0";"1";"0";"457182";"391207"
"V4mis2";"SILVA (only NR);Eukaryota;Archaeplastida;Chloroplastida;Charophyta;Phragmoplastophyta;Streptophyta;Embryophyta;Tracheophyta;Spermatophyta;Magnoliophyta;Liliopsida;Incertae Sedis;Podococcus;";"0.0";"0";"1";"1";"0";"1";"0";"457182";"391207"
"V4mis2";"SILVA (only NR);Eukaryota;Archaeplastida;Chloroplastida;Charophyta;Phragmoplastophyta;Streptophyta;Embryophyta;Tracheophyta;Spermatophyta;Magnoliophyta;Liliopsida;Incertae Sedis;Posidonia;";"0.0";"0";"3";"3";"0";"3";"0";"457180";"391207"
"V4mis2";"SILVA (only NR);Eukaryota;Archaeplastida;Chloroplastida;Charophyta;Phragmoplastophyta;Streptophyta;Embryophyta;Tracheophyta;Spermatophyta;Magnoliophyta;Liliopsida;Incertae Sedis;Potamogeton;";"0.0";"0";"2";"2";"0";"2";"0";"457181";"391207"
"V4mis2";"SILVA (only NR);Eukaryota;Archaeplastida;Chloroplastida;Charophyta;Phragmoplastophyta;Streptophyta;Embryophyta;Tracheophyta;Spermatophyta;Magnoliophyta;Liliopsida;Incertae Sedis;Pseudophoenix;";"0.0";"0";"1";"1";"0";"1";"0";"457182";"391207"
"V4mis2";"SILVA (only NR);Eukaryota;Archaeplastida;Chloroplastida;Charophyta;Phragmoplastophyta;Streptophyta;Embryophyta;Tracheophyta;Spermatophyta;Magnoliophyta;Liliopsida;Incertae Sedis;Vallisneria;";"0.0";"0";"2";"2";"0";"2";"0";"457181";"391207"
"V4mis2";"SILVA (only NR);Eukaryota;Archaeplastida;Chloroplastida;Charophyta;Phragmoplastophyta;Streptophyta;Embryophyta;Tracheophyta;Spermatophyta;Magnoliophyta;Liliopsida;Incertae Sedis;Zostera;";"0.0";"0";"1";"1";"0";"1";"0";"457182";"391207"
"V4mis2";"SILVA (only NR);Eukaryota;Archaeplastida;Chloroplastida;Charophyta;Phragmoplastophyta;Streptophyta;Embryophyta;Tracheophyta;Spermatophyta;Magnoliophyta;Liliopsida;Liliales;";"0.0";"0";"34";"34";"0";"34";"0";"457149";"391207"
"V4mis2";"SILVA (only NR);Eukaryota;Archaeplastida;Chloroplastida;Charophyta;Phragmoplastophyta;Streptophyta;Embryophyta;Tracheophyta;Spermatophyta;Magnoliophyta;Liliopsida;Liliales;Alstroemeria;";"0.0";"0";"1";"1";"0";"1";"0";"457182";"391207"
"V4mis2";"SILVA (only NR);Eukaryota;Archaeplastida;Chloroplastida;Charophyta;Phragmoplastophyta;Streptophyta;Embryophyta;Tracheophyta;Spermatophyta;Magnoliophyta;Liliopsida;Liliales;Arachnitis;";"0.0";"0";"1";"1";"0";"1";"0";"457182";"391207"
"V4mis2";"SILVA (only NR);Eukaryota;Archaeplastida;Chloroplastida;Charophyta;Phragmoplastophyta;Streptophyta;Embryophyta;Tracheophyta;Spermatophyta;Magnoliophyta;Liliopsida;Liliales;Bomarea;";"0.0";"0";"1";"1";"0";"1";"0";"457182";"391207"
"V4mis2";"SILVA (only NR);Eukaryota;Archaeplastida;Chloroplastida;Charophyta;Phragmoplastophyta;Streptophyta;Embryophyta;Tracheophyta;Spermatophyta;Magnoliophyta;Liliopsida;Liliales;Calochortus;";"0.0";"0";"2";"2";"0";"2";"0";"457181";"391207"
"V4mis2";"SILVA (only NR);Eukaryota;Archaeplastida;Chloroplastida;Charophyta;Phragmoplastophyta;Streptophyta;Embryophyta;Tracheophyta;Spermatophyta;Magnoliophyta;Liliopsida;Liliales;Campynema;";"0.0";"0";"2";"2";"0";"2";"0";"457181";"391207"
"V4mis2";"SILVA (only NR);Eukaryota;Archaeplastida;Chloroplastida;Charophyta;Phragmoplastophyta;Streptophyta;Embryophyta;Tracheophyta;Spermatophyta;Magnoliophyta;Liliopsida;Liliales;Campynemanthe;";"0.0";"0";"1";"1";"0";"1";"0";"457182";"391207"
"V4mis2";"SILVA (only NR);Eukaryota;Archaeplastida;Chloroplastida;Charophyta;Phragmoplastophyta;Streptophyta;Embryophyta;Tracheophyta;Spermatophyta;Magnoliophyta;Liliopsida;Liliales;Chamaelirium;";"0.0";"0";"1";"1";"0";"1";"0";"457182";"391207"
"V4mis2";"SILVA (only NR);Eukaryota;Archaeplastida;Chloroplastida;Charophyta;Phragmoplastophyta;Streptophyta;Embryophyta;Tracheophyta;Spermatophyta;Magnoliophyta;Liliopsida;Liliales;Clintonia;";"0.0";"0";"1";"1";"0";"1";"0";"457182";"391207"
"V4mis2";"SILVA (only NR);Eukaryota;Archaeplastida;Chloroplastida;Charophyta;Phragmoplastophyta;Streptophyta;Embryophyta;Tracheophyta;Spermatophyta;Magnoliophyta;Liliopsida;Liliales;Colchicum;";"0.0";"0";"2";"2";"0";"2";"0";"457181";"391207"
"V4mis2";"SILVA (only NR);Eukaryota;Archaeplastida;Chloroplastida;Charophyta;Phragmoplastophyta;Streptophyta;Embryophyta;Tracheophyta;Spermatophyta;Magnoliophyta;Liliopsida;Liliales;Corsia;";"0.0";"0";"1";"1";"0";"1";"0";"457182";"391207"
"V4mis2";"SILVA (only NR);Eukaryota;Archaeplastida;Chloroplastida;Charophyta;Phragmoplastophyta;Streptophyta;Embryophyta;Tracheophyta;Spermatophyta;Magnoliophyta;Liliopsida;Liliales;Gloriosa;";"0.0";"0";"3";"3";"0";"3";"0";"457180";"391207"
"V4mis2";"SILVA (only NR);Eukaryota;Archaeplastida;Chloroplastida;Charophyta;Phragmoplastophyta;Streptophyta;Embryophyta;Tracheophyta;Spermatophyta;Magnoliophyta;Liliopsida;Liliales;Lilium;";"0.0";"0";"2";"2";"0";"2";"0";"457181";"391207"
"V4mis2";"SILVA (only NR);Eukaryota;Archaeplastida;Chloroplastida;Charophyta;Phragmoplastophyta;Streptophyta;Embryophyta;Tracheophyta;Spermatophyta;Magnoliophyta;Liliopsida;Liliales;Luzuriaga;";"0.0";"0";"1";"1";"0";"1";"0";"457182";"391207"
"V4mis2";"SILVA (only NR);Eukaryota;Archaeplastida;Chloroplastida;Charophyta;Phragmoplastophyta;Streptophyta;Embryophyta;Tracheophyta;Spermatophyta;Magnoliophyta;Liliopsida;Liliales;Petermannia;";"0.0";"0";"1";"1";"0";"1";"0";"457182";"391207"
"V4mis2";"SILVA (only NR);Eukaryota;Archaeplastida;Chloroplastida;Charophyta;Phragmoplastophyta;Streptophyta;Embryophyta;Tracheophyta;Spermatophyta;Magnoliophyta;Liliopsida;Liliales;Philesia;";"0.0";"0";"2";"2";"0";"2";"0";"457181";"391207"
"V4mis2";"SILVA (only NR);Eukaryota;Archaeplastida;Chloroplastida;Charophyta;Phragmoplastophyta;Streptophyta;Embryophyta;Tracheophyta;Spermatophyta;Magnoliophyta;Liliopsida;Liliales;Ripogonum;";"0.0";"0";"3";"3";"0";"3";"0";"457180";"391207"
"V4mis2";"SILVA (only NR);Eukaryota;Archaeplastida;Chloroplastida;Charophyta;Phragmoplastophyta;Streptophyta;Embryophyta;Tracheophyta;Spermatophyta;Magnoliophyta;Liliopsida;Liliales;Scoliopus;";"0.0";"0";"1";"1";"0";"1";"0";"457182";"391207"
"V4mis2";"SILVA (only NR);Eukaryota;Archaeplastida;Chloroplastida;Charophyta;Phragmoplastophyta;Streptophyta;Embryophyta;Tracheophyta;Spermatophyta;Magnoliophyta;Liliopsida;Liliales;Smilax;";"0.0";"0";"2";"2";"0";"2";"0";"457181";"391207"
"V4mis2";"SILVA (only NR);Eukaryota;Archaeplastida;Chloroplastida;Charophyta;Phragmoplastophyta;Streptophyta;Embryophyta;Tracheophyta;Spermatophyta;Magnoliophyta;Liliopsida;Liliales;Tricyrtis;";"0.0";"0";"2";"2";"0";"2";"0";"457181";"391207"
"V4mis2";"SILVA (only NR);Eukaryota;Archaeplastida;Chloroplastida;Charophyta;Phragmoplastophyta;Streptophyta;Embryophyta;Tracheophyta;Spermatophyta;Magnoliophyta;Liliopsida;Liliales;Trillium;";"0.0";"0";"2";"2";"0";"2";"0";"457181";"391207"
"V4mis2";"SILVA (only NR);Eukaryota;Archaeplastida;Chloroplastida;Charophyta;Phragmoplastophyta;Streptophyta;Embryophyta;Tracheophyta;Spermatophyta;Magnoliophyta;Liliopsida;Liliales;Veratrum;";"0.0";"0";"2";"2";"0";"2";"0";"457181";"391207"
"V4mis2";"SILVA (only NR);Eukaryota;Archaeplastida;Chloroplastida;Charophyta;Phragmoplastophyta;Streptophyta;Embryophyta;Tracheophyta;Spermatophyta;Magnoliophyta;Liliopsida;Pandanales;";"0.0";"0";"18";"18";"0";"18";"0";"457165";"391207"
"V4mis2";"SILVA (only NR);Eukaryota;Archaeplastida;Chloroplastida;Charophyta;Phragmoplastophyta;Streptophyta;Embryophyta;Tracheophyta;Spermatophyta;Magnoliophyta;Liliopsida;Pandanales;Acanthochlamys;";"0.0";"0";"1";"1";"0";"1";"0";"457182";"391207"
"V4mis2";"SILVA (only NR);Eukaryota;Archaeplastida;Chloroplastida;Charophyta;Phragmoplastophyta;Streptophyta;Embryophyta;Tracheophyta;Spermatophyta;Magnoliophyta;Liliopsida;Pandanales;Andruris;";"0.0";"0";"1";"1";"0";"1";"0";"457182";"391207"
"V4mis2";"SILVA (only NR);Eukaryota;Archaeplastida;Chloroplastida;Charophyta;Phragmoplastophyta;Streptophyta;Embryophyta;Tracheophyta;Spermatophyta;Magnoliophyta;Liliopsida;Pandanales;Carludovica;";"0.0";"0";"1";"1";"0";"1";"0";"457182";"391207"
"V4mis2";"SILVA (only NR);Eukaryota;Archaeplastida;Chloroplastida;Charophyta;Phragmoplastophyta;Streptophyta;Embryophyta;Tracheophyta;Spermatophyta;Magnoliophyta;Liliopsida;Pandanales;Kupea;";"0.0";"0";"1";"1";"0";"1";"0";"457182";"391207"
"V4mis2";"SILVA (only NR);Eukaryota;Archaeplastida;Chloroplastida;Charophyta;Phragmoplastophyta;Streptophyta;Embryophyta;Tracheophyta;Spermatophyta;Magnoliophyta;Liliopsida;Pandanales;Pandanus;";"0.0";"0";"1";"1";"0";"1";"0";"457182";"391207"
"V4mis2";"SILVA (only NR);Eukaryota;Archaeplastida;Chloroplastida;Charophyta;Phragmoplastophyta;Streptophyta;Embryophyta;Tracheophyta;Spermatophyta;Magnoliophyta;Liliopsida;Pandanales;Pentastemona;";"0.0";"0";"1";"1";"0";"1";"0";"457182";"391207"
"V4mis2";"SILVA (only NR);Eukaryota;Archaeplastida;Chloroplastida;Charophyta;Phragmoplastophyta;Streptophyta;Embryophyta;Tracheophyta;Spermatophyta;Magnoliophyta;Liliopsida;Pandanales;Sciaphila;";"0.0";"0";"7";"7";"0";"7";"0";"457176";"391207"
"V4mis2";"SILVA (only NR);Eukaryota;Archaeplastida;Chloroplastida;Charophyta;Phragmoplastophyta;Streptophyta;Embryophyta;Tracheophyta;Spermatophyta;Magnoliophyta;Liliopsida;Pandanales;Seychellaria;";"0.0";"0";"2";"2";"0";"2";"0";"457181";"391207"
"V4mis2";"SILVA (only NR);Eukaryota;Archaeplastida;Chloroplastida;Charophyta;Phragmoplastophyta;Streptophyta;Embryophyta;Tracheophyta;Spermatophyta;Magnoliophyta;Liliopsida;Pandanales;Stemona;";"0.0";"0";"1";"1";"0";"1";"0";"457182";"391207"
"V4mis2";"SILVA (only NR);Eukaryota;Archaeplastida;Chloroplastida;Charophyta;Phragmoplastophyta;Streptophyta;Embryophyta;Tracheophyta;Spermatophyta;Magnoliophyta;Liliopsida;Pandanales;Triuris;";"0.0";"0";"1";"1";"0";"1";"0";"457182";"391207"
"V4mis2";"SILVA (only NR);Eukaryota;Archaeplastida;Chloroplastida;Charophyta;Phragmoplastophyta;Streptophyta;Embryophyta;Tracheophyta;Spermatophyta;Magnoliophyta;Liliopsida;Pandanales;Xerophyta;";"0.0";"0";"1";"1";"0";"1";"0";"457182";"391207"
"V4mis2";"SILVA (only NR);Eukaryota;Archaeplastida;Chloroplastida;Charophyta;Phragmoplastophyta;Streptophyta;Embryophyta;Tracheophyta;Spermatophyta;Magnoliophyta;Liliopsida;Petrosaviales;";"0.0";"0";"2";"2";"0";"2";"0";"457181";"391207"
"V4mis2";"SILVA (only NR);Eukaryota;Archaeplastida;Chloroplastida;Charophyta;Phragmoplastophyta;Streptophyta;Embryophyta;Tracheophyta;Spermatophyta;Magnoliophyta;Liliopsida;Petrosaviales;Japonolirion;";"0.0";"0";"1";"1";"0";"1";"0";"457182";"391207"
"V4mis2";"SILVA (only NR);Eukaryota;Archaeplastida;Chloroplastida;Charophyta;Phragmoplastophyta;Streptophyta;Embryophyta;Tracheophyta;Spermatophyta;Magnoliophyta;Liliopsida;Petrosaviales;Petrosavia;";"0.0";"0";"1";"1";"0";"1";"0";"457182";"391207"
"V4mis2";"SILVA (only NR);Eukaryota;Archaeplastida;Chloroplastida;Charophyta;Phragmoplastophyta;Streptophyta;Embryophyta;Tracheophyta;Spermatophyta;Magnoliophyta;Liliopsida;Poales;";"5.8";"14.4";"244";"243";"14";"229";"1";"456940";"391193"
"V4mis2";"SILVA (only NR);Eukaryota;Archaeplastida;Chloroplastida;Charophyta;Phragmoplastophyta;Streptophyta;Embryophyta;Tracheophyta;Spermatophyta;Magnoliophyta;Liliopsida;Poales;Abolboda;";"0.0";"0";"1";"1";"0";"1";"0";"457182";"391207"
"V4mis2";"SILVA (only NR);Eukaryota;Archaeplastida;Chloroplastida;Charophyta;Phragmoplastophyta;Streptophyta;Embryophyta;Tracheophyta;Spermatophyta;Magnoliophyta;Liliopsida;Poales;Agrostis;";"0.0";"0";"1";"1";"0";"1";"0";"457182";"391207"
"V4mis2";"SILVA (only NR);Eukaryota;Archaeplastida;Chloroplastida;Charophyta;Phragmoplastophyta;Streptophyta;Embryophyta;Tracheophyta;Spermatophyta;Magnoliophyta;Liliopsida;Poales;Ananas;";"0.0";"0";"5";"5";"0";"5";"0";"457178";"391207"
"V4mis2";"SILVA (only NR);Eukaryota;Archaeplastida;Chloroplastida;Charophyta;Phragmoplastophyta;Streptophyta;Embryophyta;Tracheophyta;Spermatophyta;Magnoliophyta;Liliopsida;Poales;Baloskion;";"0.0";"0";"1";"1";"0";"1";"0";"457182";"391207"
"V4mis2";"SILVA (only NR);Eukaryota;Archaeplastida;Chloroplastida;Charophyta;Phragmoplastophyta;Streptophyta;Embryophyta;Tracheophyta;Spermatophyta;Magnoliophyta;Liliopsida;Poales;Billbergia;";"0.0";"0";"1";"1";"0";"1";"0";"457182";"391207"
"V4mis2";"SILVA (only NR);Eukaryota;Archaeplastida;Chloroplastida;Charophyta;Phragmoplastophyta;Streptophyta;Embryophyta;Tracheophyta;Spermatophyta;Magnoliophyta;Liliopsida;Poales;Bromus;";"0.0";"0";"1";"1";"0";"1";"0";"457182";"391207"
"V4mis2";"SILVA (only NR);Eukaryota;Archaeplastida;Chloroplastida;Charophyta;Phragmoplastophyta;Streptophyta;Embryophyta;Tracheophyta;Spermatophyta;Magnoliophyta;Liliopsida;Poales;Carex;";"0.0";"0";"1";"1";"0";"1";"0";"457182";"391207"
"V4mis2";"SILVA (only NR);Eukaryota;Archaeplastida;Chloroplastida;Charophyta;Phragmoplastophyta;Streptophyta;Embryophyta;Tracheophyta;Spermatophyta;Magnoliophyta;Liliopsida;Poales;Cenchrus;";"0.0";"0";"7";"6";"0";"6";"1";"457177";"391207"
"V4mis2";"SILVA (only NR);Eukaryota;Archaeplastida;Chloroplastida;Charophyta;Phragmoplastophyta;Streptophyta;Embryophyta;Tracheophyta;Spermatophyta;Magnoliophyta;Liliopsida;Poales;Dendrocalamus;";"0.0";"0";"1";"1";"0";"1";"0";"457182";"391207"
"V4mis2";"SILVA (only NR);Eukaryota;Archaeplastida;Chloroplastida;Charophyta;Phragmoplastophyta;Streptophyta;Embryophyta;Tracheophyta;Spermatophyta;Magnoliophyta;Liliopsida;Poales;Dichanthelium;";"0.0";"0";"1";"1";"0";"1";"0";"457182";"391207"
"V4mis2";"SILVA (only NR);Eukaryota;Archaeplastida;Chloroplastida;Charophyta;Phragmoplastophyta;Streptophyta;Embryophyta;Tracheophyta;Spermatophyta;Magnoliophyta;Liliopsida;Poales;Ecdeiocolea;";"0.0";"0";"2";"2";"0";"2";"0";"457181";"391207"
"V4mis2";"SILVA (only NR);Eukaryota;Archaeplastida;Chloroplastida;Charophyta;Phragmoplastophyta;Streptophyta;Embryophyta;Tracheophyta;Spermatophyta;Magnoliophyta;Liliopsida;Poales;Echinochloa;";"0.0";"0";"1";"1";"0";"1";"0";"457182";"391207"
"V4mis2";"SILVA (only NR);Eukaryota;Archaeplastida;Chloroplastida;Charophyta;Phragmoplastophyta;Streptophyta;Embryophyta;Tracheophyta;Spermatophyta;Magnoliophyta;Liliopsida;Poales;Elegia;";"0.0";"0";"1";"1";"0";"1";"0";"457182";"391207"
"V4mis2";"SILVA (only NR);Eukaryota;Archaeplastida;Chloroplastida;Charophyta;Phragmoplastophyta;Streptophyta;Embryophyta;Tracheophyta;Spermatophyta;Magnoliophyta;Liliopsida;Poales;Eleocharis;";"0.0";"0";"1";"1";"0";"1";"0";"457182";"391207"
"V4mis2";"SILVA (only NR);Eukaryota;Archaeplastida;Chloroplastida;Charophyta;Phragmoplastophyta;Streptophyta;Embryophyta;Tracheophyta;Spermatophyta;Magnoliophyta;Liliopsida;Poales;Eleusine;";"0.0";"0";"1";"1";"0";"1";"0";"457182";"391207"
"V4mis2";"SILVA (only NR);Eukaryota;Archaeplastida;Chloroplastida;Charophyta;Phragmoplastophyta;Streptophyta;Embryophyta;Tracheophyta;Spermatophyta;Magnoliophyta;Liliopsida;Poales;Eragrostis;";"0.0";"0";"3";"3";"0";"3";"0";"457180";"391207"
"V4mis2";"SILVA (only NR);Eukaryota;Archaeplastida;Chloroplastida;Charophyta;Phragmoplastophyta;Streptophyta;Embryophyta;Tracheophyta;Spermatophyta;Magnoliophyta;Liliopsida;Poales;Eriocaulon;";"0.0";"0";"1";"1";"0";"1";"0";"457182";"391207"
"V4mis2";"SILVA (only NR);Eukaryota;Archaeplastida;Chloroplastida;Charophyta;Phragmoplastophyta;Streptophyta;Embryophyta;Tracheophyta;Spermatophyta;Magnoliophyta;Liliopsida;Poales;Festuca;";"0.0";"0";"1";"1";"0";"1";"0";"457182";"391207"
"V4mis2";"SILVA (only NR);Eukaryota;Archaeplastida;Chloroplastida;Charophyta;Phragmoplastophyta;Streptophyta;Embryophyta;Tracheophyta;Spermatophyta;Magnoliophyta;Liliopsida;Poales;Flagellaria;";"0.0";"0";"1";"1";"0";"1";"0";"457182";"391207"
"V4mis2";"SILVA (only NR);Eukaryota;Archaeplastida;Chloroplastida;Charophyta;Phragmoplastophyta;Streptophyta;Embryophyta;Tracheophyta;Spermatophyta;Magnoliophyta;Liliopsida;Poales;Hordeum;";"0.0";"0";"24";"24";"0";"24";"0";"457159";"391207"
"V4mis2";"SILVA (only NR);Eukaryota;Archaeplastida;Chloroplastida;Charophyta;Phragmoplastophyta;Streptophyta;Embryophyta;Tracheophyta;Spermatophyta;Magnoliophyta;Liliopsida;Poales;Joinvillea;";"0.0";"0";"1";"1";"0";"1";"0";"457182";"391207"
"V4mis2";"SILVA (only NR);Eukaryota;Archaeplastida;Chloroplastida;Charophyta;Phragmoplastophyta;Streptophyta;Embryophyta;Tracheophyta;Spermatophyta;Magnoliophyta;Liliopsida;Poales;Juncus;";"0.0";"0";"4";"4";"0";"4";"0";"457179";"391207"
"V4mis2";"SILVA (only NR);Eukaryota;Archaeplastida;Chloroplastida;Charophyta;Phragmoplastophyta;Streptophyta;Embryophyta;Tracheophyta;Spermatophyta;Magnoliophyta;Liliopsida;Poales;Loliinae;";"0.0";"0";"2";"2";"0";"2";"0";"457181";"391207"
"V4mis2";"SILVA (only NR);Eukaryota;Archaeplastida;Chloroplastida;Charophyta;Phragmoplastophyta;Streptophyta;Embryophyta;Tracheophyta;Spermatophyta;Magnoliophyta;Liliopsida;Poales;Mayaca;";"0.0";"0";"1";"1";"0";"1";"0";"457182";"391207"
"V4mis2";"SILVA (only NR);Eukaryota;Archaeplastida;Chloroplastida;Charophyta;Phragmoplastophyta;Streptophyta;Embryophyta;Tracheophyta;Spermatophyta;Magnoliophyta;Liliopsida;Poales;Oropetium;";"0.0";"0";"2";"2";"0";"2";"0";"457181";"391207"
"V4mis2";"SILVA (only NR);Eukaryota;Archaeplastida;Chloroplastida;Charophyta;Phragmoplastophyta;Streptophyta;Embryophyta;Tracheophyta;Spermatophyta;Magnoliophyta;Liliopsida;Poales;Oryza;";"3.2";"14.4";"31";"31";"1";"30";"0";"457152";"391206"
"V4mis2";"SILVA (only NR);Eukaryota;Archaeplastida;Chloroplastida;Charophyta;Phragmoplastophyta;Streptophyta;Embryophyta;Tracheophyta;Spermatophyta;Magnoliophyta;Liliopsida;Poales;Panicum;";"0.0";"0";"1";"1";"0";"1";"0";"457182";"391207"
"V4mis2";"SILVA (only NR);Eukaryota;Archaeplastida;Chloroplastida;Charophyta;Phragmoplastophyta;Streptophyta;Embryophyta;Tracheophyta;Spermatophyta;Magnoliophyta;Liliopsida;Poales;Rhynchospora;";"0.0";"0";"1";"1";"0";"1";"0";"457182";"391207"
"V4mis2";"SILVA (only NR);Eukaryota;Archaeplastida;Chloroplastida;Charophyta;Phragmoplastophyta;Streptophyta;Embryophyta;Tracheophyta;Spermatophyta;Magnoliophyta;Liliopsida;Poales;Setaria;";"0.0";"0";"1";"1";"0";"1";"0";"457182";"391207"
"V4mis2";"SILVA (only NR);Eukaryota;Archaeplastida;Chloroplastida;Charophyta;Phragmoplastophyta;Streptophyta;Embryophyta;Tracheophyta;Spermatophyta;Magnoliophyta;Liliopsida;Poales;Sorghum;";"0.0";"0";"6";"6";"0";"6";"0";"457177";"391207"
"V4mis2";"SILVA (only NR);Eukaryota;Archaeplastida;Chloroplastida;Charophyta;Phragmoplastophyta;Streptophyta;Embryophyta;Tracheophyta;Spermatophyta;Magnoliophyta;Liliopsida;Poales;Sparganium;";"0.0";"0";"1";"1";"0";"1";"0";"457182";"391207"
"V4mis2";"SILVA (only NR);Eukaryota;Archaeplastida;Chloroplastida;Charophyta;Phragmoplastophyta;Streptophyta;Embryophyta;Tracheophyta;Spermatophyta;Magnoliophyta;Liliopsida;Poales;Sporobolus;";"0.0";"0";"2";"2";"0";"2";"0";"457181";"391207"
"V4mis2";"SILVA (only NR);Eukaryota;Archaeplastida;Chloroplastida;Charophyta;Phragmoplastophyta;Streptophyta;Embryophyta;Tracheophyta;Spermatophyta;Magnoliophyta;Liliopsida;Poales;Triticum;";"16.2";"14.4";"74";"74";"12";"62";"0";"457109";"391195"
"V4mis2";"SILVA (only NR);Eukaryota;Archaeplastida;Chloroplastida;Charophyta;Phragmoplastophyta;Streptophyta;Embryophyta;Tracheophyta;Spermatophyta;Magnoliophyta;Liliopsida;Poales;Typha;";"0.0";"0";"2";"2";"0";"2";"0";"457181";"391207"
"V4mis2";"SILVA (only NR);Eukaryota;Archaeplastida;Chloroplastida;Charophyta;Phragmoplastophyta;Streptophyta;Embryophyta;Tracheophyta;Spermatophyta;Magnoliophyta;Liliopsida;Poales;Xyris;";"0.0";"0";"1";"1";"0";"1";"0";"457182";"391207"
"V4mis2";"SILVA (only NR);Eukaryota;Archaeplastida;Chloroplastida;Charophyta;Phragmoplastophyta;Streptophyta;Embryophyta;Tracheophyta;Spermatophyta;Magnoliophyta;Liliopsida;Poales;Zea;";"1.8";"14.4";"56";"56";"1";"55";"0";"457127";"391206"
"V4mis2";"SILVA (only NR);Eukaryota;Archaeplastida;Chloroplastida;Charophyta;Phragmoplastophyta;Streptophyta;Embryophyta;Tracheophyta;Spermatophyta;Magnoliophyta;Liliopsida;Poales;Zizania;";"0.0";"0";"2";"2";"0";"2";"0";"457181";"391207"
"V4mis2";"SILVA (only NR);Eukaryota;Archaeplastida;Chloroplastida;Charophyta;Phragmoplastophyta;Streptophyta;Embryophyta;Tracheophyta;Spermatophyta;Magnoliophyta;Liliopsida;Zingiberales;";"0.0";"0";"28";"27";"0";"27";"1";"457156";"391207"
"V4mis2";"SILVA (only NR);Eukaryota;Archaeplastida;Chloroplastida;Charophyta;Phragmoplastophyta;Streptophyta;Embryophyta;Tracheophyta;Spermatophyta;Magnoliophyta;Liliopsida;Zingiberales;Canna;";"0.0";"0";"2";"2";"0";"2";"0";"457181";"391207"
"V4mis2";"SILVA (only NR);Eukaryota;Archaeplastida;Chloroplastida;Charophyta;Phragmoplastophyta;Streptophyta;Embryophyta;Tracheophyta;Spermatophyta;Magnoliophyta;Liliopsida;Zingiberales;Dimerocostus;";"0.0";"0";"1";"1";"0";"1";"0";"457182";"391207"
"V4mis2";"SILVA (only NR);Eukaryota;Archaeplastida;Chloroplastida;Charophyta;Phragmoplastophyta;Streptophyta;Embryophyta;Tracheophyta;Spermatophyta;Magnoliophyta;Liliopsida;Zingiberales;Ensete;";"0.0";"0";"3";"3";"0";"3";"0";"457180";"391207"
"V4mis2";"SILVA (only NR);Eukaryota;Archaeplastida;Chloroplastida;Charophyta;Phragmoplastophyta;Streptophyta;Embryophyta;Tracheophyta;Spermatophyta;Magnoliophyta;Liliopsida;Zingiberales;Globba;";"0.0";"0";"1";"1";"0";"1";"0";"457182";"391207"
"V4mis2";"SILVA (only NR);Eukaryota;Archaeplastida;Chloroplastida;Charophyta;Phragmoplastophyta;Streptophyta;Embryophyta;Tracheophyta;Spermatophyta;Magnoliophyta;Liliopsida;Zingiberales;Goeppertia;";"0.0";"0";"1";"1";"0";"1";"0";"457182";"391207"
"V4mis2";"SILVA (only NR);Eukaryota;Archaeplastida;Chloroplastida;Charophyta;Phragmoplastophyta;Streptophyta;Embryophyta;Tracheophyta;Spermatophyta;Magnoliophyta;Liliopsida;Zingiberales;Hedychium;";"0.0";"0";"1";"1";"0";"1";"0";"457182";"391207"
"V4mis2";"SILVA (only NR);Eukaryota;Archaeplastida;Chloroplastida;Charophyta;Phragmoplastophyta;Streptophyta;Embryophyta;Tracheophyta;Spermatophyta;Magnoliophyta;Liliopsida;Zingiberales;Maranta;";"0.0";"0";"1";"1";"0";"1";"0";"457182";"391207"
"V4mis2";"SILVA (only NR);Eukaryota;Archaeplastida;Chloroplastida;Charophyta;Phragmoplastophyta;Streptophyta;Embryophyta;Tracheophyta;Spermatophyta;Magnoliophyta;Liliopsida;Zingiberales;Monocostus;";"0.0";"0";"1";"1";"0";"1";"0";"457182";"391207"
"V4mis2";"SILVA (only NR);Eukaryota;Archaeplastida;Chloroplastida;Charophyta;Phragmoplastophyta;Streptophyta;Embryophyta;Tracheophyta;Spermatophyta;Magnoliophyta;Liliopsida;Zingiberales;Musa;";"0.0";"0";"12";"11";"0";"11";"1";"457172";"391207"
"V4mis2";"SILVA (only NR);Eukaryota;Archaeplastida;Chloroplastida;Charophyta;Phragmoplastophyta;Streptophyta;Embryophyta;Tracheophyta;Spermatophyta;Magnoliophyta;Liliopsida;Zingiberales;Musella;";"0.0";"0";"1";"1";"0";"1";"0";"457182";"391207"
"V4mis2";"SILVA (only NR);Eukaryota;Archaeplastida;Chloroplastida;Charophyta;Phragmoplastophyta;Streptophyta;Embryophyta;Tracheophyta;Spermatophyta;Magnoliophyta;Liliopsida;Zingiberales;Orchidantha;";"0.0";"0";"1";"1";"0";"1";"0";"457182";"391207"
"V4mis2";"SILVA (only NR);Eukaryota;Archaeplastida;Chloroplastida;Charophyta;Phragmoplastophyta;Streptophyta;Embryophyta;Tracheophyta;Spermatophyta;Magnoliophyta;Liliopsida;Zingiberales;Phenakospermum;";"0.0";"0";"1";"1";"0";"1";"0";"457182";"391207"
"V4mis2";"SILVA (only NR);Eukaryota;Archaeplastida;Chloroplastida;Charophyta;Phragmoplastophyta;Streptophyta;Embryophyta;Tracheophyta;Spermatophyta;Magnoliophyta;Liliopsida;Zingiberales;Ravenala;";"0.0";"0";"1";"1";"0";"1";"0";"457182";"391207"
"V4mis2";"SILVA (only NR);Eukaryota;Archaeplastida;Chloroplastida;Charophyta;Phragmoplastophyta;Streptophyta;Embryophyta;Tracheophyta;Spermatophyta;Magnoliophyta;Liliopsida;Zingiberales;Tapeinochilos;";"0.0";"0";"1";"1";"0";"1";"0";"457182";"391207"
"V4mis2";"SILVA (only NR);Eukaryota;Archaeplastida;Chloroplastida;Charophyta;Phragmoplastophyta;Streptophyta;Embryophyta;Tracheophyta;Spermatophyta;Magnoliophyta;Magnoliales;";"0.0";"0";"20";"20";"0";"20";"0";"457163";"391207"
"V4mis2";"SILVA (only NR);Eukaryota;Archaeplastida;Chloroplastida;Charophyta;Phragmoplastophyta;Streptophyta;Embryophyta;Tracheophyta;Spermatophyta;Magnoliophyta;Magnoliales;Annona;";"0.0";"0";"1";"1";"0";"1";"0";"457182";"391207"
"V4mis2";"SILVA (only NR);Eukaryota;Archaeplastida;Chloroplastida;Charophyta;Phragmoplastophyta;Streptophyta;Embryophyta;Tracheophyta;Spermatophyta;Magnoliophyta;Magnoliales;Asimina;";"0.0";"0";"1";"1";"0";"1";"0";"457182";"391207"
"V4mis2";"SILVA (only NR);Eukaryota;Archaeplastida;Chloroplastida;Charophyta;Phragmoplastophyta;Streptophyta;Embryophyta;Tracheophyta;Spermatophyta;Magnoliophyta;Magnoliales;Cananga;";"0.0";"0";"1";"1";"0";"1";"0";"457182";"391207"
"V4mis2";"SILVA (only NR);Eukaryota;Archaeplastida;Chloroplastida;Charophyta;Phragmoplastophyta;Streptophyta;Embryophyta;Tracheophyta;Spermatophyta;Magnoliophyta;Magnoliales;Degeneria;";"0.0";"0";"1";"1";"0";"1";"0";"457182";"391207"
"V4mis2";"SILVA (only NR);Eukaryota;Archaeplastida;Chloroplastida;Charophyta;Phragmoplastophyta;Streptophyta;Embryophyta;Tracheophyta;Spermatophyta;Magnoliophyta;Magnoliales;Galbulimima;";"0.0";"0";"1";"1";"0";"1";"0";"457182";"391207"
"V4mis2";"SILVA (only NR);Eukaryota;Archaeplastida;Chloroplastida;Charophyta;Phragmoplastophyta;Streptophyta;Embryophyta;Tracheophyta;Spermatophyta;Magnoliophyta;Magnoliales;Gymnacranthera;";"0.0";"0";"2";"2";"0";"2";"0";"457181";"391207"
"V4mis2";"SILVA (only NR);Eukaryota;Archaeplastida;Chloroplastida;Charophyta;Phragmoplastophyta;Streptophyta;Embryophyta;Tracheophyta;Spermatophyta;Magnoliophyta;Magnoliales;Horsfieldia;";"0.0";"0";"3";"3";"0";"3";"0";"457180";"391207"
"V4mis2";"SILVA (only NR);Eukaryota;Archaeplastida;Chloroplastida;Charophyta;Phragmoplastophyta;Streptophyta;Embryophyta;Tracheophyta;Spermatophyta;Magnoliophyta;Magnoliales;Knema;";"0.0";"0";"2";"2";"0";"2";"0";"457181";"391207"
"V4mis2";"SILVA (only NR);Eukaryota;Archaeplastida;Chloroplastida;Charophyta;Phragmoplastophyta;Streptophyta;Embryophyta;Tracheophyta;Spermatophyta;Magnoliophyta;Magnoliales;Liriodendron;";"0.0";"0";"1";"1";"0";"1";"0";"457182";"391207"
"V4mis2";"SILVA (only NR);Eukaryota;Archaeplastida;Chloroplastida;Charophyta;Phragmoplastophyta;Streptophyta;Embryophyta;Tracheophyta;Spermatophyta;Magnoliophyta;Magnoliales;Magnolia;";"0.0";"0";"1";"1";"0";"1";"0";"457182";"391207"
"V4mis2";"SILVA (only NR);Eukaryota;Archaeplastida;Chloroplastida;Charophyta;Phragmoplastophyta;Streptophyta;Embryophyta;Tracheophyta;Spermatophyta;Magnoliophyta;Magnoliales;Mauloutchia;";"0.0";"0";"1";"1";"0";"1";"0";"457182";"391207"
"V4mis2";"SILVA (only NR);Eukaryota;Archaeplastida;Chloroplastida;Charophyta;Phragmoplastophyta;Streptophyta;Embryophyta;Tracheophyta;Spermatophyta;Magnoliophyta;Magnoliales;Myristica;";"0.0";"0";"4";"4";"0";"4";"0";"457179";"391207"
"V4mis2";"SILVA (only NR);Eukaryota;Archaeplastida;Chloroplastida;Charophyta;Phragmoplastophyta;Streptophyta;Embryophyta;Tracheophyta;Spermatophyta;Magnoliophyta;Magnoliales;Polyalthia;";"0.0";"0";"1";"1";"0";"1";"0";"457182";"391207"
"V4mis2";"SILVA (only NR);Eukaryota;Archaeplastida;Chloroplastida;Charophyta;Phragmoplastophyta;Streptophyta;Embryophyta;Tracheophyta;Spermatophyta;Magnoliophyta;Malpighiales;";"0.0";"0";"157";"157";"0";"157";"0";"457026";"391207"
"V4mis2";"SILVA (only NR);Eukaryota;Archaeplastida;Chloroplastida;Charophyta;Phragmoplastophyta;Streptophyta;Embryophyta;Tracheophyta;Spermatophyta;Magnoliophyta;Malpighiales;Acharia;";"0.0";"0";"1";"1";"0";"1";"0";"457182";"391207"
"V4mis2";"SILVA (only NR);Eukaryota;Archaeplastida;Chloroplastida;Charophyta;Phragmoplastophyta;Streptophyta;Embryophyta;Tracheophyta;Spermatophyta;Magnoliophyta;Malpighiales;Acidoton;";"0.0";"0";"1";"1";"0";"1";"0";"457182";"391207"
"V4mis2";"SILVA (only NR);Eukaryota;Archaeplastida;Chloroplastida;Charophyta;Phragmoplastophyta;Streptophyta;Embryophyta;Tracheophyta;Spermatophyta;Magnoliophyta;Malpighiales;Acridocarpus;";"0.0";"0";"1";"1";"0";"1";"0";"457182";"391207"
"V4mis2";"SILVA (only NR);Eukaryota;Archaeplastida;Chloroplastida;Charophyta;Phragmoplastophyta;Streptophyta;Embryophyta;Tracheophyta;Spermatophyta;Magnoliophyta;Malpighiales;Adriana;";"0.0";"0";"1";"1";"0";"1";"0";"457182";"391207"
"V4mis2";"SILVA (only NR);Eukaryota;Archaeplastida;Chloroplastida;Charophyta;Phragmoplastophyta;Streptophyta;Embryophyta;Tracheophyta;Spermatophyta;Magnoliophyta;Malpighiales;Agrostistachys;";"0.0";"0";"1";"1";"0";"1";"0";"457182";"391207"
"V4mis2";"SILVA (only NR);Eukaryota;Archaeplastida;Chloroplastida;Charophyta;Phragmoplastophyta;Streptophyta;Embryophyta;Tracheophyta;Spermatophyta;Magnoliophyta;Malpighiales;Allexis;";"0.0";"0";"1";"1";"0";"1";"0";"457182";"391207"
"V4mis2";"SILVA (only NR);Eukaryota;Archaeplastida;Chloroplastida;Charophyta;Phragmoplastophyta;Streptophyta;Embryophyta;Tracheophyta;Spermatophyta;Magnoliophyta;Malpighiales;Aneulophus;";"0.0";"0";"1";"1";"0";"1";"0";"457182";"391207"
"V4mis2";"SILVA (only NR);Eukaryota;Archaeplastida;Chloroplastida;Charophyta;Phragmoplastophyta;Streptophyta;Embryophyta;Tracheophyta;Spermatophyta;Magnoliophyta;Malpighiales;Aporosa;";"0.0";"0";"1";"1";"0";"1";"0";"457182";"391207"
"V4mis2";"SILVA (only NR);Eukaryota;Archaeplastida;Chloroplastida;Charophyta;Phragmoplastophyta;Streptophyta;Embryophyta;Tracheophyta;Spermatophyta;Magnoliophyta;Malpighiales;Aristogeitonia;";"0.0";"0";"1";"1";"0";"1";"0";"457182";"391207"
"V4mis2";"SILVA (only NR);Eukaryota;Archaeplastida;Chloroplastida;Charophyta;Phragmoplastophyta;Streptophyta;Embryophyta;Tracheophyta;Spermatophyta;Magnoliophyta;Malpighiales;Astrocasia;";"0.0";"0";"1";"1";"0";"1";"0";"457182";"391207"
"V4mis2";"SILVA (only NR);Eukaryota;Archaeplastida;Chloroplastida;Charophyta;Phragmoplastophyta;Streptophyta;Embryophyta;Tracheophyta;Spermatophyta;Magnoliophyta;Malpighiales;Balanops;";"0.0";"0";"1";"1";"0";"1";"0";"457182";"391207"
"V4mis2";"SILVA (only NR);Eukaryota;Archaeplastida;Chloroplastida;Charophyta;Phragmoplastophyta;Streptophyta;Embryophyta;Tracheophyta;Spermatophyta;Magnoliophyta;Malpighiales;Bhesa;";"0.0";"0";"1";"1";"0";"1";"0";"457182";"391207"
"V4mis2";"SILVA (only NR);Eukaryota;Archaeplastida;Chloroplastida;Charophyta;Phragmoplastophyta;Streptophyta;Embryophyta;Tracheophyta;Spermatophyta;Magnoliophyta;Malpighiales;Bonnetia;";"0.0";"0";"1";"1";"0";"1";"0";"457182";"391207"
"V4mis2";"SILVA (only NR);Eukaryota;Archaeplastida;Chloroplastida;Charophyta;Phragmoplastophyta;Streptophyta;Embryophyta;Tracheophyta;Spermatophyta;Magnoliophyta;Malpighiales;Bunchosia;";"0.0";"0";"1";"1";"0";"1";"0";"457182";"391207"
"V4mis2";"SILVA (only NR);Eukaryota;Archaeplastida;Chloroplastida;Charophyta;Phragmoplastophyta;Streptophyta;Embryophyta;Tracheophyta;Spermatophyta;Magnoliophyta;Malpighiales;Byrsonima;";"0.0";"0";"1";"1";"0";"1";"0";"457182";"391207"
"V4mis2";"SILVA (only NR);Eukaryota;Archaeplastida;Chloroplastida;Charophyta;Phragmoplastophyta;Streptophyta;Embryophyta;Tracheophyta;Spermatophyta;Magnoliophyta;Malpighiales;Camptostylus;";"0.0";"0";"1";"1";"0";"1";"0";"457182";"391207"
"V4mis2";"SILVA (only NR);Eukaryota;Archaeplastida;Chloroplastida;Charophyta;Phragmoplastophyta;Streptophyta;Embryophyta;Tracheophyta;Spermatophyta;Magnoliophyta;Malpighiales;Carallia;";"0.0";"0";"1";"1";"0";"1";"0";"457182";"391207"
"V4mis2";"SILVA (only NR);Eukaryota;Archaeplastida;Chloroplastida;Charophyta;Phragmoplastophyta;Streptophyta;Embryophyta;Tracheophyta;Spermatophyta;Magnoliophyta;Malpighiales;Caryocar;";"0.0";"0";"1";"1";"0";"1";"0";"457182";"391207"
"V4mis2";"SILVA (only NR);Eukaryota;Archaeplastida;Chloroplastida;Charophyta;Phragmoplastophyta;Streptophyta;Embryophyta;Tracheophyta;Spermatophyta;Magnoliophyta;Malpighiales;Chaetocarpus;";"0.0";"0";"1";"1";"0";"1";"0";"457182";"391207"
"V4mis2";"SILVA (only NR);Eukaryota;Archaeplastida;Chloroplastida;Charophyta;Phragmoplastophyta;Streptophyta;Embryophyta;Tracheophyta;Spermatophyta;Magnoliophyta;Malpighiales;Cladogynos;";"0.0";"0";"1";"1";"0";"1";"0";"457182";"391207"
"V4mis2";"SILVA (only NR);Eukaryota;Archaeplastida;Chloroplastida;Charophyta;Phragmoplastophyta;Streptophyta;Embryophyta;Tracheophyta;Spermatophyta;Magnoliophyta;Malpighiales;Clusia;";"0.0";"0";"1";"1";"0";"1";"0";"457182";"391207"
"V4mis2";"SILVA (only NR);Eukaryota;Archaeplastida;Chloroplastida;Charophyta;Phragmoplastophyta;Streptophyta;Embryophyta;Tracheophyta;Spermatophyta;Magnoliophyta;Malpighiales;Clutia;";"0.0";"0";"1";"1";"0";"1";"0";"457182";"391207"
"V4mis2";"SILVA (only NR);Eukaryota;Archaeplastida;Chloroplastida;Charophyta;Phragmoplastophyta;Streptophyta;Embryophyta;Tracheophyta;Spermatophyta;Magnoliophyta;Malpighiales;Cratoxylum;";"0.0";"0";"1";"1";"0";"1";"0";"457182";"391207"
"V4mis2";"SILVA (only NR);Eukaryota;Archaeplastida;Chloroplastida;Charophyta;Phragmoplastophyta;Streptophyta;Embryophyta;Tracheophyta;Spermatophyta;Magnoliophyta;Malpighiales;Croizatia;";"0.0";"0";"1";"1";"0";"1";"0";"457182";"391207"
"V4mis2";"SILVA (only NR);Eukaryota;Archaeplastida;Chloroplastida;Charophyta;Phragmoplastophyta;Streptophyta;Embryophyta;Tracheophyta;Spermatophyta;Magnoliophyta;Malpighiales;Croton;";"0.0";"0";"1";"1";"0";"1";"0";"457182";"391207"
"V4mis2";"SILVA (only NR);Eukaryota;Archaeplastida;Chloroplastida;Charophyta;Phragmoplastophyta;Streptophyta;Embryophyta;Tracheophyta;Spermatophyta;Magnoliophyta;Malpighiales;Dasylepis;";"0.0";"0";"1";"1";"0";"1";"0";"457182";"391207"
"V4mis2";"SILVA (only NR);Eukaryota;Archaeplastida;Chloroplastida;Charophyta;Phragmoplastophyta;Streptophyta;Embryophyta;Tracheophyta;Spermatophyta;Magnoliophyta;Malpighiales;Decorsella;";"0.0";"0";"1";"1";"0";"1";"0";"457182";"391207"
"V4mis2";"SILVA (only NR);Eukaryota;Archaeplastida;Chloroplastida;Charophyta;Phragmoplastophyta;Streptophyta;Embryophyta;Tracheophyta;Spermatophyta;Magnoliophyta;Malpighiales;Dicoelia;";"0.0";"0";"1";"1";"0";"1";"0";"457182";"391207"
"V4mis2";"SILVA (only NR);Eukaryota;Archaeplastida;Chloroplastida;Charophyta;Phragmoplastophyta;Streptophyta;Embryophyta;Tracheophyta;Spermatophyta;Magnoliophyta;Malpighiales;Diporidium;";"0.0";"0";"1";"1";"0";"1";"0";"457182";"391207"
"V4mis2";"SILVA (only NR);Eukaryota;Archaeplastida;Chloroplastida;Charophyta;Phragmoplastophyta;Streptophyta;Embryophyta;Tracheophyta;Spermatophyta;Magnoliophyta;Malpighiales;Durandea;";"0.0";"0";"1";"1";"0";"1";"0";"457182";"391207"
"V4mis2";"SILVA (only NR);Eukaryota;Archaeplastida;Chloroplastida;Charophyta;Phragmoplastophyta;Streptophyta;Embryophyta;Tracheophyta;Spermatophyta;Magnoliophyta;Malpighiales;Elatine;";"0.0";"0";"1";"1";"0";"1";"0";"457182";"391207"
"V4mis2";"SILVA (only NR);Eukaryota;Archaeplastida;Chloroplastida;Charophyta;Phragmoplastophyta;Streptophyta;Embryophyta;Tracheophyta;Spermatophyta;Magnoliophyta;Malpighiales;Endodesmia;";"0.0";"0";"1";"1";"0";"1";"0";"457182";"391207"
"V4mis2";"SILVA (only NR);Eukaryota;Archaeplastida;Chloroplastida;Charophyta;Phragmoplastophyta;Streptophyta;Embryophyta;Tracheophyta;Spermatophyta;Magnoliophyta;Malpighiales;Endospermum;";"0.0";"0";"1";"1";"0";"1";"0";"457182";"391207"
"V4mis2";"SILVA (only NR);Eukaryota;Archaeplastida;Chloroplastida;Charophyta;Phragmoplastophyta;Streptophyta;Embryophyta;Tracheophyta;Spermatophyta;Magnoliophyta;Malpighiales;Erythrococca;";"0.0";"0";"1";"1";"0";"1";"0";"457182";"391207"
"V4mis2";"SILVA (only NR);Eukaryota;Archaeplastida;Chloroplastida;Charophyta;Phragmoplastophyta;Streptophyta;Embryophyta;Tracheophyta;Spermatophyta;Magnoliophyta;Malpighiales;Erythroxylum;";"0.0";"0";"1";"1";"0";"1";"0";"457182";"391207"
"V4mis2";"SILVA (only NR);Eukaryota;Archaeplastida;Chloroplastida;Charophyta;Phragmoplastophyta;Streptophyta;Embryophyta;Tracheophyta;Spermatophyta;Magnoliophyta;Malpighiales;Euphorbia;";"0.0";"0";"18";"18";"0";"18";"0";"457165";"391207"
"V4mis2";"SILVA (only NR);Eukaryota;Archaeplastida;Chloroplastida;Charophyta;Phragmoplastophyta;Streptophyta;Embryophyta;Tracheophyta;Spermatophyta;Magnoliophyta;Malpighiales;Euphronia;";"0.0";"0";"1";"1";"0";"1";"0";"457182";"391207"
"V4mis2";"SILVA (only NR);Eukaryota;Archaeplastida;Chloroplastida;Charophyta;Phragmoplastophyta;Streptophyta;Embryophyta;Tracheophyta;Spermatophyta;Magnoliophyta;Malpighiales;Flacourtia;";"0.0";"0";"1";"1";"0";"1";"0";"457182";"391207"
"V4mis2";"SILVA (only NR);Eukaryota;Archaeplastida;Chloroplastida;Charophyta;Phragmoplastophyta;Streptophyta;Embryophyta;Tracheophyta;Spermatophyta;Magnoliophyta;Malpighiales;Flueggea;";"0.0";"0";"1";"1";"0";"1";"0";"457182";"391207"
"V4mis2";"SILVA (only NR);Eukaryota;Archaeplastida;Chloroplastida;Charophyta;Phragmoplastophyta;Streptophyta;Embryophyta;Tracheophyta;Spermatophyta;Magnoliophyta;Malpighiales;Fusispermum;";"0.0";"0";"1";"1";"0";"1";"0";"457182";"391207"
"V4mis2";"SILVA (only NR);Eukaryota;Archaeplastida;Chloroplastida;Charophyta;Phragmoplastophyta;Streptophyta;Embryophyta;Tracheophyta;Spermatophyta;Magnoliophyta;Malpighiales;Galearia;";"0.0";"0";"1";"1";"0";"1";"0";"457182";"391207"
"V4mis2";"SILVA (only NR);Eukaryota;Archaeplastida;Chloroplastida;Charophyta;Phragmoplastophyta;Streptophyta;Embryophyta;Tracheophyta;Spermatophyta;Magnoliophyta;Malpighiales;Galphimia;";"0.0";"0";"1";"1";"0";"1";"0";"457182";"391207"
"V4mis2";"SILVA (only NR);Eukaryota;Archaeplastida;Chloroplastida;Charophyta;Phragmoplastophyta;Streptophyta;Embryophyta;Tracheophyta;Spermatophyta;Magnoliophyta;Malpighiales;Garcinia;";"0.0";"0";"1";"1";"0";"1";"0";"457182";"391207"
"V4mis2";"SILVA (only NR);Eukaryota;Archaeplastida;Chloroplastida;Charophyta;Phragmoplastophyta;Streptophyta;Embryophyta;Tracheophyta;Spermatophyta;Magnoliophyta;Malpighiales;Hevea;";"0.0";"0";"10";"10";"0";"10";"0";"457173";"391207"
"V4mis2";"SILVA (only NR);Eukaryota;Archaeplastida;Chloroplastida;Charophyta;Phragmoplastophyta;Streptophyta;Embryophyta;Tracheophyta;Spermatophyta;Magnoliophyta;Malpighiales;Heywoodia;";"0.0";"0";"1";"1";"0";"1";"0";"457182";"391207"
"V4mis2";"SILVA (only NR);Eukaryota;Archaeplastida;Chloroplastida;Charophyta;Phragmoplastophyta;Streptophyta;Embryophyta;Tracheophyta;Spermatophyta;Magnoliophyta;Malpighiales;Hirtella;";"0.0";"0";"1";"1";"0";"1";"0";"457182";"391207"
"V4mis2";"SILVA (only NR);Eukaryota;Archaeplastida;Chloroplastida;Charophyta;Phragmoplastophyta;Streptophyta;Embryophyta;Tracheophyta;Spermatophyta;Magnoliophyta;Malpighiales;Homalium;";"0.0";"0";"1";"1";"0";"1";"0";"457182";"391207"
"V4mis2";"SILVA (only NR);Eukaryota;Archaeplastida;Chloroplastida;Charophyta;Phragmoplastophyta;Streptophyta;Embryophyta;Tracheophyta;Spermatophyta;Magnoliophyta;Malpighiales;Hugonia;";"0.0";"0";"1";"1";"0";"1";"0";"457182";"391207"
"V4mis2";"SILVA (only NR);Eukaryota;Archaeplastida;Chloroplastida;Charophyta;Phragmoplastophyta;Streptophyta;Embryophyta;Tracheophyta;Spermatophyta;Magnoliophyta;Malpighiales;Hybanthus;";"0.0";"0";"1";"1";"0";"1";"0";"457182";"391207"
"V4mis2";"SILVA (only NR);Eukaryota;Archaeplastida;Chloroplastida;Charophyta;Phragmoplastophyta;Streptophyta;Embryophyta;Tracheophyta;Spermatophyta;Magnoliophyta;Malpighiales;Hymenanthera;";"0.0";"0";"1";"1";"0";"1";"0";"457182";"391207"
"V4mis2";"SILVA (only NR);Eukaryota;Archaeplastida;Chloroplastida;Charophyta;Phragmoplastophyta;Streptophyta;Embryophyta;Tracheophyta;Spermatophyta;Magnoliophyta;Malpighiales;Hypericum;";"0.0";"0";"1";"1";"0";"1";"0";"457182";"391207"
"V4mis2";"SILVA (only NR);Eukaryota;Archaeplastida;Chloroplastida;Charophyta;Phragmoplastophyta;Streptophyta;Embryophyta;Tracheophyta;Spermatophyta;Magnoliophyta;Malpighiales;Irvingia;";"0.0";"0";"1";"1";"0";"1";"0";"457182";"391207"
"V4mis2";"SILVA (only NR);Eukaryota;Archaeplastida;Chloroplastida;Charophyta;Phragmoplastophyta;Streptophyta;Embryophyta;Tracheophyta;Spermatophyta;Magnoliophyta;Malpighiales;Isodendrion;";"0.0";"0";"1";"1";"0";"1";"0";"457182";"391207"
"V4mis2";"SILVA (only NR);Eukaryota;Archaeplastida;Chloroplastida;Charophyta;Phragmoplastophyta;Streptophyta;Embryophyta;Tracheophyta;Spermatophyta;Magnoliophyta;Malpighiales;Ixonanthes;";"0.0";"0";"3";"3";"0";"3";"0";"457180";"391207"
"V4mis2";"SILVA (only NR);Eukaryota;Archaeplastida;Chloroplastida;Charophyta;Phragmoplastophyta;Streptophyta;Embryophyta;Tracheophyta;Spermatophyta;Magnoliophyta;Malpighiales;Jatropha;";"0.0";"0";"2";"2";"0";"2";"0";"457181";"391207"
"V4mis2";"SILVA (only NR);Eukaryota;Archaeplastida;Chloroplastida;Charophyta;Phragmoplastophyta;Streptophyta;Embryophyta;Tracheophyta;Spermatophyta;Magnoliophyta;Malpighiales;Lachnostylis;";"0.0";"0";"1";"1";"0";"1";"0";"457182";"391207"
"V4mis2";"SILVA (only NR);Eukaryota;Archaeplastida;Chloroplastida;Charophyta;Phragmoplastophyta;Streptophyta;Embryophyta;Tracheophyta;Spermatophyta;Magnoliophyta;Malpighiales;Lacistema;";"0.0";"0";"2";"2";"0";"2";"0";"457181";"391207"
"V4mis2";"SILVA (only NR);Eukaryota;Archaeplastida;Chloroplastida;Charophyta;Phragmoplastophyta;Streptophyta;Embryophyta;Tracheophyta;Spermatophyta;Magnoliophyta;Malpighiales;Lasiocroton;";"0.0";"0";"1";"1";"0";"1";"0";"457182";"391207"
"V4mis2";"SILVA (only NR);Eukaryota;Archaeplastida;Chloroplastida;Charophyta;Phragmoplastophyta;Streptophyta;Embryophyta;Tracheophyta;Spermatophyta;Magnoliophyta;Malpighiales;Linum;";"0.0";"0";"6";"6";"0";"6";"0";"457177";"391207"
"V4mis2";"SILVA (only NR);Eukaryota;Archaeplastida;Chloroplastida;Charophyta;Phragmoplastophyta;Streptophyta;Embryophyta;Tracheophyta;Spermatophyta;Magnoliophyta;Malpighiales;Lophopyxis;";"0.0";"0";"1";"1";"0";"1";"0";"457182";"391207"
"V4mis2";"SILVA (only NR);Eukaryota;Archaeplastida;Chloroplastida;Charophyta;Phragmoplastophyta;Streptophyta;Embryophyta;Tracheophyta;Spermatophyta;Magnoliophyta;Malpighiales;Luxemburgia;";"0.0";"0";"1";"1";"0";"1";"0";"457182";"391207"
"V4mis2";"SILVA (only NR);Eukaryota;Archaeplastida;Chloroplastida;Charophyta;Phragmoplastophyta;Streptophyta;Embryophyta;Tracheophyta;Spermatophyta;Magnoliophyta;Malpighiales;Malesherbia;";"0.0";"0";"1";"1";"0";"1";"0";"457182";"391207"
"V4mis2";"SILVA (only NR);Eukaryota;Archaeplastida;Chloroplastida;Charophyta;Phragmoplastophyta;Streptophyta;Embryophyta;Tracheophyta;Spermatophyta;Magnoliophyta;Malpighiales;Malpighia;";"0.0";"0";"1";"1";"0";"1";"0";"457182";"391207"
"V4mis2";"SILVA (only NR);Eukaryota;Archaeplastida;Chloroplastida;Charophyta;Phragmoplastophyta;Streptophyta;Embryophyta;Tracheophyta;Spermatophyta;Magnoliophyta;Malpighiales;Mammea;";"0.0";"0";"1";"1";"0";"1";"0";"457182";"391207"
"V4mis2";"SILVA (only NR);Eukaryota;Archaeplastida;Chloroplastida;Charophyta;Phragmoplastophyta;Streptophyta;Embryophyta;Tracheophyta;Spermatophyta;Magnoliophyta;Malpighiales;Manihot;";"0.0";"0";"4";"4";"0";"4";"0";"457179";"391207"
"V4mis2";"SILVA (only NR);Eukaryota;Archaeplastida;Chloroplastida;Charophyta;Phragmoplastophyta;Streptophyta;Embryophyta;Tracheophyta;Spermatophyta;Magnoliophyta;Malpighiales;Marathrum;";"0.0";"0";"1";"1";"0";"1";"0";"457182";"391207"
"V4mis2";"SILVA (only NR);Eukaryota;Archaeplastida;Chloroplastida;Charophyta;Phragmoplastophyta;Streptophyta;Embryophyta;Tracheophyta;Spermatophyta;Magnoliophyta;Malpighiales;Mareya;";"0.0";"0";"1";"1";"0";"1";"0";"457182";"391207"
"V4mis2";"SILVA (only NR);Eukaryota;Archaeplastida;Chloroplastida;Charophyta;Phragmoplastophyta;Streptophyta;Embryophyta;Tracheophyta;Spermatophyta;Magnoliophyta;Malpighiales;Mathurina;";"0.0";"0";"1";"1";"0";"1";"0";"457182";"391207"
"V4mis2";"SILVA (only NR);Eukaryota;Archaeplastida;Chloroplastida;Charophyta;Phragmoplastophyta;Streptophyta;Embryophyta;Tracheophyta;Spermatophyta;Magnoliophyta;Malpighiales;Mayanaea;";"0.0";"0";"1";"1";"0";"1";"0";"457182";"391207"
"V4mis2";"SILVA (only NR);Eukaryota;Archaeplastida;Chloroplastida;Charophyta;Phragmoplastophyta;Streptophyta;Embryophyta;Tracheophyta;Spermatophyta;Magnoliophyta;Malpighiales;Medusagyne;";"0.0";"0";"1";"1";"0";"1";"0";"457182";"391207"
"V4mis2";"SILVA (only NR);Eukaryota;Archaeplastida;Chloroplastida;Charophyta;Phragmoplastophyta;Streptophyta;Embryophyta;Tracheophyta;Spermatophyta;Magnoliophyta;Malpighiales;Meineckia;";"0.0";"0";"1";"1";"0";"1";"0";"457182";"391207"
"V4mis2";"SILVA (only NR);Eukaryota;Archaeplastida;Chloroplastida;Charophyta;Phragmoplastophyta;Streptophyta;Embryophyta;Tracheophyta;Spermatophyta;Magnoliophyta;Malpighiales;Mesua;";"0.0";"0";"1";"1";"0";"1";"0";"457182";"391207"
"V4mis2";"SILVA (only NR);Eukaryota;Archaeplastida;Chloroplastida;Charophyta;Phragmoplastophyta;Streptophyta;Embryophyta;Tracheophyta;Spermatophyta;Magnoliophyta;Malpighiales;Montrouziera;";"0.0";"0";"1";"1";"0";"1";"0";"457182";"391207"
"V4mis2";"SILVA (only NR);Eukaryota;Archaeplastida;Chloroplastida;Charophyta;Phragmoplastophyta;Streptophyta;Embryophyta;Tracheophyta;Spermatophyta;Magnoliophyta;Malpighiales;Ochthocosmus;";"0.0";"0";"1";"1";"0";"1";"0";"457182";"391207"
"V4mis2";"SILVA (only NR);Eukaryota;Archaeplastida;Chloroplastida;Charophyta;Phragmoplastophyta;Streptophyta;Embryophyta;Tracheophyta;Spermatophyta;Magnoliophyta;Malpighiales;Omphalea;";"0.0";"0";"1";"1";"0";"1";"0";"457182";"391207"
"V4mis2";"SILVA (only NR);Eukaryota;Archaeplastida;Chloroplastida;Charophyta;Phragmoplastophyta;Streptophyta;Embryophyta;Tracheophyta;Spermatophyta;Magnoliophyta;Malpighiales;Pangium;";"0.0";"0";"1";"1";"0";"1";"0";"457182";"391207"
"V4mis2";"SILVA (only NR);Eukaryota;Archaeplastida;Chloroplastida;Charophyta;Phragmoplastophyta;Streptophyta;Embryophyta;Tracheophyta;Spermatophyta;Magnoliophyta;Malpighiales;Paradrypetes;";"0.0";"0";"1";"1";"0";"1";"0";"457182";"391207"
"V4mis2";"SILVA (only NR);Eukaryota;Archaeplastida;Chloroplastida;Charophyta;Phragmoplastophyta;Streptophyta;Embryophyta;Tracheophyta;Spermatophyta;Magnoliophyta;Malpighiales;Passiflora;";"0.0";"0";"1";"1";"0";"1";"0";"457182";"391207"
"V4mis2";"SILVA (only NR);Eukaryota;Archaeplastida;Chloroplastida;Charophyta;Phragmoplastophyta;Streptophyta;Embryophyta;Tracheophyta;Spermatophyta;Magnoliophyta;Malpighiales;Pera;";"0.0";"0";"1";"1";"0";"1";"0";"457182";"391207"
"V4mis2";"SILVA (only NR);Eukaryota;Archaeplastida;Chloroplastida;Charophyta;Phragmoplastophyta;Streptophyta;Embryophyta;Tracheophyta;Spermatophyta;Magnoliophyta;Malpighiales;Philyra;";"0.0";"0";"1";"1";"0";"1";"0";"457182";"391207"
"V4mis2";"SILVA (only NR);Eukaryota;Archaeplastida;Chloroplastida;Charophyta;Phragmoplastophyta;Streptophyta;Embryophyta;Tracheophyta;Spermatophyta;Magnoliophyta;Malpighiales;Phyllanthus;";"0.0";"0";"2";"2";"0";"2";"0";"457181";"391207"
"V4mis2";"SILVA (only NR);Eukaryota;Archaeplastida;Chloroplastida;Charophyta;Phragmoplastophyta;Streptophyta;Embryophyta;Tracheophyta;Spermatophyta;Magnoliophyta;Malpighiales;Picrodendron;";"0.0";"0";"1";"1";"0";"1";"0";"457182";"391207"
"V4mis2";"SILVA (only NR);Eukaryota;Archaeplastida;Chloroplastida;Charophyta;Phragmoplastophyta;Streptophyta;Embryophyta;Tracheophyta;Spermatophyta;Magnoliophyta;Malpighiales;Piriqueta;";"0.0";"0";"1";"1";"0";"1";"0";"457182";"391207"
"V4mis2";"SILVA (only NR);Eukaryota;Archaeplastida;Chloroplastida;Charophyta;Phragmoplastophyta;Streptophyta;Embryophyta;Tracheophyta;Spermatophyta;Magnoliophyta;Malpighiales;Ploiarium;";"0.0";"0";"1";"1";"0";"1";"0";"457182";"391207"
"V4mis2";"SILVA (only NR);Eukaryota;Archaeplastida;Chloroplastida;Charophyta;Phragmoplastophyta;Streptophyta;Embryophyta;Tracheophyta;Spermatophyta;Magnoliophyta;Malpighiales;Plukenetia;";"0.0";"0";"1";"1";"0";"1";"0";"457182";"391207"
"V4mis2";"SILVA (only NR);Eukaryota;Archaeplastida;Chloroplastida;Charophyta;Phragmoplastophyta;Streptophyta;Embryophyta;Tracheophyta;Spermatophyta;Magnoliophyta;Malpighiales;Podostemum;";"0.0";"0";"1";"1";"0";"1";"0";"457182";"391207"
"V4mis2";"SILVA (only NR);Eukaryota;Archaeplastida;Chloroplastida;Charophyta;Phragmoplastophyta;Streptophyta;Embryophyta;Tracheophyta;Spermatophyta;Magnoliophyta;Malpighiales;Populus;";"0.0";"0";"12";"12";"0";"12";"0";"457171";"391207"
"V4mis2";"SILVA (only NR);Eukaryota;Archaeplastida;Chloroplastida;Charophyta;Phragmoplastophyta;Streptophyta;Embryophyta;Tracheophyta;Spermatophyta;Magnoliophyta;Malpighiales;Putranjiva;";"0.0";"0";"1";"1";"0";"1";"0";"457182";"391207"
"V4mis2";"SILVA (only NR);Eukaryota;Archaeplastida;Chloroplastida;Charophyta;Phragmoplastophyta;Streptophyta;Embryophyta;Tracheophyta;Spermatophyta;Magnoliophyta;Malpighiales;Quiina;";"0.0";"0";"1";"1";"0";"1";"0";"457182";"391207"
"V4mis2";"SILVA (only NR);Eukaryota;Archaeplastida;Chloroplastida;Charophyta;Phragmoplastophyta;Streptophyta;Embryophyta;Tracheophyta;Spermatophyta;Magnoliophyta;Malpighiales;Rafflesia;";"0.0";"0";"1";"1";"0";"1";"0";"457182";"391207"
"V4mis2";"SILVA (only NR);Eukaryota;Archaeplastida;Chloroplastida;Charophyta;Phragmoplastophyta;Streptophyta;Embryophyta;Tracheophyta;Spermatophyta;Magnoliophyta;Malpighiales;Reinwardtia;";"0.0";"0";"1";"1";"0";"1";"0";"457182";"391207"
"V4mis2";"SILVA (only NR);Eukaryota;Archaeplastida;Chloroplastida;Charophyta;Phragmoplastophyta;Streptophyta;Embryophyta;Tracheophyta;Spermatophyta;Magnoliophyta;Malpighiales;Rhizanthes;";"0.0";"0";"1";"1";"0";"1";"0";"457182";"391207"
"V4mis2";"SILVA (only NR);Eukaryota;Archaeplastida;Chloroplastida;Charophyta;Phragmoplastophyta;Streptophyta;Embryophyta;Tracheophyta;Spermatophyta;Magnoliophyta;Malpighiales;Ricinus;";"0.0";"0";"3";"3";"0";"3";"0";"457180";"391207"
"V4mis2";"SILVA (only NR);Eukaryota;Archaeplastida;Chloroplastida;Charophyta;Phragmoplastophyta;Streptophyta;Embryophyta;Tracheophyta;Spermatophyta;Magnoliophyta;Malpighiales;Rinorea;";"0.0";"0";"1";"1";"0";"1";"0";"457182";"391207"
"V4mis2";"SILVA (only NR);Eukaryota;Archaeplastida;Chloroplastida;Charophyta;Phragmoplastophyta;Streptophyta;Embryophyta;Tracheophyta;Spermatophyta;Magnoliophyta;Malpighiales;Rinoreocarpus;";"0.0";"0";"1";"1";"0";"1";"0";"457182";"391207"
"V4mis2";"SILVA (only NR);Eukaryota;Archaeplastida;Chloroplastida;Charophyta;Phragmoplastophyta;Streptophyta;Embryophyta;Tracheophyta;Spermatophyta;Magnoliophyta;Malpighiales;Sapria;";"0.0";"0";"2";"2";"0";"2";"0";"457181";"391207"
"V4mis2";"SILVA (only NR);Eukaryota;Archaeplastida;Chloroplastida;Charophyta;Phragmoplastophyta;Streptophyta;Embryophyta;Tracheophyta;Spermatophyta;Magnoliophyta;Malpighiales;Sauvagesia;";"0.0";"0";"1";"1";"0";"1";"0";"457182";"391207"
"V4mis2";"SILVA (only NR);Eukaryota;Archaeplastida;Chloroplastida;Charophyta;Phragmoplastophyta;Streptophyta;Embryophyta;Tracheophyta;Spermatophyta;Magnoliophyta;Malpighiales;Stapfiella;";"0.0";"0";"1";"1";"0";"1";"0";"457182";"391207"
"V4mis2";"SILVA (only NR);Eukaryota;Archaeplastida;Chloroplastida;Charophyta;Phragmoplastophyta;Streptophyta;Embryophyta;Tracheophyta;Spermatophyta;Magnoliophyta;Malpighiales;Tapura;";"0.0";"0";"1";"1";"0";"1";"0";"457182";"391207"
"V4mis2";"SILVA (only NR);Eukaryota;Archaeplastida;Chloroplastida;Charophyta;Phragmoplastophyta;Streptophyta;Embryophyta;Tracheophyta;Spermatophyta;Magnoliophyta;Malpighiales;Tetrapterys;";"0.0";"0";"1";"1";"0";"1";"0";"457182";"391207"
"V4mis2";"SILVA (only NR);Eukaryota;Archaeplastida;Chloroplastida;Charophyta;Phragmoplastophyta;Streptophyta;Embryophyta;Tracheophyta;Spermatophyta;Magnoliophyta;Malpighiales;Tetrorchidium;";"0.0";"0";"1";"1";"0";"1";"0";"457182";"391207"
"V4mis2";"SILVA (only NR);Eukaryota;Archaeplastida;Chloroplastida;Charophyta;Phragmoplastophyta;Streptophyta;Embryophyta;Tracheophyta;Spermatophyta;Magnoliophyta;Malpighiales;Trigonia;";"0.0";"0";"1";"1";"0";"1";"0";"457182";"391207"
"V4mis2";"SILVA (only NR);Eukaryota;Archaeplastida;Chloroplastida;Charophyta;Phragmoplastophyta;Streptophyta;Embryophyta;Tracheophyta;Spermatophyta;Magnoliophyta;Malpighiales;Vantanea;";"0.0";"0";"1";"1";"0";"1";"0";"457182";"391207"
"V4mis2";"SILVA (only NR);Eukaryota;Archaeplastida;Chloroplastida;Charophyta;Phragmoplastophyta;Streptophyta;Embryophyta;Tracheophyta;Spermatophyta;Magnoliophyta;Malpighiales;Viola;";"0.0";"0";"1";"1";"0";"1";"0";"457182";"391207"
"V4mis2";"SILVA (only NR);Eukaryota;Archaeplastida;Chloroplastida;Charophyta;Phragmoplastophyta;Streptophyta;Embryophyta;Tracheophyta;Spermatophyta;Magnoliophyta;Malvales;";"0.0";"0";"328";"327";"0";"327";"1";"456856";"391207"
"V4mis2";"SILVA (only NR);Eukaryota;Archaeplastida;Chloroplastida;Charophyta;Phragmoplastophyta;Streptophyta;Embryophyta;Tracheophyta;Spermatophyta;Magnoliophyta;Malvales;Anisoptera;";"0.0";"0";"1";"1";"0";"1";"0";"457182";"391207"
"V4mis2";"SILVA (only NR);Eukaryota;Archaeplastida;Chloroplastida;Charophyta;Phragmoplastophyta;Streptophyta;Embryophyta;Tracheophyta;Spermatophyta;Magnoliophyta;Malvales;Aquilaria;";"0.0";"0";"15";"15";"0";"15";"0";"457168";"391207"
"V4mis2";"SILVA (only NR);Eukaryota;Archaeplastida;Chloroplastida;Charophyta;Phragmoplastophyta;Streptophyta;Embryophyta;Tracheophyta;Spermatophyta;Magnoliophyta;Malvales;Bdallophytum;";"0.0";"0";"1";"1";"0";"1";"0";"457182";"391207"
"V4mis2";"SILVA (only NR);Eukaryota;Archaeplastida;Chloroplastida;Charophyta;Phragmoplastophyta;Streptophyta;Embryophyta;Tracheophyta;Spermatophyta;Magnoliophyta;Malvales;Bixa;";"0.0";"0";"1";"1";"0";"1";"0";"457182";"391207"
"V4mis2";"SILVA (only NR);Eukaryota;Archaeplastida;Chloroplastida;Charophyta;Phragmoplastophyta;Streptophyta;Embryophyta;Tracheophyta;Spermatophyta;Magnoliophyta;Malvales;Bombax;";"0.0";"0";"1";"1";"0";"1";"0";"457182";"391207"
"V4mis2";"SILVA (only NR);Eukaryota;Archaeplastida;Chloroplastida;Charophyta;Phragmoplastophyta;Streptophyta;Embryophyta;Tracheophyta;Spermatophyta;Magnoliophyta;Malvales;Callirhoe;";"0.0";"0";"1";"1";"0";"1";"0";"457182";"391207"
"V4mis2";"SILVA (only NR);Eukaryota;Archaeplastida;Chloroplastida;Charophyta;Phragmoplastophyta;Streptophyta;Embryophyta;Tracheophyta;Spermatophyta;Magnoliophyta;Malvales;Corchorus;";"0.0";"0";"2";"2";"0";"2";"0";"457181";"391207"
"V4mis2";"SILVA (only NR);Eukaryota;Archaeplastida;Chloroplastida;Charophyta;Phragmoplastophyta;Streptophyta;Embryophyta;Tracheophyta;Spermatophyta;Magnoliophyta;Malvales;Cytinus;";"0.0";"0";"3";"3";"0";"3";"0";"457180";"391207"
"V4mis2";"SILVA (only NR);Eukaryota;Archaeplastida;Chloroplastida;Charophyta;Phragmoplastophyta;Streptophyta;Embryophyta;Tracheophyta;Spermatophyta;Magnoliophyta;Malvales;Durio;";"0.0";"0";"1";"1";"0";"1";"0";"457182";"391207"
"V4mis2";"SILVA (only NR);Eukaryota;Archaeplastida;Chloroplastida;Charophyta;Phragmoplastophyta;Streptophyta;Embryophyta;Tracheophyta;Spermatophyta;Magnoliophyta;Malvales;Gossypium;";"0.0";"0";"284";"283";"0";"283";"1";"456900";"391207"
"V4mis2";"SILVA (only NR);Eukaryota;Archaeplastida;Chloroplastida;Charophyta;Phragmoplastophyta;Streptophyta;Embryophyta;Tracheophyta;Spermatophyta;Magnoliophyta;Malvales;Grewia;";"0.0";"0";"1";"1";"0";"1";"0";"457182";"391207"
"V4mis2";"SILVA (only NR);Eukaryota;Archaeplastida;Chloroplastida;Charophyta;Phragmoplastophyta;Streptophyta;Embryophyta;Tracheophyta;Spermatophyta;Magnoliophyta;Malvales;Helianthemum;";"0.0";"0";"1";"1";"0";"1";"0";"457182";"391207"
"V4mis2";"SILVA (only NR);Eukaryota;Archaeplastida;Chloroplastida;Charophyta;Phragmoplastophyta;Streptophyta;Embryophyta;Tracheophyta;Spermatophyta;Magnoliophyta;Malvales;Hibiscus;";"0.0";"0";"8";"8";"0";"8";"0";"457175";"391207"
"V4mis2";"SILVA (only NR);Eukaryota;Archaeplastida;Chloroplastida;Charophyta;Phragmoplastophyta;Streptophyta;Embryophyta;Tracheophyta;Spermatophyta;Magnoliophyta;Malvales;Malva;";"0.0";"0";"1";"1";"0";"1";"0";"457182";"391207"
"V4mis2";"SILVA (only NR);Eukaryota;Archaeplastida;Chloroplastida;Charophyta;Phragmoplastophyta;Streptophyta;Embryophyta;Tracheophyta;Spermatophyta;Magnoliophyta;Malvales;Muntingia;";"0.0";"0";"1";"1";"0";"1";"0";"457182";"391207"
"V4mis2";"SILVA (only NR);Eukaryota;Archaeplastida;Chloroplastida;Charophyta;Phragmoplastophyta;Streptophyta;Embryophyta;Tracheophyta;Spermatophyta;Magnoliophyta;Malvales;Neurada;";"0.0";"0";"1";"1";"0";"1";"0";"457182";"391207"
"V4mis2";"SILVA (only NR);Eukaryota;Archaeplastida;Chloroplastida;Charophyta;Phragmoplastophyta;Streptophyta;Embryophyta;Tracheophyta;Spermatophyta;Magnoliophyta;Malvales;Ochroma;";"0.0";"0";"1";"1";"0";"1";"0";"457182";"391207"
"V4mis2";"SILVA (only NR);Eukaryota;Archaeplastida;Chloroplastida;Charophyta;Phragmoplastophyta;Streptophyta;Embryophyta;Tracheophyta;Spermatophyta;Magnoliophyta;Malvales;Sphaeralcea;";"0.0";"0";"1";"1";"0";"1";"0";"457182";"391207"
"V4mis2";"SILVA (only NR);Eukaryota;Archaeplastida;Chloroplastida;Charophyta;Phragmoplastophyta;Streptophyta;Embryophyta;Tracheophyta;Spermatophyta;Magnoliophyta;Malvales;Sterculia;";"0.0";"0";"1";"1";"0";"1";"0";"457182";"391207"
"V4mis2";"SILVA (only NR);Eukaryota;Archaeplastida;Chloroplastida;Charophyta;Phragmoplastophyta;Streptophyta;Embryophyta;Tracheophyta;Spermatophyta;Magnoliophyta;Malvales;Theobroma;";"0.0";"0";"1";"1";"0";"1";"0";"457182";"391207"
"V4mis2";"SILVA (only NR);Eukaryota;Archaeplastida;Chloroplastida;Charophyta;Phragmoplastophyta;Streptophyta;Embryophyta;Tracheophyta;Spermatophyta;Magnoliophyta;Malvales;Thymelaea;";"0.0";"0";"1";"1";"0";"1";"0";"457182";"391207"
"V4mis2";"SILVA (only NR);Eukaryota;Archaeplastida;Chloroplastida;Charophyta;Phragmoplastophyta;Streptophyta;Embryophyta;Tracheophyta;Spermatophyta;Magnoliophyta;Myrtales;";"0.0";"0";"53";"53";"0";"53";"0";"457130";"391207"
"V4mis2";"SILVA (only NR);Eukaryota;Archaeplastida;Chloroplastida;Charophyta;Phragmoplastophyta;Streptophyta;Embryophyta;Tracheophyta;Spermatophyta;Magnoliophyta;Myrtales;Brachysiphon;";"0.0";"0";"1";"1";"0";"1";"0";"457182";"391207"
"V4mis2";"SILVA (only NR);Eukaryota;Archaeplastida;Chloroplastida;Charophyta;Phragmoplastophyta;Streptophyta;Embryophyta;Tracheophyta;Spermatophyta;Magnoliophyta;Myrtales;Combretum;";"0.0";"0";"1";"1";"0";"1";"0";"457182";"391207"
"V4mis2";"SILVA (only NR);Eukaryota;Archaeplastida;Chloroplastida;Charophyta;Phragmoplastophyta;Streptophyta;Embryophyta;Tracheophyta;Spermatophyta;Magnoliophyta;Myrtales;Crypteronia;";"0.0";"0";"1";"1";"0";"1";"0";"457182";"391207"
"V4mis2";"SILVA (only NR);Eukaryota;Archaeplastida;Chloroplastida;Charophyta;Phragmoplastophyta;Streptophyta;Embryophyta;Tracheophyta;Spermatophyta;Magnoliophyta;Myrtales;Cuphea;";"0.0";"0";"1";"1";"0";"1";"0";"457182";"391207"
"V4mis2";"SILVA (only NR);Eukaryota;Archaeplastida;Chloroplastida;Charophyta;Phragmoplastophyta;Streptophyta;Embryophyta;Tracheophyta;Spermatophyta;Magnoliophyta;Myrtales;Endonema;";"0.0";"0";"1";"1";"0";"1";"0";"457182";"391207"
"V4mis2";"SILVA (only NR);Eukaryota;Archaeplastida;Chloroplastida;Charophyta;Phragmoplastophyta;Streptophyta;Embryophyta;Tracheophyta;Spermatophyta;Magnoliophyta;Myrtales;Eucalyptus;";"0.0";"0";"8";"8";"0";"8";"0";"457175";"391207"
"V4mis2";"SILVA (only NR);Eukaryota;Archaeplastida;Chloroplastida;Charophyta;Phragmoplastophyta;Streptophyta;Embryophyta;Tracheophyta;Spermatophyta;Magnoliophyta;Myrtales;Laguncularia;";"0.0";"0";"1";"1";"0";"1";"0";"457182";"391207"
"V4mis2";"SILVA (only NR);Eukaryota;Archaeplastida;Chloroplastida;Charophyta;Phragmoplastophyta;Streptophyta;Embryophyta;Tracheophyta;Spermatophyta;Magnoliophyta;Myrtales;Lythrum;";"0.0";"0";"1";"1";"0";"1";"0";"457182";"391207"
"V4mis2";"SILVA (only NR);Eukaryota;Archaeplastida;Chloroplastida;Charophyta;Phragmoplastophyta;Streptophyta;Embryophyta;Tracheophyta;Spermatophyta;Magnoliophyta;Myrtales;Mouriri;";"0.0";"0";"1";"1";"0";"1";"0";"457182";"391207"
"V4mis2";"SILVA (only NR);Eukaryota;Archaeplastida;Chloroplastida;Charophyta;Phragmoplastophyta;Streptophyta;Embryophyta;Tracheophyta;Spermatophyta;Magnoliophyta;Myrtales;Oenothera;";"0.0";"0";"3";"3";"0";"3";"0";"457180";"391207"
"V4mis2";"SILVA (only NR);Eukaryota;Archaeplastida;Chloroplastida;Charophyta;Phragmoplastophyta;Streptophyta;Embryophyta;Tracheophyta;Spermatophyta;Magnoliophyta;Myrtales;Osbeckia;";"0.0";"0";"1";"1";"0";"1";"0";"457182";"391207"
"V4mis2";"SILVA (only NR);Eukaryota;Archaeplastida;Chloroplastida;Charophyta;Phragmoplastophyta;Streptophyta;Embryophyta;Tracheophyta;Spermatophyta;Magnoliophyta;Myrtales;Pemphis;";"0.0";"0";"1";"1";"0";"1";"0";"457182";"391207"
"V4mis2";"SILVA (only NR);Eukaryota;Archaeplastida;Chloroplastida;Charophyta;Phragmoplastophyta;Streptophyta;Embryophyta;Tracheophyta;Spermatophyta;Magnoliophyta;Myrtales;Punica;";"0.0";"0";"29";"29";"0";"29";"0";"457154";"391207"
"V4mis2";"SILVA (only NR);Eukaryota;Archaeplastida;Chloroplastida;Charophyta;Phragmoplastophyta;Streptophyta;Embryophyta;Tracheophyta;Spermatophyta;Magnoliophyta;Myrtales;Qualea;";"0.0";"0";"1";"1";"0";"1";"0";"457182";"391207"
"V4mis2";"SILVA (only NR);Eukaryota;Archaeplastida;Chloroplastida;Charophyta;Phragmoplastophyta;Streptophyta;Embryophyta;Tracheophyta;Spermatophyta;Magnoliophyta;Myrtales;Sonneratia;";"0.0";"0";"1";"1";"0";"1";"0";"457182";"391207"
"V4mis2";"SILVA (only NR);Eukaryota;Archaeplastida;Chloroplastida;Charophyta;Phragmoplastophyta;Streptophyta;Embryophyta;Tracheophyta;Spermatophyta;Magnoliophyta;Myrtales;Trapa;";"0.0";"0";"1";"1";"0";"1";"0";"457182";"391207"
"V4mis2";"SILVA (only NR);Eukaryota;Archaeplastida;Chloroplastida;Charophyta;Phragmoplastophyta;Streptophyta;Embryophyta;Tracheophyta;Spermatophyta;Magnoliophyta;Nymphaeales;";"0.0";"0";"4";"4";"0";"4";"0";"457179";"391207"
"V4mis2";"SILVA (only NR);Eukaryota;Archaeplastida;Chloroplastida;Charophyta;Phragmoplastophyta;Streptophyta;Embryophyta;Tracheophyta;Spermatophyta;Magnoliophyta;Nymphaeales;Brasenia;";"0.0";"0";"1";"1";"0";"1";"0";"457182";"391207"
"V4mis2";"SILVA (only NR);Eukaryota;Archaeplastida;Chloroplastida;Charophyta;Phragmoplastophyta;Streptophyta;Embryophyta;Tracheophyta;Spermatophyta;Magnoliophyta;Nymphaeales;Cabomba;";"0.0";"0";"1";"1";"0";"1";"0";"457182";"391207"
"V4mis2";"SILVA (only NR);Eukaryota;Archaeplastida;Chloroplastida;Charophyta;Phragmoplastophyta;Streptophyta;Embryophyta;Tracheophyta;Spermatophyta;Magnoliophyta;Nymphaeales;Nuphar;";"0.0";"0";"1";"1";"0";"1";"0";"457182";"391207"
"V4mis2";"SILVA (only NR);Eukaryota;Archaeplastida;Chloroplastida;Charophyta;Phragmoplastophyta;Streptophyta;Embryophyta;Tracheophyta;Spermatophyta;Magnoliophyta;Nymphaeales;Nymphaea;";"0.0";"0";"1";"1";"0";"1";"0";"457182";"391207"
"V4mis2";"SILVA (only NR);Eukaryota;Archaeplastida;Chloroplastida;Charophyta;Phragmoplastophyta;Streptophyta;Embryophyta;Tracheophyta;Spermatophyta;Magnoliophyta;Oxalidales;";"0.0";"0";"11";"11";"0";"11";"0";"457172";"391207"
"V4mis2";"SILVA (only NR);Eukaryota;Archaeplastida;Chloroplastida;Charophyta;Phragmoplastophyta;Streptophyta;Embryophyta;Tracheophyta;Spermatophyta;Magnoliophyta;Oxalidales;Averrhoa;";"0.0";"0";"1";"1";"0";"1";"0";"457182";"391207"
"V4mis2";"SILVA (only NR);Eukaryota;Archaeplastida;Chloroplastida;Charophyta;Phragmoplastophyta;Streptophyta;Embryophyta;Tracheophyta;Spermatophyta;Magnoliophyta;Oxalidales;Cephalotus;";"0.0";"0";"2";"2";"0";"2";"0";"457181";"391207"
"V4mis2";"SILVA (only NR);Eukaryota;Archaeplastida;Chloroplastida;Charophyta;Phragmoplastophyta;Streptophyta;Embryophyta;Tracheophyta;Spermatophyta;Magnoliophyta;Oxalidales;Connarus;";"0.0";"0";"1";"1";"0";"1";"0";"457182";"391207"
"V4mis2";"SILVA (only NR);Eukaryota;Archaeplastida;Chloroplastida;Charophyta;Phragmoplastophyta;Streptophyta;Embryophyta;Tracheophyta;Spermatophyta;Magnoliophyta;Oxalidales;Davidsonia;";"0.0";"0";"1";"1";"0";"1";"0";"457182";"391207"
"V4mis2";"SILVA (only NR);Eukaryota;Archaeplastida;Chloroplastida;Charophyta;Phragmoplastophyta;Streptophyta;Embryophyta;Tracheophyta;Spermatophyta;Magnoliophyta;Oxalidales;Hua;";"0.0";"0";"1";"1";"0";"1";"0";"457182";"391207"
"V4mis2";"SILVA (only NR);Eukaryota;Archaeplastida;Chloroplastida;Charophyta;Phragmoplastophyta;Streptophyta;Embryophyta;Tracheophyta;Spermatophyta;Magnoliophyta;Oxalidales;Oxalis;";"0.0";"0";"3";"3";"0";"3";"0";"457180";"391207"
"V4mis2";"SILVA (only NR);Eukaryota;Archaeplastida;Chloroplastida;Charophyta;Phragmoplastophyta;Streptophyta;Embryophyta;Tracheophyta;Spermatophyta;Magnoliophyta;Oxalidales;Platytheca;";"0.0";"0";"1";"1";"0";"1";"0";"457182";"391207"
"V4mis2";"SILVA (only NR);Eukaryota;Archaeplastida;Chloroplastida;Charophyta;Phragmoplastophyta;Streptophyta;Embryophyta;Tracheophyta;Spermatophyta;Magnoliophyta;Oxalidales;Rourea;";"0.0";"0";"1";"1";"0";"1";"0";"457182";"391207"
"V4mis2";"SILVA (only NR);Eukaryota;Archaeplastida;Chloroplastida;Charophyta;Phragmoplastophyta;Streptophyta;Embryophyta;Tracheophyta;Spermatophyta;Magnoliophyta;Paracryphiales;";"0.0";"0";"1";"1";"0";"1";"0";"457182";"391207"
"V4mis2";"SILVA (only NR);Eukaryota;Archaeplastida;Chloroplastida;Charophyta;Phragmoplastophyta;Streptophyta;Embryophyta;Tracheophyta;Spermatophyta;Magnoliophyta;Paracryphiales;Paracryphia;";"0.0";"0";"1";"1";"0";"1";"0";"457182";"391207"
"V4mis2";"SILVA (only NR);Eukaryota;Archaeplastida;Chloroplastida;Charophyta;Phragmoplastophyta;Streptophyta;Embryophyta;Tracheophyta;Spermatophyta;Magnoliophyta;Piperales;";"0.0";"0";"17";"17";"0";"17";"0";"457166";"391207"
"V4mis2";"SILVA (only NR);Eukaryota;Archaeplastida;Chloroplastida;Charophyta;Phragmoplastophyta;Streptophyta;Embryophyta;Tracheophyta;Spermatophyta;Magnoliophyta;Piperales;Anemopsis;";"0.0";"0";"1";"1";"0";"1";"0";"457182";"391207"
"V4mis2";"SILVA (only NR);Eukaryota;Archaeplastida;Chloroplastida;Charophyta;Phragmoplastophyta;Streptophyta;Embryophyta;Tracheophyta;Spermatophyta;Magnoliophyta;Piperales;Aristolochia;";"0.0";"0";"2";"2";"0";"2";"0";"457181";"391207"
"V4mis2";"SILVA (only NR);Eukaryota;Archaeplastida;Chloroplastida;Charophyta;Phragmoplastophyta;Streptophyta;Embryophyta;Tracheophyta;Spermatophyta;Magnoliophyta;Piperales;Houttuynia;";"0.0";"0";"1";"1";"0";"1";"0";"457182";"391207"
"V4mis2";"SILVA (only NR);Eukaryota;Archaeplastida;Chloroplastida;Charophyta;Phragmoplastophyta;Streptophyta;Embryophyta;Tracheophyta;Spermatophyta;Magnoliophyta;Piperales;Hydnora;";"0.0";"0";"1";"1";"0";"1";"0";"457182";"391207"
"V4mis2";"SILVA (only NR);Eukaryota;Archaeplastida;Chloroplastida;Charophyta;Phragmoplastophyta;Streptophyta;Embryophyta;Tracheophyta;Spermatophyta;Magnoliophyta;Piperales;Lactoris;";"0.0";"0";"1";"1";"0";"1";"0";"457182";"391207"
"V4mis2";"SILVA (only NR);Eukaryota;Archaeplastida;Chloroplastida;Charophyta;Phragmoplastophyta;Streptophyta;Embryophyta;Tracheophyta;Spermatophyta;Magnoliophyta;Piperales;Manekia;";"0.0";"0";"1";"1";"0";"1";"0";"457182";"391207"
"V4mis2";"SILVA (only NR);Eukaryota;Archaeplastida;Chloroplastida;Charophyta;Phragmoplastophyta;Streptophyta;Embryophyta;Tracheophyta;Spermatophyta;Magnoliophyta;Piperales;Peperomia;";"0.0";"0";"4";"4";"0";"4";"0";"457179";"391207"
"V4mis2";"SILVA (only NR);Eukaryota;Archaeplastida;Chloroplastida;Charophyta;Phragmoplastophyta;Streptophyta;Embryophyta;Tracheophyta;Spermatophyta;Magnoliophyta;Piperales;Piper;";"0.0";"0";"2";"2";"0";"2";"0";"457181";"391207"
"V4mis2";"SILVA (only NR);Eukaryota;Archaeplastida;Chloroplastida;Charophyta;Phragmoplastophyta;Streptophyta;Embryophyta;Tracheophyta;Spermatophyta;Magnoliophyta;Piperales;Prosopanche;";"0.0";"0";"1";"1";"0";"1";"0";"457182";"391207"
"V4mis2";"SILVA (only NR);Eukaryota;Archaeplastida;Chloroplastida;Charophyta;Phragmoplastophyta;Streptophyta;Embryophyta;Tracheophyta;Spermatophyta;Magnoliophyta;Piperales;Saruma;";"0.0";"0";"1";"1";"0";"1";"0";"457182";"391207"
"V4mis2";"SILVA (only NR);Eukaryota;Archaeplastida;Chloroplastida;Charophyta;Phragmoplastophyta;Streptophyta;Embryophyta;Tracheophyta;Spermatophyta;Magnoliophyta;Piperales;Saururus;";"0.0";"0";"1";"1";"0";"1";"0";"457182";"391207"
"V4mis2";"SILVA (only NR);Eukaryota;Archaeplastida;Chloroplastida;Charophyta;Phragmoplastophyta;Streptophyta;Embryophyta;Tracheophyta;Spermatophyta;Magnoliophyta;Piperales;Verhuellia;";"0.0";"0";"1";"1";"0";"1";"0";"457182";"391207"
"V4mis2";"SILVA (only NR);Eukaryota;Archaeplastida;Chloroplastida;Charophyta;Phragmoplastophyta;Streptophyta;Embryophyta;Tracheophyta;Spermatophyta;Magnoliophyta;Proteales;";"0.0";"0";"18";"18";"0";"18";"0";"457165";"391207"
"V4mis2";"SILVA (only NR);Eukaryota;Archaeplastida;Chloroplastida;Charophyta;Phragmoplastophyta;Streptophyta;Embryophyta;Tracheophyta;Spermatophyta;Magnoliophyta;Proteales;Grevillea;";"0.0";"0";"1";"1";"0";"1";"0";"457182";"391207"
"V4mis2";"SILVA (only NR);Eukaryota;Archaeplastida;Chloroplastida;Charophyta;Phragmoplastophyta;Streptophyta;Embryophyta;Tracheophyta;Spermatophyta;Magnoliophyta;Proteales;Knightia;";"0.0";"0";"1";"1";"0";"1";"0";"457182";"391207"
"V4mis2";"SILVA (only NR);Eukaryota;Archaeplastida;Chloroplastida;Charophyta;Phragmoplastophyta;Streptophyta;Embryophyta;Tracheophyta;Spermatophyta;Magnoliophyta;Proteales;Macadamia;";"0.0";"0";"1";"1";"0";"1";"0";"457182";"391207"
"V4mis2";"SILVA (only NR);Eukaryota;Archaeplastida;Chloroplastida;Charophyta;Phragmoplastophyta;Streptophyta;Embryophyta;Tracheophyta;Spermatophyta;Magnoliophyta;Proteales;Meliosma;";"0.0";"0";"1";"1";"0";"1";"0";"457182";"391207"
"V4mis2";"SILVA (only NR);Eukaryota;Archaeplastida;Chloroplastida;Charophyta;Phragmoplastophyta;Streptophyta;Embryophyta;Tracheophyta;Spermatophyta;Magnoliophyta;Proteales;Nelumbo;";"0.0";"0";"11";"11";"0";"11";"0";"457172";"391207"
"V4mis2";"SILVA (only NR);Eukaryota;Archaeplastida;Chloroplastida;Charophyta;Phragmoplastophyta;Streptophyta;Embryophyta;Tracheophyta;Spermatophyta;Magnoliophyta;Proteales;Persoonia;";"0.0";"0";"1";"1";"0";"1";"0";"457182";"391207"
"V4mis2";"SILVA (only NR);Eukaryota;Archaeplastida;Chloroplastida;Charophyta;Phragmoplastophyta;Streptophyta;Embryophyta;Tracheophyta;Spermatophyta;Magnoliophyta;Proteales;Platanus;";"0.0";"0";"1";"1";"0";"1";"0";"457182";"391207"
"V4mis2";"SILVA (only NR);Eukaryota;Archaeplastida;Chloroplastida;Charophyta;Phragmoplastophyta;Streptophyta;Embryophyta;Tracheophyta;Spermatophyta;Magnoliophyta;Proteales;Roupala;";"0.0";"0";"1";"1";"0";"1";"0";"457182";"391207"
"V4mis2";"SILVA (only NR);Eukaryota;Archaeplastida;Chloroplastida;Charophyta;Phragmoplastophyta;Streptophyta;Embryophyta;Tracheophyta;Spermatophyta;Magnoliophyta;Ranunculales;";"0.0";"0";"23";"23";"0";"23";"0";"457160";"391207"
"V4mis2";"SILVA (only NR);Eukaryota;Archaeplastida;Chloroplastida;Charophyta;Phragmoplastophyta;Streptophyta;Embryophyta;Tracheophyta;Spermatophyta;Magnoliophyta;Ranunculales;Aconitum;";"0.0";"0";"1";"1";"0";"1";"0";"457182";"391207"
"V4mis2";"SILVA (only NR);Eukaryota;Archaeplastida;Chloroplastida;Charophyta;Phragmoplastophyta;Streptophyta;Embryophyta;Tracheophyta;Spermatophyta;Magnoliophyta;Ranunculales;Actaea;";"0.0";"0";"1";"1";"0";"1";"0";"457182";"391207"
"V4mis2";"SILVA (only NR);Eukaryota;Archaeplastida;Chloroplastida;Charophyta;Phragmoplastophyta;Streptophyta;Embryophyta;Tracheophyta;Spermatophyta;Magnoliophyta;Ranunculales;Akebia;";"0.0";"0";"1";"1";"0";"1";"0";"457182";"391207"
"V4mis2";"SILVA (only NR);Eukaryota;Archaeplastida;Chloroplastida;Charophyta;Phragmoplastophyta;Streptophyta;Embryophyta;Tracheophyta;Spermatophyta;Magnoliophyta;Ranunculales;Anemone;";"0.0";"0";"1";"1";"0";"1";"0";"457182";"391207"
"V4mis2";"SILVA (only NR);Eukaryota;Archaeplastida;Chloroplastida;Charophyta;Phragmoplastophyta;Streptophyta;Embryophyta;Tracheophyta;Spermatophyta;Magnoliophyta;Ranunculales;Aquilegia;";"0.0";"0";"1";"1";"0";"1";"0";"457182";"391207"
"V4mis2";"SILVA (only NR);Eukaryota;Archaeplastida;Chloroplastida;Charophyta;Phragmoplastophyta;Streptophyta;Embryophyta;Tracheophyta;Spermatophyta;Magnoliophyta;Ranunculales;Arcangelisia;";"0.0";"0";"1";"1";"0";"1";"0";"457182";"391207"
"V4mis2";"SILVA (only NR);Eukaryota;Archaeplastida;Chloroplastida;Charophyta;Phragmoplastophyta;Streptophyta;Embryophyta;Tracheophyta;Spermatophyta;Magnoliophyta;Ranunculales;Argemone;";"0.0";"0";"1";"1";"0";"1";"0";"457182";"391207"
"V4mis2";"SILVA (only NR);Eukaryota;Archaeplastida;Chloroplastida;Charophyta;Phragmoplastophyta;Streptophyta;Embryophyta;Tracheophyta;Spermatophyta;Magnoliophyta;Ranunculales;Berberis;";"0.0";"0";"1";"1";"0";"1";"0";"457182";"391207"
"V4mis2";"SILVA (only NR);Eukaryota;Archaeplastida;Chloroplastida;Charophyta;Phragmoplastophyta;Streptophyta;Embryophyta;Tracheophyta;Spermatophyta;Magnoliophyta;Ranunculales;Cissampelos;";"0.0";"0";"1";"1";"0";"1";"0";"457182";"391207"
"V4mis2";"SILVA (only NR);Eukaryota;Archaeplastida;Chloroplastida;Charophyta;Phragmoplastophyta;Streptophyta;Embryophyta;Tracheophyta;Spermatophyta;Magnoliophyta;Ranunculales;Clematis;";"0.0";"0";"1";"1";"0";"1";"0";"457182";"391207"
"V4mis2";"SILVA (only NR);Eukaryota;Archaeplastida;Chloroplastida;Charophyta;Phragmoplastophyta;Streptophyta;Embryophyta;Tracheophyta;Spermatophyta;Magnoliophyta;Ranunculales;Coptis;";"0.0";"0";"1";"1";"0";"1";"0";"457182";"391207"
"V4mis2";"SILVA (only NR);Eukaryota;Archaeplastida;Chloroplastida;Charophyta;Phragmoplastophyta;Streptophyta;Embryophyta;Tracheophyta;Spermatophyta;Magnoliophyta;Ranunculales;Corydalis;";"0.0";"0";"2";"2";"0";"2";"0";"457181";"391207"
"V4mis2";"SILVA (only NR);Eukaryota;Archaeplastida;Chloroplastida;Charophyta;Phragmoplastophyta;Streptophyta;Embryophyta;Tracheophyta;Spermatophyta;Magnoliophyta;Ranunculales;Fibraurea;";"0.0";"0";"1";"1";"0";"1";"0";"457182";"391207"
"V4mis2";"SILVA (only NR);Eukaryota;Archaeplastida;Chloroplastida;Charophyta;Phragmoplastophyta;Streptophyta;Embryophyta;Tracheophyta;Spermatophyta;Magnoliophyta;Ranunculales;Papaver;";"0.0";"0";"1";"1";"0";"1";"0";"457182";"391207"
"V4mis2";"SILVA (only NR);Eukaryota;Archaeplastida;Chloroplastida;Charophyta;Phragmoplastophyta;Streptophyta;Embryophyta;Tracheophyta;Spermatophyta;Magnoliophyta;Ranunculales;Podophyllum;";"0.0";"0";"1";"1";"0";"1";"0";"457182";"391207"
"V4mis2";"SILVA (only NR);Eukaryota;Archaeplastida;Chloroplastida;Charophyta;Phragmoplastophyta;Streptophyta;Embryophyta;Tracheophyta;Spermatophyta;Magnoliophyta;Ranunculales;Ranunculus;";"0.0";"0";"2";"2";"0";"2";"0";"457181";"391207"
"V4mis2";"SILVA (only NR);Eukaryota;Archaeplastida;Chloroplastida;Charophyta;Phragmoplastophyta;Streptophyta;Embryophyta;Tracheophyta;Spermatophyta;Magnoliophyta;Ranunculales;Sanguinaria;";"0.0";"0";"1";"1";"0";"1";"0";"457182";"391207"
"V4mis2";"SILVA (only NR);Eukaryota;Archaeplastida;Chloroplastida;Charophyta;Phragmoplastophyta;Streptophyta;Embryophyta;Tracheophyta;Spermatophyta;Magnoliophyta;Ranunculales;Stephania;";"0.0";"0";"4";"4";"0";"4";"0";"457179";"391207"
"V4mis2";"SILVA (only NR);Eukaryota;Archaeplastida;Chloroplastida;Charophyta;Phragmoplastophyta;Streptophyta;Embryophyta;Tracheophyta;Spermatophyta;Magnoliophyta;Rosales;";"0.0";"0";"95";"95";"0";"95";"0";"457088";"391207"
"V4mis2";"SILVA (only NR);Eukaryota;Archaeplastida;Chloroplastida;Charophyta;Phragmoplastophyta;Streptophyta;Embryophyta;Tracheophyta;Spermatophyta;Magnoliophyta;Rosales;Adenostoma;";"0.0";"0";"1";"1";"0";"1";"0";"457182";"391207"
"V4mis2";"SILVA (only NR);Eukaryota;Archaeplastida;Chloroplastida;Charophyta;Phragmoplastophyta;Streptophyta;Embryophyta;Tracheophyta;Spermatophyta;Magnoliophyta;Rosales;Barbeya;";"0.0";"0";"1";"1";"0";"1";"0";"457182";"391207"
"V4mis2";"SILVA (only NR);Eukaryota;Archaeplastida;Chloroplastida;Charophyta;Phragmoplastophyta;Streptophyta;Embryophyta;Tracheophyta;Spermatophyta;Magnoliophyta;Rosales;Boehmeria;";"0.0";"0";"2";"2";"0";"2";"0";"457181";"391207"
"V4mis2";"SILVA (only NR);Eukaryota;Archaeplastida;Chloroplastida;Charophyta;Phragmoplastophyta;Streptophyta;Embryophyta;Tracheophyta;Spermatophyta;Magnoliophyta;Rosales;Broussonetia;";"0.0";"0";"1";"1";"0";"1";"0";"457182";"391207"
"V4mis2";"SILVA (only NR);Eukaryota;Archaeplastida;Chloroplastida;Charophyta;Phragmoplastophyta;Streptophyta;Embryophyta;Tracheophyta;Spermatophyta;Magnoliophyta;Rosales;Cannabis;";"0.0";"0";"11";"11";"0";"11";"0";"457172";"391207"
"V4mis2";"SILVA (only NR);Eukaryota;Archaeplastida;Chloroplastida;Charophyta;Phragmoplastophyta;Streptophyta;Embryophyta;Tracheophyta;Spermatophyta;Magnoliophyta;Rosales;Ceanothus;";"0.0";"0";"1";"1";"0";"1";"0";"457182";"391207"
"V4mis2";"SILVA (only NR);Eukaryota;Archaeplastida;Chloroplastida;Charophyta;Phragmoplastophyta;Streptophyta;Embryophyta;Tracheophyta;Spermatophyta;Magnoliophyta;Rosales;Cecropia;";"0.0";"0";"1";"1";"0";"1";"0";"457182";"391207"
"V4mis2";"SILVA (only NR);Eukaryota;Archaeplastida;Chloroplastida;Charophyta;Phragmoplastophyta;Streptophyta;Embryophyta;Tracheophyta;Spermatophyta;Magnoliophyta;Rosales;Didymodoxa;";"0.0";"0";"1";"1";"0";"1";"0";"457182";"391207"
"V4mis2";"SILVA (only NR);Eukaryota;Archaeplastida;Chloroplastida;Charophyta;Phragmoplastophyta;Streptophyta;Embryophyta;Tracheophyta;Spermatophyta;Magnoliophyta;Rosales;Dirachma;";"0.0";"0";"1";"1";"0";"1";"0";"457182";"391207"
"V4mis2";"SILVA (only NR);Eukaryota;Archaeplastida;Chloroplastida;Charophyta;Phragmoplastophyta;Streptophyta;Embryophyta;Tracheophyta;Spermatophyta;Magnoliophyta;Rosales;Elaeagnus;";"0.0";"0";"1";"1";"0";"1";"0";"457182";"391207"
"V4mis2";"SILVA (only NR);Eukaryota;Archaeplastida;Chloroplastida;Charophyta;Phragmoplastophyta;Streptophyta;Embryophyta;Tracheophyta;Spermatophyta;Magnoliophyta;Rosales;Exochorda;";"0.0";"0";"1";"1";"0";"1";"0";"457182";"391207"
"V4mis2";"SILVA (only NR);Eukaryota;Archaeplastida;Chloroplastida;Charophyta;Phragmoplastophyta;Streptophyta;Embryophyta;Tracheophyta;Spermatophyta;Magnoliophyta;Rosales;Ficus;";"0.0";"0";"1";"1";"0";"1";"0";"457182";"391207"
"V4mis2";"SILVA (only NR);Eukaryota;Archaeplastida;Chloroplastida;Charophyta;Phragmoplastophyta;Streptophyta;Embryophyta;Tracheophyta;Spermatophyta;Magnoliophyta;Rosales;Filipendula;";"0.0";"0";"1";"1";"0";"1";"0";"457182";"391207"
"V4mis2";"SILVA (only NR);Eukaryota;Archaeplastida;Chloroplastida;Charophyta;Phragmoplastophyta;Streptophyta;Embryophyta;Tracheophyta;Spermatophyta;Magnoliophyta;Rosales;Forsskaolea;";"0.0";"0";"1";"1";"0";"1";"0";"457182";"391207"
"V4mis2";"SILVA (only NR);Eukaryota;Archaeplastida;Chloroplastida;Charophyta;Phragmoplastophyta;Streptophyta;Embryophyta;Tracheophyta;Spermatophyta;Magnoliophyta;Rosales;Fragaria;";"0.0";"0";"5";"5";"0";"5";"0";"457178";"391207"
"V4mis2";"SILVA (only NR);Eukaryota;Archaeplastida;Chloroplastida;Charophyta;Phragmoplastophyta;Streptophyta;Embryophyta;Tracheophyta;Spermatophyta;Magnoliophyta;Rosales;Gonostegia;";"0.0";"0";"1";"1";"0";"1";"0";"457182";"391207"
"V4mis2";"SILVA (only NR);Eukaryota;Archaeplastida;Chloroplastida;Charophyta;Phragmoplastophyta;Streptophyta;Embryophyta;Tracheophyta;Spermatophyta;Magnoliophyta;Rosales;Gouania;";"0.0";"0";"1";"1";"0";"1";"0";"457182";"391207"
"V4mis2";"SILVA (only NR);Eukaryota;Archaeplastida;Chloroplastida;Charophyta;Phragmoplastophyta;Streptophyta;Embryophyta;Tracheophyta;Spermatophyta;Magnoliophyta;Rosales;Holoptelea;";"0.0";"0";"1";"1";"0";"1";"0";"457182";"391207"
"V4mis2";"SILVA (only NR);Eukaryota;Archaeplastida;Chloroplastida;Charophyta;Phragmoplastophyta;Streptophyta;Embryophyta;Tracheophyta;Spermatophyta;Magnoliophyta;Rosales;Humulus;";"0.0";"0";"7";"7";"0";"7";"0";"457176";"391207"
"V4mis2";"SILVA (only NR);Eukaryota;Archaeplastida;Chloroplastida;Charophyta;Phragmoplastophyta;Streptophyta;Embryophyta;Tracheophyta;Spermatophyta;Magnoliophyta;Rosales;Kerria;";"0.0";"0";"1";"1";"0";"1";"0";"457182";"391207"
"V4mis2";"SILVA (only NR);Eukaryota;Archaeplastida;Chloroplastida;Charophyta;Phragmoplastophyta;Streptophyta;Embryophyta;Tracheophyta;Spermatophyta;Magnoliophyta;Rosales;Malus;";"0.0";"0";"3";"3";"0";"3";"0";"457180";"391207"
"V4mis2";"SILVA (only NR);Eukaryota;Archaeplastida;Chloroplastida;Charophyta;Phragmoplastophyta;Streptophyta;Embryophyta;Tracheophyta;Spermatophyta;Magnoliophyta;Rosales;Morus;";"0.0";"0";"2";"2";"0";"2";"0";"457181";"391207"
"V4mis2";"SILVA (only NR);Eukaryota;Archaeplastida;Chloroplastida;Charophyta;Phragmoplastophyta;Streptophyta;Embryophyta;Tracheophyta;Spermatophyta;Magnoliophyta;Rosales;Myriocarpa;";"0.0";"0";"1";"1";"0";"1";"0";"457182";"391207"
"V4mis2";"SILVA (only NR);Eukaryota;Archaeplastida;Chloroplastida;Charophyta;Phragmoplastophyta;Streptophyta;Embryophyta;Tracheophyta;Spermatophyta;Magnoliophyta;Rosales;Nanocnide;";"0.0";"0";"1";"1";"0";"1";"0";"457182";"391207"
"V4mis2";"SILVA (only NR);Eukaryota;Archaeplastida;Chloroplastida;Charophyta;Phragmoplastophyta;Streptophyta;Embryophyta;Tracheophyta;Spermatophyta;Magnoliophyta;Rosales;Neodistemon;";"0.0";"0";"1";"1";"0";"1";"0";"457182";"391207"
"V4mis2";"SILVA (only NR);Eukaryota;Archaeplastida;Chloroplastida;Charophyta;Phragmoplastophyta;Streptophyta;Embryophyta;Tracheophyta;Spermatophyta;Magnoliophyta;Rosales;Neraudia;";"0.0";"0";"1";"1";"0";"1";"0";"457182";"391207"
"V4mis2";"SILVA (only NR);Eukaryota;Archaeplastida;Chloroplastida;Charophyta;Phragmoplastophyta;Streptophyta;Embryophyta;Tracheophyta;Spermatophyta;Magnoliophyta;Rosales;Obetia;";"0.0";"0";"1";"1";"0";"1";"0";"457182";"391207"
"V4mis2";"SILVA (only NR);Eukaryota;Archaeplastida;Chloroplastida;Charophyta;Phragmoplastophyta;Streptophyta;Embryophyta;Tracheophyta;Spermatophyta;Magnoliophyta;Rosales;Oreocnide;";"0.0";"0";"1";"1";"0";"1";"0";"457182";"391207"
"V4mis2";"SILVA (only NR);Eukaryota;Archaeplastida;Chloroplastida;Charophyta;Phragmoplastophyta;Streptophyta;Embryophyta;Tracheophyta;Spermatophyta;Magnoliophyta;Rosales;Parietaria;";"0.0";"0";"2";"2";"0";"2";"0";"457181";"391207"
"V4mis2";"SILVA (only NR);Eukaryota;Archaeplastida;Chloroplastida;Charophyta;Phragmoplastophyta;Streptophyta;Embryophyta;Tracheophyta;Spermatophyta;Magnoliophyta;Rosales;Pellionia;";"0.0";"0";"2";"2";"0";"2";"0";"457181";"391207"
"V4mis2";"SILVA (only NR);Eukaryota;Archaeplastida;Chloroplastida;Charophyta;Phragmoplastophyta;Streptophyta;Embryophyta;Tracheophyta;Spermatophyta;Magnoliophyta;Rosales;Phyllostylon;";"0.0";"0";"1";"1";"0";"1";"0";"457182";"391207"
"V4mis2";"SILVA (only NR);Eukaryota;Archaeplastida;Chloroplastida;Charophyta;Phragmoplastophyta;Streptophyta;Embryophyta;Tracheophyta;Spermatophyta;Magnoliophyta;Rosales;Pilea;";"0.0";"0";"1";"1";"0";"1";"0";"457182";"391207"
"V4mis2";"SILVA (only NR);Eukaryota;Archaeplastida;Chloroplastida;Charophyta;Phragmoplastophyta;Streptophyta;Embryophyta;Tracheophyta;Spermatophyta;Magnoliophyta;Rosales;Pipturus;";"0.0";"0";"1";"1";"0";"1";"0";"457182";"391207"
"V4mis2";"SILVA (only NR);Eukaryota;Archaeplastida;Chloroplastida;Charophyta;Phragmoplastophyta;Streptophyta;Embryophyta;Tracheophyta;Spermatophyta;Magnoliophyta;Rosales;Prinsepia;";"0.0";"0";"1";"1";"0";"1";"0";"457182";"391207"
"V4mis2";"SILVA (only NR);Eukaryota;Archaeplastida;Chloroplastida;Charophyta;Phragmoplastophyta;Streptophyta;Embryophyta;Tracheophyta;Spermatophyta;Magnoliophyta;Rosales;Procris;";"0.0";"0";"1";"1";"0";"1";"0";"457182";"391207"
"V4mis2";"SILVA (only NR);Eukaryota;Archaeplastida;Chloroplastida;Charophyta;Phragmoplastophyta;Streptophyta;Embryophyta;Tracheophyta;Spermatophyta;Magnoliophyta;Rosales;Prunus;";"0.0";"0";"4";"4";"0";"4";"0";"457179";"391207"
"V4mis2";"SILVA (only NR);Eukaryota;Archaeplastida;Chloroplastida;Charophyta;Phragmoplastophyta;Streptophyta;Embryophyta;Tracheophyta;Spermatophyta;Magnoliophyta;Rosales;Purshia;";"0.0";"0";"1";"1";"0";"1";"0";"457182";"391207"
"V4mis2";"SILVA (only NR);Eukaryota;Archaeplastida;Chloroplastida;Charophyta;Phragmoplastophyta;Streptophyta;Embryophyta;Tracheophyta;Spermatophyta;Magnoliophyta;Rosales;Pyrus;";"0.0";"0";"5";"5";"0";"5";"0";"457178";"391207"
"V4mis2";"SILVA (only NR);Eukaryota;Archaeplastida;Chloroplastida;Charophyta;Phragmoplastophyta;Streptophyta;Embryophyta;Tracheophyta;Spermatophyta;Magnoliophyta;Rosales;Retanilla;";"0.0";"0";"1";"1";"0";"1";"0";"457182";"391207"
"V4mis2";"SILVA (only NR);Eukaryota;Archaeplastida;Chloroplastida;Charophyta;Phragmoplastophyta;Streptophyta;Embryophyta;Tracheophyta;Spermatophyta;Magnoliophyta;Rosales;Rhamnus;";"0.0";"0";"1";"1";"0";"1";"0";"457182";"391207"
"V4mis2";"SILVA (only NR);Eukaryota;Archaeplastida;Chloroplastida;Charophyta;Phragmoplastophyta;Streptophyta;Embryophyta;Tracheophyta;Spermatophyta;Magnoliophyta;Rosales;Rousselia;";"0.0";"0";"1";"1";"0";"1";"0";"457182";"391207"
"V4mis2";"SILVA (only NR);Eukaryota;Archaeplastida;Chloroplastida;Charophyta;Phragmoplastophyta;Streptophyta;Embryophyta;Tracheophyta;Spermatophyta;Magnoliophyta;Rosales;Sarcomphalus;";"0.0";"0";"1";"1";"0";"1";"0";"457182";"391207"
"V4mis2";"SILVA (only NR);Eukaryota;Archaeplastida;Chloroplastida;Charophyta;Phragmoplastophyta;Streptophyta;Embryophyta;Tracheophyta;Spermatophyta;Magnoliophyta;Rosales;Sarcopilea;";"0.0";"0";"1";"1";"0";"1";"0";"457182";"391207"
"V4mis2";"SILVA (only NR);Eukaryota;Archaeplastida;Chloroplastida;Charophyta;Phragmoplastophyta;Streptophyta;Embryophyta;Tracheophyta;Spermatophyta;Magnoliophyta;Rosales;Shepherdia;";"0.0";"0";"1";"1";"0";"1";"0";"457182";"391207"
"V4mis2";"SILVA (only NR);Eukaryota;Archaeplastida;Chloroplastida;Charophyta;Phragmoplastophyta;Streptophyta;Embryophyta;Tracheophyta;Spermatophyta;Magnoliophyta;Rosales;Spiraea;";"0.0";"0";"1";"1";"0";"1";"0";"457182";"391207"
"V4mis2";"SILVA (only NR);Eukaryota;Archaeplastida;Chloroplastida;Charophyta;Phragmoplastophyta;Streptophyta;Embryophyta;Tracheophyta;Spermatophyta;Magnoliophyta;Rosales;Ulmus;";"0.0";"0";"1";"1";"0";"1";"0";"457182";"391207"
"V4mis2";"SILVA (only NR);Eukaryota;Archaeplastida;Chloroplastida;Charophyta;Phragmoplastophyta;Streptophyta;Embryophyta;Tracheophyta;Spermatophyta;Magnoliophyta;Rosales;Urera;";"0.0";"0";"1";"1";"0";"1";"0";"457182";"391207"
"V4mis2";"SILVA (only NR);Eukaryota;Archaeplastida;Chloroplastida;Charophyta;Phragmoplastophyta;Streptophyta;Embryophyta;Tracheophyta;Spermatophyta;Magnoliophyta;Rosales;Urtica;";"0.0";"0";"1";"1";"0";"1";"0";"457182";"391207"
"V4mis2";"SILVA (only NR);Eukaryota;Archaeplastida;Chloroplastida;Charophyta;Phragmoplastophyta;Streptophyta;Embryophyta;Tracheophyta;Spermatophyta;Magnoliophyta;Rosales;Ziziphus;";"0.0";"0";"14";"14";"0";"14";"0";"457169";"391207"
"V4mis2";"SILVA (only NR);Eukaryota;Archaeplastida;Chloroplastida;Charophyta;Phragmoplastophyta;Streptophyta;Embryophyta;Tracheophyta;Spermatophyta;Magnoliophyta;Santalales;";"0.0";"0";"124";"124";"0";"124";"0";"457059";"391207"
"V4mis2";"SILVA (only NR);Eukaryota;Archaeplastida;Chloroplastida;Charophyta;Phragmoplastophyta;Streptophyta;Embryophyta;Tracheophyta;Spermatophyta;Magnoliophyta;Santalales;Actinanthella;";"0.0";"0";"1";"1";"0";"1";"0";"457182";"391207"
"V4mis2";"SILVA (only NR);Eukaryota;Archaeplastida;Chloroplastida;Charophyta;Phragmoplastophyta;Streptophyta;Embryophyta;Tracheophyta;Spermatophyta;Magnoliophyta;Santalales;Agelanthus;";"0.0";"0";"2";"2";"0";"2";"0";"457181";"391207"
"V4mis2";"SILVA (only NR);Eukaryota;Archaeplastida;Chloroplastida;Charophyta;Phragmoplastophyta;Streptophyta;Embryophyta;Tracheophyta;Spermatophyta;Magnoliophyta;Santalales;Agonandra;";"0.0";"0";"1";"1";"0";"1";"0";"457182";"391207"
"V4mis2";"SILVA (only NR);Eukaryota;Archaeplastida;Chloroplastida;Charophyta;Phragmoplastophyta;Streptophyta;Embryophyta;Tracheophyta;Spermatophyta;Magnoliophyta;Santalales;Amyema;";"0.0";"0";"1";"1";"0";"1";"0";"457182";"391207"
"V4mis2";"SILVA (only NR);Eukaryota;Archaeplastida;Chloroplastida;Charophyta;Phragmoplastophyta;Streptophyta;Embryophyta;Tracheophyta;Spermatophyta;Magnoliophyta;Santalales;Anthobolus;";"0.0";"0";"1";"1";"0";"1";"0";"457182";"391207"
"V4mis2";"SILVA (only NR);Eukaryota;Archaeplastida;Chloroplastida;Charophyta;Phragmoplastophyta;Streptophyta;Embryophyta;Tracheophyta;Spermatophyta;Magnoliophyta;Santalales;Antidaphne;";"0.0";"0";"1";"1";"0";"1";"0";"457182";"391207"
"V4mis2";"SILVA (only NR);Eukaryota;Archaeplastida;Chloroplastida;Charophyta;Phragmoplastophyta;Streptophyta;Embryophyta;Tracheophyta;Spermatophyta;Magnoliophyta;Santalales;Arceuthobium;";"0.0";"0";"3";"3";"0";"3";"0";"457180";"391207"
"V4mis2";"SILVA (only NR);Eukaryota;Archaeplastida;Chloroplastida;Charophyta;Phragmoplastophyta;Streptophyta;Embryophyta;Tracheophyta;Spermatophyta;Magnoliophyta;Santalales;Arjona;";"0.0";"0";"1";"1";"0";"1";"0";"457182";"391207"
"V4mis2";"SILVA (only NR);Eukaryota;Archaeplastida;Chloroplastida;Charophyta;Phragmoplastophyta;Streptophyta;Embryophyta;Tracheophyta;Spermatophyta;Magnoliophyta;Santalales;Balanophora;";"0.0";"0";"7";"7";"0";"7";"0";"457176";"391207"
"V4mis2";"SILVA (only NR);Eukaryota;Archaeplastida;Chloroplastida;Charophyta;Phragmoplastophyta;Streptophyta;Embryophyta;Tracheophyta;Spermatophyta;Magnoliophyta;Santalales;Benthamina;";"0.0";"0";"1";"1";"0";"1";"0";"457182";"391207"
"V4mis2";"SILVA (only NR);Eukaryota;Archaeplastida;Chloroplastida;Charophyta;Phragmoplastophyta;Streptophyta;Embryophyta;Tracheophyta;Spermatophyta;Magnoliophyta;Santalales;Berhautia;";"0.0";"0";"1";"1";"0";"1";"0";"457182";"391207"
"V4mis2";"SILVA (only NR);Eukaryota;Archaeplastida;Chloroplastida;Charophyta;Phragmoplastophyta;Streptophyta;Embryophyta;Tracheophyta;Spermatophyta;Magnoliophyta;Santalales;Cansjera;";"0.0";"0";"1";"1";"0";"1";"0";"457182";"391207"
"V4mis2";"SILVA (only NR);Eukaryota;Archaeplastida;Chloroplastida;Charophyta;Phragmoplastophyta;Streptophyta;Embryophyta;Tracheophyta;Spermatophyta;Magnoliophyta;Santalales;Cathedra;";"0.0";"0";"1";"1";"0";"1";"0";"457182";"391207"
"V4mis2";"SILVA (only NR);Eukaryota;Archaeplastida;Chloroplastida;Charophyta;Phragmoplastophyta;Streptophyta;Embryophyta;Tracheophyta;Spermatophyta;Magnoliophyta;Santalales;Cecarria;";"0.0";"0";"1";"1";"0";"1";"0";"457182";"391207"
"V4mis2";"SILVA (only NR);Eukaryota;Archaeplastida;Chloroplastida;Charophyta;Phragmoplastophyta;Streptophyta;Embryophyta;Tracheophyta;Spermatophyta;Magnoliophyta;Santalales;Chaunochiton;";"0.0";"0";"1";"1";"0";"1";"0";"457182";"391207"
"V4mis2";"SILVA (only NR);Eukaryota;Archaeplastida;Chloroplastida;Charophyta;Phragmoplastophyta;Streptophyta;Embryophyta;Tracheophyta;Spermatophyta;Magnoliophyta;Santalales;Choretrum;";"0.0";"0";"1";"1";"0";"1";"0";"457182";"391207"
"V4mis2";"SILVA (only NR);Eukaryota;Archaeplastida;Chloroplastida;Charophyta;Phragmoplastophyta;Streptophyta;Embryophyta;Tracheophyta;Spermatophyta;Magnoliophyta;Santalales;Colpoon;";"0.0";"0";"1";"1";"0";"1";"0";"457182";"391207"
"V4mis2";"SILVA (only NR);Eukaryota;Archaeplastida;Chloroplastida;Charophyta;Phragmoplastophyta;Streptophyta;Embryophyta;Tracheophyta;Spermatophyta;Magnoliophyta;Santalales;Comandra;";"0.0";"0";"1";"1";"0";"1";"0";"457182";"391207"
"V4mis2";"SILVA (only NR);Eukaryota;Archaeplastida;Chloroplastida;Charophyta;Phragmoplastophyta;Streptophyta;Embryophyta;Tracheophyta;Spermatophyta;Magnoliophyta;Santalales;Corynaea;";"0.0";"0";"1";"1";"0";"1";"0";"457182";"391207"
"V4mis2";"SILVA (only NR);Eukaryota;Archaeplastida;Chloroplastida;Charophyta;Phragmoplastophyta;Streptophyta;Embryophyta;Tracheophyta;Spermatophyta;Magnoliophyta;Santalales;Dactylanthus;";"0.0";"0";"1";"1";"0";"1";"0";"457182";"391207"
"V4mis2";"SILVA (only NR);Eukaryota;Archaeplastida;Chloroplastida;Charophyta;Phragmoplastophyta;Streptophyta;Embryophyta;Tracheophyta;Spermatophyta;Magnoliophyta;Santalales;Daenikera;";"0.0";"0";"1";"1";"0";"1";"0";"457182";"391207"
"V4mis2";"SILVA (only NR);Eukaryota;Archaeplastida;Chloroplastida;Charophyta;Phragmoplastophyta;Streptophyta;Embryophyta;Tracheophyta;Spermatophyta;Magnoliophyta;Santalales;Decaisnina;";"0.0";"0";"2";"2";"0";"2";"0";"457181";"391207"
"V4mis2";"SILVA (only NR);Eukaryota;Archaeplastida;Chloroplastida;Charophyta;Phragmoplastophyta;Streptophyta;Embryophyta;Tracheophyta;Spermatophyta;Magnoliophyta;Santalales;Dendrophthora;";"0.0";"0";"1";"1";"0";"1";"0";"457182";"391207"
"V4mis2";"SILVA (only NR);Eukaryota;Archaeplastida;Chloroplastida;Charophyta;Phragmoplastophyta;Streptophyta;Embryophyta;Tracheophyta;Spermatophyta;Magnoliophyta;Santalales;Dendrotrophe;";"0.0";"0";"1";"1";"0";"1";"0";"457182";"391207"
"V4mis2";"SILVA (only NR);Eukaryota;Archaeplastida;Chloroplastida;Charophyta;Phragmoplastophyta;Streptophyta;Embryophyta;Tracheophyta;Spermatophyta;Magnoliophyta;Santalales;Diogoa;";"0.0";"0";"1";"1";"0";"1";"0";"457182";"391207"
"V4mis2";"SILVA (only NR);Eukaryota;Archaeplastida;Chloroplastida;Charophyta;Phragmoplastophyta;Streptophyta;Embryophyta;Tracheophyta;Spermatophyta;Magnoliophyta;Santalales;Diplatia;";"0.0";"0";"1";"1";"0";"1";"0";"457182";"391207"
"V4mis2";"SILVA (only NR);Eukaryota;Archaeplastida;Chloroplastida;Charophyta;Phragmoplastophyta;Streptophyta;Embryophyta;Tracheophyta;Spermatophyta;Magnoliophyta;Santalales;Dufrenoya;";"0.0";"0";"1";"1";"0";"1";"0";"457182";"391207"
"V4mis2";"SILVA (only NR);Eukaryota;Archaeplastida;Chloroplastida;Charophyta;Phragmoplastophyta;Streptophyta;Embryophyta;Tracheophyta;Spermatophyta;Magnoliophyta;Santalales;Dulacia;";"0.0";"0";"1";"1";"0";"1";"0";"457182";"391207"
"V4mis2";"SILVA (only NR);Eukaryota;Archaeplastida;Chloroplastida;Charophyta;Phragmoplastophyta;Streptophyta;Embryophyta;Tracheophyta;Spermatophyta;Magnoliophyta;Santalales;Englerina;";"0.0";"0";"1";"1";"0";"1";"0";"457182";"391207"
"V4mis2";"SILVA (only NR);Eukaryota;Archaeplastida;Chloroplastida;Charophyta;Phragmoplastophyta;Streptophyta;Embryophyta;Tracheophyta;Spermatophyta;Magnoliophyta;Santalales;Engomegoma;";"0.0";"0";"1";"1";"0";"1";"0";"457182";"391207"
"V4mis2";"SILVA (only NR);Eukaryota;Archaeplastida;Chloroplastida;Charophyta;Phragmoplastophyta;Streptophyta;Embryophyta;Tracheophyta;Spermatophyta;Magnoliophyta;Santalales;Erianthemum;";"0.0";"0";"1";"1";"0";"1";"0";"457182";"391207"
"V4mis2";"SILVA (only NR);Eukaryota;Archaeplastida;Chloroplastida;Charophyta;Phragmoplastophyta;Streptophyta;Embryophyta;Tracheophyta;Spermatophyta;Magnoliophyta;Santalales;Erythropalum;";"0.0";"0";"1";"1";"0";"1";"0";"457182";"391207"
"V4mis2";"SILVA (only NR);Eukaryota;Archaeplastida;Chloroplastida;Charophyta;Phragmoplastophyta;Streptophyta;Embryophyta;Tracheophyta;Spermatophyta;Magnoliophyta;Santalales;Eubrachion;";"0.0";"0";"1";"1";"0";"1";"0";"457182";"391207"
"V4mis2";"SILVA (only NR);Eukaryota;Archaeplastida;Chloroplastida;Charophyta;Phragmoplastophyta;Streptophyta;Embryophyta;Tracheophyta;Spermatophyta;Magnoliophyta;Santalales;Exocarpos;";"0.0";"0";"1";"1";"0";"1";"0";"457182";"391207"
"V4mis2";"SILVA (only NR);Eukaryota;Archaeplastida;Chloroplastida;Charophyta;Phragmoplastophyta;Streptophyta;Embryophyta;Tracheophyta;Spermatophyta;Magnoliophyta;Santalales;Geocaulon;";"0.0";"0";"1";"1";"0";"1";"0";"457182";"391207"
"V4mis2";"SILVA (only NR);Eukaryota;Archaeplastida;Chloroplastida;Charophyta;Phragmoplastophyta;Streptophyta;Embryophyta;Tracheophyta;Spermatophyta;Magnoliophyta;Santalales;Ginalloa;";"0.0";"0";"1";"1";"0";"1";"0";"457182";"391207"
"V4mis2";"SILVA (only NR);Eukaryota;Archaeplastida;Chloroplastida;Charophyta;Phragmoplastophyta;Streptophyta;Embryophyta;Tracheophyta;Spermatophyta;Magnoliophyta;Santalales;Hachettea;";"0.0";"0";"1";"1";"0";"1";"0";"457182";"391207"
"V4mis2";"SILVA (only NR);Eukaryota;Archaeplastida;Chloroplastida;Charophyta;Phragmoplastophyta;Streptophyta;Embryophyta;Tracheophyta;Spermatophyta;Magnoliophyta;Santalales;Harmandia;";"0.0";"0";"1";"1";"0";"1";"0";"457182";"391207"
"V4mis2";"SILVA (only NR);Eukaryota;Archaeplastida;Chloroplastida;Charophyta;Phragmoplastophyta;Streptophyta;Embryophyta;Tracheophyta;Spermatophyta;Magnoliophyta;Santalales;Heisteria;";"0.0";"0";"1";"1";"0";"1";"0";"457182";"391207"
"V4mis2";"SILVA (only NR);Eukaryota;Archaeplastida;Chloroplastida;Charophyta;Phragmoplastophyta;Streptophyta;Embryophyta;Tracheophyta;Spermatophyta;Magnoliophyta;Santalales;Helixanthera;";"0.0";"0";"1";"1";"0";"1";"0";"457182";"391207"
"V4mis2";"SILVA (only NR);Eukaryota;Archaeplastida;Chloroplastida;Charophyta;Phragmoplastophyta;Streptophyta;Embryophyta;Tracheophyta;Spermatophyta;Magnoliophyta;Santalales;Helosis;";"0.0";"0";"1";"1";"0";"1";"0";"457182";"391207"
"V4mis2";"SILVA (only NR);Eukaryota;Archaeplastida;Chloroplastida;Charophyta;Phragmoplastophyta;Streptophyta;Embryophyta;Tracheophyta;Spermatophyta;Magnoliophyta;Santalales;Hondurodendron;";"0.0";"0";"1";"1";"0";"1";"0";"457182";"391207"
"V4mis2";"SILVA (only NR);Eukaryota;Archaeplastida;Chloroplastida;Charophyta;Phragmoplastophyta;Streptophyta;Embryophyta;Tracheophyta;Spermatophyta;Magnoliophyta;Santalales;Ileostylus;";"0.0";"0";"1";"1";"0";"1";"0";"457182";"391207"
"V4mis2";"SILVA (only NR);Eukaryota;Archaeplastida;Chloroplastida;Charophyta;Phragmoplastophyta;Streptophyta;Embryophyta;Tracheophyta;Spermatophyta;Magnoliophyta;Santalales;Jodina;";"0.0";"0";"1";"1";"0";"1";"0";"457182";"391207"
"V4mis2";"SILVA (only NR);Eukaryota;Archaeplastida;Chloroplastida;Charophyta;Phragmoplastophyta;Streptophyta;Embryophyta;Tracheophyta;Spermatophyta;Magnoliophyta;Santalales;Korthalsella;";"0.0";"0";"2";"2";"0";"2";"0";"457181";"391207"
"V4mis2";"SILVA (only NR);Eukaryota;Archaeplastida;Chloroplastida;Charophyta;Phragmoplastophyta;Streptophyta;Embryophyta;Tracheophyta;Spermatophyta;Magnoliophyta;Santalales;Kunkeliella;";"0.0";"0";"1";"1";"0";"1";"0";"457182";"391207"
"V4mis2";"SILVA (only NR);Eukaryota;Archaeplastida;Chloroplastida;Charophyta;Phragmoplastophyta;Streptophyta;Embryophyta;Tracheophyta;Spermatophyta;Magnoliophyta;Santalales;Langsdorffia;";"0.0";"0";"1";"1";"0";"1";"0";"457182";"391207"
"V4mis2";"SILVA (only NR);Eukaryota;Archaeplastida;Chloroplastida;Charophyta;Phragmoplastophyta;Streptophyta;Embryophyta;Tracheophyta;Spermatophyta;Magnoliophyta;Santalales;Lepidoceras;";"0.0";"0";"1";"1";"0";"1";"0";"457182";"391207"
"V4mis2";"SILVA (only NR);Eukaryota;Archaeplastida;Chloroplastida;Charophyta;Phragmoplastophyta;Streptophyta;Embryophyta;Tracheophyta;Spermatophyta;Magnoliophyta;Santalales;Leptomeria;";"0.0";"0";"1";"1";"0";"1";"0";"457182";"391207"
"V4mis2";"SILVA (only NR);Eukaryota;Archaeplastida;Chloroplastida;Charophyta;Phragmoplastophyta;Streptophyta;Embryophyta;Tracheophyta;Spermatophyta;Magnoliophyta;Santalales;Ligaria;";"0.0";"0";"1";"1";"0";"1";"0";"457182";"391207"
"V4mis2";"SILVA (only NR);Eukaryota;Archaeplastida;Chloroplastida;Charophyta;Phragmoplastophyta;Streptophyta;Embryophyta;Tracheophyta;Spermatophyta;Magnoliophyta;Santalales;Lophophytum;";"0.0";"0";"1";"1";"0";"1";"0";"457182";"391207"
"V4mis2";"SILVA (only NR);Eukaryota;Archaeplastida;Chloroplastida;Charophyta;Phragmoplastophyta;Streptophyta;Embryophyta;Tracheophyta;Spermatophyta;Magnoliophyta;Santalales;Loranthus;";"0.0";"0";"2";"2";"0";"2";"0";"457181";"391207"
"V4mis2";"SILVA (only NR);Eukaryota;Archaeplastida;Chloroplastida;Charophyta;Phragmoplastophyta;Streptophyta;Embryophyta;Tracheophyta;Spermatophyta;Magnoliophyta;Santalales;Loxanthera;";"0.0";"0";"1";"1";"0";"1";"0";"457182";"391207"
"V4mis2";"SILVA (only NR);Eukaryota;Archaeplastida;Chloroplastida;Charophyta;Phragmoplastophyta;Streptophyta;Embryophyta;Tracheophyta;Spermatophyta;Magnoliophyta;Santalales;Lysiana;";"0.0";"0";"1";"1";"0";"1";"0";"457182";"391207"
"V4mis2";"SILVA (only NR);Eukaryota;Archaeplastida;Chloroplastida;Charophyta;Phragmoplastophyta;Streptophyta;Embryophyta;Tracheophyta;Spermatophyta;Magnoliophyta;Santalales;Macrosolen;";"0.0";"0";"1";"1";"0";"1";"0";"457182";"391207"
"V4mis2";"SILVA (only NR);Eukaryota;Archaeplastida;Chloroplastida;Charophyta;Phragmoplastophyta;Streptophyta;Embryophyta;Tracheophyta;Spermatophyta;Magnoliophyta;Santalales;Malania;";"0.0";"0";"1";"1";"0";"1";"0";"457182";"391207"
"V4mis2";"SILVA (only NR);Eukaryota;Archaeplastida;Chloroplastida;Charophyta;Phragmoplastophyta;Streptophyta;Embryophyta;Tracheophyta;Spermatophyta;Magnoliophyta;Santalales;Mida;";"0.0";"0";"1";"1";"0";"1";"0";"457182";"391207"
"V4mis2";"SILVA (only NR);Eukaryota;Archaeplastida;Chloroplastida;Charophyta;Phragmoplastophyta;Streptophyta;Embryophyta;Tracheophyta;Spermatophyta;Magnoliophyta;Santalales;Misodendrum;";"0.0";"0";"2";"2";"0";"2";"0";"457181";"391207"
"V4mis2";"SILVA (only NR);Eukaryota;Archaeplastida;Chloroplastida;Charophyta;Phragmoplastophyta;Streptophyta;Embryophyta;Tracheophyta;Spermatophyta;Magnoliophyta;Santalales;Moquiniella;";"0.0";"0";"1";"1";"0";"1";"0";"457182";"391207"
"V4mis2";"SILVA (only NR);Eukaryota;Archaeplastida;Chloroplastida;Charophyta;Phragmoplastophyta;Streptophyta;Embryophyta;Tracheophyta;Spermatophyta;Magnoliophyta;Santalales;Myoschilos;";"0.0";"0";"1";"1";"0";"1";"0";"457182";"391207"
"V4mis2";"SILVA (only NR);Eukaryota;Archaeplastida;Chloroplastida;Charophyta;Phragmoplastophyta;Streptophyta;Embryophyta;Tracheophyta;Spermatophyta;Magnoliophyta;Santalales;Mystropetalon;";"0.0";"0";"1";"1";"0";"1";"0";"457182";"391207"
"V4mis2";"SILVA (only NR);Eukaryota;Archaeplastida;Chloroplastida;Charophyta;Phragmoplastophyta;Streptophyta;Embryophyta;Tracheophyta;Spermatophyta;Magnoliophyta;Santalales;Nestronia;";"0.0";"0";"1";"1";"0";"1";"0";"457182";"391207"
"V4mis2";"SILVA (only NR);Eukaryota;Archaeplastida;Chloroplastida;Charophyta;Phragmoplastophyta;Streptophyta;Embryophyta;Tracheophyta;Spermatophyta;Magnoliophyta;Santalales;Notanthera;";"0.0";"0";"1";"1";"0";"1";"0";"457182";"391207"
"V4mis2";"SILVA (only NR);Eukaryota;Archaeplastida;Chloroplastida;Charophyta;Phragmoplastophyta;Streptophyta;Embryophyta;Tracheophyta;Spermatophyta;Magnoliophyta;Santalales;Notothixos;";"0.0";"0";"2";"2";"0";"2";"0";"457181";"391207"
"V4mis2";"SILVA (only NR);Eukaryota;Archaeplastida;Chloroplastida;Charophyta;Phragmoplastophyta;Streptophyta;Embryophyta;Tracheophyta;Spermatophyta;Magnoliophyta;Santalales;Nuytsia;";"0.0";"0";"1";"1";"0";"1";"0";"457182";"391207"
"V4mis2";"SILVA (only NR);Eukaryota;Archaeplastida;Chloroplastida;Charophyta;Phragmoplastophyta;Streptophyta;Embryophyta;Tracheophyta;Spermatophyta;Magnoliophyta;Santalales;Olax;";"0.0";"0";"3";"3";"0";"3";"0";"457180";"391207"
"V4mis2";"SILVA (only NR);Eukaryota;Archaeplastida;Chloroplastida;Charophyta;Phragmoplastophyta;Streptophyta;Embryophyta;Tracheophyta;Spermatophyta;Magnoliophyta;Santalales;Oliverella;";"0.0";"0";"1";"1";"0";"1";"0";"457182";"391207"
"V4mis2";"SILVA (only NR);Eukaryota;Archaeplastida;Chloroplastida;Charophyta;Phragmoplastophyta;Streptophyta;Embryophyta;Tracheophyta;Spermatophyta;Magnoliophyta;Santalales;Ombrophytum;";"0.0";"0";"1";"1";"0";"1";"0";"457182";"391207"
"V4mis2";"SILVA (only NR);Eukaryota;Archaeplastida;Chloroplastida;Charophyta;Phragmoplastophyta;Streptophyta;Embryophyta;Tracheophyta;Spermatophyta;Magnoliophyta;Santalales;Omphacomeria;";"0.0";"0";"1";"1";"0";"1";"0";"457182";"391207"
"V4mis2";"SILVA (only NR);Eukaryota;Archaeplastida;Chloroplastida;Charophyta;Phragmoplastophyta;Streptophyta;Embryophyta;Tracheophyta;Spermatophyta;Magnoliophyta;Santalales;Oncella;";"0.0";"0";"1";"1";"0";"1";"0";"457182";"391207"
"V4mis2";"SILVA (only NR);Eukaryota;Archaeplastida;Chloroplastida;Charophyta;Phragmoplastophyta;Streptophyta;Embryophyta;Tracheophyta;Spermatophyta;Magnoliophyta;Santalales;Ongokea;";"0.0";"0";"1";"1";"0";"1";"0";"457182";"391207"
"V4mis2";"SILVA (only NR);Eukaryota;Archaeplastida;Chloroplastida;Charophyta;Phragmoplastophyta;Streptophyta;Embryophyta;Tracheophyta;Spermatophyta;Magnoliophyta;Santalales;Oryctanthus;";"0.0";"0";"1";"1";"0";"1";"0";"457182";"391207"
"V4mis2";"SILVA (only NR);Eukaryota;Archaeplastida;Chloroplastida;Charophyta;Phragmoplastophyta;Streptophyta;Embryophyta;Tracheophyta;Spermatophyta;Magnoliophyta;Santalales;Osyridicarpos;";"0.0";"0";"1";"1";"0";"1";"0";"457182";"391207"
"V4mis2";"SILVA (only NR);Eukaryota;Archaeplastida;Chloroplastida;Charophyta;Phragmoplastophyta;Streptophyta;Embryophyta;Tracheophyta;Spermatophyta;Magnoliophyta;Santalales;Osyris;";"0.0";"0";"2";"2";"0";"2";"0";"457181";"391207"
"V4mis2";"SILVA (only NR);Eukaryota;Archaeplastida;Chloroplastida;Charophyta;Phragmoplastophyta;Streptophyta;Embryophyta;Tracheophyta;Spermatophyta;Magnoliophyta;Santalales;Pentarhopalopilia;";"0.0";"0";"1";"1";"0";"1";"0";"457182";"391207"
"V4mis2";"SILVA (only NR);Eukaryota;Archaeplastida;Chloroplastida;Charophyta;Phragmoplastophyta;Streptophyta;Embryophyta;Tracheophyta;Spermatophyta;Magnoliophyta;Santalales;Phacellaria;";"0.0";"0";"1";"1";"0";"1";"0";"457182";"391207"
"V4mis2";"SILVA (only NR);Eukaryota;Archaeplastida;Chloroplastida;Charophyta;Phragmoplastophyta;Streptophyta;Embryophyta;Tracheophyta;Spermatophyta;Magnoliophyta;Santalales;Phoradendron;";"0.0";"0";"1";"1";"0";"1";"0";"457182";"391207"
"V4mis2";"SILVA (only NR);Eukaryota;Archaeplastida;Chloroplastida;Charophyta;Phragmoplastophyta;Streptophyta;Embryophyta;Tracheophyta;Spermatophyta;Magnoliophyta;Santalales;Phthirusa;";"0.0";"0";"1";"1";"0";"1";"0";"457182";"391207"
"V4mis2";"SILVA (only NR);Eukaryota;Archaeplastida;Chloroplastida;Charophyta;Phragmoplastophyta;Streptophyta;Embryophyta;Tracheophyta;Spermatophyta;Magnoliophyta;Santalales;Plicosepalus;";"0.0";"0";"1";"1";"0";"1";"0";"457182";"391207"
"V4mis2";"SILVA (only NR);Eukaryota;Archaeplastida;Chloroplastida;Charophyta;Phragmoplastophyta;Streptophyta;Embryophyta;Tracheophyta;Spermatophyta;Magnoliophyta;Santalales;Psittacanthus;";"0.0";"0";"1";"1";"0";"1";"0";"457182";"391207"
"V4mis2";"SILVA (only NR);Eukaryota;Archaeplastida;Chloroplastida;Charophyta;Phragmoplastophyta;Streptophyta;Embryophyta;Tracheophyta;Spermatophyta;Magnoliophyta;Santalales;Ptychopetalum;";"0.0";"0";"1";"1";"0";"1";"0";"457182";"391207"
"V4mis2";"SILVA (only NR);Eukaryota;Archaeplastida;Chloroplastida;Charophyta;Phragmoplastophyta;Streptophyta;Embryophyta;Tracheophyta;Spermatophyta;Magnoliophyta;Santalales;Quinchamalium;";"0.0";"0";"1";"1";"0";"1";"0";"457182";"391207"
"V4mis2";"SILVA (only NR);Eukaryota;Archaeplastida;Chloroplastida;Charophyta;Phragmoplastophyta;Streptophyta;Embryophyta;Tracheophyta;Spermatophyta;Magnoliophyta;Santalales;Rhoiacarpos;";"0.0";"0";"1";"1";"0";"1";"0";"457182";"391207"
"V4mis2";"SILVA (only NR);Eukaryota;Archaeplastida;Chloroplastida;Charophyta;Phragmoplastophyta;Streptophyta;Embryophyta;Tracheophyta;Spermatophyta;Magnoliophyta;Santalales;Santalum;";"0.0";"0";"1";"1";"0";"1";"0";"457182";"391207"
"V4mis2";"SILVA (only NR);Eukaryota;Archaeplastida;Chloroplastida;Charophyta;Phragmoplastophyta;Streptophyta;Embryophyta;Tracheophyta;Spermatophyta;Magnoliophyta;Santalales;Sarcophyte;";"0.0";"0";"1";"1";"0";"1";"0";"457182";"391207"
"V4mis2";"SILVA (only NR);Eukaryota;Archaeplastida;Chloroplastida;Charophyta;Phragmoplastophyta;Streptophyta;Embryophyta;Tracheophyta;Spermatophyta;Magnoliophyta;Santalales;Schoepfia;";"0.0";"0";"2";"2";"0";"2";"0";"457181";"391207"
"V4mis2";"SILVA (only NR);Eukaryota;Archaeplastida;Chloroplastida;Charophyta;Phragmoplastophyta;Streptophyta;Embryophyta;Tracheophyta;Spermatophyta;Magnoliophyta;Santalales;Scleropyrum;";"0.0";"0";"1";"1";"0";"1";"0";"457182";"391207"
"V4mis2";"SILVA (only NR);Eukaryota;Archaeplastida;Chloroplastida;Charophyta;Phragmoplastophyta;Streptophyta;Embryophyta;Tracheophyta;Spermatophyta;Magnoliophyta;Santalales;Scorodocarpus;";"0.0";"0";"1";"1";"0";"1";"0";"457182";"391207"
"V4mis2";"SILVA (only NR);Eukaryota;Archaeplastida;Chloroplastida;Charophyta;Phragmoplastophyta;Streptophyta;Embryophyta;Tracheophyta;Spermatophyta;Magnoliophyta;Santalales;Scybalium;";"0.0";"0";"1";"1";"0";"1";"0";"457182";"391207"
"V4mis2";"SILVA (only NR);Eukaryota;Archaeplastida;Chloroplastida;Charophyta;Phragmoplastophyta;Streptophyta;Embryophyta;Tracheophyta;Spermatophyta;Magnoliophyta;Santalales;Sogerianthe;";"0.0";"0";"1";"1";"0";"1";"0";"457182";"391207"
"V4mis2";"SILVA (only NR);Eukaryota;Archaeplastida;Chloroplastida;Charophyta;Phragmoplastophyta;Streptophyta;Embryophyta;Tracheophyta;Spermatophyta;Magnoliophyta;Santalales;Strombosia;";"0.0";"0";"1";"1";"0";"1";"0";"457182";"391207"
"V4mis2";"SILVA (only NR);Eukaryota;Archaeplastida;Chloroplastida;Charophyta;Phragmoplastophyta;Streptophyta;Embryophyta;Tracheophyta;Spermatophyta;Magnoliophyta;Santalales;Strombosiopsis;";"0.0";"0";"1";"1";"0";"1";"0";"457182";"391207"
"V4mis2";"SILVA (only NR);Eukaryota;Archaeplastida;Chloroplastida;Charophyta;Phragmoplastophyta;Streptophyta;Embryophyta;Tracheophyta;Spermatophyta;Magnoliophyta;Santalales;Struthanthus;";"0.0";"0";"2";"2";"0";"2";"0";"457181";"391207"
"V4mis2";"SILVA (only NR);Eukaryota;Archaeplastida;Chloroplastida;Charophyta;Phragmoplastophyta;Streptophyta;Embryophyta;Tracheophyta;Spermatophyta;Magnoliophyta;Santalales;Taxillus;";"0.0";"0";"2";"2";"0";"2";"0";"457181";"391207"
"V4mis2";"SILVA (only NR);Eukaryota;Archaeplastida;Chloroplastida;Charophyta;Phragmoplastophyta;Streptophyta;Embryophyta;Tracheophyta;Spermatophyta;Magnoliophyta;Santalales;Thesidium;";"0.0";"0";"1";"1";"0";"1";"0";"457182";"391207"
"V4mis2";"SILVA (only NR);Eukaryota;Archaeplastida;Chloroplastida;Charophyta;Phragmoplastophyta;Streptophyta;Embryophyta;Tracheophyta;Spermatophyta;Magnoliophyta;Santalales;Thesium;";"0.0";"0";"2";"2";"0";"2";"0";"457181";"391207"
"V4mis2";"SILVA (only NR);Eukaryota;Archaeplastida;Chloroplastida;Charophyta;Phragmoplastophyta;Streptophyta;Embryophyta;Tracheophyta;Spermatophyta;Magnoliophyta;Santalales;Thonningia;";"0.0";"0";"1";"1";"0";"1";"0";"457182";"391207"
"V4mis2";"SILVA (only NR);Eukaryota;Archaeplastida;Chloroplastida;Charophyta;Phragmoplastophyta;Streptophyta;Embryophyta;Tracheophyta;Spermatophyta;Magnoliophyta;Santalales;Tristerix;";"0.0";"0";"1";"1";"0";"1";"0";"457182";"391207"
"V4mis2";"SILVA (only NR);Eukaryota;Archaeplastida;Chloroplastida;Charophyta;Phragmoplastophyta;Streptophyta;Embryophyta;Tracheophyta;Spermatophyta;Magnoliophyta;Santalales;Vanwykia;";"0.0";"0";"1";"1";"0";"1";"0";"457182";"391207"
"V4mis2";"SILVA (only NR);Eukaryota;Archaeplastida;Chloroplastida;Charophyta;Phragmoplastophyta;Streptophyta;Embryophyta;Tracheophyta;Spermatophyta;Magnoliophyta;Santalales;Viscum;";"0.0";"0";"3";"3";"0";"3";"0";"457180";"391207"
"V4mis2";"SILVA (only NR);Eukaryota;Archaeplastida;Chloroplastida;Charophyta;Phragmoplastophyta;Streptophyta;Embryophyta;Tracheophyta;Spermatophyta;Magnoliophyta;Santalales;Ximenia;";"0.0";"0";"1";"1";"0";"1";"0";"457182";"391207"
"V4mis2";"SILVA (only NR);Eukaryota;Archaeplastida;Chloroplastida;Charophyta;Phragmoplastophyta;Streptophyta;Embryophyta;Tracheophyta;Spermatophyta;Magnoliophyta;Santales;";"0.0";"0";"1";"1";"0";"1";"0";"457182";"391207"
"V4mis2";"SILVA (only NR);Eukaryota;Archaeplastida;Chloroplastida;Charophyta;Phragmoplastophyta;Streptophyta;Embryophyta;Tracheophyta;Spermatophyta;Magnoliophyta;Santales;Minquartia;";"0.0";"0";"1";"1";"0";"1";"0";"457182";"391207"
"V4mis2";"SILVA (only NR);Eukaryota;Archaeplastida;Chloroplastida;Charophyta;Phragmoplastophyta;Streptophyta;Embryophyta;Tracheophyta;Spermatophyta;Magnoliophyta;Sapindales;";"2.3";"14.4";"44";"44";"1";"43";"0";"457139";"391206"
"V4mis2";"SILVA (only NR);Eukaryota;Archaeplastida;Chloroplastida;Charophyta;Phragmoplastophyta;Streptophyta;Embryophyta;Tracheophyta;Spermatophyta;Magnoliophyta;Sapindales;Anacardium;";"0.0";"0";"1";"1";"0";"1";"0";"457182";"391207"
"V4mis2";"SILVA (only NR);Eukaryota;Archaeplastida;Chloroplastida;Charophyta;Phragmoplastophyta;Streptophyta;Embryophyta;Tracheophyta;Spermatophyta;Magnoliophyta;Sapindales;Atalantia;";"0.0";"0";"1";"1";"0";"1";"0";"457182";"391207"
"V4mis2";"SILVA (only NR);Eukaryota;Archaeplastida;Chloroplastida;Charophyta;Phragmoplastophyta;Streptophyta;Embryophyta;Tracheophyta;Spermatophyta;Magnoliophyta;Sapindales;Azadirachta;";"0.0";"0";"1";"1";"0";"1";"0";"457182";"391207"
"V4mis2";"SILVA (only NR);Eukaryota;Archaeplastida;Chloroplastida;Charophyta;Phragmoplastophyta;Streptophyta;Embryophyta;Tracheophyta;Spermatophyta;Magnoliophyta;Sapindales;Biebersteinia;";"0.0";"0";"1";"1";"0";"1";"0";"457182";"391207"
"V4mis2";"SILVA (only NR);Eukaryota;Archaeplastida;Chloroplastida;Charophyta;Phragmoplastophyta;Streptophyta;Embryophyta;Tracheophyta;Spermatophyta;Magnoliophyta;Sapindales;Bursera;";"0.0";"0";"1";"1";"0";"1";"0";"457182";"391207"
"V4mis2";"SILVA (only NR);Eukaryota;Archaeplastida;Chloroplastida;Charophyta;Phragmoplastophyta;Streptophyta;Embryophyta;Tracheophyta;Spermatophyta;Magnoliophyta;Sapindales;Citrus;";"4.2";"14.4";"24";"24";"1";"23";"0";"457159";"391206"
"V4mis2";"SILVA (only NR);Eukaryota;Archaeplastida;Chloroplastida;Charophyta;Phragmoplastophyta;Streptophyta;Embryophyta;Tracheophyta;Spermatophyta;Magnoliophyta;Sapindales;Dodonaea;";"0.0";"0";"1";"1";"0";"1";"0";"457182";"391207"
"V4mis2";"SILVA (only NR);Eukaryota;Archaeplastida;Chloroplastida;Charophyta;Phragmoplastophyta;Streptophyta;Embryophyta;Tracheophyta;Spermatophyta;Magnoliophyta;Sapindales;Guarea;";"0.0";"0";"1";"1";"0";"1";"0";"457182";"391207"
"V4mis2";"SILVA (only NR);Eukaryota;Archaeplastida;Chloroplastida;Charophyta;Phragmoplastophyta;Streptophyta;Embryophyta;Tracheophyta;Spermatophyta;Magnoliophyta;Sapindales;Koelreuteria;";"0.0";"0";"2";"2";"0";"2";"0";"457181";"391207"
"V4mis2";"SILVA (only NR);Eukaryota;Archaeplastida;Chloroplastida;Charophyta;Phragmoplastophyta;Streptophyta;Embryophyta;Tracheophyta;Spermatophyta;Magnoliophyta;Sapindales;Litchi;";"0.0";"0";"1";"1";"0";"1";"0";"457182";"391207"
"V4mis2";"SILVA (only NR);Eukaryota;Archaeplastida;Chloroplastida;Charophyta;Phragmoplastophyta;Streptophyta;Embryophyta;Tracheophyta;Spermatophyta;Magnoliophyta;Sapindales;Mangifera;";"0.0";"0";"7";"7";"0";"7";"0";"457176";"391207"
"V4mis2";"SILVA (only NR);Eukaryota;Archaeplastida;Chloroplastida;Charophyta;Phragmoplastophyta;Streptophyta;Embryophyta;Tracheophyta;Spermatophyta;Magnoliophyta;Sapindales;Nitraria;";"0.0";"0";"2";"2";"0";"2";"0";"457181";"391207"
"V4mis2";"SILVA (only NR);Eukaryota;Archaeplastida;Chloroplastida;Charophyta;Phragmoplastophyta;Streptophyta;Embryophyta;Tracheophyta;Spermatophyta;Magnoliophyta;Sapindales;Xylocarpus;";"0.0";"0";"1";"1";"0";"1";"0";"457182";"391207"
"V4mis2";"SILVA (only NR);Eukaryota;Archaeplastida;Chloroplastida;Charophyta;Phragmoplastophyta;Streptophyta;Embryophyta;Tracheophyta;Spermatophyta;Magnoliophyta;Saxifragales;";"0.0";"0";"17";"17";"0";"17";"0";"457166";"391207"
"V4mis2";"SILVA (only NR);Eukaryota;Archaeplastida;Chloroplastida;Charophyta;Phragmoplastophyta;Streptophyta;Embryophyta;Tracheophyta;Spermatophyta;Magnoliophyta;Saxifragales;Chrysosplenium;";"0.0";"0";"1";"1";"0";"1";"0";"457182";"391207"
"V4mis2";"SILVA (only NR);Eukaryota;Archaeplastida;Chloroplastida;Charophyta;Phragmoplastophyta;Streptophyta;Embryophyta;Tracheophyta;Spermatophyta;Magnoliophyta;Saxifragales;Crassula;";"0.0";"0";"1";"1";"0";"1";"0";"457182";"391207"
"V4mis2";"SILVA (only NR);Eukaryota;Archaeplastida;Chloroplastida;Charophyta;Phragmoplastophyta;Streptophyta;Embryophyta;Tracheophyta;Spermatophyta;Magnoliophyta;Saxifragales;Cynomorium;";"0.0";"0";"3";"3";"0";"3";"0";"457180";"391207"
"V4mis2";"SILVA (only NR);Eukaryota;Archaeplastida;Chloroplastida;Charophyta;Phragmoplastophyta;Streptophyta;Embryophyta;Tracheophyta;Spermatophyta;Magnoliophyta;Saxifragales;Fendlera;";"0.0";"0";"1";"1";"0";"1";"0";"457182";"391207"
"V4mis2";"SILVA (only NR);Eukaryota;Archaeplastida;Chloroplastida;Charophyta;Phragmoplastophyta;Streptophyta;Embryophyta;Tracheophyta;Spermatophyta;Magnoliophyta;Saxifragales;Kalanchoe;";"0.0";"0";"1";"1";"0";"1";"0";"457182";"391207"
"V4mis2";"SILVA (only NR);Eukaryota;Archaeplastida;Chloroplastida;Charophyta;Phragmoplastophyta;Streptophyta;Embryophyta;Tracheophyta;Spermatophyta;Magnoliophyta;Saxifragales;Micranthes;";"0.0";"0";"1";"1";"0";"1";"0";"457182";"391207"
"V4mis2";"SILVA (only NR);Eukaryota;Archaeplastida;Chloroplastida;Charophyta;Phragmoplastophyta;Streptophyta;Embryophyta;Tracheophyta;Spermatophyta;Magnoliophyta;Saxifragales;Myriophyllum;";"0.0";"0";"1";"1";"0";"1";"0";"457182";"391207"
"V4mis2";"SILVA (only NR);Eukaryota;Archaeplastida;Chloroplastida;Charophyta;Phragmoplastophyta;Streptophyta;Embryophyta;Tracheophyta;Spermatophyta;Magnoliophyta;Saxifragales;Mytilaria;";"0.0";"0";"1";"1";"0";"1";"0";"457182";"391207"
"V4mis2";"SILVA (only NR);Eukaryota;Archaeplastida;Chloroplastida;Charophyta;Phragmoplastophyta;Streptophyta;Embryophyta;Tracheophyta;Spermatophyta;Magnoliophyta;Saxifragales;Paeonia;";"0.0";"0";"1";"1";"0";"1";"0";"457182";"391207"
"V4mis2";"SILVA (only NR);Eukaryota;Archaeplastida;Chloroplastida;Charophyta;Phragmoplastophyta;Streptophyta;Embryophyta;Tracheophyta;Spermatophyta;Magnoliophyta;Saxifragales;Peltoboykinia;";"0.0";"0";"1";"1";"0";"1";"0";"457182";"391207"
"V4mis2";"SILVA (only NR);Eukaryota;Archaeplastida;Chloroplastida;Charophyta;Phragmoplastophyta;Streptophyta;Embryophyta;Tracheophyta;Spermatophyta;Magnoliophyta;Saxifragales;Penthorum;";"0.0";"0";"1";"1";"0";"1";"0";"457182";"391207"
"V4mis2";"SILVA (only NR);Eukaryota;Archaeplastida;Chloroplastida;Charophyta;Phragmoplastophyta;Streptophyta;Embryophyta;Tracheophyta;Spermatophyta;Magnoliophyta;Saxifragales;Peridiscus;";"0.0";"0";"1";"1";"0";"1";"0";"457182";"391207"
"V4mis2";"SILVA (only NR);Eukaryota;Archaeplastida;Chloroplastida;Charophyta;Phragmoplastophyta;Streptophyta;Embryophyta;Tracheophyta;Spermatophyta;Magnoliophyta;Saxifragales;Ribes;";"0.0";"0";"1";"1";"0";"1";"0";"457182";"391207"
"V4mis2";"SILVA (only NR);Eukaryota;Archaeplastida;Chloroplastida;Charophyta;Phragmoplastophyta;Streptophyta;Embryophyta;Tracheophyta;Spermatophyta;Magnoliophyta;Saxifragales;Saxifraga;";"0.0";"0";"1";"1";"0";"1";"0";"457182";"391207"
"V4mis2";"SILVA (only NR);Eukaryota;Archaeplastida;Chloroplastida;Charophyta;Phragmoplastophyta;Streptophyta;Embryophyta;Tracheophyta;Spermatophyta;Magnoliophyta;Saxifragales;Tetracarpaea;";"0.0";"0";"1";"1";"0";"1";"0";"457182";"391207"
"V4mis2";"SILVA (only NR);Eukaryota;Archaeplastida;Chloroplastida;Charophyta;Phragmoplastophyta;Streptophyta;Embryophyta;Tracheophyta;Spermatophyta;Magnoliophyta;Solanales;";"1.3";"14.3";"633";"632";"8";"624";"1";"456551";"391199"
"V4mis2";"SILVA (only NR);Eukaryota;Archaeplastida;Chloroplastida;Charophyta;Phragmoplastophyta;Streptophyta;Embryophyta;Tracheophyta;Spermatophyta;Magnoliophyta;Solanales;Atropa;";"0.0";"0";"1";"1";"0";"1";"0";"457182";"391207"
"V4mis2";"SILVA (only NR);Eukaryota;Archaeplastida;Chloroplastida;Charophyta;Phragmoplastophyta;Streptophyta;Embryophyta;Tracheophyta;Spermatophyta;Magnoliophyta;Solanales;Capsicum;";"0.0";"0";"83";"83";"0";"83";"0";"457100";"391207"
"V4mis2";"SILVA (only NR);Eukaryota;Archaeplastida;Chloroplastida;Charophyta;Phragmoplastophyta;Streptophyta;Embryophyta;Tracheophyta;Spermatophyta;Magnoliophyta;Solanales;Cuscuta;";"0.0";"0";"2";"2";"0";"2";"0";"457181";"391207"
"V4mis2";"SILVA (only NR);Eukaryota;Archaeplastida;Chloroplastida;Charophyta;Phragmoplastophyta;Streptophyta;Embryophyta;Tracheophyta;Spermatophyta;Magnoliophyta;Solanales;Evolvulus;";"0.0";"0";"1";"1";"0";"1";"0";"457182";"391207"
"V4mis2";"SILVA (only NR);Eukaryota;Archaeplastida;Chloroplastida;Charophyta;Phragmoplastophyta;Streptophyta;Embryophyta;Tracheophyta;Spermatophyta;Magnoliophyta;Solanales;Hydroleaceae;";"0.0";"0";"1";"1";"0";"1";"0";"457182";"391207"
"V4mis2";"SILVA (only NR);Eukaryota;Archaeplastida;Chloroplastida;Charophyta;Phragmoplastophyta;Streptophyta;Embryophyta;Tracheophyta;Spermatophyta;Magnoliophyta;Solanales;Hydroleaceae;Hydrolea;";"0.0";"0";"1";"1";"0";"1";"0";"457182";"391207"
"V4mis2";"SILVA (only NR);Eukaryota;Archaeplastida;Chloroplastida;Charophyta;Phragmoplastophyta;Streptophyta;Embryophyta;Tracheophyta;Spermatophyta;Magnoliophyta;Solanales;Ipomoea;";"0.0";"0";"324";"323";"0";"323";"1";"456860";"391207"
"V4mis2";"SILVA (only NR);Eukaryota;Archaeplastida;Chloroplastida;Charophyta;Phragmoplastophyta;Streptophyta;Embryophyta;Tracheophyta;Spermatophyta;Magnoliophyta;Solanales;Montinia;";"0.0";"0";"2";"2";"0";"2";"0";"457181";"391207"
"V4mis2";"SILVA (only NR);Eukaryota;Archaeplastida;Chloroplastida;Charophyta;Phragmoplastophyta;Streptophyta;Embryophyta;Tracheophyta;Spermatophyta;Magnoliophyta;Solanales;Nicotiana;";"2.1";"14.4";"142";"142";"3";"139";"0";"457041";"391204"
"V4mis2";"SILVA (only NR);Eukaryota;Archaeplastida;Chloroplastida;Charophyta;Phragmoplastophyta;Streptophyta;Embryophyta;Tracheophyta;Spermatophyta;Magnoliophyta;Solanales;Petunia;";"0.0";"0";"6";"6";"0";"6";"0";"457177";"391207"
"V4mis2";"SILVA (only NR);Eukaryota;Archaeplastida;Chloroplastida;Charophyta;Phragmoplastophyta;Streptophyta;Embryophyta;Tracheophyta;Spermatophyta;Magnoliophyta;Solanales;Phacelia;";"0.0";"0";"1";"1";"0";"1";"0";"457182";"391207"
"V4mis2";"SILVA (only NR);Eukaryota;Archaeplastida;Chloroplastida;Charophyta;Phragmoplastophyta;Streptophyta;Embryophyta;Tracheophyta;Spermatophyta;Magnoliophyta;Solanales;Schizanthus;";"0.0";"0";"1";"1";"0";"1";"0";"457182";"391207"
"V4mis2";"SILVA (only NR);Eukaryota;Archaeplastida;Chloroplastida;Charophyta;Phragmoplastophyta;Streptophyta;Embryophyta;Tracheophyta;Spermatophyta;Magnoliophyta;Solanales;Solanum;";"7.9";"14.4";"63";"63";"5";"58";"0";"457120";"391202"
"V4mis2";"SILVA (only NR);Eukaryota;Archaeplastida;Chloroplastida;Charophyta;Phragmoplastophyta;Streptophyta;Embryophyta;Tracheophyta;Spermatophyta;Magnoliophyta;Solanales;Sphenoclea;";"0.0";"0";"1";"1";"0";"1";"0";"457182";"391207"
"V4mis2";"SILVA (only NR);Eukaryota;Archaeplastida;Chloroplastida;Charophyta;Phragmoplastophyta;Streptophyta;Embryophyta;Tracheophyta;Spermatophyta;Magnoliophyta;Solanales;Withania;";"0.0";"0";"5";"5";"0";"5";"0";"457178";"391207"
"V4mis2";"SILVA (only NR);Eukaryota;Archaeplastida;Chloroplastida;Charophyta;Phragmoplastophyta;Streptophyta;Embryophyta;Tracheophyta;Spermatophyta;Magnoliophyta;Trochodendrales;";"0.0";"0";"1";"1";"0";"1";"0";"457182";"391207"
"V4mis2";"SILVA (only NR);Eukaryota;Archaeplastida;Chloroplastida;Charophyta;Phragmoplastophyta;Streptophyta;Embryophyta;Tracheophyta;Spermatophyta;Magnoliophyta;Trochodendrales;Trochodendron;";"0.0";"0";"1";"1";"0";"1";"0";"457182";"391207"
"V4mis2";"SILVA (only NR);Eukaryota;Archaeplastida;Chloroplastida;Charophyta;Phragmoplastophyta;Streptophyta;Embryophyta;Tracheophyta;Spermatophyta;Magnoliophyta;Vitales;";"0.0";"0";"6";"6";"0";"6";"0";"457177";"391207"
"V4mis2";"SILVA (only NR);Eukaryota;Archaeplastida;Chloroplastida;Charophyta;Phragmoplastophyta;Streptophyta;Embryophyta;Tracheophyta;Spermatophyta;Magnoliophyta;Vitales;Leea;";"0.0";"0";"1";"1";"0";"1";"0";"457182";"391207"
"V4mis2";"SILVA (only NR);Eukaryota;Archaeplastida;Chloroplastida;Charophyta;Phragmoplastophyta;Streptophyta;Embryophyta;Tracheophyta;Spermatophyta;Magnoliophyta;Vitales;Tetrastigma;";"0.0";"0";"1";"1";"0";"1";"0";"457182";"391207"
"V4mis2";"SILVA (only NR);Eukaryota;Archaeplastida;Chloroplastida;Charophyta;Phragmoplastophyta;Streptophyta;Embryophyta;Tracheophyta;Spermatophyta;Magnoliophyta;Vitales;Vitis;";"0.0";"0";"4";"4";"0";"4";"0";"457179";"391207"
"V4mis2";"SILVA (only NR);Eukaryota;Archaeplastida;Chloroplastida;Charophyta;Phragmoplastophyta;Streptophyta;Embryophyta;Tracheophyta;Spermatophyta;Magnoliophyta;Zygophyllales;";"0.0";"0";"2";"2";"0";"2";"0";"457181";"391207"
"V4mis2";"SILVA (only NR);Eukaryota;Archaeplastida;Chloroplastida;Charophyta;Phragmoplastophyta;Streptophyta;Embryophyta;Tracheophyta;Spermatophyta;Magnoliophyta;Zygophyllales;Krameria;";"0.0";"0";"1";"1";"0";"1";"0";"457182";"391207"
"V4mis2";"SILVA (only NR);Eukaryota;Archaeplastida;Chloroplastida;Charophyta;Phragmoplastophyta;Streptophyta;Embryophyta;Tracheophyta;Spermatophyta;Magnoliophyta;Zygophyllales;Larrea;";"0.0";"0";"1";"1";"0";"1";"0";"457182";"391207"
"V4mis2";"SILVA (only NR);Eukaryota;Archaeplastida;Chloroplastida;Charophyta;Phragmoplastophyta;Streptophyta;Embryophyta;Tracheophyta;Spermatophyta;Pinophyta;";"0.3";"14.3";"686";"679";"2";"677";"7";"456504";"391205"
"V4mis2";"SILVA (only NR);Eukaryota;Archaeplastida;Chloroplastida;Charophyta;Phragmoplastophyta;Streptophyta;Embryophyta;Tracheophyta;Spermatophyta;Pinophyta;Araucariales;";"0.0";"0";"19";"18";"0";"18";"1";"457165";"391207"
"V4mis2";"SILVA (only NR);Eukaryota;Archaeplastida;Chloroplastida;Charophyta;Phragmoplastophyta;Streptophyta;Embryophyta;Tracheophyta;Spermatophyta;Pinophyta;Araucariales;Afrocarpus;";"0.0";"0";"1";"1";"0";"1";"0";"457182";"391207"
"V4mis2";"SILVA (only NR);Eukaryota;Archaeplastida;Chloroplastida;Charophyta;Phragmoplastophyta;Streptophyta;Embryophyta;Tracheophyta;Spermatophyta;Pinophyta;Araucariales;Agathis;";"0.0";"0";"1";"1";"0";"1";"0";"457182";"391207"
"V4mis2";"SILVA (only NR);Eukaryota;Archaeplastida;Chloroplastida;Charophyta;Phragmoplastophyta;Streptophyta;Embryophyta;Tracheophyta;Spermatophyta;Pinophyta;Araucariales;Araucaria;";"0.0";"0";"6";"5";"0";"5";"1";"457178";"391207"
"V4mis2";"SILVA (only NR);Eukaryota;Archaeplastida;Chloroplastida;Charophyta;Phragmoplastophyta;Streptophyta;Embryophyta;Tracheophyta;Spermatophyta;Pinophyta;Araucariales;Dacrydium;";"0.0";"0";"1";"1";"0";"1";"0";"457182";"391207"
"V4mis2";"SILVA (only NR);Eukaryota;Archaeplastida;Chloroplastida;Charophyta;Phragmoplastophyta;Streptophyta;Embryophyta;Tracheophyta;Spermatophyta;Pinophyta;Araucariales;Halocarpus;";"0.0";"0";"1";"1";"0";"1";"0";"457182";"391207"
"V4mis2";"SILVA (only NR);Eukaryota;Archaeplastida;Chloroplastida;Charophyta;Phragmoplastophyta;Streptophyta;Embryophyta;Tracheophyta;Spermatophyta;Pinophyta;Araucariales;Lagarostrobos;";"0.0";"0";"1";"1";"0";"1";"0";"457182";"391207"
"V4mis2";"SILVA (only NR);Eukaryota;Archaeplastida;Chloroplastida;Charophyta;Phragmoplastophyta;Streptophyta;Embryophyta;Tracheophyta;Spermatophyta;Pinophyta;Araucariales;Manoao;";"0.0";"0";"1";"1";"0";"1";"0";"457182";"391207"
"V4mis2";"SILVA (only NR);Eukaryota;Archaeplastida;Chloroplastida;Charophyta;Phragmoplastophyta;Streptophyta;Embryophyta;Tracheophyta;Spermatophyta;Pinophyta;Araucariales;Microcachrys;";"0.0";"0";"1";"1";"0";"1";"0";"457182";"391207"
"V4mis2";"SILVA (only NR);Eukaryota;Archaeplastida;Chloroplastida;Charophyta;Phragmoplastophyta;Streptophyta;Embryophyta;Tracheophyta;Spermatophyta;Pinophyta;Araucariales;Parasitaxus;";"0.0";"0";"1";"1";"0";"1";"0";"457182";"391207"
"V4mis2";"SILVA (only NR);Eukaryota;Archaeplastida;Chloroplastida;Charophyta;Phragmoplastophyta;Streptophyta;Embryophyta;Tracheophyta;Spermatophyta;Pinophyta;Araucariales;Pherosphaera;";"0.0";"0";"1";"1";"0";"1";"0";"457182";"391207"
"V4mis2";"SILVA (only NR);Eukaryota;Archaeplastida;Chloroplastida;Charophyta;Phragmoplastophyta;Streptophyta;Embryophyta;Tracheophyta;Spermatophyta;Pinophyta;Araucariales;Phyllocladus;";"0.0";"0";"1";"1";"0";"1";"0";"457182";"391207"
"V4mis2";"SILVA (only NR);Eukaryota;Archaeplastida;Chloroplastida;Charophyta;Phragmoplastophyta;Streptophyta;Embryophyta;Tracheophyta;Spermatophyta;Pinophyta;Araucariales;Podocarpus;";"0.0";"0";"1";"1";"0";"1";"0";"457182";"391207"
"V4mis2";"SILVA (only NR);Eukaryota;Archaeplastida;Chloroplastida;Charophyta;Phragmoplastophyta;Streptophyta;Embryophyta;Tracheophyta;Spermatophyta;Pinophyta;Araucariales;Prumnopitys;";"0.0";"0";"1";"1";"0";"1";"0";"457182";"391207"
"V4mis2";"SILVA (only NR);Eukaryota;Archaeplastida;Chloroplastida;Charophyta;Phragmoplastophyta;Streptophyta;Embryophyta;Tracheophyta;Spermatophyta;Pinophyta;Araucariales;Saxegothaea;";"0.0";"0";"1";"1";"0";"1";"0";"457182";"391207"
"V4mis2";"SILVA (only NR);Eukaryota;Archaeplastida;Chloroplastida;Charophyta;Phragmoplastophyta;Streptophyta;Embryophyta;Tracheophyta;Spermatophyta;Pinophyta;Cupressales;";"0.0";"0";"23";"23";"0";"23";"0";"457160";"391207"
"V4mis2";"SILVA (only NR);Eukaryota;Archaeplastida;Chloroplastida;Charophyta;Phragmoplastophyta;Streptophyta;Embryophyta;Tracheophyta;Spermatophyta;Pinophyta;Cupressales;Actinostrobus;";"0.0";"0";"1";"1";"0";"1";"0";"457182";"391207"
"V4mis2";"SILVA (only NR);Eukaryota;Archaeplastida;Chloroplastida;Charophyta;Phragmoplastophyta;Streptophyta;Embryophyta;Tracheophyta;Spermatophyta;Pinophyta;Cupressales;Amentotaxus;";"0.0";"0";"1";"1";"0";"1";"0";"457182";"391207"
"V4mis2";"SILVA (only NR);Eukaryota;Archaeplastida;Chloroplastida;Charophyta;Phragmoplastophyta;Streptophyta;Embryophyta;Tracheophyta;Spermatophyta;Pinophyta;Cupressales;Austrocedrus;";"0.0";"0";"1";"1";"0";"1";"0";"457182";"391207"
"V4mis2";"SILVA (only NR);Eukaryota;Archaeplastida;Chloroplastida;Charophyta;Phragmoplastophyta;Streptophyta;Embryophyta;Tracheophyta;Spermatophyta;Pinophyta;Cupressales;Austrotaxus;";"0.0";"0";"1";"1";"0";"1";"0";"457182";"391207"
"V4mis2";"SILVA (only NR);Eukaryota;Archaeplastida;Chloroplastida;Charophyta;Phragmoplastophyta;Streptophyta;Embryophyta;Tracheophyta;Spermatophyta;Pinophyta;Cupressales;Callitropsis;";"0.0";"0";"1";"1";"0";"1";"0";"457182";"391207"
"V4mis2";"SILVA (only NR);Eukaryota;Archaeplastida;Chloroplastida;Charophyta;Phragmoplastophyta;Streptophyta;Embryophyta;Tracheophyta;Spermatophyta;Pinophyta;Cupressales;Calocedrus;";"0.0";"0";"1";"1";"0";"1";"0";"457182";"391207"
"V4mis2";"SILVA (only NR);Eukaryota;Archaeplastida;Chloroplastida;Charophyta;Phragmoplastophyta;Streptophyta;Embryophyta;Tracheophyta;Spermatophyta;Pinophyta;Cupressales;Chamaecyparis;";"0.0";"0";"2";"2";"0";"2";"0";"457181";"391207"
"V4mis2";"SILVA (only NR);Eukaryota;Archaeplastida;Chloroplastida;Charophyta;Phragmoplastophyta;Streptophyta;Embryophyta;Tracheophyta;Spermatophyta;Pinophyta;Cupressales;Cunninghamia;";"0.0";"0";"1";"1";"0";"1";"0";"457182";"391207"
"V4mis2";"SILVA (only NR);Eukaryota;Archaeplastida;Chloroplastida;Charophyta;Phragmoplastophyta;Streptophyta;Embryophyta;Tracheophyta;Spermatophyta;Pinophyta;Cupressales;Cupressus;";"0.0";"0";"1";"1";"0";"1";"0";"457182";"391207"
"V4mis2";"SILVA (only NR);Eukaryota;Archaeplastida;Chloroplastida;Charophyta;Phragmoplastophyta;Streptophyta;Embryophyta;Tracheophyta;Spermatophyta;Pinophyta;Cupressales;Hesperocyparis;";"0.0";"0";"1";"1";"0";"1";"0";"457182";"391207"
"V4mis2";"SILVA (only NR);Eukaryota;Archaeplastida;Chloroplastida;Charophyta;Phragmoplastophyta;Streptophyta;Embryophyta;Tracheophyta;Spermatophyta;Pinophyta;Cupressales;Juniperus;";"0.0";"0";"2";"2";"0";"2";"0";"457181";"391207"
"V4mis2";"SILVA (only NR);Eukaryota;Archaeplastida;Chloroplastida;Charophyta;Phragmoplastophyta;Streptophyta;Embryophyta;Tracheophyta;Spermatophyta;Pinophyta;Cupressales;Metasequoia;";"0.0";"0";"1";"1";"0";"1";"0";"457182";"391207"
"V4mis2";"SILVA (only NR);Eukaryota;Archaeplastida;Chloroplastida;Charophyta;Phragmoplastophyta;Streptophyta;Embryophyta;Tracheophyta;Spermatophyta;Pinophyta;Cupressales;Sciadopitys;";"0.0";"0";"1";"1";"0";"1";"0";"457182";"391207"
"V4mis2";"SILVA (only NR);Eukaryota;Archaeplastida;Chloroplastida;Charophyta;Phragmoplastophyta;Streptophyta;Embryophyta;Tracheophyta;Spermatophyta;Pinophyta;Cupressales;Sequoia;";"0.0";"0";"1";"1";"0";"1";"0";"457182";"391207"
"V4mis2";"SILVA (only NR);Eukaryota;Archaeplastida;Chloroplastida;Charophyta;Phragmoplastophyta;Streptophyta;Embryophyta;Tracheophyta;Spermatophyta;Pinophyta;Cupressales;Taiwania;";"0.0";"0";"1";"1";"0";"1";"0";"457182";"391207"
"V4mis2";"SILVA (only NR);Eukaryota;Archaeplastida;Chloroplastida;Charophyta;Phragmoplastophyta;Streptophyta;Embryophyta;Tracheophyta;Spermatophyta;Pinophyta;Cupressales;Taxus;";"0.0";"0";"6";"6";"0";"6";"0";"457177";"391207"
"V4mis2";"SILVA (only NR);Eukaryota;Archaeplastida;Chloroplastida;Charophyta;Phragmoplastophyta;Streptophyta;Embryophyta;Tracheophyta;Spermatophyta;Pinophyta;Pinales;";"0.0";"0";"634";"628";"0";"628";"6";"456555";"391207"
"V4mis2";"SILVA (only NR);Eukaryota;Archaeplastida;Chloroplastida;Charophyta;Phragmoplastophyta;Streptophyta;Embryophyta;Tracheophyta;Spermatophyta;Pinophyta;Pinales;Abies;";"0.0";"0";"1";"1";"0";"1";"0";"457182";"391207"
"V4mis2";"SILVA (only NR);Eukaryota;Archaeplastida;Chloroplastida;Charophyta;Phragmoplastophyta;Streptophyta;Embryophyta;Tracheophyta;Spermatophyta;Pinophyta;Pinales;Cathaya;";"0.0";"0";"1";"1";"0";"1";"0";"457182";"391207"
"V4mis2";"SILVA (only NR);Eukaryota;Archaeplastida;Chloroplastida;Charophyta;Phragmoplastophyta;Streptophyta;Embryophyta;Tracheophyta;Spermatophyta;Pinophyta;Pinales;Cedrus;";"0.0";"0";"2";"2";"0";"2";"0";"457181";"391207"
"V4mis2";"SILVA (only NR);Eukaryota;Archaeplastida;Chloroplastida;Charophyta;Phragmoplastophyta;Streptophyta;Embryophyta;Tracheophyta;Spermatophyta;Pinophyta;Pinales;Nothotsuga;";"0.0";"0";"2";"2";"0";"2";"0";"457181";"391207"
"V4mis2";"SILVA (only NR);Eukaryota;Archaeplastida;Chloroplastida;Charophyta;Phragmoplastophyta;Streptophyta;Embryophyta;Tracheophyta;Spermatophyta;Pinophyta;Pinales;Picea;";"0.0";"0";"79";"79";"0";"79";"0";"457104";"391207"
"V4mis2";"SILVA (only NR);Eukaryota;Archaeplastida;Chloroplastida;Charophyta;Phragmoplastophyta;Streptophyta;Embryophyta;Tracheophyta;Spermatophyta;Pinophyta;Pinales;Pinus;";"0.0";"0";"548";"542";"0";"542";"6";"456641";"391207"
"V4mis2";"SILVA (only NR);Eukaryota;Archaeplastida;Chloroplastida;Charophyta;Phragmoplastophyta;Streptophyta;Embryophyta;Tracheophyta;Spermatophyta;Pinophyta;Pinales;Pseudolarix;";"0.0";"0";"1";"1";"0";"1";"0";"457182";"391207"
"V4mis2";"SILVA (only NR);Eukaryota;Archaeplastida;Chloroplastida;Charophyta;Phragmoplastophyta;Streptophyta;Embryophyta;uncultured;";"40.0";"14.4";"5";"5";"2";"3";"0";"457178";"391205"
"V4mis2";"SILVA (only NR);Eukaryota;Archaeplastida;Chloroplastida;Charophyta;Phragmoplastophyta;Zygnematophyceae;";"14.1";"14.4";"170";"170";"24";"146";"0";"457013";"391183"
"V4mis2";"SILVA (only NR);Eukaryota;Archaeplastida;Chloroplastida;Charophyta;Phragmoplastophyta;Zygnematophyceae;Desmidiales;";"0.0";"0";"107";"107";"0";"107";"0";"457076";"391207"
"V4mis2";"SILVA (only NR);Eukaryota;Archaeplastida;Chloroplastida;Charophyta;Phragmoplastophyta;Zygnematophyceae;Desmidiales;Actinotaenium;";"0.0";"0";"5";"5";"0";"5";"0";"457178";"391207"
"V4mis2";"SILVA (only NR);Eukaryota;Archaeplastida;Chloroplastida;Charophyta;Phragmoplastophyta;Zygnematophyceae;Desmidiales;Closterium;";"0.0";"0";"15";"15";"0";"15";"0";"457168";"391207"
"V4mis2";"SILVA (only NR);Eukaryota;Archaeplastida;Chloroplastida;Charophyta;Phragmoplastophyta;Zygnematophyceae;Desmidiales;Cosmarium;";"0.0";"0";"29";"29";"0";"29";"0";"457154";"391207"
"V4mis2";"SILVA (only NR);Eukaryota;Archaeplastida;Chloroplastida;Charophyta;Phragmoplastophyta;Zygnematophyceae;Desmidiales;Cosmocladium;";"0.0";"0";"1";"1";"0";"1";"0";"457182";"391207"
"V4mis2";"SILVA (only NR);Eukaryota;Archaeplastida;Chloroplastida;Charophyta;Phragmoplastophyta;Zygnematophyceae;Desmidiales;Desmidium;";"0.0";"0";"1";"1";"0";"1";"0";"457182";"391207"
"V4mis2";"SILVA (only NR);Eukaryota;Archaeplastida;Chloroplastida;Charophyta;Phragmoplastophyta;Zygnematophyceae;Desmidiales;Euastrum;";"0.0";"0";"6";"6";"0";"6";"0";"457177";"391207"
"V4mis2";"SILVA (only NR);Eukaryota;Archaeplastida;Chloroplastida;Charophyta;Phragmoplastophyta;Zygnematophyceae;Desmidiales;Genicularia;";"0.0";"0";"1";"1";"0";"1";"0";"457182";"391207"
"V4mis2";"SILVA (only NR);Eukaryota;Archaeplastida;Chloroplastida;Charophyta;Phragmoplastophyta;Zygnematophyceae;Desmidiales;Gonatozygon;";"0.0";"0";"5";"5";"0";"5";"0";"457178";"391207"
"V4mis2";"SILVA (only NR);Eukaryota;Archaeplastida;Chloroplastida;Charophyta;Phragmoplastophyta;Zygnematophyceae;Desmidiales;Groenbladia;";"0.0";"0";"1";"1";"0";"1";"0";"457182";"391207"
"V4mis2";"SILVA (only NR);Eukaryota;Archaeplastida;Chloroplastida;Charophyta;Phragmoplastophyta;Zygnematophyceae;Desmidiales;Haplotaenium;";"0.0";"0";"1";"1";"0";"1";"0";"457182";"391207"
"V4mis2";"SILVA (only NR);Eukaryota;Archaeplastida;Chloroplastida;Charophyta;Phragmoplastophyta;Zygnematophyceae;Desmidiales;Hyalotheca;";"0.0";"0";"3";"3";"0";"3";"0";"457180";"391207"
"V4mis2";"SILVA (only NR);Eukaryota;Archaeplastida;Chloroplastida;Charophyta;Phragmoplastophyta;Zygnematophyceae;Desmidiales;Micrasterias;";"0.0";"0";"11";"11";"0";"11";"0";"457172";"391207"
"V4mis2";"SILVA (only NR);Eukaryota;Archaeplastida;Chloroplastida;Charophyta;Phragmoplastophyta;Zygnematophyceae;Desmidiales;Penium;";"0.0";"0";"6";"6";"0";"6";"0";"457177";"391207"
"V4mis2";"SILVA (only NR);Eukaryota;Archaeplastida;Chloroplastida;Charophyta;Phragmoplastophyta;Zygnematophyceae;Desmidiales;Phymatodocis;";"0.0";"0";"1";"1";"0";"1";"0";"457182";"391207"
"V4mis2";"SILVA (only NR);Eukaryota;Archaeplastida;Chloroplastida;Charophyta;Phragmoplastophyta;Zygnematophyceae;Desmidiales;Pleurotaenium;";"0.0";"0";"1";"1";"0";"1";"0";"457182";"391207"
"V4mis2";"SILVA (only NR);Eukaryota;Archaeplastida;Chloroplastida;Charophyta;Phragmoplastophyta;Zygnematophyceae;Desmidiales;Sphaerozosma;";"0.0";"0";"1";"1";"0";"1";"0";"457182";"391207"
"V4mis2";"SILVA (only NR);Eukaryota;Archaeplastida;Chloroplastida;Charophyta;Phragmoplastophyta;Zygnematophyceae;Desmidiales;Spinoclosterium;";"0.0";"0";"1";"1";"0";"1";"0";"457182";"391207"
"V4mis2";"SILVA (only NR);Eukaryota;Archaeplastida;Chloroplastida;Charophyta;Phragmoplastophyta;Zygnematophyceae;Desmidiales;Spondylosium;";"0.0";"0";"3";"3";"0";"3";"0";"457180";"391207"
"V4mis2";"SILVA (only NR);Eukaryota;Archaeplastida;Chloroplastida;Charophyta;Phragmoplastophyta;Zygnematophyceae;Desmidiales;Staurastrum;";"0.0";"0";"6";"6";"0";"6";"0";"457177";"391207"
"V4mis2";"SILVA (only NR);Eukaryota;Archaeplastida;Chloroplastida;Charophyta;Phragmoplastophyta;Zygnematophyceae;Desmidiales;Staurodesmus;";"0.0";"0";"7";"7";"0";"7";"0";"457176";"391207"
"V4mis2";"SILVA (only NR);Eukaryota;Archaeplastida;Chloroplastida;Charophyta;Phragmoplastophyta;Zygnematophyceae;Desmidiales;Tetmemorus;";"0.0";"0";"1";"1";"0";"1";"0";"457182";"391207"
"V4mis2";"SILVA (only NR);Eukaryota;Archaeplastida;Chloroplastida;Charophyta;Phragmoplastophyta;Zygnematophyceae;Desmidiales;Xanthidium;";"0.0";"0";"1";"1";"0";"1";"0";"457182";"391207"
"V4mis2";"SILVA (only NR);Eukaryota;Archaeplastida;Chloroplastida;Charophyta;Phragmoplastophyta;Zygnematophyceae;Mesotaeniaceae;";"0.0";"0";"1";"1";"0";"1";"0";"457182";"391207"
"V4mis2";"SILVA (only NR);Eukaryota;Archaeplastida;Chloroplastida;Charophyta;Phragmoplastophyta;Zygnematophyceae;Zygnematales;";"42.9";"14.4";"56";"56";"24";"32";"0";"457127";"391183"
"V4mis2";"SILVA (only NR);Eukaryota;Archaeplastida;Chloroplastida;Charophyta;Phragmoplastophyta;Zygnematophyceae;Zygnematales;Ancylonema;";"0.0";"0";"1";"1";"0";"1";"0";"457182";"391207"
"V4mis2";"SILVA (only NR);Eukaryota;Archaeplastida;Chloroplastida;Charophyta;Phragmoplastophyta;Zygnematophyceae;Zygnematales;Cylindrocystis;";"0.0";"0";"5";"5";"0";"5";"0";"457178";"391207"
"V4mis2";"SILVA (only NR);Eukaryota;Archaeplastida;Chloroplastida;Charophyta;Phragmoplastophyta;Zygnematophyceae;Zygnematales;Fottea;";"0.0";"0";"1";"1";"0";"1";"0";"457182";"391207"
"V4mis2";"SILVA (only NR);Eukaryota;Archaeplastida;Chloroplastida;Charophyta;Phragmoplastophyta;Zygnematophyceae;Zygnematales;Mesotaenium;";"0.0";"0";"5";"5";"0";"5";"0";"457178";"391207"
"V4mis2";"SILVA (only NR);Eukaryota;Archaeplastida;Chloroplastida;Charophyta;Phragmoplastophyta;Zygnematophyceae;Zygnematales;Mougeotia;";"0.0";"0";"2";"2";"0";"2";"0";"457181";"391207"
"V4mis2";"SILVA (only NR);Eukaryota;Archaeplastida;Chloroplastida;Charophyta;Phragmoplastophyta;Zygnematophyceae;Zygnematales;Netrium;";"0.0";"0";"3";"3";"0";"3";"0";"457180";"391207"
"V4mis2";"SILVA (only NR);Eukaryota;Archaeplastida;Chloroplastida;Charophyta;Phragmoplastophyta;Zygnematophyceae;Zygnematales;Nucleotaenium;";"0.0";"0";"2";"2";"0";"2";"0";"457181";"391207"
"V4mis2";"SILVA (only NR);Eukaryota;Archaeplastida;Chloroplastida;Charophyta;Phragmoplastophyta;Zygnematophyceae;Zygnematales;Planotaenium;";"0.0";"0";"2";"2";"0";"2";"0";"457181";"391207"
"V4mis2";"SILVA (only NR);Eukaryota;Archaeplastida;Chloroplastida;Charophyta;Phragmoplastophyta;Zygnematophyceae;Zygnematales;Roya;";"0.0";"0";"1";"1";"0";"1";"0";"457182";"391207"
"V4mis2";"SILVA (only NR);Eukaryota;Archaeplastida;Chloroplastida;Charophyta;Phragmoplastophyta;Zygnematophyceae;Zygnematales;Sirogonium;";"100.0";"14.4";"1";"1";"1";"0";"0";"457182";"391206"
"V4mis2";"SILVA (only NR);Eukaryota;Archaeplastida;Chloroplastida;Charophyta;Phragmoplastophyta;Zygnematophyceae;Zygnematales;Spirogyra;";"95.8";"14.4";"24";"24";"23";"1";"0";"457159";"391184"
"V4mis2";"SILVA (only NR);Eukaryota;Archaeplastida;Chloroplastida;Charophyta;Phragmoplastophyta;Zygnematophyceae;Zygnematales;Spirotaenia;";"0.0";"0";"1";"1";"0";"1";"0";"457182";"391207"
"V4mis2";"SILVA (only NR);Eukaryota;Archaeplastida;Chloroplastida;Charophyta;Phragmoplastophyta;Zygnematophyceae;Zygnematales;Tortitaenia;";"0.0";"0";"2";"2";"0";"2";"0";"457181";"391207"
"V4mis2";"SILVA (only NR);Eukaryota;Archaeplastida;Chloroplastida;Charophyta;Phragmoplastophyta;Zygnematophyceae;Zygnematales;Zygnema;";"0.0";"0";"4";"4";"0";"4";"0";"457179";"391207"
"V4mis2";"SILVA (only NR);Eukaryota;Archaeplastida;Chloroplastida;Charophyta;Phragmoplastophyta;Zygnematophyceae;Zygnematales;Zygnemopsis;";"0.0";"0";"1";"1";"0";"1";"0";"457182";"391207"
"V4mis2";"SILVA (only NR);Eukaryota;Archaeplastida;Chloroplastida;Charophyta;Phragmoplastophyta;Zygnematophyceae;Zygnematales;Zygogonium;";"0.0";"0";"1";"1";"0";"1";"0";"457182";"391207"
"V4mis2";"SILVA (only NR);Eukaryota;Archaeplastida;Chloroplastida;Chlorophyta;";"56.5";"14.3";"1908";"1874";"1059";"815";"34";"455309";"390148"
"V4mis2";"SILVA (only NR);Eukaryota;Archaeplastida;Chloroplastida;Chlorophyta;Chlorodendrophyceae;";"0.0";"0";"28";"28";"0";"28";"0";"457155";"391207"
"V4mis2";"SILVA (only NR);Eukaryota;Archaeplastida;Chloroplastida;Chlorophyta;Chlorodendrophyceae;Chlorodendrales;";"0.0";"0";"26";"26";"0";"26";"0";"457157";"391207"
"V4mis2";"SILVA (only NR);Eukaryota;Archaeplastida;Chloroplastida;Chlorophyta;Chlorodendrophyceae;Chlorodendrales;Scherffelia;";"0.0";"0";"1";"1";"0";"1";"0";"457182";"391207"
"V4mis2";"SILVA (only NR);Eukaryota;Archaeplastida;Chloroplastida;Chlorophyta;Chlorodendrophyceae;Chlorodendrales;Tetraselmis;";"0.0";"0";"25";"25";"0";"25";"0";"457158";"391207"
"V4mis2";"SILVA (only NR);Eukaryota;Archaeplastida;Chloroplastida;Chlorophyta;Chlorophyceae;";"92.2";"14.4";"783";"781";"720";"61";"2";"456402";"390487"
"V4mis2";"SILVA (only NR);Eukaryota;Archaeplastida;Chloroplastida;Chlorophyta;Chlorophyceae;Chaetopeltidales;";"100.0";"14.4";"5";"5";"5";"0";"0";"457178";"391202"
"V4mis2";"SILVA (only NR);Eukaryota;Archaeplastida;Chloroplastida;Chlorophyta;Chlorophyceae;Chaetopeltidales;Chaetopeltis;";"100.0";"14.4";"1";"1";"1";"0";"0";"457182";"391206"
"V4mis2";"SILVA (only NR);Eukaryota;Archaeplastida;Chloroplastida;Chlorophyta;Chlorophyceae;Chaetopeltidales;Dicranochaete;";"100.0";"14.4";"1";"1";"1";"0";"0";"457182";"391206"
"V4mis2";"SILVA (only NR);Eukaryota;Archaeplastida;Chloroplastida;Chlorophyta;Chlorophyceae;Chaetopeltidales;Floydiella;";"100.0";"14.4";"1";"1";"1";"0";"0";"457182";"391206"
"V4mis2";"SILVA (only NR);Eukaryota;Archaeplastida;Chloroplastida;Chlorophyta;Chlorophyceae;Chaetopeltidales;Hormotilopsis;";"100.0";"14.4";"1";"1";"1";"0";"0";"457182";"391206"
"V4mis2";"SILVA (only NR);Eukaryota;Archaeplastida;Chloroplastida;Chlorophyta;Chlorophyceae;Chaetopeltidales;Koshicola;";"100.0";"14.4";"1";"1";"1";"0";"0";"457182";"391206"
"V4mis2";"SILVA (only NR);Eukaryota;Archaeplastida;Chloroplastida;Chlorophyta;Chlorophyceae;Chaetophorales;";"100.0";"14.4";"13";"13";"13";"0";"0";"457170";"391194"
"V4mis2";"SILVA (only NR);Eukaryota;Archaeplastida;Chloroplastida;Chlorophyta;Chlorophyceae;Chaetophorales;Aphanochaete;";"100.0";"14.4";"4";"4";"4";"0";"0";"457179";"391203"
"V4mis2";"SILVA (only NR);Eukaryota;Archaeplastida;Chloroplastida;Chlorophyta;Chlorophyceae;Chaetophorales;Barranca;";"100.0";"14.4";"1";"1";"1";"0";"0";"457182";"391206"
"V4mis2";"SILVA (only NR);Eukaryota;Archaeplastida;Chloroplastida;Chlorophyta;Chlorophyceae;Chaetophorales;Chaetophora;";"100.0";"14.4";"3";"3";"3";"0";"0";"457180";"391204"
"V4mis2";"SILVA (only NR);Eukaryota;Archaeplastida;Chloroplastida;Chlorophyta;Chlorophyceae;Chaetophorales;Gloeococcus;";"100.0";"14.4";"1";"1";"1";"0";"0";"457182";"391206"
"V4mis2";"SILVA (only NR);Eukaryota;Archaeplastida;Chloroplastida;Chlorophyta;Chlorophyceae;Chaetophorales;Schizomeris;";"100.0";"14.4";"1";"1";"1";"0";"0";"457182";"391206"
"V4mis2";"SILVA (only NR);Eukaryota;Archaeplastida;Chloroplastida;Chlorophyta;Chlorophyceae;Chaetophorales;Stigeoclonium;";"100.0";"14.4";"3";"3";"3";"0";"0";"457180";"391204"
"V4mis2";"SILVA (only NR);Eukaryota;Archaeplastida;Chloroplastida;Chlorophyta;Chlorophyceae;Chlamydomonadales;";"94.5";"14.4";"275";"275";"260";"15";"0";"456908";"390947"
"V4mis2";"SILVA (only NR);Eukaryota;Archaeplastida;Chloroplastida;Chlorophyta;Chlorophyceae;Chlamydomonadales;Actinochloris;";"100.0";"14.4";"2";"2";"2";"0";"0";"457181";"391205"
"V4mis2";"SILVA (only NR);Eukaryota;Archaeplastida;Chloroplastida;Chlorophyta;Chlorophyceae;Chlamydomonadales;Ascochloris;";"100.0";"14.4";"1";"1";"1";"0";"0";"457182";"391206"
"V4mis2";"SILVA (only NR);Eukaryota;Archaeplastida;Chloroplastida;Chlorophyta;Chlorophyceae;Chlamydomonadales;Asteromonas;";"100.0";"14.4";"1";"1";"1";"0";"0";"457182";"391206"
"V4mis2";"SILVA (only NR);Eukaryota;Archaeplastida;Chloroplastida;Chlorophyta;Chlorophyceae;Chlamydomonadales;Astrephomene;";"100.0";"14.4";"2";"2";"2";"0";"0";"457181";"391205"
"V4mis2";"SILVA (only NR);Eukaryota;Archaeplastida;Chloroplastida;Chlorophyta;Chlorophyceae;Chlamydomonadales;Axilosphaera;";"100.0";"14.4";"1";"1";"1";"0";"0";"457182";"391206"
"V4mis2";"SILVA (only NR);Eukaryota;Archaeplastida;Chloroplastida;Chlorophyta;Chlorophyceae;Chlamydomonadales;Basichlamys;";"100.0";"14.4";"1";"1";"1";"0";"0";"457182";"391206"
"V4mis2";"SILVA (only NR);Eukaryota;Archaeplastida;Chloroplastida;Chlorophyta;Chlorophyceae;Chlamydomonadales;Brachiomonas;";"100.0";"14.4";"1";"1";"1";"0";"0";"457182";"391206"
"V4mis2";"SILVA (only NR);Eukaryota;Archaeplastida;Chloroplastida;Chlorophyta;Chlorophyceae;Chlamydomonadales;Cephalomonas;";"100.0";"14.4";"1";"1";"1";"0";"0";"457182";"391206"
"V4mis2";"SILVA (only NR);Eukaryota;Archaeplastida;Chloroplastida;Chlorophyta;Chlorophyceae;Chlamydomonadales;Characiochloris;";"100.0";"14.4";"2";"2";"2";"0";"0";"457181";"391205"
"V4mis2";"SILVA (only NR);Eukaryota;Archaeplastida;Chloroplastida;Chlorophyta;Chlorophyceae;Chlamydomonadales;Characium;";"100.0";"14.4";"3";"3";"3";"0";"0";"457180";"391204"
"V4mis2";"SILVA (only NR);Eukaryota;Archaeplastida;Chloroplastida;Chlorophyta;Chlorophyceae;Chlamydomonadales;Chlamydomonas;";"95.2";"14.4";"84";"84";"80";"4";"0";"457099";"391127"
"V4mis2";"SILVA (only NR);Eukaryota;Archaeplastida;Chloroplastida;Chlorophyta;Chlorophyceae;Chlamydomonadales;Chlorococcum;";"100.0";"14.4";"20";"20";"20";"0";"0";"457163";"391187"
"V4mis2";"SILVA (only NR);Eukaryota;Archaeplastida;Chloroplastida;Chlorophyta;Chlorophyceae;Chlamydomonadales;Chlorogonium;";"100.0";"14.4";"1";"1";"1";"0";"0";"457182";"391206"
"V4mis2";"SILVA (only NR);Eukaryota;Archaeplastida;Chloroplastida;Chlorophyta;Chlorophyceae;Chlamydomonadales;Chloromonas;";"96.2";"14.4";"26";"26";"25";"1";"0";"457157";"391182"
"V4mis2";"SILVA (only NR);Eukaryota;Archaeplastida;Chloroplastida;Chlorophyta;Chlorophyceae;Chlamydomonadales;Colemanosphaera;";"100.0";"14.4";"1";"1";"1";"0";"0";"457182";"391206"
"V4mis2";"SILVA (only NR);Eukaryota;Archaeplastida;Chloroplastida;Chlorophyta;Chlorophyceae;Chlamydomonadales;Cylindrocapsa;";"100.0";"14.4";"2";"2";"2";"0";"0";"457181";"391205"
"V4mis2";"SILVA (only NR);Eukaryota;Archaeplastida;Chloroplastida;Chlorophyta;Chlorophyceae;Chlamydomonadales;Deasonia;";"100.0";"14.4";"2";"2";"2";"0";"0";"457181";"391205"
"V4mis2";"SILVA (only NR);Eukaryota;Archaeplastida;Chloroplastida;Chlorophyta;Chlorophyceae;Chlamydomonadales;Dunaliella;";"71.4";"14.4";"21";"21";"15";"6";"0";"457162";"391192"
"V4mis2";"SILVA (only NR);Eukaryota;Archaeplastida;Chloroplastida;Chlorophyta;Chlorophyceae;Chlamydomonadales;Dysmorphococcus;";"100.0";"14.4";"2";"2";"2";"0";"0";"457181";"391205"
"V4mis2";"SILVA (only NR);Eukaryota;Archaeplastida;Chloroplastida;Chlorophyta;Chlorophyceae;Chlamydomonadales;Ettlia;";"100.0";"14.4";"2";"2";"2";"0";"0";"457181";"391205"
"V4mis2";"SILVA (only NR);Eukaryota;Archaeplastida;Chloroplastida;Chlorophyta;Chlorophyceae;Chlamydomonadales;Eudorina;";"100.0";"14.4";"3";"3";"3";"0";"0";"457180";"391204"
"V4mis2";"SILVA (only NR);Eukaryota;Archaeplastida;Chloroplastida;Chlorophyta;Chlorophyceae;Chlamydomonadales;Gloeomonas;";"100.0";"14.4";"2";"2";"2";"0";"0";"457181";"391205"
"V4mis2";"SILVA (only NR);Eukaryota;Archaeplastida;Chloroplastida;Chlorophyta;Chlorophyceae;Chlamydomonadales;Golenkinia;";"100.0";"14.4";"3";"3";"3";"0";"0";"457180";"391204"
"V4mis2";"SILVA (only NR);Eukaryota;Archaeplastida;Chloroplastida;Chlorophyta;Chlorophyceae;Chlamydomonadales;Gonium;";"100.0";"14.4";"4";"4";"4";"0";"0";"457179";"391203"
"V4mis2";"SILVA (only NR);Eukaryota;Archaeplastida;Chloroplastida;Chlorophyta;Chlorophyceae;Chlamydomonadales;Gungnir;";"100.0";"14.4";"2";"2";"2";"0";"0";"457181";"391205"
"V4mis2";"SILVA (only NR);Eukaryota;Archaeplastida;Chloroplastida;Chlorophyta;Chlorophyceae;Chlamydomonadales;Haematococcus;";"100.0";"14.4";"1";"1";"1";"0";"0";"457182";"391206"
"V4mis2";"SILVA (only NR);Eukaryota;Archaeplastida;Chloroplastida;Chlorophyta;Chlorophyceae;Chlamydomonadales;Hafniomonas;";"100.0";"14.4";"3";"3";"3";"0";"0";"457180";"391204"
"V4mis2";"SILVA (only NR);Eukaryota;Archaeplastida;Chloroplastida;Chlorophyta;Chlorophyceae;Chlamydomonadales;Halosarcinochlamys;";"100.0";"14.4";"1";"1";"1";"0";"0";"457182";"391206"
"V4mis2";"SILVA (only NR);Eukaryota;Archaeplastida;Chloroplastida;Chlorophyta;Chlorophyceae;Chlamydomonadales;Hapalochloris;";"100.0";"14.4";"1";"1";"1";"0";"0";"457182";"391206"
"V4mis2";"SILVA (only NR);Eukaryota;Archaeplastida;Chloroplastida;Chlorophyta;Chlorophyceae;Chlamydomonadales;Hemiflagellochloris;";"100.0";"14.4";"1";"1";"1";"0";"0";"457182";"391206"
"V4mis2";"SILVA (only NR);Eukaryota;Archaeplastida;Chloroplastida;Chlorophyta;Chlorophyceae;Chlamydomonadales;Heterochlamydomonas;";"100.0";"14.4";"1";"1";"1";"0";"0";"457182";"391206"
"V4mis2";"SILVA (only NR);Eukaryota;Archaeplastida;Chloroplastida;Chlorophyta;Chlorophyceae;Chlamydomonadales;Heterotetracystis;";"0.0";"0";"1";"1";"0";"1";"0";"457182";"391207"
"V4mis2";"SILVA (only NR);Eukaryota;Archaeplastida;Chloroplastida;Chlorophyta;Chlorophyceae;Chlamydomonadales;Lobochlamys;";"100.0";"14.4";"6";"6";"6";"0";"0";"457177";"391201"
"V4mis2";"SILVA (only NR);Eukaryota;Archaeplastida;Chloroplastida;Chlorophyta;Chlorophyceae;Chlamydomonadales;Lobomonas;";"100.0";"14.4";"2";"2";"2";"0";"0";"457181";"391205"
"V4mis2";"SILVA (only NR);Eukaryota;Archaeplastida;Chloroplastida;Chlorophyta;Chlorophyceae;Chlamydomonadales;Microglena;";"66.7";"14.4";"6";"6";"4";"2";"0";"457177";"391203"
"V4mis2";"SILVA (only NR);Eukaryota;Archaeplastida;Chloroplastida;Chlorophyta;Chlorophyceae;Chlamydomonadales;Neospongiococcum;";"100.0";"14.4";"2";"2";"2";"0";"0";"457181";"391205"
"V4mis2";"SILVA (only NR);Eukaryota;Archaeplastida;Chloroplastida;Chlorophyta;Chlorophyceae;Chlamydomonadales;Oogamochlamys;";"100.0";"14.4";"3";"3";"3";"0";"0";"457180";"391204"
"V4mis2";"SILVA (only NR);Eukaryota;Archaeplastida;Chloroplastida;Chlorophyta;Chlorophyceae;Chlamydomonadales;Oophila;";"100.0";"14.4";"5";"5";"5";"0";"0";"457178";"391202"
"V4mis2";"SILVA (only NR);Eukaryota;Archaeplastida;Chloroplastida;Chlorophyta;Chlorophyceae;Chlamydomonadales;Pachycladella;";"100.0";"14.4";"1";"1";"1";"0";"0";"457182";"391206"
"V4mis2";"SILVA (only NR);Eukaryota;Archaeplastida;Chloroplastida;Chlorophyta;Chlorophyceae;Chlamydomonadales;Pandorina;";"100.0";"14.4";"4";"4";"4";"0";"0";"457179";"391203"
"V4mis2";"SILVA (only NR);Eukaryota;Archaeplastida;Chloroplastida;Chlorophyta;Chlorophyceae;Chlamydomonadales;Pascherina;";"100.0";"14.4";"1";"1";"1";"0";"0";"457182";"391206"
"V4mis2";"SILVA (only NR);Eukaryota;Archaeplastida;Chloroplastida;Chlorophyta;Chlorophyceae;Chlamydomonadales;Phacotus;";"100.0";"14.4";"2";"2";"2";"0";"0";"457181";"391205"
"V4mis2";"SILVA (only NR);Eukaryota;Archaeplastida;Chloroplastida;Chlorophyta;Chlorophyceae;Chlamydomonadales;Pleodorina;";"100.0";"14.4";"1";"1";"1";"0";"0";"457182";"391206"
"V4mis2";"SILVA (only NR);Eukaryota;Archaeplastida;Chloroplastida;Chlorophyta;Chlorophyceae;Chlamydomonadales;Polytoma;";"100.0";"14.4";"2";"2";"2";"0";"0";"457181";"391205"
"V4mis2";"SILVA (only NR);Eukaryota;Archaeplastida;Chloroplastida;Chlorophyta;Chlorophyceae;Chlamydomonadales;Polytomella;";"100.0";"14.4";"4";"4";"4";"0";"0";"457179";"391203"
"V4mis2";"SILVA (only NR);Eukaryota;Archaeplastida;Chloroplastida;Chlorophyta;Chlorophyceae;Chlamydomonadales;Protosiphon;";"100.0";"14.4";"2";"2";"2";"0";"0";"457181";"391205"
"V4mis2";"SILVA (only NR);Eukaryota;Archaeplastida;Chloroplastida;Chlorophyta;Chlorophyceae;Chlamydomonadales;Pteromonas;";"100.0";"14.4";"1";"1";"1";"0";"0";"457182";"391206"
"V4mis2";"SILVA (only NR);Eukaryota;Archaeplastida;Chloroplastida;Chlorophyta;Chlorophyceae;Chlamydomonadales;Pyrobotrys;";"100.0";"14.4";"2";"2";"2";"0";"0";"457181";"391205"
"V4mis2";"SILVA (only NR);Eukaryota;Archaeplastida;Chloroplastida;Chlorophyta;Chlorophyceae;Chlamydomonadales;Radiosphaera;";"100.0";"14.4";"1";"1";"1";"0";"0";"457182";"391206"
"V4mis2";"SILVA (only NR);Eukaryota;Archaeplastida;Chloroplastida;Chlorophyta;Chlorophyceae;Chlamydomonadales;Rhysamphichloris;";"100.0";"14.4";"1";"1";"1";"0";"0";"457182";"391206"
"V4mis2";"SILVA (only NR);Eukaryota;Archaeplastida;Chloroplastida;Chlorophyta;Chlorophyceae;Chlamydomonadales;Rusalka;";"100.0";"14.4";"1";"1";"1";"0";"0";"457182";"391206"
"V4mis2";"SILVA (only NR);Eukaryota;Archaeplastida;Chloroplastida;Chlorophyta;Chlorophyceae;Chlamydomonadales;Spongiochloris;";"100.0";"14.4";"2";"2";"2";"0";"0";"457181";"391205"
"V4mis2";"SILVA (only NR);Eukaryota;Archaeplastida;Chloroplastida;Chlorophyta;Chlorophyceae;Chlamydomonadales;Stephanosphaera;";"100.0";"14.4";"1";"1";"1";"0";"0";"457182";"391206"
"V4mis2";"SILVA (only NR);Eukaryota;Archaeplastida;Chloroplastida;Chlorophyta;Chlorophyceae;Chlamydomonadales;Tetrabaena;";"100.0";"14.4";"1";"1";"1";"0";"0";"457182";"391206"
"V4mis2";"SILVA (only NR);Eukaryota;Archaeplastida;Chloroplastida;Chlorophyta;Chlorophyceae;Chlamydomonadales;Tetracystis;";"90.9";"14.4";"11";"11";"10";"1";"0";"457172";"391197"
"V4mis2";"SILVA (only NR);Eukaryota;Archaeplastida;Chloroplastida;Chlorophyta;Chlorophyceae;Chlamydomonadales;Vitreochlamys;";"100.0";"14.4";"6";"6";"6";"0";"0";"457177";"391201"
"V4mis2";"SILVA (only NR);Eukaryota;Archaeplastida;Chloroplastida;Chlorophyta;Chlorophyceae;Chlamydomonadales;Volvox;";"100.0";"14.4";"5";"5";"5";"0";"0";"457178";"391202"
"V4mis2";"SILVA (only NR);Eukaryota;Archaeplastida;Chloroplastida;Chlorophyta;Chlorophyceae;Chlamydomonadales;Volvulina;";"100.0";"14.4";"3";"3";"3";"0";"0";"457180";"391204"
"V4mis2";"SILVA (only NR);Eukaryota;Archaeplastida;Chloroplastida;Chlorophyta;Chlorophyceae;Chlorosarcinales;";"94.4";"14.4";"18";"18";"17";"1";"0";"457165";"391190"
"V4mis2";"SILVA (only NR);Eukaryota;Archaeplastida;Chloroplastida;Chlorophyta;Chlorophyceae;Chlorosarcinales;Chlorosarcina;";"100.0";"14.4";"3";"3";"3";"0";"0";"457180";"391204"
"V4mis2";"SILVA (only NR);Eukaryota;Archaeplastida;Chloroplastida;Chlorophyta;Chlorophyceae;Chlorosarcinales;Chlorosarcinopsis;";"88.9";"14.4";"9";"9";"8";"1";"0";"457174";"391199"
"V4mis2";"SILVA (only NR);Eukaryota;Archaeplastida;Chloroplastida;Chlorophyta;Chlorophyceae;Chlorosarcinales;Neochlorosarcina;";"100.0";"14.4";"6";"6";"6";"0";"0";"457177";"391201"
"V4mis2";"SILVA (only NR);Eukaryota;Archaeplastida;Chloroplastida;Chlorophyta;Chlorophyceae;Incertae Sedis;";"88.5";"14.4";"26";"26";"23";"3";"0";"457157";"391184"
"V4mis2";"SILVA (only NR);Eukaryota;Archaeplastida;Chloroplastida;Chlorophyta;Chlorophyceae;Incertae Sedis;Botryococcus;";"0.0";"0";"1";"1";"0";"1";"0";"457182";"391207"
"V4mis2";"SILVA (only NR);Eukaryota;Archaeplastida;Chloroplastida;Chlorophyta;Chlorophyceae;Incertae Sedis;Carteria;";"100.0";"14.4";"8";"8";"8";"0";"0";"457175";"391199"
"V4mis2";"SILVA (only NR);Eukaryota;Archaeplastida;Chloroplastida;Chlorophyta;Chlorophyceae;Incertae Sedis;Chlamydopodium;";"100.0";"14.4";"3";"3";"3";"0";"0";"457180";"391204"
"V4mis2";"SILVA (only NR);Eukaryota;Archaeplastida;Chloroplastida;Chlorophyta;Chlorophyceae;Incertae Sedis;Chlorochytrium;";"100.0";"14.4";"2";"2";"2";"0";"0";"457181";"391205"
"V4mis2";"SILVA (only NR);Eukaryota;Archaeplastida;Chloroplastida;Chlorophyta;Chlorophyceae;Incertae Sedis;Jenufa;";"100.0";"14.4";"3";"3";"3";"0";"0";"457180";"391204"
"V4mis2";"SILVA (only NR);Eukaryota;Archaeplastida;Chloroplastida;Chlorophyta;Chlorophyceae;Incertae Sedis;Nautococcus;";"100.0";"14.4";"1";"1";"1";"0";"0";"457182";"391206"
"V4mis2";"SILVA (only NR);Eukaryota;Archaeplastida;Chloroplastida;Chlorophyta;Chlorophyceae;Incertae Sedis;Pleurastrum;";"100.0";"14.4";"1";"1";"1";"0";"0";"457182";"391206"
"V4mis2";"SILVA (only NR);Eukaryota;Archaeplastida;Chloroplastida;Chlorophyta;Chlorophyceae;Incertae Sedis;Spermatozopsis;";"0.0";"0";"1";"1";"0";"1";"0";"457182";"391207"
"V4mis2";"SILVA (only NR);Eukaryota;Archaeplastida;Chloroplastida;Chlorophyta;Chlorophyceae;Incertae Sedis;Tetraflagellochloris;";"100.0";"14.4";"1";"1";"1";"0";"0";"457182";"391206"
"V4mis2";"SILVA (only NR);Eukaryota;Archaeplastida;Chloroplastida;Chlorophyta;Chlorophyceae;Oedogoniales;";"56.3";"14.4";"16";"16";"9";"7";"0";"457167";"391198"
"V4mis2";"SILVA (only NR);Eukaryota;Archaeplastida;Chloroplastida;Chlorophyta;Chlorophyceae;Oedogoniales;Bulbochaete;";"100.0";"14.4";"1";"1";"1";"0";"0";"457182";"391206"
"V4mis2";"SILVA (only NR);Eukaryota;Archaeplastida;Chloroplastida;Chlorophyta;Chlorophyceae;Oedogoniales;Oedocladium;";"50.0";"14.4";"2";"2";"1";"1";"0";"457181";"391206"
"V4mis2";"SILVA (only NR);Eukaryota;Archaeplastida;Chloroplastida;Chlorophyta;Chlorophyceae;Oedogoniales;Oedogonium;";"53.8";"14.4";"13";"13";"7";"6";"0";"457170";"391200"
"V4mis2";"SILVA (only NR);Eukaryota;Archaeplastida;Chloroplastida;Chlorophyta;Chlorophyceae;Sphaeropleales;";"94.4";"14.4";"180";"179";"169";"10";"1";"457004";"391038"
"V4mis2";"SILVA (only NR);Eukaryota;Archaeplastida;Chloroplastida;Chlorophyta;Chlorophyceae;Sphaeropleales;Acutodesmus;";"100.0";"14.4";"2";"2";"2";"0";"0";"457181";"391205"
"V4mis2";"SILVA (only NR);Eukaryota;Archaeplastida;Chloroplastida;Chlorophyta;Chlorophyceae;Sphaeropleales;Ankistrodesmus;";"85.7";"14.4";"7";"7";"6";"1";"0";"457176";"391201"
"V4mis2";"SILVA (only NR);Eukaryota;Archaeplastida;Chloroplastida;Chlorophyta;Chlorophyceae;Sphaeropleales;Ankyra;";"100.0";"14.4";"1";"1";"1";"0";"0";"457182";"391206"
"V4mis2";"SILVA (only NR);Eukaryota;Archaeplastida;Chloroplastida;Chlorophyta;Chlorophyceae;Sphaeropleales;Asterarcys;";"100.0";"14.4";"1";"1";"1";"0";"0";"457182";"391206"
"V4mis2";"SILVA (only NR);Eukaryota;Archaeplastida;Chloroplastida;Chlorophyta;Chlorophyceae;Sphaeropleales;Auctodesmus;";"100.0";"14.4";"1";"1";"1";"0";"0";"457182";"391206"
"V4mis2";"SILVA (only NR);Eukaryota;Archaeplastida;Chloroplastida;Chlorophyta;Chlorophyceae;Sphaeropleales;Bracteacoccus;";"100.0";"14.4";"15";"15";"15";"0";"0";"457168";"391192"
"V4mis2";"SILVA (only NR);Eukaryota;Archaeplastida;Chloroplastida;Chlorophyta;Chlorophyceae;Sphaeropleales;Characiopodium;";"100.0";"14.4";"2";"2";"2";"0";"0";"457181";"391205"
"V4mis2";"SILVA (only NR);Eukaryota;Archaeplastida;Chloroplastida;Chlorophyta;Chlorophyceae;Sphaeropleales;Chlorolobion;";"100.0";"14.4";"2";"2";"2";"0";"0";"457181";"391205"
"V4mis2";"SILVA (only NR);Eukaryota;Archaeplastida;Chloroplastida;Chlorophyta;Chlorophyceae;Sphaeropleales;Chlorotetraedron;";"100.0";"14.4";"1";"1";"1";"0";"0";"457182";"391206"
"V4mis2";"SILVA (only NR);Eukaryota;Archaeplastida;Chloroplastida;Chlorophyta;Chlorophyceae;Sphaeropleales;Chromochloris;";"100.0";"14.4";"1";"1";"1";"0";"0";"457182";"391206"
"V4mis2";"SILVA (only NR);Eukaryota;Archaeplastida;Chloroplastida;Chlorophyta;Chlorophyceae;Sphaeropleales;Coelastrella;";"100.0";"14.4";"11";"11";"11";"0";"0";"457172";"391196"
"V4mis2";"SILVA (only NR);Eukaryota;Archaeplastida;Chloroplastida;Chlorophyta;Chlorophyceae;Sphaeropleales;Coelastrum;";"100.0";"14.4";"2";"2";"2";"0";"0";"457181";"391205"
"V4mis2";"SILVA (only NR);Eukaryota;Archaeplastida;Chloroplastida;Chlorophyta;Chlorophyceae;Sphaeropleales;Crucigenia;";"100.0";"14.4";"1";"1";"1";"0";"0";"457182";"391206"
"V4mis2";"SILVA (only NR);Eukaryota;Archaeplastida;Chloroplastida;Chlorophyta;Chlorophyceae;Sphaeropleales;Desmodesmus;";"81.3";"14.4";"17";"16";"13";"3";"1";"457167";"391194"
"V4mis2";"SILVA (only NR);Eukaryota;Archaeplastida;Chloroplastida;Chlorophyta;Chlorophyceae;Sphaeropleales;Dictyochloris;";"100.0";"14.4";"1";"1";"1";"0";"0";"457182";"391206"
"V4mis2";"SILVA (only NR);Eukaryota;Archaeplastida;Chloroplastida;Chlorophyta;Chlorophyceae;Sphaeropleales;Dictyococcus;";"100.0";"14.4";"7";"7";"7";"0";"0";"457176";"391200"
"V4mis2";"SILVA (only NR);Eukaryota;Archaeplastida;Chloroplastida;Chlorophyta;Chlorophyceae;Sphaeropleales;Dimorphococcus;";"100.0";"14.4";"1";"1";"1";"0";"0";"457182";"391206"
"V4mis2";"SILVA (only NR);Eukaryota;Archaeplastida;Chloroplastida;Chlorophyta;Chlorophyceae;Sphaeropleales;Hylodesmus;";"100.0";"14.4";"1";"1";"1";"0";"0";"457182";"391206"
"V4mis2";"SILVA (only NR);Eukaryota;Archaeplastida;Chloroplastida;Chlorophyta;Chlorophyceae;Sphaeropleales;Kirchneriella;";"100.0";"14.4";"1";"1";"1";"0";"0";"457182";"391206"
"V4mis2";"SILVA (only NR);Eukaryota;Archaeplastida;Chloroplastida;Chlorophyta;Chlorophyceae;Sphaeropleales;Lacunastrum;";"100.0";"14.4";"1";"1";"1";"0";"0";"457182";"391206"
"V4mis2";"SILVA (only NR);Eukaryota;Archaeplastida;Chloroplastida;Chlorophyta;Chlorophyceae;Sphaeropleales;Messastrum;";"100.0";"14.4";"2";"2";"2";"0";"0";"457181";"391205"
"V4mis2";"SILVA (only NR);Eukaryota;Archaeplastida;Chloroplastida;Chlorophyta;Chlorophyceae;Sphaeropleales;Monactinus;";"100.0";"14.4";"2";"2";"2";"0";"0";"457181";"391205"
"V4mis2";"SILVA (only NR);Eukaryota;Archaeplastida;Chloroplastida;Chlorophyta;Chlorophyceae;Sphaeropleales;Monoraphidium;";"100.0";"14.4";"23";"23";"23";"0";"0";"457160";"391184"
"V4mis2";"SILVA (only NR);Eukaryota;Archaeplastida;Chloroplastida;Chlorophyta;Chlorophyceae;Sphaeropleales;Mychonastes;";"100.0";"14.4";"9";"9";"9";"0";"0";"457174";"391198"
"V4mis2";"SILVA (only NR);Eukaryota;Archaeplastida;Chloroplastida;Chlorophyta;Chlorophyceae;Sphaeropleales;Neochloris;";"66.7";"14.4";"3";"3";"2";"1";"0";"457180";"391205"
"V4mis2";"SILVA (only NR);Eukaryota;Archaeplastida;Chloroplastida;Chlorophyta;Chlorophyceae;Sphaeropleales;Neodesmus;";"100.0";"14.4";"1";"1";"1";"0";"0";"457182";"391206"
"V4mis2";"SILVA (only NR);Eukaryota;Archaeplastida;Chloroplastida;Chlorophyta;Chlorophyceae;Sphaeropleales;Ourococcus;";"100.0";"14.4";"1";"1";"1";"0";"0";"457182";"391206"
"V4mis2";"SILVA (only NR);Eukaryota;Archaeplastida;Chloroplastida;Chlorophyta;Chlorophyceae;Sphaeropleales;Parapediastrum;";"100.0";"14.4";"1";"1";"1";"0";"0";"457182";"391206"
"V4mis2";"SILVA (only NR);Eukaryota;Archaeplastida;Chloroplastida;Chlorophyta;Chlorophyceae;Sphaeropleales;Pectinodesmus;";"100.0";"14.4";"2";"2";"2";"0";"0";"457181";"391205"
"V4mis2";"SILVA (only NR);Eukaryota;Archaeplastida;Chloroplastida;Chlorophyta;Chlorophyceae;Sphaeropleales;Pectodictyon;";"100.0";"14.4";"1";"1";"1";"0";"0";"457182";"391206"
"V4mis2";"SILVA (only NR);Eukaryota;Archaeplastida;Chloroplastida;Chlorophyta;Chlorophyceae;Sphaeropleales;Pediastrum;";"100.0";"14.4";"2";"2";"2";"0";"0";"457181";"391205"
"V4mis2";"SILVA (only NR);Eukaryota;Archaeplastida;Chloroplastida;Chlorophyta;Chlorophyceae;Sphaeropleales;Planktosphaeria;";"100.0";"14.4";"1";"1";"1";"0";"0";"457182";"391206"
"V4mis2";"SILVA (only NR);Eukaryota;Archaeplastida;Chloroplastida;Chlorophyta;Chlorophyceae;Sphaeropleales;Polyedriopsis;";"100.0";"14.4";"2";"2";"2";"0";"0";"457181";"391205"
"V4mis2";"SILVA (only NR);Eukaryota;Archaeplastida;Chloroplastida;Chlorophyta;Chlorophyceae;Sphaeropleales;Protodesmus;";"100.0";"14.4";"1";"1";"1";"0";"0";"457182";"391206"
"V4mis2";"SILVA (only NR);Eukaryota;Archaeplastida;Chloroplastida;Chlorophyta;Chlorophyceae;Sphaeropleales;Pseudomuriella;";"100.0";"14.4";"4";"4";"4";"0";"0";"457179";"391203"
"V4mis2";"SILVA (only NR);Eukaryota;Archaeplastida;Chloroplastida;Chlorophyta;Chlorophyceae;Sphaeropleales;Pseudopediastrum;";"100.0";"14.4";"5";"5";"5";"0";"0";"457178";"391202"
"V4mis2";"SILVA (only NR);Eukaryota;Archaeplastida;Chloroplastida;Chlorophyta;Chlorophyceae;Sphaeropleales;Pseudoschroederia;";"100.0";"14.4";"1";"1";"1";"0";"0";"457182";"391206"
"V4mis2";"SILVA (only NR);Eukaryota;Archaeplastida;Chloroplastida;Chlorophyta;Chlorophyceae;Sphaeropleales;Quadrigula;";"100.0";"14.4";"1";"1";"1";"0";"0";"457182";"391206"
"V4mis2";"SILVA (only NR);Eukaryota;Archaeplastida;Chloroplastida;Chlorophyta;Chlorophyceae;Sphaeropleales;Radiococcus;";"100.0";"14.4";"3";"3";"3";"0";"0";"457180";"391204"
"V4mis2";"SILVA (only NR);Eukaryota;Archaeplastida;Chloroplastida;Chlorophyta;Chlorophyceae;Sphaeropleales;Raphidocelis;";"100.0";"14.4";"1";"1";"1";"0";"0";"457182";"391206"
"V4mis2";"SILVA (only NR);Eukaryota;Archaeplastida;Chloroplastida;Chlorophyta;Chlorophyceae;Sphaeropleales;Rhombocystis;";"100.0";"14.4";"1";"1";"1";"0";"0";"457182";"391206"
"V4mis2";"SILVA (only NR);Eukaryota;Archaeplastida;Chloroplastida;Chlorophyta;Chlorophyceae;Sphaeropleales;Rotundella;";"100.0";"14.4";"1";"1";"1";"0";"0";"457182";"391206"
"V4mis2";"SILVA (only NR);Eukaryota;Archaeplastida;Chloroplastida;Chlorophyta;Chlorophyceae;Sphaeropleales;Scenedesmus;";"86.4";"14.4";"22";"22";"19";"3";"0";"457161";"391188"
"V4mis2";"SILVA (only NR);Eukaryota;Archaeplastida;Chloroplastida;Chlorophyta;Chlorophyceae;Sphaeropleales;Selenastrum;";"100.0";"14.4";"2";"2";"2";"0";"0";"457181";"391205"
"V4mis2";"SILVA (only NR);Eukaryota;Archaeplastida;Chloroplastida;Chlorophyta;Chlorophyceae;Sphaeropleales;Stauridium;";"100.0";"14.4";"1";"1";"1";"0";"0";"457182";"391206"
"V4mis2";"SILVA (only NR);Eukaryota;Archaeplastida;Chloroplastida;Chlorophyta;Chlorophyceae;Sphaeropleales;Tetradesmus;";"66.7";"14.4";"3";"3";"2";"1";"0";"457180";"391205"
"V4mis2";"SILVA (only NR);Eukaryota;Archaeplastida;Chloroplastida;Chlorophyta;Chlorophyceae;Sphaeropleales;Tetraedron;";"100.0";"14.4";"2";"2";"2";"0";"0";"457181";"391205"
"V4mis2";"SILVA (only NR);Eukaryota;Archaeplastida;Chloroplastida;Chlorophyta;Chlorophyceae;Sphaeropleales;Tetranephris;";"66.7";"14.4";"3";"3";"2";"1";"0";"457180";"391205"
"V4mis2";"SILVA (only NR);Eukaryota;Archaeplastida;Chloroplastida;Chlorophyta;Chlorophyceae;Sphaeropleales;Tumidella;";"100.0";"14.4";"1";"1";"1";"0";"0";"457182";"391206"
"V4mis2";"SILVA (only NR);Eukaryota;Archaeplastida;Chloroplastida;Chlorophyta;Chlorophyceae;Sphaeropleales;Verrucodesmus;";"100.0";"14.4";"1";"1";"1";"0";"0";"457182";"391206"
"V4mis2";"SILVA (only NR);Eukaryota;Archaeplastida;Chloroplastida;Chlorophyta;Chlorophyceae;Sphaeropleales;Westella;";"100.0";"14.4";"1";"1";"1";"0";"0";"457182";"391206"
"V4mis2";"SILVA (only NR);Eukaryota;Archaeplastida;Chloroplastida;Chlorophyta;Chlorophyceae;Tetrasporales;";"100.0";"14.4";"3";"3";"3";"0";"0";"457180";"391204"
"V4mis2";"SILVA (only NR);Eukaryota;Archaeplastida;Chloroplastida;Chlorophyta;Chlorophyceae;Tetrasporales;Asterococcus;";"100.0";"14.4";"1";"1";"1";"0";"0";"457182";"391206"
"V4mis2";"SILVA (only NR);Eukaryota;Archaeplastida;Chloroplastida;Chlorophyta;Chlorophyceae;Tetrasporales;Fritschiella;";"100.0";"14.4";"1";"1";"1";"0";"0";"457182";"391206"
"V4mis2";"SILVA (only NR);Eukaryota;Archaeplastida;Chloroplastida;Chlorophyta;Chlorophyceae;Tetrasporales;Paulschulzia;";"100.0";"14.4";"1";"1";"1";"0";"0";"457182";"391206"
"V4mis2";"SILVA (only NR);Eukaryota;Archaeplastida;Chloroplastida;Chlorophyta;Clade IX;";"80.6";"14.4";"31";"31";"25";"6";"0";"457152";"391182"
"V4mis2";"SILVA (only NR);Eukaryota;Archaeplastida;Chloroplastida;Chlorophyta;Clade VII;";"0.0";"0";"38";"37";"0";"37";"1";"457146";"391207"
"V4mis2";"SILVA (only NR);Eukaryota;Archaeplastida;Chloroplastida;Chlorophyta;Clade VII;Subclade A;";"0.0";"0";"26";"25";"0";"25";"1";"457158";"391207"
"V4mis2";"SILVA (only NR);Eukaryota;Archaeplastida;Chloroplastida;Chlorophyta;Clade VII;Subclade B;";"0.0";"0";"12";"12";"0";"12";"0";"457171";"391207"
"V4mis2";"SILVA (only NR);Eukaryota;Archaeplastida;Chloroplastida;Chlorophyta;Incertae Sedis;";"0.0";"0";"2";"2";"0";"2";"0";"457181";"391207"
"V4mis2";"SILVA (only NR);Eukaryota;Archaeplastida;Chloroplastida;Chlorophyta;Incertae Sedis;Picocystis;";"0.0";"0";"2";"2";"0";"2";"0";"457181";"391207"
"V4mis2";"SILVA (only NR);Eukaryota;Archaeplastida;Chloroplastida;Chlorophyta;Mamiellophyceae;";"0.0";"0";"140";"139";"0";"139";"1";"457044";"391207"
"V4mis2";"SILVA (only NR);Eukaryota;Archaeplastida;Chloroplastida;Chlorophyta;Mamiellophyceae;DSGM-81;";"0.0";"0";"4";"4";"0";"4";"0";"457179";"391207"
"V4mis2";"SILVA (only NR);Eukaryota;Archaeplastida;Chloroplastida;Chlorophyta;Mamiellophyceae;Dolichomastigales;";"0.0";"0";"7";"7";"0";"7";"0";"457176";"391207"
"V4mis2";"SILVA (only NR);Eukaryota;Archaeplastida;Chloroplastida;Chlorophyta;Mamiellophyceae;Dolichomastigales;Crustomastix;";"0.0";"0";"7";"7";"0";"7";"0";"457176";"391207"
"V4mis2";"SILVA (only NR);Eukaryota;Archaeplastida;Chloroplastida;Chlorophyta;Mamiellophyceae;Dolichomastix;";"0.0";"0";"3";"3";"0";"3";"0";"457180";"391207"
"V4mis2";"SILVA (only NR);Eukaryota;Archaeplastida;Chloroplastida;Chlorophyta;Mamiellophyceae;Mamiellales;";"0.0";"0";"109";"108";"0";"108";"1";"457075";"391207"
"V4mis2";"SILVA (only NR);Eukaryota;Archaeplastida;Chloroplastida;Chlorophyta;Mamiellophyceae;Mamiellales;Bathycoccus;";"0.0";"0";"24";"24";"0";"24";"0";"457159";"391207"
"V4mis2";"SILVA (only NR);Eukaryota;Archaeplastida;Chloroplastida;Chlorophyta;Mamiellophyceae;Mamiellales;Mamiella;";"0.0";"0";"4";"4";"0";"4";"0";"457179";"391207"
"V4mis2";"SILVA (only NR);Eukaryota;Archaeplastida;Chloroplastida;Chlorophyta;Mamiellophyceae;Mamiellales;Mantoniella;";"0.0";"0";"1";"1";"0";"1";"0";"457182";"391207"
"V4mis2";"SILVA (only NR);Eukaryota;Archaeplastida;Chloroplastida;Chlorophyta;Mamiellophyceae;Mamiellales;Micromonas;";"0.0";"0";"62";"62";"0";"62";"0";"457121";"391207"
"V4mis2";"SILVA (only NR);Eukaryota;Archaeplastida;Chloroplastida;Chlorophyta;Mamiellophyceae;Mamiellales;Ostreococcus;";"0.0";"0";"18";"17";"0";"17";"1";"457166";"391207"
"V4mis2";"SILVA (only NR);Eukaryota;Archaeplastida;Chloroplastida;Chlorophyta;Mamiellophyceae;Monomastigales;";"0.0";"0";"3";"3";"0";"3";"0";"457180";"391207"
"V4mis2";"SILVA (only NR);Eukaryota;Archaeplastida;Chloroplastida;Chlorophyta;Mamiellophyceae;Monomastigales;Monomastix;";"0.0";"0";"3";"3";"0";"3";"0";"457180";"391207"
"V4mis2";"SILVA (only NR);Eukaryota;Archaeplastida;Chloroplastida;Chlorophyta;Mamiellophyceae;uncultured;";"0.0";"0";"3";"3";"0";"3";"0";"457180";"391207"
"V4mis2";"SILVA (only NR);Eukaryota;Archaeplastida;Chloroplastida;Chlorophyta;Nephroselmidophyceae;";"25.0";"14.4";"16";"16";"4";"12";"0";"457167";"391203"
"V4mis2";"SILVA (only NR);Eukaryota;Archaeplastida;Chloroplastida;Chlorophyta;Nephroselmidophyceae;Nephroselmidales;";"25.0";"14.4";"16";"16";"4";"12";"0";"457167";"391203"
"V4mis2";"SILVA (only NR);Eukaryota;Archaeplastida;Chloroplastida;Chlorophyta;Nephroselmidophyceae;Nephroselmidales;Nephroselmis;";"25.0";"14.4";"16";"16";"4";"12";"0";"457167";"391203"
"V4mis2";"SILVA (only NR);Eukaryota;Archaeplastida;Chloroplastida;Chlorophyta;Palmophyllophyceae;";"100.0";"14.4";"2";"2";"2";"0";"0";"457181";"391205"
"V4mis2";"SILVA (only NR);Eukaryota;Archaeplastida;Chloroplastida;Chlorophyta;Palmophyllophyceae;Palmophyllales;";"100.0";"14.4";"2";"2";"2";"0";"0";"457181";"391205"
"V4mis2";"SILVA (only NR);Eukaryota;Archaeplastida;Chloroplastida;Chlorophyta;Palmophyllophyceae;Palmophyllales;Palmophyllum;";"100.0";"14.4";"1";"1";"1";"0";"0";"457182";"391206"
"V4mis2";"SILVA (only NR);Eukaryota;Archaeplastida;Chloroplastida;Chlorophyta;Palmophyllophyceae;Palmophyllales;Verdigellas;";"100.0";"14.4";"1";"1";"1";"0";"0";"457182";"391206"
"V4mis2";"SILVA (only NR);Eukaryota;Archaeplastida;Chloroplastida;Chlorophyta;Pedinophyceae;";"0.0";"0";"9";"9";"0";"9";"0";"457174";"391207"
"V4mis2";"SILVA (only NR);Eukaryota;Archaeplastida;Chloroplastida;Chlorophyta;Pedinophyceae;Pedinomonadales;";"0.0";"0";"9";"9";"0";"9";"0";"457174";"391207"
"V4mis2";"SILVA (only NR);Eukaryota;Archaeplastida;Chloroplastida;Chlorophyta;Pedinophyceae;Pedinomonadales;Pedinomonas;";"0.0";"0";"9";"9";"0";"9";"0";"457174";"391207"
"V4mis2";"SILVA (only NR);Eukaryota;Archaeplastida;Chloroplastida;Chlorophyta;Prasinophytae;";"0.0";"0";"56";"56";"0";"56";"0";"457127";"391207"
"V4mis2";"SILVA (only NR);Eukaryota;Archaeplastida;Chloroplastida;Chlorophyta;Prasinophytae;Prasinococcales;";"0.0";"0";"5";"5";"0";"5";"0";"457178";"391207"
"V4mis2";"SILVA (only NR);Eukaryota;Archaeplastida;Chloroplastida;Chlorophyta;Prasinophytae;Prasinococcales;Prasinococcus;";"0.0";"0";"5";"5";"0";"5";"0";"457178";"391207"
"V4mis2";"SILVA (only NR);Eukaryota;Archaeplastida;Chloroplastida;Chlorophyta;Prasinophytae;Pseudoscourfieldiales;";"0.0";"0";"11";"11";"0";"11";"0";"457172";"391207"
"V4mis2";"SILVA (only NR);Eukaryota;Archaeplastida;Chloroplastida;Chlorophyta;Prasinophytae;Pseudoscourfieldiales;Prasinoderma;";"0.0";"0";"9";"9";"0";"9";"0";"457174";"391207"
"V4mis2";"SILVA (only NR);Eukaryota;Archaeplastida;Chloroplastida;Chlorophyta;Prasinophytae;Pseudoscourfieldiales;Pycnococcus;";"0.0";"0";"2";"2";"0";"2";"0";"457181";"391207"
"V4mis2";"SILVA (only NR);Eukaryota;Archaeplastida;Chloroplastida;Chlorophyta;Prasinophytae;Pyramimonadales;";"0.0";"0";"26";"26";"0";"26";"0";"457157";"391207"
"V4mis2";"SILVA (only NR);Eukaryota;Archaeplastida;Chloroplastida;Chlorophyta;Prasinophytae;Pyramimonadales;Cymbomonas;";"0.0";"0";"1";"1";"0";"1";"0";"457182";"391207"
"V4mis2";"SILVA (only NR);Eukaryota;Archaeplastida;Chloroplastida;Chlorophyta;Prasinophytae;Pyramimonadales;Prasinopapilla;";"0.0";"0";"1";"1";"0";"1";"0";"457182";"391207"
"V4mis2";"SILVA (only NR);Eukaryota;Archaeplastida;Chloroplastida;Chlorophyta;Prasinophytae;Pyramimonadales;Pterosperma;";"0.0";"0";"5";"5";"0";"5";"0";"457178";"391207"
"V4mis2";"SILVA (only NR);Eukaryota;Archaeplastida;Chloroplastida;Chlorophyta;Prasinophytae;Pyramimonadales;Pyramimonas;";"0.0";"0";"19";"19";"0";"19";"0";"457164";"391207"
"V4mis2";"SILVA (only NR);Eukaryota;Archaeplastida;Chloroplastida;Chlorophyta;Prasinophytae;shizugawa;";"0.0";"0";"3";"3";"0";"3";"0";"457180";"391207"
"V4mis2";"SILVA (only NR);Eukaryota;Archaeplastida;Chloroplastida;Chlorophyta;Trebouxiophyceae;";"4.4";"14.4";"440";"435";"19";"416";"5";"456748";"391188"
"V4mis2";"SILVA (only NR);Eukaryota;Archaeplastida;Chloroplastida;Chlorophyta;Trebouxiophyceae;Chlorellales;";"0.0";"0";"131";"130";"0";"130";"1";"457053";"391207"
"V4mis2";"SILVA (only NR);Eukaryota;Archaeplastida;Chloroplastida;Chlorophyta;Trebouxiophyceae;Chlorellales;Auxenochlorella;";"0.0";"0";"2";"2";"0";"2";"0";"457181";"391207"
"V4mis2";"SILVA (only NR);Eukaryota;Archaeplastida;Chloroplastida;Chlorophyta;Trebouxiophyceae;Chlorellales;Chlorella;";"0.0";"0";"47";"47";"0";"47";"0";"457136";"391207"
"V4mis2";"SILVA (only NR);Eukaryota;Archaeplastida;Chloroplastida;Chlorophyta;Trebouxiophyceae;Chlorellales;Chloroidium;";"0.0";"0";"10";"9";"0";"9";"1";"457174";"391207"
"V4mis2";"SILVA (only NR);Eukaryota;Archaeplastida;Chloroplastida;Chlorophyta;Trebouxiophyceae;Chlorellales;Didymogenes;";"0.0";"0";"2";"2";"0";"2";"0";"457181";"391207"
"V4mis2";"SILVA (only NR);Eukaryota;Archaeplastida;Chloroplastida;Chlorophyta;Trebouxiophyceae;Chlorellales;Echinocoleum;";"0.0";"0";"1";"1";"0";"1";"0";"457182";"391207"
"V4mis2";"SILVA (only NR);Eukaryota;Archaeplastida;Chloroplastida;Chlorophyta;Trebouxiophyceae;Chlorellales;Elongatocystis;";"0.0";"0";"1";"1";"0";"1";"0";"457182";"391207"
"V4mis2";"SILVA (only NR);Eukaryota;Archaeplastida;Chloroplastida;Chlorophyta;Trebouxiophyceae;Chlorellales;Eremosphaera;";"0.0";"0";"2";"2";"0";"2";"0";"457181";"391207"
"V4mis2";"SILVA (only NR);Eukaryota;Archaeplastida;Chloroplastida;Chlorophyta;Trebouxiophyceae;Chlorellales;Franceia;";"0.0";"0";"2";"2";"0";"2";"0";"457181";"391207"
"V4mis2";"SILVA (only NR);Eukaryota;Archaeplastida;Chloroplastida;Chlorophyta;Trebouxiophyceae;Chlorellales;Hemichloris;";"0.0";"0";"2";"2";"0";"2";"0";"457181";"391207"
"V4mis2";"SILVA (only NR);Eukaryota;Archaeplastida;Chloroplastida;Chlorophyta;Trebouxiophyceae;Chlorellales;Heveochlorella;";"0.0";"0";"1";"1";"0";"1";"0";"457182";"391207"
"V4mis2";"SILVA (only NR);Eukaryota;Archaeplastida;Chloroplastida;Chlorophyta;Trebouxiophyceae;Chlorellales;Lagerheimia;";"0.0";"0";"6";"6";"0";"6";"0";"457177";"391207"
"V4mis2";"SILVA (only NR);Eukaryota;Archaeplastida;Chloroplastida;Chlorophyta;Trebouxiophyceae;Chlorellales;Makinoella;";"0.0";"0";"2";"2";"0";"2";"0";"457181";"391207"
"V4mis2";"SILVA (only NR);Eukaryota;Archaeplastida;Chloroplastida;Chlorophyta;Trebouxiophyceae;Chlorellales;Marvania;";"0.0";"0";"1";"1";"0";"1";"0";"457182";"391207"
"V4mis2";"SILVA (only NR);Eukaryota;Archaeplastida;Chloroplastida;Chlorophyta;Trebouxiophyceae;Chlorellales;Micractinium;";"0.0";"0";"10";"10";"0";"10";"0";"457173";"391207"
"V4mis2";"SILVA (only NR);Eukaryota;Archaeplastida;Chloroplastida;Chlorophyta;Trebouxiophyceae;Chlorellales;Nannochloris;";"0.0";"0";"6";"6";"0";"6";"0";"457177";"391207"
"V4mis2";"SILVA (only NR);Eukaryota;Archaeplastida;Chloroplastida;Chlorophyta;Trebouxiophyceae;Chlorellales;Neglectella;";"0.0";"0";"2";"2";"0";"2";"0";"457181";"391207"
"V4mis2";"SILVA (only NR);Eukaryota;Archaeplastida;Chloroplastida;Chlorophyta;Trebouxiophyceae;Chlorellales;Oocystella;";"0.0";"0";"5";"5";"0";"5";"0";"457178";"391207"
"V4mis2";"SILVA (only NR);Eukaryota;Archaeplastida;Chloroplastida;Chlorophyta;Trebouxiophyceae;Chlorellales;Oocystis;";"0.0";"0";"8";"8";"0";"8";"0";"457175";"391207"
"V4mis2";"SILVA (only NR);Eukaryota;Archaeplastida;Chloroplastida;Chlorophyta;Trebouxiophyceae;Chlorellales;Parachlorella;";"0.0";"0";"4";"4";"0";"4";"0";"457179";"391207"
"V4mis2";"SILVA (only NR);Eukaryota;Archaeplastida;Chloroplastida;Chlorophyta;Trebouxiophyceae;Chlorellales;Prototheca;";"0.0";"0";"10";"10";"0";"10";"0";"457173";"391207"
"V4mis2";"SILVA (only NR);Eukaryota;Archaeplastida;Chloroplastida;Chlorophyta;Trebouxiophyceae;Chlorellales;Quadricoccus;";"0.0";"0";"1";"1";"0";"1";"0";"457182";"391207"
"V4mis2";"SILVA (only NR);Eukaryota;Archaeplastida;Chloroplastida;Chlorophyta;Trebouxiophyceae;Chlorellales;Tetrachlorella;";"0.0";"0";"1";"1";"0";"1";"0";"457182";"391207"
"V4mis2";"SILVA (only NR);Eukaryota;Archaeplastida;Chloroplastida;Chlorophyta;Trebouxiophyceae;Chlorellales;Tetrastrum;";"0.0";"0";"3";"3";"0";"3";"0";"457180";"391207"
"V4mis2";"SILVA (only NR);Eukaryota;Archaeplastida;Chloroplastida;Chlorophyta;Trebouxiophyceae;Chlorellales;Viridiella;";"0.0";"0";"1";"1";"0";"1";"0";"457182";"391207"
"V4mis2";"SILVA (only NR);Eukaryota;Archaeplastida;Chloroplastida;Chlorophyta;Trebouxiophyceae;Ctenocladales;";"0.0";"0";"1";"1";"0";"1";"0";"457182";"391207"
"V4mis2";"SILVA (only NR);Eukaryota;Archaeplastida;Chloroplastida;Chlorophyta;Trebouxiophyceae;Ctenocladales;Leptosira;";"0.0";"0";"1";"1";"0";"1";"0";"457182";"391207"
"V4mis2";"SILVA (only NR);Eukaryota;Archaeplastida;Chloroplastida;Chlorophyta;Trebouxiophyceae;Incertae Sedis;";"1.1";"14.4";"94";"94";"1";"93";"0";"457089";"391206"
"V4mis2";"SILVA (only NR);Eukaryota;Archaeplastida;Chloroplastida;Chlorophyta;Trebouxiophyceae;Incertae Sedis;Actinastrum;";"0.0";"0";"2";"2";"0";"2";"0";"457181";"391207"
"V4mis2";"SILVA (only NR);Eukaryota;Archaeplastida;Chloroplastida;Chlorophyta;Trebouxiophyceae;Incertae Sedis;Botryococcus;";"6.3";"14.4";"16";"16";"1";"15";"0";"457167";"391206"
"V4mis2";"SILVA (only NR);Eukaryota;Archaeplastida;Chloroplastida;Chlorophyta;Trebouxiophyceae;Incertae Sedis;Chloroparva;";"0.0";"0";"2";"2";"0";"2";"0";"457181";"391207"
"V4mis2";"SILVA (only NR);Eukaryota;Archaeplastida;Chloroplastida;Chlorophyta;Trebouxiophyceae;Incertae Sedis;Chloropyrula;";"0.0";"0";"1";"1";"0";"1";"0";"457182";"391207"
"V4mis2";"SILVA (only NR);Eukaryota;Archaeplastida;Chloroplastida;Chlorophyta;Trebouxiophyceae;Incertae Sedis;Chlorosphaera;";"0.0";"0";"1";"1";"0";"1";"0";"457182";"391207"
"V4mis2";"SILVA (only NR);Eukaryota;Archaeplastida;Chloroplastida;Chlorophyta;Trebouxiophyceae;Incertae Sedis;Choricystis;";"0.0";"0";"2";"2";"0";"2";"0";"457181";"391207"
"V4mis2";"SILVA (only NR);Eukaryota;Archaeplastida;Chloroplastida;Chlorophyta;Trebouxiophyceae;Incertae Sedis;Coccomyxa;";"0.0";"0";"20";"20";"0";"20";"0";"457163";"391207"
"V4mis2";"SILVA (only NR);Eukaryota;Archaeplastida;Chloroplastida;Chlorophyta;Trebouxiophyceae;Incertae Sedis;Coenocystis;";"0.0";"0";"1";"1";"0";"1";"0";"457182";"391207"
"V4mis2";"SILVA (only NR);Eukaryota;Archaeplastida;Chloroplastida;Chlorophyta;Trebouxiophyceae;Incertae Sedis;Dictyosphaerium;";"0.0";"0";"8";"8";"0";"8";"0";"457175";"391207"
"V4mis2";"SILVA (only NR);Eukaryota;Archaeplastida;Chloroplastida;Chlorophyta;Trebouxiophyceae;Incertae Sedis;Gloeotila;";"0.0";"0";"2";"2";"0";"2";"0";"457181";"391207"
"V4mis2";"SILVA (only NR);Eukaryota;Archaeplastida;Chloroplastida;Chlorophyta;Trebouxiophyceae;Incertae Sedis;Heterochlorella;";"0.0";"0";"6";"6";"0";"6";"0";"457177";"391207"
"V4mis2";"SILVA (only NR);Eukaryota;Archaeplastida;Chloroplastida;Chlorophyta;Trebouxiophyceae;Incertae Sedis;Hindakia;";"0.0";"0";"1";"1";"0";"1";"0";"457182";"391207"
"V4mis2";"SILVA (only NR);Eukaryota;Archaeplastida;Chloroplastida;Chlorophyta;Trebouxiophyceae;Incertae Sedis;Kalinella;";"0.0";"0";"2";"2";"0";"2";"0";"457181";"391207"
"V4mis2";"SILVA (only NR);Eukaryota;Archaeplastida;Chloroplastida;Chlorophyta;Trebouxiophyceae;Incertae Sedis;Lemmermannia;";"0.0";"0";"4";"4";"0";"4";"0";"457179";"391207"
"V4mis2";"SILVA (only NR);Eukaryota;Archaeplastida;Chloroplastida;Chlorophyta;Trebouxiophyceae;Incertae Sedis;Leptochlorella;";"0.0";"0";"2";"2";"0";"2";"0";"457181";"391207"
"V4mis2";"SILVA (only NR);Eukaryota;Archaeplastida;Chloroplastida;Chlorophyta;Trebouxiophyceae;Incertae Sedis;Mucidosphaerium;";"0.0";"0";"2";"2";"0";"2";"0";"457181";"391207"
"V4mis2";"SILVA (only NR);Eukaryota;Archaeplastida;Chloroplastida;Chlorophyta;Trebouxiophyceae;Incertae Sedis;Muriella;";"0.0";"0";"1";"1";"0";"1";"0";"457182";"391207"
"V4mis2";"SILVA (only NR);Eukaryota;Archaeplastida;Chloroplastida;Chlorophyta;Trebouxiophyceae;Incertae Sedis;Mysteriochloris;";"0.0";"0";"1";"1";"0";"1";"0";"457182";"391207"
"V4mis2";"SILVA (only NR);Eukaryota;Archaeplastida;Chloroplastida;Chlorophyta;Trebouxiophyceae;Incertae Sedis;Neocystis;";"0.0";"0";"1";"1";"0";"1";"0";"457182";"391207"
"V4mis2";"SILVA (only NR);Eukaryota;Archaeplastida;Chloroplastida;Chlorophyta;Trebouxiophyceae;Incertae Sedis;Parachloroidium;";"0.0";"0";"1";"1";"0";"1";"0";"457182";"391207"
"V4mis2";"SILVA (only NR);Eukaryota;Archaeplastida;Chloroplastida;Chlorophyta;Trebouxiophyceae;Incertae Sedis;Parietochloris;";"0.0";"0";"1";"1";"0";"1";"0";"457182";"391207"
"V4mis2";"SILVA (only NR);Eukaryota;Archaeplastida;Chloroplastida;Chlorophyta;Trebouxiophyceae;Incertae Sedis;Picochlorum;";"0.0";"0";"13";"13";"0";"13";"0";"457170";"391207"
"V4mis2";"SILVA (only NR);Eukaryota;Archaeplastida;Chloroplastida;Chlorophyta;Trebouxiophyceae;Incertae Sedis;Pseudostichococcus;";"0.0";"0";"1";"1";"0";"1";"0";"457182";"391207"
"V4mis2";"SILVA (only NR);Eukaryota;Archaeplastida;Chloroplastida;Chlorophyta;Trebouxiophyceae;Incertae Sedis;Watanabea;";"0.0";"0";"1";"1";"0";"1";"0";"457182";"391207"
"V4mis2";"SILVA (only NR);Eukaryota;Archaeplastida;Chloroplastida;Chlorophyta;Trebouxiophyceae;Incertae Sedis;Xylochloris;";"0.0";"0";"2";"2";"0";"2";"0";"457181";"391207"
"V4mis2";"SILVA (only NR);Eukaryota;Archaeplastida;Chloroplastida;Chlorophyta;Trebouxiophyceae;Microthamniales;";"8.3";"14.4";"12";"12";"1";"11";"0";"457171";"391206"
"V4mis2";"SILVA (only NR);Eukaryota;Archaeplastida;Chloroplastida;Chlorophyta;Trebouxiophyceae;Microthamniales;Asterochloris;";"0.0";"0";"1";"1";"0";"1";"0";"457182";"391207"
"V4mis2";"SILVA (only NR);Eukaryota;Archaeplastida;Chloroplastida;Chlorophyta;Trebouxiophyceae;Microthamniales;Dictyochloropsis;";"0.0";"0";"3";"3";"0";"3";"0";"457180";"391207"
"V4mis2";"SILVA (only NR);Eukaryota;Archaeplastida;Chloroplastida;Chlorophyta;Trebouxiophyceae;Microthamniales;Elliptochloris;";"25.0";"14.4";"4";"4";"1";"3";"0";"457179";"391206"
"V4mis2";"SILVA (only NR);Eukaryota;Archaeplastida;Chloroplastida;Chlorophyta;Trebouxiophyceae;Microthamniales;Microthamnion;";"0.0";"0";"2";"2";"0";"2";"0";"457181";"391207"
"V4mis2";"SILVA (only NR);Eukaryota;Archaeplastida;Chloroplastida;Chlorophyta;Trebouxiophyceae;Microthamniales;Pseudomarvania;";"0.0";"0";"2";"2";"0";"2";"0";"457181";"391207"
"V4mis2";"SILVA (only NR);Eukaryota;Archaeplastida;Chloroplastida;Chlorophyta;Trebouxiophyceae;Prasiolales;";"0.0";"0";"26";"26";"0";"26";"0";"457157";"391207"
"V4mis2";"SILVA (only NR);Eukaryota;Archaeplastida;Chloroplastida;Chlorophyta;Trebouxiophyceae;Prasiolales;Desmococcus;";"0.0";"0";"1";"1";"0";"1";"0";"457182";"391207"
"V4mis2";"SILVA (only NR);Eukaryota;Archaeplastida;Chloroplastida;Chlorophyta;Trebouxiophyceae;Prasiolales;Koliella;";"0.0";"0";"4";"4";"0";"4";"0";"457179";"391207"
"V4mis2";"SILVA (only NR);Eukaryota;Archaeplastida;Chloroplastida;Chlorophyta;Trebouxiophyceae;Prasiolales;Pabia;";"0.0";"0";"1";"1";"0";"1";"0";"457182";"391207"
"V4mis2";"SILVA (only NR);Eukaryota;Archaeplastida;Chloroplastida;Chlorophyta;Trebouxiophyceae;Prasiolales;Prasiola;";"0.0";"0";"7";"7";"0";"7";"0";"457176";"391207"
"V4mis2";"SILVA (only NR);Eukaryota;Archaeplastida;Chloroplastida;Chlorophyta;Trebouxiophyceae;Prasiolales;Prasiolopsis;";"0.0";"0";"1";"1";"0";"1";"0";"457182";"391207"
"V4mis2";"SILVA (only NR);Eukaryota;Archaeplastida;Chloroplastida;Chlorophyta;Trebouxiophyceae;Prasiolales;Stichococcus;";"0.0";"0";"12";"12";"0";"12";"0";"457171";"391207"
"V4mis2";"SILVA (only NR);Eukaryota;Archaeplastida;Chloroplastida;Chlorophyta;Trebouxiophyceae;Trebouxiales;";"14.3";"14.4";"7";"7";"1";"6";"0";"457176";"391206"
"V4mis2";"SILVA (only NR);Eukaryota;Archaeplastida;Chloroplastida;Chlorophyta;Trebouxiophyceae;Trebouxiales;Myrmecia;";"33.3";"14.4";"3";"3";"1";"2";"0";"457180";"391206"
"V4mis2";"SILVA (only NR);Eukaryota;Archaeplastida;Chloroplastida;Chlorophyta;Trebouxiophyceae;Trebouxiales;Trebouxia;";"0.0";"0";"4";"4";"0";"4";"0";"457179";"391207"
"V4mis2";"SILVA (only NR);Eukaryota;Archaeplastida;Chloroplastida;Chlorophyta;Ulvophyceae;";"86.4";"14.4";"356";"331";"286";"45";"25";"456852";"390921"
"V4mis2";"SILVA (only NR);Eukaryota;Archaeplastida;Chloroplastida;Chlorophyta;Ulvophyceae;Bryopsidales;";"71.4";"14.4";"30";"7";"5";"2";"23";"457176";"391202"
"V4mis2";"SILVA (only NR);Eukaryota;Archaeplastida;Chloroplastida;Chlorophyta;Ulvophyceae;Bryopsidales;Bryopsis;";"100.0";"14.4";"1";"1";"1";"0";"0";"457182";"391206"
"V4mis2";"SILVA (only NR);Eukaryota;Archaeplastida;Chloroplastida;Chlorophyta;Ulvophyceae;Bryopsidales;Caulerpa;";"66.7";"14.4";"6";"6";"4";"2";"0";"457177";"391203"
"V4mis2";"SILVA (only NR);Eukaryota;Archaeplastida;Chloroplastida;Chlorophyta;Ulvophyceae;Bryopsidales;Chlorodesmis;";"0.0";"0";"2";"0";"0";"0";"2";"457183";"391207"
"V4mis2";"SILVA (only NR);Eukaryota;Archaeplastida;Chloroplastida;Chlorophyta;Ulvophyceae;Bryopsidales;Flabellia;";"0.0";"0";"1";"0";"0";"0";"1";"457183";"391207"
"V4mis2";"SILVA (only NR);Eukaryota;Archaeplastida;Chloroplastida;Chlorophyta;Ulvophyceae;Bryopsidales;Halimeda;";"0.0";"0";"12";"0";"0";"0";"12";"457183";"391207"
"V4mis2";"SILVA (only NR);Eukaryota;Archaeplastida;Chloroplastida;Chlorophyta;Ulvophyceae;Bryopsidales;Penicillus;";"0.0";"0";"2";"0";"0";"0";"2";"457183";"391207"
"V4mis2";"SILVA (only NR);Eukaryota;Archaeplastida;Chloroplastida;Chlorophyta;Ulvophyceae;Bryopsidales;Udotea;";"0.0";"0";"6";"0";"0";"0";"6";"457183";"391207"
"V4mis2";"SILVA (only NR);Eukaryota;Archaeplastida;Chloroplastida;Chlorophyta;Ulvophyceae;Chlorocystidales;";"100.0";"14.4";"2";"2";"2";"0";"0";"457181";"391205"
"V4mis2";"SILVA (only NR);Eukaryota;Archaeplastida;Chloroplastida;Chlorophyta;Ulvophyceae;Chlorocystidales;Desmochloris;";"100.0";"14.4";"2";"2";"2";"0";"0";"457181";"391205"
"V4mis2";"SILVA (only NR);Eukaryota;Archaeplastida;Chloroplastida;Chlorophyta;Ulvophyceae;Cladophorales;";"84.9";"14.4";"73";"73";"62";"11";"0";"457110";"391145"
"V4mis2";"SILVA (only NR);Eukaryota;Archaeplastida;Chloroplastida;Chlorophyta;Ulvophyceae;Cladophorales;Aegagropila;";"100.0";"14.4";"1";"1";"1";"0";"0";"457182";"391206"
"V4mis2";"SILVA (only NR);Eukaryota;Archaeplastida;Chloroplastida;Chlorophyta;Ulvophyceae;Cladophorales;Aegagropilopsis;";"75.0";"14.4";"4";"4";"3";"1";"0";"457179";"391204"
"V4mis2";"SILVA (only NR);Eukaryota;Archaeplastida;Chloroplastida;Chlorophyta;Ulvophyceae;Cladophorales;Arnoldiella;";"100.0";"14.4";"2";"2";"2";"0";"0";"457181";"391205"
"V4mis2";"SILVA (only NR);Eukaryota;Archaeplastida;Chloroplastida;Chlorophyta;Ulvophyceae;Cladophorales;Boergesenia;";"66.7";"14.4";"3";"3";"2";"1";"0";"457180";"391205"
"V4mis2";"SILVA (only NR);Eukaryota;Archaeplastida;Chloroplastida;Chlorophyta;Ulvophyceae;Cladophorales;Chaetomorpha;";"100.0";"14.4";"14";"14";"14";"0";"0";"457169";"391193"
"V4mis2";"SILVA (only NR);Eukaryota;Archaeplastida;Chloroplastida;Chlorophyta;Ulvophyceae;Cladophorales;Chamaedoris;";"0.0";"0";"1";"1";"0";"1";"0";"457182";"391207"
"V4mis2";"SILVA (only NR);Eukaryota;Archaeplastida;Chloroplastida;Chlorophyta;Ulvophyceae;Cladophorales;Cladophora;";"76.5";"14.4";"17";"17";"13";"4";"0";"457166";"391194"
"V4mis2";"SILVA (only NR);Eukaryota;Archaeplastida;Chloroplastida;Chlorophyta;Ulvophyceae;Cladophorales;Cladophoropsis;";"100.0";"14.4";"2";"2";"2";"0";"0";"457181";"391205"
"V4mis2";"SILVA (only NR);Eukaryota;Archaeplastida;Chloroplastida;Chlorophyta;Ulvophyceae;Cladophorales;Dictyosphaeria;";"100.0";"14.4";"1";"1";"1";"0";"0";"457182";"391206"
"V4mis2";"SILVA (only NR);Eukaryota;Archaeplastida;Chloroplastida;Chlorophyta;Ulvophyceae;Cladophorales;Ernodesmis;";"100.0";"14.4";"2";"2";"2";"0";"0";"457181";"391205"
"V4mis2";"SILVA (only NR);Eukaryota;Archaeplastida;Chloroplastida;Chlorophyta;Ulvophyceae;Cladophorales;Phyllodictyon;";"100.0";"14.4";"1";"1";"1";"0";"0";"457182";"391206"
"V4mis2";"SILVA (only NR);Eukaryota;Archaeplastida;Chloroplastida;Chlorophyta;Ulvophyceae;Cladophorales;Pseudocladophora;";"100.0";"14.4";"1";"1";"1";"0";"0";"457182";"391206"
"V4mis2";"SILVA (only NR);Eukaryota;Archaeplastida;Chloroplastida;Chlorophyta;Ulvophyceae;Cladophorales;Rhizoclonium;";"100.0";"14.4";"10";"10";"10";"0";"0";"457173";"391197"
"V4mis2";"SILVA (only NR);Eukaryota;Archaeplastida;Chloroplastida;Chlorophyta;Ulvophyceae;Cladophorales;Siphonocladus;";"100.0";"14.4";"1";"1";"1";"0";"0";"457182";"391206"
"V4mis2";"SILVA (only NR);Eukaryota;Archaeplastida;Chloroplastida;Chlorophyta;Ulvophyceae;Cladophorales;Spongiochrysis;";"100.0";"14.4";"1";"1";"1";"0";"0";"457182";"391206"
"V4mis2";"SILVA (only NR);Eukaryota;Archaeplastida;Chloroplastida;Chlorophyta;Ulvophyceae;Cladophorales;Valonia;";"50.0";"14.4";"8";"8";"4";"4";"0";"457175";"391203"
"V4mis2";"SILVA (only NR);Eukaryota;Archaeplastida;Chloroplastida;Chlorophyta;Ulvophyceae;Cladophorales;Valoniopsis;";"100.0";"14.4";"1";"1";"1";"0";"0";"457182";"391206"
"V4mis2";"SILVA (only NR);Eukaryota;Archaeplastida;Chloroplastida;Chlorophyta;Ulvophyceae;Cladophorales;Ventricaria;";"100.0";"14.4";"1";"1";"1";"0";"0";"457182";"391206"
"V4mis2";"SILVA (only NR);Eukaryota;Archaeplastida;Chloroplastida;Chlorophyta;Ulvophyceae;Cladophorales;Wittrockiella;";"100.0";"14.4";"2";"2";"2";"0";"0";"457181";"391205"
"V4mis2";"SILVA (only NR);Eukaryota;Archaeplastida;Chloroplastida;Chlorophyta;Ulvophyceae;Dasycladales;";"0.0";"0";"20";"20";"0";"20";"0";"457163";"391207"
"V4mis2";"SILVA (only NR);Eukaryota;Archaeplastida;Chloroplastida;Chlorophyta;Ulvophyceae;Dasycladales;Acetabularia;";"0.0";"0";"10";"10";"0";"10";"0";"457173";"391207"
"V4mis2";"SILVA (only NR);Eukaryota;Archaeplastida;Chloroplastida;Chlorophyta;Ulvophyceae;Dasycladales;Batophora;";"0.0";"0";"1";"1";"0";"1";"0";"457182";"391207"
"V4mis2";"SILVA (only NR);Eukaryota;Archaeplastida;Chloroplastida;Chlorophyta;Ulvophyceae;Dasycladales;Bornetella;";"0.0";"0";"1";"1";"0";"1";"0";"457182";"391207"
"V4mis2";"SILVA (only NR);Eukaryota;Archaeplastida;Chloroplastida;Chlorophyta;Ulvophyceae;Dasycladales;Chalmasia;";"0.0";"0";"1";"1";"0";"1";"0";"457182";"391207"
"V4mis2";"SILVA (only NR);Eukaryota;Archaeplastida;Chloroplastida;Chlorophyta;Ulvophyceae;Dasycladales;Cymopolia;";"0.0";"0";"1";"1";"0";"1";"0";"457182";"391207"
"V4mis2";"SILVA (only NR);Eukaryota;Archaeplastida;Chloroplastida;Chlorophyta;Ulvophyceae;Dasycladales;Neomeris;";"0.0";"0";"1";"1";"0";"1";"0";"457182";"391207"
"V4mis2";"SILVA (only NR);Eukaryota;Archaeplastida;Chloroplastida;Chlorophyta;Ulvophyceae;Dasycladales;Parvocaulis;";"0.0";"0";"5";"5";"0";"5";"0";"457178";"391207"
"V4mis2";"SILVA (only NR);Eukaryota;Archaeplastida;Chloroplastida;Chlorophyta;Ulvophyceae;Incertae Sedis;";"100.0";"14.4";"2";"2";"2";"0";"0";"457181";"391205"
"V4mis2";"SILVA (only NR);Eukaryota;Archaeplastida;Chloroplastida;Chlorophyta;Ulvophyceae;Incertae Sedis;Dilabifilum;";"100.0";"14.4";"2";"2";"2";"0";"0";"457181";"391205"
"V4mis2";"SILVA (only NR);Eukaryota;Archaeplastida;Chloroplastida;Chlorophyta;Ulvophyceae;Oltmansiellopsidales;";"100.0";"14.4";"3";"3";"3";"0";"0";"457180";"391204"
"V4mis2";"SILVA (only NR);Eukaryota;Archaeplastida;Chloroplastida;Chlorophyta;Ulvophyceae;Oltmansiellopsidales;Oltmannsiellopsis;";"100.0";"14.4";"3";"3";"3";"0";"0";"457180";"391204"
"V4mis2";"SILVA (only NR);Eukaryota;Archaeplastida;Chloroplastida;Chlorophyta;Ulvophyceae;Scotinosphaerales;";"100.0";"14.4";"4";"4";"4";"0";"0";"457179";"391203"
"V4mis2";"SILVA (only NR);Eukaryota;Archaeplastida;Chloroplastida;Chlorophyta;Ulvophyceae;Scotinosphaerales;Scotinosphaera;";"100.0";"14.4";"4";"4";"4";"0";"0";"457179";"391203"
"V4mis2";"SILVA (only NR);Eukaryota;Archaeplastida;Chloroplastida;Chlorophyta;Ulvophyceae;Trentepohliales;";"96.6";"14.4";"88";"88";"85";"3";"0";"457095";"391122"
"V4mis2";"SILVA (only NR);Eukaryota;Archaeplastida;Chloroplastida;Chlorophyta;Ulvophyceae;Trentepohliales;Cephaleuros;";"100.0";"14.4";"16";"16";"16";"0";"0";"457167";"391191"
"V4mis2";"SILVA (only NR);Eukaryota;Archaeplastida;Chloroplastida;Chlorophyta;Ulvophyceae;Trentepohliales;Phycopeltis;";"100.0";"14.4";"6";"6";"6";"0";"0";"457177";"391201"
"V4mis2";"SILVA (only NR);Eukaryota;Archaeplastida;Chloroplastida;Chlorophyta;Ulvophyceae;Trentepohliales;Printzina;";"100.0";"14.4";"7";"7";"7";"0";"0";"457176";"391200"
"V4mis2";"SILVA (only NR);Eukaryota;Archaeplastida;Chloroplastida;Chlorophyta;Ulvophyceae;Trentepohliales;Stomatochroon;";"100.0";"14.4";"1";"1";"1";"0";"0";"457182";"391206"
"V4mis2";"SILVA (only NR);Eukaryota;Archaeplastida;Chloroplastida;Chlorophyta;Ulvophyceae;Trentepohliales;Trentepohlia;";"94.8";"14.4";"58";"58";"55";"3";"0";"457125";"391152"
"V4mis2";"SILVA (only NR);Eukaryota;Archaeplastida;Chloroplastida;Chlorophyta;Ulvophyceae;Ulotrichales;";"100.0";"14.4";"10";"10";"10";"0";"0";"457173";"391197"
"V4mis2";"SILVA (only NR);Eukaryota;Archaeplastida;Chloroplastida;Chlorophyta;Ulvophyceae;Ulotrichales;Acrosiphonia;";"100.0";"14.4";"2";"2";"2";"0";"0";"457181";"391205"
"V4mis2";"SILVA (only NR);Eukaryota;Archaeplastida;Chloroplastida;Chlorophyta;Ulvophyceae;Ulotrichales;Gloeotilopsis;";"100.0";"14.4";"1";"1";"1";"0";"0";"457182";"391206"
"V4mis2";"SILVA (only NR);Eukaryota;Archaeplastida;Chloroplastida;Chlorophyta;Ulvophyceae;Ulotrichales;Halochlorococcum;";"100.0";"14.4";"1";"1";"1";"0";"0";"457182";"391206"
"V4mis2";"SILVA (only NR);Eukaryota;Archaeplastida;Chloroplastida;Chlorophyta;Ulvophyceae;Ulotrichales;Hazenia;";"100.0";"14.4";"2";"2";"2";"0";"0";"457181";"391205"
"V4mis2";"SILVA (only NR);Eukaryota;Archaeplastida;Chloroplastida;Chlorophyta;Ulvophyceae;Ulotrichales;Kraftionema;";"100.0";"14.4";"1";"1";"1";"0";"0";"457182";"391206"
"V4mis2";"SILVA (only NR);Eukaryota;Archaeplastida;Chloroplastida;Chlorophyta;Ulvophyceae;Ulotrichales;Pseudoneochloris;";"100.0";"14.4";"1";"1";"1";"0";"0";"457182";"391206"
"V4mis2";"SILVA (only NR);Eukaryota;Archaeplastida;Chloroplastida;Chlorophyta;Ulvophyceae;Ulotrichales;Ulothrix;";"100.0";"14.4";"1";"1";"1";"0";"0";"457182";"391206"
"V4mis2";"SILVA (only NR);Eukaryota;Archaeplastida;Chloroplastida;Chlorophyta;Ulvophyceae;Ulotrichales;Urospora;";"100.0";"14.4";"1";"1";"1";"0";"0";"457182";"391206"
"V4mis2";"SILVA (only NR);Eukaryota;Archaeplastida;Chloroplastida;Chlorophyta;Ulvophyceae;Ulvales;";"97.2";"14.4";"36";"36";"35";"1";"0";"457147";"391172"
"V4mis2";"SILVA (only NR);Eukaryota;Archaeplastida;Chloroplastida;Chlorophyta;Ulvophyceae;Ulvales;Blidingia;";"100.0";"14.4";"2";"2";"2";"0";"0";"457181";"391205"
"V4mis2";"SILVA (only NR);Eukaryota;Archaeplastida;Chloroplastida;Chlorophyta;Ulvophyceae;Ulvales;Bolbocoleon;";"100.0";"14.4";"1";"1";"1";"0";"0";"457182";"391206"
"V4mis2";"SILVA (only NR);Eukaryota;Archaeplastida;Chloroplastida;Chlorophyta;Ulvophyceae;Ulvales;Cloniophora;";"100.0";"14.4";"1";"1";"1";"0";"0";"457182";"391206"
"V4mis2";"SILVA (only NR);Eukaryota;Archaeplastida;Chloroplastida;Chlorophyta;Ulvophyceae;Ulvales;Jaoa;";"100.0";"14.4";"1";"1";"1";"0";"0";"457182";"391206"
"V4mis2";"SILVA (only NR);Eukaryota;Archaeplastida;Chloroplastida;Chlorophyta;Ulvophyceae;Ulvales;Monostroma;";"100.0";"14.4";"2";"2";"2";"0";"0";"457181";"391205"
"V4mis2";"SILVA (only NR);Eukaryota;Archaeplastida;Chloroplastida;Chlorophyta;Ulvophyceae;Ulvales;Ochlochaete;";"100.0";"14.4";"3";"3";"3";"0";"0";"457180";"391204"
"V4mis2";"SILVA (only NR);Eukaryota;Archaeplastida;Chloroplastida;Chlorophyta;Ulvophyceae;Ulvales;Phaeophila;";"100.0";"14.4";"3";"3";"3";"0";"0";"457180";"391204"
"V4mis2";"SILVA (only NR);Eukaryota;Archaeplastida;Chloroplastida;Chlorophyta;Ulvophyceae;Ulvales;Pseudendoclonium;";"100.0";"14.4";"4";"4";"4";"0";"0";"457179";"391203"
"V4mis2";"SILVA (only NR);Eukaryota;Archaeplastida;Chloroplastida;Chlorophyta;Ulvophyceae;Ulvales;Ruthnielsenia;";"100.0";"14.4";"1";"1";"1";"0";"0";"457182";"391206"
"V4mis2";"SILVA (only NR);Eukaryota;Archaeplastida;Chloroplastida;Chlorophyta;Ulvophyceae;Ulvales;Ulva;";"100.0";"14.4";"10";"10";"10";"0";"0";"457173";"391197"
"V4mis2";"SILVA (only NR);Eukaryota;Archaeplastida;Chloroplastida;Chlorophyta;Ulvophyceae;Ulvales;Ulvaria;";"100.0";"14.4";"1";"1";"1";"0";"0";"457182";"391206"
"V4mis2";"SILVA (only NR);Eukaryota;Archaeplastida;Chloroplastida;Chlorophyta;Ulvophyceae;Ulvales;Ulvella;";"83.3";"14.4";"6";"6";"5";"1";"0";"457177";"391202"
"V4mis2";"SILVA (only NR);Eukaryota;Archaeplastida;Chloroplastida;Chlorophyta;Ulvophyceae;Ulvales;Umbraulva;";"100.0";"14.4";"1";"1";"1";"0";"0";"457182";"391206"
"V4mis2";"SILVA (only NR);Eukaryota;Archaeplastida;Glaucophyta;";"0.0";"0";"8";"8";"0";"8";"0";"457175";"391207"
"V4mis2";"SILVA (only NR);Eukaryota;Archaeplastida;Glaucophyta;Cyanophora;";"0.0";"0";"2";"2";"0";"2";"0";"457181";"391207"
"V4mis2";"SILVA (only NR);Eukaryota;Archaeplastida;Glaucophyta;Cyanoptyche;";"0.0";"0";"1";"1";"0";"1";"0";"457182";"391207"
"V4mis2";"SILVA (only NR);Eukaryota;Archaeplastida;Glaucophyta;Glaucocystis;";"0.0";"0";"3";"3";"0";"3";"0";"457180";"391207"
"V4mis2";"SILVA (only NR);Eukaryota;Archaeplastida;Glaucophyta;Gloeochaete;";"0.0";"0";"1";"1";"0";"1";"0";"457182";"391207"
"V4mis2";"SILVA (only NR);Eukaryota;Archaeplastida;Rhodophyceae;";"5.6";"14.3";"881";"877";"49";"828";"4";"456306";"391158"
"V4mis2";"SILVA (only NR);Eukaryota;Archaeplastida;Rhodophyceae;Bangiales;";"0.7";"14.4";"147";"143";"1";"142";"4";"457040";"391206"
"V4mis2";"SILVA (only NR);Eukaryota;Archaeplastida;Rhodophyceae;Bangiales;Bangia;";"0.0";"0";"13";"12";"0";"12";"1";"457171";"391207"
"V4mis2";"SILVA (only NR);Eukaryota;Archaeplastida;Rhodophyceae;Bangiales;Dione;";"0.0";"0";"1";"1";"0";"1";"0";"457182";"391207"
"V4mis2";"SILVA (only NR);Eukaryota;Archaeplastida;Rhodophyceae;Bangiales;Fuscifolium;";"0.0";"0";"1";"1";"0";"1";"0";"457182";"391207"
"V4mis2";"SILVA (only NR);Eukaryota;Archaeplastida;Rhodophyceae;Bangiales;Lysithea;";"0.0";"0";"1";"1";"0";"1";"0";"457182";"391207"
"V4mis2";"SILVA (only NR);Eukaryota;Archaeplastida;Rhodophyceae;Bangiales;Minerva;";"0.0";"0";"1";"1";"0";"1";"0";"457182";"391207"
"V4mis2";"SILVA (only NR);Eukaryota;Archaeplastida;Rhodophyceae;Bangiales;Porphyra-Clymene;";"0.0";"0";"20";"20";"0";"20";"0";"457163";"391207"
"V4mis2";"SILVA (only NR);Eukaryota;Archaeplastida;Rhodophyceae;Bangiales;Porphyra-Clymene;Clymene;";"0.0";"0";"1";"1";"0";"1";"0";"457182";"391207"
"V4mis2";"SILVA (only NR);Eukaryota;Archaeplastida;Rhodophyceae;Bangiales;Porphyra-Pyropia;";"0.0";"0";"104";"101";"0";"101";"3";"457082";"391207"
"V4mis2";"SILVA (only NR);Eukaryota;Archaeplastida;Rhodophyceae;Bangiales;Porphyra-Pyropia;Boreophyllum;";"0.0";"0";"2";"2";"0";"2";"0";"457181";"391207"
"V4mis2";"SILVA (only NR);Eukaryota;Archaeplastida;Rhodophyceae;Bangiales;Porphyra-Pyropia;Pyropia;";"0.0";"0";"5";"5";"0";"5";"0";"457178";"391207"
"V4mis2";"SILVA (only NR);Eukaryota;Archaeplastida;Rhodophyceae;Bangiales;Porphyra-Pyropia;Wildemania;";"0.0";"0";"8";"8";"0";"8";"0";"457175";"391207"
"V4mis2";"SILVA (only NR);Eukaryota;Archaeplastida;Rhodophyceae;Bangiales;Porphyra;";"0.0";"0";"1";"1";"0";"1";"0";"457182";"391207"
"V4mis2";"SILVA (only NR);Eukaryota;Archaeplastida;Rhodophyceae;Bangiales;Pseudobangia;";"0.0";"0";"1";"1";"0";"1";"0";"457182";"391207"
"V4mis2";"SILVA (only NR);Eukaryota;Archaeplastida;Rhodophyceae;Compsopogonales;";"92.9";"14.4";"14";"14";"13";"1";"0";"457169";"391194"
"V4mis2";"SILVA (only NR);Eukaryota;Archaeplastida;Rhodophyceae;Compsopogonales;Chlidophyllon;";"100.0";"14.4";"1";"1";"1";"0";"0";"457182";"391206"
"V4mis2";"SILVA (only NR);Eukaryota;Archaeplastida;Rhodophyceae;Compsopogonales;Compsopogon;";"100.0";"14.4";"2";"2";"2";"0";"0";"457181";"391205"
"V4mis2";"SILVA (only NR);Eukaryota;Archaeplastida;Rhodophyceae;Compsopogonales;Compsopogonopsis;";"100.0";"14.4";"1";"1";"1";"0";"0";"457182";"391206"
"V4mis2";"SILVA (only NR);Eukaryota;Archaeplastida;Rhodophyceae;Compsopogonales;Erythrotrichia;";"100.0";"14.4";"1";"1";"1";"0";"0";"457182";"391206"
"V4mis2";"SILVA (only NR);Eukaryota;Archaeplastida;Rhodophyceae;Compsopogonales;Madagascaria;";"100.0";"14.4";"1";"1";"1";"0";"0";"457182";"391206"
"V4mis2";"SILVA (only NR);Eukaryota;Archaeplastida;Rhodophyceae;Compsopogonales;Pyrophyllon;";"100.0";"14.4";"2";"2";"2";"0";"0";"457181";"391205"
"V4mis2";"SILVA (only NR);Eukaryota;Archaeplastida;Rhodophyceae;Compsopogonales;Rhodochaete;";"100.0";"14.4";"1";"1";"1";"0";"0";"457182";"391206"
"V4mis2";"SILVA (only NR);Eukaryota;Archaeplastida;Rhodophyceae;Compsopogonales;Sahlingia;";"0.0";"0";"1";"1";"0";"1";"0";"457182";"391207"
"V4mis2";"SILVA (only NR);Eukaryota;Archaeplastida;Rhodophyceae;Compsopogonales;Smithora;";"100.0";"14.4";"1";"1";"1";"0";"0";"457182";"391206"
"V4mis2";"SILVA (only NR);Eukaryota;Archaeplastida;Rhodophyceae;Cyanidiales;";"86.7";"14.4";"15";"15";"13";"2";"0";"457168";"391194"
"V4mis2";"SILVA (only NR);Eukaryota;Archaeplastida;Rhodophyceae;Cyanidiales;Cyanidioschyzon;";"100.0";"14.4";"2";"2";"2";"0";"0";"457181";"391205"
"V4mis2";"SILVA (only NR);Eukaryota;Archaeplastida;Rhodophyceae;Cyanidiales;Cyanidium;";"100.0";"14.4";"2";"2";"2";"0";"0";"457181";"391205"
"V4mis2";"SILVA (only NR);Eukaryota;Archaeplastida;Rhodophyceae;Cyanidiales;Galdieria;";"100.0";"14.4";"8";"8";"8";"0";"0";"457175";"391199"
"V4mis2";"SILVA (only NR);Eukaryota;Archaeplastida;Rhodophyceae;Cyanidiales;uncultured;";"0.0";"0";"2";"2";"0";"2";"0";"457181";"391207"
"V4mis2";"SILVA (only NR);Eukaryota;Archaeplastida;Rhodophyceae;Florideophycidae;";"2.2";"14.3";"671";"671";"15";"656";"0";"456512";"391192"
"V4mis2";"SILVA (only NR);Eukaryota;Archaeplastida;Rhodophyceae;Florideophycidae;Ahnfeltiophycidae;";"0.0";"0";"2";"2";"0";"2";"0";"457181";"391207"
"V4mis2";"SILVA (only NR);Eukaryota;Archaeplastida;Rhodophyceae;Florideophycidae;Ahnfeltiophycidae;Ahnfeltia;";"0.0";"0";"1";"1";"0";"1";"0";"457182";"391207"
"V4mis2";"SILVA (only NR);Eukaryota;Archaeplastida;Rhodophyceae;Florideophycidae;Ahnfeltiophycidae;Pihiella;";"0.0";"0";"1";"1";"0";"1";"0";"457182";"391207"
"V4mis2";"SILVA (only NR);Eukaryota;Archaeplastida;Rhodophyceae;Florideophycidae;Corallinophycidae;";"0.6";"14.4";"162";"162";"1";"161";"0";"457021";"391206"
"V4mis2";"SILVA (only NR);Eukaryota;Archaeplastida;Rhodophyceae;Florideophycidae;Corallinophycidae;Amphiroa;";"0.0";"0";"7";"7";"0";"7";"0";"457176";"391207"
"V4mis2";"SILVA (only NR);Eukaryota;Archaeplastida;Rhodophyceae;Florideophycidae;Corallinophycidae;Arthrocardia;";"0.0";"0";"3";"3";"0";"3";"0";"457180";"391207"
"V4mis2";"SILVA (only NR);Eukaryota;Archaeplastida;Rhodophyceae;Florideophycidae;Corallinophycidae;Bossiella;";"0.0";"0";"1";"1";"0";"1";"0";"457182";"391207"
"V4mis2";"SILVA (only NR);Eukaryota;Archaeplastida;Rhodophyceae;Florideophycidae;Corallinophycidae;Callilithophytum;";"0.0";"0";"1";"1";"0";"1";"0";"457182";"391207"
"V4mis2";"SILVA (only NR);Eukaryota;Archaeplastida;Rhodophyceae;Florideophycidae;Corallinophycidae;Cheilosporum;";"0.0";"0";"1";"1";"0";"1";"0";"457182";"391207"
"V4mis2";"SILVA (only NR);Eukaryota;Archaeplastida;Rhodophyceae;Florideophycidae;Corallinophycidae;Clathromorphum;";"0.0";"0";"1";"1";"0";"1";"0";"457182";"391207"
"V4mis2";"SILVA (only NR);Eukaryota;Archaeplastida;Rhodophyceae;Florideophycidae;Corallinophycidae;Corallina;";"0.0";"0";"3";"3";"0";"3";"0";"457180";"391207"
"V4mis2";"SILVA (only NR);Eukaryota;Archaeplastida;Rhodophyceae;Florideophycidae;Corallinophycidae;Ellisolandia;";"0.0";"0";"1";"1";"0";"1";"0";"457182";"391207"
"V4mis2";"SILVA (only NR);Eukaryota;Archaeplastida;Rhodophyceae;Florideophycidae;Corallinophycidae;Haliptilon;";"0.0";"0";"1";"1";"0";"1";"0";"457182";"391207"
"V4mis2";"SILVA (only NR);Eukaryota;Archaeplastida;Rhodophyceae;Florideophycidae;Corallinophycidae;Heydrichia;";"0.0";"0";"3";"3";"0";"3";"0";"457180";"391207"
"V4mis2";"SILVA (only NR);Eukaryota;Archaeplastida;Rhodophyceae;Florideophycidae;Corallinophycidae;Hydrolithon;";"0.0";"0";"20";"20";"0";"20";"0";"457163";"391207"
"V4mis2";"SILVA (only NR);Eukaryota;Archaeplastida;Rhodophyceae;Florideophycidae;Corallinophycidae;Jania;";"0.0";"0";"6";"6";"0";"6";"0";"457177";"391207"
"V4mis2";"SILVA (only NR);Eukaryota;Archaeplastida;Rhodophyceae;Florideophycidae;Corallinophycidae;Leptophytum;";"0.0";"0";"3";"3";"0";"3";"0";"457180";"391207"
"V4mis2";"SILVA (only NR);Eukaryota;Archaeplastida;Rhodophyceae;Florideophycidae;Corallinophycidae;Lithophyllum;";"0.0";"0";"11";"11";"0";"11";"0";"457172";"391207"
"V4mis2";"SILVA (only NR);Eukaryota;Archaeplastida;Rhodophyceae;Florideophycidae;Corallinophycidae;Lithothamnion;";"0.0";"0";"4";"4";"0";"4";"0";"457179";"391207"
"V4mis2";"SILVA (only NR);Eukaryota;Archaeplastida;Rhodophyceae;Florideophycidae;Corallinophycidae;Lithothrix;";"0.0";"0";"1";"1";"0";"1";"0";"457182";"391207"
"V4mis2";"SILVA (only NR);Eukaryota;Archaeplastida;Rhodophyceae;Florideophycidae;Corallinophycidae;Mastophora;";"0.0";"0";"3";"3";"0";"3";"0";"457180";"391207"
"V4mis2";"SILVA (only NR);Eukaryota;Archaeplastida;Rhodophyceae;Florideophycidae;Corallinophycidae;Mastophoropsis;";"0.0";"0";"1";"1";"0";"1";"0";"457182";"391207"
"V4mis2";"SILVA (only NR);Eukaryota;Archaeplastida;Rhodophyceae;Florideophycidae;Corallinophycidae;Mesophyllum;";"0.0";"0";"8";"8";"0";"8";"0";"457175";"391207"
"V4mis2";"SILVA (only NR);Eukaryota;Archaeplastida;Rhodophyceae;Florideophycidae;Corallinophycidae;Metagoniolithon;";"0.0";"0";"1";"1";"0";"1";"0";"457182";"391207"
"V4mis2";"SILVA (only NR);Eukaryota;Archaeplastida;Rhodophyceae;Florideophycidae;Corallinophycidae;Metamastophora;";"0.0";"0";"1";"1";"0";"1";"0";"457182";"391207"
"V4mis2";"SILVA (only NR);Eukaryota;Archaeplastida;Rhodophyceae;Florideophycidae;Corallinophycidae;Neogoniolithon;";"0.0";"0";"13";"13";"0";"13";"0";"457170";"391207"
"V4mis2";"SILVA (only NR);Eukaryota;Archaeplastida;Rhodophyceae;Florideophycidae;Corallinophycidae;Neopolyporolithon;";"0.0";"0";"1";"1";"0";"1";"0";"457182";"391207"
"V4mis2";"SILVA (only NR);Eukaryota;Archaeplastida;Rhodophyceae;Florideophycidae;Corallinophycidae;Phymatolithon;";"0.0";"0";"2";"2";"0";"2";"0";"457181";"391207"
"V4mis2";"SILVA (only NR);Eukaryota;Archaeplastida;Rhodophyceae;Florideophycidae;Corallinophycidae;Rhodogorgon;";"0.0";"0";"2";"2";"0";"2";"0";"457181";"391207"
"V4mis2";"SILVA (only NR);Eukaryota;Archaeplastida;Rhodophyceae;Florideophycidae;Corallinophycidae;Spongites;";"0.0";"0";"9";"9";"0";"9";"0";"457174";"391207"
"V4mis2";"SILVA (only NR);Eukaryota;Archaeplastida;Rhodophyceae;Florideophycidae;Corallinophycidae;Sporolithon;";"0.0";"0";"11";"11";"0";"11";"0";"457172";"391207"
"V4mis2";"SILVA (only NR);Eukaryota;Archaeplastida;Rhodophyceae;Florideophycidae;Corallinophycidae;Synarthrophyton;";"0.0";"0";"3";"3";"0";"3";"0";"457180";"391207"
"V4mis2";"SILVA (only NR);Eukaryota;Archaeplastida;Rhodophyceae;Florideophycidae;Corallinophycidae;Titanoderma;";"0.0";"0";"1";"1";"0";"1";"0";"457182";"391207"
"V4mis2";"SILVA (only NR);Eukaryota;Archaeplastida;Rhodophyceae;Florideophycidae;Hildenbrandiophycidae;";"0.0";"0";"29";"29";"0";"29";"0";"457154";"391207"
"V4mis2";"SILVA (only NR);Eukaryota;Archaeplastida;Rhodophyceae;Florideophycidae;Hildenbrandiophycidae;Apophlaea;";"0.0";"0";"2";"2";"0";"2";"0";"457181";"391207"
"V4mis2";"SILVA (only NR);Eukaryota;Archaeplastida;Rhodophyceae;Florideophycidae;Hildenbrandiophycidae;Hildenbrandia;";"0.0";"0";"25";"25";"0";"25";"0";"457158";"391207"
"V4mis2";"SILVA (only NR);Eukaryota;Archaeplastida;Rhodophyceae;Florideophycidae;Nemaliophycidae;";"0.0";"0";"43";"43";"0";"43";"0";"457140";"391207"
"V4mis2";"SILVA (only NR);Eukaryota;Archaeplastida;Rhodophyceae;Florideophycidae;Nemaliophycidae;Audouinella;";"0.0";"0";"2";"2";"0";"2";"0";"457181";"391207"
"V4mis2";"SILVA (only NR);Eukaryota;Archaeplastida;Rhodophyceae;Florideophycidae;Nemaliophycidae;Ballia;";"0.0";"0";"2";"2";"0";"2";"0";"457181";"391207"
"V4mis2";"SILVA (only NR);Eukaryota;Archaeplastida;Rhodophyceae;Florideophycidae;Nemaliophycidae;Balliopsis;";"0.0";"0";"1";"1";"0";"1";"0";"457182";"391207"
"V4mis2";"SILVA (only NR);Eukaryota;Archaeplastida;Rhodophyceae;Florideophycidae;Nemaliophycidae;Batrachospermum;";"0.0";"0";"6";"6";"0";"6";"0";"457177";"391207"
"V4mis2";"SILVA (only NR);Eukaryota;Archaeplastida;Rhodophyceae;Florideophycidae;Nemaliophycidae;Camontagnea;";"0.0";"0";"1";"1";"0";"1";"0";"457182";"391207"
"V4mis2";"SILVA (only NR);Eukaryota;Archaeplastida;Rhodophyceae;Florideophycidae;Nemaliophycidae;Chantransia;";"0.0";"0";"2";"2";"0";"2";"0";"457181";"391207"
"V4mis2";"SILVA (only NR);Eukaryota;Archaeplastida;Rhodophyceae;Florideophycidae;Nemaliophycidae;Colaconema;";"0.0";"0";"1";"1";"0";"1";"0";"457182";"391207"
"V4mis2";"SILVA (only NR);Eukaryota;Archaeplastida;Rhodophyceae;Florideophycidae;Nemaliophycidae;Cumagloia;";"0.0";"0";"1";"1";"0";"1";"0";"457182";"391207"
"V4mis2";"SILVA (only NR);Eukaryota;Archaeplastida;Rhodophyceae;Florideophycidae;Nemaliophycidae;Dichotomaria;";"0.0";"0";"1";"1";"0";"1";"0";"457182";"391207"
"V4mis2";"SILVA (only NR);Eukaryota;Archaeplastida;Rhodophyceae;Florideophycidae;Nemaliophycidae;Kumanoa;";"0.0";"0";"3";"3";"0";"3";"0";"457180";"391207"
"V4mis2";"SILVA (only NR);Eukaryota;Archaeplastida;Rhodophyceae;Florideophycidae;Nemaliophycidae;Nemalion;";"0.0";"0";"1";"1";"0";"1";"0";"457182";"391207"
"V4mis2";"SILVA (only NR);Eukaryota;Archaeplastida;Rhodophyceae;Florideophycidae;Nemaliophycidae;Nemalionopsis;";"0.0";"0";"1";"1";"0";"1";"0";"457182";"391207"
"V4mis2";"SILVA (only NR);Eukaryota;Archaeplastida;Rhodophyceae;Florideophycidae;Nemaliophycidae;Nothocladus;";"0.0";"0";"1";"1";"0";"1";"0";"457182";"391207"
"V4mis2";"SILVA (only NR);Eukaryota;Archaeplastida;Rhodophyceae;Florideophycidae;Nemaliophycidae;Nothogenia;";"0.0";"0";"1";"1";"0";"1";"0";"457182";"391207"
"V4mis2";"SILVA (only NR);Eukaryota;Archaeplastida;Rhodophyceae;Florideophycidae;Nemaliophycidae;Rhodachlya;";"0.0";"0";"1";"1";"0";"1";"0";"457182";"391207"
"V4mis2";"SILVA (only NR);Eukaryota;Archaeplastida;Rhodophyceae;Florideophycidae;Nemaliophycidae;Rhododraparnaldia;";"0.0";"0";"1";"1";"0";"1";"0";"457182";"391207"
"V4mis2";"SILVA (only NR);Eukaryota;Archaeplastida;Rhodophyceae;Florideophycidae;Nemaliophycidae;Rhodophysema;";"0.0";"0";"1";"1";"0";"1";"0";"457182";"391207"
"V4mis2";"SILVA (only NR);Eukaryota;Archaeplastida;Rhodophyceae;Florideophycidae;Nemaliophycidae;Sheathia;";"0.0";"0";"1";"1";"0";"1";"0";"457182";"391207"
"V4mis2";"SILVA (only NR);Eukaryota;Archaeplastida;Rhodophyceae;Florideophycidae;Nemaliophycidae;Stenopeltis;";"0.0";"0";"1";"1";"0";"1";"0";"457182";"391207"
"V4mis2";"SILVA (only NR);Eukaryota;Archaeplastida;Rhodophyceae;Florideophycidae;Nemaliophycidae;Thorea;";"0.0";"0";"8";"8";"0";"8";"0";"457175";"391207"
"V4mis2";"SILVA (only NR);Eukaryota;Archaeplastida;Rhodophyceae;Florideophycidae;Rhodymeniophycidae;";"3.2";"14.4";"435";"435";"14";"421";"0";"456748";"391193"
"V4mis2";"SILVA (only NR);Eukaryota;Archaeplastida;Rhodophyceae;Florideophycidae;Rhodymeniophycidae;Acrosymphyton;";"0.0";"0";"1";"1";"0";"1";"0";"457182";"391207"
"V4mis2";"SILVA (only NR);Eukaryota;Archaeplastida;Rhodophyceae;Florideophycidae;Rhodymeniophycidae;Acrotylus;";"0.0";"0";"1";"1";"0";"1";"0";"457182";"391207"
"V4mis2";"SILVA (only NR);Eukaryota;Archaeplastida;Rhodophyceae;Florideophycidae;Rhodymeniophycidae;Aglaothamnion;";"0.0";"0";"3";"3";"0";"3";"0";"457180";"391207"
"V4mis2";"SILVA (only NR);Eukaryota;Archaeplastida;Rhodophyceae;Florideophycidae;Rhodymeniophycidae;Amansia;";"0.0";"0";"2";"2";"0";"2";"0";"457181";"391207"
"V4mis2";"SILVA (only NR);Eukaryota;Archaeplastida;Rhodophyceae;Florideophycidae;Rhodymeniophycidae;Amphiplexia;";"0.0";"0";"1";"1";"0";"1";"0";"457182";"391207"
"V4mis2";"SILVA (only NR);Eukaryota;Archaeplastida;Rhodophyceae;Florideophycidae;Rhodymeniophycidae;Aneurianna;";"0.0";"0";"1";"1";"0";"1";"0";"457182";"391207"
"V4mis2";"SILVA (only NR);Eukaryota;Archaeplastida;Rhodophyceae;Florideophycidae;Rhodymeniophycidae;Anglaothamnion;";"0.0";"0";"1";"1";"0";"1";"0";"457182";"391207"
"V4mis2";"SILVA (only NR);Eukaryota;Archaeplastida;Rhodophyceae;Florideophycidae;Rhodymeniophycidae;Anotrichium;";"0.0";"0";"2";"2";"0";"2";"0";"457181";"391207"
"V4mis2";"SILVA (only NR);Eukaryota;Archaeplastida;Rhodophyceae;Florideophycidae;Rhodymeniophycidae;Antithamnion;";"0.0";"0";"1";"1";"0";"1";"0";"457182";"391207"
"V4mis2";"SILVA (only NR);Eukaryota;Archaeplastida;Rhodophyceae;Florideophycidae;Rhodymeniophycidae;Antithamnionella;";"0.0";"0";"1";"1";"0";"1";"0";"457182";"391207"
"V4mis2";"SILVA (only NR);Eukaryota;Archaeplastida;Rhodophyceae;Florideophycidae;Rhodymeniophycidae;Antrocentrum;";"0.0";"0";"1";"1";"0";"1";"0";"457182";"391207"
"V4mis2";"SILVA (only NR);Eukaryota;Archaeplastida;Rhodophyceae;Florideophycidae;Rhodymeniophycidae;Aphanta;";"0.0";"0";"1";"1";"0";"1";"0";"457182";"391207"
"V4mis2";"SILVA (only NR);Eukaryota;Archaeplastida;Rhodophyceae;Florideophycidae;Rhodymeniophycidae;Asparagopsis;";"0.0";"0";"2";"2";"0";"2";"0";"457181";"391207"
"V4mis2";"SILVA (only NR);Eukaryota;Archaeplastida;Rhodophyceae;Florideophycidae;Rhodymeniophycidae;Asteromenia;";"0.0";"0";"1";"1";"0";"1";"0";"457182";"391207"
"V4mis2";"SILVA (only NR);Eukaryota;Archaeplastida;Rhodophyceae;Florideophycidae;Rhodymeniophycidae;Atractophora;";"0.0";"0";"1";"1";"0";"1";"0";"457182";"391207"
"V4mis2";"SILVA (only NR);Eukaryota;Archaeplastida;Rhodophyceae;Florideophycidae;Rhodymeniophycidae;Austroclonium;";"0.0";"0";"1";"1";"0";"1";"0";"457182";"391207"
"V4mis2";"SILVA (only NR);Eukaryota;Archaeplastida;Rhodophyceae;Florideophycidae;Rhodymeniophycidae;Betaphycus;";"0.0";"0";"1";"1";"0";"1";"0";"457182";"391207"
"V4mis2";"SILVA (only NR);Eukaryota;Archaeplastida;Rhodophyceae;Florideophycidae;Rhodymeniophycidae;Boergeseniella;";"0.0";"0";"1";"1";"0";"1";"0";"457182";"391207"
"V4mis2";"SILVA (only NR);Eukaryota;Archaeplastida;Rhodophyceae;Florideophycidae;Rhodymeniophycidae;Bonnemaisonia;";"0.0";"0";"3";"3";"0";"3";"0";"457180";"391207"
"V4mis2";"SILVA (only NR);Eukaryota;Archaeplastida;Rhodophyceae;Florideophycidae;Rhodymeniophycidae;Bostrychia;";"0.0";"0";"4";"4";"0";"4";"0";"457179";"391207"
"V4mis2";"SILVA (only NR);Eukaryota;Archaeplastida;Rhodophyceae;Florideophycidae;Rhodymeniophycidae;Bostrychiocolax;";"0.0";"0";"1";"1";"0";"1";"0";"457182";"391207"
"V4mis2";"SILVA (only NR);Eukaryota;Archaeplastida;Rhodophyceae;Florideophycidae;Rhodymeniophycidae;Botryocladia;";"0.0";"0";"2";"2";"0";"2";"0";"457181";"391207"
"V4mis2";"SILVA (only NR);Eukaryota;Archaeplastida;Rhodophyceae;Florideophycidae;Rhodymeniophycidae;Calliblepharis;";"0.0";"0";"6";"6";"0";"6";"0";"457177";"391207"
"V4mis2";"SILVA (only NR);Eukaryota;Archaeplastida;Rhodophyceae;Florideophycidae;Rhodymeniophycidae;Callithamnion;";"0.0";"0";"2";"2";"0";"2";"0";"457181";"391207"
"V4mis2";"SILVA (only NR);Eukaryota;Archaeplastida;Rhodophyceae;Florideophycidae;Rhodymeniophycidae;Callophycus;";"0.0";"0";"1";"1";"0";"1";"0";"457182";"391207"
"V4mis2";"SILVA (only NR);Eukaryota;Archaeplastida;Rhodophyceae;Florideophycidae;Rhodymeniophycidae;Callophyllis;";"0.0";"0";"1";"1";"0";"1";"0";"457182";"391207"
"V4mis2";"SILVA (only NR);Eukaryota;Archaeplastida;Rhodophyceae;Florideophycidae;Rhodymeniophycidae;Caloglossa;";"0.0";"0";"5";"5";"0";"5";"0";"457178";"391207"
"V4mis2";"SILVA (only NR);Eukaryota;Archaeplastida;Rhodophyceae;Florideophycidae;Rhodymeniophycidae;Carpothamnion;";"0.0";"0";"1";"1";"0";"1";"0";"457182";"391207"
"V4mis2";"SILVA (only NR);Eukaryota;Archaeplastida;Rhodophyceae;Florideophycidae;Rhodymeniophycidae;Catenella;";"0.0";"0";"1";"1";"0";"1";"0";"457182";"391207"
"V4mis2";"SILVA (only NR);Eukaryota;Archaeplastida;Rhodophyceae;Florideophycidae;Rhodymeniophycidae;Caulacanthus;";"0.0";"0";"1";"1";"0";"1";"0";"457182";"391207"
"V4mis2";"SILVA (only NR);Eukaryota;Archaeplastida;Rhodophyceae;Florideophycidae;Rhodymeniophycidae;Centroceras;";"75.0";"14.4";"4";"4";"3";"1";"0";"457179";"391204"
"V4mis2";"SILVA (only NR);Eukaryota;Archaeplastida;Rhodophyceae;Florideophycidae;Rhodymeniophycidae;Cephalocystis;";"0.0";"0";"1";"1";"0";"1";"0";"457182";"391207"
"V4mis2";"SILVA (only NR);Eukaryota;Archaeplastida;Rhodophyceae;Florideophycidae;Rhodymeniophycidae;Ceramium;";"0.0";"0";"9";"9";"0";"9";"0";"457174";"391207"
"V4mis2";"SILVA (only NR);Eukaryota;Archaeplastida;Rhodophyceae;Florideophycidae;Rhodymeniophycidae;Ceratodictyon;";"0.0";"0";"1";"1";"0";"1";"0";"457182";"391207"
"V4mis2";"SILVA (only NR);Eukaryota;Archaeplastida;Rhodophyceae;Florideophycidae;Rhodymeniophycidae;Champia;";"0.0";"0";"9";"9";"0";"9";"0";"457174";"391207"
"V4mis2";"SILVA (only NR);Eukaryota;Archaeplastida;Rhodophyceae;Florideophycidae;Rhodymeniophycidae;Chondrus;";"0.0";"0";"2";"2";"0";"2";"0";"457181";"391207"
"V4mis2";"SILVA (only NR);Eukaryota;Archaeplastida;Rhodophyceae;Florideophycidae;Rhodymeniophycidae;Choreocolax;";"0.0";"0";"1";"1";"0";"1";"0";"457182";"391207"
"V4mis2";"SILVA (only NR);Eukaryota;Archaeplastida;Rhodophyceae;Florideophycidae;Rhodymeniophycidae;Chrysymenia;";"0.0";"0";"2";"2";"0";"2";"0";"457181";"391207"
"V4mis2";"SILVA (only NR);Eukaryota;Archaeplastida;Rhodophyceae;Florideophycidae;Rhodymeniophycidae;Chylocladia;";"0.0";"0";"2";"2";"0";"2";"0";"457181";"391207"
"V4mis2";"SILVA (only NR);Eukaryota;Archaeplastida;Rhodophyceae;Florideophycidae;Rhodymeniophycidae;Coelarthrum;";"100.0";"14.4";"1";"1";"1";"0";"0";"457182";"391206"
"V4mis2";"SILVA (only NR);Eukaryota;Archaeplastida;Rhodophyceae;Florideophycidae;Rhodymeniophycidae;Coelothrix;";"0.0";"0";"2";"2";"0";"2";"0";"457181";"391207"
"V4mis2";"SILVA (only NR);Eukaryota;Archaeplastida;Rhodophyceae;Florideophycidae;Rhodymeniophycidae;Compsothamnion;";"0.0";"0";"1";"1";"0";"1";"0";"457182";"391207"
"V4mis2";"SILVA (only NR);Eukaryota;Archaeplastida;Rhodophyceae;Florideophycidae;Rhodymeniophycidae;Constantinea;";"0.0";"0";"1";"1";"0";"1";"0";"457182";"391207"
"V4mis2";"SILVA (only NR);Eukaryota;Archaeplastida;Rhodophyceae;Florideophycidae;Rhodymeniophycidae;Cordylecladia;";"0.0";"0";"1";"1";"0";"1";"0";"457182";"391207"
"V4mis2";"SILVA (only NR);Eukaryota;Archaeplastida;Rhodophyceae;Florideophycidae;Rhodymeniophycidae;Corynocystis;";"0.0";"0";"1";"1";"0";"1";"0";"457182";"391207"
"V4mis2";"SILVA (only NR);Eukaryota;Archaeplastida;Rhodophyceae;Florideophycidae;Rhodymeniophycidae;Crassitegula;";"0.0";"0";"1";"1";"0";"1";"0";"457182";"391207"
"V4mis2";"SILVA (only NR);Eukaryota;Archaeplastida;Rhodophyceae;Florideophycidae;Rhodymeniophycidae;Cresia;";"0.0";"0";"1";"1";"0";"1";"0";"457182";"391207"
"V4mis2";"SILVA (only NR);Eukaryota;Archaeplastida;Rhodophyceae;Florideophycidae;Rhodymeniophycidae;Crouania;";"0.0";"0";"2";"2";"0";"2";"0";"457181";"391207"
"V4mis2";"SILVA (only NR);Eukaryota;Archaeplastida;Rhodophyceae;Florideophycidae;Rhodymeniophycidae;Cryptopleura;";"0.0";"0";"2";"2";"0";"2";"0";"457181";"391207"
"V4mis2";"SILVA (only NR);Eukaryota;Archaeplastida;Rhodophyceae;Florideophycidae;Rhodymeniophycidae;Cubiculosporum;";"0.0";"0";"1";"1";"0";"1";"0";"457182";"391207"
"V4mis2";"SILVA (only NR);Eukaryota;Archaeplastida;Rhodophyceae;Florideophycidae;Rhodymeniophycidae;Curdiea;";"0.0";"0";"2";"2";"0";"2";"0";"457181";"391207"
"V4mis2";"SILVA (only NR);Eukaryota;Archaeplastida;Rhodophyceae;Florideophycidae;Rhodymeniophycidae;Cystoclonium;";"0.0";"0";"1";"1";"0";"1";"0";"457182";"391207"
"V4mis2";"SILVA (only NR);Eukaryota;Archaeplastida;Rhodophyceae;Florideophycidae;Rhodymeniophycidae;Dasya;";"0.0";"0";"1";"1";"0";"1";"0";"457182";"391207"
"V4mis2";"SILVA (only NR);Eukaryota;Archaeplastida;Rhodophyceae;Florideophycidae;Rhodymeniophycidae;Dasyphloea;";"0.0";"0";"1";"1";"0";"1";"0";"457182";"391207"
"V4mis2";"SILVA (only NR);Eukaryota;Archaeplastida;Rhodophyceae;Florideophycidae;Rhodymeniophycidae;Dasysiphonia;";"0.0";"0";"1";"1";"0";"1";"0";"457182";"391207"
"V4mis2";"SILVA (only NR);Eukaryota;Archaeplastida;Rhodophyceae;Florideophycidae;Rhodymeniophycidae;Dasythamniella;";"0.0";"0";"1";"1";"0";"1";"0";"457182";"391207"
"V4mis2";"SILVA (only NR);Eukaryota;Archaeplastida;Rhodophyceae;Florideophycidae;Rhodymeniophycidae;Dawsoniocolax;";"0.0";"0";"1";"1";"0";"1";"0";"457182";"391207"
"V4mis2";"SILVA (only NR);Eukaryota;Archaeplastida;Rhodophyceae;Florideophycidae;Rhodymeniophycidae;Delisea;";"0.0";"0";"1";"1";"0";"1";"0";"457182";"391207"
"V4mis2";"SILVA (only NR);Eukaryota;Archaeplastida;Rhodophyceae;Florideophycidae;Rhodymeniophycidae;Diapse;";"0.0";"0";"1";"1";"0";"1";"0";"457182";"391207"
"V4mis2";"SILVA (only NR);Eukaryota;Archaeplastida;Rhodophyceae;Florideophycidae;Rhodymeniophycidae;Dicranema;";"0.0";"0";"1";"1";"0";"1";"0";"457182";"391207"
"V4mis2";"SILVA (only NR);Eukaryota;Archaeplastida;Rhodophyceae;Florideophycidae;Rhodymeniophycidae;Dictyothamnion;";"0.0";"0";"1";"1";"0";"1";"0";"457182";"391207"
"V4mis2";"SILVA (only NR);Eukaryota;Archaeplastida;Rhodophyceae;Florideophycidae;Rhodymeniophycidae;Dictyurus;";"0.0";"0";"1";"1";"0";"1";"0";"457182";"391207"
"V4mis2";"SILVA (only NR);Eukaryota;Archaeplastida;Rhodophyceae;Florideophycidae;Rhodymeniophycidae;Drouetia;";"0.0";"0";"1";"1";"0";"1";"0";"457182";"391207"
"V4mis2";"SILVA (only NR);Eukaryota;Archaeplastida;Rhodophyceae;Florideophycidae;Rhodymeniophycidae;Dudresnaya;";"0.0";"0";"1";"1";"0";"1";"0";"457182";"391207"
"V4mis2";"SILVA (only NR);Eukaryota;Archaeplastida;Rhodophyceae;Florideophycidae;Rhodymeniophycidae;Dumontia;";"0.0";"0";"1";"1";"0";"1";"0";"457182";"391207"
"V4mis2";"SILVA (only NR);Eukaryota;Archaeplastida;Rhodophyceae;Florideophycidae;Rhodymeniophycidae;Epiphloea;";"0.0";"0";"1";"1";"0";"1";"0";"457182";"391207"
"V4mis2";"SILVA (only NR);Eukaryota;Archaeplastida;Rhodophyceae;Florideophycidae;Rhodymeniophycidae;Erythrocolon;";"0.0";"0";"1";"1";"0";"1";"0";"457182";"391207"
"V4mis2";"SILVA (only NR);Eukaryota;Archaeplastida;Rhodophyceae;Florideophycidae;Rhodymeniophycidae;Erythronaema;";"0.0";"0";"1";"1";"0";"1";"0";"457182";"391207"
"V4mis2";"SILVA (only NR);Eukaryota;Archaeplastida;Rhodophyceae;Florideophycidae;Rhodymeniophycidae;Erythrophyllum;";"0.0";"0";"1";"1";"0";"1";"0";"457182";"391207"
"V4mis2";"SILVA (only NR);Eukaryota;Archaeplastida;Rhodophyceae;Florideophycidae;Rhodymeniophycidae;Erythrymenia;";"0.0";"0";"1";"1";"0";"1";"0";"457182";"391207"
"V4mis2";"SILVA (only NR);Eukaryota;Archaeplastida;Rhodophyceae;Florideophycidae;Rhodymeniophycidae;Eucheuma;";"0.0";"0";"1";"1";"0";"1";"0";"457182";"391207"
"V4mis2";"SILVA (only NR);Eukaryota;Archaeplastida;Rhodophyceae;Florideophycidae;Rhodymeniophycidae;Euptilocladia;";"0.0";"0";"1";"1";"0";"1";"0";"457182";"391207"
"V4mis2";"SILVA (only NR);Eukaryota;Archaeplastida;Rhodophyceae;Florideophycidae;Rhodymeniophycidae;Euptilota;";"0.0";"0";"3";"3";"0";"3";"0";"457180";"391207"
"V4mis2";"SILVA (only NR);Eukaryota;Archaeplastida;Rhodophyceae;Florideophycidae;Rhodymeniophycidae;Euthora;";"0.0";"0";"1";"1";"0";"1";"0";"457182";"391207"
"V4mis2";"SILVA (only NR);Eukaryota;Archaeplastida;Rhodophyceae;Florideophycidae;Rhodymeniophycidae;Fimbrifolium;";"0.0";"0";"1";"1";"0";"1";"0";"457182";"391207"
"V4mis2";"SILVA (only NR);Eukaryota;Archaeplastida;Rhodophyceae;Florideophycidae;Rhodymeniophycidae;Fryeella;";"0.0";"0";"1";"1";"0";"1";"0";"457182";"391207"
"V4mis2";"SILVA (only NR);Eukaryota;Archaeplastida;Rhodophyceae;Florideophycidae;Rhodymeniophycidae;Furcellaria;";"0.0";"0";"1";"1";"0";"1";"0";"457182";"391207"
"V4mis2";"SILVA (only NR);Eukaryota;Archaeplastida;Rhodophyceae;Florideophycidae;Rhodymeniophycidae;Gardneriella;";"0.0";"0";"1";"1";"0";"1";"0";"457182";"391207"
"V4mis2";"SILVA (only NR);Eukaryota;Archaeplastida;Rhodophyceae;Florideophycidae;Rhodymeniophycidae;Gastroclonium;";"0.0";"0";"1";"1";"0";"1";"0";"457182";"391207"
"V4mis2";"SILVA (only NR);Eukaryota;Archaeplastida;Rhodophyceae;Florideophycidae;Rhodymeniophycidae;Gelidiella;";"0.0";"0";"2";"2";"0";"2";"0";"457181";"391207"
"V4mis2";"SILVA (only NR);Eukaryota;Archaeplastida;Rhodophyceae;Florideophycidae;Rhodymeniophycidae;Gelidiopsis;";"0.0";"0";"1";"1";"0";"1";"0";"457182";"391207"
"V4mis2";"SILVA (only NR);Eukaryota;Archaeplastida;Rhodophyceae;Florideophycidae;Rhodymeniophycidae;Gelidium;";"0.0";"0";"3";"3";"0";"3";"0";"457180";"391207"
"V4mis2";"SILVA (only NR);Eukaryota;Archaeplastida;Rhodophyceae;Florideophycidae;Rhodymeniophycidae;Georgiella;";"0.0";"0";"1";"1";"0";"1";"0";"457182";"391207"
"V4mis2";"SILVA (only NR);Eukaryota;Archaeplastida;Rhodophyceae;Florideophycidae;Rhodymeniophycidae;Gibsmithia;";"0.0";"0";"1";"1";"0";"1";"0";"457182";"391207"
"V4mis2";"SILVA (only NR);Eukaryota;Archaeplastida;Rhodophyceae;Florideophycidae;Rhodymeniophycidae;Gloiocladia;";"0.0";"0";"6";"6";"0";"6";"0";"457177";"391207"
"V4mis2";"SILVA (only NR);Eukaryota;Archaeplastida;Rhodophyceae;Florideophycidae;Rhodymeniophycidae;Gloiopeltis;";"0.0";"0";"1";"1";"0";"1";"0";"457182";"391207"
"V4mis2";"SILVA (only NR);Eukaryota;Archaeplastida;Rhodophyceae;Florideophycidae;Rhodymeniophycidae;Gracilaria;";"9.1";"14.4";"11";"11";"1";"10";"0";"457172";"391206"
"V4mis2";"SILVA (only NR);Eukaryota;Archaeplastida;Rhodophyceae;Florideophycidae;Rhodymeniophycidae;Gracilariopsis;";"0.0";"0";"7";"7";"0";"7";"0";"457176";"391207"
"V4mis2";"SILVA (only NR);Eukaryota;Archaeplastida;Rhodophyceae;Florideophycidae;Rhodymeniophycidae;Grateloupia;";"0.0";"0";"2";"2";"0";"2";"0";"457181";"391207"
"V4mis2";"SILVA (only NR);Eukaryota;Archaeplastida;Rhodophyceae;Florideophycidae;Rhodymeniophycidae;Griffithsia;";"0.0";"0";"2";"2";"0";"2";"0";"457181";"391207"
"V4mis2";"SILVA (only NR);Eukaryota;Archaeplastida;Rhodophyceae;Florideophycidae;Rhodymeniophycidae;Grinnellia;";"0.0";"0";"1";"1";"0";"1";"0";"457182";"391207"
"V4mis2";"SILVA (only NR);Eukaryota;Archaeplastida;Rhodophyceae;Florideophycidae;Rhodymeniophycidae;Gulsonia;";"0.0";"0";"1";"1";"0";"1";"0";"457182";"391207"
"V4mis2";"SILVA (only NR);Eukaryota;Archaeplastida;Rhodophyceae;Florideophycidae;Rhodymeniophycidae;Halichrysis;";"0.0";"0";"1";"1";"0";"1";"0";"457182";"391207"
"V4mis2";"SILVA (only NR);Eukaryota;Archaeplastida;Rhodophyceae;Florideophycidae;Rhodymeniophycidae;Halopithys;";"0.0";"0";"1";"1";"0";"1";"0";"457182";"391207"
"V4mis2";"SILVA (only NR);Eukaryota;Archaeplastida;Rhodophyceae;Florideophycidae;Rhodymeniophycidae;Halurus;";"0.0";"0";"1";"1";"0";"1";"0";"457182";"391207"
"V4mis2";"SILVA (only NR);Eukaryota;Archaeplastida;Rhodophyceae;Florideophycidae;Rhodymeniophycidae;Halydictyon;";"0.0";"0";"1";"1";"0";"1";"0";"457182";"391207"
"V4mis2";"SILVA (only NR);Eukaryota;Archaeplastida;Rhodophyceae;Florideophycidae;Rhodymeniophycidae;Harveyella;";"0.0";"0";"2";"2";"0";"2";"0";"457181";"391207"
"V4mis2";"SILVA (only NR);Eukaryota;Archaeplastida;Rhodophyceae;Florideophycidae;Rhodymeniophycidae;Hemineura;";"0.0";"0";"1";"1";"0";"1";"0";"457182";"391207"
"V4mis2";"SILVA (only NR);Eukaryota;Archaeplastida;Rhodophyceae;Florideophycidae;Rhodymeniophycidae;Herposiphonia;";"0.0";"0";"3";"3";"0";"3";"0";"457180";"391207"
"V4mis2";"SILVA (only NR);Eukaryota;Archaeplastida;Rhodophyceae;Florideophycidae;Rhodymeniophycidae;Heterocladia;";"0.0";"0";"1";"1";"0";"1";"0";"457182";"391207"
"V4mis2";"SILVA (only NR);Eukaryota;Archaeplastida;Rhodophyceae;Florideophycidae;Rhodymeniophycidae;Heteroptilon;";"0.0";"0";"1";"1";"0";"1";"0";"457182";"391207"
"V4mis2";"SILVA (only NR);Eukaryota;Archaeplastida;Rhodophyceae;Florideophycidae;Rhodymeniophycidae;Heterosiphonia;";"100.0";"14.4";"3";"3";"3";"0";"0";"457180";"391204"
"V4mis2";"SILVA (only NR);Eukaryota;Archaeplastida;Rhodophyceae;Florideophycidae;Rhodymeniophycidae;Hummbrella;";"0.0";"0";"1";"1";"0";"1";"0";"457182";"391207"
"V4mis2";"SILVA (only NR);Eukaryota;Archaeplastida;Rhodophyceae;Florideophycidae;Rhodymeniophycidae;Hymenocladia;";"0.0";"0";"1";"1";"0";"1";"0";"457182";"391207"
"V4mis2";"SILVA (only NR);Eukaryota;Archaeplastida;Rhodophyceae;Florideophycidae;Rhodymeniophycidae;Hymenocladiopsis;";"0.0";"0";"1";"1";"0";"1";"0";"457182";"391207"
"V4mis2";"SILVA (only NR);Eukaryota;Archaeplastida;Rhodophyceae;Florideophycidae;Rhodymeniophycidae;Hypnea;";"0.0";"0";"2";"2";"0";"2";"0";"457181";"391207"
"V4mis2";"SILVA (only NR);Eukaryota;Archaeplastida;Rhodophyceae;Florideophycidae;Rhodymeniophycidae;Hypoglossum;";"0.0";"0";"1";"1";"0";"1";"0";"457182";"391207"
"V4mis2";"SILVA (only NR);Eukaryota;Archaeplastida;Rhodophyceae;Florideophycidae;Rhodymeniophycidae;Inkyuleea;";"0.0";"0";"1";"1";"0";"1";"0";"457182";"391207"
"V4mis2";"SILVA (only NR);Eukaryota;Archaeplastida;Rhodophyceae;Florideophycidae;Rhodymeniophycidae;Involucrana;";"0.0";"0";"1";"1";"0";"1";"0";"457182";"391207"
"V4mis2";"SILVA (only NR);Eukaryota;Archaeplastida;Rhodophyceae;Florideophycidae;Rhodymeniophycidae;Irvinea;";"0.0";"0";"1";"1";"0";"1";"0";"457182";"391207"
"V4mis2";"SILVA (only NR);Eukaryota;Archaeplastida;Rhodophyceae;Florideophycidae;Rhodymeniophycidae;Isabbottia;";"0.0";"0";"1";"1";"0";"1";"0";"457182";"391207"
"V4mis2";"SILVA (only NR);Eukaryota;Archaeplastida;Rhodophyceae;Florideophycidae;Rhodymeniophycidae;Kappaphycus;";"0.0";"0";"2";"2";"0";"2";"0";"457181";"391207"
"V4mis2";"SILVA (only NR);Eukaryota;Archaeplastida;Rhodophyceae;Florideophycidae;Rhodymeniophycidae;Kraftia;";"0.0";"0";"1";"1";"0";"1";"0";"457182";"391207"
"V4mis2";"SILVA (only NR);Eukaryota;Archaeplastida;Rhodophyceae;Florideophycidae;Rhodymeniophycidae;Kuetzingia;";"0.0";"0";"1";"1";"0";"1";"0";"457182";"391207"
"V4mis2";"SILVA (only NR);Eukaryota;Archaeplastida;Rhodophyceae;Florideophycidae;Rhodymeniophycidae;Laurencia;";"0.0";"0";"1";"1";"0";"1";"0";"457182";"391207"
"V4mis2";"SILVA (only NR);Eukaryota;Archaeplastida;Rhodophyceae;Florideophycidae;Rhodymeniophycidae;Leachiella;";"0.0";"0";"1";"1";"0";"1";"0";"457182";"391207"
"V4mis2";"SILVA (only NR);Eukaryota;Archaeplastida;Rhodophyceae;Florideophycidae;Rhodymeniophycidae;Lejolisia;";"0.0";"0";"1";"1";"0";"1";"0";"457182";"391207"
"V4mis2";"SILVA (only NR);Eukaryota;Archaeplastida;Rhodophyceae;Florideophycidae;Rhodymeniophycidae;Lembergia;";"0.0";"0";"1";"1";"0";"1";"0";"457182";"391207"
"V4mis2";"SILVA (only NR);Eukaryota;Archaeplastida;Rhodophyceae;Florideophycidae;Rhodymeniophycidae;Lenormandia;";"0.0";"0";"4";"4";"0";"4";"0";"457179";"391207"
"V4mis2";"SILVA (only NR);Eukaryota;Archaeplastida;Rhodophyceae;Florideophycidae;Rhodymeniophycidae;Leptosomia;";"0.0";"0";"1";"1";"0";"1";"0";"457182";"391207"
"V4mis2";"SILVA (only NR);Eukaryota;Archaeplastida;Rhodophyceae;Florideophycidae;Rhodymeniophycidae;Lesleigha;";"0.0";"0";"2";"2";"0";"2";"0";"457181";"391207"
"V4mis2";"SILVA (only NR);Eukaryota;Archaeplastida;Rhodophyceae;Florideophycidae;Rhodymeniophycidae;Lomentaria;";"0.0";"0";"2";"2";"0";"2";"0";"457181";"391207"
"V4mis2";"SILVA (only NR);Eukaryota;Archaeplastida;Rhodophyceae;Florideophycidae;Rhodymeniophycidae;Lophocladia;";"0.0";"0";"2";"2";"0";"2";"0";"457181";"391207"
"V4mis2";"SILVA (only NR);Eukaryota;Archaeplastida;Rhodophyceae;Florideophycidae;Rhodymeniophycidae;Lophothalia;";"0.0";"0";"1";"1";"0";"1";"0";"457182";"391207"
"V4mis2";"SILVA (only NR);Eukaryota;Archaeplastida;Rhodophyceae;Florideophycidae;Rhodymeniophycidae;Maripelta;";"0.0";"0";"1";"1";"0";"1";"0";"457182";"391207"
"V4mis2";"SILVA (only NR);Eukaryota;Archaeplastida;Rhodophyceae;Florideophycidae;Rhodymeniophycidae;Mastocarpus;";"0.0";"0";"1";"1";"0";"1";"0";"457182";"391207"
"V4mis2";"SILVA (only NR);Eukaryota;Archaeplastida;Rhodophyceae;Florideophycidae;Rhodymeniophycidae;Melanthalia;";"0.0";"0";"1";"1";"0";"1";"0";"457182";"391207"
"V4mis2";"SILVA (only NR);Eukaryota;Archaeplastida;Rhodophyceae;Florideophycidae;Rhodymeniophycidae;Micropeuce;";"0.0";"0";"1";"1";"0";"1";"0";"457182";"391207"
"V4mis2";"SILVA (only NR);Eukaryota;Archaeplastida;Rhodophyceae;Florideophycidae;Rhodymeniophycidae;Monosporus;";"0.0";"0";"1";"1";"0";"1";"0";"457182";"391207"
"V4mis2";"SILVA (only NR);Eukaryota;Archaeplastida;Rhodophyceae;Florideophycidae;Rhodymeniophycidae;Muellerena;";"0.0";"0";"1";"1";"0";"1";"0";"457182";"391207"
"V4mis2";"SILVA (only NR);Eukaryota;Archaeplastida;Rhodophyceae;Florideophycidae;Rhodymeniophycidae;Murrayella;";"0.0";"0";"1";"1";"0";"1";"0";"457182";"391207"
"V4mis2";"SILVA (only NR);Eukaryota;Archaeplastida;Rhodophyceae;Florideophycidae;Rhodymeniophycidae;Naccaria;";"0.0";"0";"1";"1";"0";"1";"0";"457182";"391207"
"V4mis2";"SILVA (only NR);Eukaryota;Archaeplastida;Rhodophyceae;Florideophycidae;Rhodymeniophycidae;Nemastoma;";"0.0";"0";"1";"1";"0";"1";"0";"457182";"391207"
"V4mis2";"SILVA (only NR);Eukaryota;Archaeplastida;Rhodophyceae;Florideophycidae;Rhodymeniophycidae;Neodilsea;";"0.0";"0";"1";"1";"0";"1";"0";"457182";"391207"
"V4mis2";"SILVA (only NR);Eukaryota;Archaeplastida;Rhodophyceae;Florideophycidae;Rhodymeniophycidae;Neorhodomela;";"0.0";"0";"1";"1";"0";"1";"0";"457182";"391207"
"V4mis2";"SILVA (only NR);Eukaryota;Archaeplastida;Rhodophyceae;Florideophycidae;Rhodymeniophycidae;Neosiphonia;";"0.0";"0";"6";"6";"0";"6";"0";"457177";"391207"
"V4mis2";"SILVA (only NR);Eukaryota;Archaeplastida;Rhodophyceae;Florideophycidae;Rhodymeniophycidae;Neurymenia;";"0.0";"0";"1";"1";"0";"1";"0";"457182";"391207"
"V4mis2";"SILVA (only NR);Eukaryota;Archaeplastida;Rhodophyceae;Florideophycidae;Rhodymeniophycidae;Nizymenia;";"0.0";"0";"1";"1";"0";"1";"0";"457182";"391207"
"V4mis2";"SILVA (only NR);Eukaryota;Archaeplastida;Rhodophyceae;Florideophycidae;Rhodymeniophycidae;Norrissia;";"0.0";"0";"1";"1";"0";"1";"0";"457182";"391207"
"V4mis2";"SILVA (only NR);Eukaryota;Archaeplastida;Rhodophyceae;Florideophycidae;Rhodymeniophycidae;Odonthalia;";"100.0";"14.4";"1";"1";"1";"0";"0";"457182";"391206"
"V4mis2";"SILVA (only NR);Eukaryota;Archaeplastida;Rhodophyceae;Florideophycidae;Rhodymeniophycidae;Ophidocladus;";"0.0";"0";"1";"1";"0";"1";"0";"457182";"391207"
"V4mis2";"SILVA (only NR);Eukaryota;Archaeplastida;Rhodophyceae;Florideophycidae;Rhodymeniophycidae;Osmundaria;";"0.0";"0";"1";"1";"0";"1";"0";"457182";"391207"
"V4mis2";"SILVA (only NR);Eukaryota;Archaeplastida;Rhodophyceae;Florideophycidae;Rhodymeniophycidae;Osmundea;";"0.0";"0";"1";"1";"0";"1";"0";"457182";"391207"
"V4mis2";"SILVA (only NR);Eukaryota;Archaeplastida;Rhodophyceae;Florideophycidae;Rhodymeniophycidae;Pachymenia;";"0.0";"0";"2";"2";"0";"2";"0";"457181";"391207"
"V4mis2";"SILVA (only NR);Eukaryota;Archaeplastida;Rhodophyceae;Florideophycidae;Rhodymeniophycidae;Parviphycus;";"0.0";"0";"1";"1";"0";"1";"0";"457182";"391207"
"V4mis2";"SILVA (only NR);Eukaryota;Archaeplastida;Rhodophyceae;Florideophycidae;Rhodymeniophycidae;Peyssonnelia;";"0.0";"0";"16";"16";"0";"16";"0";"457167";"391207"
"V4mis2";"SILVA (only NR);Eukaryota;Archaeplastida;Rhodophyceae;Florideophycidae;Rhodymeniophycidae;Phycodrys;";"0.0";"0";"1";"1";"0";"1";"0";"457182";"391207"
"V4mis2";"SILVA (only NR);Eukaryota;Archaeplastida;Rhodophyceae;Florideophycidae;Rhodymeniophycidae;Platoma;";"100.0";"14.4";"1";"1";"1";"0";"0";"457182";"391206"
"V4mis2";"SILVA (only NR);Eukaryota;Archaeplastida;Rhodophyceae;Florideophycidae;Rhodymeniophycidae;Platysiphonia;";"0.0";"0";"2";"2";"0";"2";"0";"457181";"391207"
"V4mis2";"SILVA (only NR);Eukaryota;Archaeplastida;Rhodophyceae;Florideophycidae;Rhodymeniophycidae;Pleonosporium;";"0.0";"0";"1";"1";"0";"1";"0";"457182";"391207"
"V4mis2";"SILVA (only NR);Eukaryota;Archaeplastida;Rhodophyceae;Florideophycidae;Rhodymeniophycidae;Plocamium;";"0.0";"0";"2";"2";"0";"2";"0";"457181";"391207"
"V4mis2";"SILVA (only NR);Eukaryota;Archaeplastida;Rhodophyceae;Florideophycidae;Rhodymeniophycidae;Polsiphonia;";"0.0";"0";"1";"1";"0";"1";"0";"457182";"391207"
"V4mis2";"SILVA (only NR);Eukaryota;Archaeplastida;Rhodophyceae;Florideophycidae;Rhodymeniophycidae;Polyides;";"0.0";"0";"1";"1";"0";"1";"0";"457182";"391207"
"V4mis2";"SILVA (only NR);Eukaryota;Archaeplastida;Rhodophyceae;Florideophycidae;Rhodymeniophycidae;Polyopes;";"0.0";"0";"1";"1";"0";"1";"0";"457182";"391207"
"V4mis2";"SILVA (only NR);Eukaryota;Archaeplastida;Rhodophyceae;Florideophycidae;Rhodymeniophycidae;Polysiphonia;";"7.1";"14.4";"28";"28";"2";"26";"0";"457155";"391205"
"V4mis2";"SILVA (only NR);Eukaryota;Archaeplastida;Rhodophyceae;Florideophycidae;Rhodymeniophycidae;Polystrata;";"0.0";"0";"1";"1";"0";"1";"0";"457182";"391207"
"V4mis2";"SILVA (only NR);Eukaryota;Archaeplastida;Rhodophyceae;Florideophycidae;Rhodymeniophycidae;Portieria;";"0.0";"0";"2";"2";"0";"2";"0";"457181";"391207"
"V4mis2";"SILVA (only NR);Eukaryota;Archaeplastida;Rhodophyceae;Florideophycidae;Rhodymeniophycidae;Predaea;";"0.0";"0";"2";"2";"0";"2";"0";"457181";"391207"
"V4mis2";"SILVA (only NR);Eukaryota;Archaeplastida;Rhodophyceae;Florideophycidae;Rhodymeniophycidae;Prionitis;";"0.0";"0";"1";"1";"0";"1";"0";"457182";"391207"
"V4mis2";"SILVA (only NR);Eukaryota;Archaeplastida;Rhodophyceae;Florideophycidae;Rhodymeniophycidae;Pterothamnion;";"0.0";"0";"1";"1";"0";"1";"0";"457182";"391207"
"V4mis2";"SILVA (only NR);Eukaryota;Archaeplastida;Rhodophyceae;Florideophycidae;Rhodymeniophycidae;Ptilocladiopsis;";"0.0";"0";"1";"1";"0";"1";"0";"457182";"391207"
"V4mis2";"SILVA (only NR);Eukaryota;Archaeplastida;Rhodophyceae;Florideophycidae;Rhodymeniophycidae;Ptilonia;";"0.0";"0";"1";"1";"0";"1";"0";"457182";"391207"
"V4mis2";"SILVA (only NR);Eukaryota;Archaeplastida;Rhodophyceae;Florideophycidae;Rhodymeniophycidae;Ptilophora;";"0.0";"0";"1";"1";"0";"1";"0";"457182";"391207"
"V4mis2";"SILVA (only NR);Eukaryota;Archaeplastida;Rhodophyceae;Florideophycidae;Rhodymeniophycidae;Ptilota;";"0.0";"0";"2";"2";"0";"2";"0";"457181";"391207"
"V4mis2";"SILVA (only NR);Eukaryota;Archaeplastida;Rhodophyceae;Florideophycidae;Rhodymeniophycidae;Pugetia;";"0.0";"0";"1";"1";"0";"1";"0";"457182";"391207"
"V4mis2";"SILVA (only NR);Eukaryota;Archaeplastida;Rhodophyceae;Florideophycidae;Rhodymeniophycidae;Rhodocallis;";"0.0";"0";"1";"1";"0";"1";"0";"457182";"391207"
"V4mis2";"SILVA (only NR);Eukaryota;Archaeplastida;Rhodophyceae;Florideophycidae;Rhodymeniophycidae;Rhodoglossum;";"0.0";"0";"1";"1";"0";"1";"0";"457182";"391207"
"V4mis2";"SILVA (only NR);Eukaryota;Archaeplastida;Rhodophyceae;Florideophycidae;Rhodymeniophycidae;Rhodomela;";"0.0";"0";"1";"1";"0";"1";"0";"457182";"391207"
"V4mis2";"SILVA (only NR);Eukaryota;Archaeplastida;Rhodophyceae;Florideophycidae;Rhodymeniophycidae;Rhodopeltis;";"0.0";"0";"1";"1";"0";"1";"0";"457182";"391207"
"V4mis2";"SILVA (only NR);Eukaryota;Archaeplastida;Rhodophyceae;Florideophycidae;Rhodymeniophycidae;Rhodophyllis;";"0.0";"0";"1";"1";"0";"1";"0";"457182";"391207"
"V4mis2";"SILVA (only NR);Eukaryota;Archaeplastida;Rhodophyceae;Florideophycidae;Rhodymeniophycidae;Rhodoptilum;";"0.0";"0";"1";"1";"0";"1";"0";"457182";"391207"
"V4mis2";"SILVA (only NR);Eukaryota;Archaeplastida;Rhodophyceae;Florideophycidae;Rhodymeniophycidae;Rissoella;";"0.0";"0";"1";"1";"0";"1";"0";"457182";"391207"
"V4mis2";"SILVA (only NR);Eukaryota;Archaeplastida;Rhodophyceae;Florideophycidae;Rhodymeniophycidae;Sarcodia;";"0.0";"0";"1";"1";"0";"1";"0";"457182";"391207"
"V4mis2";"SILVA (only NR);Eukaryota;Archaeplastida;Rhodophyceae;Florideophycidae;Rhodymeniophycidae;Sarcodiotheca;";"0.0";"0";"2";"2";"0";"2";"0";"457181";"391207"
"V4mis2";"SILVA (only NR);Eukaryota;Archaeplastida;Rhodophyceae;Florideophycidae;Rhodymeniophycidae;Schimmelmannia;";"0.0";"0";"1";"1";"0";"1";"0";"457182";"391207"
"V4mis2";"SILVA (only NR);Eukaryota;Archaeplastida;Rhodophyceae;Florideophycidae;Rhodymeniophycidae;Schmitziella;";"0.0";"0";"1";"1";"0";"1";"0";"457182";"391207"
"V4mis2";"SILVA (only NR);Eukaryota;Archaeplastida;Rhodophyceae;Florideophycidae;Rhodymeniophycidae;Sciurothamnion;";"0.0";"0";"2";"2";"0";"2";"0";"457181";"391207"
"V4mis2";"SILVA (only NR);Eukaryota;Archaeplastida;Rhodophyceae;Florideophycidae;Rhodymeniophycidae;Sebdenia;";"0.0";"0";"2";"2";"0";"2";"0";"457181";"391207"
"V4mis2";"SILVA (only NR);Eukaryota;Archaeplastida;Rhodophyceae;Florideophycidae;Rhodymeniophycidae;Seirospora;";"0.0";"0";"3";"3";"0";"3";"0";"457180";"391207"
"V4mis2";"SILVA (only NR);Eukaryota;Archaeplastida;Rhodophyceae;Florideophycidae;Rhodymeniophycidae;Semnocarpa;";"0.0";"0";"1";"1";"0";"1";"0";"457182";"391207"
"V4mis2";"SILVA (only NR);Eukaryota;Archaeplastida;Rhodophyceae;Florideophycidae;Rhodymeniophycidae;Shepleya;";"0.0";"0";"1";"1";"0";"1";"0";"457182";"391207"
"V4mis2";"SILVA (only NR);Eukaryota;Archaeplastida;Rhodophyceae;Florideophycidae;Rhodymeniophycidae;Sonderella;";"0.0";"0";"1";"1";"0";"1";"0";"457182";"391207"
"V4mis2";"SILVA (only NR);Eukaryota;Archaeplastida;Rhodophyceae;Florideophycidae;Rhodymeniophycidae;Sorella;";"0.0";"0";"1";"1";"0";"1";"0";"457182";"391207"
"V4mis2";"SILVA (only NR);Eukaryota;Archaeplastida;Rhodophyceae;Florideophycidae;Rhodymeniophycidae;Sparlingia;";"0.0";"0";"1";"1";"0";"1";"0";"457182";"391207"
"V4mis2";"SILVA (only NR);Eukaryota;Archaeplastida;Rhodophyceae;Florideophycidae;Rhodymeniophycidae;Spermothamnion;";"0.0";"0";"1";"1";"0";"1";"0";"457182";"391207"
"V4mis2";"SILVA (only NR);Eukaryota;Archaeplastida;Rhodophyceae;Florideophycidae;Rhodymeniophycidae;Sphaerococcus;";"0.0";"0";"1";"1";"0";"1";"0";"457182";"391207"
"V4mis2";"SILVA (only NR);Eukaryota;Archaeplastida;Rhodophyceae;Florideophycidae;Rhodymeniophycidae;Spongoclonium;";"0.0";"0";"1";"1";"0";"1";"0";"457182";"391207"
"V4mis2";"SILVA (only NR);Eukaryota;Archaeplastida;Rhodophyceae;Florideophycidae;Rhodymeniophycidae;Spyridia;";"0.0";"0";"3";"3";"0";"3";"0";"457180";"391207"
"V4mis2";"SILVA (only NR);Eukaryota;Archaeplastida;Rhodophyceae;Florideophycidae;Rhodymeniophycidae;Sterrocladia;";"0.0";"0";"1";"1";"0";"1";"0";"457182";"391207"
"V4mis2";"SILVA (only NR);Eukaryota;Archaeplastida;Rhodophyceae;Florideophycidae;Rhodymeniophycidae;Stictosporum;";"0.0";"0";"1";"1";"0";"1";"0";"457182";"391207"
"V4mis2";"SILVA (only NR);Eukaryota;Archaeplastida;Rhodophyceae;Florideophycidae;Rhodymeniophycidae;Symphyocladia;";"0.0";"0";"2";"2";"0";"2";"0";"457181";"391207"
"V4mis2";"SILVA (only NR);Eukaryota;Archaeplastida;Rhodophyceae;Florideophycidae;Rhodymeniophycidae;Thuretia;";"0.0";"0";"1";"1";"0";"1";"0";"457182";"391207"
"V4mis2";"SILVA (only NR);Eukaryota;Archaeplastida;Rhodophyceae;Florideophycidae;Rhodymeniophycidae;Titanophora;";"100.0";"14.4";"1";"1";"1";"0";"0";"457182";"391206"
"V4mis2";"SILVA (only NR);Eukaryota;Archaeplastida;Rhodophyceae;Florideophycidae;Rhodymeniophycidae;Trematocarpus;";"0.0";"0";"1";"1";"0";"1";"0";"457182";"391207"
"V4mis2";"SILVA (only NR);Eukaryota;Archaeplastida;Rhodophyceae;Florideophycidae;Rhodymeniophycidae;Tsengia;";"0.0";"0";"1";"1";"0";"1";"0";"457182";"391207"
"V4mis2";"SILVA (only NR);Eukaryota;Archaeplastida;Rhodophyceae;Florideophycidae;Rhodymeniophycidae;Warrenia;";"0.0";"0";"1";"1";"0";"1";"0";"457182";"391207"
"V4mis2";"SILVA (only NR);Eukaryota;Archaeplastida;Rhodophyceae;Florideophycidae;Rhodymeniophycidae;Webervanbossea;";"0.0";"0";"1";"1";"0";"1";"0";"457182";"391207"
"V4mis2";"SILVA (only NR);Eukaryota;Archaeplastida;Rhodophyceae;Florideophycidae;Rhodymeniophycidae;Weeksia;";"0.0";"0";"1";"1";"0";"1";"0";"457182";"391207"
"V4mis2";"SILVA (only NR);Eukaryota;Archaeplastida;Rhodophyceae;Florideophycidae;Rhodymeniophycidae;Wetherbeella;";"0.0";"0";"1";"1";"0";"1";"0";"457182";"391207"
"V4mis2";"SILVA (only NR);Eukaryota;Archaeplastida;Rhodophyceae;Florideophycidae;Rhodymeniophycidae;Womersleyella;";"0.0";"0";"1";"1";"0";"1";"0";"457182";"391207"
"V4mis2";"SILVA (only NR);Eukaryota;Archaeplastida;Rhodophyceae;Florideophycidae;Rhodymeniophycidae;Wrangelia;";"0.0";"0";"6";"6";"0";"6";"0";"457177";"391207"
"V4mis2";"SILVA (only NR);Eukaryota;Archaeplastida;Rhodophyceae;Florideophycidae;Rhodymeniophycidae;Zymurgia;";"0.0";"0";"1";"1";"0";"1";"0";"457182";"391207"
"V4mis2";"SILVA (only NR);Eukaryota;Archaeplastida;Rhodophyceae;Porphyridiophyceae;";"0.0";"0";"8";"8";"0";"8";"0";"457175";"391207"
"V4mis2";"SILVA (only NR);Eukaryota;Archaeplastida;Rhodophyceae;Porphyridiophyceae;Flintiella;";"0.0";"0";"1";"1";"0";"1";"0";"457182";"391207"
"V4mis2";"SILVA (only NR);Eukaryota;Archaeplastida;Rhodophyceae;Porphyridiophyceae;Porphyridium;";"0.0";"0";"6";"6";"0";"6";"0";"457177";"391207"
"V4mis2";"SILVA (only NR);Eukaryota;Archaeplastida;Rhodophyceae;Porphyridiophyceae;Timspurckia;";"0.0";"0";"1";"1";"0";"1";"0";"457182";"391207"
"V4mis2";"SILVA (only NR);Eukaryota;Archaeplastida;Rhodophyceae;Rhodellophyceae;";"42.9";"14.4";"14";"14";"6";"8";"0";"457169";"391201"
"V4mis2";"SILVA (only NR);Eukaryota;Archaeplastida;Rhodophyceae;Rhodellophyceae;Bulboplastis;";"100.0";"14.4";"1";"1";"1";"0";"0";"457182";"391206"
"V4mis2";"SILVA (only NR);Eukaryota;Archaeplastida;Rhodophyceae;Rhodellophyceae;Corynoplastis;";"0.0";"0";"1";"1";"0";"1";"0";"457182";"391207"
"V4mis2";"SILVA (only NR);Eukaryota;Archaeplastida;Rhodophyceae;Rhodellophyceae;Dixoniella;";"50.0";"14.4";"4";"4";"2";"2";"0";"457179";"391205"
"V4mis2";"SILVA (only NR);Eukaryota;Archaeplastida;Rhodophyceae;Rhodellophyceae;Glaucosphaera;";"0.0";"0";"1";"1";"0";"1";"0";"457182";"391207"
"V4mis2";"SILVA (only NR);Eukaryota;Archaeplastida;Rhodophyceae;Rhodellophyceae;Neorhodella;";"100.0";"14.4";"2";"2";"2";"0";"0";"457181";"391205"
"V4mis2";"SILVA (only NR);Eukaryota;Archaeplastida;Rhodophyceae;Rhodellophyceae;Rhodella;";"20.0";"14.4";"5";"5";"1";"4";"0";"457178";"391206"
"V4mis2";"SILVA (only NR);Eukaryota;Archaeplastida;Rhodophyceae;Stylonematales;";"8.3";"14.4";"12";"12";"1";"11";"0";"457171";"391206"
"V4mis2";"SILVA (only NR);Eukaryota;Archaeplastida;Rhodophyceae;Stylonematales;Bangiopsis;";"0.0";"0";"1";"1";"0";"1";"0";"457182";"391207"
"V4mis2";"SILVA (only NR);Eukaryota;Archaeplastida;Rhodophyceae;Stylonematales;Chroodactylon;";"0.0";"0";"2";"2";"0";"2";"0";"457181";"391207"
"V4mis2";"SILVA (only NR);Eukaryota;Archaeplastida;Rhodophyceae;Stylonematales;Purpureofilum;";"0.0";"0";"1";"1";"0";"1";"0";"457182";"391207"
"V4mis2";"SILVA (only NR);Eukaryota;Archaeplastida;Rhodophyceae;Stylonematales;Rhodosorus;";"33.3";"14.4";"3";"3";"1";"2";"0";"457180";"391206"
"V4mis2";"SILVA (only NR);Eukaryota;Archaeplastida;Rhodophyceae;Stylonematales;Rhodospora;";"0.0";"0";"1";"1";"0";"1";"0";"457182";"391207"
"V4mis2";"SILVA (only NR);Eukaryota;Archaeplastida;Rhodophyceae;Stylonematales;Stylonema;";"0.0";"0";"3";"3";"0";"3";"0";"457180";"391207"
"V4mis2";"SILVA (only NR);Eukaryota;Archaeplastida;Rhodophyceae;Stylonematales;Tsunamia;";"0.0";"0";"1";"1";"0";"1";"0";"457182";"391207"
"V4mis2";"SILVA (only NR);Eukaryota;Cryptophyceae;";"29.2";"14.4";"289";"288";"84";"204";"1";"456895";"391123"
"V4mis2";"SILVA (only NR);Eukaryota;Cryptophyceae;Cryptomonadales;";"38.4";"14.4";"211";"211";"81";"130";"0";"456972";"391126"
"V4mis2";"SILVA (only NR);Eukaryota;Cryptophyceae;Cryptomonadales;Chroomonas;";"50.0";"14.4";"14";"14";"7";"7";"0";"457169";"391200"
"V4mis2";"SILVA (only NR);Eukaryota;Cryptophyceae;Cryptomonadales;Cryptomonas;";"33.3";"14.4";"81";"81";"27";"54";"0";"457102";"391180"
"V4mis2";"SILVA (only NR);Eukaryota;Cryptophyceae;Cryptomonadales;Falcomonas;";"0.0";"0";"1";"1";"0";"1";"0";"457182";"391207"
"V4mis2";"SILVA (only NR);Eukaryota;Cryptophyceae;Cryptomonadales;Geminigera;";"0.0";"0";"6";"6";"0";"6";"0";"457177";"391207"
"V4mis2";"SILVA (only NR);Eukaryota;Cryptophyceae;Cryptomonadales;Guillardia;";"50.0";"14.4";"6";"6";"3";"3";"0";"457177";"391204"
"V4mis2";"SILVA (only NR);Eukaryota;Cryptophyceae;Cryptomonadales;Hanusia;";"100.0";"14.4";"1";"1";"1";"0";"0";"457182";"391206"
"V4mis2";"SILVA (only NR);Eukaryota;Cryptophyceae;Cryptomonadales;Hemiselmis;";"42.9";"14.4";"14";"14";"6";"8";"0";"457169";"391201"
"V4mis2";"SILVA (only NR);Eukaryota;Cryptophyceae;Cryptomonadales;Komma;";"100.0";"14.4";"1";"1";"1";"0";"0";"457182";"391206"
"V4mis2";"SILVA (only NR);Eukaryota;Cryptophyceae;Cryptomonadales;Plagioselmis;";"0.0";"0";"4";"4";"0";"4";"0";"457179";"391207"
"V4mis2";"SILVA (only NR);Eukaryota;Cryptophyceae;Cryptomonadales;Proteomonas;";"0.0";"0";"2";"2";"0";"2";"0";"457181";"391207"
"V4mis2";"SILVA (only NR);Eukaryota;Cryptophyceae;Cryptomonadales;Rhodomonas;";"55.6";"14.4";"27";"27";"15";"12";"0";"457156";"391192"
"V4mis2";"SILVA (only NR);Eukaryota;Cryptophyceae;Cryptomonadales;Teleaulax;";"43.5";"14.4";"23";"23";"10";"13";"0";"457160";"391197"
"V4mis2";"SILVA (only NR);Eukaryota;Cryptophyceae;Cryptomonadales;uncultured;";"0.0";"0";"6";"6";"0";"6";"0";"457177";"391207"
"V4mis2";"SILVA (only NR);Eukaryota;Cryptophyceae;Goniomonas;";"0.0";"0";"13";"12";"0";"12";"1";"457171";"391207"
"V4mis2";"SILVA (only NR);Eukaryota;Cryptophyceae;Kathablepharidae;";"0.0";"0";"39";"39";"0";"39";"0";"457144";"391207"
"V4mis2";"SILVA (only NR);Eukaryota;Cryptophyceae;Kathablepharidae;Hatena;";"0.0";"0";"2";"2";"0";"2";"0";"457181";"391207"
"V4mis2";"SILVA (only NR);Eukaryota;Cryptophyceae;Kathablepharidae;Katablepharis;";"0.0";"0";"6";"6";"0";"6";"0";"457177";"391207"
"V4mis2";"SILVA (only NR);Eukaryota;Cryptophyceae;Kathablepharidae;Leucocryptos;";"0.0";"0";"13";"13";"0";"13";"0";"457170";"391207"
"V4mis2";"SILVA (only NR);Eukaryota;Cryptophyceae;Kathablepharidae;Roombia;";"0.0";"0";"1";"1";"0";"1";"0";"457182";"391207"
"V4mis2";"SILVA (only NR);Eukaryota;Cryptophyceae;Kathablepharidae;uncultured;";"0.0";"0";"14";"14";"0";"14";"0";"457169";"391207"
"V4mis2";"SILVA (only NR);Eukaryota;Cryptophyceae;uncultured;";"11.5";"14.4";"26";"26";"3";"23";"0";"457157";"391204"
"V4mis2";"SILVA (only NR);Eukaryota;Discoba;";"70.7";"14.4";"1032";"988";"699";"289";"44";"456195";"390508"
"V4mis2";"SILVA (only NR);Eukaryota;Discoba;Discicristata;";"72.0";"14.4";"963";"933";"672";"261";"30";"456250";"390535"
"V4mis2";"SILVA (only NR);Eukaryota;Discoba;Discicristata;Euglenozoa;";"72.0";"14.4";"911";"885";"637";"248";"26";"456298";"390570"
"V4mis2";"SILVA (only NR);Eukaryota;Discoba;Discicristata;Euglenozoa;Diplonemea;";"80.4";"14.4";"155";"138";"111";"27";"17";"457045";"391096"
"V4mis2";"SILVA (only NR);Eukaryota;Discoba;Discicristata;Euglenozoa;Diplonemea;Diplonema;";"66.7";"14.4";"9";"9";"6";"3";"0";"457174";"391201"
"V4mis2";"SILVA (only NR);Eukaryota;Discoba;Discicristata;Euglenozoa;Diplonemea;Rhynchopus;";"88.9";"14.4";"9";"9";"8";"1";"0";"457174";"391199"
"V4mis2";"SILVA (only NR);Eukaryota;Discoba;Discicristata;Euglenozoa;Diplonemea;SCM38C39 marine group;";"80.9";"14.4";"132";"115";"93";"22";"17";"457068";"391114"
"V4mis2";"SILVA (only NR);Eukaryota;Discoba;Discicristata;Euglenozoa;Euglenida;";"20.1";"14.4";"244";"244";"49";"195";"0";"456939";"391158"
"V4mis2";"SILVA (only NR);Eukaryota;Discoba;Discicristata;Euglenozoa;Euglenida;Aphagea;";"80.0";"14.4";"5";"5";"4";"1";"0";"457178";"391203"
"V4mis2";"SILVA (only NR);Eukaryota;Discoba;Discicristata;Euglenozoa;Euglenida;Aphagea;Distigma;";"0.0";"0";"1";"1";"0";"1";"0";"457182";"391207"
"V4mis2";"SILVA (only NR);Eukaryota;Discoba;Discicristata;Euglenozoa;Euglenida;Aphagea;Gyropaigne;";"100.0";"14.4";"1";"1";"1";"0";"0";"457182";"391206"
"V4mis2";"SILVA (only NR);Eukaryota;Discoba;Discicristata;Euglenozoa;Euglenida;Aphagea;Menoidium;";"100.0";"14.4";"1";"1";"1";"0";"0";"457182";"391206"
"V4mis2";"SILVA (only NR);Eukaryota;Discoba;Discicristata;Euglenozoa;Euglenida;Aphagea;Rhabdomonas;";"100.0";"14.4";"2";"2";"2";"0";"0";"457181";"391205"
"V4mis2";"SILVA (only NR);Eukaryota;Discoba;Discicristata;Euglenozoa;Euglenida;Euglenophyceae;";"11.5";"14.4";"218";"218";"25";"193";"0";"456965";"391182"
"V4mis2";"SILVA (only NR);Eukaryota;Discoba;Discicristata;Euglenozoa;Euglenida;Euglenophyceae;Euglenea;";"11.5";"14.4";"218";"218";"25";"193";"0";"456965";"391182"
"V4mis2";"SILVA (only NR);Eukaryota;Discoba;Discicristata;Euglenozoa;Euglenida;Euglenophyceae;Euglenea;Euglenaceae;";"10.3";"14.4";"97";"97";"10";"87";"0";"457086";"391197"
"V4mis2";"SILVA (only NR);Eukaryota;Discoba;Discicristata;Euglenozoa;Euglenida;Euglenophyceae;Euglenea;Euglenaceae;Colacium;";"0.0";"0";"7";"7";"0";"7";"0";"457176";"391207"
"V4mis2";"SILVA (only NR);Eukaryota;Discoba;Discicristata;Euglenozoa;Euglenida;Euglenophyceae;Euglenea;Euglenaceae;Cryptoglena;";"0.0";"0";"11";"11";"0";"11";"0";"457172";"391207"
"V4mis2";"SILVA (only NR);Eukaryota;Discoba;Discicristata;Euglenozoa;Euglenida;Euglenophyceae;Euglenea;Euglenaceae;Euglena;";"3.4";"14.4";"29";"29";"1";"28";"0";"457154";"391206"
"V4mis2";"SILVA (only NR);Eukaryota;Discoba;Discicristata;Euglenozoa;Euglenida;Euglenophyceae;Euglenea;Euglenaceae;Euglenaria;";"33.3";"14.4";"3";"3";"1";"2";"0";"457180";"391206"
"V4mis2";"SILVA (only NR);Eukaryota;Discoba;Discicristata;Euglenozoa;Euglenida;Euglenophyceae;Euglenea;Euglenaceae;Monomorphina;";"100.0";"14.4";"8";"8";"8";"0";"0";"457175";"391199"
"V4mis2";"SILVA (only NR);Eukaryota;Discoba;Discicristata;Euglenozoa;Euglenida;Euglenophyceae;Euglenea;Euglenaceae;Trachelomonas;";"0.0";"0";"39";"39";"0";"39";"0";"457144";"391207"
"V4mis2";"SILVA (only NR);Eukaryota;Discoba;Discicristata;Euglenozoa;Euglenida;Euglenophyceae;Euglenea;Phacaceae;";"12.7";"14.4";"110";"110";"14";"96";"0";"457073";"391193"
"V4mis2";"SILVA (only NR);Eukaryota;Discoba;Discicristata;Euglenozoa;Euglenida;Euglenophyceae;Euglenea;Phacaceae;Lepocinclis;";"0.0";"0";"28";"28";"0";"28";"0";"457155";"391207"
"V4mis2";"SILVA (only NR);Eukaryota;Discoba;Discicristata;Euglenozoa;Euglenida;Euglenophyceae;Euglenea;Phacaceae;Phacus;";"17.1";"14.4";"82";"82";"14";"68";"0";"457101";"391193"
"V4mis2";"SILVA (only NR);Eukaryota;Discoba;Discicristata;Euglenozoa;Euglenida;Euglenophyceae;Euglenea;Strombomonas;";"10.0";"14.4";"10";"10";"1";"9";"0";"457173";"391206"
"V4mis2";"SILVA (only NR);Eukaryota;Discoba;Discicristata;Euglenozoa;Euglenida;Heteronematina;";"95.2";"14.4";"21";"21";"20";"1";"0";"457162";"391187"
"V4mis2";"SILVA (only NR);Eukaryota;Discoba;Discicristata;Euglenozoa;Euglenida;Heteronematina;Notosolenus;";"100.0";"14.4";"2";"2";"2";"0";"0";"457181";"391205"
"V4mis2";"SILVA (only NR);Eukaryota;Discoba;Discicristata;Euglenozoa;Euglenida;Heteronematina;Petalomonas;";"94.7";"14.4";"19";"19";"18";"1";"0";"457164";"391189"
"V4mis2";"SILVA (only NR);Eukaryota;Discoba;Discicristata;Euglenozoa;Kinetoplastea;";"94.8";"14.4";"510";"501";"475";"26";"9";"456682";"390732"
"V4mis2";"SILVA (only NR);Eukaryota;Discoba;Discicristata;Euglenozoa;Kinetoplastea;Incertae Sedis;";"100.0";"14.4";"2";"2";"2";"0";"0";"457181";"391205"
"V4mis2";"SILVA (only NR);Eukaryota;Discoba;Discicristata;Euglenozoa;Kinetoplastea;Incertae Sedis;Hemistasia;";"100.0";"14.4";"2";"2";"2";"0";"0";"457181";"391205"
"V4mis2";"SILVA (only NR);Eukaryota;Discoba;Discicristata;Euglenozoa;Kinetoplastea;Metakinetoplastina;";"94.3";"14.4";"467";"458";"432";"26";"9";"456725";"390775"
"V4mis2";"SILVA (only NR);Eukaryota;Discoba;Discicristata;Euglenozoa;Kinetoplastea;Metakinetoplastina;Eubodonida;";"93.1";"14.4";"29";"29";"27";"2";"0";"457154";"391180"
"V4mis2";"SILVA (only NR);Eukaryota;Discoba;Discicristata;Euglenozoa;Kinetoplastea;Metakinetoplastina;Eubodonida;Bodo;";"93.1";"14.4";"29";"29";"27";"2";"0";"457154";"391180"
"V4mis2";"SILVA (only NR);Eukaryota;Discoba;Discicristata;Euglenozoa;Kinetoplastea;Metakinetoplastina;Neobodonida;";"97.5";"14.4";"125";"121";"118";"3";"4";"457062";"391089"
"V4mis2";"SILVA (only NR);Eukaryota;Discoba;Discicristata;Euglenozoa;Kinetoplastea;Metakinetoplastina;Neobodonida;Cruzella;";"100.0";"14.4";"1";"1";"1";"0";"0";"457182";"391206"
"V4mis2";"SILVA (only NR);Eukaryota;Discoba;Discicristata;Euglenozoa;Kinetoplastea;Metakinetoplastina;Neobodonida;Dimastigella;";"100.0";"14.4";"5";"5";"5";"0";"0";"457178";"391202"
"V4mis2";"SILVA (only NR);Eukaryota;Discoba;Discicristata;Euglenozoa;Kinetoplastea;Metakinetoplastina;Neobodonida;Lake Biwa clade;";"0.0";"0";"2";"0";"0";"0";"2";"457183";"391207"
"V4mis2";"SILVA (only NR);Eukaryota;Discoba;Discicristata;Euglenozoa;Kinetoplastea;Metakinetoplastina;Neobodonida;Neobodo;";"97.5";"14.4";"83";"81";"79";"2";"2";"457102";"391128"
"V4mis2";"SILVA (only NR);Eukaryota;Discoba;Discicristata;Euglenozoa;Kinetoplastea;Metakinetoplastina;Neobodonida;Rhynchobodo;";"100.0";"14.4";"12";"12";"12";"0";"0";"457171";"391195"
"V4mis2";"SILVA (only NR);Eukaryota;Discoba;Discicristata;Euglenozoa;Kinetoplastea;Metakinetoplastina;Neobodonida;Rhynchomonas;";"94.7";"14.4";"19";"19";"18";"1";"0";"457164";"391189"
"V4mis2";"SILVA (only NR);Eukaryota;Discoba;Discicristata;Euglenozoa;Kinetoplastea;Metakinetoplastina;Parabodonida;";"91.7";"14.4";"24";"24";"22";"2";"0";"457159";"391185"
"V4mis2";"SILVA (only NR);Eukaryota;Discoba;Discicristata;Euglenozoa;Kinetoplastea;Metakinetoplastina;Parabodonida;Cryptobia;";"100.0";"14.4";"5";"5";"5";"0";"0";"457178";"391202"
"V4mis2";"SILVA (only NR);Eukaryota;Discoba;Discicristata;Euglenozoa;Kinetoplastea;Metakinetoplastina;Parabodonida;Parabodo;";"91.7";"14.4";"12";"12";"11";"1";"0";"457171";"391196"
"V4mis2";"SILVA (only NR);Eukaryota;Discoba;Discicristata;Euglenozoa;Kinetoplastea;Metakinetoplastina;Trypanosomatida;";"93.3";"14.4";"288";"283";"264";"19";"5";"456900";"390943"
"V4mis2";"SILVA (only NR);Eukaryota;Discoba;Discicristata;Euglenozoa;Kinetoplastea;Metakinetoplastina;Trypanosomatida;Angomonas;";"100.0";"14.4";"4";"4";"4";"0";"0";"457179";"391203"
"V4mis2";"SILVA (only NR);Eukaryota;Discoba;Discicristata;Euglenozoa;Kinetoplastea;Metakinetoplastina;Trypanosomatida;Blastocrithidia;";"90.0";"14.4";"10";"10";"9";"1";"0";"457173";"391198"
"V4mis2";"SILVA (only NR);Eukaryota;Discoba;Discicristata;Euglenozoa;Kinetoplastea;Metakinetoplastina;Trypanosomatida;Blechomonas;";"100.0";"14.4";"6";"6";"6";"0";"0";"457177";"391201"
"V4mis2";"SILVA (only NR);Eukaryota;Discoba;Discicristata;Euglenozoa;Kinetoplastea;Metakinetoplastina;Trypanosomatida;Crithidia;";"72.7";"14.4";"11";"11";"8";"3";"0";"457172";"391199"
"V4mis2";"SILVA (only NR);Eukaryota;Discoba;Discicristata;Euglenozoa;Kinetoplastea;Metakinetoplastina;Trypanosomatida;Endotrypanum;";"100.0";"14.4";"11";"11";"11";"0";"0";"457172";"391196"
"V4mis2";"SILVA (only NR);Eukaryota;Discoba;Discicristata;Euglenozoa;Kinetoplastea;Metakinetoplastina;Trypanosomatida;Herpetomonas;";"96.3";"14.4";"27";"27";"26";"1";"0";"457156";"391181"
"V4mis2";"SILVA (only NR);Eukaryota;Discoba;Discicristata;Euglenozoa;Kinetoplastea;Metakinetoplastina;Trypanosomatida;Jaenimonas;";"100.0";"14.4";"2";"2";"2";"0";"0";"457181";"391205"
"V4mis2";"SILVA (only NR);Eukaryota;Discoba;Discicristata;Euglenozoa;Kinetoplastea;Metakinetoplastina;Trypanosomatida;Leishmania;";"100.0";"14.4";"3";"2";"2";"0";"1";"457181";"391205"
"V4mis2";"SILVA (only NR);Eukaryota;Discoba;Discicristata;Euglenozoa;Kinetoplastea;Metakinetoplastina;Trypanosomatida;Leptomonas;";"100.0";"14.4";"26";"25";"25";"0";"1";"457158";"391182"
"V4mis2";"SILVA (only NR);Eukaryota;Discoba;Discicristata;Euglenozoa;Kinetoplastea;Metakinetoplastina;Trypanosomatida;Paratrypanosoma;";"100.0";"14.4";"1";"1";"1";"0";"0";"457182";"391206"
"V4mis2";"SILVA (only NR);Eukaryota;Discoba;Discicristata;Euglenozoa;Kinetoplastea;Metakinetoplastina;Trypanosomatida;Phytomonas;";"100.0";"14.4";"7";"7";"7";"0";"0";"457176";"391200"
"V4mis2";"SILVA (only NR);Eukaryota;Discoba;Discicristata;Euglenozoa;Kinetoplastea;Metakinetoplastina;Trypanosomatida;Sergeia;";"100.0";"14.4";"2";"2";"2";"0";"0";"457181";"391205"
"V4mis2";"SILVA (only NR);Eukaryota;Discoba;Discicristata;Euglenozoa;Kinetoplastea;Metakinetoplastina;Trypanosomatida;Strigomonas;";"80.0";"14.4";"5";"5";"4";"1";"0";"457178";"391203"
"V4mis2";"SILVA (only NR);Eukaryota;Discoba;Discicristata;Euglenozoa;Kinetoplastea;Metakinetoplastina;Trypanosomatida;Trypanosoma;";"92.6";"14.4";"139";"136";"126";"10";"3";"457047";"391081"
"V4mis2";"SILVA (only NR);Eukaryota;Discoba;Discicristata;Euglenozoa;Kinetoplastea;Metakinetoplastina;Trypanosomatida;Wallaceina;";"100.0";"14.4";"1";"1";"1";"0";"0";"457182";"391206"
"V4mis2";"SILVA (only NR);Eukaryota;Discoba;Discicristata;Euglenozoa;Kinetoplastea;Metakinetoplastina;Trypanosomatida;Zelonia;";"100.0";"14.4";"1";"1";"1";"0";"0";"457182";"391206"
"V4mis2";"SILVA (only NR);Eukaryota;Discoba;Discicristata;Euglenozoa;Kinetoplastea;Prokinetoplastina;";"100.0";"14.4";"40";"40";"40";"0";"0";"457143";"391167"
"V4mis2";"SILVA (only NR);Eukaryota;Discoba;Discicristata;Euglenozoa;Kinetoplastea;Prokinetoplastina;Ichthyobodo;";"100.0";"14.4";"40";"40";"40";"0";"0";"457143";"391167"
"V4mis2";"SILVA (only NR);Eukaryota;Discoba;Discicristata;Heterolobosea;";"72.9";"14.4";"52";"48";"35";"13";"4";"457135";"391172"
"V4mis2";"SILVA (only NR);Eukaryota;Discoba;Discicristata;Heterolobosea;Tetramitia;";"72.9";"14.4";"52";"48";"35";"13";"4";"457135";"391172"
"V4mis2";"SILVA (only NR);Eukaryota;Discoba;Discicristata;Heterolobosea;Tetramitia;Allovahlkampfia;";"100.0";"14.4";"4";"4";"4";"0";"0";"457179";"391203"
"V4mis2";"SILVA (only NR);Eukaryota;Discoba;Discicristata;Heterolobosea;Tetramitia;Learamoeba;";"100.0";"14.4";"1";"1";"1";"0";"0";"457182";"391206"
"V4mis2";"SILVA (only NR);Eukaryota;Discoba;Discicristata;Heterolobosea;Tetramitia;Naegleria;";"70.0";"14.4";"21";"20";"14";"6";"1";"457163";"391193"
"V4mis2";"SILVA (only NR);Eukaryota;Discoba;Discicristata;Heterolobosea;Tetramitia;Neovahlkampfia;";"100.0";"14.4";"2";"2";"2";"0";"0";"457181";"391205"
"V4mis2";"SILVA (only NR);Eukaryota;Discoba;Discicristata;Heterolobosea;Tetramitia;Psalteriomonas;";"0.0";"0";"4";"4";"0";"4";"0";"457179";"391207"
"V4mis2";"SILVA (only NR);Eukaryota;Discoba;Discicristata;Heterolobosea;Tetramitia;Sawyeria;";"100.0";"14.4";"1";"1";"1";"0";"0";"457182";"391206"
"V4mis2";"SILVA (only NR);Eukaryota;Discoba;Discicristata;Heterolobosea;Tetramitia;Singhamoeba;";"50.0";"14.4";"2";"2";"1";"1";"0";"457181";"391206"
"V4mis2";"SILVA (only NR);Eukaryota;Discoba;Discicristata;Heterolobosea;Tetramitia;Tetramitus;";"85.7";"14.4";"8";"7";"6";"1";"1";"457176";"391201"
"V4mis2";"SILVA (only NR);Eukaryota;Discoba;Discicristata;Heterolobosea;Tetramitia;Vahlkampfia;";"100.0";"14.4";"4";"4";"4";"0";"0";"457179";"391203"
"V4mis2";"SILVA (only NR);Eukaryota;Discoba;Jakobida;";"52.0";"14.4";"64";"50";"26";"24";"14";"457133";"391181"
"V4mis2";"SILVA (only NR);Eukaryota;Discoba;Jakobida;Andalucia;";"96.3";"14.4";"38";"27";"26";"1";"11";"457156";"391181"
"V4mis2";"SILVA (only NR);Eukaryota;Discoba;Jakobida;Jakoba;";"0.0";"0";"2";"2";"0";"2";"0";"457181";"391207"
"V4mis2";"SILVA (only NR);Eukaryota;Discoba;Jakobida;Moramonas;";"0.0";"0";"1";"1";"0";"1";"0";"457182";"391207"
"V4mis2";"SILVA (only NR);Eukaryota;Discoba;Jakobida;RM1-SGM49;";"0.0";"0";"5";"4";"0";"4";"1";"457179";"391207"
"V4mis2";"SILVA (only NR);Eukaryota;Discoba;Jakobida;Reclinomonas;";"0.0";"0";"3";"3";"0";"3";"0";"457180";"391207"
"V4mis2";"SILVA (only NR);Eukaryota;Discoba;Jakobida;Seculamonas;";"0.0";"0";"1";"1";"0";"1";"0";"457182";"391207"
"V4mis2";"SILVA (only NR);Eukaryota;Discoba;Jakobida;uncultured;";"0.0";"0";"4";"4";"0";"4";"0";"457179";"391207"
"V4mis2";"SILVA (only NR);Eukaryota;Discoba;Malawimonas;";"0.0";"0";"1";"1";"0";"1";"0";"457182";"391207"
"V4mis2";"SILVA (only NR);Eukaryota;Excavata;";"62.1";"14.4";"389";"383";"238";"145";"6";"456800";"390969"
"V4mis2";"SILVA (only NR);Eukaryota;Excavata;Metamonada;";"62.1";"14.4";"389";"383";"238";"145";"6";"456800";"390969"
"V4mis2";"SILVA (only NR);Eukaryota;Excavata;Metamonada;Fornicata;";"0.0";"0";"21";"21";"0";"21";"0";"457162";"391207"
"V4mis2";"SILVA (only NR);Eukaryota;Excavata;Metamonada;Fornicata;Carpediomonas-like organisms;";"0.0";"0";"10";"10";"0";"10";"0";"457173";"391207"
"V4mis2";"SILVA (only NR);Eukaryota;Excavata;Metamonada;Fornicata;Carpediomonas-like organisms;Carpediemonas;";"0.0";"0";"3";"3";"0";"3";"0";"457180";"391207"
"V4mis2";"SILVA (only NR);Eukaryota;Excavata;Metamonada;Fornicata;Carpediomonas-like organisms;Dysnectes;";"0.0";"0";"2";"2";"0";"2";"0";"457181";"391207"
"V4mis2";"SILVA (only NR);Eukaryota;Excavata;Metamonada;Fornicata;Carpediomonas-like organisms;Ergobibamus;";"0.0";"0";"2";"2";"0";"2";"0";"457181";"391207"
"V4mis2";"SILVA (only NR);Eukaryota;Excavata;Metamonada;Fornicata;Diplomonadida;";"0.0";"0";"11";"11";"0";"11";"0";"457172";"391207"
"V4mis2";"SILVA (only NR);Eukaryota;Excavata;Metamonada;Fornicata;Diplomonadida;Giardiinae;";"0.0";"0";"11";"11";"0";"11";"0";"457172";"391207"
"V4mis2";"SILVA (only NR);Eukaryota;Excavata;Metamonada;Fornicata;Diplomonadida;Giardiinae;Giardia;";"0.0";"0";"11";"11";"0";"11";"0";"457172";"391207"
"V4mis2";"SILVA (only NR);Eukaryota;Excavata;Metamonada;Parabasalia;";"67.8";"14.4";"342";"342";"232";"110";"0";"456841";"390975"
"V4mis2";"SILVA (only NR);Eukaryota;Excavata;Metamonada;Parabasalia;Cristamonadea;";"51.7";"14.4";"60";"60";"31";"29";"0";"457123";"391176"
"V4mis2";"SILVA (only NR);Eukaryota;Excavata;Metamonada;Parabasalia;Cristamonadea;Calonympha;";"100.0";"14.4";"4";"4";"4";"0";"0";"457179";"391203"
"V4mis2";"SILVA (only NR);Eukaryota;Excavata;Metamonada;Parabasalia;Cristamonadea;Coronympha;";"100.0";"14.4";"4";"4";"4";"0";"0";"457179";"391203"
"V4mis2";"SILVA (only NR);Eukaryota;Excavata;Metamonada;Parabasalia;Cristamonadea;Deltotrichonympha;";"100.0";"14.4";"1";"1";"1";"0";"0";"457182";"391206"
"V4mis2";"SILVA (only NR);Eukaryota;Excavata;Metamonada;Parabasalia;Cristamonadea;Devescovina;";"20.0";"14.4";"15";"15";"3";"12";"0";"457168";"391204"
"V4mis2";"SILVA (only NR);Eukaryota;Excavata;Metamonada;Parabasalia;Cristamonadea;Foaina;";"50.0";"14.4";"4";"4";"2";"2";"0";"457179";"391205"
"V4mis2";"SILVA (only NR);Eukaryota;Excavata;Metamonada;Parabasalia;Cristamonadea;Gigantomonas;";"100.0";"14.4";"1";"1";"1";"0";"0";"457182";"391206"
"V4mis2";"SILVA (only NR);Eukaryota;Excavata;Metamonada;Parabasalia;Cristamonadea;Joenia;";"0.0";"0";"3";"3";"0";"3";"0";"457180";"391207"
"V4mis2";"SILVA (only NR);Eukaryota;Excavata;Metamonada;Parabasalia;Cristamonadea;Joenoides;";"100.0";"14.4";"1";"1";"1";"0";"0";"457182";"391206"
"V4mis2";"SILVA (only NR);Eukaryota;Excavata;Metamonada;Parabasalia;Cristamonadea;Kofoidia;";"0.0";"0";"2";"2";"0";"2";"0";"457181";"391207"
"V4mis2";"SILVA (only NR);Eukaryota;Excavata;Metamonada;Parabasalia;Cristamonadea;Koruga;";"100.0";"14.4";"1";"1";"1";"0";"0";"457182";"391206"
"V4mis2";"SILVA (only NR);Eukaryota;Excavata;Metamonada;Parabasalia;Cristamonadea;Lophomonas;";"100.0";"14.4";"1";"1";"1";"0";"0";"457182";"391206"
"V4mis2";"SILVA (only NR);Eukaryota;Excavata;Metamonada;Parabasalia;Cristamonadea;Metadevescovina;";"0.0";"0";"9";"9";"0";"9";"0";"457174";"391207"
"V4mis2";"SILVA (only NR);Eukaryota;Excavata;Metamonada;Parabasalia;Cristamonadea;Mixotricha;";"100.0";"14.4";"1";"1";"1";"0";"0";"457182";"391206"
"V4mis2";"SILVA (only NR);Eukaryota;Excavata;Metamonada;Parabasalia;Cristamonadea;Nk3 symbiont group;";"100.0";"14.4";"2";"2";"2";"0";"0";"457181";"391205"
"V4mis2";"SILVA (only NR);Eukaryota;Excavata;Metamonada;Parabasalia;Cristamonadea;Snyderella;";"100.0";"14.4";"4";"4";"4";"0";"0";"457179";"391203"
"V4mis2";"SILVA (only NR);Eukaryota;Excavata;Metamonada;Parabasalia;Cristamonadea;Stephanonympha;";"100.0";"14.4";"2";"2";"2";"0";"0";"457181";"391205"
"V4mis2";"SILVA (only NR);Eukaryota;Excavata;Metamonada;Parabasalia;Cryptotermes symbiont group;";"36.4";"14.4";"22";"22";"8";"14";"0";"457161";"391199"
"V4mis2";"SILVA (only NR);Eukaryota;Excavata;Metamonada;Parabasalia;Gf10 symbiont group;";"75.0";"14.4";"4";"4";"3";"1";"0";"457179";"391204"
"V4mis2";"SILVA (only NR);Eukaryota;Excavata;Metamonada;Parabasalia;Hypotrichomonadea;";"29.4";"14.4";"17";"17";"5";"12";"0";"457166";"391202"
"V4mis2";"SILVA (only NR);Eukaryota;Excavata;Metamonada;Parabasalia;Hypotrichomonadea;Hypotrichomonas;";"7.7";"14.4";"13";"13";"1";"12";"0";"457170";"391206"
"V4mis2";"SILVA (only NR);Eukaryota;Excavata;Metamonada;Parabasalia;Hypotrichomonadea;Trichomitus;";"100.0";"14.4";"4";"4";"4";"0";"0";"457179";"391203"
"V4mis2";"SILVA (only NR);Eukaryota;Excavata;Metamonada;Parabasalia;Spirotrichonymphea;";"0.0";"0";"36";"36";"0";"36";"0";"457147";"391207"
"V4mis2";"SILVA (only NR);Eukaryota;Excavata;Metamonada;Parabasalia;Spirotrichonymphea;Holomastigotoides;";"0.0";"0";"12";"12";"0";"12";"0";"457171";"391207"
"V4mis2";"SILVA (only NR);Eukaryota;Excavata;Metamonada;Parabasalia;Spirotrichonymphea;Spirotrichonympha;";"0.0";"0";"3";"3";"0";"3";"0";"457180";"391207"
"V4mis2";"SILVA (only NR);Eukaryota;Excavata;Metamonada;Parabasalia;Spirotrichonymphea;pool A symbiont group;";"0.0";"0";"18";"18";"0";"18";"0";"457165";"391207"
"V4mis2";"SILVA (only NR);Eukaryota;Excavata;Metamonada;Parabasalia;Trichomonadea;";"97.3";"14.4";"74";"74";"72";"2";"0";"457109";"391135"
"V4mis2";"SILVA (only NR);Eukaryota;Excavata;Metamonada;Parabasalia;Trichomonadea;Cochlosoma;";"100.0";"14.4";"1";"1";"1";"0";"0";"457182";"391206"
"V4mis2";"SILVA (only NR);Eukaryota;Excavata;Metamonada;Parabasalia;Trichomonadea;Ditrichomonas;";"100.0";"14.4";"2";"2";"2";"0";"0";"457181";"391205"
"V4mis2";"SILVA (only NR);Eukaryota;Excavata;Metamonada;Parabasalia;Trichomonadea;Hexamastix;";"100.0";"14.4";"5";"5";"5";"0";"0";"457178";"391202"
"V4mis2";"SILVA (only NR);Eukaryota;Excavata;Metamonada;Parabasalia;Trichomonadea;Honigbergiella;";"100.0";"14.4";"1";"1";"1";"0";"0";"457182";"391206"
"V4mis2";"SILVA (only NR);Eukaryota;Excavata;Metamonada;Parabasalia;Trichomonadea;Lacusteria;";"100.0";"14.4";"1";"1";"1";"0";"0";"457182";"391206"
"V4mis2";"SILVA (only NR);Eukaryota;Excavata;Metamonada;Parabasalia;Trichomonadea;Pentatrichomonas;";"100.0";"14.4";"2";"2";"2";"0";"0";"457181";"391205"
"V4mis2";"SILVA (only NR);Eukaryota;Excavata;Metamonada;Parabasalia;Trichomonadea;Pentatrichomonoides;";"100.0";"14.4";"1";"1";"1";"0";"0";"457182";"391206"
"V4mis2";"SILVA (only NR);Eukaryota;Excavata;Metamonada;Parabasalia;Trichomonadea;Pseudotrichomonas;";"100.0";"14.4";"2";"2";"2";"0";"0";"457181";"391205"
"V4mis2";"SILVA (only NR);Eukaryota;Excavata;Metamonada;Parabasalia;Trichomonadea;Pseudotrypanosoma;";"100.0";"14.4";"1";"1";"1";"0";"0";"457182";"391206"
"V4mis2";"SILVA (only NR);Eukaryota;Excavata;Metamonada;Parabasalia;Trichomonadea;Simplicimonas;";"100.0";"14.4";"6";"6";"6";"0";"0";"457177";"391201"
"V4mis2";"SILVA (only NR);Eukaryota;Excavata;Metamonada;Parabasalia;Trichomonadea;Tetratrichomonas;";"96.4";"14.4";"28";"28";"27";"1";"0";"457155";"391180"
"V4mis2";"SILVA (only NR);Eukaryota;Excavata;Metamonada;Parabasalia;Trichomonadea;Trichomitopsis;";"100.0";"14.4";"5";"5";"5";"0";"0";"457178";"391202"
"V4mis2";"SILVA (only NR);Eukaryota;Excavata;Metamonada;Parabasalia;Trichomonadea;Trichomonas;";"92.9";"14.4";"14";"14";"13";"1";"0";"457169";"391194"
"V4mis2";"SILVA (only NR);Eukaryota;Excavata;Metamonada;Parabasalia;Trichonymphea;";"92.8";"14.4";"97";"97";"90";"7";"0";"457086";"391117"
"V4mis2";"SILVA (only NR);Eukaryota;Excavata;Metamonada;Parabasalia;Trichonymphea;Barbulanympha;";"100.0";"14.4";"5";"5";"5";"0";"0";"457178";"391202"
"V4mis2";"SILVA (only NR);Eukaryota;Excavata;Metamonada;Parabasalia;Trichonymphea;Eucomonympha;";"100.0";"14.4";"4";"4";"4";"0";"0";"457179";"391203"
"V4mis2";"SILVA (only NR);Eukaryota;Excavata;Metamonada;Parabasalia;Trichonymphea;Pseudotrichonympha;";"100.0";"14.4";"23";"23";"23";"0";"0";"457160";"391184"
"V4mis2";"SILVA (only NR);Eukaryota;Excavata;Metamonada;Parabasalia;Trichonymphea;Staurojoenia;";"100.0";"14.4";"3";"3";"3";"0";"0";"457180";"391204"
"V4mis2";"SILVA (only NR);Eukaryota;Excavata;Metamonada;Parabasalia;Trichonymphea;Teranympha;";"66.7";"14.4";"12";"12";"8";"4";"0";"457171";"391199"
"V4mis2";"SILVA (only NR);Eukaryota;Excavata;Metamonada;Parabasalia;Trichonymphea;Trichonympha;";"93.6";"14.4";"47";"47";"44";"3";"0";"457136";"391163"
"V4mis2";"SILVA (only NR);Eukaryota;Excavata;Metamonada;Parabasalia;Tritrichomonadea;";"40.0";"14.4";"15";"15";"6";"9";"0";"457168";"391201"
"V4mis2";"SILVA (only NR);Eukaryota;Excavata;Metamonada;Parabasalia;Tritrichomonadea;Dientamoeba;";"0.0";"0";"1";"1";"0";"1";"0";"457182";"391207"
"V4mis2";"SILVA (only NR);Eukaryota;Excavata;Metamonada;Parabasalia;Tritrichomonadea;Histomonas;";"0.0";"0";"1";"1";"0";"1";"0";"457182";"391207"
"V4mis2";"SILVA (only NR);Eukaryota;Excavata;Metamonada;Parabasalia;Tritrichomonadea;Monocercomonas;";"100.0";"14.4";"5";"5";"5";"0";"0";"457178";"391202"
"V4mis2";"SILVA (only NR);Eukaryota;Excavata;Metamonada;Parabasalia;Tritrichomonadea;Parahistomonas;";"0.0";"0";"2";"2";"0";"2";"0";"457181";"391207"
"V4mis2";"SILVA (only NR);Eukaryota;Excavata;Metamonada;Parabasalia;Tritrichomonadea;Tritrichomonas;";"16.7";"14.4";"6";"6";"1";"5";"0";"457177";"391206"
"V4mis2";"SILVA (only NR);Eukaryota;Excavata;Metamonada;Parabasalia;uncultured;";"100.0";"14.4";"5";"5";"5";"0";"0";"457178";"391202"
"V4mis2";"SILVA (only NR);Eukaryota;Excavata;Metamonada;Preaxostyla;";"30.0";"14.4";"26";"20";"6";"14";"6";"457163";"391201"
"V4mis2";"SILVA (only NR);Eukaryota;Excavata;Metamonada;Preaxostyla;Oxymonadida;";"16.7";"14.4";"18";"12";"2";"10";"6";"457171";"391205"
"V4mis2";"SILVA (only NR);Eukaryota;Excavata;Metamonada;Preaxostyla;Oxymonadida;Blattamonas;";"0.0";"0";"4";"4";"0";"4";"0";"457179";"391207"
"V4mis2";"SILVA (only NR);Eukaryota;Excavata;Metamonada;Preaxostyla;Oxymonadida;Dinenympha;";"0.0";"0";"5";"3";"0";"3";"2";"457180";"391207"
"V4mis2";"SILVA (only NR);Eukaryota;Excavata;Metamonada;Preaxostyla;Oxymonadida;Pyrsonympha;";"0.0";"0";"2";"0";"0";"0";"2";"457183";"391207"
"V4mis2";"SILVA (only NR);Eukaryota;Excavata;Metamonada;Preaxostyla;Oxymonadida;Saccinobaculus;";"0.0";"0";"2";"2";"0";"2";"0";"457181";"391207"
"V4mis2";"SILVA (only NR);Eukaryota;Excavata;Metamonada;Preaxostyla;Paratrimastix;";"80.0";"14.4";"5";"5";"4";"1";"0";"457178";"391203"
"V4mis2";"SILVA (only NR);Eukaryota;Excavata;Metamonada;Preaxostyla;Trimastix;";"0.0";"0";"3";"3";"0";"3";"0";"457180";"391207"
"V4mis2";"SILVA (only NR);Eukaryota;Haptophyta;";"9.0";"14.4";"228";"221";"20";"201";"7";"456962";"391187"
"V4mis2";"SILVA (only NR);Eukaryota;Haptophyta;Pav3;";"0.0";"0";"2";"2";"0";"2";"0";"457181";"391207"
"V4mis2";"SILVA (only NR);Eukaryota;Haptophyta;Pavlovophyceae;";"0.0";"0";"38";"37";"0";"37";"1";"457146";"391207"
"V4mis2";"SILVA (only NR);Eukaryota;Haptophyta;Pavlovophyceae;AA5F1;";"0.0";"0";"4";"3";"0";"3";"1";"457180";"391207"
"V4mis2";"SILVA (only NR);Eukaryota;Haptophyta;Pavlovophyceae;Diacronema;";"0.0";"0";"9";"9";"0";"9";"0";"457174";"391207"
"V4mis2";"SILVA (only NR);Eukaryota;Haptophyta;Pavlovophyceae;Exanthemachrysis;";"0.0";"0";"5";"5";"0";"5";"0";"457178";"391207"
"V4mis2";"SILVA (only NR);Eukaryota;Haptophyta;Pavlovophyceae;Pavlova;";"0.0";"0";"12";"12";"0";"12";"0";"457171";"391207"
"V4mis2";"SILVA (only NR);Eukaryota;Haptophyta;Pavlovophyceae;Rebecca;";"0.0";"0";"6";"6";"0";"6";"0";"457177";"391207"
"V4mis2";"SILVA (only NR);Eukaryota;Haptophyta;Prymnesiophyceae;";"11.8";"14.4";"173";"169";"20";"149";"4";"457014";"391187"
"V4mis2";"SILVA (only NR);Eukaryota;Haptophyta;Prymnesiophyceae;Coccolithales;";"0.0";"0";"22";"22";"0";"22";"0";"457161";"391207"
"V4mis2";"SILVA (only NR);Eukaryota;Haptophyta;Prymnesiophyceae;Coccolithales;Algirosphaera;";"0.0";"0";"1";"1";"0";"1";"0";"457182";"391207"
"V4mis2";"SILVA (only NR);Eukaryota;Haptophyta;Prymnesiophyceae;Coccolithales;Coccolithus;";"0.0";"0";"1";"1";"0";"1";"0";"457182";"391207"
"V4mis2";"SILVA (only NR);Eukaryota;Haptophyta;Prymnesiophyceae;Coccolithales;Coronosphaera;";"0.0";"0";"2";"2";"0";"2";"0";"457181";"391207"
"V4mis2";"SILVA (only NR);Eukaryota;Haptophyta;Prymnesiophyceae;Coccolithales;Cruciplacolithus;";"0.0";"0";"1";"1";"0";"1";"0";"457182";"391207"
"V4mis2";"SILVA (only NR);Eukaryota;Haptophyta;Prymnesiophyceae;Coccolithales;Hymenomonas;";"0.0";"0";"1";"1";"0";"1";"0";"457182";"391207"
"V4mis2";"SILVA (only NR);Eukaryota;Haptophyta;Prymnesiophyceae;Coccolithales;Jomonlithus;";"0.0";"0";"1";"1";"0";"1";"0";"457182";"391207"
"V4mis2";"SILVA (only NR);Eukaryota;Haptophyta;Prymnesiophyceae;Coccolithales;Pleurochrysis;";"0.0";"0";"4";"4";"0";"4";"0";"457179";"391207"
"V4mis2";"SILVA (only NR);Eukaryota;Haptophyta;Prymnesiophyceae;Coccolithales;Reticulosphaera;";"0.0";"0";"2";"2";"0";"2";"0";"457181";"391207"
"V4mis2";"SILVA (only NR);Eukaryota;Haptophyta;Prymnesiophyceae;Coccolithales;Tergestiella;";"0.0";"0";"1";"1";"0";"1";"0";"457182";"391207"
"V4mis2";"SILVA (only NR);Eukaryota;Haptophyta;Prymnesiophyceae;Coccolithales;Umbilicosphaera;";"0.0";"0";"2";"2";"0";"2";"0";"457181";"391207"
"V4mis2";"SILVA (only NR);Eukaryota;Haptophyta;Prymnesiophyceae;Isochrysidales;";"14.3";"14.4";"14";"14";"2";"12";"0";"457169";"391205"
"V4mis2";"SILVA (only NR);Eukaryota;Haptophyta;Prymnesiophyceae;Isochrysidales;ESS2202;";"100.0";"14.4";"2";"2";"2";"0";"0";"457181";"391205"
"V4mis2";"SILVA (only NR);Eukaryota;Haptophyta;Prymnesiophyceae;Isochrysidales;Emiliania;";"0.0";"0";"2";"2";"0";"2";"0";"457181";"391207"
"V4mis2";"SILVA (only NR);Eukaryota;Haptophyta;Prymnesiophyceae;Isochrysidales;Isochrysis;";"0.0";"0";"10";"10";"0";"10";"0";"457173";"391207"
"V4mis2";"SILVA (only NR);Eukaryota;Haptophyta;Prymnesiophyceae;Phaeocystis;";"0.0";"0";"14";"14";"0";"14";"0";"457169";"391207"
"V4mis2";"SILVA (only NR);Eukaryota;Haptophyta;Prymnesiophyceae;Prymnesiales;";"16.1";"14.4";"116";"112";"18";"94";"4";"457071";"391189"
"V4mis2";"SILVA (only NR);Eukaryota;Haptophyta;Prymnesiophyceae;Prymnesiales;AI5F14RJ2A07;";"0.0";"0";"3";"1";"0";"1";"2";"457182";"391207"
"V4mis2";"SILVA (only NR);Eukaryota;Haptophyta;Prymnesiophyceae;Prymnesiales;Chrysocampanula;";"0.0";"0";"3";"3";"0";"3";"0";"457180";"391207"
"V4mis2";"SILVA (only NR);Eukaryota;Haptophyta;Prymnesiophyceae;Prymnesiales;Chrysochromulina;";"51.5";"14.4";"33";"33";"17";"16";"0";"457150";"391190"
"V4mis2";"SILVA (only NR);Eukaryota;Haptophyta;Prymnesiophyceae;Prymnesiales;Chrysoculter;";"0.0";"0";"6";"5";"0";"5";"1";"457178";"391207"
"V4mis2";"SILVA (only NR);Eukaryota;Haptophyta;Prymnesiophyceae;Prymnesiales;Haptolina;";"0.0";"0";"5";"5";"0";"5";"0";"457178";"391207"
"V4mis2";"SILVA (only NR);Eukaryota;Haptophyta;Prymnesiophyceae;Prymnesiales;Helicosphaera;";"0.0";"0";"1";"1";"0";"1";"0";"457182";"391207"
"V4mis2";"SILVA (only NR);Eukaryota;Haptophyta;Prymnesiophyceae;Prymnesiales;Imantonia;";"0.0";"0";"2";"2";"0";"2";"0";"457181";"391207"
"V4mis2";"SILVA (only NR);Eukaryota;Haptophyta;Prymnesiophyceae;Prymnesiales;OLI16029;";"0.0";"0";"21";"21";"0";"21";"0";"457162";"391207"
"V4mis2";"SILVA (only NR);Eukaryota;Haptophyta;Prymnesiophyceae;Prymnesiales;OLI51059;";"0.0";"0";"5";"5";"0";"5";"0";"457178";"391207"
"V4mis2";"SILVA (only NR);Eukaryota;Haptophyta;Prymnesiophyceae;Prymnesiales;Prymnesium;";"0.0";"0";"18";"18";"0";"18";"0";"457165";"391207"
"V4mis2";"SILVA (only NR);Eukaryota;Haptophyta;Prymnesiophyceae;Prymnesiales;Pseudohaptolina;";"0.0";"0";"2";"2";"0";"2";"0";"457181";"391207"
"V4mis2";"SILVA (only NR);Eukaryota;Haptophyta;Prymnesiophyceae;Prymnesiales;Scyphosphaera;";"0.0";"0";"1";"1";"0";"1";"0";"457182";"391207"
"V4mis2";"SILVA (only NR);Eukaryota;Haptophyta;Prymnesiophyceae;Prymnesiales;uncultured;";"0.0";"0";"3";"2";"0";"2";"1";"457181";"391207"
"V4mis2";"SILVA (only NR);Eukaryota;Haptophyta;Prymnesiophyceae;SGUH624;";"0.0";"0";"3";"3";"0";"3";"0";"457180";"391207"
"V4mis2";"SILVA (only NR);Eukaryota;Haptophyta;Prymnesiophyceae;uncultured;";"0.0";"0";"2";"2";"0";"2";"0";"457181";"391207"
"V4mis2";"SILVA (only NR);Eukaryota;Haptophyta;T58;";"0.0";"0";"3";"2";"0";"2";"1";"457181";"391207"
"V4mis2";"SILVA (only NR);Eukaryota;Haptophyta;uncultured;";"0.0";"0";"2";"2";"0";"2";"0";"457181";"391207"
"V4mis2";"SILVA (only NR);Eukaryota;Incertae Sedis;";"13.2";"14.4";"117";"114";"15";"99";"3";"457069";"391192"
"V4mis2";"SILVA (only NR);Eukaryota;Incertae Sedis;Ancyromonadida;";"63.6";"14.4";"11";"11";"7";"4";"0";"457172";"391200"
"V4mis2";"SILVA (only NR);Eukaryota;Incertae Sedis;Ancyromonadida;Ancyromonas;";"100.0";"14.4";"4";"4";"4";"0";"0";"457179";"391203"
"V4mis2";"SILVA (only NR);Eukaryota;Incertae Sedis;Ancyromonadida;Nutomonas;";"100.0";"14.4";"1";"1";"1";"0";"0";"457182";"391206"
"V4mis2";"SILVA (only NR);Eukaryota;Incertae Sedis;Apusomonadidae;";"75.0";"14.4";"8";"8";"6";"2";"0";"457175";"391201"
"V4mis2";"SILVA (only NR);Eukaryota;Incertae Sedis;Apusomonadidae;Amastigomonas;";"66.7";"14.4";"6";"6";"4";"2";"0";"457177";"391203"
"V4mis2";"SILVA (only NR);Eukaryota;Incertae Sedis;Apusomonadidae;Chelonemonas;";"100.0";"14.4";"2";"2";"2";"0";"0";"457181";"391205"
"V4mis2";"SILVA (only NR);Eukaryota;Incertae Sedis;Mantamonas;";"0.0";"0";"4";"4";"0";"4";"0";"457179";"391207"
"V4mis2";"SILVA (only NR);Eukaryota;Incertae Sedis;Palpitomonas;";"7.7";"14.4";"13";"13";"1";"12";"0";"457170";"391206"
"V4mis2";"SILVA (only NR);Eukaryota;Incertae Sedis;Palustrimonas;";"0.0";"0";"1";"1";"0";"1";"0";"457182";"391207"
"V4mis2";"SILVA (only NR);Eukaryota;Incertae Sedis;Telonema;";"1.3";"14.4";"78";"75";"1";"74";"3";"457108";"391206"
"V4mis2";"SILVA (only NR);Eukaryota;NAMAKO-1;";"100.0";"14.4";"3";"3";"3";"0";"0";"457180";"391204"
"V4mis2";"SILVA (only NR);Eukaryota;Picozoa;";"0.0";"0";"34";"34";"0";"34";"0";"457149";"391207"
"V4mis2";"SILVA (only NR);Eukaryota;Picozoa;Picomonadida;";"0.0";"0";"17";"17";"0";"17";"0";"457166";"391207"
"V4mis2";"SILVA (only NR);Eukaryota;Picozoa;Picomonadida;Picomonadidae;";"0.0";"0";"6";"6";"0";"6";"0";"457177";"391207"
"V4mis2";"SILVA (only NR);Eukaryota;Picozoa;Picomonadida;Picomonadidae;Picomonas;";"0.0";"0";"6";"6";"0";"6";"0";"457177";"391207"
"V4mis2";"SILVA (only NR);Eukaryota;SA1-3C06;";"0.0";"0";"4";"4";"0";"4";"0";"457179";"391207"
"V4mis2";"SILVA (only NR);Eukaryota;SAR;";"36.2";"12.8";"15220";"14610";"5283";"9327";"610";"442573";"385924"
"V4mis2";"SILVA (only NR);Eukaryota;SAR;Alveolata;";"21.9";"13.2";"9140";"8922";"1955";"6967";"218";"448261";"389252"
"V4mis2";"SILVA (only NR);Eukaryota;SAR;Alveolata;Acavomonidia;";"0.0";"0";"1";"1";"0";"1";"0";"457182";"391207"
"V4mis2";"SILVA (only NR);Eukaryota;SAR;Alveolata;Acavomonidia;Acavomonas;";"0.0";"0";"1";"1";"0";"1";"0";"457182";"391207"
"V4mis2";"SILVA (only NR);Eukaryota;SAR;Alveolata;Apicomplexa;";"30.6";"14.3";"1206";"1197";"366";"831";"9";"455986";"390841"
"V4mis2";"SILVA (only NR);Eukaryota;SAR;Alveolata;Apicomplexa;Aconoidasida;";"54.9";"14.4";"487";"483";"265";"218";"4";"456700";"390942"
"V4mis2";"SILVA (only NR);Eukaryota;SAR;Alveolata;Apicomplexa;Aconoidasida;Haemosporoidia;";"0.0";"0";"198";"194";"0";"194";"4";"456989";"391207"
"V4mis2";"SILVA (only NR);Eukaryota;SAR;Alveolata;Apicomplexa;Aconoidasida;Haemosporoidia;Plasmodium;";"0.0";"0";"198";"194";"0";"194";"4";"456989";"391207"
"V4mis2";"SILVA (only NR);Eukaryota;SAR;Alveolata;Apicomplexa;Aconoidasida;Piroplasmorida;";"91.7";"14.4";"289";"289";"265";"24";"0";"456894";"390942"
"V4mis2";"SILVA (only NR);Eukaryota;SAR;Alveolata;Apicomplexa;Aconoidasida;Piroplasmorida;Babesia;";"96.5";"14.4";"141";"141";"136";"5";"0";"457042";"391071"
"V4mis2";"SILVA (only NR);Eukaryota;SAR;Alveolata;Apicomplexa;Aconoidasida;Piroplasmorida;Cardiosporidium;";"0.0";"0";"2";"2";"0";"2";"0";"457181";"391207"
"V4mis2";"SILVA (only NR);Eukaryota;SAR;Alveolata;Apicomplexa;Aconoidasida;Piroplasmorida;Cytauxzoon;";"100.0";"14.4";"4";"4";"4";"0";"0";"457179";"391203"
"V4mis2";"SILVA (only NR);Eukaryota;SAR;Alveolata;Apicomplexa;Aconoidasida;Piroplasmorida;Nephromyces;";"0.0";"0";"9";"9";"0";"9";"0";"457174";"391207"
"V4mis2";"SILVA (only NR);Eukaryota;SAR;Alveolata;Apicomplexa;Aconoidasida;Piroplasmorida;Theileria;";"95.8";"14.4";"120";"120";"115";"5";"0";"457063";"391092"
"V4mis2";"SILVA (only NR);Eukaryota;SAR;Alveolata;Apicomplexa;Aconoidasida;Piroplasmorida;uncultured;";"25.0";"14.4";"4";"4";"1";"3";"0";"457179";"391206"
"V4mis2";"SILVA (only NR);Eukaryota;SAR;Alveolata;Apicomplexa;Conoidasida;";"14.6";"14.3";"682";"677";"99";"578";"5";"456506";"391108"
"V4mis2";"SILVA (only NR);Eukaryota;SAR;Alveolata;Apicomplexa;Conoidasida;Coccidia;";"2.6";"14.3";"458";"457";"12";"445";"1";"456726";"391195"
"V4mis2";"SILVA (only NR);Eukaryota;SAR;Alveolata;Apicomplexa;Conoidasida;Coccidia;Adeleorina;";"10.1";"14.4";"69";"69";"7";"62";"0";"457114";"391200"
"V4mis2";"SILVA (only NR);Eukaryota;SAR;Alveolata;Apicomplexa;Conoidasida;Coccidia;Adeleorina;Adelina;";"0.0";"0";"2";"2";"0";"2";"0";"457181";"391207"
"V4mis2";"SILVA (only NR);Eukaryota;SAR;Alveolata;Apicomplexa;Conoidasida;Coccidia;Adeleorina;Dactylosoma;";"0.0";"0";"1";"1";"0";"1";"0";"457182";"391207"
"V4mis2";"SILVA (only NR);Eukaryota;SAR;Alveolata;Apicomplexa;Conoidasida;Coccidia;Adeleorina;Haemogregarina;";"0.0";"0";"5";"5";"0";"5";"0";"457178";"391207"
"V4mis2";"SILVA (only NR);Eukaryota;SAR;Alveolata;Apicomplexa;Conoidasida;Coccidia;Adeleorina;Hemolivia;";"0.0";"0";"7";"7";"0";"7";"0";"457176";"391207"
"V4mis2";"SILVA (only NR);Eukaryota;SAR;Alveolata;Apicomplexa;Conoidasida;Coccidia;Adeleorina;Hepatozoon;";"13.7";"14.4";"51";"51";"7";"44";"0";"457132";"391200"
"V4mis2";"SILVA (only NR);Eukaryota;SAR;Alveolata;Apicomplexa;Conoidasida;Coccidia;Adeleorina;Klossia;";"0.0";"0";"1";"1";"0";"1";"0";"457182";"391207"
"V4mis2";"SILVA (only NR);Eukaryota;SAR;Alveolata;Apicomplexa;Conoidasida;Coccidia;Eimeriorina;";"1.3";"14.4";"389";"388";"5";"383";"1";"456795";"391202"
"V4mis2";"SILVA (only NR);Eukaryota;SAR;Alveolata;Apicomplexa;Conoidasida;Coccidia;Eimeriorina;Acroeimeria;";"0.0";"0";"4";"4";"0";"4";"0";"457179";"391207"
"V4mis2";"SILVA (only NR);Eukaryota;SAR;Alveolata;Apicomplexa;Conoidasida;Coccidia;Eimeriorina;Aggregata;";"0.0";"0";"3";"3";"0";"3";"0";"457180";"391207"
"V4mis2";"SILVA (only NR);Eukaryota;SAR;Alveolata;Apicomplexa;Conoidasida;Coccidia;Eimeriorina;Besnoitia;";"0.0";"0";"3";"3";"0";"3";"0";"457180";"391207"
"V4mis2";"SILVA (only NR);Eukaryota;SAR;Alveolata;Apicomplexa;Conoidasida;Coccidia;Eimeriorina;Calyptosporidae;";"0.0";"0";"6";"6";"0";"6";"0";"457177";"391207"
"V4mis2";"SILVA (only NR);Eukaryota;SAR;Alveolata;Apicomplexa;Conoidasida;Coccidia;Eimeriorina;Caryospora;";"0.0";"0";"2";"2";"0";"2";"0";"457181";"391207"
"V4mis2";"SILVA (only NR);Eukaryota;SAR;Alveolata;Apicomplexa;Conoidasida;Coccidia;Eimeriorina;Choleoeimeria;";"0.0";"0";"2";"1";"0";"1";"1";"457182";"391207"
"V4mis2";"SILVA (only NR);Eukaryota;SAR;Alveolata;Apicomplexa;Conoidasida;Coccidia;Eimeriorina;Cyclospora;";"0.0";"0";"1";"1";"0";"1";"0";"457182";"391207"
"V4mis2";"SILVA (only NR);Eukaryota;SAR;Alveolata;Apicomplexa;Conoidasida;Coccidia;Eimeriorina;Cystoisospora;";"0.0";"0";"3";"3";"0";"3";"0";"457180";"391207"
"V4mis2";"SILVA (only NR);Eukaryota;SAR;Alveolata;Apicomplexa;Conoidasida;Coccidia;Eimeriorina;Eimeria;";"0.7";"14.4";"148";"148";"1";"147";"0";"457035";"391206"
"V4mis2";"SILVA (only NR);Eukaryota;SAR;Alveolata;Apicomplexa;Conoidasida;Coccidia;Eimeriorina;Goussia;";"4.0";"14.4";"25";"25";"1";"24";"0";"457158";"391206"
"V4mis2";"SILVA (only NR);Eukaryota;SAR;Alveolata;Apicomplexa;Conoidasida;Coccidia;Eimeriorina;Hyaloklossia;";"0.0";"0";"1";"1";"0";"1";"0";"457182";"391207"
"V4mis2";"SILVA (only NR);Eukaryota;SAR;Alveolata;Apicomplexa;Conoidasida;Coccidia;Eimeriorina;Isospora;";"0.0";"0";"2";"2";"0";"2";"0";"457181";"391207"
"V4mis2";"SILVA (only NR);Eukaryota;SAR;Alveolata;Apicomplexa;Conoidasida;Coccidia;Eimeriorina;Lankesterella;";"0.0";"0";"7";"7";"0";"7";"0";"457176";"391207"
"V4mis2";"SILVA (only NR);Eukaryota;SAR;Alveolata;Apicomplexa;Conoidasida;Coccidia;Eimeriorina;Margolisiella;";"60.0";"14.4";"5";"5";"3";"2";"0";"457178";"391204"
"V4mis2";"SILVA (only NR);Eukaryota;SAR;Alveolata;Apicomplexa;Conoidasida;Coccidia;Eimeriorina;Rhytidocystis;";"0.0";"0";"3";"3";"0";"3";"0";"457180";"391207"
"V4mis2";"SILVA (only NR);Eukaryota;SAR;Alveolata;Apicomplexa;Conoidasida;Coccidia;Eimeriorina;Sarcocystis;";"0.0";"0";"129";"129";"0";"129";"0";"457054";"391207"
"V4mis2";"SILVA (only NR);Eukaryota;SAR;Alveolata;Apicomplexa;Conoidasida;Coccidia;Eimeriorina;Toxoplasma;";"0.0";"0";"4";"4";"0";"4";"0";"457179";"391207"
"V4mis2";"SILVA (only NR);Eukaryota;SAR;Alveolata;Apicomplexa;Conoidasida;Coccidia;Eimeriorina;uncultured;";"0.0";"0";"8";"8";"0";"8";"0";"457175";"391207"
"V4mis2";"SILVA (only NR);Eukaryota;SAR;Alveolata;Apicomplexa;Conoidasida;Cryptosporida;";"25.6";"14.4";"43";"43";"11";"32";"0";"457140";"391196"
"V4mis2";"SILVA (only NR);Eukaryota;SAR;Alveolata;Apicomplexa;Conoidasida;Cryptosporida;Cryptosporidium;";"25.6";"14.4";"43";"43";"11";"32";"0";"457140";"391196"
"V4mis2";"SILVA (only NR);Eukaryota;SAR;Alveolata;Apicomplexa;Conoidasida;Gregarinasina;";"43.4";"14.4";"178";"175";"76";"99";"3";"457008";"391131"
"V4mis2";"SILVA (only NR);Eukaryota;SAR;Alveolata;Apicomplexa;Conoidasida;Gregarinasina;Archigregarinorida;";"0.0";"0";"33";"33";"0";"33";"0";"457150";"391207"
"V4mis2";"SILVA (only NR);Eukaryota;SAR;Alveolata;Apicomplexa;Conoidasida;Gregarinasina;Archigregarinorida;Filipodium;";"0.0";"0";"1";"1";"0";"1";"0";"457182";"391207"
"V4mis2";"SILVA (only NR);Eukaryota;SAR;Alveolata;Apicomplexa;Conoidasida;Gregarinasina;Archigregarinorida;Selenidium;";"0.0";"0";"32";"32";"0";"32";"0";"457151";"391207"
"V4mis2";"SILVA (only NR);Eukaryota;SAR;Alveolata;Apicomplexa;Conoidasida;Gregarinasina;BAQA40;";"0.0";"0";"4";"4";"0";"4";"0";"457179";"391207"
"V4mis2";"SILVA (only NR);Eukaryota;SAR;Alveolata;Apicomplexa;Conoidasida;Gregarinasina;Eugregarinorida;";"59.8";"14.4";"130";"127";"76";"51";"3";"457056";"391131"
"V4mis2";"SILVA (only NR);Eukaryota;SAR;Alveolata;Apicomplexa;Conoidasida;Gregarinasina;Eugregarinorida;Amoebogregarina;";"100.0";"14.4";"1";"1";"1";"0";"0";"457182";"391206"
"V4mis2";"SILVA (only NR);Eukaryota;SAR;Alveolata;Apicomplexa;Conoidasida;Gregarinasina;Eugregarinorida;Ascogregarina;";"0.0";"0";"4";"4";"0";"4";"0";"457179";"391207"
"V4mis2";"SILVA (only NR);Eukaryota;SAR;Alveolata;Apicomplexa;Conoidasida;Gregarinasina;Eugregarinorida;Colepismatophila;";"0.0";"0";"1";"1";"0";"1";"0";"457182";"391207"
"V4mis2";"SILVA (only NR);Eukaryota;SAR;Alveolata;Apicomplexa;Conoidasida;Gregarinasina;Eugregarinorida;D3P05A02;";"0.0";"0";"4";"3";"0";"3";"1";"457180";"391207"
"V4mis2";"SILVA (only NR);Eukaryota;SAR;Alveolata;Apicomplexa;Conoidasida;Gregarinasina;Eugregarinorida;D4P07G01;";"100.0";"14.4";"3";"3";"3";"0";"0";"457180";"391204"
"V4mis2";"SILVA (only NR);Eukaryota;SAR;Alveolata;Apicomplexa;Conoidasida;Gregarinasina;Eugregarinorida;Elev-18S-1089;";"0.0";"0";"4";"4";"0";"4";"0";"457179";"391207"
"V4mis2";"SILVA (only NR);Eukaryota;SAR;Alveolata;Apicomplexa;Conoidasida;Gregarinasina;Eugregarinorida;Geneiorhynchus;";"0.0";"0";"1";"1";"0";"1";"0";"457182";"391207"
"V4mis2";"SILVA (only NR);Eukaryota;SAR;Alveolata;Apicomplexa;Conoidasida;Gregarinasina;Eugregarinorida;Gregarina;";"100.0";"14.4";"13";"11";"11";"0";"2";"457172";"391196"
"V4mis2";"SILVA (only NR);Eukaryota;SAR;Alveolata;Apicomplexa;Conoidasida;Gregarinasina;Eugregarinorida;Hoplorhynchus;";"0.0";"0";"2";"2";"0";"2";"0";"457181";"391207"
"V4mis2";"SILVA (only NR);Eukaryota;SAR;Alveolata;Apicomplexa;Conoidasida;Gregarinasina;Eugregarinorida;LEMD098;";"77.8";"14.4";"9";"9";"7";"2";"0";"457174";"391200"
"V4mis2";"SILVA (only NR);Eukaryota;SAR;Alveolata;Apicomplexa;Conoidasida;Gregarinasina;Eugregarinorida;Lankesteria;";"100.0";"14.4";"15";"15";"15";"0";"0";"457168";"391192"
"V4mis2";"SILVA (only NR);Eukaryota;SAR;Alveolata;Apicomplexa;Conoidasida;Gregarinasina;Eugregarinorida;Lecudina;";"66.7";"14.4";"21";"21";"14";"7";"0";"457162";"391193"
"V4mis2";"SILVA (only NR);Eukaryota;SAR;Alveolata;Apicomplexa;Conoidasida;Gregarinasina;Eugregarinorida;Leidyana;";"100.0";"14.4";"3";"3";"3";"0";"0";"457180";"391204"
"V4mis2";"SILVA (only NR);Eukaryota;SAR;Alveolata;Apicomplexa;Conoidasida;Gregarinasina;Eugregarinorida;Monocystis;";"0.0";"0";"3";"3";"0";"3";"0";"457180";"391207"
"V4mis2";"SILVA (only NR);Eukaryota;SAR;Alveolata;Apicomplexa;Conoidasida;Gregarinasina;Eugregarinorida;Nematopsis;";"0.0";"0";"6";"6";"0";"6";"0";"457177";"391207"
"V4mis2";"SILVA (only NR);Eukaryota;SAR;Alveolata;Apicomplexa;Conoidasida;Gregarinasina;Eugregarinorida;Paraschneideria;";"0.0";"0";"2";"2";"0";"2";"0";"457181";"391207"
"V4mis2";"SILVA (only NR);Eukaryota;SAR;Alveolata;Apicomplexa;Conoidasida;Gregarinasina;Eugregarinorida;Prismatospora;";"0.0";"0";"1";"1";"0";"1";"0";"457182";"391207"
"V4mis2";"SILVA (only NR);Eukaryota;SAR;Alveolata;Apicomplexa;Conoidasida;Gregarinasina;Eugregarinorida;Protomagalhaensia;";"100.0";"14.4";"1";"1";"1";"0";"0";"457182";"391206"
"V4mis2";"SILVA (only NR);Eukaryota;SAR;Alveolata;Apicomplexa;Conoidasida;Gregarinasina;Eugregarinorida;Psychodiella;";"0.0";"0";"2";"2";"0";"2";"0";"457181";"391207"
"V4mis2";"SILVA (only NR);Eukaryota;SAR;Alveolata;Apicomplexa;Conoidasida;Gregarinasina;Eugregarinorida;Pterospora;";"100.0";"14.4";"2";"2";"2";"0";"0";"457181";"391205"
"V4mis2";"SILVA (only NR);Eukaryota;SAR;Alveolata;Apicomplexa;Conoidasida;Gregarinasina;Eugregarinorida;Stenophora;";"0.0";"0";"1";"1";"0";"1";"0";"457182";"391207"
"V4mis2";"SILVA (only NR);Eukaryota;SAR;Alveolata;Apicomplexa;Conoidasida;Gregarinasina;Eugregarinorida;Stylocephalus;";"0.0";"0";"2";"2";"0";"2";"0";"457181";"391207"
"V4mis2";"SILVA (only NR);Eukaryota;SAR;Alveolata;Apicomplexa;Conoidasida;Gregarinasina;Eugregarinorida;Syncystis;";"0.0";"0";"1";"1";"0";"1";"0";"457182";"391207"
"V4mis2";"SILVA (only NR);Eukaryota;SAR;Alveolata;Apicomplexa;Conoidasida;Gregarinasina;Eugregarinorida;Urospora;";"100.0";"14.4";"6";"6";"6";"0";"0";"457177";"391201"
"V4mis2";"SILVA (only NR);Eukaryota;SAR;Alveolata;Apicomplexa;Conoidasida;Gregarinasina;Eugregarinorida;Xiphocephalus;";"0.0";"0";"1";"1";"0";"1";"0";"457182";"391207"
"V4mis2";"SILVA (only NR);Eukaryota;SAR;Alveolata;Apicomplexa;Conoidasida;Gregarinasina;Eugregarinorida;uncultured;";"28.6";"14.4";"7";"7";"2";"5";"0";"457176";"391205"
"V4mis2";"SILVA (only NR);Eukaryota;SAR;Alveolata;Apicomplexa;Conoidasida;Gregarinasina;Neogregarinorida;";"0.0";"0";"8";"8";"0";"8";"0";"457175";"391207"
"V4mis2";"SILVA (only NR);Eukaryota;SAR;Alveolata;Apicomplexa;Conoidasida;Gregarinasina;Neogregarinorida;Apicystis;";"0.0";"0";"2";"2";"0";"2";"0";"457181";"391207"
"V4mis2";"SILVA (only NR);Eukaryota;SAR;Alveolata;Apicomplexa;Conoidasida;Gregarinasina;Neogregarinorida;Aranciocystis;";"0.0";"0";"1";"1";"0";"1";"0";"457182";"391207"
"V4mis2";"SILVA (only NR);Eukaryota;SAR;Alveolata;Apicomplexa;Conoidasida;Gregarinasina;Neogregarinorida;Mattesia;";"0.0";"0";"2";"2";"0";"2";"0";"457181";"391207"
"V4mis2";"SILVA (only NR);Eukaryota;SAR;Alveolata;Apicomplexa;Conoidasida;Gregarinasina;Neogregarinorida;Ophryocystis;";"0.0";"0";"1";"1";"0";"1";"0";"457182";"391207"
"V4mis2";"SILVA (only NR);Eukaryota;SAR;Alveolata;Apicomplexa;Novel Apicomplexa Class 1;";"5.9";"14.4";"17";"17";"1";"16";"0";"457166";"391206"
"V4mis2";"SILVA (only NR);Eukaryota;SAR;Alveolata;Apicomplexa;Novel Apicomplexa Class 2;";"5.6";"14.4";"18";"18";"1";"17";"0";"457165";"391206"
"V4mis2";"SILVA (only NR);Eukaryota;SAR;Alveolata;Ciliophora;";"12.5";"14";"2935";"2931";"367";"2564";"4";"454252";"390840"
"V4mis2";"SILVA (only NR);Eukaryota;SAR;Alveolata;Ciliophora;Intramacronucleata;";"13.1";"14";"2783";"2779";"365";"2414";"4";"454404";"390842"
"V4mis2";"SILVA (only NR);Eukaryota;SAR;Alveolata;Ciliophora;Intramacronucleata;Armophorea;";"0.0";"0";"83";"83";"0";"83";"0";"457100";"391207"
"V4mis2";"SILVA (only NR);Eukaryota;SAR;Alveolata;Ciliophora;Intramacronucleata;Armophorea;Armophorida;";"0.0";"0";"39";"39";"0";"39";"0";"457144";"391207"
"V4mis2";"SILVA (only NR);Eukaryota;SAR;Alveolata;Ciliophora;Intramacronucleata;Armophorea;Armophorida;Brachonella;";"0.0";"0";"10";"10";"0";"10";"0";"457173";"391207"
"V4mis2";"SILVA (only NR);Eukaryota;SAR;Alveolata;Ciliophora;Intramacronucleata;Armophorea;Armophorida;Caenomorpha;";"0.0";"0";"5";"5";"0";"5";"0";"457178";"391207"
"V4mis2";"SILVA (only NR);Eukaryota;SAR;Alveolata;Ciliophora;Intramacronucleata;Armophorea;Armophorida;Metopus;";"0.0";"0";"14";"14";"0";"14";"0";"457169";"391207"
"V4mis2";"SILVA (only NR);Eukaryota;SAR;Alveolata;Ciliophora;Intramacronucleata;Armophorea;Armophorida;Parametopidium;";"0.0";"0";"1";"1";"0";"1";"0";"457182";"391207"
"V4mis2";"SILVA (only NR);Eukaryota;SAR;Alveolata;Ciliophora;Intramacronucleata;Armophorea;Cariaco Basin group 1;";"0.0";"0";"9";"9";"0";"9";"0";"457174";"391207"
"V4mis2";"SILVA (only NR);Eukaryota;SAR;Alveolata;Ciliophora;Intramacronucleata;Armophorea;Cariaco Basin group 2;";"0.0";"0";"7";"7";"0";"7";"0";"457176";"391207"
"V4mis2";"SILVA (only NR);Eukaryota;SAR;Alveolata;Ciliophora;Intramacronucleata;Armophorea;Clevelandellida;";"0.0";"0";"15";"15";"0";"15";"0";"457168";"391207"
"V4mis2";"SILVA (only NR);Eukaryota;SAR;Alveolata;Ciliophora;Intramacronucleata;Armophorea;Clevelandellida;Clevelandella;";"0.0";"0";"5";"5";"0";"5";"0";"457178";"391207"
"V4mis2";"SILVA (only NR);Eukaryota;SAR;Alveolata;Ciliophora;Intramacronucleata;Armophorea;Clevelandellida;Nyctotheroides;";"0.0";"0";"4";"4";"0";"4";"0";"457179";"391207"
"V4mis2";"SILVA (only NR);Eukaryota;SAR;Alveolata;Ciliophora;Intramacronucleata;Armophorea;Clevelandellida;Nyctotherus;";"0.0";"0";"5";"5";"0";"5";"0";"457178";"391207"
"V4mis2";"SILVA (only NR);Eukaryota;SAR;Alveolata;Ciliophora;Intramacronucleata;Armophorea;uncultured;";"0.0";"0";"10";"10";"0";"10";"0";"457173";"391207"
"V4mis2";"SILVA (only NR);Eukaryota;SAR;Alveolata;Ciliophora;Intramacronucleata;Conthreep;";"15.6";"14.3";"1076";"1074";"168";"906";"2";"456109";"391039"
"V4mis2";"SILVA (only NR);Eukaryota;SAR;Alveolata;Ciliophora;Intramacronucleata;Conthreep;Colpodea;";"1.7";"14.4";"117";"117";"2";"115";"0";"457066";"391205"
"V4mis2";"SILVA (only NR);Eukaryota;SAR;Alveolata;Ciliophora;Intramacronucleata;Conthreep;Colpodea;Bursariomorphida;";"8.3";"14.4";"12";"12";"1";"11";"0";"457171";"391206"
"V4mis2";"SILVA (only NR);Eukaryota;SAR;Alveolata;Ciliophora;Intramacronucleata;Conthreep;Colpodea;Bursariomorphida;Bryometopus;";"11.1";"14.4";"9";"9";"1";"8";"0";"457174";"391206"
"V4mis2";"SILVA (only NR);Eukaryota;SAR;Alveolata;Ciliophora;Intramacronucleata;Conthreep;Colpodea;Bursariomorphida;Bursaria;";"0.0";"0";"3";"3";"0";"3";"0";"457180";"391207"
"V4mis2";"SILVA (only NR);Eukaryota;SAR;Alveolata;Ciliophora;Intramacronucleata;Conthreep;Colpodea;Colpodida;";"1.5";"14.4";"68";"68";"1";"67";"0";"457115";"391206"
"V4mis2";"SILVA (only NR);Eukaryota;SAR;Alveolata;Ciliophora;Intramacronucleata;Conthreep;Colpodea;Colpodida;Bardeliella;";"0.0";"0";"1";"1";"0";"1";"0";"457182";"391207"
"V4mis2";"SILVA (only NR);Eukaryota;SAR;Alveolata;Ciliophora;Intramacronucleata;Conthreep;Colpodea;Colpodida;Bresslaua;";"0.0";"0";"1";"1";"0";"1";"0";"457182";"391207"
"V4mis2";"SILVA (only NR);Eukaryota;SAR;Alveolata;Ciliophora;Intramacronucleata;Conthreep;Colpodea;Colpodida;Bresslauides;";"0.0";"0";"2";"2";"0";"2";"0";"457181";"391207"
"V4mis2";"SILVA (only NR);Eukaryota;SAR;Alveolata;Ciliophora;Intramacronucleata;Conthreep;Colpodea;Colpodida;Bromeliothrix;";"0.0";"0";"3";"3";"0";"3";"0";"457180";"391207"
"V4mis2";"SILVA (only NR);Eukaryota;SAR;Alveolata;Ciliophora;Intramacronucleata;Conthreep;Colpodea;Colpodida;Bryophrya;";"0.0";"0";"1";"1";"0";"1";"0";"457182";"391207"
"V4mis2";"SILVA (only NR);Eukaryota;SAR;Alveolata;Ciliophora;Intramacronucleata;Conthreep;Colpodea;Colpodida;Bryophryoides;";"0.0";"0";"1";"1";"0";"1";"0";"457182";"391207"
"V4mis2";"SILVA (only NR);Eukaryota;SAR;Alveolata;Ciliophora;Intramacronucleata;Conthreep;Colpodea;Colpodida;Colpoda;";"0.0";"0";"17";"17";"0";"17";"0";"457166";"391207"
"V4mis2";"SILVA (only NR);Eukaryota;SAR;Alveolata;Ciliophora;Intramacronucleata;Conthreep;Colpodea;Colpodida;Exocolpoda;";"0.0";"0";"1";"1";"0";"1";"0";"457182";"391207"
"V4mis2";"SILVA (only NR);Eukaryota;SAR;Alveolata;Ciliophora;Intramacronucleata;Conthreep;Colpodea;Colpodida;Hausmanniella;";"0.0";"0";"1";"1";"0";"1";"0";"457182";"391207"
"V4mis2";"SILVA (only NR);Eukaryota;SAR;Alveolata;Ciliophora;Intramacronucleata;Conthreep;Colpodea;Colpodida;Ilsiella;";"0.0";"0";"1";"1";"0";"1";"0";"457182";"391207"
"V4mis2";"SILVA (only NR);Eukaryota;SAR;Alveolata;Ciliophora;Intramacronucleata;Conthreep;Colpodea;Colpodida;Jaroschia;";"0.0";"0";"1";"1";"0";"1";"0";"457182";"391207"
"V4mis2";"SILVA (only NR);Eukaryota;SAR;Alveolata;Ciliophora;Intramacronucleata;Conthreep;Colpodea;Colpodida;Kalometopia;";"0.0";"0";"1";"1";"0";"1";"0";"457182";"391207"
"V4mis2";"SILVA (only NR);Eukaryota;SAR;Alveolata;Ciliophora;Intramacronucleata;Conthreep;Colpodea;Colpodida;Maryna;";"0.0";"0";"3";"3";"0";"3";"0";"457180";"391207"
"V4mis2";"SILVA (only NR);Eukaryota;SAR;Alveolata;Ciliophora;Intramacronucleata;Conthreep;Colpodea;Colpodida;Mykophagophrys;";"0.0";"0";"1";"1";"0";"1";"0";"457182";"391207"
"V4mis2";"SILVA (only NR);Eukaryota;SAR;Alveolata;Ciliophora;Intramacronucleata;Conthreep;Colpodea;Colpodida;Notoxoma;";"0.0";"0";"2";"2";"0";"2";"0";"457181";"391207"
"V4mis2";"SILVA (only NR);Eukaryota;SAR;Alveolata;Ciliophora;Intramacronucleata;Conthreep;Colpodea;Colpodida;Pseudoplatyophrya;";"0.0";"0";"2";"2";"0";"2";"0";"457181";"391207"
"V4mis2";"SILVA (only NR);Eukaryota;SAR;Alveolata;Ciliophora;Intramacronucleata;Conthreep;Colpodea;Colpodida;Repoma;";"0.0";"0";"1";"1";"0";"1";"0";"457182";"391207"
"V4mis2";"SILVA (only NR);Eukaryota;SAR;Alveolata;Ciliophora;Intramacronucleata;Conthreep;Colpodea;Colpodida;uncultured;";"0.0";"0";"7";"7";"0";"7";"0";"457176";"391207"
"V4mis2";"SILVA (only NR);Eukaryota;SAR;Alveolata;Ciliophora;Intramacronucleata;Conthreep;Colpodea;Cyrtolophosidida;";"0.0";"0";"15";"15";"0";"15";"0";"457168";"391207"
"V4mis2";"SILVA (only NR);Eukaryota;SAR;Alveolata;Ciliophora;Intramacronucleata;Conthreep;Colpodea;Cyrtolophosidida;Aristerostoma;";"0.0";"0";"3";"3";"0";"3";"0";"457180";"391207"
"V4mis2";"SILVA (only NR);Eukaryota;SAR;Alveolata;Ciliophora;Intramacronucleata;Conthreep;Colpodea;Cyrtolophosidida;Cyrtolophosis;";"0.0";"0";"4";"4";"0";"4";"0";"457179";"391207"
"V4mis2";"SILVA (only NR);Eukaryota;SAR;Alveolata;Ciliophora;Intramacronucleata;Conthreep;Colpodea;Cyrtolophosidida;Microdiaphanosoma;";"0.0";"0";"3";"3";"0";"3";"0";"457180";"391207"
"V4mis2";"SILVA (only NR);Eukaryota;SAR;Alveolata;Ciliophora;Intramacronucleata;Conthreep;Colpodea;Platyophryida;";"0.0";"0";"18";"18";"0";"18";"0";"457165";"391207"
"V4mis2";"SILVA (only NR);Eukaryota;SAR;Alveolata;Ciliophora;Intramacronucleata;Conthreep;Colpodea;Platyophryida;Etoschophrya;";"0.0";"0";"1";"1";"0";"1";"0";"457182";"391207"
"V4mis2";"SILVA (only NR);Eukaryota;SAR;Alveolata;Ciliophora;Intramacronucleata;Conthreep;Colpodea;Platyophryida;Platyophrya;";"0.0";"0";"8";"8";"0";"8";"0";"457175";"391207"
"V4mis2";"SILVA (only NR);Eukaryota;SAR;Alveolata;Ciliophora;Intramacronucleata;Conthreep;Colpodea;Platyophryida;Platyophryides;";"0.0";"0";"2";"2";"0";"2";"0";"457181";"391207"
"V4mis2";"SILVA (only NR);Eukaryota;SAR;Alveolata;Ciliophora;Intramacronucleata;Conthreep;Colpodea;Platyophryida;Sorogena;";"0.0";"0";"1";"1";"0";"1";"0";"457182";"391207"
"V4mis2";"SILVA (only NR);Eukaryota;SAR;Alveolata;Ciliophora;Intramacronucleata;Conthreep;Colpodea;Platyophryida;Woodruffides;";"0.0";"0";"4";"4";"0";"4";"0";"457179";"391207"
"V4mis2";"SILVA (only NR);Eukaryota;SAR;Alveolata;Ciliophora;Intramacronucleata;Conthreep;Colpodea;uncultured;";"0.0";"0";"4";"4";"0";"4";"0";"457179";"391207"
"V4mis2";"SILVA (only NR);Eukaryota;SAR;Alveolata;Ciliophora;Intramacronucleata;Conthreep;IN2411;";"0.0";"0";"6";"6";"0";"6";"0";"457177";"391207"
"V4mis2";"SILVA (only NR);Eukaryota;SAR;Alveolata;Ciliophora;Intramacronucleata;Conthreep;Nassophorea;";"6.8";"14.4";"74";"73";"5";"68";"1";"457110";"391202"
"V4mis2";"SILVA (only NR);Eukaryota;SAR;Alveolata;Ciliophora;Intramacronucleata;Conthreep;Nassophorea;Colpodidium;";"0.0";"0";"3";"3";"0";"3";"0";"457180";"391207"
"V4mis2";"SILVA (only NR);Eukaryota;SAR;Alveolata;Ciliophora;Intramacronucleata;Conthreep;Nassophorea;Discotricha;";"0.0";"0";"8";"8";"0";"8";"0";"457175";"391207"
"V4mis2";"SILVA (only NR);Eukaryota;SAR;Alveolata;Ciliophora;Intramacronucleata;Conthreep;Nassophorea;Furgasonia;";"0.0";"0";"1";"1";"0";"1";"0";"457182";"391207"
"V4mis2";"SILVA (only NR);Eukaryota;SAR;Alveolata;Ciliophora;Intramacronucleata;Conthreep;Nassophorea;Leptopharynx;";"0.0";"0";"2";"2";"0";"2";"0";"457181";"391207"
"V4mis2";"SILVA (only NR);Eukaryota;SAR;Alveolata;Ciliophora;Intramacronucleata;Conthreep;Nassophorea;Obertrumia;";"100.0";"14.4";"4";"4";"4";"0";"0";"457179";"391203"
"V4mis2";"SILVA (only NR);Eukaryota;SAR;Alveolata;Ciliophora;Intramacronucleata;Conthreep;Nassophorea;Pseudomicrothorax;";"0.0";"0";"1";"1";"0";"1";"0";"457182";"391207"
"V4mis2";"SILVA (only NR);Eukaryota;SAR;Alveolata;Ciliophora;Intramacronucleata;Conthreep;Nassophorea;Trochiliopsis;";"0.0";"0";"1";"1";"0";"1";"0";"457182";"391207"
"V4mis2";"SILVA (only NR);Eukaryota;SAR;Alveolata;Ciliophora;Intramacronucleata;Conthreep;Nassophorea;Zosterodasys;";"0.0";"0";"10";"10";"0";"10";"0";"457173";"391207"
"V4mis2";"SILVA (only NR);Eukaryota;SAR;Alveolata;Ciliophora;Intramacronucleata;Conthreep;Nassophorea;uncultured;";"0.0";"0";"35";"34";"0";"34";"1";"457149";"391207"
"V4mis2";"SILVA (only NR);Eukaryota;SAR;Alveolata;Ciliophora;Intramacronucleata;Conthreep;Oligohymenophorea;";"2.7";"14.3";"587";"586";"16";"570";"1";"456597";"391191"
"V4mis2";"SILVA (only NR);Eukaryota;SAR;Alveolata;Ciliophora;Intramacronucleata;Conthreep;Oligohymenophorea;Apostomatia;";"0.0";"0";"31";"31";"0";"31";"0";"457152";"391207"
"V4mis2";"SILVA (only NR);Eukaryota;SAR;Alveolata;Ciliophora;Intramacronucleata;Conthreep;Oligohymenophorea;Apostomatia;Cinetochilum;";"0.0";"0";"2";"2";"0";"2";"0";"457181";"391207"
"V4mis2";"SILVA (only NR);Eukaryota;SAR;Alveolata;Ciliophora;Intramacronucleata;Conthreep;Oligohymenophorea;Apostomatia;Fusiforma;";"0.0";"0";"1";"1";"0";"1";"0";"457182";"391207"
"V4mis2";"SILVA (only NR);Eukaryota;SAR;Alveolata;Ciliophora;Intramacronucleata;Conthreep;Oligohymenophorea;Apostomatia;Gymnodinioides;";"0.0";"0";"2";"2";"0";"2";"0";"457181";"391207"
"V4mis2";"SILVA (only NR);Eukaryota;SAR;Alveolata;Ciliophora;Intramacronucleata;Conthreep;Oligohymenophorea;Apostomatia;Hyalophysa;";"0.0";"0";"6";"6";"0";"6";"0";"457177";"391207"
"V4mis2";"SILVA (only NR);Eukaryota;SAR;Alveolata;Ciliophora;Intramacronucleata;Conthreep;Oligohymenophorea;Apostomatia;Platynematum;";"0.0";"0";"1";"1";"0";"1";"0";"457182";"391207"
"V4mis2";"SILVA (only NR);Eukaryota;SAR;Alveolata;Ciliophora;Intramacronucleata;Conthreep;Oligohymenophorea;Apostomatia;Pseudocollinia;";"0.0";"0";"3";"3";"0";"3";"0";"457180";"391207"
"V4mis2";"SILVA (only NR);Eukaryota;SAR;Alveolata;Ciliophora;Intramacronucleata;Conthreep;Oligohymenophorea;Apostomatia;Vampyrophrya;";"0.0";"0";"1";"1";"0";"1";"0";"457182";"391207"
"V4mis2";"SILVA (only NR);Eukaryota;SAR;Alveolata;Ciliophora;Intramacronucleata;Conthreep;Oligohymenophorea;Apostomatia;uncultured;";"0.0";"0";"7";"7";"0";"7";"0";"457176";"391207"
"V4mis2";"SILVA (only NR);Eukaryota;SAR;Alveolata;Ciliophora;Intramacronucleata;Conthreep;Oligohymenophorea;Astomatia;";"0.0";"0";"6";"6";"0";"6";"0";"457177";"391207"
"V4mis2";"SILVA (only NR);Eukaryota;SAR;Alveolata;Ciliophora;Intramacronucleata;Conthreep;Oligohymenophorea;Astomatia;Anoplophrya;";"0.0";"0";"1";"1";"0";"1";"0";"457182";"391207"
"V4mis2";"SILVA (only NR);Eukaryota;SAR;Alveolata;Ciliophora;Intramacronucleata;Conthreep;Oligohymenophorea;Astomatia;Metaracoelophrya;";"0.0";"0";"2";"2";"0";"2";"0";"457181";"391207"
"V4mis2";"SILVA (only NR);Eukaryota;SAR;Alveolata;Ciliophora;Intramacronucleata;Conthreep;Oligohymenophorea;Astomatia;Metaradiophrya;";"0.0";"0";"1";"1";"0";"1";"0";"457182";"391207"
"V4mis2";"SILVA (only NR);Eukaryota;SAR;Alveolata;Ciliophora;Intramacronucleata;Conthreep;Oligohymenophorea;Astomatia;Njinella;";"0.0";"0";"1";"1";"0";"1";"0";"457182";"391207"
"V4mis2";"SILVA (only NR);Eukaryota;SAR;Alveolata;Ciliophora;Intramacronucleata;Conthreep;Oligohymenophorea;Astomatia;Paraclausilocola;";"0.0";"0";"1";"1";"0";"1";"0";"457182";"391207"
"V4mis2";"SILVA (only NR);Eukaryota;SAR;Alveolata;Ciliophora;Intramacronucleata;Conthreep;Oligohymenophorea;CV1-2A-17;";"0.0";"0";"6";"6";"0";"6";"0";"457177";"391207"
"V4mis2";"SILVA (only NR);Eukaryota;SAR;Alveolata;Ciliophora;Intramacronucleata;Conthreep;Oligohymenophorea;Hymenostomatia;";"9.7";"14.4";"31";"31";"3";"28";"0";"457152";"391204"
"V4mis2";"SILVA (only NR);Eukaryota;SAR;Alveolata;Ciliophora;Intramacronucleata;Conthreep;Oligohymenophorea;Hymenostomatia;Agolohymena;";"0.0";"0";"1";"1";"0";"1";"0";"457182";"391207"
"V4mis2";"SILVA (only NR);Eukaryota;SAR;Alveolata;Ciliophora;Intramacronucleata;Conthreep;Oligohymenophorea;Hymenostomatia;Bromeliophrya;";"0.0";"0";"4";"4";"0";"4";"0";"457179";"391207"
"V4mis2";"SILVA (only NR);Eukaryota;SAR;Alveolata;Ciliophora;Intramacronucleata;Conthreep;Oligohymenophorea;Hymenostomatia;Colpidium;";"0.0";"0";"1";"1";"0";"1";"0";"457182";"391207"
"V4mis2";"SILVA (only NR);Eukaryota;SAR;Alveolata;Ciliophora;Intramacronucleata;Conthreep;Oligohymenophorea;Hymenostomatia;Glaucoma;";"0.0";"0";"2";"2";"0";"2";"0";"457181";"391207"
"V4mis2";"SILVA (only NR);Eukaryota;SAR;Alveolata;Ciliophora;Intramacronucleata;Conthreep;Oligohymenophorea;Hymenostomatia;Ichthyophthirius;";"0.0";"0";"1";"1";"0";"1";"0";"457182";"391207"
"V4mis2";"SILVA (only NR);Eukaryota;SAR;Alveolata;Ciliophora;Intramacronucleata;Conthreep;Oligohymenophorea;Hymenostomatia;Ophryoglena;";"0.0";"0";"1";"1";"0";"1";"0";"457182";"391207"
"V4mis2";"SILVA (only NR);Eukaryota;SAR;Alveolata;Ciliophora;Intramacronucleata;Conthreep;Oligohymenophorea;Hymenostomatia;Tetrahymena;";"15.4";"14.4";"13";"13";"2";"11";"0";"457170";"391205"
"V4mis2";"SILVA (only NR);Eukaryota;SAR;Alveolata;Ciliophora;Intramacronucleata;Conthreep;Oligohymenophorea;Hymenostomatia;uncultured;";"0.0";"0";"2";"2";"0";"2";"0";"457181";"391207"
"V4mis2";"SILVA (only NR);Eukaryota;SAR;Alveolata;Ciliophora;Intramacronucleata;Conthreep;Oligohymenophorea;Peniculia;";"0.0";"0";"79";"79";"0";"79";"0";"457104";"391207"
"V4mis2";"SILVA (only NR);Eukaryota;SAR;Alveolata;Ciliophora;Intramacronucleata;Conthreep;Oligohymenophorea;Peniculia;Frontonia;";"0.0";"0";"25";"25";"0";"25";"0";"457158";"391207"
"V4mis2";"SILVA (only NR);Eukaryota;SAR;Alveolata;Ciliophora;Intramacronucleata;Conthreep;Oligohymenophorea;Peniculia;Lembadion;";"0.0";"0";"1";"1";"0";"1";"0";"457182";"391207"
"V4mis2";"SILVA (only NR);Eukaryota;SAR;Alveolata;Ciliophora;Intramacronucleata;Conthreep;Oligohymenophorea;Peniculia;Paramecium;";"0.0";"0";"29";"29";"0";"29";"0";"457154";"391207"
"V4mis2";"SILVA (only NR);Eukaryota;SAR;Alveolata;Ciliophora;Intramacronucleata;Conthreep;Oligohymenophorea;Peniculia;Stokesia;";"0.0";"0";"16";"16";"0";"16";"0";"457167";"391207"
"V4mis2";"SILVA (only NR);Eukaryota;SAR;Alveolata;Ciliophora;Intramacronucleata;Conthreep;Oligohymenophorea;Peniculia;uncultured;";"0.0";"0";"2";"2";"0";"2";"0";"457181";"391207"
"V4mis2";"SILVA (only NR);Eukaryota;SAR;Alveolata;Ciliophora;Intramacronucleata;Conthreep;Oligohymenophorea;Peritrichia;";"5.1";"14.4";"235";"235";"12";"223";"0";"456948";"391195"
"V4mis2";"SILVA (only NR);Eukaryota;SAR;Alveolata;Ciliophora;Intramacronucleata;Conthreep;Oligohymenophorea;Peritrichia;Apocarchesium;";"0.0";"0";"2";"2";"0";"2";"0";"457181";"391207"
"V4mis2";"SILVA (only NR);Eukaryota;SAR;Alveolata;Ciliophora;Intramacronucleata;Conthreep;Oligohymenophorea;Peritrichia;Astylozoon;";"0.0";"0";"1";"1";"0";"1";"0";"457182";"391207"
"V4mis2";"SILVA (only NR);Eukaryota;SAR;Alveolata;Ciliophora;Intramacronucleata;Conthreep;Oligohymenophorea;Peritrichia;Carchesium;";"0.0";"0";"2";"2";"0";"2";"0";"457181";"391207"
"V4mis2";"SILVA (only NR);Eukaryota;SAR;Alveolata;Ciliophora;Intramacronucleata;Conthreep;Oligohymenophorea;Peritrichia;Cothurnia;";"0.0";"0";"4";"4";"0";"4";"0";"457179";"391207"
"V4mis2";"SILVA (only NR);Eukaryota;SAR;Alveolata;Ciliophora;Intramacronucleata;Conthreep;Oligohymenophorea;Peritrichia;Epicarchesium;";"0.0";"0";"6";"6";"0";"6";"0";"457177";"391207"
"V4mis2";"SILVA (only NR);Eukaryota;SAR;Alveolata;Ciliophora;Intramacronucleata;Conthreep;Oligohymenophorea;Peritrichia;Epistylis;";"25.0";"14.4";"12";"12";"3";"9";"0";"457171";"391204"
"V4mis2";"SILVA (only NR);Eukaryota;SAR;Alveolata;Ciliophora;Intramacronucleata;Conthreep;Oligohymenophorea;Peritrichia;Opercularia;";"0.0";"0";"1";"1";"0";"1";"0";"457182";"391207"
"V4mis2";"SILVA (only NR);Eukaryota;SAR;Alveolata;Ciliophora;Intramacronucleata;Conthreep;Oligohymenophorea;Peritrichia;Ophrydium;";"0.0";"0";"1";"1";"0";"1";"0";"457182";"391207"
"V4mis2";"SILVA (only NR);Eukaryota;SAR;Alveolata;Ciliophora;Intramacronucleata;Conthreep;Oligohymenophorea;Peritrichia;Opisthonecta;";"0.0";"0";"3";"3";"0";"3";"0";"457180";"391207"
"V4mis2";"SILVA (only NR);Eukaryota;SAR;Alveolata;Ciliophora;Intramacronucleata;Conthreep;Oligohymenophorea;Peritrichia;Pseudepistylis;";"0.0";"0";"1";"1";"0";"1";"0";"457182";"391207"
"V4mis2";"SILVA (only NR);Eukaryota;SAR;Alveolata;Ciliophora;Intramacronucleata;Conthreep;Oligohymenophorea;Peritrichia;Pseudovorticella;";"0.0";"0";"19";"19";"0";"19";"0";"457164";"391207"
"V4mis2";"SILVA (only NR);Eukaryota;SAR;Alveolata;Ciliophora;Intramacronucleata;Conthreep;Oligohymenophorea;Peritrichia;Telotrochidium;";"0.0";"0";"25";"25";"0";"25";"0";"457158";"391207"
"V4mis2";"SILVA (only NR);Eukaryota;SAR;Alveolata;Ciliophora;Intramacronucleata;Conthreep;Oligohymenophorea;Peritrichia;Trichodina;";"0.0";"0";"22";"22";"0";"22";"0";"457161";"391207"
"V4mis2";"SILVA (only NR);Eukaryota;SAR;Alveolata;Ciliophora;Intramacronucleata;Conthreep;Oligohymenophorea;Peritrichia;Trichodinella;";"0.0";"0";"4";"4";"0";"4";"0";"457179";"391207"
"V4mis2";"SILVA (only NR);Eukaryota;SAR;Alveolata;Ciliophora;Intramacronucleata;Conthreep;Oligohymenophorea;Peritrichia;Urceolaria;";"0.0";"0";"5";"5";"0";"5";"0";"457178";"391207"
"V4mis2";"SILVA (only NR);Eukaryota;SAR;Alveolata;Ciliophora;Intramacronucleata;Conthreep;Oligohymenophorea;Peritrichia;Vaginicola;";"0.0";"0";"4";"4";"0";"4";"0";"457179";"391207"
"V4mis2";"SILVA (only NR);Eukaryota;SAR;Alveolata;Ciliophora;Intramacronucleata;Conthreep;Oligohymenophorea;Peritrichia;Vorticella;";"0.0";"0";"19";"19";"0";"19";"0";"457164";"391207"
"V4mis2";"SILVA (only NR);Eukaryota;SAR;Alveolata;Ciliophora;Intramacronucleata;Conthreep;Oligohymenophorea;Peritrichia;Zoothamnium;";"0.0";"0";"40";"40";"0";"40";"0";"457143";"391207"
"V4mis2";"SILVA (only NR);Eukaryota;SAR;Alveolata;Ciliophora;Intramacronucleata;Conthreep;Oligohymenophorea;Peritrichia;Zoothamnopsis;";"0.0";"0";"4";"4";"0";"4";"0";"457179";"391207"
"V4mis2";"SILVA (only NR);Eukaryota;SAR;Alveolata;Ciliophora;Intramacronucleata;Conthreep;Oligohymenophorea;Peritrichia;uncultured;";"47.1";"14.4";"17";"17";"8";"9";"0";"457166";"391199"
"V4mis2";"SILVA (only NR);Eukaryota;SAR;Alveolata;Ciliophora;Intramacronucleata;Conthreep;Oligohymenophorea;Scuticociliatia;";"0.5";"14.4";"190";"189";"1";"188";"1";"456994";"391206"
"V4mis2";"SILVA (only NR);Eukaryota;SAR;Alveolata;Ciliophora;Intramacronucleata;Conthreep;Oligohymenophorea;Scuticociliatia;Ancistrum;";"0.0";"0";"2";"2";"0";"2";"0";"457181";"391207"
"V4mis2";"SILVA (only NR);Eukaryota;SAR;Alveolata;Ciliophora;Intramacronucleata;Conthreep;Oligohymenophorea;Scuticociliatia;Anophryoides;";"0.0";"0";"1";"1";"0";"1";"0";"457182";"391207"
"V4mis2";"SILVA (only NR);Eukaryota;SAR;Alveolata;Ciliophora;Intramacronucleata;Conthreep;Oligohymenophorea;Scuticociliatia;Boveria;";"0.0";"0";"2";"2";"0";"2";"0";"457181";"391207"
"V4mis2";"SILVA (only NR);Eukaryota;SAR;Alveolata;Ciliophora;Intramacronucleata;Conthreep;Oligohymenophorea;Scuticociliatia;Cardiostomatella;";"0.0";"0";"5";"5";"0";"5";"0";"457178";"391207"
"V4mis2";"SILVA (only NR);Eukaryota;SAR;Alveolata;Ciliophora;Intramacronucleata;Conthreep;Oligohymenophorea;Scuticociliatia;Cohnilembus;";"0.0";"0";"1";"1";"0";"1";"0";"457182";"391207"
"V4mis2";"SILVA (only NR);Eukaryota;SAR;Alveolata;Ciliophora;Intramacronucleata;Conthreep;Oligohymenophorea;Scuticociliatia;Cristigera;";"0.0";"0";"4";"4";"0";"4";"0";"457179";"391207"
"V4mis2";"SILVA (only NR);Eukaryota;SAR;Alveolata;Ciliophora;Intramacronucleata;Conthreep;Oligohymenophorea;Scuticociliatia;Cyclidium;";"0.0";"0";"12";"12";"0";"12";"0";"457171";"391207"
"V4mis2";"SILVA (only NR);Eukaryota;SAR;Alveolata;Ciliophora;Intramacronucleata;Conthreep;Oligohymenophorea;Scuticociliatia;Dexiotricha;";"0.0";"0";"3";"3";"0";"3";"0";"457180";"391207"
"V4mis2";"SILVA (only NR);Eukaryota;SAR;Alveolata;Ciliophora;Intramacronucleata;Conthreep;Oligohymenophorea;Scuticociliatia;Dexitrichides;";"0.0";"0";"1";"1";"0";"1";"0";"457182";"391207"
"V4mis2";"SILVA (only NR);Eukaryota;SAR;Alveolata;Ciliophora;Intramacronucleata;Conthreep;Oligohymenophorea;Scuticociliatia;Entodiscus;";"0.0";"0";"1";"1";"0";"1";"0";"457182";"391207"
"V4mis2";"SILVA (only NR);Eukaryota;SAR;Alveolata;Ciliophora;Intramacronucleata;Conthreep;Oligohymenophorea;Scuticociliatia;Entorhipidium;";"0.0";"0";"1";"1";"0";"1";"0";"457182";"391207"
"V4mis2";"SILVA (only NR);Eukaryota;SAR;Alveolata;Ciliophora;Intramacronucleata;Conthreep;Oligohymenophorea;Scuticociliatia;Eurystomatella;";"0.0";"0";"1";"1";"0";"1";"0";"457182";"391207"
"V4mis2";"SILVA (only NR);Eukaryota;SAR;Alveolata;Ciliophora;Intramacronucleata;Conthreep;Oligohymenophorea;Scuticociliatia;Falcicyclidium;";"0.0";"0";"2";"2";"0";"2";"0";"457181";"391207"
"V4mis2";"SILVA (only NR);Eukaryota;SAR;Alveolata;Ciliophora;Intramacronucleata;Conthreep;Oligohymenophorea;Scuticociliatia;Hippocomos;";"0.0";"0";"1";"1";"0";"1";"0";"457182";"391207"
"V4mis2";"SILVA (only NR);Eukaryota;SAR;Alveolata;Ciliophora;Intramacronucleata;Conthreep;Oligohymenophorea;Scuticociliatia;Histiobalantium;";"0.0";"0";"3";"3";"0";"3";"0";"457180";"391207"
"V4mis2";"SILVA (only NR);Eukaryota;SAR;Alveolata;Ciliophora;Intramacronucleata;Conthreep;Oligohymenophorea;Scuticociliatia;Homalogastra;";"0.0";"0";"13";"13";"0";"13";"0";"457170";"391207"
"V4mis2";"SILVA (only NR);Eukaryota;SAR;Alveolata;Ciliophora;Intramacronucleata;Conthreep;Oligohymenophorea;Scuticociliatia;Mesanophrys;";"0.0";"0";"2";"2";"0";"2";"0";"457181";"391207"
"V4mis2";"SILVA (only NR);Eukaryota;SAR;Alveolata;Ciliophora;Intramacronucleata;Conthreep;Oligohymenophorea;Scuticociliatia;Metanophrys;";"0.0";"0";"3";"3";"0";"3";"0";"457180";"391207"
"V4mis2";"SILVA (only NR);Eukaryota;SAR;Alveolata;Ciliophora;Intramacronucleata;Conthreep;Oligohymenophorea;Scuticociliatia;Miamiensis;";"0.0";"0";"3";"3";"0";"3";"0";"457180";"391207"
"V4mis2";"SILVA (only NR);Eukaryota;SAR;Alveolata;Ciliophora;Intramacronucleata;Conthreep;Oligohymenophorea;Scuticociliatia;Paranophrys;";"0.0";"0";"2";"2";"0";"2";"0";"457181";"391207"
"V4mis2";"SILVA (only NR);Eukaryota;SAR;Alveolata;Ciliophora;Intramacronucleata;Conthreep;Oligohymenophorea;Scuticociliatia;Paratetrahymena;";"0.0";"0";"2";"2";"0";"2";"0";"457181";"391207"
"V4mis2";"SILVA (only NR);Eukaryota;SAR;Alveolata;Ciliophora;Intramacronucleata;Conthreep;Oligohymenophorea;Scuticociliatia;Parauronema;";"0.0";"0";"2";"2";"0";"2";"0";"457181";"391207"
"V4mis2";"SILVA (only NR);Eukaryota;SAR;Alveolata;Ciliophora;Intramacronucleata;Conthreep;Oligohymenophorea;Scuticociliatia;Philaster;";"0.0";"0";"4";"4";"0";"4";"0";"457179";"391207"
"V4mis2";"SILVA (only NR);Eukaryota;SAR;Alveolata;Ciliophora;Intramacronucleata;Conthreep;Oligohymenophorea;Scuticociliatia;Philasterides;";"0.0";"0";"1";"1";"0";"1";"0";"457182";"391207"
"V4mis2";"SILVA (only NR);Eukaryota;SAR;Alveolata;Ciliophora;Intramacronucleata;Conthreep;Oligohymenophorea;Scuticociliatia;Pleuronema;";"0.0";"0";"26";"26";"0";"26";"0";"457157";"391207"
"V4mis2";"SILVA (only NR);Eukaryota;SAR;Alveolata;Ciliophora;Intramacronucleata;Conthreep;Oligohymenophorea;Scuticociliatia;Porpostoma;";"0.0";"0";"1";"1";"0";"1";"0";"457182";"391207"
"V4mis2";"SILVA (only NR);Eukaryota;SAR;Alveolata;Ciliophora;Intramacronucleata;Conthreep;Oligohymenophorea;Scuticociliatia;Protocyclidium;";"14.3";"14.4";"7";"7";"1";"6";"0";"457176";"391206"
"V4mis2";"SILVA (only NR);Eukaryota;SAR;Alveolata;Ciliophora;Intramacronucleata;Conthreep;Oligohymenophorea;Scuticociliatia;Pseudocohnilembus;";"0.0";"0";"6";"6";"0";"6";"0";"457177";"391207"
"V4mis2";"SILVA (only NR);Eukaryota;SAR;Alveolata;Ciliophora;Intramacronucleata;Conthreep;Oligohymenophorea;Scuticociliatia;Pseudoplatynematum;";"0.0";"0";"1";"1";"0";"1";"0";"457182";"391207"
"V4mis2";"SILVA (only NR);Eukaryota;SAR;Alveolata;Ciliophora;Intramacronucleata;Conthreep;Oligohymenophorea;Scuticociliatia;Sathrophilus;";"0.0";"0";"2";"2";"0";"2";"0";"457181";"391207"
"V4mis2";"SILVA (only NR);Eukaryota;SAR;Alveolata;Ciliophora;Intramacronucleata;Conthreep;Oligohymenophorea;Scuticociliatia;Schizocalyptra;";"0.0";"0";"3";"3";"0";"3";"0";"457180";"391207"
"V4mis2";"SILVA (only NR);Eukaryota;SAR;Alveolata;Ciliophora;Intramacronucleata;Conthreep;Oligohymenophorea;Scuticociliatia;Schizocaryum;";"0.0";"0";"1";"1";"0";"1";"0";"457182";"391207"
"V4mis2";"SILVA (only NR);Eukaryota;SAR;Alveolata;Ciliophora;Intramacronucleata;Conthreep;Oligohymenophorea;Scuticociliatia;Thyrophylax;";"0.0";"0";"1";"1";"0";"1";"0";"457182";"391207"
"V4mis2";"SILVA (only NR);Eukaryota;SAR;Alveolata;Ciliophora;Intramacronucleata;Conthreep;Oligohymenophorea;Scuticociliatia;Uronema;";"0.0";"0";"4";"4";"0";"4";"0";"457179";"391207"
"V4mis2";"SILVA (only NR);Eukaryota;SAR;Alveolata;Ciliophora;Intramacronucleata;Conthreep;Oligohymenophorea;Scuticociliatia;Uronemella;";"0.0";"0";"2";"2";"0";"2";"0";"457181";"391207"
"V4mis2";"SILVA (only NR);Eukaryota;SAR;Alveolata;Ciliophora;Intramacronucleata;Conthreep;Oligohymenophorea;Scuticociliatia;Wilbertia;";"0.0";"0";"1";"1";"0";"1";"0";"457182";"391207"
"V4mis2";"SILVA (only NR);Eukaryota;SAR;Alveolata;Ciliophora;Intramacronucleata;Conthreep;Oligohymenophorea;Scuticociliatia;uncultured;";"0.0";"0";"44";"43";"0";"43";"1";"457140";"391207"
"V4mis2";"SILVA (only NR);Eukaryota;SAR;Alveolata;Ciliophora;Intramacronucleata;Conthreep;Oligohymenophorea;uncultured;";"0.0";"0";"2";"2";"0";"2";"0";"457181";"391207"
"V4mis2";"SILVA (only NR);Eukaryota;SAR;Alveolata;Ciliophora;Intramacronucleata;Conthreep;Phyllopharyngea;";"95.1";"14.4";"144";"144";"137";"7";"0";"457039";"391070"
"V4mis2";"SILVA (only NR);Eukaryota;SAR;Alveolata;Ciliophora;Intramacronucleata;Conthreep;Phyllopharyngea;Cyrtophoria;";"98.0";"14.4";"99";"99";"97";"2";"0";"457084";"391110"
"V4mis2";"SILVA (only NR);Eukaryota;SAR;Alveolata;Ciliophora;Intramacronucleata;Conthreep;Phyllopharyngea;Cyrtophoria;Aegyriana;";"100.0";"14.4";"2";"2";"2";"0";"0";"457181";"391205"
"V4mis2";"SILVA (only NR);Eukaryota;SAR;Alveolata;Ciliophora;Intramacronucleata;Conthreep;Phyllopharyngea;Cyrtophoria;Agnathodysteria;";"100.0";"14.4";"1";"1";"1";"0";"0";"457182";"391206"
"V4mis2";"SILVA (only NR);Eukaryota;SAR;Alveolata;Ciliophora;Intramacronucleata;Conthreep;Phyllopharyngea;Cyrtophoria;Brooklynella;";"100.0";"14.4";"1";"1";"1";"0";"0";"457182";"391206"
"V4mis2";"SILVA (only NR);Eukaryota;SAR;Alveolata;Ciliophora;Intramacronucleata;Conthreep;Phyllopharyngea;Cyrtophoria;Chilodochona;";"100.0";"14.4";"3";"3";"3";"0";"0";"457180";"391204"
"V4mis2";"SILVA (only NR);Eukaryota;SAR;Alveolata;Ciliophora;Intramacronucleata;Conthreep;Phyllopharyngea;Cyrtophoria;Chilodonella;";"100.0";"14.4";"5";"5";"5";"0";"0";"457178";"391202"
"V4mis2";"SILVA (only NR);Eukaryota;SAR;Alveolata;Ciliophora;Intramacronucleata;Conthreep;Phyllopharyngea;Cyrtophoria;Chlamydodon;";"100.0";"14.4";"9";"9";"9";"0";"0";"457174";"391198"
"V4mis2";"SILVA (only NR);Eukaryota;SAR;Alveolata;Ciliophora;Intramacronucleata;Conthreep;Phyllopharyngea;Cyrtophoria;Chlamydonella;";"100.0";"14.4";"2";"2";"2";"0";"0";"457181";"391205"
"V4mis2";"SILVA (only NR);Eukaryota;SAR;Alveolata;Ciliophora;Intramacronucleata;Conthreep;Phyllopharyngea;Cyrtophoria;Chlamydonellopsis;";"100.0";"14.4";"2";"2";"2";"0";"0";"457181";"391205"
"V4mis2";"SILVA (only NR);Eukaryota;SAR;Alveolata;Ciliophora;Intramacronucleata;Conthreep;Phyllopharyngea;Cyrtophoria;Coeloperix;";"100.0";"14.4";"4";"4";"4";"0";"0";"457179";"391203"
"V4mis2";"SILVA (only NR);Eukaryota;SAR;Alveolata;Ciliophora;Intramacronucleata;Conthreep;Phyllopharyngea;Cyrtophoria;Dysteria;";"100.0";"14.4";"17";"17";"17";"0";"0";"457166";"391190"
"V4mis2";"SILVA (only NR);Eukaryota;SAR;Alveolata;Ciliophora;Intramacronucleata;Conthreep;Phyllopharyngea;Cyrtophoria;Hartmannula;";"100.0";"14.4";"2";"2";"2";"0";"0";"457181";"391205"
"V4mis2";"SILVA (only NR);Eukaryota;SAR;Alveolata;Ciliophora;Intramacronucleata;Conthreep;Phyllopharyngea;Cyrtophoria;Heterohartmannula;";"100.0";"14.4";"1";"1";"1";"0";"0";"457182";"391206"
"V4mis2";"SILVA (only NR);Eukaryota;SAR;Alveolata;Ciliophora;Intramacronucleata;Conthreep;Phyllopharyngea;Cyrtophoria;Microxysma;";"100.0";"14.4";"1";"1";"1";"0";"0";"457182";"391206"
"V4mis2";"SILVA (only NR);Eukaryota;SAR;Alveolata;Ciliophora;Intramacronucleata;Conthreep;Phyllopharyngea;Cyrtophoria;Odontochlamys;";"100.0";"14.4";"1";"1";"1";"0";"0";"457182";"391206"
"V4mis2";"SILVA (only NR);Eukaryota;SAR;Alveolata;Ciliophora;Intramacronucleata;Conthreep;Phyllopharyngea;Cyrtophoria;Paracyrtophoron;";"100.0";"14.4";"1";"1";"1";"0";"0";"457182";"391206"
"V4mis2";"SILVA (only NR);Eukaryota;SAR;Alveolata;Ciliophora;Intramacronucleata;Conthreep;Phyllopharyngea;Cyrtophoria;Phascolodon;";"100.0";"14.4";"7";"7";"7";"0";"0";"457176";"391200"
"V4mis2";"SILVA (only NR);Eukaryota;SAR;Alveolata;Ciliophora;Intramacronucleata;Conthreep;Phyllopharyngea;Cyrtophoria;Pithites;";"91.7";"14.4";"12";"12";"11";"1";"0";"457171";"391196"
"V4mis2";"SILVA (only NR);Eukaryota;SAR;Alveolata;Ciliophora;Intramacronucleata;Conthreep;Phyllopharyngea;Cyrtophoria;Pseudochilodonopsis;";"100.0";"14.4";"5";"5";"5";"0";"0";"457178";"391202"
"V4mis2";"SILVA (only NR);Eukaryota;SAR;Alveolata;Ciliophora;Intramacronucleata;Conthreep;Phyllopharyngea;Cyrtophoria;Trichopodiella;";"100.0";"14.4";"1";"1";"1";"0";"0";"457182";"391206"
"V4mis2";"SILVA (only NR);Eukaryota;SAR;Alveolata;Ciliophora;Intramacronucleata;Conthreep;Phyllopharyngea;Cyrtophoria;Trithigmostoma;";"100.0";"14.4";"1";"1";"1";"0";"0";"457182";"391206"
"V4mis2";"SILVA (only NR);Eukaryota;SAR;Alveolata;Ciliophora;Intramacronucleata;Conthreep;Phyllopharyngea;Cyrtophoria;Trochilia;";"100.0";"14.4";"1";"1";"1";"0";"0";"457182";"391206"
"V4mis2";"SILVA (only NR);Eukaryota;SAR;Alveolata;Ciliophora;Intramacronucleata;Conthreep;Phyllopharyngea;Cyrtophoria;Trochilioides;";"100.0";"14.4";"1";"1";"1";"0";"0";"457182";"391206"
"V4mis2";"SILVA (only NR);Eukaryota;SAR;Alveolata;Ciliophora;Intramacronucleata;Conthreep;Phyllopharyngea;Cyrtophoria;Trochochilodon;";"100.0";"14.4";"1";"1";"1";"0";"0";"457182";"391206"
"V4mis2";"SILVA (only NR);Eukaryota;SAR;Alveolata;Ciliophora;Intramacronucleata;Conthreep;Phyllopharyngea;Hypocomatida;";"100.0";"14.4";"1";"1";"1";"0";"0";"457182";"391206"
"V4mis2";"SILVA (only NR);Eukaryota;SAR;Alveolata;Ciliophora;Intramacronucleata;Conthreep;Phyllopharyngea;Hypocomatida;Hypocoma;";"100.0";"14.4";"1";"1";"1";"0";"0";"457182";"391206"
"V4mis2";"SILVA (only NR);Eukaryota;SAR;Alveolata;Ciliophora;Intramacronucleata;Conthreep;Phyllopharyngea;Suctoria;";"88.4";"14.4";"43";"43";"38";"5";"0";"457140";"391169"
"V4mis2";"SILVA (only NR);Eukaryota;SAR;Alveolata;Ciliophora;Intramacronucleata;Conthreep;Phyllopharyngea;Suctoria;Acineta;";"100.0";"14.4";"7";"7";"7";"0";"0";"457176";"391200"
"V4mis2";"SILVA (only NR);Eukaryota;SAR;Alveolata;Ciliophora;Intramacronucleata;Conthreep;Phyllopharyngea;Suctoria;BOLA439;";"25.0";"14.4";"4";"4";"1";"3";"0";"457179";"391206"
"V4mis2";"SILVA (only NR);Eukaryota;SAR;Alveolata;Ciliophora;Intramacronucleata;Conthreep;Phyllopharyngea;Suctoria;Discophrya;";"100.0";"14.4";"1";"1";"1";"0";"0";"457182";"391206"
"V4mis2";"SILVA (only NR);Eukaryota;SAR;Alveolata;Ciliophora;Intramacronucleata;Conthreep;Phyllopharyngea;Suctoria;Ephelota;";"87.5";"14.4";"8";"8";"7";"1";"0";"457175";"391200"
"V4mis2";"SILVA (only NR);Eukaryota;SAR;Alveolata;Ciliophora;Intramacronucleata;Conthreep;Phyllopharyngea;Suctoria;Heliophrya;";"100.0";"14.4";"3";"3";"3";"0";"0";"457180";"391204"
"V4mis2";"SILVA (only NR);Eukaryota;SAR;Alveolata;Ciliophora;Intramacronucleata;Conthreep;Phyllopharyngea;Suctoria;Paracineta;";"100.0";"14.4";"5";"5";"5";"0";"0";"457178";"391202"
"V4mis2";"SILVA (only NR);Eukaryota;SAR;Alveolata;Ciliophora;Intramacronucleata;Conthreep;Phyllopharyngea;Suctoria;Tokophrya;";"100.0";"14.4";"8";"8";"8";"0";"0";"457175";"391199"
"V4mis2";"SILVA (only NR);Eukaryota;SAR;Alveolata;Ciliophora;Intramacronucleata;Conthreep;Plagiopylea;";"14.9";"14.4";"47";"47";"7";"40";"0";"457136";"391200"
"V4mis2";"SILVA (only NR);Eukaryota;SAR;Alveolata;Ciliophora;Intramacronucleata;Conthreep;Plagiopylea;Odontostomatida;";"0.0";"0";"12";"12";"0";"12";"0";"457171";"391207"
"V4mis2";"SILVA (only NR);Eukaryota;SAR;Alveolata;Ciliophora;Intramacronucleata;Conthreep;Plagiopylea;Odontostomatida;Epalxella;";"0.0";"0";"12";"12";"0";"12";"0";"457171";"391207"
"V4mis2";"SILVA (only NR);Eukaryota;SAR;Alveolata;Ciliophora;Intramacronucleata;Conthreep;Plagiopylea;Plagiopylida;";"20.6";"14.4";"34";"34";"7";"27";"0";"457149";"391200"
"V4mis2";"SILVA (only NR);Eukaryota;SAR;Alveolata;Ciliophora;Intramacronucleata;Conthreep;Plagiopylea;Plagiopylida;FV36-2C12;";"0.0";"0";"3";"3";"0";"3";"0";"457180";"391207"
"V4mis2";"SILVA (only NR);Eukaryota;SAR;Alveolata;Ciliophora;Intramacronucleata;Conthreep;Plagiopylea;Plagiopylida;Lechriopyla;";"0.0";"0";"6";"6";"0";"6";"0";"457177";"391207"
"V4mis2";"SILVA (only NR);Eukaryota;SAR;Alveolata;Ciliophora;Intramacronucleata;Conthreep;Plagiopylea;Plagiopylida;Parasonderia;";"0.0";"0";"3";"3";"0";"3";"0";"457180";"391207"
"V4mis2";"SILVA (only NR);Eukaryota;SAR;Alveolata;Ciliophora;Intramacronucleata;Conthreep;Plagiopylea;Plagiopylida;Plagiopyla;";"0.0";"0";"4";"4";"0";"4";"0";"457179";"391207"
"V4mis2";"SILVA (only NR);Eukaryota;SAR;Alveolata;Ciliophora;Intramacronucleata;Conthreep;Plagiopylea;Plagiopylida;RM1-SG02;";"0.0";"0";"2";"2";"0";"2";"0";"457181";"391207"
"V4mis2";"SILVA (only NR);Eukaryota;SAR;Alveolata;Ciliophora;Intramacronucleata;Conthreep;Plagiopylea;Plagiopylida;Trimyema;";"53.8";"14.4";"13";"13";"7";"6";"0";"457170";"391200"
"V4mis2";"SILVA (only NR);Eukaryota;SAR;Alveolata;Ciliophora;Intramacronucleata;Conthreep;Prostomatea;";"0.0";"0";"99";"99";"0";"99";"0";"457084";"391207"
"V4mis2";"SILVA (only NR);Eukaryota;SAR;Alveolata;Ciliophora;Intramacronucleata;Conthreep;Prostomatea;Coleps;";"0.0";"0";"6";"6";"0";"6";"0";"457177";"391207"
"V4mis2";"SILVA (only NR);Eukaryota;SAR;Alveolata;Ciliophora;Intramacronucleata;Conthreep;Prostomatea;Cryptocaryon;";"0.0";"0";"68";"68";"0";"68";"0";"457115";"391207"
"V4mis2";"SILVA (only NR);Eukaryota;SAR;Alveolata;Ciliophora;Intramacronucleata;Conthreep;Prostomatea;Levicoleps;";"0.0";"0";"2";"2";"0";"2";"0";"457181";"391207"
"V4mis2";"SILVA (only NR);Eukaryota;SAR;Alveolata;Ciliophora;Intramacronucleata;Conthreep;Prostomatea;Nolandia;";"0.0";"0";"2";"2";"0";"2";"0";"457181";"391207"
"V4mis2";"SILVA (only NR);Eukaryota;SAR;Alveolata;Ciliophora;Intramacronucleata;Conthreep;Prostomatea;Pinacocoleps;";"0.0";"0";"1";"1";"0";"1";"0";"457182";"391207"
"V4mis2";"SILVA (only NR);Eukaryota;SAR;Alveolata;Ciliophora;Intramacronucleata;Conthreep;Prostomatea;Placus;";"0.0";"0";"3";"3";"0";"3";"0";"457180";"391207"
"V4mis2";"SILVA (only NR);Eukaryota;SAR;Alveolata;Ciliophora;Intramacronucleata;Conthreep;Prostomatea;Plagiopogon;";"0.0";"0";"1";"1";"0";"1";"0";"457182";"391207"
"V4mis2";"SILVA (only NR);Eukaryota;SAR;Alveolata;Ciliophora;Intramacronucleata;Conthreep;Prostomatea;Prorodon;";"0.0";"0";"10";"10";"0";"10";"0";"457173";"391207"
"V4mis2";"SILVA (only NR);Eukaryota;SAR;Alveolata;Ciliophora;Intramacronucleata;Conthreep;Prostomatea;Spathidiopsis;";"0.0";"0";"1";"1";"0";"1";"0";"457182";"391207"
"V4mis2";"SILVA (only NR);Eukaryota;SAR;Alveolata;Ciliophora;Intramacronucleata;Conthreep;Prostomatea;Tiarina;";"0.0";"0";"2";"2";"0";"2";"0";"457181";"391207"
"V4mis2";"SILVA (only NR);Eukaryota;SAR;Alveolata;Ciliophora;Intramacronucleata;Litostomatea;";"42.0";"14.4";"450";"450";"189";"261";"0";"456733";"391018"
"V4mis2";"SILVA (only NR);Eukaryota;SAR;Alveolata;Ciliophora;Intramacronucleata;Litostomatea;Haptoria;";"75.7";"14.4";"169";"169";"128";"41";"0";"457014";"391079"
"V4mis2";"SILVA (only NR);Eukaryota;SAR;Alveolata;Ciliophora;Intramacronucleata;Litostomatea;Haptoria;Acineria;";"100.0";"14.4";"2";"2";"2";"0";"0";"457181";"391205"
"V4mis2";"SILVA (only NR);Eukaryota;SAR;Alveolata;Ciliophora;Intramacronucleata;Litostomatea;Haptoria;Amphileptus;";"100.0";"14.4";"5";"5";"5";"0";"0";"457178";"391202"
"V4mis2";"SILVA (only NR);Eukaryota;SAR;Alveolata;Ciliophora;Intramacronucleata;Litostomatea;Haptoria;Apobryophyllum;";"100.0";"14.4";"3";"3";"3";"0";"0";"457180";"391204"
"V4mis2";"SILVA (only NR);Eukaryota;SAR;Alveolata;Ciliophora;Intramacronucleata;Litostomatea;Haptoria;Arcuospathidium;";"100.0";"14.4";"9";"9";"9";"0";"0";"457174";"391198"
"V4mis2";"SILVA (only NR);Eukaryota;SAR;Alveolata;Ciliophora;Intramacronucleata;Litostomatea;Haptoria;Balantidion;";"100.0";"14.4";"1";"1";"1";"0";"0";"457182";"391206"
"V4mis2";"SILVA (only NR);Eukaryota;SAR;Alveolata;Ciliophora;Intramacronucleata;Litostomatea;Haptoria;Chaenea;";"100.0";"14.4";"6";"6";"6";"0";"0";"457177";"391201"
"V4mis2";"SILVA (only NR);Eukaryota;SAR;Alveolata;Ciliophora;Intramacronucleata;Litostomatea;Haptoria;Didinium;";"94.1";"14.4";"17";"17";"16";"1";"0";"457166";"391191"
"V4mis2";"SILVA (only NR);Eukaryota;SAR;Alveolata;Ciliophora;Intramacronucleata;Litostomatea;Haptoria;Dileptus;";"0.0";"0";"6";"6";"0";"6";"0";"457177";"391207"
"V4mis2";"SILVA (only NR);Eukaryota;SAR;Alveolata;Ciliophora;Intramacronucleata;Litostomatea;Haptoria;Dimacrocaryon;";"0.0";"0";"1";"1";"0";"1";"0";"457182";"391207"
"V4mis2";"SILVA (only NR);Eukaryota;SAR;Alveolata;Ciliophora;Intramacronucleata;Litostomatea;Haptoria;Enchelys;";"100.0";"14.4";"2";"2";"2";"0";"0";"457181";"391205"
"V4mis2";"SILVA (only NR);Eukaryota;SAR;Alveolata;Ciliophora;Intramacronucleata;Litostomatea;Haptoria;Epiphyllum;";"100.0";"14.4";"4";"4";"4";"0";"0";"457179";"391203"
"V4mis2";"SILVA (only NR);Eukaryota;SAR;Alveolata;Ciliophora;Intramacronucleata;Litostomatea;Haptoria;Epispathidium;";"100.0";"14.4";"2";"2";"2";"0";"0";"457181";"391205"
"V4mis2";"SILVA (only NR);Eukaryota;SAR;Alveolata;Ciliophora;Intramacronucleata;Litostomatea;Haptoria;Helicoprorodon;";"0.0";"0";"2";"2";"0";"2";"0";"457181";"391207"
"V4mis2";"SILVA (only NR);Eukaryota;SAR;Alveolata;Ciliophora;Intramacronucleata;Litostomatea;Haptoria;Hemiophrys;";"100.0";"14.4";"6";"6";"6";"0";"0";"457177";"391201"
"V4mis2";"SILVA (only NR);Eukaryota;SAR;Alveolata;Ciliophora;Intramacronucleata;Litostomatea;Haptoria;Homalozoon;";"100.0";"14.4";"2";"2";"2";"0";"0";"457181";"391205"
"V4mis2";"SILVA (only NR);Eukaryota;SAR;Alveolata;Ciliophora;Intramacronucleata;Litostomatea;Haptoria;Lacrymaria;";"100.0";"14.4";"2";"2";"2";"0";"0";"457181";"391205"
"V4mis2";"SILVA (only NR);Eukaryota;SAR;Alveolata;Ciliophora;Intramacronucleata;Litostomatea;Haptoria;Lagynophrya;";"0.0";"0";"1";"1";"0";"1";"0";"457182";"391207"
"V4mis2";"SILVA (only NR);Eukaryota;SAR;Alveolata;Ciliophora;Intramacronucleata;Litostomatea;Haptoria;Litonotus;";"100.0";"14.4";"6";"6";"6";"0";"0";"457177";"391201"
"V4mis2";"SILVA (only NR);Eukaryota;SAR;Alveolata;Ciliophora;Intramacronucleata;Litostomatea;Haptoria;Loxophyllum;";"100.0";"14.4";"9";"9";"9";"0";"0";"457174";"391198"
"V4mis2";"SILVA (only NR);Eukaryota;SAR;Alveolata;Ciliophora;Intramacronucleata;Litostomatea;Haptoria;Microdileptus;";"0.0";"0";"1";"1";"0";"1";"0";"457182";"391207"
"V4mis2";"SILVA (only NR);Eukaryota;SAR;Alveolata;Ciliophora;Intramacronucleata;Litostomatea;Haptoria;Monilicaryon;";"0.0";"0";"1";"1";"0";"1";"0";"457182";"391207"
"V4mis2";"SILVA (only NR);Eukaryota;SAR;Alveolata;Ciliophora;Intramacronucleata;Litostomatea;Haptoria;Phialina;";"100.0";"14.4";"3";"3";"3";"0";"0";"457180";"391204"
"V4mis2";"SILVA (only NR);Eukaryota;SAR;Alveolata;Ciliophora;Intramacronucleata;Litostomatea;Haptoria;Protospathidium;";"100.0";"14.4";"1";"1";"1";"0";"0";"457182";"391206"
"V4mis2";"SILVA (only NR);Eukaryota;SAR;Alveolata;Ciliophora;Intramacronucleata;Litostomatea;Haptoria;Pseudoholophrya;";"100.0";"14.4";"1";"1";"1";"0";"0";"457182";"391206"
"V4mis2";"SILVA (only NR);Eukaryota;SAR;Alveolata;Ciliophora;Intramacronucleata;Litostomatea;Haptoria;Pseudomonilicaryon;";"0.0";"0";"3";"3";"0";"3";"0";"457180";"391207"
"V4mis2";"SILVA (only NR);Eukaryota;SAR;Alveolata;Ciliophora;Intramacronucleata;Litostomatea;Haptoria;Rurikoplites;";"0.0";"0";"4";"4";"0";"4";"0";"457179";"391207"
"V4mis2";"SILVA (only NR);Eukaryota;SAR;Alveolata;Ciliophora;Intramacronucleata;Litostomatea;Haptoria;Spathidium;";"100.0";"14.4";"8";"8";"8";"0";"0";"457175";"391199"
"V4mis2";"SILVA (only NR);Eukaryota;SAR;Alveolata;Ciliophora;Intramacronucleata;Litostomatea;Haptoria;Teuthophrys;";"100.0";"14.4";"1";"1";"1";"0";"0";"457182";"391206"
"V4mis2";"SILVA (only NR);Eukaryota;SAR;Alveolata;Ciliophora;Intramacronucleata;Litostomatea;Haptoria;Trachelius;";"0.0";"0";"1";"1";"0";"1";"0";"457182";"391207"
"V4mis2";"SILVA (only NR);Eukaryota;SAR;Alveolata;Ciliophora;Intramacronucleata;Litostomatea;Haptoria;Trachelotractus;";"0.0";"0";"4";"4";"0";"4";"0";"457179";"391207"
"V4mis2";"SILVA (only NR);Eukaryota;SAR;Alveolata;Ciliophora;Intramacronucleata;Litostomatea;Haptoria;uncultured;";"71.4";"14.4";"7";"7";"5";"2";"0";"457176";"391202"
"V4mis2";"SILVA (only NR);Eukaryota;SAR;Alveolata;Ciliophora;Intramacronucleata;Litostomatea;Mesodiniidae;";"93.8";"14.4";"64";"64";"60";"4";"0";"457119";"391147"
"V4mis2";"SILVA (only NR);Eukaryota;SAR;Alveolata;Ciliophora;Intramacronucleata;Litostomatea;Mesodiniidae;FV18-2A2;";"100.0";"14.4";"5";"5";"5";"0";"0";"457178";"391202"
"V4mis2";"SILVA (only NR);Eukaryota;SAR;Alveolata;Ciliophora;Intramacronucleata;Litostomatea;Mesodiniidae;Mesodinium;";"75.0";"14.4";"4";"4";"3";"1";"0";"457179";"391204"
"V4mis2";"SILVA (only NR);Eukaryota;SAR;Alveolata;Ciliophora;Intramacronucleata;Litostomatea;Mesodiniidae;Myrionecta;";"90.5";"14.4";"21";"21";"19";"2";"0";"457162";"391188"
"V4mis2";"SILVA (only NR);Eukaryota;SAR;Alveolata;Ciliophora;Intramacronucleata;Litostomatea;Mesodiniidae;uncultured;";"94.7";"14.4";"19";"19";"18";"1";"0";"457164";"391189"
"V4mis2";"SILVA (only NR);Eukaryota;SAR;Alveolata;Ciliophora;Intramacronucleata;Litostomatea;Trichostomatia;";"0.5";"14.4";"215";"215";"1";"214";"0";"456968";"391206"
"V4mis2";"SILVA (only NR);Eukaryota;SAR;Alveolata;Ciliophora;Intramacronucleata;Litostomatea;Trichostomatia;Alloiozona;";"0.0";"0";"1";"1";"0";"1";"0";"457182";"391207"
"V4mis2";"SILVA (only NR);Eukaryota;SAR;Alveolata;Ciliophora;Intramacronucleata;Litostomatea;Trichostomatia;Amylovorax;";"0.0";"0";"2";"2";"0";"2";"0";"457181";"391207"
"V4mis2";"SILVA (only NR);Eukaryota;SAR;Alveolata;Ciliophora;Intramacronucleata;Litostomatea;Trichostomatia;Balantidium;";"0.0";"0";"7";"7";"0";"7";"0";"457176";"391207"
"V4mis2";"SILVA (only NR);Eukaryota;SAR;Alveolata;Ciliophora;Intramacronucleata;Litostomatea;Trichostomatia;Bandia;";"0.0";"0";"3";"3";"0";"3";"0";"457180";"391207"
"V4mis2";"SILVA (only NR);Eukaryota;SAR;Alveolata;Ciliophora;Intramacronucleata;Litostomatea;Trichostomatia;Bitricha;";"0.0";"0";"2";"2";"0";"2";"0";"457181";"391207"
"V4mis2";"SILVA (only NR);Eukaryota;SAR;Alveolata;Ciliophora;Intramacronucleata;Litostomatea;Trichostomatia;Blepharocorys;";"0.0";"0";"8";"8";"0";"8";"0";"457175";"391207"
"V4mis2";"SILVA (only NR);Eukaryota;SAR;Alveolata;Ciliophora;Intramacronucleata;Litostomatea;Trichostomatia;Bundleia;";"0.0";"0";"5";"5";"0";"5";"0";"457178";"391207"
"V4mis2";"SILVA (only NR);Eukaryota;SAR;Alveolata;Ciliophora;Intramacronucleata;Litostomatea;Trichostomatia;Buxtonella;";"0.0";"0";"1";"1";"0";"1";"0";"457182";"391207"
"V4mis2";"SILVA (only NR);Eukaryota;SAR;Alveolata;Ciliophora;Intramacronucleata;Litostomatea;Trichostomatia;Charonina;";"0.0";"0";"1";"1";"0";"1";"0";"457182";"391207"
"V4mis2";"SILVA (only NR);Eukaryota;SAR;Alveolata;Ciliophora;Intramacronucleata;Litostomatea;Trichostomatia;Cochliatoxum;";"0.0";"0";"1";"1";"0";"1";"0";"457182";"391207"
"V4mis2";"SILVA (only NR);Eukaryota;SAR;Alveolata;Ciliophora;Intramacronucleata;Litostomatea;Trichostomatia;Cycloposthium;";"0.0";"0";"2";"2";"0";"2";"0";"457181";"391207"
"V4mis2";"SILVA (only NR);Eukaryota;SAR;Alveolata;Ciliophora;Intramacronucleata;Litostomatea;Trichostomatia;Dasytricha;";"0.0";"0";"22";"22";"0";"22";"0";"457161";"391207"
"V4mis2";"SILVA (only NR);Eukaryota;SAR;Alveolata;Ciliophora;Intramacronucleata;Litostomatea;Trichostomatia;Diplodinium;";"0.0";"0";"11";"11";"0";"11";"0";"457172";"391207"
"V4mis2";"SILVA (only NR);Eukaryota;SAR;Alveolata;Ciliophora;Intramacronucleata;Litostomatea;Trichostomatia;Diploplastron;";"0.0";"0";"1";"1";"0";"1";"0";"457182";"391207"
"V4mis2";"SILVA (only NR);Eukaryota;SAR;Alveolata;Ciliophora;Intramacronucleata;Litostomatea;Trichostomatia;Ditoxum;";"0.0";"0";"1";"1";"0";"1";"0";"457182";"391207"
"V4mis2";"SILVA (only NR);Eukaryota;SAR;Alveolata;Ciliophora;Intramacronucleata;Litostomatea;Trichostomatia;Enoploplastron;";"0.0";"0";"1";"1";"0";"1";"0";"457182";"391207"
"V4mis2";"SILVA (only NR);Eukaryota;SAR;Alveolata;Ciliophora;Intramacronucleata;Litostomatea;Trichostomatia;Entodinium;";"0.0";"0";"63";"63";"0";"63";"0";"457120";"391207"
"V4mis2";"SILVA (only NR);Eukaryota;SAR;Alveolata;Ciliophora;Intramacronucleata;Litostomatea;Trichostomatia;Eremoplastron;";"0.0";"0";"2";"2";"0";"2";"0";"457181";"391207"
"V4mis2";"SILVA (only NR);Eukaryota;SAR;Alveolata;Ciliophora;Intramacronucleata;Litostomatea;Trichostomatia;Eudiplodinium;";"0.0";"0";"2";"2";"0";"2";"0";"457181";"391207"
"V4mis2";"SILVA (only NR);Eukaryota;SAR;Alveolata;Ciliophora;Intramacronucleata;Litostomatea;Trichostomatia;Gassovskiella;";"0.0";"0";"1";"1";"0";"1";"0";"457182";"391207"
"V4mis2";"SILVA (only NR);Eukaryota;SAR;Alveolata;Ciliophora;Intramacronucleata;Litostomatea;Trichostomatia;Helicozoster;";"0.0";"0";"1";"1";"0";"1";"0";"457182";"391207"
"V4mis2";"SILVA (only NR);Eukaryota;SAR;Alveolata;Ciliophora;Intramacronucleata;Litostomatea;Trichostomatia;Hemiprorodon;";"0.0";"0";"1";"1";"0";"1";"0";"457182";"391207"
"V4mis2";"SILVA (only NR);Eukaryota;SAR;Alveolata;Ciliophora;Intramacronucleata;Litostomatea;Trichostomatia;Isotricha;";"0.0";"0";"8";"8";"0";"8";"0";"457175";"391207"
"V4mis2";"SILVA (only NR);Eukaryota;SAR;Alveolata;Ciliophora;Intramacronucleata;Litostomatea;Trichostomatia;Latteuria;";"0.0";"0";"2";"2";"0";"2";"0";"457181";"391207"
"V4mis2";"SILVA (only NR);Eukaryota;SAR;Alveolata;Ciliophora;Intramacronucleata;Litostomatea;Trichostomatia;Macropodinium;";"0.0";"0";"4";"4";"0";"4";"0";"457179";"391207"
"V4mis2";"SILVA (only NR);Eukaryota;SAR;Alveolata;Ciliophora;Intramacronucleata;Litostomatea;Trichostomatia;Metadinium;";"0.0";"0";"4";"4";"0";"4";"0";"457179";"391207"
"V4mis2";"SILVA (only NR);Eukaryota;SAR;Alveolata;Ciliophora;Intramacronucleata;Litostomatea;Trichostomatia;Neobalantidium;";"0.0";"0";"2";"2";"0";"2";"0";"457181";"391207"
"V4mis2";"SILVA (only NR);Eukaryota;SAR;Alveolata;Ciliophora;Intramacronucleata;Litostomatea;Trichostomatia;Ophryoscolex;";"7.1";"14.4";"14";"14";"1";"13";"0";"457169";"391206"
"V4mis2";"SILVA (only NR);Eukaryota;SAR;Alveolata;Ciliophora;Intramacronucleata;Litostomatea;Trichostomatia;Polycosta;";"0.0";"0";"1";"1";"0";"1";"0";"457182";"391207"
"V4mis2";"SILVA (only NR);Eukaryota;SAR;Alveolata;Ciliophora;Intramacronucleata;Litostomatea;Trichostomatia;Polydiniella;";"0.0";"0";"1";"1";"0";"1";"0";"457182";"391207"
"V4mis2";"SILVA (only NR);Eukaryota;SAR;Alveolata;Ciliophora;Intramacronucleata;Litostomatea;Trichostomatia;Polyplastron;";"0.0";"0";"11";"11";"0";"11";"0";"457172";"391207"
"V4mis2";"SILVA (only NR);Eukaryota;SAR;Alveolata;Ciliophora;Intramacronucleata;Litostomatea;Trichostomatia;Raabena;";"0.0";"0";"1";"1";"0";"1";"0";"457182";"391207"
"V4mis2";"SILVA (only NR);Eukaryota;SAR;Alveolata;Ciliophora;Intramacronucleata;Litostomatea;Trichostomatia;Spirodinium;";"0.0";"0";"1";"1";"0";"1";"0";"457182";"391207"
"V4mis2";"SILVA (only NR);Eukaryota;SAR;Alveolata;Ciliophora;Intramacronucleata;Litostomatea;Trichostomatia;Tetratoxum;";"0.0";"0";"1";"1";"0";"1";"0";"457182";"391207"
"V4mis2";"SILVA (only NR);Eukaryota;SAR;Alveolata;Ciliophora;Intramacronucleata;Litostomatea;Trichostomatia;Triadinium;";"0.0";"0";"2";"2";"0";"2";"0";"457181";"391207"
"V4mis2";"SILVA (only NR);Eukaryota;SAR;Alveolata;Ciliophora;Intramacronucleata;Litostomatea;Trichostomatia;Tripalmaria;";"0.0";"0";"1";"1";"0";"1";"0";"457182";"391207"
"V4mis2";"SILVA (only NR);Eukaryota;SAR;Alveolata;Ciliophora;Intramacronucleata;Litostomatea;Trichostomatia;Triplumaria;";"0.0";"0";"3";"3";"0";"3";"0";"457180";"391207"
"V4mis2";"SILVA (only NR);Eukaryota;SAR;Alveolata;Ciliophora;Intramacronucleata;Litostomatea;Trichostomatia;Troglodytella;";"0.0";"0";"1";"1";"0";"1";"0";"457182";"391207"
"V4mis2";"SILVA (only NR);Eukaryota;SAR;Alveolata;Ciliophora;Intramacronucleata;Litostomatea;Trichostomatia;uncultured;";"0.0";"0";"2";"2";"0";"2";"0";"457181";"391207"
"V4mis2";"SILVA (only NR);Eukaryota;SAR;Alveolata;Ciliophora;Intramacronucleata;Spirotrichea;";"0.7";"14.2";"1174";"1172";"8";"1164";"2";"456011";"391199"
"V4mis2";"SILVA (only NR);Eukaryota;SAR;Alveolata;Ciliophora;Intramacronucleata;Spirotrichea;Choreotrichia;";"0.0";"0";"249";"249";"0";"249";"0";"456934";"391207"
"V4mis2";"SILVA (only NR);Eukaryota;SAR;Alveolata;Ciliophora;Intramacronucleata;Spirotrichea;Choreotrichia;Amphorellopsis;";"0.0";"0";"4";"4";"0";"4";"0";"457179";"391207"
"V4mis2";"SILVA (only NR);Eukaryota;SAR;Alveolata;Ciliophora;Intramacronucleata;Spirotrichea;Choreotrichia;Ascampbelliella;";"0.0";"0";"1";"1";"0";"1";"0";"457182";"391207"
"V4mis2";"SILVA (only NR);Eukaryota;SAR;Alveolata;Ciliophora;Intramacronucleata;Spirotrichea;Choreotrichia;Codonella;";"0.0";"0";"2";"2";"0";"2";"0";"457181";"391207"
"V4mis2";"SILVA (only NR);Eukaryota;SAR;Alveolata;Ciliophora;Intramacronucleata;Spirotrichea;Choreotrichia;Codonellopsis;";"0.0";"0";"5";"5";"0";"5";"0";"457178";"391207"
"V4mis2";"SILVA (only NR);Eukaryota;SAR;Alveolata;Ciliophora;Intramacronucleata;Spirotrichea;Choreotrichia;Cyttarocylis;";"0.0";"0";"1";"1";"0";"1";"0";"457182";"391207"
"V4mis2";"SILVA (only NR);Eukaryota;SAR;Alveolata;Ciliophora;Intramacronucleata;Spirotrichea;Choreotrichia;Epiplocylis;";"0.0";"0";"1";"1";"0";"1";"0";"457182";"391207"
"V4mis2";"SILVA (only NR);Eukaryota;SAR;Alveolata;Ciliophora;Intramacronucleata;Spirotrichea;Choreotrichia;Epiplocyloides;";"0.0";"0";"1";"1";"0";"1";"0";"457182";"391207"
"V4mis2";"SILVA (only NR);Eukaryota;SAR;Alveolata;Ciliophora;Intramacronucleata;Spirotrichea;Choreotrichia;Eutintinnus;";"0.0";"0";"10";"10";"0";"10";"0";"457173";"391207"
"V4mis2";"SILVA (only NR);Eukaryota;SAR;Alveolata;Ciliophora;Intramacronucleata;Spirotrichea;Choreotrichia;Favella;";"0.0";"0";"3";"3";"0";"3";"0";"457180";"391207"
"V4mis2";"SILVA (only NR);Eukaryota;SAR;Alveolata;Ciliophora;Intramacronucleata;Spirotrichea;Choreotrichia;Helicostomella;";"0.0";"0";"3";"3";"0";"3";"0";"457180";"391207"
"V4mis2";"SILVA (only NR);Eukaryota;SAR;Alveolata;Ciliophora;Intramacronucleata;Spirotrichea;Choreotrichia;Leprotintinnus;";"0.0";"0";"1";"1";"0";"1";"0";"457182";"391207"
"V4mis2";"SILVA (only NR);Eukaryota;SAR;Alveolata;Ciliophora;Intramacronucleata;Spirotrichea;Choreotrichia;Metacylis;";"0.0";"0";"6";"6";"0";"6";"0";"457177";"391207"
"V4mis2";"SILVA (only NR);Eukaryota;SAR;Alveolata;Ciliophora;Intramacronucleata;Spirotrichea;Choreotrichia;Parastrombidinopsis;";"0.0";"0";"4";"4";"0";"4";"0";"457179";"391207"
"V4mis2";"SILVA (only NR);Eukaryota;SAR;Alveolata;Ciliophora;Intramacronucleata;Spirotrichea;Choreotrichia;Pelagostrobilidium;";"0.0";"0";"12";"12";"0";"12";"0";"457171";"391207"
"V4mis2";"SILVA (only NR);Eukaryota;SAR;Alveolata;Ciliophora;Intramacronucleata;Spirotrichea;Choreotrichia;Rimostrombidium;";"0.0";"0";"8";"8";"0";"8";"0";"457175";"391207"
"V4mis2";"SILVA (only NR);Eukaryota;SAR;Alveolata;Ciliophora;Intramacronucleata;Spirotrichea;Choreotrichia;Salpingacantha;";"0.0";"0";"1";"1";"0";"1";"0";"457182";"391207"
"V4mis2";"SILVA (only NR);Eukaryota;SAR;Alveolata;Ciliophora;Intramacronucleata;Spirotrichea;Choreotrichia;Salpingella;";"0.0";"0";"3";"3";"0";"3";"0";"457180";"391207"
"V4mis2";"SILVA (only NR);Eukaryota;SAR;Alveolata;Ciliophora;Intramacronucleata;Spirotrichea;Choreotrichia;Steenstrupiella;";"0.0";"0";"7";"7";"0";"7";"0";"457176";"391207"
"V4mis2";"SILVA (only NR);Eukaryota;SAR;Alveolata;Ciliophora;Intramacronucleata;Spirotrichea;Choreotrichia;Stenosemella;";"0.0";"0";"2";"2";"0";"2";"0";"457181";"391207"
"V4mis2";"SILVA (only NR);Eukaryota;SAR;Alveolata;Ciliophora;Intramacronucleata;Spirotrichea;Choreotrichia;Strobilidium;";"0.0";"0";"1";"1";"0";"1";"0";"457182";"391207"
"V4mis2";"SILVA (only NR);Eukaryota;SAR;Alveolata;Ciliophora;Intramacronucleata;Spirotrichea;Choreotrichia;Strombidinopsis;";"0.0";"0";"3";"3";"0";"3";"0";"457180";"391207"
"V4mis2";"SILVA (only NR);Eukaryota;SAR;Alveolata;Ciliophora;Intramacronucleata;Spirotrichea;Choreotrichia;Tintinnidium;";"0.0";"0";"9";"9";"0";"9";"0";"457174";"391207"
"V4mis2";"SILVA (only NR);Eukaryota;SAR;Alveolata;Ciliophora;Intramacronucleata;Spirotrichea;Choreotrichia;Tintinnopsis;";"0.0";"0";"30";"30";"0";"30";"0";"457153";"391207"
"V4mis2";"SILVA (only NR);Eukaryota;SAR;Alveolata;Ciliophora;Intramacronucleata;Spirotrichea;Choreotrichia;Undella;";"0.0";"0";"1";"1";"0";"1";"0";"457182";"391207"
"V4mis2";"SILVA (only NR);Eukaryota;SAR;Alveolata;Ciliophora;Intramacronucleata;Spirotrichea;Choreotrichia;Xystonella;";"0.0";"0";"3";"3";"0";"3";"0";"457180";"391207"
"V4mis2";"SILVA (only NR);Eukaryota;SAR;Alveolata;Ciliophora;Intramacronucleata;Spirotrichea;Choreotrichia;uncultured;";"0.0";"0";"97";"97";"0";"97";"0";"457086";"391207"
"V4mis2";"SILVA (only NR);Eukaryota;SAR;Alveolata;Ciliophora;Intramacronucleata;Spirotrichea;Euplotia;";"1.6";"14.4";"130";"129";"2";"127";"1";"457054";"391205"
"V4mis2";"SILVA (only NR);Eukaryota;SAR;Alveolata;Ciliophora;Intramacronucleata;Spirotrichea;Euplotia;Apodiophrys;";"0.0";"0";"1";"1";"0";"1";"0";"457182";"391207"
"V4mis2";"SILVA (only NR);Eukaryota;SAR;Alveolata;Ciliophora;Intramacronucleata;Spirotrichea;Euplotia;Aspidisca;";"2.9";"14.4";"35";"35";"1";"34";"0";"457148";"391206"
"V4mis2";"SILVA (only NR);Eukaryota;SAR;Alveolata;Ciliophora;Intramacronucleata;Spirotrichea;Euplotia;Certesia;";"0.0";"0";"1";"1";"0";"1";"0";"457182";"391207"
"V4mis2";"SILVA (only NR);Eukaryota;SAR;Alveolata;Ciliophora;Intramacronucleata;Spirotrichea;Euplotia;Diophrys;";"0.0";"0";"9";"9";"0";"9";"0";"457174";"391207"
"V4mis2";"SILVA (only NR);Eukaryota;SAR;Alveolata;Ciliophora;Intramacronucleata;Spirotrichea;Euplotia;Discocephalus;";"0.0";"0";"4";"4";"0";"4";"0";"457179";"391207"
"V4mis2";"SILVA (only NR);Eukaryota;SAR;Alveolata;Ciliophora;Intramacronucleata;Spirotrichea;Euplotia;Euplotes;";"1.4";"14.4";"73";"72";"1";"71";"1";"457111";"391206"
"V4mis2";"SILVA (only NR);Eukaryota;SAR;Alveolata;Ciliophora;Intramacronucleata;Spirotrichea;Euplotia;Euplotidium;";"0.0";"0";"2";"2";"0";"2";"0";"457181";"391207"
"V4mis2";"SILVA (only NR);Eukaryota;SAR;Alveolata;Ciliophora;Intramacronucleata;Spirotrichea;Euplotia;Gastrocirrhus;";"0.0";"0";"1";"1";"0";"1";"0";"457182";"391207"
"V4mis2";"SILVA (only NR);Eukaryota;SAR;Alveolata;Ciliophora;Intramacronucleata;Spirotrichea;Euplotia;Paradiophrys;";"0.0";"0";"2";"2";"0";"2";"0";"457181";"391207"
"V4mis2";"SILVA (only NR);Eukaryota;SAR;Alveolata;Ciliophora;Intramacronucleata;Spirotrichea;Euplotia;Prodiscocephalus;";"0.0";"0";"1";"1";"0";"1";"0";"457182";"391207"
"V4mis2";"SILVA (only NR);Eukaryota;SAR;Alveolata;Ciliophora;Intramacronucleata;Spirotrichea;Hypotrichia;";"0.0";"0";"308";"307";"0";"307";"1";"456876";"391207"
"V4mis2";"SILVA (only NR);Eukaryota;SAR;Alveolata;Ciliophora;Intramacronucleata;Spirotrichea;Hypotrichia;Amphisiella;";"0.0";"0";"5";"5";"0";"5";"0";"457178";"391207"
"V4mis2";"SILVA (only NR);Eukaryota;SAR;Alveolata;Ciliophora;Intramacronucleata;Spirotrichea;Hypotrichia;Anteholosticha;";"0.0";"0";"2";"2";"0";"2";"0";"457181";"391207"
"V4mis2";"SILVA (only NR);Eukaryota;SAR;Alveolata;Ciliophora;Intramacronucleata;Spirotrichea;Hypotrichia;Apogastrostyla;";"0.0";"0";"1";"1";"0";"1";"0";"457182";"391207"
"V4mis2";"SILVA (only NR);Eukaryota;SAR;Alveolata;Ciliophora;Intramacronucleata;Spirotrichea;Hypotrichia;Apoholosticha;";"0.0";"0";"1";"1";"0";"1";"0";"457182";"391207"
"V4mis2";"SILVA (only NR);Eukaryota;SAR;Alveolata;Ciliophora;Intramacronucleata;Spirotrichea;Hypotrichia;Apokeronopsis;";"0.0";"0";"5";"5";"0";"5";"0";"457178";"391207"
"V4mis2";"SILVA (only NR);Eukaryota;SAR;Alveolata;Ciliophora;Intramacronucleata;Spirotrichea;Hypotrichia;Arcuseries;";"0.0";"0";"1";"1";"0";"1";"0";"457182";"391207"
"V4mis2";"SILVA (only NR);Eukaryota;SAR;Alveolata;Ciliophora;Intramacronucleata;Spirotrichea;Hypotrichia;Atractos;";"0.0";"0";"1";"1";"0";"1";"0";"457182";"391207"
"V4mis2";"SILVA (only NR);Eukaryota;SAR;Alveolata;Ciliophora;Intramacronucleata;Spirotrichea;Hypotrichia;Birojimia;";"0.0";"0";"1";"1";"0";"1";"0";"457182";"391207"
"V4mis2";"SILVA (only NR);Eukaryota;SAR;Alveolata;Ciliophora;Intramacronucleata;Spirotrichea;Hypotrichia;Cyrtohymena;";"0.0";"0";"1";"1";"0";"1";"0";"457182";"391207"
"V4mis2";"SILVA (only NR);Eukaryota;SAR;Alveolata;Ciliophora;Intramacronucleata;Spirotrichea;Hypotrichia;Deviata;";"0.0";"0";"2";"2";"0";"2";"0";"457181";"391207"
"V4mis2";"SILVA (only NR);Eukaryota;SAR;Alveolata;Ciliophora;Intramacronucleata;Spirotrichea;Hypotrichia;Diaxonella;";"0.0";"0";"1";"1";"0";"1";"0";"457182";"391207"
"V4mis2";"SILVA (only NR);Eukaryota;SAR;Alveolata;Ciliophora;Intramacronucleata;Spirotrichea;Hypotrichia;Engelmanniella;";"0.0";"0";"1";"1";"0";"1";"0";"457182";"391207"
"V4mis2";"SILVA (only NR);Eukaryota;SAR;Alveolata;Ciliophora;Intramacronucleata;Spirotrichea;Hypotrichia;Epiclintes;";"0.0";"0";"3";"3";"0";"3";"0";"457180";"391207"
"V4mis2";"SILVA (only NR);Eukaryota;SAR;Alveolata;Ciliophora;Intramacronucleata;Spirotrichea;Hypotrichia;Gonostomum;";"0.0";"0";"13";"13";"0";"13";"0";"457170";"391207"
"V4mis2";"SILVA (only NR);Eukaryota;SAR;Alveolata;Ciliophora;Intramacronucleata;Spirotrichea;Hypotrichia;Halteria;";"0.0";"0";"14";"14";"0";"14";"0";"457169";"391207"
"V4mis2";"SILVA (only NR);Eukaryota;SAR;Alveolata;Ciliophora;Intramacronucleata;Spirotrichea;Hypotrichia;Hemicycliostyla;";"0.0";"0";"1";"1";"0";"1";"0";"457182";"391207"
"V4mis2";"SILVA (only NR);Eukaryota;SAR;Alveolata;Ciliophora;Intramacronucleata;Spirotrichea;Hypotrichia;Hemigastrostyla;";"0.0";"0";"3";"3";"0";"3";"0";"457180";"391207"
"V4mis2";"SILVA (only NR);Eukaryota;SAR;Alveolata;Ciliophora;Intramacronucleata;Spirotrichea;Hypotrichia;Hemiurosoma;";"0.0";"0";"1";"1";"0";"1";"0";"457182";"391207"
"V4mis2";"SILVA (only NR);Eukaryota;SAR;Alveolata;Ciliophora;Intramacronucleata;Spirotrichea;Hypotrichia;Hemiurosomoida;";"0.0";"0";"4";"4";"0";"4";"0";"457179";"391207"
"V4mis2";"SILVA (only NR);Eukaryota;SAR;Alveolata;Ciliophora;Intramacronucleata;Spirotrichea;Hypotrichia;Heterokeronopsis;";"0.0";"0";"1";"1";"0";"1";"0";"457182";"391207"
"V4mis2";"SILVA (only NR);Eukaryota;SAR;Alveolata;Ciliophora;Intramacronucleata;Spirotrichea;Hypotrichia;Histriculus;";"0.0";"0";"1";"1";"0";"1";"0";"457182";"391207"
"V4mis2";"SILVA (only NR);Eukaryota;SAR;Alveolata;Ciliophora;Intramacronucleata;Spirotrichea;Hypotrichia;Holosticha;";"0.0";"0";"16";"16";"0";"16";"0";"457167";"391207"
"V4mis2";"SILVA (only NR);Eukaryota;SAR;Alveolata;Ciliophora;Intramacronucleata;Spirotrichea;Hypotrichia;Holostichides;";"0.0";"0";"1";"1";"0";"1";"0";"457182";"391207"
"V4mis2";"SILVA (only NR);Eukaryota;SAR;Alveolata;Ciliophora;Intramacronucleata;Spirotrichea;Hypotrichia;Hypotrichidium;";"0.0";"0";"1";"1";"0";"1";"0";"457182";"391207"
"V4mis2";"SILVA (only NR);Eukaryota;SAR;Alveolata;Ciliophora;Intramacronucleata;Spirotrichea;Hypotrichia;Kahliella;";"0.0";"0";"1";"1";"0";"1";"0";"457182";"391207"
"V4mis2";"SILVA (only NR);Eukaryota;SAR;Alveolata;Ciliophora;Intramacronucleata;Spirotrichea;Hypotrichia;Kleinstyla;";"0.0";"0";"1";"1";"0";"1";"0";"457182";"391207"
"V4mis2";"SILVA (only NR);Eukaryota;SAR;Alveolata;Ciliophora;Intramacronucleata;Spirotrichea;Hypotrichia;Laurentiella;";"0.0";"0";"1";"1";"0";"1";"0";"457182";"391207"
"V4mis2";"SILVA (only NR);Eukaryota;SAR;Alveolata;Ciliophora;Intramacronucleata;Spirotrichea;Hypotrichia;Meseres;";"0.0";"0";"1";"1";"0";"1";"0";"457182";"391207"
"V4mis2";"SILVA (only NR);Eukaryota;SAR;Alveolata;Ciliophora;Intramacronucleata;Spirotrichea;Hypotrichia;Metaurostylopsis;";"0.0";"0";"4";"4";"0";"4";"0";"457179";"391207"
"V4mis2";"SILVA (only NR);Eukaryota;SAR;Alveolata;Ciliophora;Intramacronucleata;Spirotrichea;Hypotrichia;Monocoronella;";"0.0";"0";"1";"1";"0";"1";"0";"457182";"391207"
"V4mis2";"SILVA (only NR);Eukaryota;SAR;Alveolata;Ciliophora;Intramacronucleata;Spirotrichea;Hypotrichia;Neobakuella;";"0.0";"0";"1";"1";"0";"1";"0";"457182";"391207"
"V4mis2";"SILVA (only NR);Eukaryota;SAR;Alveolata;Ciliophora;Intramacronucleata;Spirotrichea;Hypotrichia;Neokeronopsis;";"0.0";"0";"1";"1";"0";"1";"0";"457182";"391207"
"V4mis2";"SILVA (only NR);Eukaryota;SAR;Alveolata;Ciliophora;Intramacronucleata;Spirotrichea;Hypotrichia;Neourostylopsis;";"0.0";"0";"1";"1";"0";"1";"0";"457182";"391207"
"V4mis2";"SILVA (only NR);Eukaryota;SAR;Alveolata;Ciliophora;Intramacronucleata;Spirotrichea;Hypotrichia;Nothoholosticha;";"0.0";"0";"1";"1";"0";"1";"0";"457182";"391207"
"V4mis2";"SILVA (only NR);Eukaryota;SAR;Alveolata;Ciliophora;Intramacronucleata;Spirotrichea;Hypotrichia;Notohymena;";"0.0";"0";"3";"3";"0";"3";"0";"457180";"391207"
"V4mis2";"SILVA (only NR);Eukaryota;SAR;Alveolata;Ciliophora;Intramacronucleata;Spirotrichea;Hypotrichia;Onychodromopsis;";"0.0";"0";"1";"1";"0";"1";"0";"457182";"391207"
"V4mis2";"SILVA (only NR);Eukaryota;SAR;Alveolata;Ciliophora;Intramacronucleata;Spirotrichea;Hypotrichia;Onychodromus;";"0.0";"0";"2";"2";"0";"2";"0";"457181";"391207"
"V4mis2";"SILVA (only NR);Eukaryota;SAR;Alveolata;Ciliophora;Intramacronucleata;Spirotrichea;Hypotrichia;Oxytricha;";"0.0";"0";"10";"10";"0";"10";"0";"457173";"391207"
"V4mis2";"SILVA (only NR);Eukaryota;SAR;Alveolata;Ciliophora;Intramacronucleata;Spirotrichea;Hypotrichia;Parabirojimia;";"0.0";"0";"2";"2";"0";"2";"0";"457181";"391207"
"V4mis2";"SILVA (only NR);Eukaryota;SAR;Alveolata;Ciliophora;Intramacronucleata;Spirotrichea;Hypotrichia;Parasterkiella;";"0.0";"0";"3";"3";"0";"3";"0";"457180";"391207"
"V4mis2";"SILVA (only NR);Eukaryota;SAR;Alveolata;Ciliophora;Intramacronucleata;Spirotrichea;Hypotrichia;Paraurosomoida;";"0.0";"0";"1";"1";"0";"1";"0";"457182";"391207"
"V4mis2";"SILVA (only NR);Eukaryota;SAR;Alveolata;Ciliophora;Intramacronucleata;Spirotrichea;Hypotrichia;Paraurostyla;";"0.0";"0";"3";"3";"0";"3";"0";"457180";"391207"
"V4mis2";"SILVA (only NR);Eukaryota;SAR;Alveolata;Ciliophora;Intramacronucleata;Spirotrichea;Hypotrichia;Paruroleptus;";"0.0";"0";"3";"3";"0";"3";"0";"457180";"391207"
"V4mis2";"SILVA (only NR);Eukaryota;SAR;Alveolata;Ciliophora;Intramacronucleata;Spirotrichea;Hypotrichia;Perisincirra;";"0.0";"0";"1";"1";"0";"1";"0";"457182";"391207"
"V4mis2";"SILVA (only NR);Eukaryota;SAR;Alveolata;Ciliophora;Intramacronucleata;Spirotrichea;Hypotrichia;Plagiotoma;";"0.0";"0";"1";"1";"0";"1";"0";"457182";"391207"
"V4mis2";"SILVA (only NR);Eukaryota;SAR;Alveolata;Ciliophora;Intramacronucleata;Spirotrichea;Hypotrichia;Ponturostyla;";"0.0";"0";"1";"1";"0";"1";"0";"457182";"391207"
"V4mis2";"SILVA (only NR);Eukaryota;SAR;Alveolata;Ciliophora;Intramacronucleata;Spirotrichea;Hypotrichia;Protogastrostyla;";"0.0";"0";"2";"2";"0";"2";"0";"457181";"391207"
"V4mis2";"SILVA (only NR);Eukaryota;SAR;Alveolata;Ciliophora;Intramacronucleata;Spirotrichea;Hypotrichia;Psammomitra;";"0.0";"0";"1";"1";"0";"1";"0";"457182";"391207"
"V4mis2";"SILVA (only NR);Eukaryota;SAR;Alveolata;Ciliophora;Intramacronucleata;Spirotrichea;Hypotrichia;Pseudoamphisiella;";"0.0";"0";"4";"4";"0";"4";"0";"457179";"391207"
"V4mis2";"SILVA (only NR);Eukaryota;SAR;Alveolata;Ciliophora;Intramacronucleata;Spirotrichea;Hypotrichia;Pseudogastrostyla;";"0.0";"0";"1";"1";"0";"1";"0";"457182";"391207"
"V4mis2";"SILVA (only NR);Eukaryota;SAR;Alveolata;Ciliophora;Intramacronucleata;Spirotrichea;Hypotrichia;Pseudokahliella;";"0.0";"0";"1";"1";"0";"1";"0";"457182";"391207"
"V4mis2";"SILVA (only NR);Eukaryota;SAR;Alveolata;Ciliophora;Intramacronucleata;Spirotrichea;Hypotrichia;Pseudokeronopsis;";"0.0";"0";"4";"4";"0";"4";"0";"457179";"391207"
"V4mis2";"SILVA (only NR);Eukaryota;SAR;Alveolata;Ciliophora;Intramacronucleata;Spirotrichea;Hypotrichia;Pseudouroleptus;";"0.0";"0";"6";"6";"0";"6";"0";"457177";"391207"
"V4mis2";"SILVA (only NR);Eukaryota;SAR;Alveolata;Ciliophora;Intramacronucleata;Spirotrichea;Hypotrichia;Pseudourostyla;";"0.0";"0";"8";"8";"0";"8";"0";"457175";"391207"
"V4mis2";"SILVA (only NR);Eukaryota;SAR;Alveolata;Ciliophora;Intramacronucleata;Spirotrichea;Hypotrichia;Rigidothrix;";"0.0";"0";"1";"1";"0";"1";"0";"457182";"391207"
"V4mis2";"SILVA (only NR);Eukaryota;SAR;Alveolata;Ciliophora;Intramacronucleata;Spirotrichea;Hypotrichia;Rubrioxytricha;";"0.0";"0";"1";"1";"0";"1";"0";"457182";"391207"
"V4mis2";"SILVA (only NR);Eukaryota;SAR;Alveolata;Ciliophora;Intramacronucleata;Spirotrichea;Hypotrichia;Spirotrachelostyla;";"0.0";"0";"3";"3";"0";"3";"0";"457180";"391207"
"V4mis2";"SILVA (only NR);Eukaryota;SAR;Alveolata;Ciliophora;Intramacronucleata;Spirotrichea;Hypotrichia;Steinia;";"0.0";"0";"1";"1";"0";"1";"0";"457182";"391207"
"V4mis2";"SILVA (only NR);Eukaryota;SAR;Alveolata;Ciliophora;Intramacronucleata;Spirotrichea;Hypotrichia;Sterkiella;";"0.0";"0";"6";"6";"0";"6";"0";"457177";"391207"
"V4mis2";"SILVA (only NR);Eukaryota;SAR;Alveolata;Ciliophora;Intramacronucleata;Spirotrichea;Hypotrichia;Stichotricha;";"0.0";"0";"2";"2";"0";"2";"0";"457181";"391207"
"V4mis2";"SILVA (only NR);Eukaryota;SAR;Alveolata;Ciliophora;Intramacronucleata;Spirotrichea;Hypotrichia;Strongylidium;";"0.0";"0";"2";"2";"0";"2";"0";"457181";"391207"
"V4mis2";"SILVA (only NR);Eukaryota;SAR;Alveolata;Ciliophora;Intramacronucleata;Spirotrichea;Hypotrichia;Stylonychia;";"0.0";"0";"14";"14";"0";"14";"0";"457169";"391207"
"V4mis2";"SILVA (only NR);Eukaryota;SAR;Alveolata;Ciliophora;Intramacronucleata;Spirotrichea;Hypotrichia;Tachysoma;";"0.0";"0";"1";"1";"0";"1";"0";"457182";"391207"
"V4mis2";"SILVA (only NR);Eukaryota;SAR;Alveolata;Ciliophora;Intramacronucleata;Spirotrichea;Hypotrichia;Tetmemena;";"0.0";"0";"1";"1";"0";"1";"0";"457182";"391207"
"V4mis2";"SILVA (only NR);Eukaryota;SAR;Alveolata;Ciliophora;Intramacronucleata;Spirotrichea;Hypotrichia;Thigmokeronopsis;";"0.0";"0";"2";"2";"0";"2";"0";"457181";"391207"
"V4mis2";"SILVA (only NR);Eukaryota;SAR;Alveolata;Ciliophora;Intramacronucleata;Spirotrichea;Hypotrichia;Trachelostyla;";"0.0";"0";"2";"2";"0";"2";"0";"457181";"391207"
"V4mis2";"SILVA (only NR);Eukaryota;SAR;Alveolata;Ciliophora;Intramacronucleata;Spirotrichea;Hypotrichia;Trichototaxis;";"0.0";"0";"1";"1";"0";"1";"0";"457182";"391207"
"V4mis2";"SILVA (only NR);Eukaryota;SAR;Alveolata;Ciliophora;Intramacronucleata;Spirotrichea;Hypotrichia;Tunicothrix;";"0.0";"0";"2";"2";"0";"2";"0";"457181";"391207"
"V4mis2";"SILVA (only NR);Eukaryota;SAR;Alveolata;Ciliophora;Intramacronucleata;Spirotrichea;Hypotrichia;Uroleptopsis;";"0.0";"0";"1";"1";"0";"1";"0";"457182";"391207"
"V4mis2";"SILVA (only NR);Eukaryota;SAR;Alveolata;Ciliophora;Intramacronucleata;Spirotrichea;Hypotrichia;Uroleptus;";"0.0";"0";"4";"4";"0";"4";"0";"457179";"391207"
"V4mis2";"SILVA (only NR);Eukaryota;SAR;Alveolata;Ciliophora;Intramacronucleata;Spirotrichea;Hypotrichia;Uronychia;";"0.0";"0";"6";"6";"0";"6";"0";"457177";"391207"
"V4mis2";"SILVA (only NR);Eukaryota;SAR;Alveolata;Ciliophora;Intramacronucleata;Spirotrichea;Hypotrichia;Urosoma;";"0.0";"0";"4";"4";"0";"4";"0";"457179";"391207"
"V4mis2";"SILVA (only NR);Eukaryota;SAR;Alveolata;Ciliophora;Intramacronucleata;Spirotrichea;Hypotrichia;Urosomoida;";"0.0";"0";"1";"1";"0";"1";"0";"457182";"391207"
"V4mis2";"SILVA (only NR);Eukaryota;SAR;Alveolata;Ciliophora;Intramacronucleata;Spirotrichea;Hypotrichia;Urospinula;";"0.0";"0";"1";"1";"0";"1";"0";"457182";"391207"
"V4mis2";"SILVA (only NR);Eukaryota;SAR;Alveolata;Ciliophora;Intramacronucleata;Spirotrichea;Hypotrichia;Urostyla;";"0.0";"0";"2";"2";"0";"2";"0";"457181";"391207"
"V4mis2";"SILVA (only NR);Eukaryota;SAR;Alveolata;Ciliophora;Intramacronucleata;Spirotrichea;Hypotrichia;uncultured;";"0.0";"0";"15";"14";"0";"14";"1";"457169";"391207"
"V4mis2";"SILVA (only NR);Eukaryota;SAR;Alveolata;Ciliophora;Intramacronucleata;Spirotrichea;Licnophoria;";"0.0";"0";"3";"3";"0";"3";"0";"457180";"391207"
"V4mis2";"SILVA (only NR);Eukaryota;SAR;Alveolata;Ciliophora;Intramacronucleata;Spirotrichea;Licnophoria;Licnophora;";"0.0";"0";"3";"3";"0";"3";"0";"457180";"391207"
"V4mis2";"SILVA (only NR);Eukaryota;SAR;Alveolata;Ciliophora;Intramacronucleata;Spirotrichea;Oligotrichia;";"0.5";"14.4";"432";"432";"2";"430";"0";"456751";"391205"
"V4mis2";"SILVA (only NR);Eukaryota;SAR;Alveolata;Ciliophora;Intramacronucleata;Spirotrichea;Oligotrichia;Antestrombidium;";"0.0";"0";"1";"1";"0";"1";"0";"457182";"391207"
"V4mis2";"SILVA (only NR);Eukaryota;SAR;Alveolata;Ciliophora;Intramacronucleata;Spirotrichea;Oligotrichia;Apostrombidium;";"0.0";"0";"1";"1";"0";"1";"0";"457182";"391207"
"V4mis2";"SILVA (only NR);Eukaryota;SAR;Alveolata;Ciliophora;Intramacronucleata;Spirotrichea;Oligotrichia;Novistrombidium;";"0.0";"0";"2";"2";"0";"2";"0";"457181";"391207"
"V4mis2";"SILVA (only NR);Eukaryota;SAR;Alveolata;Ciliophora;Intramacronucleata;Spirotrichea;Oligotrichia;Omegastrombidium;";"0.0";"0";"1";"1";"0";"1";"0";"457182";"391207"
"V4mis2";"SILVA (only NR);Eukaryota;SAR;Alveolata;Ciliophora;Intramacronucleata;Spirotrichea;Oligotrichia;Parallelostrombidium;";"0.0";"0";"6";"6";"0";"6";"0";"457177";"391207"
"V4mis2";"SILVA (only NR);Eukaryota;SAR;Alveolata;Ciliophora;Intramacronucleata;Spirotrichea;Oligotrichia;Pseudotontonia;";"2.6";"14.4";"38";"38";"1";"37";"0";"457145";"391206"
"V4mis2";"SILVA (only NR);Eukaryota;SAR;Alveolata;Ciliophora;Intramacronucleata;Spirotrichea;Oligotrichia;Sinistrostrombidium;";"0.0";"0";"5";"5";"0";"5";"0";"457178";"391207"
"V4mis2";"SILVA (only NR);Eukaryota;SAR;Alveolata;Ciliophora;Intramacronucleata;Spirotrichea;Oligotrichia;Spirostrombidium;";"0.0";"0";"22";"22";"0";"22";"0";"457161";"391207"
"V4mis2";"SILVA (only NR);Eukaryota;SAR;Alveolata;Ciliophora;Intramacronucleata;Spirotrichea;Oligotrichia;Spirotontonia;";"1.5";"14.4";"68";"68";"1";"67";"0";"457115";"391206"
"V4mis2";"SILVA (only NR);Eukaryota;SAR;Alveolata;Ciliophora;Intramacronucleata;Spirotrichea;Oligotrichia;Strombidium;";"0.0";"0";"210";"210";"0";"210";"0";"456973";"391207"
"V4mis2";"SILVA (only NR);Eukaryota;SAR;Alveolata;Ciliophora;Intramacronucleata;Spirotrichea;Oligotrichia;Varistrombidium;";"0.0";"0";"3";"3";"0";"3";"0";"457180";"391207"
"V4mis2";"SILVA (only NR);Eukaryota;SAR;Alveolata;Ciliophora;Intramacronucleata;Spirotrichea;Oligotrichia;uncultured;";"0.0";"0";"51";"51";"0";"51";"0";"457132";"391207"
"V4mis2";"SILVA (only NR);Eukaryota;SAR;Alveolata;Ciliophora;Intramacronucleata;Spirotrichea;Oxytrichidae;";"10.5";"14.4";"38";"38";"4";"34";"0";"457145";"391203"
"V4mis2";"SILVA (only NR);Eukaryota;SAR;Alveolata;Ciliophora;Intramacronucleata;Spirotrichea;Phacodinium;";"0.0";"0";"1";"1";"0";"1";"0";"457182";"391207"
"V4mis2";"SILVA (only NR);Eukaryota;SAR;Alveolata;Ciliophora;Intramacronucleata;Spirotrichea;Protocruzia;";"0.0";"0";"7";"7";"0";"7";"0";"457176";"391207"
"V4mis2";"SILVA (only NR);Eukaryota;SAR;Alveolata;Ciliophora;Intramacronucleata;Spirotrichea;Protohypotrichia;";"0.0";"0";"3";"3";"0";"3";"0";"457180";"391207"
"V4mis2";"SILVA (only NR);Eukaryota;SAR;Alveolata;Ciliophora;Intramacronucleata;Spirotrichea;Protohypotrichia;Caryotricha;";"0.0";"0";"2";"2";"0";"2";"0";"457181";"391207"
"V4mis2";"SILVA (only NR);Eukaryota;SAR;Alveolata;Ciliophora;Intramacronucleata;Spirotrichea;Protohypotrichia;Kiitricha;";"0.0";"0";"1";"1";"0";"1";"0";"457182";"391207"
"V4mis2";"SILVA (only NR);Eukaryota;SAR;Alveolata;Ciliophora;Postciliodesmatophora;";"0.7";"14.4";"149";"149";"1";"148";"0";"457034";"391206"
"V4mis2";"SILVA (only NR);Eukaryota;SAR;Alveolata;Ciliophora;Postciliodesmatophora;Heterotrichea;";"1.1";"14.4";"90";"90";"1";"89";"0";"457093";"391206"
"V4mis2";"SILVA (only NR);Eukaryota;SAR;Alveolata;Ciliophora;Postciliodesmatophora;Heterotrichea;Anigsteinia;";"0.0";"0";"3";"3";"0";"3";"0";"457180";"391207"
"V4mis2";"SILVA (only NR);Eukaryota;SAR;Alveolata;Ciliophora;Postciliodesmatophora;Heterotrichea;Blepharisma;";"6.7";"14.4";"15";"15";"1";"14";"0";"457168";"391206"
"V4mis2";"SILVA (only NR);Eukaryota;SAR;Alveolata;Ciliophora;Postciliodesmatophora;Heterotrichea;Chattonidium;";"0.0";"0";"1";"1";"0";"1";"0";"457182";"391207"
"V4mis2";"SILVA (only NR);Eukaryota;SAR;Alveolata;Ciliophora;Postciliodesmatophora;Heterotrichea;Climacostomum;";"0.0";"0";"3";"3";"0";"3";"0";"457180";"391207"
"V4mis2";"SILVA (only NR);Eukaryota;SAR;Alveolata;Ciliophora;Postciliodesmatophora;Heterotrichea;Condylostentor;";"0.0";"0";"2";"2";"0";"2";"0";"457181";"391207"
"V4mis2";"SILVA (only NR);Eukaryota;SAR;Alveolata;Ciliophora;Postciliodesmatophora;Heterotrichea;Condylostoma;";"0.0";"0";"9";"9";"0";"9";"0";"457174";"391207"
"V4mis2";"SILVA (only NR);Eukaryota;SAR;Alveolata;Ciliophora;Postciliodesmatophora;Heterotrichea;Eufolliculina;";"0.0";"0";"6";"6";"0";"6";"0";"457177";"391207"
"V4mis2";"SILVA (only NR);Eukaryota;SAR;Alveolata;Ciliophora;Postciliodesmatophora;Heterotrichea;Fabrea;";"0.0";"0";"2";"2";"0";"2";"0";"457181";"391207"
"V4mis2";"SILVA (only NR);Eukaryota;SAR;Alveolata;Ciliophora;Postciliodesmatophora;Heterotrichea;Maristentor;";"0.0";"0";"1";"1";"0";"1";"0";"457182";"391207"
"V4mis2";"SILVA (only NR);Eukaryota;SAR;Alveolata;Ciliophora;Postciliodesmatophora;Heterotrichea;Peritromus;";"0.0";"0";"7";"7";"0";"7";"0";"457176";"391207"
"V4mis2";"SILVA (only NR);Eukaryota;SAR;Alveolata;Ciliophora;Postciliodesmatophora;Heterotrichea;Spirostomum;";"0.0";"0";"13";"13";"0";"13";"0";"457170";"391207"
"V4mis2";"SILVA (only NR);Eukaryota;SAR;Alveolata;Ciliophora;Postciliodesmatophora;Heterotrichea;Stentor;";"0.0";"0";"18";"18";"0";"18";"0";"457165";"391207"
"V4mis2";"SILVA (only NR);Eukaryota;SAR;Alveolata;Ciliophora;Postciliodesmatophora;Heterotrichea;uncultured;";"0.0";"0";"4";"4";"0";"4";"0";"457179";"391207"
"V4mis2";"SILVA (only NR);Eukaryota;SAR;Alveolata;Ciliophora;Postciliodesmatophora;Karyorelictea;";"0.0";"0";"58";"58";"0";"58";"0";"457125";"391207"
"V4mis2";"SILVA (only NR);Eukaryota;SAR;Alveolata;Ciliophora;Postciliodesmatophora;Karyorelictea;Apotrachelocerca;";"0.0";"0";"1";"1";"0";"1";"0";"457182";"391207"
"V4mis2";"SILVA (only NR);Eukaryota;SAR;Alveolata;Ciliophora;Postciliodesmatophora;Karyorelictea;Corlissina;";"0.0";"0";"1";"1";"0";"1";"0";"457182";"391207"
"V4mis2";"SILVA (only NR);Eukaryota;SAR;Alveolata;Ciliophora;Postciliodesmatophora;Karyorelictea;Geleia;";"0.0";"0";"3";"3";"0";"3";"0";"457180";"391207"
"V4mis2";"SILVA (only NR);Eukaryota;SAR;Alveolata;Ciliophora;Postciliodesmatophora;Karyorelictea;Kentrophoros;";"0.0";"0";"22";"22";"0";"22";"0";"457161";"391207"
"V4mis2";"SILVA (only NR);Eukaryota;SAR;Alveolata;Ciliophora;Postciliodesmatophora;Karyorelictea;Kovalevaia;";"0.0";"0";"2";"2";"0";"2";"0";"457181";"391207"
"V4mis2";"SILVA (only NR);Eukaryota;SAR;Alveolata;Ciliophora;Postciliodesmatophora;Karyorelictea;Loxodes;";"0.0";"0";"2";"2";"0";"2";"0";"457181";"391207"
"V4mis2";"SILVA (only NR);Eukaryota;SAR;Alveolata;Ciliophora;Postciliodesmatophora;Karyorelictea;Parduczia;";"0.0";"0";"2";"2";"0";"2";"0";"457181";"391207"
"V4mis2";"SILVA (only NR);Eukaryota;SAR;Alveolata;Ciliophora;Postciliodesmatophora;Karyorelictea;Remanella;";"0.0";"0";"8";"8";"0";"8";"0";"457175";"391207"
"V4mis2";"SILVA (only NR);Eukaryota;SAR;Alveolata;Ciliophora;Postciliodesmatophora;Karyorelictea;Trachelocerca;";"0.0";"0";"1";"1";"0";"1";"0";"457182";"391207"
"V4mis2";"SILVA (only NR);Eukaryota;SAR;Alveolata;Ciliophora;Postciliodesmatophora;Karyorelictea;Tracheloraphis;";"0.0";"0";"10";"10";"0";"10";"0";"457173";"391207"
"V4mis2";"SILVA (only NR);Eukaryota;SAR;Alveolata;Ciliophora;Postciliodesmatophora;Karyorelictea;Wilbertomorpha;";"0.0";"0";"1";"1";"0";"1";"0";"457182";"391207"
"V4mis2";"SILVA (only NR);Eukaryota;SAR;Alveolata;Dinoflagellata;";"0.7";"14.1";"1815";"1764";"12";"1752";"51";"455419";"391195"
"V4mis2";"SILVA (only NR);Eukaryota;SAR;Alveolata;Dinoflagellata;Dinophyceae;";"0.6";"14.1";"1747";"1699";"11";"1688";"48";"455484";"391196"
"V4mis2";"SILVA (only NR);Eukaryota;SAR;Alveolata;Dinoflagellata;Dinophyceae;Dinophysiales;";"2.7";"14.4";"40";"37";"1";"36";"3";"457146";"391206"
"V4mis2";"SILVA (only NR);Eukaryota;SAR;Alveolata;Dinoflagellata;Dinophyceae;Dinophysiales;Amphisolenia;";"0.0";"0";"2";"2";"0";"2";"0";"457181";"391207"
"V4mis2";"SILVA (only NR);Eukaryota;SAR;Alveolata;Dinoflagellata;Dinophyceae;Dinophysiales;Dinophysis;";"14.3";"14.4";"7";"7";"1";"6";"0";"457176";"391206"
"V4mis2";"SILVA (only NR);Eukaryota;SAR;Alveolata;Dinoflagellata;Dinophyceae;Dinophysiales;Ornithocercus;";"0.0";"0";"2";"2";"0";"2";"0";"457181";"391207"
"V4mis2";"SILVA (only NR);Eukaryota;SAR;Alveolata;Dinoflagellata;Dinophyceae;Dinophysiales;Phalacroma;";"0.0";"0";"6";"6";"0";"6";"0";"457177";"391207"
"V4mis2";"SILVA (only NR);Eukaryota;SAR;Alveolata;Dinoflagellata;Dinophyceae;Dinophysiales;Pseudophalacroma;";"0.0";"0";"1";"1";"0";"1";"0";"457182";"391207"
"V4mis2";"SILVA (only NR);Eukaryota;SAR;Alveolata;Dinoflagellata;Dinophyceae;Dinophysiales;Sinophysis;";"0.0";"0";"19";"16";"0";"16";"3";"457167";"391207"
"V4mis2";"SILVA (only NR);Eukaryota;SAR;Alveolata;Dinoflagellata;Dinophyceae;Dinophysiales;Triposolenia;";"0.0";"0";"1";"1";"0";"1";"0";"457182";"391207"
"V4mis2";"SILVA (only NR);Eukaryota;SAR;Alveolata;Dinoflagellata;Dinophyceae;Gymnodiniphycidae;";"0.5";"14.3";"844";"813";"4";"809";"31";"456370";"391203"
"V4mis2";"SILVA (only NR);Eukaryota;SAR;Alveolata;Dinoflagellata;Dinophyceae;Gymnodiniphycidae;Amphidinium;";"2.0";"14.4";"51";"51";"1";"50";"0";"457132";"391206"
"V4mis2";"SILVA (only NR);Eukaryota;SAR;Alveolata;Dinoflagellata;Dinophyceae;Gymnodiniphycidae;Ankistrodinium;";"0.0";"0";"1";"1";"0";"1";"0";"457182";"391207"
"V4mis2";"SILVA (only NR);Eukaryota;SAR;Alveolata;Dinoflagellata;Dinophyceae;Gymnodiniphycidae;Gymnodinium clade;";"0.5";"14.4";"212";"201";"1";"200";"11";"456982";"391206"
"V4mis2";"SILVA (only NR);Eukaryota;SAR;Alveolata;Dinoflagellata;Dinophyceae;Gymnodiniphycidae;Gymnodinium clade;Chytriodinium;";"0.0";"0";"7";"7";"0";"7";"0";"457176";"391207"
"V4mis2";"SILVA (only NR);Eukaryota;SAR;Alveolata;Dinoflagellata;Dinophyceae;Gymnodiniphycidae;Gymnodinium clade;Erythropsidinium;";"0.0";"0";"37";"37";"0";"37";"0";"457146";"391207"
"V4mis2";"SILVA (only NR);Eukaryota;SAR;Alveolata;Dinoflagellata;Dinophyceae;Gymnodiniphycidae;Gymnodinium clade;Gymnodinium;";"0.0";"0";"59";"58";"0";"58";"1";"457125";"391207"
"V4mis2";"SILVA (only NR);Eukaryota;SAR;Alveolata;Dinoflagellata;Dinophyceae;Gymnodiniphycidae;Gymnodinium clade;Gymnoxanthella;";"0.0";"0";"3";"3";"0";"3";"0";"457180";"391207"
"V4mis2";"SILVA (only NR);Eukaryota;SAR;Alveolata;Dinoflagellata;Dinophyceae;Gymnodiniphycidae;Gymnodinium clade;Gyrodiniellum;";"0.0";"0";"18";"8";"0";"8";"10";"457175";"391207"
"V4mis2";"SILVA (only NR);Eukaryota;SAR;Alveolata;Dinoflagellata;Dinophyceae;Gymnodiniphycidae;Gymnodinium clade;Lepidodinium;";"0.0";"0";"8";"8";"0";"8";"0";"457175";"391207"
"V4mis2";"SILVA (only NR);Eukaryota;SAR;Alveolata;Dinoflagellata;Dinophyceae;Gymnodiniphycidae;Gymnodinium clade;Nematodinium;";"0.0";"0";"2";"2";"0";"2";"0";"457181";"391207"
"V4mis2";"SILVA (only NR);Eukaryota;SAR;Alveolata;Dinoflagellata;Dinophyceae;Gymnodiniphycidae;Gymnodinium clade;Nusuttodinium;";"0.0";"0";"8";"8";"0";"8";"0";"457175";"391207"
"V4mis2";"SILVA (only NR);Eukaryota;SAR;Alveolata;Dinoflagellata;Dinophyceae;Gymnodiniphycidae;Gymnodinium clade;Paragymnodinium;";"0.0";"0";"7";"7";"0";"7";"0";"457176";"391207"
"V4mis2";"SILVA (only NR);Eukaryota;SAR;Alveolata;Dinoflagellata;Dinophyceae;Gymnodiniphycidae;Gymnodinium clade;Pellucidodinium;";"0.0";"0";"2";"2";"0";"2";"0";"457181";"391207"
"V4mis2";"SILVA (only NR);Eukaryota;SAR;Alveolata;Dinoflagellata;Dinophyceae;Gymnodiniphycidae;Gymnodinium clade;Pheopolykrikos;";"0.0";"0";"2";"2";"0";"2";"0";"457181";"391207"
"V4mis2";"SILVA (only NR);Eukaryota;SAR;Alveolata;Dinoflagellata;Dinophyceae;Gymnodiniphycidae;Gymnodinium clade;Polykrikos;";"14.3";"14.4";"7";"7";"1";"6";"0";"457176";"391206"
"V4mis2";"SILVA (only NR);Eukaryota;SAR;Alveolata;Dinoflagellata;Dinophyceae;Gymnodiniphycidae;Gymnodinium clade;Proterythropsis;";"0.0";"0";"1";"1";"0";"1";"0";"457182";"391207"
"V4mis2";"SILVA (only NR);Eukaryota;SAR;Alveolata;Dinoflagellata;Dinophyceae;Gymnodiniphycidae;Gymnodinium clade;Spiniferodinium;";"0.0";"0";"2";"2";"0";"2";"0";"457181";"391207"
"V4mis2";"SILVA (only NR);Eukaryota;SAR;Alveolata;Dinoflagellata;Dinophyceae;Gymnodiniphycidae;Gymnodinium clade;Warnowia;";"0.0";"0";"3";"3";"0";"3";"0";"457180";"391207"
"V4mis2";"SILVA (only NR);Eukaryota;SAR;Alveolata;Dinoflagellata;Dinophyceae;Gymnodiniphycidae;Gymnodinium clade;Woloszynskia;";"0.0";"0";"11";"11";"0";"11";"0";"457172";"391207"
"V4mis2";"SILVA (only NR);Eukaryota;SAR;Alveolata;Dinoflagellata;Dinophyceae;Gymnodiniphycidae;Gymnodinium clade;uncultured;";"0.0";"0";"22";"22";"0";"22";"0";"457161";"391207"
"V4mis2";"SILVA (only NR);Eukaryota;SAR;Alveolata;Dinoflagellata;Dinophyceae;Gymnodiniphycidae;Gyrodinium;";"0.5";"14.4";"217";"206";"1";"205";"11";"456977";"391206"
"V4mis2";"SILVA (only NR);Eukaryota;SAR;Alveolata;Dinoflagellata;Dinophyceae;Gymnodiniphycidae;Incertae Sedis;";"2.4";"14.4";"42";"41";"1";"40";"1";"457142";"391206"
"V4mis2";"SILVA (only NR);Eukaryota;SAR;Alveolata;Dinoflagellata;Dinophyceae;Gymnodiniphycidae;Incertae Sedis;Akashiwo;";"0.0";"0";"19";"19";"0";"19";"0";"457164";"391207"
"V4mis2";"SILVA (only NR);Eukaryota;SAR;Alveolata;Dinoflagellata;Dinophyceae;Gymnodiniphycidae;Incertae Sedis;Apicoporus;";"0.0";"0";"5";"4";"0";"4";"1";"457179";"391207"
"V4mis2";"SILVA (only NR);Eukaryota;SAR;Alveolata;Dinoflagellata;Dinophyceae;Gymnodiniphycidae;Incertae Sedis;Cochlodinium;";"5.6";"14.4";"18";"18";"1";"17";"0";"457165";"391206"
"V4mis2";"SILVA (only NR);Eukaryota;SAR;Alveolata;Dinoflagellata;Dinophyceae;Gymnodiniphycidae;Kareniaceae;";"0.0";"0";"122";"116";"0";"116";"6";"457067";"391207"
"V4mis2";"SILVA (only NR);Eukaryota;SAR;Alveolata;Dinoflagellata;Dinophyceae;Gymnodiniphycidae;Kareniaceae;Karenia;";"0.0";"0";"4";"4";"0";"4";"0";"457179";"391207"
"V4mis2";"SILVA (only NR);Eukaryota;SAR;Alveolata;Dinoflagellata;Dinophyceae;Gymnodiniphycidae;Kareniaceae;Karlodinium;";"0.0";"0";"112";"106";"0";"106";"6";"457077";"391207"
"V4mis2";"SILVA (only NR);Eukaryota;SAR;Alveolata;Dinoflagellata;Dinophyceae;Gymnodiniphycidae;Kareniaceae;Takayama;";"0.0";"0";"4";"4";"0";"4";"0";"457179";"391207"
"V4mis2";"SILVA (only NR);Eukaryota;SAR;Alveolata;Dinoflagellata;Dinophyceae;Gymnodiniphycidae;Katodinium;";"0.0";"0";"9";"9";"0";"9";"0";"457174";"391207"
"V4mis2";"SILVA (only NR);Eukaryota;SAR;Alveolata;Dinoflagellata;Dinophyceae;Gymnodiniphycidae;Moestrupia;";"0.0";"0";"3";"3";"0";"3";"0";"457180";"391207"
"V4mis2";"SILVA (only NR);Eukaryota;SAR;Alveolata;Dinoflagellata;Dinophyceae;Gymnodiniphycidae;Ptychodiscus;";"0.0";"0";"9";"9";"0";"9";"0";"457174";"391207"
"V4mis2";"SILVA (only NR);Eukaryota;SAR;Alveolata;Dinoflagellata;Dinophyceae;Gymnodiniphycidae;Suessiaceae;";"0.0";"0";"146";"146";"0";"146";"0";"457037";"391207"
"V4mis2";"SILVA (only NR);Eukaryota;SAR;Alveolata;Dinoflagellata;Dinophyceae;Gymnodiniphycidae;Suessiaceae;Ansanella;";"0.0";"0";"1";"1";"0";"1";"0";"457182";"391207"
"V4mis2";"SILVA (only NR);Eukaryota;SAR;Alveolata;Dinoflagellata;Dinophyceae;Gymnodiniphycidae;Suessiaceae;Biecheleria;";"0.0";"0";"16";"16";"0";"16";"0";"457167";"391207"
"V4mis2";"SILVA (only NR);Eukaryota;SAR;Alveolata;Dinoflagellata;Dinophyceae;Gymnodiniphycidae;Suessiaceae;Pelagodinium;";"0.0";"0";"13";"13";"0";"13";"0";"457170";"391207"
"V4mis2";"SILVA (only NR);Eukaryota;SAR;Alveolata;Dinoflagellata;Dinophyceae;Gymnodiniphycidae;Suessiaceae;Polarella;";"0.0";"0";"4";"4";"0";"4";"0";"457179";"391207"
"V4mis2";"SILVA (only NR);Eukaryota;SAR;Alveolata;Dinoflagellata;Dinophyceae;Gymnodiniphycidae;Suessiaceae;Protodinium;";"0.0";"0";"2";"2";"0";"2";"0";"457181";"391207"
"V4mis2";"SILVA (only NR);Eukaryota;SAR;Alveolata;Dinoflagellata;Dinophyceae;Gymnodiniphycidae;Suessiaceae;Symbiodinium;";"0.0";"0";"103";"103";"0";"103";"0";"457080";"391207"
"V4mis2";"SILVA (only NR);Eukaryota;SAR;Alveolata;Dinoflagellata;Dinophyceae;Gymnodiniphycidae;Suessiaceae;uncultured;";"0.0";"0";"5";"5";"0";"5";"0";"457178";"391207"
"V4mis2";"SILVA (only NR);Eukaryota;SAR;Alveolata;Dinoflagellata;Dinophyceae;Gymnodiniphycidae;Tovelliaceae;";"0.0";"0";"5";"5";"0";"5";"0";"457178";"391207"
"V4mis2";"SILVA (only NR);Eukaryota;SAR;Alveolata;Dinoflagellata;Dinophyceae;Gymnodiniphycidae;Tovelliaceae;Esoptrodinium;";"0.0";"0";"2";"2";"0";"2";"0";"457181";"391207"
"V4mis2";"SILVA (only NR);Eukaryota;SAR;Alveolata;Dinoflagellata;Dinophyceae;Gymnodiniphycidae;Tovelliaceae;Jadwigia;";"0.0";"0";"3";"3";"0";"3";"0";"457180";"391207"
"V4mis2";"SILVA (only NR);Eukaryota;SAR;Alveolata;Dinoflagellata;Dinophyceae;Gymnodiniphycidae;uncultured;";"0.0";"0";"17";"16";"0";"16";"1";"457167";"391207"
"V4mis2";"SILVA (only NR);Eukaryota;SAR;Alveolata;Dinoflagellata;Dinophyceae;Incertae Sedis;";"0.0";"0";"8";"8";"0";"8";"0";"457175";"391207"
"V4mis2";"SILVA (only NR);Eukaryota;SAR;Alveolata;Dinoflagellata;Dinophyceae;Incertae Sedis;Ailadinium;";"0.0";"0";"1";"1";"0";"1";"0";"457182";"391207"
"V4mis2";"SILVA (only NR);Eukaryota;SAR;Alveolata;Dinoflagellata;Dinophyceae;Incertae Sedis;Halostylodinium;";"0.0";"0";"2";"2";"0";"2";"0";"457181";"391207"
"V4mis2";"SILVA (only NR);Eukaryota;SAR;Alveolata;Dinoflagellata;Dinophyceae;Incertae Sedis;Madanidinium;";"0.0";"0";"2";"2";"0";"2";"0";"457181";"391207"
"V4mis2";"SILVA (only NR);Eukaryota;SAR;Alveolata;Dinoflagellata;Dinophyceae;Incertae Sedis;Pileidinium;";"0.0";"0";"1";"1";"0";"1";"0";"457182";"391207"
"V4mis2";"SILVA (only NR);Eukaryota;SAR;Alveolata;Dinoflagellata;Dinophyceae;Incertae Sedis;Sabulodinium;";"0.0";"0";"2";"2";"0";"2";"0";"457181";"391207"
"V4mis2";"SILVA (only NR);Eukaryota;SAR;Alveolata;Dinoflagellata;Dinophyceae;Peridiniphycidae;";"0.5";"14.3";"584";"573";"3";"570";"11";"456610";"391204"
"V4mis2";"SILVA (only NR);Eukaryota;SAR;Alveolata;Dinoflagellata;Dinophyceae;Peridiniphycidae;Gonyaulacales;";"0.7";"14.4";"312";"305";"2";"303";"7";"456878";"391205"
"V4mis2";"SILVA (only NR);Eukaryota;SAR;Alveolata;Dinoflagellata;Dinophyceae;Peridiniphycidae;Gonyaulacales;Adenoides;";"0.0";"0";"2";"2";"0";"2";"0";"457181";"391207"
"V4mis2";"SILVA (only NR);Eukaryota;SAR;Alveolata;Dinoflagellata;Dinophyceae;Peridiniphycidae;Gonyaulacales;Alexandrium;";"0.0";"0";"42";"42";"0";"42";"0";"457141";"391207"
"V4mis2";"SILVA (only NR);Eukaryota;SAR;Alveolata;Dinoflagellata;Dinophyceae;Peridiniphycidae;Gonyaulacales;Amphidoma;";"0.0";"0";"1";"1";"0";"1";"0";"457182";"391207"
"V4mis2";"SILVA (only NR);Eukaryota;SAR;Alveolata;Dinoflagellata;Dinophyceae;Peridiniphycidae;Gonyaulacales;Amylax;";"0.0";"0";"1";"1";"0";"1";"0";"457182";"391207"
"V4mis2";"SILVA (only NR);Eukaryota;SAR;Alveolata;Dinoflagellata;Dinophyceae;Peridiniphycidae;Gonyaulacales;Azadinium;";"0.0";"0";"114";"113";"0";"113";"1";"457070";"391207"
"V4mis2";"SILVA (only NR);Eukaryota;SAR;Alveolata;Dinoflagellata;Dinophyceae;Peridiniphycidae;Gonyaulacales;Ceratium;";"0.0";"0";"11";"11";"0";"11";"0";"457172";"391207"
"V4mis2";"SILVA (only NR);Eukaryota;SAR;Alveolata;Dinoflagellata;Dinophyceae;Peridiniphycidae;Gonyaulacales;Ceratocorys;";"0.0";"0";"2";"2";"0";"2";"0";"457181";"391207"
"V4mis2";"SILVA (only NR);Eukaryota;SAR;Alveolata;Dinoflagellata;Dinophyceae;Peridiniphycidae;Gonyaulacales;Coolia;";"0.0";"0";"5";"5";"0";"5";"0";"457178";"391207"
"V4mis2";"SILVA (only NR);Eukaryota;SAR;Alveolata;Dinoflagellata;Dinophyceae;Peridiniphycidae;Gonyaulacales;Dapsilidinium;";"0.0";"0";"1";"1";"0";"1";"0";"457182";"391207"
"V4mis2";"SILVA (only NR);Eukaryota;SAR;Alveolata;Dinoflagellata;Dinophyceae;Peridiniphycidae;Gonyaulacales;Fragilidium;";"0.0";"0";"3";"3";"0";"3";"0";"457180";"391207"
"V4mis2";"SILVA (only NR);Eukaryota;SAR;Alveolata;Dinoflagellata;Dinophyceae;Peridiniphycidae;Gonyaulacales;Gambierdiscus;";"0.0";"0";"64";"64";"0";"64";"0";"457119";"391207"
"V4mis2";"SILVA (only NR);Eukaryota;SAR;Alveolata;Dinoflagellata;Dinophyceae;Peridiniphycidae;Gonyaulacales;Goniodoma;";"0.0";"0";"1";"1";"0";"1";"0";"457182";"391207"
"V4mis2";"SILVA (only NR);Eukaryota;SAR;Alveolata;Dinoflagellata;Dinophyceae;Peridiniphycidae;Gonyaulacales;Gonyaulax;";"0.0";"0";"24";"21";"0";"21";"3";"457162";"391207"
"V4mis2";"SILVA (only NR);Eukaryota;SAR;Alveolata;Dinoflagellata;Dinophyceae;Peridiniphycidae;Gonyaulacales;Grammatodinium;";"0.0";"0";"1";"1";"0";"1";"0";"457182";"391207"
"V4mis2";"SILVA (only NR);Eukaryota;SAR;Alveolata;Dinoflagellata;Dinophyceae;Peridiniphycidae;Gonyaulacales;Heterodinium;";"0.0";"0";"8";"6";"0";"6";"2";"457177";"391207"
"V4mis2";"SILVA (only NR);Eukaryota;SAR;Alveolata;Dinoflagellata;Dinophyceae;Peridiniphycidae;Gonyaulacales;Lingulodinium;";"0.0";"0";"6";"5";"0";"5";"1";"457178";"391207"
"V4mis2";"SILVA (only NR);Eukaryota;SAR;Alveolata;Dinoflagellata;Dinophyceae;Peridiniphycidae;Gonyaulacales;Neoceratium;";"14.3";"14.4";"7";"7";"1";"6";"0";"457176";"391206"
"V4mis2";"SILVA (only NR);Eukaryota;SAR;Alveolata;Dinoflagellata;Dinophyceae;Peridiniphycidae;Gonyaulacales;Ostreopsis;";"0.0";"0";"7";"7";"0";"7";"0";"457176";"391207"
"V4mis2";"SILVA (only NR);Eukaryota;SAR;Alveolata;Dinoflagellata;Dinophyceae;Peridiniphycidae;Gonyaulacales;Posoniella;";"0.0";"0";"1";"1";"0";"1";"0";"457182";"391207"
"V4mis2";"SILVA (only NR);Eukaryota;SAR;Alveolata;Dinoflagellata;Dinophyceae;Peridiniphycidae;Gonyaulacales;Protoceratium;";"0.0";"0";"2";"2";"0";"2";"0";"457181";"391207"
"V4mis2";"SILVA (only NR);Eukaryota;SAR;Alveolata;Dinoflagellata;Dinophyceae;Peridiniphycidae;Gonyaulacales;Pyrocystis;";"0.0";"0";"2";"2";"0";"2";"0";"457181";"391207"
"V4mis2";"SILVA (only NR);Eukaryota;SAR;Alveolata;Dinoflagellata;Dinophyceae;Peridiniphycidae;Gonyaulacales;Pyrodinium;";"0.0";"0";"2";"2";"0";"2";"0";"457181";"391207"
"V4mis2";"SILVA (only NR);Eukaryota;SAR;Alveolata;Dinoflagellata;Dinophyceae;Peridiniphycidae;Gonyaulacales;Pyrophacus;";"100.0";"14.4";"1";"1";"1";"0";"0";"457182";"391206"
"V4mis2";"SILVA (only NR);Eukaryota;SAR;Alveolata;Dinoflagellata;Dinophyceae;Peridiniphycidae;Gonyaulacales;Pyxidinopsis;";"0.0";"0";"1";"1";"0";"1";"0";"457182";"391207"
"V4mis2";"SILVA (only NR);Eukaryota;SAR;Alveolata;Dinoflagellata;Dinophyceae;Peridiniphycidae;Gonyaulacales;Thecadinium;";"0.0";"0";"1";"1";"0";"1";"0";"457182";"391207"
"V4mis2";"SILVA (only NR);Eukaryota;SAR;Alveolata;Dinoflagellata;Dinophyceae;Peridiniphycidae;Gonyaulacales;uncultured;";"0.0";"0";"2";"2";"0";"2";"0";"457181";"391207"
"V4mis2";"SILVA (only NR);Eukaryota;SAR;Alveolata;Dinoflagellata;Dinophyceae;Peridiniphycidae;Peridiniales;";"0.5";"14.4";"204";"202";"1";"201";"2";"456981";"391206"
"V4mis2";"SILVA (only NR);Eukaryota;SAR;Alveolata;Dinoflagellata;Dinophyceae;Peridiniphycidae;Peridiniales;Aduncodinium;";"0.0";"0";"3";"3";"0";"3";"0";"457180";"391207"
"V4mis2";"SILVA (only NR);Eukaryota;SAR;Alveolata;Dinoflagellata;Dinophyceae;Peridiniphycidae;Peridiniales;Amphidiniella;";"0.0";"0";"1";"1";"0";"1";"0";"457182";"391207"
"V4mis2";"SILVA (only NR);Eukaryota;SAR;Alveolata;Dinoflagellata;Dinophyceae;Peridiniphycidae;Peridiniales;Amphidiniopsis;";"0.0";"0";"17";"17";"0";"17";"0";"457166";"391207"
"V4mis2";"SILVA (only NR);Eukaryota;SAR;Alveolata;Dinoflagellata;Dinophyceae;Peridiniphycidae;Peridiniales;Archaeperidinium;";"0.0";"0";"1";"1";"0";"1";"0";"457182";"391207"
"V4mis2";"SILVA (only NR);Eukaryota;SAR;Alveolata;Dinoflagellata;Dinophyceae;Peridiniphycidae;Peridiniales;Balechina;";"0.0";"0";"3";"3";"0";"3";"0";"457180";"391207"
"V4mis2";"SILVA (only NR);Eukaryota;SAR;Alveolata;Dinoflagellata;Dinophyceae;Peridiniphycidae;Peridiniales;Blixaea;";"0.0";"0";"1";"1";"0";"1";"0";"457182";"391207"
"V4mis2";"SILVA (only NR);Eukaryota;SAR;Alveolata;Dinoflagellata;Dinophyceae;Peridiniphycidae;Peridiniales;Crypthecodinium;";"0.0";"0";"4";"4";"0";"4";"0";"457179";"391207"
"V4mis2";"SILVA (only NR);Eukaryota;SAR;Alveolata;Dinoflagellata;Dinophyceae;Peridiniphycidae;Peridiniales;Cystodinium;";"0.0";"0";"1";"1";"0";"1";"0";"457182";"391207"
"V4mis2";"SILVA (only NR);Eukaryota;SAR;Alveolata;Dinoflagellata;Dinophyceae;Peridiniphycidae;Peridiniales;Diplopsalis;";"0.0";"0";"1";"1";"0";"1";"0";"457182";"391207"
"V4mis2";"SILVA (only NR);Eukaryota;SAR;Alveolata;Dinoflagellata;Dinophyceae;Peridiniphycidae;Peridiniales;Diplosalopsis;";"0.0";"0";"1";"1";"0";"1";"0";"457182";"391207"
"V4mis2";"SILVA (only NR);Eukaryota;SAR;Alveolata;Dinoflagellata;Dinophyceae;Peridiniphycidae;Peridiniales;Durinskia;";"0.0";"0";"6";"6";"0";"6";"0";"457177";"391207"
"V4mis2";"SILVA (only NR);Eukaryota;SAR;Alveolata;Dinoflagellata;Dinophyceae;Peridiniphycidae;Peridiniales;Galeidinium;";"0.0";"0";"1";"1";"0";"1";"0";"457182";"391207"
"V4mis2";"SILVA (only NR);Eukaryota;SAR;Alveolata;Dinoflagellata;Dinophyceae;Peridiniphycidae;Peridiniales;Glenodiniopsis;";"0.0";"0";"2";"2";"0";"2";"0";"457181";"391207"
"V4mis2";"SILVA (only NR);Eukaryota;SAR;Alveolata;Dinoflagellata;Dinophyceae;Peridiniphycidae;Peridiniales;Glenodinium;";"0.0";"0";"3";"3";"0";"3";"0";"457180";"391207"
"V4mis2";"SILVA (only NR);Eukaryota;SAR;Alveolata;Dinoflagellata;Dinophyceae;Peridiniphycidae;Peridiniales;Gotoius;";"0.0";"0";"1";"1";"0";"1";"0";"457182";"391207"
"V4mis2";"SILVA (only NR);Eukaryota;SAR;Alveolata;Dinoflagellata;Dinophyceae;Peridiniphycidae;Peridiniales;Hemidinium;";"0.0";"0";"1";"1";"0";"1";"0";"457182";"391207"
"V4mis2";"SILVA (only NR);Eukaryota;SAR;Alveolata;Dinoflagellata;Dinophyceae;Peridiniphycidae;Peridiniales;Herdmania;";"0.0";"0";"2";"2";"0";"2";"0";"457181";"391207"
"V4mis2";"SILVA (only NR);Eukaryota;SAR;Alveolata;Dinoflagellata;Dinophyceae;Peridiniphycidae;Peridiniales;Heterocapsa;";"0.0";"0";"29";"29";"0";"29";"0";"457154";"391207"
"V4mis2";"SILVA (only NR);Eukaryota;SAR;Alveolata;Dinoflagellata;Dinophyceae;Peridiniphycidae;Peridiniales;Islandinium;";"0.0";"0";"5";"4";"0";"4";"1";"457179";"391207"
"V4mis2";"SILVA (only NR);Eukaryota;SAR;Alveolata;Dinoflagellata;Dinophyceae;Peridiniphycidae;Peridiniales;Kryptoperidinium;";"0.0";"0";"2";"2";"0";"2";"0";"457181";"391207"
"V4mis2";"SILVA (only NR);Eukaryota;SAR;Alveolata;Dinoflagellata;Dinophyceae;Peridiniphycidae;Peridiniales;Niea;";"0.0";"0";"2";"2";"0";"2";"0";"457181";"391207"
"V4mis2";"SILVA (only NR);Eukaryota;SAR;Alveolata;Dinoflagellata;Dinophyceae;Peridiniphycidae;Peridiniales;Peridiniopsis;";"0.0";"0";"3";"3";"0";"3";"0";"457180";"391207"
"V4mis2";"SILVA (only NR);Eukaryota;SAR;Alveolata;Dinoflagellata;Dinophyceae;Peridiniphycidae;Peridiniales;Peridinium;";"3.2";"14.4";"32";"31";"1";"30";"1";"457152";"391206"
"V4mis2";"SILVA (only NR);Eukaryota;SAR;Alveolata;Dinoflagellata;Dinophyceae;Peridiniphycidae;Peridiniales;Preperidinium;";"0.0";"0";"1";"1";"0";"1";"0";"457182";"391207"
"V4mis2";"SILVA (only NR);Eukaryota;SAR;Alveolata;Dinoflagellata;Dinophyceae;Peridiniphycidae;Peridiniales;Protoperidinium;";"0.0";"0";"62";"62";"0";"62";"0";"457121";"391207"
"V4mis2";"SILVA (only NR);Eukaryota;SAR;Alveolata;Dinoflagellata;Dinophyceae;Peridiniphycidae;Peridiniales;Pyramidodinium;";"0.0";"0";"2";"2";"0";"2";"0";"457181";"391207"
"V4mis2";"SILVA (only NR);Eukaryota;SAR;Alveolata;Dinoflagellata;Dinophyceae;Peridiniphycidae;Peridiniales;Qia;";"0.0";"0";"1";"1";"0";"1";"0";"457182";"391207"
"V4mis2";"SILVA (only NR);Eukaryota;SAR;Alveolata;Dinoflagellata;Dinophyceae;Peridiniphycidae;Peridiniales;Stylodinium;";"0.0";"0";"1";"1";"0";"1";"0";"457182";"391207"
"V4mis2";"SILVA (only NR);Eukaryota;SAR;Alveolata;Dinoflagellata;Dinophyceae;Peridiniphycidae;Peridiniales;Thecate;";"0.0";"0";"1";"1";"0";"1";"0";"457182";"391207"
"V4mis2";"SILVA (only NR);Eukaryota;SAR;Alveolata;Dinoflagellata;Dinophyceae;Peridiniphycidae;Peridiniales;uncultured;";"0.0";"0";"7";"7";"0";"7";"0";"457176";"391207"
"V4mis2";"SILVA (only NR);Eukaryota;SAR;Alveolata;Dinoflagellata;Dinophyceae;Peridiniphycidae;Podolampadaceae;";"0.0";"0";"10";"10";"0";"10";"0";"457173";"391207"
"V4mis2";"SILVA (only NR);Eukaryota;SAR;Alveolata;Dinoflagellata;Dinophyceae;Peridiniphycidae;Podolampadaceae;Lessardia;";"0.0";"0";"6";"6";"0";"6";"0";"457177";"391207"
"V4mis2";"SILVA (only NR);Eukaryota;SAR;Alveolata;Dinoflagellata;Dinophyceae;Peridiniphycidae;Podolampadaceae;Podolampas;";"0.0";"0";"1";"1";"0";"1";"0";"457182";"391207"
"V4mis2";"SILVA (only NR);Eukaryota;SAR;Alveolata;Dinoflagellata;Dinophyceae;Peridiniphycidae;Podolampadaceae;Roscoffia;";"0.0";"0";"2";"2";"0";"2";"0";"457181";"391207"
"V4mis2";"SILVA (only NR);Eukaryota;SAR;Alveolata;Dinoflagellata;Dinophyceae;Peridiniphycidae;Thoracosphaeraceae;";"0.0";"0";"58";"56";"0";"56";"2";"457127";"391207"
"V4mis2";"SILVA (only NR);Eukaryota;SAR;Alveolata;Dinoflagellata;Dinophyceae;Peridiniphycidae;Thoracosphaeraceae;Cryptoperidiniopsis;";"0.0";"0";"5";"5";"0";"5";"0";"457178";"391207"
"V4mis2";"SILVA (only NR);Eukaryota;SAR;Alveolata;Dinoflagellata;Dinophyceae;Peridiniphycidae;Thoracosphaeraceae;Gloeodinium;";"0.0";"0";"2";"2";"0";"2";"0";"457181";"391207"
"V4mis2";"SILVA (only NR);Eukaryota;SAR;Alveolata;Dinoflagellata;Dinophyceae;Peridiniphycidae;Thoracosphaeraceae;Oodinium;";"0.0";"0";"8";"6";"0";"6";"2";"457177";"391207"
"V4mis2";"SILVA (only NR);Eukaryota;SAR;Alveolata;Dinoflagellata;Dinophyceae;Peridiniphycidae;Thoracosphaeraceae;Pentapharsodinium;";"0.0";"0";"6";"6";"0";"6";"0";"457177";"391207"
"V4mis2";"SILVA (only NR);Eukaryota;SAR;Alveolata;Dinoflagellata;Dinophyceae;Peridiniphycidae;Thoracosphaeraceae;Pfiesteria;";"0.0";"0";"9";"9";"0";"9";"0";"457174";"391207"
"V4mis2";"SILVA (only NR);Eukaryota;SAR;Alveolata;Dinoflagellata;Dinophyceae;Peridiniphycidae;Thoracosphaeraceae;Scrippsiella;";"0.0";"0";"14";"14";"0";"14";"0";"457169";"391207"
"V4mis2";"SILVA (only NR);Eukaryota;SAR;Alveolata;Dinoflagellata;Dinophyceae;Peridiniphycidae;Thoracosphaeraceae;Stoeckeria;";"0.0";"0";"1";"1";"0";"1";"0";"457182";"391207"
"V4mis2";"SILVA (only NR);Eukaryota;SAR;Alveolata;Dinoflagellata;Dinophyceae;Peridiniphycidae;Thoracosphaeraceae;Thoracosphaera;";"0.0";"0";"2";"2";"0";"2";"0";"457181";"391207"
"V4mis2";"SILVA (only NR);Eukaryota;SAR;Alveolata;Dinoflagellata;Dinophyceae;Peridiniphycidae;Thoracosphaeraceae;Tintinnophagus;";"0.0";"0";"1";"1";"0";"1";"0";"457182";"391207"
"V4mis2";"SILVA (only NR);Eukaryota;SAR;Alveolata;Dinoflagellata;Dinophyceae;Peridiniphycidae;Thoracosphaeraceae;uncultured;";"0.0";"0";"5";"5";"0";"5";"0";"457178";"391207"
"V4mis2";"SILVA (only NR);Eukaryota;SAR;Alveolata;Dinoflagellata;Dinophyceae;Prorocentrales;";"0.0";"0";"44";"44";"0";"44";"0";"457139";"391207"
"V4mis2";"SILVA (only NR);Eukaryota;SAR;Alveolata;Dinoflagellata;Dinophyceae;Prorocentrales;Plagiodinium;";"0.0";"0";"3";"3";"0";"3";"0";"457180";"391207"
"V4mis2";"SILVA (only NR);Eukaryota;SAR;Alveolata;Dinoflagellata;Dinophyceae;Prorocentrales;Prorocentrum;";"0.0";"0";"41";"41";"0";"41";"0";"457142";"391207"
"V4mis2";"SILVA (only NR);Eukaryota;SAR;Alveolata;Dinoflagellata;Dinophyceae;uncultured;";"1.6";"14.4";"194";"191";"3";"188";"3";"456992";"391204"
"V4mis2";"SILVA (only NR);Eukaryota;SAR;Alveolata;Dinoflagellata;Incertae Sedis;";"0.0";"0";"39";"36";"0";"36";"3";"457147";"391207"
"V4mis2";"SILVA (only NR);Eukaryota;SAR;Alveolata;Dinoflagellata;Incertae Sedis;Blastodinium;";"0.0";"0";"24";"21";"0";"21";"3";"457162";"391207"
"V4mis2";"SILVA (only NR);Eukaryota;SAR;Alveolata;Dinoflagellata;Incertae Sedis;Haplozoon;";"0.0";"0";"7";"7";"0";"7";"0";"457176";"391207"
"V4mis2";"SILVA (only NR);Eukaryota;SAR;Alveolata;Dinoflagellata;Incertae Sedis;Paulsenella;";"0.0";"0";"1";"1";"0";"1";"0";"457182";"391207"
"V4mis2";"SILVA (only NR);Eukaryota;SAR;Alveolata;Dinoflagellata;Noctilucales;";"9.1";"14.4";"11";"11";"1";"10";"0";"457172";"391206"
"V4mis2";"SILVA (only NR);Eukaryota;SAR;Alveolata;Dinoflagellata;Noctilucales;Abedinium;";"0.0";"0";"4";"4";"0";"4";"0";"457179";"391207"
"V4mis2";"SILVA (only NR);Eukaryota;SAR;Alveolata;Dinoflagellata;Noctilucales;Kofoidinium;";"0.0";"0";"1";"1";"0";"1";"0";"457182";"391207"
"V4mis2";"SILVA (only NR);Eukaryota;SAR;Alveolata;Dinoflagellata;Noctilucales;Noctiluca;";"0.0";"0";"2";"2";"0";"2";"0";"457181";"391207"
"V4mis2";"SILVA (only NR);Eukaryota;SAR;Alveolata;Dinoflagellata;Noctilucales;Spatulodinium;";"0.0";"0";"1";"1";"0";"1";"0";"457182";"391207"
"V4mis2";"SILVA (only NR);Eukaryota;SAR;Alveolata;Dinoflagellata;uncultured;";"0.0";"0";"11";"11";"0";"11";"0";"457172";"391207"
"V4mis2";"SILVA (only NR);Eukaryota;SAR;Alveolata;Incertae Sedis;";"0.0";"0";"7";"7";"0";"7";"0";"457176";"391207"
"V4mis2";"SILVA (only NR);Eukaryota;SAR;Alveolata;Incertae Sedis;Colponema;";"0.0";"0";"7";"7";"0";"7";"0";"457176";"391207"
"V4mis2";"SILVA (only NR);Eukaryota;SAR;Alveolata;Protalveolata;";"41.4";"14.1";"3050";"2912";"1205";"1707";"138";"454271";"390002"
"V4mis2";"SILVA (only NR);Eukaryota;SAR;Alveolata;Protalveolata;Chromerida;";"0.0";"0";"3";"3";"0";"3";"0";"457180";"391207"
"V4mis2";"SILVA (only NR);Eukaryota;SAR;Alveolata;Protalveolata;Chromerida;Chromera;";"0.0";"0";"3";"3";"0";"3";"0";"457180";"391207"
"V4mis2";"SILVA (only NR);Eukaryota;SAR;Alveolata;Protalveolata;Colpodellida;";"0.4";"14.4";"228";"228";"1";"227";"0";"456955";"391206"
"V4mis2";"SILVA (only NR);Eukaryota;SAR;Alveolata;Protalveolata;Colpodellida;Colpodella;";"0.5";"14.4";"222";"222";"1";"221";"0";"456961";"391206"
"V4mis2";"SILVA (only NR);Eukaryota;SAR;Alveolata;Protalveolata;Colpodellida;Voromonas;";"0.0";"0";"2";"2";"0";"2";"0";"457181";"391207"
"V4mis2";"SILVA (only NR);Eukaryota;SAR;Alveolata;Protalveolata;Incertae Sedis;";"0.0";"0";"10";"10";"0";"10";"0";"457173";"391207"
"V4mis2";"SILVA (only NR);Eukaryota;SAR;Alveolata;Protalveolata;Incertae Sedis;Ellobiopsidae;";"0.0";"0";"10";"10";"0";"10";"0";"457173";"391207"
"V4mis2";"SILVA (only NR);Eukaryota;SAR;Alveolata;Protalveolata;Incertae Sedis;Ellobiopsidae;Ellobiopsis;";"0.0";"0";"5";"5";"0";"5";"0";"457178";"391207"
"V4mis2";"SILVA (only NR);Eukaryota;SAR;Alveolata;Protalveolata;Incertae Sedis;Ellobiopsidae;Thalassomyces;";"0.0";"0";"3";"3";"0";"3";"0";"457180";"391207"
"V4mis2";"SILVA (only NR);Eukaryota;SAR;Alveolata;Protalveolata;Incertae Sedis;Ellobiopsidae;uncultured;";"0.0";"0";"2";"2";"0";"2";"0";"457181";"391207"
"V4mis2";"SILVA (only NR);Eukaryota;SAR;Alveolata;Protalveolata;Oxyrrhis;";"27.3";"14.4";"12";"11";"3";"8";"1";"457172";"391204"
"V4mis2";"SILVA (only NR);Eukaryota;SAR;Alveolata;Protalveolata;Perkinsidae;";"18.1";"14.4";"75";"72";"13";"59";"3";"457111";"391194"
"V4mis2";"SILVA (only NR);Eukaryota;SAR;Alveolata;Protalveolata;Perkinsidae;A31;";"24.4";"14.4";"41";"41";"10";"31";"0";"457142";"391197"
"V4mis2";"SILVA (only NR);Eukaryota;SAR;Alveolata;Protalveolata;Perkinsidae;Parvilucifera;";"8.7";"14.4";"26";"23";"2";"21";"3";"457160";"391205"
"V4mis2";"SILVA (only NR);Eukaryota;SAR;Alveolata;Protalveolata;Perkinsidae;Perkinsus;";"16.7";"14.4";"6";"6";"1";"5";"0";"457177";"391206"
"V4mis2";"SILVA (only NR);Eukaryota;SAR;Alveolata;Protalveolata;Syndiniales;";"45.9";"14.2";"2722";"2588";"1188";"1400";"134";"454595";"390019"
"V4mis2";"SILVA (only NR);Eukaryota;SAR;Alveolata;Protalveolata;Syndiniales;Amoebophrya;";"94.0";"14.4";"222";"201";"189";"12";"21";"456982";"391018"
"V4mis2";"SILVA (only NR);Eukaryota;SAR;Alveolata;Protalveolata;Syndiniales;Duboscquella;";"0.0";"0";"47";"40";"0";"40";"7";"457143";"391207"
"V4mis2";"SILVA (only NR);Eukaryota;SAR;Alveolata;Protalveolata;Syndiniales;Hematodinium;";"0.0";"0";"10";"10";"0";"10";"0";"457173";"391207"
"V4mis2";"SILVA (only NR);Eukaryota;SAR;Alveolata;Protalveolata;Syndiniales;Syndiniales Group I;";"3.7";"14.3";"757";"702";"26";"676";"55";"456481";"391181"
"V4mis2";"SILVA (only NR);Eukaryota;SAR;Alveolata;Protalveolata;Syndiniales;Syndiniales Group II;";"66.2";"14.4";"1469";"1428";"945";"483";"41";"455755";"390262"
"V4mis2";"SILVA (only NR);Eukaryota;SAR;Alveolata;Protalveolata;Syndiniales;Syndiniales Group III;";"0.0";"0";"52";"49";"0";"49";"3";"457134";"391207"
"V4mis2";"SILVA (only NR);Eukaryota;SAR;Alveolata;Protalveolata;Syndiniales;Syndiniales Group V;";"0.0";"0";"36";"36";"0";"36";"0";"457147";"391207"
"V4mis2";"SILVA (only NR);Eukaryota;SAR;Alveolata;Protalveolata;Syndiniales;Syndinium;";"0.0";"0";"6";"6";"0";"6";"0";"457177";"391207"
"V4mis2";"SILVA (only NR);Eukaryota;SAR;Alveolata;Protalveolata;Syndiniales;uncultured;";"50.0";"14.4";"50";"48";"24";"24";"2";"457135";"391183"
"V4mis2";"SILVA (only NR);Eukaryota;SAR;Alveolata;uncultured;";"5.0";"14.4";"116";"100";"5";"95";"16";"457083";"391202"
"V4mis2";"SILVA (only NR);Eukaryota;SAR;Rhizaria;";"7.4";"14";"2522";"2300";"171";"2129";"222";"454883";"391036"
"V4mis2";"SILVA (only NR);Eukaryota;SAR;Rhizaria;Cercozoa;";"8.4";"14.2";"1374";"1339";"112";"1227";"35";"455844";"391095"
"V4mis2";"SILVA (only NR);Eukaryota;SAR;Rhizaria;Cercozoa;Ascetosporea;";"49.0";"14.4";"49";"49";"24";"25";"0";"457134";"391183"
"V4mis2";"SILVA (only NR);Eukaryota;SAR;Rhizaria;Cercozoa;Ascetosporea;Haplosporida;";"63.2";"14.4";"38";"38";"24";"14";"0";"457145";"391183"
"V4mis2";"SILVA (only NR);Eukaryota;SAR;Rhizaria;Cercozoa;Ascetosporea;Haplosporida;Bonamia;";"100.0";"14.4";"5";"5";"5";"0";"0";"457178";"391202"
"V4mis2";"SILVA (only NR);Eukaryota;SAR;Rhizaria;Cercozoa;Ascetosporea;Haplosporida;Haplosporidium;";"35.7";"14.4";"14";"14";"5";"9";"0";"457169";"391202"
"V4mis2";"SILVA (only NR);Eukaryota;SAR;Rhizaria;Cercozoa;Ascetosporea;Haplosporida;Minchinia;";"80.0";"14.4";"10";"10";"8";"2";"0";"457173";"391199"
"V4mis2";"SILVA (only NR);Eukaryota;SAR;Rhizaria;Cercozoa;Ascetosporea;Haplosporida;Urosporidium;";"100.0";"14.4";"4";"4";"4";"0";"0";"457179";"391203"
"V4mis2";"SILVA (only NR);Eukaryota;SAR;Rhizaria;Cercozoa;Ascetosporea;Paradiniidae;";"0.0";"0";"5";"5";"0";"5";"0";"457178";"391207"
"V4mis2";"SILVA (only NR);Eukaryota;SAR;Rhizaria;Cercozoa;Ascetosporea;Paradiniidae;Paradinium;";"0.0";"0";"5";"5";"0";"5";"0";"457178";"391207"
"V4mis2";"SILVA (only NR);Eukaryota;SAR;Rhizaria;Cercozoa;Basal Group T;";"0.0";"0";"14";"8";"0";"8";"6";"457175";"391207"
"V4mis2";"SILVA (only NR);Eukaryota;SAR;Rhizaria;Cercozoa;Cercomonadidae;";"3.9";"14.4";"184";"181";"7";"174";"3";"457002";"391200"
"V4mis2";"SILVA (only NR);Eukaryota;SAR;Rhizaria;Cercozoa;Cercomonadidae;Cavernomonas;";"0.0";"0";"2";"2";"0";"2";"0";"457181";"391207"
"V4mis2";"SILVA (only NR);Eukaryota;SAR;Rhizaria;Cercozoa;Cercomonadidae;Cercomonas;";"7.9";"14.4";"89";"89";"7";"82";"0";"457094";"391200"
"V4mis2";"SILVA (only NR);Eukaryota;SAR;Rhizaria;Cercozoa;Cercomonadidae;Eocercomonas;";"0.0";"0";"2";"2";"0";"2";"0";"457181";"391207"
"V4mis2";"SILVA (only NR);Eukaryota;SAR;Rhizaria;Cercozoa;Cercomonadidae;Metabolomonas;";"0.0";"0";"2";"2";"0";"2";"0";"457181";"391207"
"V4mis2";"SILVA (only NR);Eukaryota;SAR;Rhizaria;Cercozoa;Cercomonadidae;Paracercomonas;";"0.0";"0";"15";"15";"0";"15";"0";"457168";"391207"
"V4mis2";"SILVA (only NR);Eukaryota;SAR;Rhizaria;Cercozoa;Cercomonadidae;uncultured;";"0.0";"0";"52";"49";"0";"49";"3";"457134";"391207"
"V4mis2";"SILVA (only NR);Eukaryota;SAR;Rhizaria;Cercozoa;Chlorarachniophyta;";"5.0";"14.4";"60";"60";"3";"57";"0";"457123";"391204"
"V4mis2";"SILVA (only NR);Eukaryota;SAR;Rhizaria;Cercozoa;Chlorarachniophyta;Amorphochlora;";"0.0";"0";"2";"2";"0";"2";"0";"457181";"391207"
"V4mis2";"SILVA (only NR);Eukaryota;SAR;Rhizaria;Cercozoa;Chlorarachniophyta;Bigelowiella;";"0.0";"0";"9";"9";"0";"9";"0";"457174";"391207"
"V4mis2";"SILVA (only NR);Eukaryota;SAR;Rhizaria;Cercozoa;Chlorarachniophyta;Chlorarachnion;";"0.0";"0";"5";"5";"0";"5";"0";"457178";"391207"
"V4mis2";"SILVA (only NR);Eukaryota;SAR;Rhizaria;Cercozoa;Chlorarachniophyta;Gymnochlora;";"33.3";"14.4";"6";"6";"2";"4";"0";"457177";"391205"
"V4mis2";"SILVA (only NR);Eukaryota;SAR;Rhizaria;Cercozoa;Chlorarachniophyta;Lotharella;";"0.0";"0";"13";"13";"0";"13";"0";"457170";"391207"
"V4mis2";"SILVA (only NR);Eukaryota;SAR;Rhizaria;Cercozoa;Chlorarachniophyta;Minorisa;";"0.0";"0";"6";"6";"0";"6";"0";"457177";"391207"
"V4mis2";"SILVA (only NR);Eukaryota;SAR;Rhizaria;Cercozoa;Chlorarachniophyta;NOR26;";"0.0";"0";"7";"7";"0";"7";"0";"457176";"391207"
"V4mis2";"SILVA (only NR);Eukaryota;SAR;Rhizaria;Cercozoa;Chlorarachniophyta;uncultured;";"0.0";"0";"9";"9";"0";"9";"0";"457174";"391207"
"V4mis2";"SILVA (only NR);Eukaryota;SAR;Rhizaria;Cercozoa;Clathrulinidae;";"0.0";"0";"3";"3";"0";"3";"0";"457180";"391207"
"V4mis2";"SILVA (only NR);Eukaryota;SAR;Rhizaria;Cercozoa;Clathrulinidae;Hedriocystis;";"0.0";"0";"3";"3";"0";"3";"0";"457180";"391207"
"V4mis2";"SILVA (only NR);Eukaryota;SAR;Rhizaria;Cercozoa;Cyranomonas;";"0.0";"0";"5";"4";"0";"4";"1";"457179";"391207"
"V4mis2";"SILVA (only NR);Eukaryota;SAR;Rhizaria;Cercozoa;Glissomonadida;";"0.7";"14.4";"138";"138";"1";"137";"0";"457045";"391206"
"V4mis2";"SILVA (only NR);Eukaryota;SAR;Rhizaria;Cercozoa;Glissomonadida;Allantion;";"0.0";"0";"6";"6";"0";"6";"0";"457177";"391207"
"V4mis2";"SILVA (only NR);Eukaryota;SAR;Rhizaria;Cercozoa;Glissomonadida;Bodomorpha;";"0.0";"0";"10";"10";"0";"10";"0";"457173";"391207"
"V4mis2";"SILVA (only NR);Eukaryota;SAR;Rhizaria;Cercozoa;Glissomonadida;Heteromita;";"1.1";"14.4";"95";"95";"1";"94";"0";"457088";"391206"
"V4mis2";"SILVA (only NR);Eukaryota;SAR;Rhizaria;Cercozoa;Glissomonadida;Orciraptor;";"0.0";"0";"2";"2";"0";"2";"0";"457181";"391207"
"V4mis2";"SILVA (only NR);Eukaryota;SAR;Rhizaria;Cercozoa;Glissomonadida;Proleptomonas;";"0.0";"0";"4";"4";"0";"4";"0";"457179";"391207"
"V4mis2";"SILVA (only NR);Eukaryota;SAR;Rhizaria;Cercozoa;Glissomonadida;Viridiraptor;";"0.0";"0";"2";"2";"0";"2";"0";"457181";"391207"
"V4mis2";"SILVA (only NR);Eukaryota;SAR;Rhizaria;Cercozoa;Glissomonadida;uncultured;";"0.0";"0";"8";"8";"0";"8";"0";"457175";"391207"
"V4mis2";"SILVA (only NR);Eukaryota;SAR;Rhizaria;Cercozoa;Granofilosea;";"60.0";"14.4";"10";"10";"6";"4";"0";"457173";"391201"
"V4mis2";"SILVA (only NR);Eukaryota;SAR;Rhizaria;Cercozoa;Granofilosea;Massisteria;";"60.0";"14.4";"10";"10";"6";"4";"0";"457173";"391201"
"V4mis2";"SILVA (only NR);Eukaryota;SAR;Rhizaria;Cercozoa;Gromia;";"11.1";"14.4";"9";"9";"1";"8";"0";"457174";"391206"
"V4mis2";"SILVA (only NR);Eukaryota;SAR;Rhizaria;Cercozoa;Imbricatea;";"0.0";"0";"187";"184";"0";"184";"3";"456999";"391207"
"V4mis2";"SILVA (only NR);Eukaryota;SAR;Rhizaria;Cercozoa;Imbricatea;Auranticordis;";"0.0";"0";"1";"1";"0";"1";"0";"457182";"391207"
"V4mis2";"SILVA (only NR);Eukaryota;SAR;Rhizaria;Cercozoa;Imbricatea;Marimonadida;";"0.0";"0";"18";"17";"0";"17";"1";"457166";"391207"
"V4mis2";"SILVA (only NR);Eukaryota;SAR;Rhizaria;Cercozoa;Imbricatea;Marimonadida;BB01-173;";"0.0";"0";"3";"3";"0";"3";"0";"457180";"391207"
"V4mis2";"SILVA (only NR);Eukaryota;SAR;Rhizaria;Cercozoa;Imbricatea;Marimonadida;NAMAKO-15;";"0.0";"0";"4";"4";"0";"4";"0";"457179";"391207"
"V4mis2";"SILVA (only NR);Eukaryota;SAR;Rhizaria;Cercozoa;Imbricatea;Marimonadida;Pseudopirsonia;";"0.0";"0";"8";"8";"0";"8";"0";"457175";"391207"
"V4mis2";"SILVA (only NR);Eukaryota;SAR;Rhizaria;Cercozoa;Imbricatea;Novel Clade 3;";"0.0";"0";"4";"4";"0";"4";"0";"457179";"391207"
"V4mis2";"SILVA (only NR);Eukaryota;SAR;Rhizaria;Cercozoa;Imbricatea;Nudifila;";"0.0";"0";"7";"7";"0";"7";"0";"457176";"391207"
"V4mis2";"SILVA (only NR);Eukaryota;SAR;Rhizaria;Cercozoa;Imbricatea;Silicofilosea;";"0.0";"0";"151";"149";"0";"149";"2";"457034";"391207"
"V4mis2";"SILVA (only NR);Eukaryota;SAR;Rhizaria;Cercozoa;Imbricatea;Silicofilosea;Euglyphida;";"0.0";"0";"99";"98";"0";"98";"1";"457085";"391207"
"V4mis2";"SILVA (only NR);Eukaryota;SAR;Rhizaria;Cercozoa;Imbricatea;Silicofilosea;Euglyphida;Assulinidae;";"0.0";"0";"3";"3";"0";"3";"0";"457180";"391207"
"V4mis2";"SILVA (only NR);Eukaryota;SAR;Rhizaria;Cercozoa;Imbricatea;Silicofilosea;Euglyphida;Assulinidae;Assulina;";"0.0";"0";"1";"1";"0";"1";"0";"457182";"391207"
"V4mis2";"SILVA (only NR);Eukaryota;SAR;Rhizaria;Cercozoa;Imbricatea;Silicofilosea;Euglyphida;Assulinidae;Placocista;";"0.0";"0";"2";"2";"0";"2";"0";"457181";"391207"
"V4mis2";"SILVA (only NR);Eukaryota;SAR;Rhizaria;Cercozoa;Imbricatea;Silicofilosea;Euglyphida;Cyphoderiidae;";"0.0";"0";"15";"15";"0";"15";"0";"457168";"391207"
"V4mis2";"SILVA (only NR);Eukaryota;SAR;Rhizaria;Cercozoa;Imbricatea;Silicofilosea;Euglyphida;Cyphoderiidae;Corythionella;";"0.0";"0";"1";"1";"0";"1";"0";"457182";"391207"
"V4mis2";"SILVA (only NR);Eukaryota;SAR;Rhizaria;Cercozoa;Imbricatea;Silicofilosea;Euglyphida;Cyphoderiidae;Cyphoderia;";"0.0";"0";"10";"10";"0";"10";"0";"457173";"391207"
"V4mis2";"SILVA (only NR);Eukaryota;SAR;Rhizaria;Cercozoa;Imbricatea;Silicofilosea;Euglyphida;Euglyphidae;";"0.0";"0";"12";"12";"0";"12";"0";"457171";"391207"
"V4mis2";"SILVA (only NR);Eukaryota;SAR;Rhizaria;Cercozoa;Imbricatea;Silicofilosea;Euglyphida;Euglyphidae;Euglypha;";"0.0";"0";"12";"12";"0";"12";"0";"457171";"391207"
"V4mis2";"SILVA (only NR);Eukaryota;SAR;Rhizaria;Cercozoa;Imbricatea;Silicofilosea;Euglyphida;Incertae Sedis;";"0.0";"0";"7";"7";"0";"7";"0";"457176";"391207"
"V4mis2";"SILVA (only NR);Eukaryota;SAR;Rhizaria;Cercozoa;Imbricatea;Silicofilosea;Euglyphida;Incertae Sedis;Sphenoderia;";"0.0";"0";"4";"4";"0";"4";"0";"457179";"391207"
"V4mis2";"SILVA (only NR);Eukaryota;SAR;Rhizaria;Cercozoa;Imbricatea;Silicofilosea;Euglyphida;Incertae Sedis;Tracheleuglypha;";"0.0";"0";"2";"2";"0";"2";"0";"457181";"391207"
"V4mis2";"SILVA (only NR);Eukaryota;SAR;Rhizaria;Cercozoa;Imbricatea;Silicofilosea;Euglyphida;Incertae Sedis;Trachelocorythion;";"0.0";"0";"1";"1";"0";"1";"0";"457182";"391207"
"V4mis2";"SILVA (only NR);Eukaryota;SAR;Rhizaria;Cercozoa;Imbricatea;Silicofilosea;Euglyphida;Paulinellidae;";"0.0";"0";"15";"14";"0";"14";"1";"457169";"391207"
"V4mis2";"SILVA (only NR);Eukaryota;SAR;Rhizaria;Cercozoa;Imbricatea;Silicofilosea;Euglyphida;Paulinellidae;Paulinella;";"0.0";"0";"15";"14";"0";"14";"1";"457169";"391207"
"V4mis2";"SILVA (only NR);Eukaryota;SAR;Rhizaria;Cercozoa;Imbricatea;Silicofilosea;Euglyphida;Trinematidae;";"0.0";"0";"33";"33";"0";"33";"0";"457150";"391207"
"V4mis2";"SILVA (only NR);Eukaryota;SAR;Rhizaria;Cercozoa;Imbricatea;Silicofilosea;Euglyphida;Trinematidae;Corythion;";"0.0";"0";"1";"1";"0";"1";"0";"457182";"391207"
"V4mis2";"SILVA (only NR);Eukaryota;SAR;Rhizaria;Cercozoa;Imbricatea;Silicofilosea;Euglyphida;Trinematidae;Trinema;";"0.0";"0";"23";"23";"0";"23";"0";"457160";"391207"
"V4mis2";"SILVA (only NR);Eukaryota;SAR;Rhizaria;Cercozoa;Imbricatea;Silicofilosea;Euglyphida;Trinematidae;uncultured;";"0.0";"0";"5";"5";"0";"5";"0";"457178";"391207"
"V4mis2";"SILVA (only NR);Eukaryota;SAR;Rhizaria;Cercozoa;Imbricatea;Silicofilosea;Euglyphida;uncultured;";"0.0";"0";"8";"8";"0";"8";"0";"457175";"391207"
"V4mis2";"SILVA (only NR);Eukaryota;SAR;Rhizaria;Cercozoa;Imbricatea;Silicofilosea;Thaumatomonadida;";"0.0";"0";"52";"51";"0";"51";"1";"457132";"391207"
"V4mis2";"SILVA (only NR);Eukaryota;SAR;Rhizaria;Cercozoa;Imbricatea;Silicofilosea;Thaumatomonadida;Peregriniidae;";"0.0";"0";"18";"18";"0";"18";"0";"457165";"391207"
"V4mis2";"SILVA (only NR);Eukaryota;SAR;Rhizaria;Cercozoa;Imbricatea;Silicofilosea;Thaumatomonadida;Peregriniidae;CCe;";"0.0";"0";"2";"2";"0";"2";"0";"457181";"391207"
"V4mis2";"SILVA (only NR);Eukaryota;SAR;Rhizaria;Cercozoa;Imbricatea;Silicofilosea;Thaumatomonadida;Peregriniidae;D2P04A09;";"0.0";"0";"6";"6";"0";"6";"0";"457177";"391207"
"V4mis2";"SILVA (only NR);Eukaryota;SAR;Rhizaria;Cercozoa;Imbricatea;Silicofilosea;Thaumatomonadida;Peregriniidae;Esquamula;";"0.0";"0";"1";"1";"0";"1";"0";"457182";"391207"
"V4mis2";"SILVA (only NR);Eukaryota;SAR;Rhizaria;Cercozoa;Imbricatea;Silicofilosea;Thaumatomonadida;Peregriniidae;Gyromitus;";"0.0";"0";"5";"5";"0";"5";"0";"457178";"391207"
"V4mis2";"SILVA (only NR);Eukaryota;SAR;Rhizaria;Cercozoa;Imbricatea;Silicofilosea;Thaumatomonadida;Thaumatomonadidae;";"0.0";"0";"34";"33";"0";"33";"1";"457150";"391207"
"V4mis2";"SILVA (only NR);Eukaryota;SAR;Rhizaria;Cercozoa;Imbricatea;Silicofilosea;Thaumatomonadida;Thaumatomonadidae;Allas;";"0.0";"0";"5";"4";"0";"4";"1";"457179";"391207"
"V4mis2";"SILVA (only NR);Eukaryota;SAR;Rhizaria;Cercozoa;Imbricatea;Silicofilosea;Thaumatomonadida;Thaumatomonadidae;Thaumatomastix;";"0.0";"0";"7";"7";"0";"7";"0";"457176";"391207"
"V4mis2";"SILVA (only NR);Eukaryota;SAR;Rhizaria;Cercozoa;Imbricatea;Silicofilosea;Thaumatomonadida;Thaumatomonadidae;Thaumatomonas;";"0.0";"0";"5";"5";"0";"5";"0";"457178";"391207"
"V4mis2";"SILVA (only NR);Eukaryota;SAR;Rhizaria;Cercozoa;Imbricatea;Silicofilosea;Thaumatomonadida;Thaumatomonadidae;uncultured;";"0.0";"0";"10";"10";"0";"10";"0";"457173";"391207"
"V4mis2";"SILVA (only NR);Eukaryota;SAR;Rhizaria;Cercozoa;Imbricatea;Spongomonadida;";"0.0";"0";"6";"6";"0";"6";"0";"457177";"391207"
"V4mis2";"SILVA (only NR);Eukaryota;SAR;Rhizaria;Cercozoa;Imbricatea;Spongomonadida;Spongomonas;";"0.0";"0";"6";"6";"0";"6";"0";"457177";"391207"
"V4mis2";"SILVA (only NR);Eukaryota;SAR;Rhizaria;Cercozoa;Incertae Sedis;";"16.3";"14.4";"49";"49";"8";"41";"0";"457134";"391199"
"V4mis2";"SILVA (only NR);Eukaryota;SAR;Rhizaria;Cercozoa;Incertae Sedis;Cholamonas;";"0.0";"0";"1";"1";"0";"1";"0";"457182";"391207"
"V4mis2";"SILVA (only NR);Eukaryota;SAR;Rhizaria;Cercozoa;Incertae Sedis;Gymnophrys;";"0.0";"0";"24";"24";"0";"24";"0";"457159";"391207"
"V4mis2";"SILVA (only NR);Eukaryota;SAR;Rhizaria;Cercozoa;Incertae Sedis;Kraken;";"9.1";"14.4";"11";"11";"1";"10";"0";"457172";"391206"
"V4mis2";"SILVA (only NR);Eukaryota;SAR;Rhizaria;Cercozoa;Incertae Sedis;Metromonas;";"0.0";"0";"1";"1";"0";"1";"0";"457182";"391207"
"V4mis2";"SILVA (only NR);Eukaryota;SAR;Rhizaria;Cercozoa;Incertae Sedis;Reticulamoeba;";"100.0";"14.4";"7";"7";"7";"0";"0";"457176";"391200"
"V4mis2";"SILVA (only NR);Eukaryota;SAR;Rhizaria;Cercozoa;Incertae Sedis;Sainouron;";"0.0";"0";"1";"1";"0";"1";"0";"457182";"391207"
"V4mis2";"SILVA (only NR);Eukaryota;SAR;Rhizaria;Cercozoa;Incertae Sedis;Trachyrhizium;";"0.0";"0";"1";"1";"0";"1";"0";"457182";"391207"
"V4mis2";"SILVA (only NR);Eukaryota;SAR;Rhizaria;Cercozoa;Metromonadea;";"0.0";"0";"6";"3";"0";"3";"3";"457180";"391207"
"V4mis2";"SILVA (only NR);Eukaryota;SAR;Rhizaria;Cercozoa;Metromonadea;Metopion;";"0.0";"0";"2";"1";"0";"1";"1";"457182";"391207"
"V4mis2";"SILVA (only NR);Eukaryota;SAR;Rhizaria;Cercozoa;Metromonadea;Micrometopion;";"0.0";"0";"4";"2";"0";"2";"2";"457181";"391207"
"V4mis2";"SILVA (only NR);Eukaryota;SAR;Rhizaria;Cercozoa;Novel Clade 10;";"0.0";"0";"29";"29";"0";"29";"0";"457154";"391207"
"V4mis2";"SILVA (only NR);Eukaryota;SAR;Rhizaria;Cercozoa;Novel Clade 12;";"41.7";"14.4";"13";"12";"5";"7";"1";"457171";"391202"
"V4mis2";"SILVA (only NR);Eukaryota;SAR;Rhizaria;Cercozoa;Novel Clade 2;";"0.0";"0";"31";"31";"0";"31";"0";"457152";"391207"
"V4mis2";"SILVA (only NR);Eukaryota;SAR;Rhizaria;Cercozoa;Novel Clade 4;";"0.0";"0";"2";"2";"0";"2";"0";"457181";"391207"
"V4mis2";"SILVA (only NR);Eukaryota;SAR;Rhizaria;Cercozoa;Novel Clade Gran-1;";"0.0";"0";"4";"4";"0";"4";"0";"457179";"391207"
"V4mis2";"SILVA (only NR);Eukaryota;SAR;Rhizaria;Cercozoa;Novel Clade Gran-3;";"12.5";"14.4";"18";"16";"2";"14";"2";"457167";"391205"
"V4mis2";"SILVA (only NR);Eukaryota;SAR;Rhizaria;Cercozoa;Novel Clade Gran-4;";"57.1";"14.4";"8";"7";"4";"3";"1";"457176";"391203"
"V4mis2";"SILVA (only NR);Eukaryota;SAR;Rhizaria;Cercozoa;Novel Clade Gran-5;";"0.0";"0";"3";"3";"0";"3";"0";"457180";"391207"
"V4mis2";"SILVA (only NR);Eukaryota;SAR;Rhizaria;Cercozoa;Novel Clade Gran-6;";"0.0";"0";"2";"2";"0";"2";"0";"457181";"391207"
"V4mis2";"SILVA (only NR);Eukaryota;SAR;Rhizaria;Cercozoa;Pansomonadida;";"0.0";"0";"1";"1";"0";"1";"0";"457182";"391207"
"V4mis2";"SILVA (only NR);Eukaryota;SAR;Rhizaria;Cercozoa;Pansomonadida;Aurigamonas;";"0.0";"0";"1";"1";"0";"1";"0";"457182";"391207"
"V4mis2";"SILVA (only NR);Eukaryota;SAR;Rhizaria;Cercozoa;Phaeocalpida;";"100.0";"14.4";"2";"2";"2";"0";"0";"457181";"391205"
"V4mis2";"SILVA (only NR);Eukaryota;SAR;Rhizaria;Cercozoa;Phaeocalpida;Porospathis;";"100.0";"14.4";"1";"1";"1";"0";"0";"457182";"391206"
"V4mis2";"SILVA (only NR);Eukaryota;SAR;Rhizaria;Cercozoa;Phaeocalpida;Tuscaretta;";"100.0";"14.4";"1";"1";"1";"0";"0";"457182";"391206"
"V4mis2";"SILVA (only NR);Eukaryota;SAR;Rhizaria;Cercozoa;Phaeoconchia;";"100.0";"14.4";"4";"4";"4";"0";"0";"457179";"391203"
"V4mis2";"SILVA (only NR);Eukaryota;SAR;Rhizaria;Cercozoa;Phaeoconchia;Coelodendrum;";"100.0";"14.4";"2";"2";"2";"0";"0";"457181";"391205"
"V4mis2";"SILVA (only NR);Eukaryota;SAR;Rhizaria;Cercozoa;Phaeocystina;";"100.0";"14.4";"3";"3";"3";"0";"0";"457180";"391204"
"V4mis2";"SILVA (only NR);Eukaryota;SAR;Rhizaria;Cercozoa;Phaeocystina;Aulacantha;";"100.0";"14.4";"2";"2";"2";"0";"0";"457181";"391205"
"V4mis2";"SILVA (only NR);Eukaryota;SAR;Rhizaria;Cercozoa;Phaeocystina;Auloceros;";"100.0";"14.4";"1";"1";"1";"0";"0";"457182";"391206"
"V4mis2";"SILVA (only NR);Eukaryota;SAR;Rhizaria;Cercozoa;Phaeogromia;";"83.3";"14.4";"6";"6";"5";"1";"0";"457177";"391202"
"V4mis2";"SILVA (only NR);Eukaryota;SAR;Rhizaria;Cercozoa;Phaeogromia;Challengeron;";"50.0";"14.4";"2";"2";"1";"1";"0";"457181";"391206"
"V4mis2";"SILVA (only NR);Eukaryota;SAR;Rhizaria;Cercozoa;Phaeogromia;Medusetta;";"100.0";"14.4";"1";"1";"1";"0";"0";"457182";"391206"
"V4mis2";"SILVA (only NR);Eukaryota;SAR;Rhizaria;Cercozoa;Phaeogromia;Protocystis;";"100.0";"14.4";"2";"2";"2";"0";"0";"457181";"391205"
"V4mis2";"SILVA (only NR);Eukaryota;SAR;Rhizaria;Cercozoa;Phytomyxea;";"0.0";"0";"49";"49";"0";"49";"0";"457134";"391207"
"V4mis2";"SILVA (only NR);Eukaryota;SAR;Rhizaria;Cercozoa;Phytomyxea;Ligniera;";"0.0";"0";"1";"1";"0";"1";"0";"457182";"391207"
"V4mis2";"SILVA (only NR);Eukaryota;SAR;Rhizaria;Cercozoa;Phytomyxea;Maullinia;";"0.0";"0";"4";"4";"0";"4";"0";"457179";"391207"
"V4mis2";"SILVA (only NR);Eukaryota;SAR;Rhizaria;Cercozoa;Phytomyxea;Phagomyxa;";"0.0";"0";"2";"2";"0";"2";"0";"457181";"391207"
"V4mis2";"SILVA (only NR);Eukaryota;SAR;Rhizaria;Cercozoa;Phytomyxea;Plasmodiophora;";"0.0";"0";"4";"4";"0";"4";"0";"457179";"391207"
"V4mis2";"SILVA (only NR);Eukaryota;SAR;Rhizaria;Cercozoa;Phytomyxea;Polymyxa;";"0.0";"0";"15";"15";"0";"15";"0";"457168";"391207"
"V4mis2";"SILVA (only NR);Eukaryota;SAR;Rhizaria;Cercozoa;Phytomyxea;Sorosphaerula;";"0.0";"0";"2";"2";"0";"2";"0";"457181";"391207"
"V4mis2";"SILVA (only NR);Eukaryota;SAR;Rhizaria;Cercozoa;Phytomyxea;Spongospora;";"0.0";"0";"3";"3";"0";"3";"0";"457180";"391207"
"V4mis2";"SILVA (only NR);Eukaryota;SAR;Rhizaria;Cercozoa;Phytomyxea;Woronina;";"0.0";"0";"2";"2";"0";"2";"0";"457181";"391207"
"V4mis2";"SILVA (only NR);Eukaryota;SAR;Rhizaria;Cercozoa;Phytomyxea;uncultured;";"0.0";"0";"9";"9";"0";"9";"0";"457174";"391207"
"V4mis2";"SILVA (only NR);Eukaryota;SAR;Rhizaria;Cercozoa;Thecofilosea;";"7.8";"14.4";"246";"244";"19";"225";"2";"456939";"391188"
"V4mis2";"SILVA (only NR);Eukaryota;SAR;Rhizaria;Cercozoa;Thecofilosea;Cryomonadida;";"1.2";"14.4";"83";"83";"1";"82";"0";"457100";"391206"
"V4mis2";"SILVA (only NR);Eukaryota;SAR;Rhizaria;Cercozoa;Thecofilosea;Cryomonadida;Protaspidae;";"2.4";"14.4";"41";"41";"1";"40";"0";"457142";"391206"
"V4mis2";"SILVA (only NR);Eukaryota;SAR;Rhizaria;Cercozoa;Thecofilosea;Cryomonadida;Protaspidae;Cryothecomonas;";"0.0";"0";"15";"15";"0";"15";"0";"457168";"391207"
"V4mis2";"SILVA (only NR);Eukaryota;SAR;Rhizaria;Cercozoa;Thecofilosea;Cryomonadida;Protaspidae;Protaspis;";"3.8";"14.4";"26";"26";"1";"25";"0";"457157";"391206"
"V4mis2";"SILVA (only NR);Eukaryota;SAR;Rhizaria;Cercozoa;Thecofilosea;Cryomonadida;Rhizaspididae;";"0.0";"0";"32";"32";"0";"32";"0";"457151";"391207"
"V4mis2";"SILVA (only NR);Eukaryota;SAR;Rhizaria;Cercozoa;Thecofilosea;Cryomonadida;Rhizaspididae;Rhogostoma;";"0.0";"0";"32";"32";"0";"32";"0";"457151";"391207"
"V4mis2";"SILVA (only NR);Eukaryota;SAR;Rhizaria;Cercozoa;Thecofilosea;Cryomonadida;Ventrifissuridae;";"0.0";"0";"10";"10";"0";"10";"0";"457173";"391207"
"V4mis2";"SILVA (only NR);Eukaryota;SAR;Rhizaria;Cercozoa;Thecofilosea;Cryomonadida;Ventrifissuridae;Ventrifissura;";"0.0";"0";"3";"3";"0";"3";"0";"457180";"391207"
"V4mis2";"SILVA (only NR);Eukaryota;SAR;Rhizaria;Cercozoa;Thecofilosea;Ebriacea;";"9.5";"14.4";"21";"21";"2";"19";"0";"457162";"391205"
"V4mis2";"SILVA (only NR);Eukaryota;SAR;Rhizaria;Cercozoa;Thecofilosea;Ebriacea;Ebria;";"9.5";"14.4";"21";"21";"2";"19";"0";"457162";"391205"
"V4mis2";"SILVA (only NR);Eukaryota;SAR;Rhizaria;Cercozoa;Thecofilosea;Incertae Sedis;";"0.0";"0";"12";"12";"0";"12";"0";"457171";"391207"
"V4mis2";"SILVA (only NR);Eukaryota;SAR;Rhizaria;Cercozoa;Thecofilosea;Incertae Sedis;Lecythium;";"0.0";"0";"10";"10";"0";"10";"0";"457173";"391207"
"V4mis2";"SILVA (only NR);Eukaryota;SAR;Rhizaria;Cercozoa;Thecofilosea;Incertae Sedis;Pseudodifflugia;";"0.0";"0";"2";"2";"0";"2";"0";"457181";"391207"
"V4mis2";"SILVA (only NR);Eukaryota;SAR;Rhizaria;Cercozoa;Thecofilosea;Phaeosphaerida;";"100.0";"14.4";"3";"3";"3";"0";"0";"457180";"391204"
"V4mis2";"SILVA (only NR);Eukaryota;SAR;Rhizaria;Cercozoa;Thecofilosea;Phaeosphaerida;Aulosphaera;";"100.0";"14.4";"3";"3";"3";"0";"0";"457180";"391204"
"V4mis2";"SILVA (only NR);Eukaryota;SAR;Rhizaria;Cercozoa;Thecofilosea;uncultured;";"11.4";"14.4";"116";"114";"13";"101";"2";"457069";"391194"
"V4mis2";"SILVA (only NR);Eukaryota;SAR;Rhizaria;Cercozoa;Vampyrellidae;";"4.6";"14.4";"87";"87";"4";"83";"0";"457096";"391203"
"V4mis2";"SILVA (only NR);Eukaryota;SAR;Rhizaria;Cercozoa;Vampyrellidae;Arachnula;";"0.0";"0";"1";"1";"0";"1";"0";"457182";"391207"
"V4mis2";"SILVA (only NR);Eukaryota;SAR;Rhizaria;Cercozoa;Vampyrellidae;Leptophrys;";"0.0";"0";"3";"3";"0";"3";"0";"457180";"391207"
"V4mis2";"SILVA (only NR);Eukaryota;SAR;Rhizaria;Cercozoa;Vampyrellidae;Vampyrella;";"0.0";"0";"3";"3";"0";"3";"0";"457180";"391207"
"V4mis2";"SILVA (only NR);Eukaryota;SAR;Rhizaria;Cercozoa;Vampyrellidae;uncultured;";"12.9";"14.4";"31";"31";"4";"27";"0";"457152";"391203"
"V4mis2";"SILVA (only NR);Eukaryota;SAR;Rhizaria;Cercozoa;uncultured;";"8.8";"14.4";"127";"114";"10";"104";"13";"457069";"391197"
"V4mis2";"SILVA (only NR);Eukaryota;SAR;Rhizaria;Retaria;";"6.1";"14.3";"1148";"961";"59";"902";"187";"456222";"391148"
"V4mis2";"SILVA (only NR);Eukaryota;SAR;Rhizaria;Retaria;Acantharia;";"0.9";"14.4";"120";"116";"1";"115";"4";"457067";"391206"
"V4mis2";"SILVA (only NR);Eukaryota;SAR;Rhizaria;Retaria;Acantharia;Acantharea Group I;";"2.8";"14.4";"36";"36";"1";"35";"0";"457147";"391206"
"V4mis2";"SILVA (only NR);Eukaryota;SAR;Rhizaria;Retaria;Acantharia;Acantharea Group II;";"0.0";"0";"11";"11";"0";"11";"0";"457172";"391207"
"V4mis2";"SILVA (only NR);Eukaryota;SAR;Rhizaria;Retaria;Acantharia;Acantharea Group VI;";"0.0";"0";"7";"7";"0";"7";"0";"457176";"391207"
"V4mis2";"SILVA (only NR);Eukaryota;SAR;Rhizaria;Retaria;Acantharia;Arthracanthida;";"0.0";"0";"21";"20";"0";"20";"1";"457163";"391207"
"V4mis2";"SILVA (only NR);Eukaryota;SAR;Rhizaria;Retaria;Acantharia;Arthracanthida;Acanthostaurus;";"0.0";"0";"1";"1";"0";"1";"0";"457182";"391207"
"V4mis2";"SILVA (only NR);Eukaryota;SAR;Rhizaria;Retaria;Acantharia;Arthracanthida;Amphilonche;";"0.0";"0";"1";"1";"0";"1";"0";"457182";"391207"
"V4mis2";"SILVA (only NR);Eukaryota;SAR;Rhizaria;Retaria;Acantharia;Arthracanthida;Hexaconus;";"0.0";"0";"3";"3";"0";"3";"0";"457180";"391207"
"V4mis2";"SILVA (only NR);Eukaryota;SAR;Rhizaria;Retaria;Acantharia;Arthracanthida;Phyllostaurus;";"0.0";"0";"6";"5";"0";"5";"1";"457178";"391207"
"V4mis2";"SILVA (only NR);Eukaryota;SAR;Rhizaria;Retaria;Acantharia;Arthracanthida;uncultured;";"0.0";"0";"4";"4";"0";"4";"0";"457179";"391207"
"V4mis2";"SILVA (only NR);Eukaryota;SAR;Rhizaria;Retaria;Acantharia;Chaunocanthida;";"0.0";"0";"22";"20";"0";"20";"2";"457163";"391207"
"V4mis2";"SILVA (only NR);Eukaryota;SAR;Rhizaria;Retaria;Acantharia;Chaunocanthida;Acanthocyrta;";"0.0";"0";"1";"1";"0";"1";"0";"457182";"391207"
"V4mis2";"SILVA (only NR);Eukaryota;SAR;Rhizaria;Retaria;Acantharia;Chaunocanthida;Amphiacon;";"0.0";"0";"3";"3";"0";"3";"0";"457180";"391207"
"V4mis2";"SILVA (only NR);Eukaryota;SAR;Rhizaria;Retaria;Acantharia;Chaunocanthida;Heteracon;";"0.0";"0";"1";"1";"0";"1";"0";"457182";"391207"
"V4mis2";"SILVA (only NR);Eukaryota;SAR;Rhizaria;Retaria;Acantharia;Holocanthida;";"0.0";"0";"4";"4";"0";"4";"0";"457179";"391207"
"V4mis2";"SILVA (only NR);Eukaryota;SAR;Rhizaria;Retaria;Acantharia;Holocanthida;Acanthocolla;";"0.0";"0";"1";"1";"0";"1";"0";"457182";"391207"
"V4mis2";"SILVA (only NR);Eukaryota;SAR;Rhizaria;Retaria;Acantharia;Holocanthida;Trizona;";"0.0";"0";"1";"1";"0";"1";"0";"457182";"391207"
"V4mis2";"SILVA (only NR);Eukaryota;SAR;Rhizaria;Retaria;Acantharia;SSRPB68;";"0.0";"0";"7";"6";"0";"6";"1";"457177";"391207"
"V4mis2";"SILVA (only NR);Eukaryota;SAR;Rhizaria;Retaria;Acantharia;Symphyacanthida;";"0.0";"0";"2";"2";"0";"2";"0";"457181";"391207"
"V4mis2";"SILVA (only NR);Eukaryota;SAR;Rhizaria;Retaria;Acantharia;Symphyacanthida;Amphibelone;";"0.0";"0";"2";"2";"0";"2";"0";"457181";"391207"
"V4mis2";"SILVA (only NR);Eukaryota;SAR;Rhizaria;Retaria;Acantharia;uncultured;";"0.0";"0";"4";"4";"0";"4";"0";"457179";"391207"
"V4mis2";"SILVA (only NR);Eukaryota;SAR;Rhizaria;Retaria;Foraminifera;";"78.1";"14.4";"67";"64";"50";"14";"3";"457119";"391157"
"V4mis2";"SILVA (only NR);Eukaryota;SAR;Rhizaria;Retaria;Foraminifera;Globothalamea;";"73.5";"14.4";"37";"34";"25";"9";"3";"457149";"391182"
"V4mis2";"SILVA (only NR);Eukaryota;SAR;Rhizaria;Retaria;Foraminifera;Globothalamea;Rotaliida;";"73.5";"14.4";"37";"34";"25";"9";"3";"457149";"391182"
"V4mis2";"SILVA (only NR);Eukaryota;SAR;Rhizaria;Retaria;Foraminifera;Globothalamea;Rotaliida;Alabaminidae;";"0.0";"0";"1";"1";"0";"1";"0";"457182";"391207"
"V4mis2";"SILVA (only NR);Eukaryota;SAR;Rhizaria;Retaria;Foraminifera;Globothalamea;Rotaliida;Alabaminidae;Oridorsalis;";"0.0";"0";"1";"1";"0";"1";"0";"457182";"391207"
"V4mis2";"SILVA (only NR);Eukaryota;SAR;Rhizaria;Retaria;Foraminifera;Globothalamea;Rotaliida;Buliminidae;";"100.0";"14.4";"2";"1";"1";"0";"1";"457182";"391206"
"V4mis2";"SILVA (only NR);Eukaryota;SAR;Rhizaria;Retaria;Foraminifera;Globothalamea;Rotaliida;Buliminidae;Bulimina;";"100.0";"14.4";"1";"1";"1";"0";"0";"457182";"391206"
"V4mis2";"SILVA (only NR);Eukaryota;SAR;Rhizaria;Retaria;Foraminifera;Globothalamea;Rotaliida;Buliminidae;Globobulimina;";"0.0";"0";"1";"0";"0";"0";"1";"457183";"391207"
"V4mis2";"SILVA (only NR);Eukaryota;SAR;Rhizaria;Retaria;Foraminifera;Globothalamea;Rotaliida;Calcarinidae;";"100.0";"14.4";"3";"3";"3";"0";"0";"457180";"391204"
"V4mis2";"SILVA (only NR);Eukaryota;SAR;Rhizaria;Retaria;Foraminifera;Globothalamea;Rotaliida;Calcarinidae;Calcarina;";"100.0";"14.4";"2";"2";"2";"0";"0";"457181";"391205"
"V4mis2";"SILVA (only NR);Eukaryota;SAR;Rhizaria;Retaria;Foraminifera;Globothalamea;Rotaliida;Calcarinidae;Schlumbergerella;";"100.0";"14.4";"1";"1";"1";"0";"0";"457182";"391206"
"V4mis2";"SILVA (only NR);Eukaryota;SAR;Rhizaria;Retaria;Foraminifera;Globothalamea;Rotaliida;Cibicididae;";"0.0";"0";"5";"4";"0";"4";"1";"457179";"391207"
"V4mis2";"SILVA (only NR);Eukaryota;SAR;Rhizaria;Retaria;Foraminifera;Globothalamea;Rotaliida;Cibicididae;Cibicides;";"0.0";"0";"2";"1";"0";"1";"1";"457182";"391207"
"V4mis2";"SILVA (only NR);Eukaryota;SAR;Rhizaria;Retaria;Foraminifera;Globothalamea;Rotaliida;Cibicididae;Cibicidoides;";"0.0";"0";"3";"3";"0";"3";"0";"457180";"391207"
"V4mis2";"SILVA (only NR);Eukaryota;SAR;Rhizaria;Retaria;Foraminifera;Globothalamea;Rotaliida;Elphidiidae;";"100.0";"14.4";"4";"3";"3";"0";"1";"457180";"391204"
"V4mis2";"SILVA (only NR);Eukaryota;SAR;Rhizaria;Retaria;Foraminifera;Globothalamea;Rotaliida;Elphidiidae;Elphidium;";"100.0";"14.4";"4";"3";"3";"0";"1";"457180";"391204"
"V4mis2";"SILVA (only NR);Eukaryota;SAR;Rhizaria;Retaria;Foraminifera;Globothalamea;Rotaliida;Nonionidae;";"66.7";"14.4";"3";"3";"2";"1";"0";"457180";"391205"
"V4mis2";"SILVA (only NR);Eukaryota;SAR;Rhizaria;Retaria;Foraminifera;Globothalamea;Rotaliida;Nonionidae;Haynesina;";"0.0";"0";"1";"1";"0";"1";"0";"457182";"391207"
"V4mis2";"SILVA (only NR);Eukaryota;SAR;Rhizaria;Retaria;Foraminifera;Globothalamea;Rotaliida;Nonionidae;Pullenia;";"100.0";"14.4";"2";"2";"2";"0";"0";"457181";"391205"
"V4mis2";"SILVA (only NR);Eukaryota;SAR;Rhizaria;Retaria;Foraminifera;Globothalamea;Rotaliida;Nummulitidae;";"100.0";"14.4";"9";"9";"9";"0";"0";"457174";"391198"
"V4mis2";"SILVA (only NR);Eukaryota;SAR;Rhizaria;Retaria;Foraminifera;Globothalamea;Rotaliida;Nummulitidae;Cycloclypeus;";"100.0";"14.4";"1";"1";"1";"0";"0";"457182";"391206"
"V4mis2";"SILVA (only NR);Eukaryota;SAR;Rhizaria;Retaria;Foraminifera;Globothalamea;Rotaliida;Nummulitidae;Heterostegina;";"100.0";"14.4";"1";"1";"1";"0";"0";"457182";"391206"
"V4mis2";"SILVA (only NR);Eukaryota;SAR;Rhizaria;Retaria;Foraminifera;Globothalamea;Rotaliida;Nummulitidae;Nummulites;";"100.0";"14.4";"1";"1";"1";"0";"0";"457182";"391206"
"V4mis2";"SILVA (only NR);Eukaryota;SAR;Rhizaria;Retaria;Foraminifera;Globothalamea;Rotaliida;Nummulitidae;Operculina;";"100.0";"14.4";"5";"5";"5";"0";"0";"457178";"391202"
"V4mis2";"SILVA (only NR);Eukaryota;SAR;Rhizaria;Retaria;Foraminifera;Globothalamea;Rotaliida;Nummulitidae;Planoperculina;";"100.0";"14.4";"1";"1";"1";"0";"0";"457182";"391206"
"V4mis2";"SILVA (only NR);Eukaryota;SAR;Rhizaria;Retaria;Foraminifera;Globothalamea;Rotaliida;Pseudoparrellidae;";"50.0";"14.4";"2";"2";"1";"1";"0";"457181";"391206"
"V4mis2";"SILVA (only NR);Eukaryota;SAR;Rhizaria;Retaria;Foraminifera;Globothalamea;Rotaliida;Pseudoparrellidae;Epistominella;";"50.0";"14.4";"2";"2";"1";"1";"0";"457181";"391206"
"V4mis2";"SILVA (only NR);Eukaryota;SAR;Rhizaria;Retaria;Foraminifera;Globothalamea;Rotaliida;Rotaliidae;";"33.3";"14.4";"3";"3";"1";"2";"0";"457180";"391206"
"V4mis2";"SILVA (only NR);Eukaryota;SAR;Rhizaria;Retaria;Foraminifera;Globothalamea;Rotaliida;Rotaliidae;Ammonia;";"50.0";"14.4";"2";"2";"1";"1";"0";"457181";"391206"
"V4mis2";"SILVA (only NR);Eukaryota;SAR;Rhizaria;Retaria;Foraminifera;Globothalamea;Rotaliida;Rotaliidae;Pararotalia;";"0.0";"0";"1";"1";"0";"1";"0";"457182";"391207"
"V4mis2";"SILVA (only NR);Eukaryota;SAR;Rhizaria;Retaria;Foraminifera;Globothalamea;Rotaliida;Stainforthiidae;";"100.0";"14.4";"2";"2";"2";"0";"0";"457181";"391205"
"V4mis2";"SILVA (only NR);Eukaryota;SAR;Rhizaria;Retaria;Foraminifera;Globothalamea;Rotaliida;Stainforthiidae;Stainforthia;";"100.0";"14.4";"2";"2";"2";"0";"0";"457181";"391205"
"V4mis2";"SILVA (only NR);Eukaryota;SAR;Rhizaria;Retaria;Foraminifera;Tubothalamea;";"83.3";"14.4";"30";"30";"25";"5";"0";"457153";"391182"
"V4mis2";"SILVA (only NR);Eukaryota;SAR;Rhizaria;Retaria;Foraminifera;Tubothalamea;Miliolida;";"83.3";"14.4";"30";"30";"25";"5";"0";"457153";"391182"
"V4mis2";"SILVA (only NR);Eukaryota;SAR;Rhizaria;Retaria;Foraminifera;Tubothalamea;Miliolida;Amphisorus;";"100.0";"14.4";"6";"6";"6";"0";"0";"457177";"391201"
"V4mis2";"SILVA (only NR);Eukaryota;SAR;Rhizaria;Retaria;Foraminifera;Tubothalamea;Miliolida;Androsina;";"0.0";"0";"1";"1";"0";"1";"0";"457182";"391207"
"V4mis2";"SILVA (only NR);Eukaryota;SAR;Rhizaria;Retaria;Foraminifera;Tubothalamea;Miliolida;Archaias;";"50.0";"14.4";"2";"2";"1";"1";"0";"457181";"391206"
"V4mis2";"SILVA (only NR);Eukaryota;SAR;Rhizaria;Retaria;Foraminifera;Tubothalamea;Miliolida;Cyclorbiculina;";"100.0";"14.4";"1";"1";"1";"0";"0";"457182";"391206"
"V4mis2";"SILVA (only NR);Eukaryota;SAR;Rhizaria;Retaria;Foraminifera;Tubothalamea;Miliolida;Dendritina;";"100.0";"14.4";"1";"1";"1";"0";"0";"457182";"391206"
"V4mis2";"SILVA (only NR);Eukaryota;SAR;Rhizaria;Retaria;Foraminifera;Tubothalamea;Miliolida;Laevipeneroplis;";"66.7";"14.4";"3";"3";"2";"1";"0";"457180";"391205"
"V4mis2";"SILVA (only NR);Eukaryota;SAR;Rhizaria;Retaria;Foraminifera;Tubothalamea;Miliolida;Marginopora;";"100.0";"14.4";"4";"4";"4";"0";"0";"457179";"391203"
"V4mis2";"SILVA (only NR);Eukaryota;SAR;Rhizaria;Retaria;Foraminifera;Tubothalamea;Miliolida;Sorites;";"87.5";"14.4";"8";"8";"7";"1";"0";"457175";"391200"
"V4mis2";"SILVA (only NR);Eukaryota;SAR;Rhizaria;Retaria;Polycystinea;";"0.9";"14.3";"713";"551";"5";"546";"162";"456632";"391202"
"V4mis2";"SILVA (only NR);Eukaryota;SAR;Rhizaria;Retaria;Polycystinea;Collodaria;";"5.5";"14.4";"71";"55";"3";"52";"16";"457128";"391204"
"V4mis2";"SILVA (only NR);Eukaryota;SAR;Rhizaria;Retaria;Polycystinea;Collodaria;AT8-54;";"14.3";"14.4";"15";"7";"1";"6";"8";"457176";"391206"
"V4mis2";"SILVA (only NR);Eukaryota;SAR;Rhizaria;Retaria;Polycystinea;Collodaria;Collophidium;";"40.0";"14.4";"8";"5";"2";"3";"3";"457178";"391205"
"V4mis2";"SILVA (only NR);Eukaryota;SAR;Rhizaria;Retaria;Polycystinea;Collodaria;Collosphaera;";"0.0";"0";"6";"6";"0";"6";"0";"457177";"391207"
"V4mis2";"SILVA (only NR);Eukaryota;SAR;Rhizaria;Retaria;Polycystinea;Collodaria;Collozoum;";"0.0";"0";"9";"9";"0";"9";"0";"457174";"391207"
"V4mis2";"SILVA (only NR);Eukaryota;SAR;Rhizaria;Retaria;Polycystinea;Collodaria;Disolenia;";"0.0";"0";"3";"3";"0";"3";"0";"457180";"391207"
"V4mis2";"SILVA (only NR);Eukaryota;SAR;Rhizaria;Retaria;Polycystinea;Collodaria;E84;";"0.0";"0";"4";"1";"0";"1";"3";"457182";"391207"
"V4mis2";"SILVA (only NR);Eukaryota;SAR;Rhizaria;Retaria;Polycystinea;Collodaria;Rhaphidozoum;";"0.0";"0";"2";"2";"0";"2";"0";"457181";"391207"
"V4mis2";"SILVA (only NR);Eukaryota;SAR;Rhizaria;Retaria;Polycystinea;Collodaria;Siphonosphaera;";"0.0";"0";"6";"5";"0";"5";"1";"457178";"391207"
"V4mis2";"SILVA (only NR);Eukaryota;SAR;Rhizaria;Retaria;Polycystinea;Collodaria;Sphaerozoum;";"0.0";"0";"3";"3";"0";"3";"0";"457180";"391207"
"V4mis2";"SILVA (only NR);Eukaryota;SAR;Rhizaria;Retaria;Polycystinea;Collodaria;Thalassicolla;";"0.0";"0";"4";"4";"0";"4";"0";"457179";"391207"
"V4mis2";"SILVA (only NR);Eukaryota;SAR;Rhizaria;Retaria;Polycystinea;Nassellaria;";"0.0";"0";"40";"38";"0";"38";"2";"457145";"391207"
"V4mis2";"SILVA (only NR);Eukaryota;SAR;Rhizaria;Retaria;Polycystinea;Nassellaria;Asp-05;";"0.0";"0";"2";"2";"0";"2";"0";"457181";"391207"
"V4mis2";"SILVA (only NR);Eukaryota;SAR;Rhizaria;Retaria;Polycystinea;Nassellaria;Ceratospyris;";"0.0";"0";"10";"9";"0";"9";"1";"457174";"391207"
"V4mis2";"SILVA (only NR);Eukaryota;SAR;Rhizaria;Retaria;Polycystinea;Nassellaria;Eucyrtidium;";"0.0";"0";"3";"3";"0";"3";"0";"457180";"391207"
"V4mis2";"SILVA (only NR);Eukaryota;SAR;Rhizaria;Retaria;Polycystinea;Nassellaria;Pseudocubus;";"0.0";"0";"15";"14";"0";"14";"1";"457169";"391207"
"V4mis2";"SILVA (only NR);Eukaryota;SAR;Rhizaria;Retaria;Polycystinea;Nassellaria;Pterocanium;";"0.0";"0";"1";"1";"0";"1";"0";"457182";"391207"
"V4mis2";"SILVA (only NR);Eukaryota;SAR;Rhizaria;Retaria;Polycystinea;Nassellaria;Pterocorys;";"0.0";"0";"4";"4";"0";"4";"0";"457179";"391207"
"V4mis2";"SILVA (only NR);Eukaryota;SAR;Rhizaria;Retaria;Polycystinea;Spumellaria;";"0.4";"14.3";"598";"454";"2";"452";"144";"456729";"391205"
"V4mis2";"SILVA (only NR);Eukaryota;SAR;Rhizaria;Retaria;Polycystinea;Spumellaria;Actinomma;";"14.3";"14.4";"8";"7";"1";"6";"1";"457176";"391206"
"V4mis2";"SILVA (only NR);Eukaryota;SAR;Rhizaria;Retaria;Polycystinea;Spumellaria;Astrosphaera;";"0.0";"0";"17";"17";"0";"17";"0";"457166";"391207"
"V4mis2";"SILVA (only NR);Eukaryota;SAR;Rhizaria;Retaria;Polycystinea;Spumellaria;Cladococcus;";"0.0";"0";"111";"110";"0";"110";"1";"457073";"391207"
"V4mis2";"SILVA (only NR);Eukaryota;SAR;Rhizaria;Retaria;Polycystinea;Spumellaria;Dictyocoryne;";"0.0";"0";"2";"2";"0";"2";"0";"457181";"391207"
"V4mis2";"SILVA (only NR);Eukaryota;SAR;Rhizaria;Retaria;Polycystinea;Spumellaria;Didymocyrtis;";"0.0";"0";"1";"1";"0";"1";"0";"457182";"391207"
"V4mis2";"SILVA (only NR);Eukaryota;SAR;Rhizaria;Retaria;Polycystinea;Spumellaria;Hexacontium;";"0.0";"0";"10";"4";"0";"4";"6";"457179";"391207"
"V4mis2";"SILVA (only NR);Eukaryota;SAR;Rhizaria;Retaria;Polycystinea;Spumellaria;Larcopyle;";"0.0";"0";"2";"2";"0";"2";"0";"457181";"391207"
"V4mis2";"SILVA (only NR);Eukaryota;SAR;Rhizaria;Retaria;Polycystinea;Spumellaria;Phorticium;";"0.0";"0";"1";"1";"0";"1";"0";"457182";"391207"
"V4mis2";"SILVA (only NR);Eukaryota;SAR;Rhizaria;Retaria;Polycystinea;Spumellaria;Rhizosphaera;";"0.0";"0";"11";"10";"0";"10";"1";"457173";"391207"
"V4mis2";"SILVA (only NR);Eukaryota;SAR;Rhizaria;Retaria;Polycystinea;Spumellaria;Spongocore;";"0.0";"0";"1";"1";"0";"1";"0";"457182";"391207"
"V4mis2";"SILVA (only NR);Eukaryota;SAR;Rhizaria;Retaria;Polycystinea;Spumellaria;Spongodiscus;";"0.0";"0";"2";"2";"0";"2";"0";"457181";"391207"
"V4mis2";"SILVA (only NR);Eukaryota;SAR;Rhizaria;Retaria;Polycystinea;Spumellaria;Spongopyle;";"0.0";"0";"1";"1";"0";"1";"0";"457182";"391207"
"V4mis2";"SILVA (only NR);Eukaryota;SAR;Rhizaria;Retaria;Polycystinea;Spumellaria;Spongotrochus;";"0.0";"0";"3";"3";"0";"3";"0";"457180";"391207"
"V4mis2";"SILVA (only NR);Eukaryota;SAR;Rhizaria;Retaria;Polycystinea;Spumellaria;Streblacantha;";"0.0";"0";"1";"1";"0";"1";"0";"457182";"391207"
"V4mis2";"SILVA (only NR);Eukaryota;SAR;Rhizaria;Retaria;Polycystinea;Spumellaria;Stylochlamydium;";"0.0";"0";"2";"2";"0";"2";"0";"457181";"391207"
"V4mis2";"SILVA (only NR);Eukaryota;SAR;Rhizaria;Retaria;Polycystinea;Spumellaria;Stylodictya;";"0.0";"0";"1";"1";"0";"1";"0";"457182";"391207"
"V4mis2";"SILVA (only NR);Eukaryota;SAR;Rhizaria;Retaria;Polycystinea;Spumellaria;Tetrapyle;";"0.0";"0";"2";"2";"0";"2";"0";"457181";"391207"
"V4mis2";"SILVA (only NR);Eukaryota;SAR;Rhizaria;Retaria;Polycystinea;Spumellaria;Triastrum;";"0.0";"0";"14";"13";"0";"13";"1";"457170";"391207"
"V4mis2";"SILVA (only NR);Eukaryota;SAR;Rhizaria;Retaria;Polycystinea;Spumellaria;uncultured;";"0.4";"14.4";"385";"255";"1";"254";"130";"456928";"391206"
"V4mis2";"SILVA (only NR);Eukaryota;SAR;Rhizaria;Retaria;RAD A;";"2.5";"14.4";"47";"40";"1";"39";"7";"457143";"391206"
"V4mis2";"SILVA (only NR);Eukaryota;SAR;Rhizaria;Retaria;RAD B;";"1.2";"14.4";"177";"167";"2";"165";"10";"457016";"391205"
"V4mis2";"SILVA (only NR);Eukaryota;SAR;Rhizaria;Retaria;RAD C;";"0.0";"0";"19";"18";"0";"18";"1";"457165";"391207"
"V4mis2";"SILVA (only NR);Eukaryota;SAR;Rhizaria;Retaria;uncultured;";"0.0";"0";"4";"4";"0";"4";"0";"457179";"391207"
"V4mis2";"SILVA (only NR);Eukaryota;SAR;Stramenopiles;";"93.2";"14.5";"3556";"3386";"3157";"229";"170";"453797";"388050"
"V4mis2";"SILVA (only NR);Eukaryota;SAR;Stramenopiles;Bicosoecida;";"95.6";"14.4";"143";"136";"130";"6";"7";"457047";"391077"
"V4mis2";"SILVA (only NR);Eukaryota;SAR;Stramenopiles;Bicosoecida;Adriamonas;";"100.0";"14.4";"1";"1";"1";"0";"0";"457182";"391206"
"V4mis2";"SILVA (only NR);Eukaryota;SAR;Stramenopiles;Bicosoecida;Bicosoeca;";"96.3";"14.4";"27";"27";"26";"1";"0";"457156";"391181"
"V4mis2";"SILVA (only NR);Eukaryota;SAR;Stramenopiles;Bicosoecida;CH1-2B-3;";"100.0";"14.4";"16";"16";"16";"0";"0";"457167";"391191"
"V4mis2";"SILVA (only NR);Eukaryota;SAR;Stramenopiles;Bicosoecida;Caecitellus;";"100.0";"14.4";"10";"10";"10";"0";"0";"457173";"391197"
"V4mis2";"SILVA (only NR);Eukaryota;SAR;Stramenopiles;Bicosoecida;Cafeteria;";"83.3";"14.4";"13";"12";"10";"2";"1";"457171";"391197"
"V4mis2";"SILVA (only NR);Eukaryota;SAR;Stramenopiles;Bicosoecida;Halocafeteria;";"100.0";"14.4";"13";"13";"13";"0";"0";"457170";"391194"
"V4mis2";"SILVA (only NR);Eukaryota;SAR;Stramenopiles;Bicosoecida;K4;";"100.0";"14.4";"3";"3";"3";"0";"0";"457180";"391204"
"V4mis2";"SILVA (only NR);Eukaryota;SAR;Stramenopiles;Bicosoecida;LG08-10;";"94.7";"14.4";"19";"19";"18";"1";"0";"457164";"391189"
"V4mis2";"SILVA (only NR);Eukaryota;SAR;Stramenopiles;Bicosoecida;P34.6;";"100.0";"14.4";"3";"3";"3";"0";"0";"457180";"391204"
"V4mis2";"SILVA (only NR);Eukaryota;SAR;Stramenopiles;Bicosoecida;Paramonas;";"100.0";"14.4";"2";"2";"2";"0";"0";"457181";"391205"
"V4mis2";"SILVA (only NR);Eukaryota;SAR;Stramenopiles;Bicosoecida;Pseudobodo;";"100.0";"14.4";"5";"5";"5";"0";"0";"457178";"391202"
"V4mis2";"SILVA (only NR);Eukaryota;SAR;Stramenopiles;Bicosoecida;Rictus;";"100.0";"14.4";"2";"2";"2";"0";"0";"457181";"391205"
"V4mis2";"SILVA (only NR);Eukaryota;SAR;Stramenopiles;Bicosoecida;Siluania;";"100.0";"14.4";"1";"1";"1";"0";"0";"457182";"391206"
"V4mis2";"SILVA (only NR);Eukaryota;SAR;Stramenopiles;Bicosoecida;uncultured;";"75.0";"14.4";"13";"8";"6";"2";"5";"457175";"391201"
"V4mis2";"SILVA (only NR);Eukaryota;SAR;Stramenopiles;Hyphochytriomycetes;";"100.0";"14.4";"7";"7";"7";"0";"0";"457176";"391200"
"V4mis2";"SILVA (only NR);Eukaryota;SAR;Stramenopiles;Hyphochytriomycetes;Hyphochytriales;";"100.0";"14.4";"7";"7";"7";"0";"0";"457176";"391200"
"V4mis2";"SILVA (only NR);Eukaryota;SAR;Stramenopiles;Hyphochytriomycetes;Hyphochytriales;Hyphochytrium;";"100.0";"14.4";"1";"1";"1";"0";"0";"457182";"391206"
"V4mis2";"SILVA (only NR);Eukaryota;SAR;Stramenopiles;Hyphochytriomycetes;Hyphochytriales;Rhizidiomyces;";"100.0";"14.4";"1";"1";"1";"0";"0";"457182";"391206"
"V4mis2";"SILVA (only NR);Eukaryota;SAR;Stramenopiles;Incertae Sedis;";"98.0";"14.4";"101";"99";"97";"2";"2";"457084";"391110"
"V4mis2";"SILVA (only NR);Eukaryota;SAR;Stramenopiles;Incertae Sedis;Blastocystis;";"97.4";"14.4";"80";"78";"76";"2";"2";"457105";"391131"
"V4mis2";"SILVA (only NR);Eukaryota;SAR;Stramenopiles;Incertae Sedis;Cantina;";"100.0";"14.4";"1";"1";"1";"0";"0";"457182";"391206"
"V4mis2";"SILVA (only NR);Eukaryota;SAR;Stramenopiles;Incertae Sedis;Developayella;";"100.0";"14.4";"2";"2";"2";"0";"0";"457181";"391205"
"V4mis2";"SILVA (only NR);Eukaryota;SAR;Stramenopiles;Incertae Sedis;Develorapax;";"100.0";"14.4";"1";"1";"1";"0";"0";"457182";"391206"
"V4mis2";"SILVA (only NR);Eukaryota;SAR;Stramenopiles;Incertae Sedis;Pirsonia;";"100.0";"14.4";"16";"16";"16";"0";"0";"457167";"391191"
"V4mis2";"SILVA (only NR);Eukaryota;SAR;Stramenopiles;Labyrinthulomycetes;";"88.1";"14.4";"392";"371";"327";"44";"21";"456812";"390880"
"V4mis2";"SILVA (only NR);Eukaryota;SAR;Stramenopiles;Labyrinthulomycetes;Amphitraemidae;";"100.0";"14.4";"9";"9";"9";"0";"0";"457174";"391198"
"V4mis2";"SILVA (only NR);Eukaryota;SAR;Stramenopiles;Labyrinthulomycetes;Amphitraemidae;Amphitrema;";"100.0";"14.4";"1";"1";"1";"0";"0";"457182";"391206"
"V4mis2";"SILVA (only NR);Eukaryota;SAR;Stramenopiles;Labyrinthulomycetes;Amphitraemidae;Archerella;";"100.0";"14.4";"1";"1";"1";"0";"0";"457182";"391206"
"V4mis2";"SILVA (only NR);Eukaryota;SAR;Stramenopiles;Labyrinthulomycetes;Incertae Sedis;";"100.0";"14.4";"1";"1";"1";"0";"0";"457182";"391206"
"V4mis2";"SILVA (only NR);Eukaryota;SAR;Stramenopiles;Labyrinthulomycetes;Incertae Sedis;Stellarchytrium;";"100.0";"14.4";"1";"1";"1";"0";"0";"457182";"391206"
"V4mis2";"SILVA (only NR);Eukaryota;SAR;Stramenopiles;Labyrinthulomycetes;Labyrinthulaceae;";"71.4";"14.4";"21";"21";"15";"6";"0";"457162";"391192"
"V4mis2";"SILVA (only NR);Eukaryota;SAR;Stramenopiles;Labyrinthulomycetes;Labyrinthulaceae;Labyrinthula;";"71.4";"14.4";"21";"21";"15";"6";"0";"457162";"391192"
"V4mis2";"SILVA (only NR);Eukaryota;SAR;Stramenopiles;Labyrinthulomycetes;Thraustochytriaceae;";"87.3";"14.4";"268";"260";"227";"33";"8";"456923";"390980"
"V4mis2";"SILVA (only NR);Eukaryota;SAR;Stramenopiles;Labyrinthulomycetes;Thraustochytriaceae;Aplanochytrium;";"81.6";"14.4";"44";"38";"31";"7";"6";"457145";"391176"
"V4mis2";"SILVA (only NR);Eukaryota;SAR;Stramenopiles;Labyrinthulomycetes;Thraustochytriaceae;Aurantiochytrium;";"86.1";"14.4";"36";"36";"31";"5";"0";"457147";"391176"
"V4mis2";"SILVA (only NR);Eukaryota;SAR;Stramenopiles;Labyrinthulomycetes;Thraustochytriaceae;Labyrinthuloides;";"100.0";"14.4";"7";"7";"7";"0";"0";"457176";"391200"
"V4mis2";"SILVA (only NR);Eukaryota;SAR;Stramenopiles;Labyrinthulomycetes;Thraustochytriaceae;Monorhizochytrium;";"100.0";"14.4";"1";"1";"1";"0";"0";"457182";"391206"
"V4mis2";"SILVA (only NR);Eukaryota;SAR;Stramenopiles;Labyrinthulomycetes;Thraustochytriaceae;Oblongichytrium;";"100.0";"14.4";"1";"1";"1";"0";"0";"457182";"391206"
"V4mis2";"SILVA (only NR);Eukaryota;SAR;Stramenopiles;Labyrinthulomycetes;Thraustochytriaceae;Parietichytrium;";"92.9";"14.4";"14";"14";"13";"1";"0";"457169";"391194"
"V4mis2";"SILVA (only NR);Eukaryota;SAR;Stramenopiles;Labyrinthulomycetes;Thraustochytriaceae;Schizochytrium;";"84.6";"14.4";"13";"13";"11";"2";"0";"457170";"391196"
"V4mis2";"SILVA (only NR);Eukaryota;SAR;Stramenopiles;Labyrinthulomycetes;Thraustochytriaceae;Sicyoidochytrium;";"100.0";"14.4";"6";"6";"6";"0";"0";"457177";"391201"
"V4mis2";"SILVA (only NR);Eukaryota;SAR;Stramenopiles;Labyrinthulomycetes;Thraustochytriaceae;Thraustochytrium;";"88.9";"14.4";"90";"90";"80";"10";"0";"457093";"391127"
"V4mis2";"SILVA (only NR);Eukaryota;SAR;Stramenopiles;Labyrinthulomycetes;Thraustochytriaceae;Ulkenia;";"92.3";"14.4";"13";"13";"12";"1";"0";"457170";"391195"
"V4mis2";"SILVA (only NR);Eukaryota;SAR;Stramenopiles;Labyrinthulomycetes;Thraustochytriaceae;uncultured;";"72.0";"14.4";"27";"25";"18";"7";"2";"457158";"391189"
"V4mis2";"SILVA (only NR);Eukaryota;SAR;Stramenopiles;Labyrinthulomycetes;uncultured;";"93.2";"14.4";"85";"73";"68";"5";"12";"457110";"391139"
"V4mis2";"SILVA (only NR);Eukaryota;SAR;Stramenopiles;MAST-11;";"100.0";"14.4";"5";"5";"5";"0";"0";"457178";"391202"
"V4mis2";"SILVA (only NR);Eukaryota;SAR;Stramenopiles;MAST-12;";"89.5";"14.4";"40";"38";"34";"4";"2";"457145";"391173"
"V4mis2";"SILVA (only NR);Eukaryota;SAR;Stramenopiles;MAST-12;MAST-12A;";"90.9";"14.4";"11";"11";"10";"1";"0";"457172";"391197"
"V4mis2";"SILVA (only NR);Eukaryota;SAR;Stramenopiles;MAST-12;MAST-12B;";"66.7";"14.4";"3";"3";"2";"1";"0";"457180";"391205"
"V4mis2";"SILVA (only NR);Eukaryota;SAR;Stramenopiles;MAST-12;MAST-12C;";"100.0";"14.4";"11";"11";"11";"0";"0";"457172";"391196"
"V4mis2";"SILVA (only NR);Eukaryota;SAR;Stramenopiles;MAST-12;MAST-12D;";"100.0";"14.4";"3";"2";"2";"0";"1";"457181";"391205"
"V4mis2";"SILVA (only NR);Eukaryota;SAR;Stramenopiles;MAST-16;";"0.0";"0";"2";"1";"0";"1";"1";"457182";"391207"
"V4mis2";"SILVA (only NR);Eukaryota;SAR;Stramenopiles;MAST-1;";"88.0";"14.4";"30";"25";"22";"3";"5";"457158";"391185"
"V4mis2";"SILVA (only NR);Eukaryota;SAR;Stramenopiles;MAST-1;MAST-1A;";"57.1";"14.4";"8";"7";"4";"3";"1";"457176";"391203"
"V4mis2";"SILVA (only NR);Eukaryota;SAR;Stramenopiles;MAST-1;MAST-1B;";"100.0";"14.4";"2";"2";"2";"0";"0";"457181";"391205"
"V4mis2";"SILVA (only NR);Eukaryota;SAR;Stramenopiles;MAST-1;MAST-1C;";"100.0";"14.4";"12";"10";"10";"0";"2";"457173";"391197"
"V4mis2";"SILVA (only NR);Eukaryota;SAR;Stramenopiles;MAST-1;MAST-1D;";"100.0";"14.4";"5";"3";"3";"0";"2";"457180";"391204"
"V4mis2";"SILVA (only NR);Eukaryota;SAR;Stramenopiles;MAST-22;";"87.5";"14.4";"10";"8";"7";"1";"2";"457175";"391200"
"V4mis2";"SILVA (only NR);Eukaryota;SAR;Stramenopiles;MAST-22;MAST-22A;";"100.0";"14.4";"2";"1";"1";"0";"1";"457182";"391206"
"V4mis2";"SILVA (only NR);Eukaryota;SAR;Stramenopiles;MAST-22;MAST-22B;";"66.7";"14.4";"3";"3";"2";"1";"0";"457180";"391205"
"V4mis2";"SILVA (only NR);Eukaryota;SAR;Stramenopiles;MAST-22;MAST-22C;";"100.0";"14.4";"3";"3";"3";"0";"0";"457180";"391204"
"V4mis2";"SILVA (only NR);Eukaryota;SAR;Stramenopiles;MAST-23;";"100.0";"14.4";"2";"2";"2";"0";"0";"457181";"391205"
"V4mis2";"SILVA (only NR);Eukaryota;SAR;Stramenopiles;MAST-24;";"100.0";"14.4";"2";"2";"2";"0";"0";"457181";"391205"
"V4mis2";"SILVA (only NR);Eukaryota;SAR;Stramenopiles;MAST-2;";"100.0";"14.4";"6";"6";"6";"0";"0";"457177";"391201"
"V4mis2";"SILVA (only NR);Eukaryota;SAR;Stramenopiles;MAST-3;";"94.3";"14.4";"128";"106";"100";"6";"22";"457077";"391107"
"V4mis2";"SILVA (only NR);Eukaryota;SAR;Stramenopiles;MAST-3;MAST-3A;";"100.0";"14.4";"9";"8";"8";"0";"1";"457175";"391199"
"V4mis2";"SILVA (only NR);Eukaryota;SAR;Stramenopiles;MAST-3;MAST-3B;";"80.0";"14.4";"13";"10";"8";"2";"3";"457173";"391199"
"V4mis2";"SILVA (only NR);Eukaryota;SAR;Stramenopiles;MAST-3;MAST-3C;";"92.3";"14.4";"13";"13";"12";"1";"0";"457170";"391195"
"V4mis2";"SILVA (only NR);Eukaryota;SAR;Stramenopiles;MAST-3;MAST-3D;";"100.0";"14.4";"10";"7";"7";"0";"3";"457176";"391200"
"V4mis2";"SILVA (only NR);Eukaryota;SAR;Stramenopiles;MAST-3;MAST-3E;";"91.7";"14.4";"12";"12";"11";"1";"0";"457171";"391196"
"V4mis2";"SILVA (only NR);Eukaryota;SAR;Stramenopiles;MAST-3;MAST-3F;";"100.0";"14.4";"19";"18";"18";"0";"1";"457165";"391189"
"V4mis2";"SILVA (only NR);Eukaryota;SAR;Stramenopiles;MAST-3;MAST-3I;";"92.9";"14.4";"20";"14";"13";"1";"6";"457169";"391194"
"V4mis2";"SILVA (only NR);Eukaryota;SAR;Stramenopiles;MAST-3;MAST-3J;";"90.0";"14.4";"14";"10";"9";"1";"4";"457173";"391198"
"V4mis2";"SILVA (only NR);Eukaryota;SAR;Stramenopiles;MAST-3;MAST-3K;";"100.0";"14.4";"5";"2";"2";"0";"3";"457181";"391205"
"V4mis2";"SILVA (only NR);Eukaryota;SAR;Stramenopiles;MAST-3;MAST-3L;";"100.0";"14.4";"3";"3";"3";"0";"0";"457180";"391204"
"V4mis2";"SILVA (only NR);Eukaryota;SAR;Stramenopiles;MAST-4;";"100.0";"14.4";"28";"27";"27";"0";"1";"457156";"391180"
"V4mis2";"SILVA (only NR);Eukaryota;SAR;Stramenopiles;MAST-4;MAST-4A;";"100.0";"14.4";"3";"3";"3";"0";"0";"457180";"391204"
"V4mis2";"SILVA (only NR);Eukaryota;SAR;Stramenopiles;MAST-4;MAST-4D;";"100.0";"14.4";"3";"2";"2";"0";"1";"457181";"391205"
"V4mis2";"SILVA (only NR);Eukaryota;SAR;Stramenopiles;MAST-4;MAST-4F;";"100.0";"14.4";"5";"5";"5";"0";"0";"457178";"391202"
"V4mis2";"SILVA (only NR);Eukaryota;SAR;Stramenopiles;MAST-6;";"100.0";"14.4";"5";"5";"5";"0";"0";"457178";"391202"
"V4mis2";"SILVA (only NR);Eukaryota;SAR;Stramenopiles;MAST-7;";"92.6";"14.4";"27";"27";"25";"2";"0";"457156";"391182"
"V4mis2";"SILVA (only NR);Eukaryota;SAR;Stramenopiles;MAST-7;MAST-7A;";"100.0";"14.4";"11";"11";"11";"0";"0";"457172";"391196"
"V4mis2";"SILVA (only NR);Eukaryota;SAR;Stramenopiles;MAST-7;MAST-7B;";"66.7";"14.4";"6";"6";"4";"2";"0";"457177";"391203"
"V4mis2";"SILVA (only NR);Eukaryota;SAR;Stramenopiles;MAST-7;MAST-7D;";"100.0";"14.4";"5";"5";"5";"0";"0";"457178";"391202"
"V4mis2";"SILVA (only NR);Eukaryota;SAR;Stramenopiles;MAST-8;";"100.0";"14.4";"17";"15";"15";"0";"2";"457168";"391192"
"V4mis2";"SILVA (only NR);Eukaryota;SAR;Stramenopiles;MAST-8;MAST-8D;";"100.0";"14.4";"6";"6";"6";"0";"0";"457177";"391201"
"V4mis2";"SILVA (only NR);Eukaryota;SAR;Stramenopiles;MAST-9;";"100.0";"14.4";"13";"12";"12";"0";"1";"457171";"391195"
"V4mis2";"SILVA (only NR);Eukaryota;SAR;Stramenopiles;MAST-9;MAST-9A;";"100.0";"14.4";"6";"6";"6";"0";"0";"457177";"391201"
"V4mis2";"SILVA (only NR);Eukaryota;SAR;Stramenopiles;Ochrophyta;";"94.0";"14.5";"2392";"2298";"2159";"139";"94";"454885";"389048"
"V4mis2";"SILVA (only NR);Eukaryota;SAR;Stramenopiles;Ochrophyta;ANT37-16;";"100.0";"14.4";"4";"4";"4";"0";"0";"457179";"391203"
"V4mis2";"SILVA (only NR);Eukaryota;SAR;Stramenopiles;Ochrophyta;Aurearenophyceae;";"100.0";"14.4";"1";"1";"1";"0";"0";"457182";"391206"
"V4mis2";"SILVA (only NR);Eukaryota;SAR;Stramenopiles;Ochrophyta;Aurearenophyceae;Aurearena;";"100.0";"14.4";"1";"1";"1";"0";"0";"457182";"391206"
"V4mis2";"SILVA (only NR);Eukaryota;SAR;Stramenopiles;Ochrophyta;Bolidomonas;";"88.0";"14.4";"25";"25";"22";"3";"0";"457158";"391185"
"V4mis2";"SILVA (only NR);Eukaryota;SAR;Stramenopiles;Ochrophyta;Chrysomerophyceae;";"100.0";"14.4";"3";"3";"3";"0";"0";"457180";"391204"
"V4mis2";"SILVA (only NR);Eukaryota;SAR;Stramenopiles;Ochrophyta;Chrysomerophyceae;Antarctosaccion;";"100.0";"14.4";"1";"1";"1";"0";"0";"457182";"391206"
"V4mis2";"SILVA (only NR);Eukaryota;SAR;Stramenopiles;Ochrophyta;Chrysomerophyceae;Chrysowaernella;";"100.0";"14.4";"1";"1";"1";"0";"0";"457182";"391206"
"V4mis2";"SILVA (only NR);Eukaryota;SAR;Stramenopiles;Ochrophyta;Chrysomerophyceae;Giraudyopsis;";"100.0";"14.4";"1";"1";"1";"0";"0";"457182";"391206"
"V4mis2";"SILVA (only NR);Eukaryota;SAR;Stramenopiles;Ochrophyta;Chrysophyceae;";"92.8";"14.4";"489";"470";"436";"34";"19";"456713";"390771"
"V4mis2";"SILVA (only NR);Eukaryota;SAR;Stramenopiles;Ochrophyta;Chrysophyceae;A-3-62;";"100.0";"14.4";"2";"2";"2";"0";"0";"457181";"391205"
"V4mis2";"SILVA (only NR);Eukaryota;SAR;Stramenopiles;Ochrophyta;Chrysophyceae;Chromulinales;";"92.6";"14.4";"97";"95";"88";"7";"2";"457088";"391119"
"V4mis2";"SILVA (only NR);Eukaryota;SAR;Stramenopiles;Ochrophyta;Chrysophyceae;Chromulinales;Chromulina;";"100.0";"14.4";"5";"5";"5";"0";"0";"457178";"391202"
"V4mis2";"SILVA (only NR);Eukaryota;SAR;Stramenopiles;Ochrophyta;Chrysophyceae;Chromulinales;Chrysamoeba;";"100.0";"14.4";"6";"6";"6";"0";"0";"457177";"391201"
"V4mis2";"SILVA (only NR);Eukaryota;SAR;Stramenopiles;Ochrophyta;Chrysophyceae;Chromulinales;Chrysochaete;";"100.0";"14.4";"2";"2";"2";"0";"0";"457181";"391205"
"V4mis2";"SILVA (only NR);Eukaryota;SAR;Stramenopiles;Ochrophyta;Chrysophyceae;Chromulinales;Chrysoxys;";"100.0";"14.4";"2";"2";"2";"0";"0";"457181";"391205"
"V4mis2";"SILVA (only NR);Eukaryota;SAR;Stramenopiles;Ochrophyta;Chrysophyceae;Chromulinales;Cyclonexis;";"100.0";"14.4";"1";"1";"1";"0";"0";"457182";"391206"
"V4mis2";"SILVA (only NR);Eukaryota;SAR;Stramenopiles;Ochrophyta;Chrysophyceae;Chromulinales;JBNA46;";"100.0";"14.4";"4";"4";"4";"0";"0";"457179";"391203"
"V4mis2";"SILVA (only NR);Eukaryota;SAR;Stramenopiles;Ochrophyta;Chrysophyceae;Chromulinales;Oikomonas;";"100.0";"14.4";"5";"5";"5";"0";"0";"457178";"391202"
"V4mis2";"SILVA (only NR);Eukaryota;SAR;Stramenopiles;Ochrophyta;Chrysophyceae;Chromulinales;Phaeoplaca;";"100.0";"14.4";"2";"2";"2";"0";"0";"457181";"391205"
"V4mis2";"SILVA (only NR);Eukaryota;SAR;Stramenopiles;Ochrophyta;Chrysophyceae;Chromulinales;Poterioochromonas;";"71.4";"14.4";"7";"7";"5";"2";"0";"457176";"391202"
"V4mis2";"SILVA (only NR);Eukaryota;SAR;Stramenopiles;Ochrophyta;Chrysophyceae;Chromulinales;Poteriospumella;";"100.0";"14.4";"2";"2";"2";"0";"0";"457181";"391205"
"V4mis2";"SILVA (only NR);Eukaryota;SAR;Stramenopiles;Ochrophyta;Chrysophyceae;Chromulinales;Spumella;";"92.9";"14.4";"29";"28";"26";"2";"1";"457155";"391181"
"V4mis2";"SILVA (only NR);Eukaryota;SAR;Stramenopiles;Ochrophyta;Chrysophyceae;Chromulinales;Uroglena;";"100.0";"14.4";"6";"6";"6";"0";"0";"457177";"391201"
"V4mis2";"SILVA (only NR);Eukaryota;SAR;Stramenopiles;Ochrophyta;Chrysophyceae;Chromulinales;eukaryotic;";"100.0";"14.4";"2";"2";"2";"0";"0";"457181";"391205"
"V4mis2";"SILVA (only NR);Eukaryota;SAR;Stramenopiles;Ochrophyta;Chrysophyceae;Chromulinales;uncultured;";"80.0";"14.4";"16";"15";"12";"3";"1";"457168";"391195"
"V4mis2";"SILVA (only NR);Eukaryota;SAR;Stramenopiles;Ochrophyta;Chrysophyceae;Chrysocapsales;";"100.0";"14.4";"8";"8";"8";"0";"0";"457175";"391199"
"V4mis2";"SILVA (only NR);Eukaryota;SAR;Stramenopiles;Ochrophyta;Chrysophyceae;Chrysocapsales;Chrysocapsa;";"100.0";"14.4";"2";"2";"2";"0";"0";"457181";"391205"
"V4mis2";"SILVA (only NR);Eukaryota;SAR;Stramenopiles;Ochrophyta;Chrysophyceae;Chrysocapsales;Chrysonebula;";"100.0";"14.4";"3";"3";"3";"0";"0";"457180";"391204"
"V4mis2";"SILVA (only NR);Eukaryota;SAR;Stramenopiles;Ochrophyta;Chrysophyceae;Chrysocapsales;Hydrurus;";"100.0";"14.4";"3";"3";"3";"0";"0";"457180";"391204"
"V4mis2";"SILVA (only NR);Eukaryota;SAR;Stramenopiles;Ochrophyta;Chrysophyceae;Chrysosphaerales;";"100.0";"14.4";"1";"1";"1";"0";"0";"457182";"391206"
"V4mis2";"SILVA (only NR);Eukaryota;SAR;Stramenopiles;Ochrophyta;Chrysophyceae;Chrysosphaerales;Chrysosphaera;";"100.0";"14.4";"1";"1";"1";"0";"0";"457182";"391206"
"V4mis2";"SILVA (only NR);Eukaryota;SAR;Stramenopiles;Ochrophyta;Chrysophyceae;Hibberdiales;";"83.3";"14.4";"6";"6";"5";"1";"0";"457177";"391202"
"V4mis2";"SILVA (only NR);Eukaryota;SAR;Stramenopiles;Ochrophyta;Chrysophyceae;Hibberdiales;Chromophyton;";"100.0";"14.4";"2";"2";"2";"0";"0";"457181";"391205"
"V4mis2";"SILVA (only NR);Eukaryota;SAR;Stramenopiles;Ochrophyta;Chrysophyceae;Hibberdiales;Chrysopodocystis;";"50.0";"14.4";"2";"2";"1";"1";"0";"457181";"391206"
"V4mis2";"SILVA (only NR);Eukaryota;SAR;Stramenopiles;Ochrophyta;Chrysophyceae;Hibberdiales;Hibberdia;";"100.0";"14.4";"1";"1";"1";"0";"0";"457182";"391206"
"V4mis2";"SILVA (only NR);Eukaryota;SAR;Stramenopiles;Ochrophyta;Chrysophyceae;Hibberdiales;Lagynion;";"100.0";"14.4";"1";"1";"1";"0";"0";"457182";"391206"
"V4mis2";"SILVA (only NR);Eukaryota;SAR;Stramenopiles;Ochrophyta;Chrysophyceae;Incertae Sedis;";"75.0";"14.4";"5";"4";"3";"1";"1";"457179";"391204"
"V4mis2";"SILVA (only NR);Eukaryota;SAR;Stramenopiles;Ochrophyta;Chrysophyceae;Incertae Sedis;Chlamydomyxa;";"75.0";"14.4";"5";"4";"3";"1";"1";"457179";"391204"
"V4mis2";"SILVA (only NR);Eukaryota;SAR;Stramenopiles;Ochrophyta;Chrysophyceae;Ochromonadales;";"91.9";"14.4";"124";"111";"102";"9";"13";"457072";"391105"
"V4mis2";"SILVA (only NR);Eukaryota;SAR;Stramenopiles;Ochrophyta;Chrysophyceae;Ochromonadales;Chrysolepidomonas;";"100.0";"14.4";"1";"1";"1";"0";"0";"457182";"391206"
"V4mis2";"SILVA (only NR);Eukaryota;SAR;Stramenopiles;Ochrophyta;Chrysophyceae;Ochromonadales;Chrysonephele;";"100.0";"14.4";"1";"1";"1";"0";"0";"457182";"391206"
"V4mis2";"SILVA (only NR);Eukaryota;SAR;Stramenopiles;Ochrophyta;Chrysophyceae;Ochromonadales;Dinobryon;";"100.0";"14.4";"9";"9";"9";"0";"0";"457174";"391198"
"V4mis2";"SILVA (only NR);Eukaryota;SAR;Stramenopiles;Ochrophyta;Chrysophyceae;Ochromonadales;Epipyxis;";"100.0";"14.4";"5";"5";"5";"0";"0";"457178";"391202"
"V4mis2";"SILVA (only NR);Eukaryota;SAR;Stramenopiles;Ochrophyta;Chrysophyceae;Ochromonadales;Ochromonas;";"91.7";"14.4";"37";"36";"33";"3";"1";"457147";"391174"
"V4mis2";"SILVA (only NR);Eukaryota;SAR;Stramenopiles;Ochrophyta;Chrysophyceae;Ochromonadales;Paraphysomonas;";"90.2";"14.4";"63";"51";"46";"5";"12";"457132";"391161"
"V4mis2";"SILVA (only NR);Eukaryota;SAR;Stramenopiles;Ochrophyta;Chrysophyceae;Ochromonadales;uncultured;";"85.7";"14.4";"7";"7";"6";"1";"0";"457176";"391201"
"V4mis2";"SILVA (only NR);Eukaryota;SAR;Stramenopiles;Ochrophyta;Chrysophyceae;P34.45;";"91.7";"14.4";"13";"12";"11";"1";"1";"457171";"391196"
"V4mis2";"SILVA (only NR);Eukaryota;SAR;Stramenopiles;Ochrophyta;Chrysophyceae;P34.48;";"100.0";"14.4";"12";"12";"12";"0";"0";"457171";"391195"
"V4mis2";"SILVA (only NR);Eukaryota;SAR;Stramenopiles;Ochrophyta;Chrysophyceae;Synurales;";"100.0";"14.4";"47";"47";"47";"0";"0";"457136";"391160"
"V4mis2";"SILVA (only NR);Eukaryota;SAR;Stramenopiles;Ochrophyta;Chrysophyceae;Synurales;Mallomonas;";"100.0";"14.4";"30";"30";"30";"0";"0";"457153";"391177"
"V4mis2";"SILVA (only NR);Eukaryota;SAR;Stramenopiles;Ochrophyta;Chrysophyceae;Synurales;Synura;";"100.0";"14.4";"15";"15";"15";"0";"0";"457168";"391192"
"V4mis2";"SILVA (only NR);Eukaryota;SAR;Stramenopiles;Ochrophyta;Chrysophyceae;Synurales;Tessellaria;";"100.0";"14.4";"2";"2";"2";"0";"0";"457181";"391205"
"V4mis2";"SILVA (only NR);Eukaryota;SAR;Stramenopiles;Ochrophyta;Chrysophyceae;uncultured;";"90.9";"14.4";"156";"154";"140";"14";"2";"457029";"391067"
"V4mis2";"SILVA (only NR);Eukaryota;SAR;Stramenopiles;Ochrophyta;Diatomea;";"93.9";"14.5";"1571";"1502";"1410";"92";"69";"455681";"389797"
"V4mis2";"SILVA (only NR);Eukaryota;SAR;Stramenopiles;Ochrophyta;Diatomea;Bacillariophytina;";"93.9";"14.5";"1283";"1218";"1144";"74";"65";"455965";"390063"
"V4mis2";"SILVA (only NR);Eukaryota;SAR;Stramenopiles;Ochrophyta;Diatomea;Bacillariophytina;Bacillariophyceae;";"95.6";"14.5";"900";"873";"835";"38";"27";"456310";"390372"
"V4mis2";"SILVA (only NR);Eukaryota;SAR;Stramenopiles;Ochrophyta;Diatomea;Bacillariophytina;Bacillariophyceae;Achnanthes;";"100.0";"14.4";"5";"5";"5";"0";"0";"457178";"391202"
"V4mis2";"SILVA (only NR);Eukaryota;SAR;Stramenopiles;Ochrophyta;Diatomea;Bacillariophytina;Bacillariophyceae;Achnanthidium;";"100.0";"14.4";"8";"8";"8";"0";"0";"457175";"391199"
"V4mis2";"SILVA (only NR);Eukaryota;SAR;Stramenopiles;Ochrophyta;Diatomea;Bacillariophytina;Bacillariophyceae;Amphipleura;";"100.0";"14.4";"1";"1";"1";"0";"0";"457182";"391206"
"V4mis2";"SILVA (only NR);Eukaryota;SAR;Stramenopiles;Ochrophyta;Diatomea;Bacillariophytina;Bacillariophyceae;Amphiprora;";"100.0";"14.4";"1";"1";"1";"0";"0";"457182";"391206"
"V4mis2";"SILVA (only NR);Eukaryota;SAR;Stramenopiles;Ochrophyta;Diatomea;Bacillariophytina;Bacillariophyceae;Amphora;";"98.2";"14.4";"114";"113";"111";"2";"1";"457070";"391096"
"V4mis2";"SILVA (only NR);Eukaryota;SAR;Stramenopiles;Ochrophyta;Diatomea;Bacillariophytina;Bacillariophyceae;Anomoeoneis;";"100.0";"14.4";"3";"3";"3";"0";"0";"457180";"391204"
"V4mis2";"SILVA (only NR);Eukaryota;SAR;Stramenopiles;Ochrophyta;Diatomea;Bacillariophytina;Bacillariophyceae;Asterionella;";"50.0";"14.4";"2";"2";"1";"1";"0";"457181";"391206"
"V4mis2";"SILVA (only NR);Eukaryota;SAR;Stramenopiles;Ochrophyta;Diatomea;Bacillariophytina;Bacillariophyceae;Asterionellopsis;";"100.0";"14.4";"1";"1";"1";"0";"0";"457182";"391206"
"V4mis2";"SILVA (only NR);Eukaryota;SAR;Stramenopiles;Ochrophyta;Diatomea;Bacillariophytina;Bacillariophyceae;Asteroplanus;";"100.0";"14.4";"1";"1";"1";"0";"0";"457182";"391206"
"V4mis2";"SILVA (only NR);Eukaryota;SAR;Stramenopiles;Ochrophyta;Diatomea;Bacillariophytina;Bacillariophyceae;Auricula;";"100.0";"14.4";"5";"5";"5";"0";"0";"457178";"391202"
"V4mis2";"SILVA (only NR);Eukaryota;SAR;Stramenopiles;Ochrophyta;Diatomea;Bacillariophytina;Bacillariophyceae;Bacillaria;";"100.0";"14.4";"5";"5";"5";"0";"0";"457178";"391202"
"V4mis2";"SILVA (only NR);Eukaryota;SAR;Stramenopiles;Ochrophyta;Diatomea;Bacillariophytina;Bacillariophyceae;Biremis;";"100.0";"14.4";"4";"4";"4";"0";"0";"457179";"391203"
"V4mis2";"SILVA (only NR);Eukaryota;SAR;Stramenopiles;Ochrophyta;Diatomea;Bacillariophytina;Bacillariophyceae;Campylodiscus;";"100.0";"14.4";"20";"20";"20";"0";"0";"457163";"391187"
"V4mis2";"SILVA (only NR);Eukaryota;SAR;Stramenopiles;Ochrophyta;Diatomea;Bacillariophytina;Bacillariophyceae;Carinasigma;";"100.0";"14.4";"1";"1";"1";"0";"0";"457182";"391206"
"V4mis2";"SILVA (only NR);Eukaryota;SAR;Stramenopiles;Ochrophyta;Diatomea;Bacillariophytina;Bacillariophyceae;Climaconeis;";"100.0";"14.4";"3";"3";"3";"0";"0";"457180";"391204"
"V4mis2";"SILVA (only NR);Eukaryota;SAR;Stramenopiles;Ochrophyta;Diatomea;Bacillariophytina;Bacillariophyceae;Cocconeis;";"77.8";"14.4";"9";"9";"7";"2";"0";"457174";"391200"
"V4mis2";"SILVA (only NR);Eukaryota;SAR;Stramenopiles;Ochrophyta;Diatomea;Bacillariophytina;Bacillariophyceae;Craspedostauros;";"50.0";"14.4";"2";"2";"1";"1";"0";"457181";"391206"
"V4mis2";"SILVA (only NR);Eukaryota;SAR;Stramenopiles;Ochrophyta;Diatomea;Bacillariophytina;Bacillariophyceae;Craticula;";"100.0";"14.4";"4";"4";"4";"0";"0";"457179";"391203"
"V4mis2";"SILVA (only NR);Eukaryota;SAR;Stramenopiles;Ochrophyta;Diatomea;Bacillariophytina;Bacillariophyceae;Cylindrotheca;";"81.3";"14.4";"16";"16";"13";"3";"0";"457167";"391194"
"V4mis2";"SILVA (only NR);Eukaryota;SAR;Stramenopiles;Ochrophyta;Diatomea;Bacillariophytina;Bacillariophyceae;Cymatopleura;";"100.0";"14.4";"3";"3";"3";"0";"0";"457180";"391204"
"V4mis2";"SILVA (only NR);Eukaryota;SAR;Stramenopiles;Ochrophyta;Diatomea;Bacillariophytina;Bacillariophyceae;Cymbella;";"100.0";"14.4";"17";"17";"17";"0";"0";"457166";"391190"
"V4mis2";"SILVA (only NR);Eukaryota;SAR;Stramenopiles;Ochrophyta;Diatomea;Bacillariophytina;Bacillariophyceae;Cymbellonitzschia;";"100.0";"14.4";"2";"2";"2";"0";"0";"457181";"391205"
"V4mis2";"SILVA (only NR);Eukaryota;SAR;Stramenopiles;Ochrophyta;Diatomea;Bacillariophytina;Bacillariophyceae;Cymbopleura;";"100.0";"14.4";"2";"2";"2";"0";"0";"457181";"391205"
"V4mis2";"SILVA (only NR);Eukaryota;SAR;Stramenopiles;Ochrophyta;Diatomea;Bacillariophytina;Bacillariophyceae;Diadesmis;";"100.0";"14.4";"1";"1";"1";"0";"0";"457182";"391206"
"V4mis2";"SILVA (only NR);Eukaryota;SAR;Stramenopiles;Ochrophyta;Diatomea;Bacillariophytina;Bacillariophyceae;Diatoma;";"100.0";"14.4";"5";"5";"5";"0";"0";"457178";"391202"
"V4mis2";"SILVA (only NR);Eukaryota;SAR;Stramenopiles;Ochrophyta;Diatomea;Bacillariophytina;Bacillariophyceae;Dickieia;";"100.0";"14.4";"3";"3";"3";"0";"0";"457180";"391204"
"V4mis2";"SILVA (only NR);Eukaryota;SAR;Stramenopiles;Ochrophyta;Diatomea;Bacillariophytina;Bacillariophyceae;Diploneis;";"100.0";"14.4";"8";"8";"8";"0";"0";"457175";"391199"
"V4mis2";"SILVA (only NR);Eukaryota;SAR;Stramenopiles;Ochrophyta;Diatomea;Bacillariophytina;Bacillariophyceae;Encyonema;";"100.0";"14.4";"6";"6";"6";"0";"0";"457177";"391201"
"V4mis2";"SILVA (only NR);Eukaryota;SAR;Stramenopiles;Ochrophyta;Diatomea;Bacillariophytina;Bacillariophyceae;Entomoneis;";"100.0";"14.4";"20";"20";"20";"0";"0";"457163";"391187"
"V4mis2";"SILVA (only NR);Eukaryota;SAR;Stramenopiles;Ochrophyta;Diatomea;Bacillariophytina;Bacillariophyceae;Epithemia;";"100.0";"14.4";"3";"3";"3";"0";"0";"457180";"391204"
"V4mis2";"SILVA (only NR);Eukaryota;SAR;Stramenopiles;Ochrophyta;Diatomea;Bacillariophytina;Bacillariophyceae;Eucocconeis;";"100.0";"14.4";"1";"1";"1";"0";"0";"457182";"391206"
"V4mis2";"SILVA (only NR);Eukaryota;SAR;Stramenopiles;Ochrophyta;Diatomea;Bacillariophytina;Bacillariophyceae;Eunotia;";"100.0";"14.4";"14";"14";"14";"0";"0";"457169";"391193"
"V4mis2";"SILVA (only NR);Eukaryota;SAR;Stramenopiles;Ochrophyta;Diatomea;Bacillariophytina;Bacillariophyceae;Fistulifera;";"85.7";"14.4";"7";"7";"6";"1";"0";"457176";"391201"
"V4mis2";"SILVA (only NR);Eukaryota;SAR;Stramenopiles;Ochrophyta;Diatomea;Bacillariophytina;Bacillariophyceae;Fragilariopsis;";"86.4";"14.4";"23";"22";"19";"3";"1";"457161";"391188"
"V4mis2";"SILVA (only NR);Eukaryota;SAR;Stramenopiles;Ochrophyta;Diatomea;Bacillariophytina;Bacillariophyceae;Frustulia;";"100.0";"14.4";"7";"7";"7";"0";"0";"457176";"391200"
"V4mis2";"SILVA (only NR);Eukaryota;SAR;Stramenopiles;Ochrophyta;Diatomea;Bacillariophytina;Bacillariophyceae;Geissleria;";"100.0";"14.4";"1";"1";"1";"0";"0";"457182";"391206"
"V4mis2";"SILVA (only NR);Eukaryota;SAR;Stramenopiles;Ochrophyta;Diatomea;Bacillariophytina;Bacillariophyceae;Gomphonema;";"100.0";"14.4";"12";"12";"12";"0";"0";"457171";"391195"
"V4mis2";"SILVA (only NR);Eukaryota;SAR;Stramenopiles;Ochrophyta;Diatomea;Bacillariophytina;Bacillariophyceae;Gyrosigma;";"100.0";"14.4";"4";"4";"4";"0";"0";"457179";"391203"
"V4mis2";"SILVA (only NR);Eukaryota;SAR;Stramenopiles;Ochrophyta;Diatomea;Bacillariophytina;Bacillariophyceae;Hantzschia;";"85.7";"14.4";"14";"14";"12";"2";"0";"457169";"391195"
"V4mis2";"SILVA (only NR);Eukaryota;SAR;Stramenopiles;Ochrophyta;Diatomea;Bacillariophytina;Bacillariophyceae;Haslea;";"100.0";"14.4";"6";"6";"6";"0";"0";"457177";"391201"
"V4mis2";"SILVA (only NR);Eukaryota;SAR;Stramenopiles;Ochrophyta;Diatomea;Bacillariophytina;Bacillariophyceae;Humidophila;";"100.0";"14.4";"2";"2";"2";"0";"0";"457181";"391205"
"V4mis2";"SILVA (only NR);Eukaryota;SAR;Stramenopiles;Ochrophyta;Diatomea;Bacillariophytina;Bacillariophyceae;Lemnicula;";"100.0";"14.4";"4";"4";"4";"0";"0";"457179";"391203"
"V4mis2";"SILVA (only NR);Eukaryota;SAR;Stramenopiles;Ochrophyta;Diatomea;Bacillariophytina;Bacillariophyceae;Luticola;";"100.0";"14.4";"6";"6";"6";"0";"0";"457177";"391201"
"V4mis2";"SILVA (only NR);Eukaryota;SAR;Stramenopiles;Ochrophyta;Diatomea;Bacillariophytina;Bacillariophyceae;Meuniera;";"100.0";"14.4";"1";"1";"1";"0";"0";"457182";"391206"
"V4mis2";"SILVA (only NR);Eukaryota;SAR;Stramenopiles;Ochrophyta;Diatomea;Bacillariophytina;Bacillariophyceae;Navicula;";"86.1";"14.4";"72";"72";"62";"10";"0";"457111";"391145"
"V4mis2";"SILVA (only NR);Eukaryota;SAR;Stramenopiles;Ochrophyta;Diatomea;Bacillariophytina;Bacillariophyceae;Neidium;";"100.0";"14.4";"2";"2";"2";"0";"0";"457181";"391205"
"V4mis2";"SILVA (only NR);Eukaryota;SAR;Stramenopiles;Ochrophyta;Diatomea;Bacillariophytina;Bacillariophyceae;Nitzschia;";"97.5";"14.4";"79";"79";"77";"2";"0";"457104";"391130"
"V4mis2";"SILVA (only NR);Eukaryota;SAR;Stramenopiles;Ochrophyta;Diatomea;Bacillariophytina;Bacillariophyceae;Parlibellus;";"75.0";"14.4";"4";"4";"3";"1";"0";"457179";"391204"
"V4mis2";"SILVA (only NR);Eukaryota;SAR;Stramenopiles;Ochrophyta;Diatomea;Bacillariophytina;Bacillariophyceae;Pauliella;";"100.0";"14.4";"4";"4";"4";"0";"0";"457179";"391203"
"V4mis2";"SILVA (only NR);Eukaryota;SAR;Stramenopiles;Ochrophyta;Diatomea;Bacillariophytina;Bacillariophyceae;Phaeodactylum;";"100.0";"14.4";"2";"2";"2";"0";"0";"457181";"391205"
"V4mis2";"SILVA (only NR);Eukaryota;SAR;Stramenopiles;Ochrophyta;Diatomea;Bacillariophytina;Bacillariophyceae;Pinnularia;";"100.0";"14.4";"55";"55";"55";"0";"0";"457128";"391152"
"V4mis2";"SILVA (only NR);Eukaryota;SAR;Stramenopiles;Ochrophyta;Diatomea;Bacillariophytina;Bacillariophyceae;Placoneis;";"100.0";"14.4";"7";"7";"7";"0";"0";"457176";"391200"
"V4mis2";"SILVA (only NR);Eukaryota;SAR;Stramenopiles;Ochrophyta;Diatomea;Bacillariophytina;Bacillariophyceae;Planothidium;";"100.0";"14.4";"12";"12";"12";"0";"0";"457171";"391195"
"V4mis2";"SILVA (only NR);Eukaryota;SAR;Stramenopiles;Ochrophyta;Diatomea;Bacillariophytina;Bacillariophyceae;Pleurosigma;";"91.7";"14.4";"14";"12";"11";"1";"2";"457171";"391196"
"V4mis2";"SILVA (only NR);Eukaryota;SAR;Stramenopiles;Ochrophyta;Diatomea;Bacillariophytina;Bacillariophyceae;Protokeelia;";"100.0";"14.4";"1";"1";"1";"0";"0";"457182";"391206"
"V4mis2";"SILVA (only NR);Eukaryota;SAR;Stramenopiles;Ochrophyta;Diatomea;Bacillariophytina;Bacillariophyceae;Psammodictyon;";"100.0";"14.4";"3";"3";"3";"0";"0";"457180";"391204"
"V4mis2";"SILVA (only NR);Eukaryota;SAR;Stramenopiles;Ochrophyta;Diatomea;Bacillariophytina;Bacillariophyceae;Pseudo-nitzschia;";"100.0";"14.4";"31";"12";"12";"0";"19";"457171";"391195"
"V4mis2";"SILVA (only NR);Eukaryota;SAR;Stramenopiles;Ochrophyta;Diatomea;Bacillariophytina;Bacillariophyceae;Reimeria;";"100.0";"14.4";"1";"1";"1";"0";"0";"457182";"391206"
"V4mis2";"SILVA (only NR);Eukaryota;SAR;Stramenopiles;Ochrophyta;Diatomea;Bacillariophytina;Bacillariophyceae;Rhaphoneis;";"87.5";"14.4";"16";"16";"14";"2";"0";"457167";"391193"
"V4mis2";"SILVA (only NR);Eukaryota;SAR;Stramenopiles;Ochrophyta;Diatomea;Bacillariophytina;Bacillariophyceae;Rhoicosphenia;";"100.0";"14.4";"4";"4";"4";"0";"0";"457179";"391203"
"V4mis2";"SILVA (only NR);Eukaryota;SAR;Stramenopiles;Ochrophyta;Diatomea;Bacillariophytina;Bacillariophyceae;Rhopalodia;";"100.0";"14.4";"3";"3";"3";"0";"0";"457180";"391204"
"V4mis2";"SILVA (only NR);Eukaryota;SAR;Stramenopiles;Ochrophyta;Diatomea;Bacillariophytina;Bacillariophyceae;Scoliopleura;";"100.0";"14.4";"1";"1";"1";"0";"0";"457182";"391206"
"V4mis2";"SILVA (only NR);Eukaryota;SAR;Stramenopiles;Ochrophyta;Diatomea;Bacillariophytina;Bacillariophyceae;Sellaphoraceae;";"100.0";"14.4";"33";"30";"30";"0";"3";"457153";"391177"
"V4mis2";"SILVA (only NR);Eukaryota;SAR;Stramenopiles;Ochrophyta;Diatomea;Bacillariophytina;Bacillariophyceae;Sellaphoraceae;Eolimna;";"100.0";"14.4";"3";"3";"3";"0";"0";"457180";"391204"
"V4mis2";"SILVA (only NR);Eukaryota;SAR;Stramenopiles;Ochrophyta;Diatomea;Bacillariophytina;Bacillariophyceae;Sellaphoraceae;Fallacia;";"100.0";"14.4";"4";"4";"4";"0";"0";"457179";"391203"
"V4mis2";"SILVA (only NR);Eukaryota;SAR;Stramenopiles;Ochrophyta;Diatomea;Bacillariophytina;Bacillariophyceae;Sellaphoraceae;Sellaphora;";"100.0";"14.4";"17";"17";"17";"0";"0";"457166";"391190"
"V4mis2";"SILVA (only NR);Eukaryota;SAR;Stramenopiles;Ochrophyta;Diatomea;Bacillariophytina;Bacillariophyceae;Stauroneis;";"100.0";"14.4";"4";"4";"4";"0";"0";"457179";"391203"
"V4mis2";"SILVA (only NR);Eukaryota;SAR;Stramenopiles;Ochrophyta;Diatomea;Bacillariophytina;Bacillariophyceae;Staurotropis;";"100.0";"14.4";"1";"1";"1";"0";"0";"457182";"391206"
"V4mis2";"SILVA (only NR);Eukaryota;SAR;Stramenopiles;Ochrophyta;Diatomea;Bacillariophytina;Bacillariophyceae;Stenopterobia;";"100.0";"14.4";"2";"2";"2";"0";"0";"457181";"391205"
"V4mis2";"SILVA (only NR);Eukaryota;SAR;Stramenopiles;Ochrophyta;Diatomea;Bacillariophytina;Bacillariophyceae;Surirella;";"83.3";"14.4";"18";"18";"15";"3";"0";"457165";"391192"
"V4mis2";"SILVA (only NR);Eukaryota;SAR;Stramenopiles;Ochrophyta;Diatomea;Bacillariophytina;Bacillariophyceae;Thalassiophysa;";"100.0";"14.4";"1";"1";"1";"0";"0";"457182";"391206"
"V4mis2";"SILVA (only NR);Eukaryota;SAR;Stramenopiles;Ochrophyta;Diatomea;Bacillariophytina;Bacillariophyceae;Tryblionella;";"100.0";"14.4";"2";"2";"2";"0";"0";"457181";"391205"
"V4mis2";"SILVA (only NR);Eukaryota;SAR;Stramenopiles;Ochrophyta;Diatomea;Bacillariophytina;Bacillariophyceae;Undatella;";"100.0";"14.4";"2";"2";"2";"0";"0";"457181";"391205"
"V4mis2";"SILVA (only NR);Eukaryota;SAR;Stramenopiles;Ochrophyta;Diatomea;Bacillariophytina;Bacillariophyceae;uncultured;";"88.9";"14.4";"9";"9";"8";"1";"0";"457174";"391199"
"V4mis2";"SILVA (only NR);Eukaryota;SAR;Stramenopiles;Ochrophyta;Diatomea;Bacillariophytina;Mediophyceae;";"89.6";"14.4";"383";"345";"309";"36";"38";"456838";"390898"
"V4mis2";"SILVA (only NR);Eukaryota;SAR;Stramenopiles;Ochrophyta;Diatomea;Bacillariophytina;Mediophyceae;Arcocellulus;";"0.0";"0";"12";"8";"0";"8";"4";"457175";"391207"
"V4mis2";"SILVA (only NR);Eukaryota;SAR;Stramenopiles;Ochrophyta;Diatomea;Bacillariophytina;Mediophyceae;Attheya;";"100.0";"14.4";"2";"2";"2";"0";"0";"457181";"391205"
"V4mis2";"SILVA (only NR);Eukaryota;SAR;Stramenopiles;Ochrophyta;Diatomea;Bacillariophytina;Mediophyceae;Bellerochea;";"100.0";"14.4";"5";"5";"5";"0";"0";"457178";"391202"
"V4mis2";"SILVA (only NR);Eukaryota;SAR;Stramenopiles;Ochrophyta;Diatomea;Bacillariophytina;Mediophyceae;Biddulphia;";"100.0";"14.4";"2";"2";"2";"0";"0";"457181";"391205"
"V4mis2";"SILVA (only NR);Eukaryota;SAR;Stramenopiles;Ochrophyta;Diatomea;Bacillariophytina;Mediophyceae;Biddulphiopsis;";"100.0";"14.4";"7";"7";"7";"0";"0";"457176";"391200"
"V4mis2";"SILVA (only NR);Eukaryota;SAR;Stramenopiles;Ochrophyta;Diatomea;Bacillariophytina;Mediophyceae;Brockmanniella;";"100.0";"14.4";"2";"2";"2";"0";"0";"457181";"391205"
"V4mis2";"SILVA (only NR);Eukaryota;SAR;Stramenopiles;Ochrophyta;Diatomea;Bacillariophytina;Mediophyceae;Campylosira;";"100.0";"14.4";"1";"1";"1";"0";"0";"457182";"391206"
"V4mis2";"SILVA (only NR);Eukaryota;SAR;Stramenopiles;Ochrophyta;Diatomea;Bacillariophytina;Mediophyceae;Cerataulina;";"100.0";"14.4";"2";"2";"2";"0";"0";"457181";"391205"
"V4mis2";"SILVA (only NR);Eukaryota;SAR;Stramenopiles;Ochrophyta;Diatomea;Bacillariophytina;Mediophyceae;Chaetoceros;";"85.7";"14.4";"86";"77";"66";"11";"9";"457106";"391141"
"V4mis2";"SILVA (only NR);Eukaryota;SAR;Stramenopiles;Ochrophyta;Diatomea;Bacillariophytina;Mediophyceae;Cyclotella;";"90.0";"14.4";"20";"20";"18";"2";"0";"457163";"391189"
"V4mis2";"SILVA (only NR);Eukaryota;SAR;Stramenopiles;Ochrophyta;Diatomea;Bacillariophytina;Mediophyceae;Cymatosira;";"100.0";"14.4";"2";"2";"2";"0";"0";"457181";"391205"
"V4mis2";"SILVA (only NR);Eukaryota;SAR;Stramenopiles;Ochrophyta;Diatomea;Bacillariophytina;Mediophyceae;Dimeregramma;";"75.0";"14.4";"4";"4";"3";"1";"0";"457179";"391204"
"V4mis2";"SILVA (only NR);Eukaryota;SAR;Stramenopiles;Ochrophyta;Diatomea;Bacillariophytina;Mediophyceae;Discostella;";"100.0";"14.4";"3";"3";"3";"0";"0";"457180";"391204"
"V4mis2";"SILVA (only NR);Eukaryota;SAR;Stramenopiles;Ochrophyta;Diatomea;Bacillariophytina;Mediophyceae;Ditylum;";"100.0";"14.4";"2";"2";"2";"0";"0";"457181";"391205"
"V4mis2";"SILVA (only NR);Eukaryota;SAR;Stramenopiles;Ochrophyta;Diatomea;Bacillariophytina;Mediophyceae;Eucampia;";"0.0";"0";"2";"1";"0";"1";"1";"457182";"391207"
"V4mis2";"SILVA (only NR);Eukaryota;SAR;Stramenopiles;Ochrophyta;Diatomea;Bacillariophytina;Mediophyceae;Eunotogramma;";"100.0";"14.4";"1";"1";"1";"0";"0";"457182";"391206"
"V4mis2";"SILVA (only NR);Eukaryota;SAR;Stramenopiles;Ochrophyta;Diatomea;Bacillariophytina;Mediophyceae;Extubocellulus;";"100.0";"14.4";"1";"1";"1";"0";"0";"457182";"391206"
"V4mis2";"SILVA (only NR);Eukaryota;SAR;Stramenopiles;Ochrophyta;Diatomea;Bacillariophytina;Mediophyceae;Helicotheca;";"100.0";"14.4";"2";"2";"2";"0";"0";"457181";"391205"
"V4mis2";"SILVA (only NR);Eukaryota;SAR;Stramenopiles;Ochrophyta;Diatomea;Bacillariophytina;Mediophyceae;Hemiaulus;";"100.0";"14.4";"1";"1";"1";"0";"0";"457182";"391206"
"V4mis2";"SILVA (only NR);Eukaryota;SAR;Stramenopiles;Ochrophyta;Diatomea;Bacillariophytina;Mediophyceae;Isthmia;";"100.0";"14.4";"1";"1";"1";"0";"0";"457182";"391206"
"V4mis2";"SILVA (only NR);Eukaryota;SAR;Stramenopiles;Ochrophyta;Diatomea;Bacillariophytina;Mediophyceae;Lambertocellus;";"100.0";"14.4";"1";"1";"1";"0";"0";"457182";"391206"
"V4mis2";"SILVA (only NR);Eukaryota;SAR;Stramenopiles;Ochrophyta;Diatomea;Bacillariophytina;Mediophyceae;Lampriscus;";"100.0";"14.4";"3";"3";"3";"0";"0";"457180";"391204"
"V4mis2";"SILVA (only NR);Eukaryota;SAR;Stramenopiles;Ochrophyta;Diatomea;Bacillariophytina;Mediophyceae;Lauderia;";"50.0";"14.4";"2";"2";"1";"1";"0";"457181";"391206"
"V4mis2";"SILVA (only NR);Eukaryota;SAR;Stramenopiles;Ochrophyta;Diatomea;Bacillariophytina;Mediophyceae;Leyanella;";"100.0";"14.4";"2";"2";"2";"0";"0";"457181";"391205"
"V4mis2";"SILVA (only NR);Eukaryota;SAR;Stramenopiles;Ochrophyta;Diatomea;Bacillariophytina;Mediophyceae;Lithodesmium;";"100.0";"14.4";"2";"2";"2";"0";"0";"457181";"391205"
"V4mis2";"SILVA (only NR);Eukaryota;SAR;Stramenopiles;Ochrophyta;Diatomea;Bacillariophytina;Mediophyceae;Mastodiscus;";"100.0";"14.4";"1";"1";"1";"0";"0";"457182";"391206"
"V4mis2";"SILVA (only NR);Eukaryota;SAR;Stramenopiles;Ochrophyta;Diatomea;Bacillariophytina;Mediophyceae;Mediopyxis;";"100.0";"14.4";"1";"1";"1";"0";"0";"457182";"391206"
"V4mis2";"SILVA (only NR);Eukaryota;SAR;Stramenopiles;Ochrophyta;Diatomea;Bacillariophytina;Mediophyceae;Minidiscus;";"100.0";"14.4";"1";"1";"1";"0";"0";"457182";"391206"
"V4mis2";"SILVA (only NR);Eukaryota;SAR;Stramenopiles;Ochrophyta;Diatomea;Bacillariophytina;Mediophyceae;Minutocellus;";"0.0";"0";"3";"3";"0";"3";"0";"457180";"391207"
"V4mis2";"SILVA (only NR);Eukaryota;SAR;Stramenopiles;Ochrophyta;Diatomea;Bacillariophytina;Mediophyceae;Odontella;";"100.0";"14.4";"8";"8";"8";"0";"0";"457175";"391199"
"V4mis2";"SILVA (only NR);Eukaryota;SAR;Stramenopiles;Ochrophyta;Diatomea;Bacillariophytina;Mediophyceae;Papiliocellulus;";"66.7";"14.4";"3";"3";"2";"1";"0";"457180";"391205"
"V4mis2";"SILVA (only NR);Eukaryota;SAR;Stramenopiles;Ochrophyta;Diatomea;Bacillariophytina;Mediophyceae;Plagiogramma;";"100.0";"14.4";"2";"2";"2";"0";"0";"457181";"391205"
"V4mis2";"SILVA (only NR);Eukaryota;SAR;Stramenopiles;Ochrophyta;Diatomea;Bacillariophytina;Mediophyceae;Plagiogrammopsis;";"100.0";"14.4";"1";"1";"1";"0";"0";"457182";"391206"
"V4mis2";"SILVA (only NR);Eukaryota;SAR;Stramenopiles;Ochrophyta;Diatomea;Bacillariophytina;Mediophyceae;Planktoniella;";"100.0";"14.4";"1";"1";"1";"0";"0";"457182";"391206"
"V4mis2";"SILVA (only NR);Eukaryota;SAR;Stramenopiles;Ochrophyta;Diatomea;Bacillariophytina;Mediophyceae;Pleurosira;";"100.0";"14.4";"2";"2";"2";"0";"0";"457181";"391205"
"V4mis2";"SILVA (only NR);Eukaryota;SAR;Stramenopiles;Ochrophyta;Diatomea;Bacillariophytina;Mediophyceae;Porosira;";"100.0";"14.4";"4";"4";"4";"0";"0";"457179";"391203"
"V4mis2";"SILVA (only NR);Eukaryota;SAR;Stramenopiles;Ochrophyta;Diatomea;Bacillariophytina;Mediophyceae;Psammogramma;";"0.0";"0";"1";"1";"0";"1";"0";"457182";"391207"
"V4mis2";"SILVA (only NR);Eukaryota;SAR;Stramenopiles;Ochrophyta;Diatomea;Bacillariophytina;Mediophyceae;Psammoneis;";"100.0";"14.4";"1";"1";"1";"0";"0";"457182";"391206"
"V4mis2";"SILVA (only NR);Eukaryota;SAR;Stramenopiles;Ochrophyta;Diatomea;Bacillariophytina;Mediophyceae;Roundia;";"100.0";"14.4";"2";"2";"2";"0";"0";"457181";"391205"
"V4mis2";"SILVA (only NR);Eukaryota;SAR;Stramenopiles;Ochrophyta;Diatomea;Bacillariophytina;Mediophyceae;Skeletonema;";"96.6";"14.4";"40";"29";"28";"1";"11";"457154";"391179"
"V4mis2";"SILVA (only NR);Eukaryota;SAR;Stramenopiles;Ochrophyta;Diatomea;Bacillariophytina;Mediophyceae;Stephanodiscus;";"100.0";"14.4";"4";"4";"4";"0";"0";"457179";"391203"
"V4mis2";"SILVA (only NR);Eukaryota;SAR;Stramenopiles;Ochrophyta;Diatomea;Bacillariophytina;Mediophyceae;Talaroneis;";"100.0";"14.4";"1";"1";"1";"0";"0";"457182";"391206"
"V4mis2";"SILVA (only NR);Eukaryota;SAR;Stramenopiles;Ochrophyta;Diatomea;Bacillariophytina;Mediophyceae;Terpsinoe;";"100.0";"14.4";"2";"2";"2";"0";"0";"457181";"391205"
"V4mis2";"SILVA (only NR);Eukaryota;SAR;Stramenopiles;Ochrophyta;Diatomea;Bacillariophytina;Mediophyceae;Thalassiosira;";"95.2";"14.4";"97";"84";"80";"4";"13";"457099";"391127"
"V4mis2";"SILVA (only NR);Eukaryota;SAR;Stramenopiles;Ochrophyta;Diatomea;Bacillariophytina;Mediophyceae;Toxarium;";"100.0";"14.4";"2";"2";"2";"0";"0";"457181";"391205"
"V4mis2";"SILVA (only NR);Eukaryota;SAR;Stramenopiles;Ochrophyta;Diatomea;Bacillariophytina;Mediophyceae;Triceratium;";"100.0";"14.4";"5";"5";"5";"0";"0";"457178";"391202"
"V4mis2";"SILVA (only NR);Eukaryota;SAR;Stramenopiles;Ochrophyta;Diatomea;Bacillariophytina;Mediophyceae;uncultured;";"100.0";"14.4";"6";"6";"6";"0";"0";"457177";"391201"
"V4mis2";"SILVA (only NR);Eukaryota;SAR;Stramenopiles;Ochrophyta;Diatomea;Coscinodiscophytina;";"94.9";"14.4";"256";"253";"240";"13";"3";"456930";"390967"
"V4mis2";"SILVA (only NR);Eukaryota;SAR;Stramenopiles;Ochrophyta;Diatomea;Coscinodiscophytina;Actinocyclus;";"100.0";"14.4";"8";"8";"8";"0";"0";"457175";"391199"
"V4mis2";"SILVA (only NR);Eukaryota;SAR;Stramenopiles;Ochrophyta;Diatomea;Coscinodiscophytina;Actinoptychus;";"100.0";"14.4";"3";"3";"3";"0";"0";"457180";"391204"
"V4mis2";"SILVA (only NR);Eukaryota;SAR;Stramenopiles;Ochrophyta;Diatomea;Coscinodiscophytina;Aulacodiscus;";"100.0";"14.4";"2";"2";"2";"0";"0";"457181";"391205"
"V4mis2";"SILVA (only NR);Eukaryota;SAR;Stramenopiles;Ochrophyta;Diatomea;Coscinodiscophytina;Corethrids;";"100.0";"14.4";"4";"4";"4";"0";"0";"457179";"391203"
"V4mis2";"SILVA (only NR);Eukaryota;SAR;Stramenopiles;Ochrophyta;Diatomea;Coscinodiscophytina;Corethrids;Corethron;";"100.0";"14.4";"4";"4";"4";"0";"0";"457179";"391203"
"V4mis2";"SILVA (only NR);Eukaryota;SAR;Stramenopiles;Ochrophyta;Diatomea;Coscinodiscophytina;Coscinodiscus;";"100.0";"14.4";"8";"8";"8";"0";"0";"457175";"391199"
"V4mis2";"SILVA (only NR);Eukaryota;SAR;Stramenopiles;Ochrophyta;Diatomea;Coscinodiscophytina;Fragilariales;";"94.5";"14.4";"166";"164";"155";"9";"2";"457019";"391052"
"V4mis2";"SILVA (only NR);Eukaryota;SAR;Stramenopiles;Ochrophyta;Diatomea;Coscinodiscophytina;Fragilariales;Ardissonea;";"100.0";"14.4";"2";"2";"2";"0";"0";"457181";"391205"
"V4mis2";"SILVA (only NR);Eukaryota;SAR;Stramenopiles;Ochrophyta;Diatomea;Coscinodiscophytina;Fragilariales;Astrosyne;";"100.0";"14.4";"1";"1";"1";"0";"0";"457182";"391206"
"V4mis2";"SILVA (only NR);Eukaryota;SAR;Stramenopiles;Ochrophyta;Diatomea;Coscinodiscophytina;Fragilariales;Berkeleya;";"100.0";"14.4";"1";"1";"1";"0";"0";"457182";"391206"
"V4mis2";"SILVA (only NR);Eukaryota;SAR;Stramenopiles;Ochrophyta;Diatomea;Coscinodiscophytina;Fragilariales;Catacombas;";"100.0";"14.4";"1";"1";"1";"0";"0";"457182";"391206"
"V4mis2";"SILVA (only NR);Eukaryota;SAR;Stramenopiles;Ochrophyta;Diatomea;Coscinodiscophytina;Fragilariales;Climacosphenia;";"100.0";"14.4";"1";"1";"1";"0";"0";"457182";"391206"
"V4mis2";"SILVA (only NR);Eukaryota;SAR;Stramenopiles;Ochrophyta;Diatomea;Coscinodiscophytina;Fragilariales;Cyclophora;";"100.0";"14.4";"5";"5";"5";"0";"0";"457178";"391202"
"V4mis2";"SILVA (only NR);Eukaryota;SAR;Stramenopiles;Ochrophyta;Diatomea;Coscinodiscophytina;Fragilariales;Falcula;";"100.0";"14.4";"1";"1";"1";"0";"0";"457182";"391206"
"V4mis2";"SILVA (only NR);Eukaryota;SAR;Stramenopiles;Ochrophyta;Diatomea;Coscinodiscophytina;Fragilariales;Florella;";"100.0";"14.4";"1";"1";"1";"0";"0";"457182";"391206"
"V4mis2";"SILVA (only NR);Eukaryota;SAR;Stramenopiles;Ochrophyta;Diatomea;Coscinodiscophytina;Fragilariales;Fragilaria;";"94.4";"14.4";"18";"18";"17";"1";"0";"457165";"391190"
"V4mis2";"SILVA (only NR);Eukaryota;SAR;Stramenopiles;Ochrophyta;Diatomea;Coscinodiscophytina;Fragilariales;Fragilariaceae;";"100.0";"14.4";"2";"2";"2";"0";"0";"457181";"391205"
"V4mis2";"SILVA (only NR);Eukaryota;SAR;Stramenopiles;Ochrophyta;Diatomea;Coscinodiscophytina;Fragilariales;Fragilariaceae;Perideraion;";"100.0";"14.4";"2";"2";"2";"0";"0";"457181";"391205"
"V4mis2";"SILVA (only NR);Eukaryota;SAR;Stramenopiles;Ochrophyta;Diatomea;Coscinodiscophytina;Fragilariales;Fragilariforma;";"100.0";"14.4";"1";"1";"1";"0";"0";"457182";"391206"
"V4mis2";"SILVA (only NR);Eukaryota;SAR;Stramenopiles;Ochrophyta;Diatomea;Coscinodiscophytina;Fragilariales;Gedaniella;";"100.0";"14.4";"1";"1";"1";"0";"0";"457182";"391206"
"V4mis2";"SILVA (only NR);Eukaryota;SAR;Stramenopiles;Ochrophyta;Diatomea;Coscinodiscophytina;Fragilariales;Grammatophora;";"100.0";"14.4";"3";"3";"3";"0";"0";"457180";"391204"
"V4mis2";"SILVA (only NR);Eukaryota;SAR;Stramenopiles;Ochrophyta;Diatomea;Coscinodiscophytina;Fragilariales;Grammonema;";"100.0";"14.4";"3";"3";"3";"0";"0";"457180";"391204"
"V4mis2";"SILVA (only NR);Eukaryota;SAR;Stramenopiles;Ochrophyta;Diatomea;Coscinodiscophytina;Fragilariales;Hanicella;";"100.0";"14.4";"1";"1";"1";"0";"0";"457182";"391206"
"V4mis2";"SILVA (only NR);Eukaryota;SAR;Stramenopiles;Ochrophyta;Diatomea;Coscinodiscophytina;Fragilariales;Hyalosira;";"100.0";"14.4";"5";"5";"5";"0";"0";"457178";"391202"
"V4mis2";"SILVA (only NR);Eukaryota;SAR;Stramenopiles;Ochrophyta;Diatomea;Coscinodiscophytina;Fragilariales;Hyalosynedra;";"100.0";"14.4";"2";"2";"2";"0";"0";"457181";"391205"
"V4mis2";"SILVA (only NR);Eukaryota;SAR;Stramenopiles;Ochrophyta;Diatomea;Coscinodiscophytina;Fragilariales;Licmophora;";"96.6";"14.4";"29";"29";"28";"1";"0";"457154";"391179"
"V4mis2";"SILVA (only NR);Eukaryota;SAR;Stramenopiles;Ochrophyta;Diatomea;Coscinodiscophytina;Fragilariales;Licmosphenia;";"100.0";"14.4";"1";"1";"1";"0";"0";"457182";"391206"
"V4mis2";"SILVA (only NR);Eukaryota;SAR;Stramenopiles;Ochrophyta;Diatomea;Coscinodiscophytina;Fragilariales;Lucanicum;";"100.0";"14.4";"1";"1";"1";"0";"0";"457182";"391206"
"V4mis2";"SILVA (only NR);Eukaryota;SAR;Stramenopiles;Ochrophyta;Diatomea;Coscinodiscophytina;Fragilariales;Mastogloia;";"100.0";"14.4";"1";"1";"1";"0";"0";"457182";"391206"
"V4mis2";"SILVA (only NR);Eukaryota;SAR;Stramenopiles;Ochrophyta;Diatomea;Coscinodiscophytina;Fragilariales;Microtabella;";"100.0";"14.4";"2";"2";"2";"0";"0";"457181";"391205"
"V4mis2";"SILVA (only NR);Eukaryota;SAR;Stramenopiles;Ochrophyta;Diatomea;Coscinodiscophytina;Fragilariales;Nanofrustulum;";"100.0";"14.4";"3";"3";"3";"0";"0";"457180";"391204"
"V4mis2";"SILVA (only NR);Eukaryota;SAR;Stramenopiles;Ochrophyta;Diatomea;Coscinodiscophytina;Fragilariales;Opephora;";"100.0";"14.4";"1";"1";"1";"0";"0";"457182";"391206"
"V4mis2";"SILVA (only NR);Eukaryota;SAR;Stramenopiles;Ochrophyta;Diatomea;Coscinodiscophytina;Fragilariales;Plagiostriata;";"100.0";"14.4";"3";"3";"3";"0";"0";"457180";"391204"
"V4mis2";"SILVA (only NR);Eukaryota;SAR;Stramenopiles;Ochrophyta;Diatomea;Coscinodiscophytina;Fragilariales;Podocystis;";"100.0";"14.4";"2";"2";"2";"0";"0";"457181";"391205"
"V4mis2";"SILVA (only NR);Eukaryota;SAR;Stramenopiles;Ochrophyta;Diatomea;Coscinodiscophytina;Fragilariales;Protoraphis;";"100.0";"14.4";"2";"2";"2";"0";"0";"457181";"391205"
"V4mis2";"SILVA (only NR);Eukaryota;SAR;Stramenopiles;Ochrophyta;Diatomea;Coscinodiscophytina;Fragilariales;Pseudohimantidium;";"100.0";"14.4";"1";"1";"1";"0";"0";"457182";"391206"
"V4mis2";"SILVA (only NR);Eukaryota;SAR;Stramenopiles;Ochrophyta;Diatomea;Coscinodiscophytina;Fragilariales;Pseudostaurosira;";"100.0";"14.4";"1";"1";"1";"0";"0";"457182";"391206"
"V4mis2";"SILVA (only NR);Eukaryota;SAR;Stramenopiles;Ochrophyta;Diatomea;Coscinodiscophytina;Fragilariales;Pseudostriatella;";"100.0";"14.4";"1";"1";"1";"0";"0";"457182";"391206"
"V4mis2";"SILVA (only NR);Eukaryota;SAR;Stramenopiles;Ochrophyta;Diatomea;Coscinodiscophytina;Fragilariales;Pteroncola;";"100.0";"14.4";"1";"1";"1";"0";"0";"457182";"391206"
"V4mis2";"SILVA (only NR);Eukaryota;SAR;Stramenopiles;Ochrophyta;Diatomea;Coscinodiscophytina;Fragilariales;Rhabdonema;";"75.0";"14.4";"4";"4";"3";"1";"0";"457179";"391204"
"V4mis2";"SILVA (only NR);Eukaryota;SAR;Stramenopiles;Ochrophyta;Diatomea;Coscinodiscophytina;Fragilariales;Serratifera;";"100.0";"14.4";"6";"6";"6";"0";"0";"457177";"391201"
"V4mis2";"SILVA (only NR);Eukaryota;SAR;Stramenopiles;Ochrophyta;Diatomea;Coscinodiscophytina;Fragilariales;Stauroforma;";"100.0";"14.4";"1";"1";"1";"0";"0";"457182";"391206"
"V4mis2";"SILVA (only NR);Eukaryota;SAR;Stramenopiles;Ochrophyta;Diatomea;Coscinodiscophytina;Fragilariales;Staurosira;";"92.9";"14.4";"14";"14";"13";"1";"0";"457169";"391194"
"V4mis2";"SILVA (only NR);Eukaryota;SAR;Stramenopiles;Ochrophyta;Diatomea;Coscinodiscophytina;Fragilariales;Striatella;";"100.0";"14.4";"2";"2";"2";"0";"0";"457181";"391205"
"V4mis2";"SILVA (only NR);Eukaryota;SAR;Stramenopiles;Ochrophyta;Diatomea;Coscinodiscophytina;Fragilariales;Synedra;";"100.0";"14.4";"2";"2";"2";"0";"0";"457181";"391205"
"V4mis2";"SILVA (only NR);Eukaryota;SAR;Stramenopiles;Ochrophyta;Diatomea;Coscinodiscophytina;Fragilariales;Synedropsis;";"0.0";"0";"1";"1";"0";"1";"0";"457182";"391207"
"V4mis2";"SILVA (only NR);Eukaryota;SAR;Stramenopiles;Ochrophyta;Diatomea;Coscinodiscophytina;Fragilariales;Tabularia;";"100.0";"14.4";"1";"1";"1";"0";"0";"457182";"391206"
"V4mis2";"SILVA (only NR);Eukaryota;SAR;Stramenopiles;Ochrophyta;Diatomea;Coscinodiscophytina;Fragilariales;Thalassionema;";"85.7";"14.4";"7";"7";"6";"1";"0";"457176";"391201"
"V4mis2";"SILVA (only NR);Eukaryota;SAR;Stramenopiles;Ochrophyta;Diatomea;Coscinodiscophytina;Fragilariales;Ulnaria;";"83.3";"14.4";"6";"6";"5";"1";"0";"457177";"391202"
"V4mis2";"SILVA (only NR);Eukaryota;SAR;Stramenopiles;Ochrophyta;Diatomea;Coscinodiscophytina;Melosirids;";"96.3";"14.4";"27";"27";"26";"1";"0";"457156";"391181"
"V4mis2";"SILVA (only NR);Eukaryota;SAR;Stramenopiles;Ochrophyta;Diatomea;Coscinodiscophytina;Melosirids;Aulacoseira;";"92.9";"14.4";"14";"14";"13";"1";"0";"457169";"391194"
"V4mis2";"SILVA (only NR);Eukaryota;SAR;Stramenopiles;Ochrophyta;Diatomea;Coscinodiscophytina;Melosirids;Endictya;";"100.0";"14.4";"1";"1";"1";"0";"0";"457182";"391206"
"V4mis2";"SILVA (only NR);Eukaryota;SAR;Stramenopiles;Ochrophyta;Diatomea;Coscinodiscophytina;Melosirids;Hyalodiscus;";"100.0";"14.4";"2";"2";"2";"0";"0";"457181";"391205"
"V4mis2";"SILVA (only NR);Eukaryota;SAR;Stramenopiles;Ochrophyta;Diatomea;Coscinodiscophytina;Melosirids;Melosira;";"100.0";"14.4";"4";"4";"4";"0";"0";"457179";"391203"
"V4mis2";"SILVA (only NR);Eukaryota;SAR;Stramenopiles;Ochrophyta;Diatomea;Coscinodiscophytina;Melosirids;Paralia;";"100.0";"14.4";"3";"3";"3";"0";"0";"457180";"391204"
"V4mis2";"SILVA (only NR);Eukaryota;SAR;Stramenopiles;Ochrophyta;Diatomea;Coscinodiscophytina;Melosirids;Stephanopyxis;";"100.0";"14.4";"2";"2";"2";"0";"0";"457181";"391205"
"V4mis2";"SILVA (only NR);Eukaryota;SAR;Stramenopiles;Ochrophyta;Diatomea;Coscinodiscophytina;Palmerina;";"100.0";"14.4";"2";"2";"2";"0";"0";"457181";"391205"
"V4mis2";"SILVA (only NR);Eukaryota;SAR;Stramenopiles;Ochrophyta;Diatomea;Coscinodiscophytina;Rhizosolenids;";"100.0";"14.4";"28";"27";"27";"0";"1";"457156";"391180"
"V4mis2";"SILVA (only NR);Eukaryota;SAR;Stramenopiles;Ochrophyta;Diatomea;Coscinodiscophytina;Rhizosolenids;Guinardia;";"100.0";"14.4";"6";"5";"5";"0";"1";"457178";"391202"
"V4mis2";"SILVA (only NR);Eukaryota;SAR;Stramenopiles;Ochrophyta;Diatomea;Coscinodiscophytina;Rhizosolenids;Leptocylindrus;";"100.0";"14.4";"4";"4";"4";"0";"0";"457179";"391203"
"V4mis2";"SILVA (only NR);Eukaryota;SAR;Stramenopiles;Ochrophyta;Diatomea;Coscinodiscophytina;Rhizosolenids;Proboscia;";"100.0";"14.4";"5";"5";"5";"0";"0";"457178";"391202"
"V4mis2";"SILVA (only NR);Eukaryota;SAR;Stramenopiles;Ochrophyta;Diatomea;Coscinodiscophytina;Rhizosolenids;Pseudosolenia;";"100.0";"14.4";"2";"2";"2";"0";"0";"457181";"391205"
"V4mis2";"SILVA (only NR);Eukaryota;SAR;Stramenopiles;Ochrophyta;Diatomea;Coscinodiscophytina;Rhizosolenids;Rhizosolenia;";"100.0";"14.4";"6";"6";"6";"0";"0";"457177";"391201"
"V4mis2";"SILVA (only NR);Eukaryota;SAR;Stramenopiles;Ochrophyta;Diatomea;Coscinodiscophytina;Rhizosolenids;Tenuicylindrus;";"100.0";"14.4";"1";"1";"1";"0";"0";"457182";"391206"
"V4mis2";"SILVA (only NR);Eukaryota;SAR;Stramenopiles;Ochrophyta;Diatomea;Coscinodiscophytina;uncultured;";"0.0";"0";"3";"3";"0";"3";"0";"457180";"391207"
"V4mis2";"SILVA (only NR);Eukaryota;SAR;Stramenopiles;Ochrophyta;Diatomea;ME-Euk-FW10;";"81.0";"14.4";"22";"21";"17";"4";"1";"457162";"391190"
"V4mis2";"SILVA (only NR);Eukaryota;SAR;Stramenopiles;Ochrophyta;Dictyochophyceae;";"94.4";"14.4";"55";"54";"51";"3";"1";"457129";"391156"
"V4mis2";"SILVA (only NR);Eukaryota;SAR;Stramenopiles;Ochrophyta;Dictyochophyceae;Dictyochales;";"90.9";"14.4";"11";"11";"10";"1";"0";"457172";"391197"
"V4mis2";"SILVA (only NR);Eukaryota;SAR;Stramenopiles;Ochrophyta;Dictyochophyceae;Dictyochales;Dictyocha;";"100.0";"14.4";"5";"5";"5";"0";"0";"457178";"391202"
"V4mis2";"SILVA (only NR);Eukaryota;SAR;Stramenopiles;Ochrophyta;Dictyochophyceae;Dictyochales;Florenciella;";"83.3";"14.4";"6";"6";"5";"1";"0";"457177";"391202"
"V4mis2";"SILVA (only NR);Eukaryota;SAR;Stramenopiles;Ochrophyta;Dictyochophyceae;Florenciellales;";"100.0";"14.4";"2";"2";"2";"0";"0";"457181";"391205"
"V4mis2";"SILVA (only NR);Eukaryota;SAR;Stramenopiles;Ochrophyta;Dictyochophyceae;Florenciellales;Pseudochattonella;";"100.0";"14.4";"2";"2";"2";"0";"0";"457181";"391205"
"V4mis2";"SILVA (only NR);Eukaryota;SAR;Stramenopiles;Ochrophyta;Dictyochophyceae;Pedinellales;";"96.8";"14.4";"31";"31";"30";"1";"0";"457152";"391177"
"V4mis2";"SILVA (only NR);Eukaryota;SAR;Stramenopiles;Ochrophyta;Dictyochophyceae;Pedinellales;Ciliophrys;";"100.0";"14.4";"3";"3";"3";"0";"0";"457180";"391204"
"V4mis2";"SILVA (only NR);Eukaryota;SAR;Stramenopiles;Ochrophyta;Dictyochophyceae;Pedinellales;FV36-2G08;";"75.0";"14.4";"4";"4";"3";"1";"0";"457179";"391204"
"V4mis2";"SILVA (only NR);Eukaryota;SAR;Stramenopiles;Ochrophyta;Dictyochophyceae;Pedinellales;Helicopedinella;";"100.0";"14.4";"1";"1";"1";"0";"0";"457182";"391206"
"V4mis2";"SILVA (only NR);Eukaryota;SAR;Stramenopiles;Ochrophyta;Dictyochophyceae;Pedinellales;Pedinella;";"100.0";"14.4";"2";"2";"2";"0";"0";"457181";"391205"
"V4mis2";"SILVA (only NR);Eukaryota;SAR;Stramenopiles;Ochrophyta;Dictyochophyceae;Pedinellales;Pseudopedinella;";"100.0";"14.4";"6";"6";"6";"0";"0";"457177";"391201"
"V4mis2";"SILVA (only NR);Eukaryota;SAR;Stramenopiles;Ochrophyta;Dictyochophyceae;Pedinellales;Pteridomonas;";"100.0";"14.4";"6";"6";"6";"0";"0";"457177";"391201"
"V4mis2";"SILVA (only NR);Eukaryota;SAR;Stramenopiles;Ochrophyta;Dictyochophyceae;Rhizochromulinales;";"100.0";"14.4";"3";"3";"3";"0";"0";"457180";"391204"
"V4mis2";"SILVA (only NR);Eukaryota;SAR;Stramenopiles;Ochrophyta;Dictyochophyceae;Rhizochromulinales;Rhizochromulina;";"100.0";"14.4";"3";"3";"3";"0";"0";"457180";"391204"
"V4mis2";"SILVA (only NR);Eukaryota;SAR;Stramenopiles;Ochrophyta;Eustigmatophyceae;";"92.7";"14.4";"56";"55";"51";"4";"1";"457128";"391156"
"V4mis2";"SILVA (only NR);Eukaryota;SAR;Stramenopiles;Ochrophyta;Eustigmatophyceae;Eustigmatales;";"92.7";"14.4";"56";"55";"51";"4";"1";"457128";"391156"
"V4mis2";"SILVA (only NR);Eukaryota;SAR;Stramenopiles;Ochrophyta;Eustigmatophyceae;Eustigmatales;Characiopsis;";"100.0";"14.4";"1";"1";"1";"0";"0";"457182";"391206"
"V4mis2";"SILVA (only NR);Eukaryota;SAR;Stramenopiles;Ochrophyta;Eustigmatophyceae;Eustigmatales;Chlorobotrys;";"100.0";"14.4";"1";"1";"1";"0";"0";"457182";"391206"
"V4mis2";"SILVA (only NR);Eukaryota;SAR;Stramenopiles;Ochrophyta;Eustigmatophyceae;Eustigmatales;Goniochloris;";"100.0";"14.4";"5";"5";"5";"0";"0";"457178";"391202"
"V4mis2";"SILVA (only NR);Eukaryota;SAR;Stramenopiles;Ochrophyta;Eustigmatophyceae;Eustigmatales;Monodus;";"100.0";"14.4";"1";"1";"1";"0";"0";"457182";"391206"
"V4mis2";"SILVA (only NR);Eukaryota;SAR;Stramenopiles;Ochrophyta;Eustigmatophyceae;Eustigmatales;Nannochloropsis;";"78.6";"14.4";"15";"14";"11";"3";"1";"457169";"391196"
"V4mis2";"SILVA (only NR);Eukaryota;SAR;Stramenopiles;Ochrophyta;Eustigmatophyceae;Eustigmatales;Pseudocharaciopsis;";"100.0";"14.4";"2";"2";"2";"0";"0";"457181";"391205"
"V4mis2";"SILVA (only NR);Eukaryota;SAR;Stramenopiles;Ochrophyta;Eustigmatophyceae;Eustigmatales;Pseudostaurastrum;";"100.0";"14.4";"4";"4";"4";"0";"0";"457179";"391203"
"V4mis2";"SILVA (only NR);Eukaryota;SAR;Stramenopiles;Ochrophyta;Eustigmatophyceae;Eustigmatales;Tetraedriella;";"100.0";"14.4";"1";"1";"1";"0";"0";"457182";"391206"
"V4mis2";"SILVA (only NR);Eukaryota;SAR;Stramenopiles;Ochrophyta;Eustigmatophyceae;Eustigmatales;Trachydiscus;";"100.0";"14.4";"2";"2";"2";"0";"0";"457181";"391205"
"V4mis2";"SILVA (only NR);Eukaryota;SAR;Stramenopiles;Ochrophyta;Eustigmatophyceae;Eustigmatales;Vacuoliviride;";"100.0";"14.4";"1";"1";"1";"0";"0";"457182";"391206"
"V4mis2";"SILVA (only NR);Eukaryota;SAR;Stramenopiles;Ochrophyta;Eustigmatophyceae;Eustigmatales;Vischeria;";"100.0";"14.4";"1";"1";"1";"0";"0";"457182";"391206"
"V4mis2";"SILVA (only NR);Eukaryota;SAR;Stramenopiles;Ochrophyta;Eustigmatophyceae;Eustigmatales;phytoplankton;";"100.0";"14.4";"1";"1";"1";"0";"0";"457182";"391206"
"V4mis2";"SILVA (only NR);Eukaryota;SAR;Stramenopiles;Ochrophyta;Eustigmatophyceae;Eustigmatales;uncultured;";"85.7";"14.4";"7";"7";"6";"1";"0";"457176";"391201"
"V4mis2";"SILVA (only NR);Eukaryota;SAR;Stramenopiles;Ochrophyta;Incertae Sedis;";"100.0";"14.4";"1";"1";"1";"0";"0";"457182";"391206"
"V4mis2";"SILVA (only NR);Eukaryota;SAR;Stramenopiles;Ochrophyta;Incertae Sedis;Picophagus;";"100.0";"14.4";"1";"1";"1";"0";"0";"457182";"391206"
"V4mis2";"SILVA (only NR);Eukaryota;SAR;Stramenopiles;Ochrophyta;MOCH-2;";"75.0";"14.4";"4";"4";"3";"1";"0";"457179";"391204"
"V4mis2";"SILVA (only NR);Eukaryota;SAR;Stramenopiles;Ochrophyta;Pelagophyceae;";"97.4";"14.4";"38";"38";"37";"1";"0";"457145";"391170"
"V4mis2";"SILVA (only NR);Eukaryota;SAR;Stramenopiles;Ochrophyta;Pelagophyceae;Pelagomonadales;";"88.9";"14.4";"9";"9";"8";"1";"0";"457174";"391199"
"V4mis2";"SILVA (only NR);Eukaryota;SAR;Stramenopiles;Ochrophyta;Pelagophyceae;Pelagomonadales;Aureococcus;";"80.0";"14.4";"5";"5";"4";"1";"0";"457178";"391203"
"V4mis2";"SILVA (only NR);Eukaryota;SAR;Stramenopiles;Ochrophyta;Pelagophyceae;Pelagomonadales;Pelagomonas;";"100.0";"14.4";"1";"1";"1";"0";"0";"457182";"391206"
"V4mis2";"SILVA (only NR);Eukaryota;SAR;Stramenopiles;Ochrophyta;Pelagophyceae;Sarcinochrysidales;";"100.0";"14.4";"27";"27";"27";"0";"0";"457156";"391180"
"V4mis2";"SILVA (only NR);Eukaryota;SAR;Stramenopiles;Ochrophyta;Pelagophyceae;Sarcinochrysidales;Andersenia;";"100.0";"14.4";"1";"1";"1";"0";"0";"457182";"391206"
"V4mis2";"SILVA (only NR);Eukaryota;SAR;Stramenopiles;Ochrophyta;Pelagophyceae;Sarcinochrysidales;Ankylochrisis;";"100.0";"14.4";"6";"6";"6";"0";"0";"457177";"391201"
"V4mis2";"SILVA (only NR);Eukaryota;SAR;Stramenopiles;Ochrophyta;Pelagophyceae;Sarcinochrysidales;Aureoumbra;";"100.0";"14.4";"6";"6";"6";"0";"0";"457177";"391201"
"V4mis2";"SILVA (only NR);Eukaryota;SAR;Stramenopiles;Ochrophyta;Pelagophyceae;Sarcinochrysidales;Chrysophaeum;";"100.0";"14.4";"1";"1";"1";"0";"0";"457182";"391206"
"V4mis2";"SILVA (only NR);Eukaryota;SAR;Stramenopiles;Ochrophyta;Pelagophyceae;Sarcinochrysidales;SS1-E01-69;";"100.0";"14.4";"4";"4";"4";"0";"0";"457179";"391203"
"V4mis2";"SILVA (only NR);Eukaryota;SAR;Stramenopiles;Ochrophyta;Pelagophyceae;Sarcinochrysidales;Sarcinochrysis;";"100.0";"14.4";"5";"5";"5";"0";"0";"457178";"391202"
"V4mis2";"SILVA (only NR);Eukaryota;SAR;Stramenopiles;Ochrophyta;Phaeophyceae;";"98.5";"14.4";"66";"65";"64";"1";"1";"457118";"391143"
"V4mis2";"SILVA (only NR);Eukaryota;SAR;Stramenopiles;Ochrophyta;Phaeophyceae;Chorda;";"100.0";"14.4";"1";"1";"1";"0";"0";"457182";"391206"
"V4mis2";"SILVA (only NR);Eukaryota;SAR;Stramenopiles;Ochrophyta;Phaeophyceae;Desmarestiales;";"100.0";"14.4";"1";"1";"1";"0";"0";"457182";"391206"
"V4mis2";"SILVA (only NR);Eukaryota;SAR;Stramenopiles;Ochrophyta;Phaeophyceae;Desmarestiales;Desmarestia;";"100.0";"14.4";"1";"1";"1";"0";"0";"457182";"391206"
"V4mis2";"SILVA (only NR);Eukaryota;SAR;Stramenopiles;Ochrophyta;Phaeophyceae;Dictyotales;";"100.0";"14.4";"23";"23";"23";"0";"0";"457160";"391184"
"V4mis2";"SILVA (only NR);Eukaryota;SAR;Stramenopiles;Ochrophyta;Phaeophyceae;Dictyotales;Dictyopteris;";"100.0";"14.4";"2";"2";"2";"0";"0";"457181";"391205"
"V4mis2";"SILVA (only NR);Eukaryota;SAR;Stramenopiles;Ochrophyta;Phaeophyceae;Dictyotales;Dictyota;";"100.0";"14.4";"1";"1";"1";"0";"0";"457182";"391206"
"V4mis2";"SILVA (only NR);Eukaryota;SAR;Stramenopiles;Ochrophyta;Phaeophyceae;Dictyotales;Distromium;";"100.0";"14.4";"2";"2";"2";"0";"0";"457181";"391205"
"V4mis2";"SILVA (only NR);Eukaryota;SAR;Stramenopiles;Ochrophyta;Phaeophyceae;Dictyotales;Exallosorus;";"100.0";"14.4";"2";"2";"2";"0";"0";"457181";"391205"
"V4mis2";"SILVA (only NR);Eukaryota;SAR;Stramenopiles;Ochrophyta;Phaeophyceae;Dictyotales;Lobophora;";"100.0";"14.4";"1";"1";"1";"0";"0";"457182";"391206"
"V4mis2";"SILVA (only NR);Eukaryota;SAR;Stramenopiles;Ochrophyta;Phaeophyceae;Dictyotales;Lobospira;";"100.0";"14.4";"1";"1";"1";"0";"0";"457182";"391206"
"V4mis2";"SILVA (only NR);Eukaryota;SAR;Stramenopiles;Ochrophyta;Phaeophyceae;Dictyotales;Newhousia;";"100.0";"14.4";"1";"1";"1";"0";"0";"457182";"391206"
"V4mis2";"SILVA (only NR);Eukaryota;SAR;Stramenopiles;Ochrophyta;Phaeophyceae;Dictyotales;Padina;";"100.0";"14.4";"7";"7";"7";"0";"0";"457176";"391200"
"V4mis2";"SILVA (only NR);Eukaryota;SAR;Stramenopiles;Ochrophyta;Phaeophyceae;Dictyotales;Rugulopteryx;";"100.0";"14.4";"1";"1";"1";"0";"0";"457182";"391206"
"V4mis2";"SILVA (only NR);Eukaryota;SAR;Stramenopiles;Ochrophyta;Phaeophyceae;Dictyotales;Zonaria;";"100.0";"14.4";"4";"4";"4";"0";"0";"457179";"391203"
"V4mis2";"SILVA (only NR);Eukaryota;SAR;Stramenopiles;Ochrophyta;Phaeophyceae;Ectocarpales;";"100.0";"14.4";"21";"20";"20";"0";"1";"457163";"391187"
"V4mis2";"SILVA (only NR);Eukaryota;SAR;Stramenopiles;Ochrophyta;Phaeophyceae;Ectocarpales;Asterocladon;";"100.0";"14.4";"2";"2";"2";"0";"0";"457181";"391205"
"V4mis2";"SILVA (only NR);Eukaryota;SAR;Stramenopiles;Ochrophyta;Phaeophyceae;Ectocarpales;Ectocarpus;";"100.0";"14.4";"1";"1";"1";"0";"0";"457182";"391206"
"V4mis2";"SILVA (only NR);Eukaryota;SAR;Stramenopiles;Ochrophyta;Phaeophyceae;Ectocarpales;Halothrix;";"100.0";"14.4";"1";"1";"1";"0";"0";"457182";"391206"
"V4mis2";"SILVA (only NR);Eukaryota;SAR;Stramenopiles;Ochrophyta;Phaeophyceae;Ectocarpales;Heribaudiella;";"100.0";"14.4";"1";"1";"1";"0";"0";"457182";"391206"
"V4mis2";"SILVA (only NR);Eukaryota;SAR;Stramenopiles;Ochrophyta;Phaeophyceae;Ectocarpales;Ishige;";"100.0";"14.4";"2";"1";"1";"0";"1";"457182";"391206"
"V4mis2";"SILVA (only NR);Eukaryota;SAR;Stramenopiles;Ochrophyta;Phaeophyceae;Ectocarpales;Papenfussiella;";"100.0";"14.4";"1";"1";"1";"0";"0";"457182";"391206"
"V4mis2";"SILVA (only NR);Eukaryota;SAR;Stramenopiles;Ochrophyta;Phaeophyceae;Ectocarpales;Petalonia;";"100.0";"14.4";"1";"1";"1";"0";"0";"457182";"391206"
"V4mis2";"SILVA (only NR);Eukaryota;SAR;Stramenopiles;Ochrophyta;Phaeophyceae;Ectocarpales;Phaeostrophion;";"100.0";"14.4";"1";"1";"1";"0";"0";"457182";"391206"
"V4mis2";"SILVA (only NR);Eukaryota;SAR;Stramenopiles;Ochrophyta;Phaeophyceae;Ectocarpales;Porterinema;";"100.0";"14.4";"1";"1";"1";"0";"0";"457182";"391206"
"V4mis2";"SILVA (only NR);Eukaryota;SAR;Stramenopiles;Ochrophyta;Phaeophyceae;Ectocarpales;Pylaiella;";"100.0";"14.4";"2";"2";"2";"0";"0";"457181";"391205"
"V4mis2";"SILVA (only NR);Eukaryota;SAR;Stramenopiles;Ochrophyta;Phaeophyceae;Ectocarpales;Scytosiphon;";"100.0";"14.4";"2";"2";"2";"0";"0";"457181";"391205"
"V4mis2";"SILVA (only NR);Eukaryota;SAR;Stramenopiles;Ochrophyta;Phaeophyceae;Ectocarpales;Stschapovia;";"100.0";"14.4";"1";"1";"1";"0";"0";"457182";"391206"
"V4mis2";"SILVA (only NR);Eukaryota;SAR;Stramenopiles;Ochrophyta;Phaeophyceae;Ectocarpales;Tribonema;";"100.0";"14.4";"1";"1";"1";"0";"0";"457182";"391206"
"V4mis2";"SILVA (only NR);Eukaryota;SAR;Stramenopiles;Ochrophyta;Phaeophyceae;Fucales;";"100.0";"14.4";"9";"9";"9";"0";"0";"457174";"391198"
"V4mis2";"SILVA (only NR);Eukaryota;SAR;Stramenopiles;Ochrophyta;Phaeophyceae;Fucales;Coccophora;";"100.0";"14.4";"1";"1";"1";"0";"0";"457182";"391206"
"V4mis2";"SILVA (only NR);Eukaryota;SAR;Stramenopiles;Ochrophyta;Phaeophyceae;Fucales;Cystoseira;";"100.0";"14.4";"1";"1";"1";"0";"0";"457182";"391206"
"V4mis2";"SILVA (only NR);Eukaryota;SAR;Stramenopiles;Ochrophyta;Phaeophyceae;Fucales;Fucus;";"100.0";"14.4";"1";"1";"1";"0";"0";"457182";"391206"
"V4mis2";"SILVA (only NR);Eukaryota;SAR;Stramenopiles;Ochrophyta;Phaeophyceae;Fucales;Sargassum;";"100.0";"14.4";"5";"5";"5";"0";"0";"457178";"391202"
"V4mis2";"SILVA (only NR);Eukaryota;SAR;Stramenopiles;Ochrophyta;Phaeophyceae;Fucales;Silvetia;";"100.0";"14.4";"1";"1";"1";"0";"0";"457182";"391206"
"V4mis2";"SILVA (only NR);Eukaryota;SAR;Stramenopiles;Ochrophyta;Phaeophyceae;Laminariales;";"66.7";"14.4";"3";"3";"2";"1";"0";"457180";"391205"
"V4mis2";"SILVA (only NR);Eukaryota;SAR;Stramenopiles;Ochrophyta;Phaeophyceae;Laminariales;Akkesiphycus;";"100.0";"14.4";"1";"1";"1";"0";"0";"457182";"391206"
"V4mis2";"SILVA (only NR);Eukaryota;SAR;Stramenopiles;Ochrophyta;Phaeophyceae;Laminariales;Lessonia;";"50.0";"14.4";"2";"2";"1";"1";"0";"457181";"391206"
"V4mis2";"SILVA (only NR);Eukaryota;SAR;Stramenopiles;Ochrophyta;Phaeophyceae;Sphacelariales;";"100.0";"14.4";"2";"2";"2";"0";"0";"457181";"391205"
"V4mis2";"SILVA (only NR);Eukaryota;SAR;Stramenopiles;Ochrophyta;Phaeophyceae;Sphacelariales;Choristocarpus;";"100.0";"14.4";"1";"1";"1";"0";"0";"457182";"391206"
"V4mis2";"SILVA (only NR);Eukaryota;SAR;Stramenopiles;Ochrophyta;Phaeophyceae;Sphacelariales;Discosporangium;";"100.0";"14.4";"1";"1";"1";"0";"0";"457182";"391206"
"V4mis2";"SILVA (only NR);Eukaryota;SAR;Stramenopiles;Ochrophyta;Phaeophyceae;Tilopteridales;";"100.0";"14.4";"3";"3";"3";"0";"0";"457180";"391204"
"V4mis2";"SILVA (only NR);Eukaryota;SAR;Stramenopiles;Ochrophyta;Phaeophyceae;Tilopteridales;Phaeosiphoniella;";"100.0";"14.4";"1";"1";"1";"0";"0";"457182";"391206"
"V4mis2";"SILVA (only NR);Eukaryota;SAR;Stramenopiles;Ochrophyta;Phaeophyceae;Tilopteridales;Saccorhiza;";"100.0";"14.4";"1";"1";"1";"0";"0";"457182";"391206"
"V4mis2";"SILVA (only NR);Eukaryota;SAR;Stramenopiles;Ochrophyta;Phaeophyceae;Tilopteridales;Tilopteris;";"100.0";"14.4";"1";"1";"1";"0";"0";"457182";"391206"
"V4mis2";"SILVA (only NR);Eukaryota;SAR;Stramenopiles;Ochrophyta;Phaeothamniophyceae;";"100.0";"14.4";"8";"8";"8";"0";"0";"457175";"391199"
"V4mis2";"SILVA (only NR);Eukaryota;SAR;Stramenopiles;Ochrophyta;Phaeothamniophyceae;Phaeothamniales;";"100.0";"14.4";"4";"4";"4";"0";"0";"457179";"391203"
"V4mis2";"SILVA (only NR);Eukaryota;SAR;Stramenopiles;Ochrophyta;Phaeothamniophyceae;Phaeothamniales;Phaeothamnion;";"100.0";"14.4";"1";"1";"1";"0";"0";"457182";"391206"
"V4mis2";"SILVA (only NR);Eukaryota;SAR;Stramenopiles;Ochrophyta;Phaeothamniophyceae;Phaeothamniales;Stichogloea;";"100.0";"14.4";"1";"1";"1";"0";"0";"457182";"391206"
"V4mis2";"SILVA (only NR);Eukaryota;SAR;Stramenopiles;Ochrophyta;Phaeothamniophyceae;Pleurochloridales;";"100.0";"14.4";"4";"4";"4";"0";"0";"457179";"391203"
"V4mis2";"SILVA (only NR);Eukaryota;SAR;Stramenopiles;Ochrophyta;Phaeothamniophyceae;Pleurochloridales;Phaeobotrys;";"100.0";"14.4";"1";"1";"1";"0";"0";"457182";"391206"
"V4mis2";"SILVA (only NR);Eukaryota;SAR;Stramenopiles;Ochrophyta;Phaeothamniophyceae;Pleurochloridales;Pleurochloridella;";"100.0";"14.4";"2";"2";"2";"0";"0";"457181";"391205"
"V4mis2";"SILVA (only NR);Eukaryota;SAR;Stramenopiles;Ochrophyta;Phaeothamniophyceae;Pleurochloridales;Tetrasporopsis;";"100.0";"14.4";"1";"1";"1";"0";"0";"457182";"391206"
"V4mis2";"SILVA (only NR);Eukaryota;SAR;Stramenopiles;Ochrophyta;Pinguiophyceae;";"100.0";"14.4";"6";"6";"6";"0";"0";"457177";"391201"
"V4mis2";"SILVA (only NR);Eukaryota;SAR;Stramenopiles;Ochrophyta;Pinguiophyceae;Pinguiochrysidales;";"100.0";"14.4";"6";"6";"6";"0";"0";"457177";"391201"
"V4mis2";"SILVA (only NR);Eukaryota;SAR;Stramenopiles;Ochrophyta;Pinguiophyceae;Pinguiochrysidales;Glossomastix;";"100.0";"14.4";"1";"1";"1";"0";"0";"457182";"391206"
"V4mis2";"SILVA (only NR);Eukaryota;SAR;Stramenopiles;Ochrophyta;Pinguiophyceae;Pinguiochrysidales;Phaeomonas;";"100.0";"14.4";"2";"2";"2";"0";"0";"457181";"391205"
"V4mis2";"SILVA (only NR);Eukaryota;SAR;Stramenopiles;Ochrophyta;Pinguiophyceae;Pinguiochrysidales;Pinguiochrysis;";"100.0";"14.4";"1";"1";"1";"0";"0";"457182";"391206"
"V4mis2";"SILVA (only NR);Eukaryota;SAR;Stramenopiles;Ochrophyta;Pinguiophyceae;Pinguiochrysidales;Pinguiococcus;";"100.0";"14.4";"1";"1";"1";"0";"0";"457182";"391206"
"V4mis2";"SILVA (only NR);Eukaryota;SAR;Stramenopiles;Ochrophyta;Pinguiophyceae;Pinguiochrysidales;Polypodochrysis;";"100.0";"14.4";"1";"1";"1";"0";"0";"457182";"391206"
"V4mis2";"SILVA (only NR);Eukaryota;SAR;Stramenopiles;Ochrophyta;Raphidophyceae;";"100.0";"14.4";"23";"20";"20";"0";"3";"457163";"391187"
"V4mis2";"SILVA (only NR);Eukaryota;SAR;Stramenopiles;Ochrophyta;Raphidophyceae;Chattonellales;";"100.0";"14.4";"18";"16";"16";"0";"2";"457167";"391191"
"V4mis2";"SILVA (only NR);Eukaryota;SAR;Stramenopiles;Ochrophyta;Raphidophyceae;Chattonellales;Chattonella;";"100.0";"14.4";"2";"2";"2";"0";"0";"457181";"391205"
"V4mis2";"SILVA (only NR);Eukaryota;SAR;Stramenopiles;Ochrophyta;Raphidophyceae;Chattonellales;Chloromorum;";"100.0";"14.4";"2";"2";"2";"0";"0";"457181";"391205"
"V4mis2";"SILVA (only NR);Eukaryota;SAR;Stramenopiles;Ochrophyta;Raphidophyceae;Chattonellales;Fibrocapsa;";"100.0";"14.4";"1";"1";"1";"0";"0";"457182";"391206"
"V4mis2";"SILVA (only NR);Eukaryota;SAR;Stramenopiles;Ochrophyta;Raphidophyceae;Chattonellales;Gonyostomum;";"100.0";"14.4";"1";"1";"1";"0";"0";"457182";"391206"
"V4mis2";"SILVA (only NR);Eukaryota;SAR;Stramenopiles;Ochrophyta;Raphidophyceae;Chattonellales;Haramonas;";"100.0";"14.4";"3";"3";"3";"0";"0";"457180";"391204"
"V4mis2";"SILVA (only NR);Eukaryota;SAR;Stramenopiles;Ochrophyta;Raphidophyceae;Chattonellales;Heterosigma;";"100.0";"14.4";"1";"1";"1";"0";"0";"457182";"391206"
"V4mis2";"SILVA (only NR);Eukaryota;SAR;Stramenopiles;Ochrophyta;Raphidophyceae;Chattonellales;Isonoura-2009;";"100.0";"14.4";"2";"2";"2";"0";"0";"457181";"391205"
"V4mis2";"SILVA (only NR);Eukaryota;SAR;Stramenopiles;Ochrophyta;Raphidophyceae;Chattonellales;Merotricha;";"100.0";"14.4";"1";"1";"1";"0";"0";"457182";"391206"
"V4mis2";"SILVA (only NR);Eukaryota;SAR;Stramenopiles;Ochrophyta;Raphidophyceae;Chattonellales;Psammamonas;";"100.0";"14.4";"1";"1";"1";"0";"0";"457182";"391206"
"V4mis2";"SILVA (only NR);Eukaryota;SAR;Stramenopiles;Ochrophyta;Raphidophyceae;Chattonellales;Vacuolaria;";"100.0";"14.4";"1";"1";"1";"0";"0";"457182";"391206"
"V4mis2";"SILVA (only NR);Eukaryota;SAR;Stramenopiles;Ochrophyta;Raphidophyceae;Chattonellales;Viridilobus;";"100.0";"14.4";"1";"1";"1";"0";"0";"457182";"391206"
"V4mis2";"SILVA (only NR);Eukaryota;SAR;Stramenopiles;Ochrophyta;Raphidophyceae;Olisthodiscus;";"100.0";"14.4";"2";"2";"2";"0";"0";"457181";"391205"
"V4mis2";"SILVA (only NR);Eukaryota;SAR;Stramenopiles;Ochrophyta;Schizocladiophyceae;";"100.0";"14.4";"1";"1";"1";"0";"0";"457182";"391206"
"V4mis2";"SILVA (only NR);Eukaryota;SAR;Stramenopiles;Ochrophyta;Schizocladiophyceae;Schizocladia;";"100.0";"14.4";"1";"1";"1";"0";"0";"457182";"391206"
"V4mis2";"SILVA (only NR);Eukaryota;SAR;Stramenopiles;Ochrophyta;Synchromophyceae;";"100.0";"14.4";"4";"4";"4";"0";"0";"457179";"391203"
"V4mis2";"SILVA (only NR);Eukaryota;SAR;Stramenopiles;Ochrophyta;Synchromophyceae;Synchroma;";"100.0";"14.4";"4";"4";"4";"0";"0";"457179";"391203"
"V4mis2";"SILVA (only NR);Eukaryota;SAR;Stramenopiles;Ochrophyta;Xanthophyceae;";"100.0";"14.4";"36";"36";"36";"0";"0";"457147";"391171"
"V4mis2";"SILVA (only NR);Eukaryota;SAR;Stramenopiles;Ochrophyta;Xanthophyceae;Mischococcales;";"100.0";"14.4";"12";"12";"12";"0";"0";"457171";"391195"
"V4mis2";"SILVA (only NR);Eukaryota;SAR;Stramenopiles;Ochrophyta;Xanthophyceae;Mischococcales;Botrydiopsis;";"100.0";"14.4";"3";"3";"3";"0";"0";"457180";"391204"
"V4mis2";"SILVA (only NR);Eukaryota;SAR;Stramenopiles;Ochrophyta;Xanthophyceae;Mischococcales;Bumilleriopsis;";"100.0";"14.4";"2";"2";"2";"0";"0";"457181";"391205"
"V4mis2";"SILVA (only NR);Eukaryota;SAR;Stramenopiles;Ochrophyta;Xanthophyceae;Mischococcales;Chlorellidium;";"100.0";"14.4";"2";"2";"2";"0";"0";"457181";"391205"
"V4mis2";"SILVA (only NR);Eukaryota;SAR;Stramenopiles;Ochrophyta;Xanthophyceae;Mischococcales;Mischococcus;";"100.0";"14.4";"1";"1";"1";"0";"0";"457182";"391206"
"V4mis2";"SILVA (only NR);Eukaryota;SAR;Stramenopiles;Ochrophyta;Xanthophyceae;Mischococcales;Pleurochloris;";"100.0";"14.4";"1";"1";"1";"0";"0";"457182";"391206"
"V4mis2";"SILVA (only NR);Eukaryota;SAR;Stramenopiles;Ochrophyta;Xanthophyceae;Mischococcales;Pseudopleurochloris;";"100.0";"14.4";"1";"1";"1";"0";"0";"457182";"391206"
"V4mis2";"SILVA (only NR);Eukaryota;SAR;Stramenopiles;Ochrophyta;Xanthophyceae;Mischococcales;Sphaerosorus;";"100.0";"14.4";"1";"1";"1";"0";"0";"457182";"391206"
"V4mis2";"SILVA (only NR);Eukaryota;SAR;Stramenopiles;Ochrophyta;Xanthophyceae;Tribonematales;";"100.0";"14.4";"11";"11";"11";"0";"0";"457172";"391196"
"V4mis2";"SILVA (only NR);Eukaryota;SAR;Stramenopiles;Ochrophyta;Xanthophyceae;Tribonematales;Asterosiphon;";"100.0";"14.4";"1";"1";"1";"0";"0";"457182";"391206"
"V4mis2";"SILVA (only NR);Eukaryota;SAR;Stramenopiles;Ochrophyta;Xanthophyceae;Tribonematales;Botrydium;";"100.0";"14.4";"2";"2";"2";"0";"0";"457181";"391205"
"V4mis2";"SILVA (only NR);Eukaryota;SAR;Stramenopiles;Ochrophyta;Xanthophyceae;Tribonematales;Ophiocytium;";"100.0";"14.4";"3";"3";"3";"0";"0";"457180";"391204"
"V4mis2";"SILVA (only NR);Eukaryota;SAR;Stramenopiles;Ochrophyta;Xanthophyceae;Tribonematales;Tribonema;";"100.0";"14.4";"3";"3";"3";"0";"0";"457180";"391204"
"V4mis2";"SILVA (only NR);Eukaryota;SAR;Stramenopiles;Ochrophyta;Xanthophyceae;Tribonematales;Xanthonema;";"100.0";"14.4";"1";"1";"1";"0";"0";"457182";"391206"
"V4mis2";"SILVA (only NR);Eukaryota;SAR;Stramenopiles;Ochrophyta;Xanthophyceae;Vaucheriales;";"100.0";"14.4";"2";"2";"2";"0";"0";"457181";"391205"
"V4mis2";"SILVA (only NR);Eukaryota;SAR;Stramenopiles;Ochrophyta;Xanthophyceae;Vaucheriales;Vaucheria;";"100.0";"14.4";"2";"2";"2";"0";"0";"457181";"391205"
"V4mis2";"SILVA (only NR);Eukaryota;SAR;Stramenopiles;Ochrophyta;Xanthophyceae;uncultured;";"100.0";"14.4";"2";"2";"2";"0";"0";"457181";"391205"
"V4mis2";"SILVA (only NR);Eukaryota;SAR;Stramenopiles;Opalinata;";"100.0";"14.4";"5";"5";"5";"0";"0";"457178";"391202"
"V4mis2";"SILVA (only NR);Eukaryota;SAR;Stramenopiles;Opalinata;Opalinea;";"100.0";"14.4";"1";"1";"1";"0";"0";"457182";"391206"
"V4mis2";"SILVA (only NR);Eukaryota;SAR;Stramenopiles;Opalinata;Opalinea;Protoopalina;";"100.0";"14.4";"1";"1";"1";"0";"0";"457182";"391206"
"V4mis2";"SILVA (only NR);Eukaryota;SAR;Stramenopiles;Opalinata;Proteromonadea;";"100.0";"14.4";"1";"1";"1";"0";"0";"457182";"391206"
"V4mis2";"SILVA (only NR);Eukaryota;SAR;Stramenopiles;Opalinata;Proteromonadea;Proteromonas;";"100.0";"14.4";"1";"1";"1";"0";"0";"457182";"391206"
"V4mis2";"SILVA (only NR);Eukaryota;SAR;Stramenopiles;Peronosporomycetes;";"89.9";"14.4";"177";"169";"152";"17";"8";"457014";"391055"
"V4mis2";"SILVA (only NR);Eukaryota;SAR;Stramenopiles;Peronosporomycetes;Achlya;";"100.0";"14.4";"2";"2";"2";"0";"0";"457181";"391205"
"V4mis2";"SILVA (only NR);Eukaryota;SAR;Stramenopiles;Peronosporomycetes;Aphanomyces;";"100.0";"14.4";"6";"6";"6";"0";"0";"457177";"391201"
"V4mis2";"SILVA (only NR);Eukaryota;SAR;Stramenopiles;Peronosporomycetes;Aplanopsis;";"100.0";"14.4";"1";"1";"1";"0";"0";"457182";"391206"
"V4mis2";"SILVA (only NR);Eukaryota;SAR;Stramenopiles;Peronosporomycetes;Apodachlya;";"100.0";"14.4";"1";"1";"1";"0";"0";"457182";"391206"
"V4mis2";"SILVA (only NR);Eukaryota;SAR;Stramenopiles;Peronosporomycetes;Atkinsiella;";"100.0";"14.4";"1";"1";"1";"0";"0";"457182";"391206"
"V4mis2";"SILVA (only NR);Eukaryota;SAR;Stramenopiles;Peronosporomycetes;Eurychasma;";"100.0";"14.4";"1";"1";"1";"0";"0";"457182";"391206"
"V4mis2";"SILVA (only NR);Eukaryota;SAR;Stramenopiles;Peronosporomycetes;Haliphthoros;";"50.0";"14.4";"4";"4";"2";"2";"0";"457179";"391205"
"V4mis2";"SILVA (only NR);Eukaryota;SAR;Stramenopiles;Peronosporomycetes;Halodaphnea;";"100.0";"14.4";"2";"2";"2";"0";"0";"457181";"391205"
"V4mis2";"SILVA (only NR);Eukaryota;SAR;Stramenopiles;Peronosporomycetes;Halophytophthora;";"100.0";"14.4";"7";"7";"7";"0";"0";"457176";"391200"
"V4mis2";"SILVA (only NR);Eukaryota;SAR;Stramenopiles;Peronosporomycetes;Haptoglossa;";"100.0";"14.4";"5";"5";"5";"0";"0";"457178";"391202"
"V4mis2";"SILVA (only NR);Eukaryota;SAR;Stramenopiles;Peronosporomycetes;Lagenidium;";"100.0";"14.4";"4";"4";"4";"0";"0";"457179";"391203"
"V4mis2";"SILVA (only NR);Eukaryota;SAR;Stramenopiles;Peronosporomycetes;Leptolegnia;";"100.0";"14.4";"2";"2";"2";"0";"0";"457181";"391205"
"V4mis2";"SILVA (only NR);Eukaryota;SAR;Stramenopiles;Peronosporomycetes;Myzocytiopsis;";"100.0";"14.4";"3";"3";"3";"0";"0";"457180";"391204"
"V4mis2";"SILVA (only NR);Eukaryota;SAR;Stramenopiles;Peronosporomycetes;Olpidiopsis;";"100.0";"14.4";"5";"5";"5";"0";"0";"457178";"391202"
"V4mis2";"SILVA (only NR);Eukaryota;SAR;Stramenopiles;Peronosporomycetes;Phytophthora;";"80.8";"14.4";"52";"52";"42";"10";"0";"457131";"391165"
"V4mis2";"SILVA (only NR);Eukaryota;SAR;Stramenopiles;Peronosporomycetes;Phytopythium;";"100.0";"14.4";"3";"3";"3";"0";"0";"457180";"391204"
"V4mis2";"SILVA (only NR);Eukaryota;SAR;Stramenopiles;Peronosporomycetes;Pythium;";"95.7";"14.4";"23";"23";"22";"1";"0";"457160";"391185"
"V4mis2";"SILVA (only NR);Eukaryota;SAR;Stramenopiles;Peronosporomycetes;Salispina;";"100.0";"14.4";"2";"2";"2";"0";"0";"457181";"391205"
"V4mis2";"SILVA (only NR);Eukaryota;SAR;Stramenopiles;Peronosporomycetes;Saprolegnia;";"100.0";"14.4";"3";"3";"3";"0";"0";"457180";"391204"
"V4mis2";"SILVA (only NR);Eukaryota;SAR;Stramenopiles;Peronosporomycetes;Sapromyces;";"100.0";"14.4";"1";"1";"1";"0";"0";"457182";"391206"
"V4mis2";"SILVA (only NR);Eukaryota;SAR;Stramenopiles;Peronosporomycetes;uncultured;";"82.4";"14.4";"25";"17";"14";"3";"8";"457166";"391193"
"V4mis2";"SILVA (only NR);Eukaryota;SAR;Stramenopiles;Placididea;";"100.0";"14.4";"9";"9";"9";"0";"0";"457174";"391198"
"V4mis2";"SILVA (only NR);Eukaryota;SAR;Stramenopiles;Placididea;Placidia;";"100.0";"14.4";"2";"2";"2";"0";"0";"457181";"391205"
"V4mis2";"SILVA (only NR);Eukaryota;SAR;Stramenopiles;Placididea;Suigetsumonas;";"100.0";"14.4";"3";"3";"3";"0";"0";"457180";"391204"
"V4mis2";"SILVA (only NR);Eukaryota;SAR;Stramenopiles;Placididea;Wobblia;";"100.0";"14.4";"2";"2";"2";"0";"0";"457181";"391205"
"V4mis2";"SILVA (only NR);Eukaryota;SAR;Stramenopiles;uncultured;";"60.0";"14.4";"12";"10";"6";"4";"2";"457173";"391201"
"V4mis2";"SILVA (only NR);Eukaryota;uncultured;";"45.5";"14.4";"11";"11";"5";"6";"0";"457172";"391202"
"V4mis2";"SILVA (only NR);";"85.6";"100";"458561";"457262";"391283";"65979";"1299";"0";"0"
