"job_name";"taxonomy";"coverage";"specificity";"accessions";"eligible";"match";"mismatch";"nodata";"outgroup_matchable";"outgroup_matched"
"V4mis1";"SILVA (only NR);Unclassified;";"0.0";"0";"0";"0";"0";"0";"0";"457183";"373894"
"V4mis1";"SILVA (only NR);Archaea;";"94.6";"18.8";"20197";"19983";"18894";"1089";"214";"437200";"355000"
"V4mis1";"SILVA (only NR);Archaea;Aenigmarchaeota;";"81.5";"18.2";"319";"313";"255";"58";"6";"456870";"373639"
"V4mis1";"SILVA (only NR);Archaea;Aenigmarchaeota;Aenigmarchaeia;";"87.7";"18.2";"161";"155";"136";"19";"6";"457028";"373758"
"V4mis1";"SILVA (only NR);Archaea;Aenigmarchaeota;Aenigmarchaeia;Aenigmarchaeales;";"87.7";"18.2";"161";"155";"136";"19";"6";"457028";"373758"
"V4mis1";"SILVA (only NR);Archaea;Aenigmarchaeota;Aenigmarchaeia;Aenigmarchaeales;Candidatus Aenigmarchaeum;";"81.3";"18.2";"16";"16";"13";"3";"0";"457167";"373881"
"V4mis1";"SILVA (only NR);Archaea;Aenigmarchaeota;Deep Sea Euryarchaeotic Group(DSEG);";"75.5";"18.2";"155";"155";"117";"38";"0";"457028";"373777"
"V4mis1";"SILVA (only NR);Archaea;Altiarchaeota;";"100.0";"18.2";"41";"40";"40";"0";"1";"457143";"373854"
"V4mis1";"SILVA (only NR);Archaea;Altiarchaeota;Altiarchaeia;";"100.0";"18.2";"41";"40";"40";"0";"1";"457143";"373854"
"V4mis1";"SILVA (only NR);Archaea;Altiarchaeota;Altiarchaeia;Altiarchaeales;";"100.0";"18.2";"41";"40";"40";"0";"1";"457143";"373854"
"V4mis1";"SILVA (only NR);Archaea;Altiarchaeota;Altiarchaeia;Altiarchaeales;Altiarchaeaceae;";"100.0";"18.2";"41";"40";"40";"0";"1";"457143";"373854"
"V4mis1";"SILVA (only NR);Archaea;Altiarchaeota;Altiarchaeia;Altiarchaeales;Altiarchaeaceae;Candidatus Altiarchaeum;";"100.0";"18.2";"41";"40";"40";"0";"1";"457143";"373854"
"V4mis1";"SILVA (only NR);Archaea;Asgardarchaeota;";"88.8";"18.2";"670";"661";"587";"74";"9";"456522";"373307"
"V4mis1";"SILVA (only NR);Archaea;Asgardarchaeota;Heimdallarchaeia;";"93.0";"18.2";"45";"43";"40";"3";"2";"457140";"373854"
"V4mis1";"SILVA (only NR);Archaea;Asgardarchaeota;Lokiarchaeia;";"88.4";"18.2";"527";"524";"463";"61";"3";"456659";"373431"
"V4mis1";"SILVA (only NR);Archaea;Asgardarchaeota;Odinarchaeia;";"90.1";"18.2";"95";"91";"82";"9";"4";"457092";"373812"
"V4mis1";"SILVA (only NR);Archaea;Crenarchaeota;";"95.8";"18.5";"7625";"7552";"7236";"316";"73";"449631";"366658"
"V4mis1";"SILVA (only NR);Archaea;Crenarchaeota;Bathyarchaeia;";"96.6";"18.3";"3641";"3604";"3480";"124";"37";"453579";"370414"
"V4mis1";"SILVA (only NR);Archaea;Crenarchaeota;Methanomethylicia;";"94.1";"18.2";"34";"34";"32";"2";"0";"457149";"373862"
"V4mis1";"SILVA (only NR);Archaea;Crenarchaeota;Methanomethylicia;Methanomethyliales;";"94.1";"18.2";"34";"34";"32";"2";"0";"457149";"373862"
"V4mis1";"SILVA (only NR);Archaea;Crenarchaeota;Methanomethylicia;Methanomethyliales;Methanomethyliaceae;";"94.1";"18.2";"34";"34";"32";"2";"0";"457149";"373862"
"V4mis1";"SILVA (only NR);Archaea;Crenarchaeota;Methanomethylicia;Methanomethyliales;Methanomethyliaceae;Candidatus Methanomethylicus;";"92.9";"18.2";"28";"28";"26";"2";"0";"457155";"373868"
"V4mis1";"SILVA (only NR);Archaea;Crenarchaeota;Nitrososphaeria;";"94.9";"18.3";"3259";"3225";"3062";"163";"34";"453958";"370832"
"V4mis1";"SILVA (only NR);Archaea;Crenarchaeota;Nitrososphaeria;Caldiarchaeales;";"97.1";"18.2";"170";"170";"165";"5";"0";"457013";"373729"
"V4mis1";"SILVA (only NR);Archaea;Crenarchaeota;Nitrososphaeria;Caldiarchaeales;Caldiarchaeaceae;";"98.3";"18.2";"58";"58";"57";"1";"0";"457125";"373837"
"V4mis1";"SILVA (only NR);Archaea;Crenarchaeota;Nitrososphaeria;Caldiarchaeales;Caldiarchaeaceae;Candidatus Caldiarchaeum;";"98.3";"18.2";"58";"58";"57";"1";"0";"457125";"373837"
"V4mis1";"SILVA (only NR);Archaea;Crenarchaeota;Nitrososphaeria;Caldiarchaeales;Geothermarchaeaceae;";"95.5";"18.2";"66";"66";"63";"3";"0";"457117";"373831"
"V4mis1";"SILVA (only NR);Archaea;Crenarchaeota;Nitrososphaeria;Caldiarchaeales;Terrestrial Hot Spring Gp(THSCG);";"97.8";"18.2";"46";"46";"45";"1";"0";"457137";"373849"
"V4mis1";"SILVA (only NR);Archaea;Crenarchaeota;Nitrososphaeria;Group 1.1c;";"96.5";"18.2";"233";"231";"223";"8";"2";"456952";"373671"
"V4mis1";"SILVA (only NR);Archaea;Crenarchaeota;Nitrososphaeria;Marine Benthic Group A;";"97.7";"18.2";"131";"128";"125";"3";"3";"457055";"373769"
"V4mis1";"SILVA (only NR);Archaea;Crenarchaeota;Nitrososphaeria;Nitrosocaldales;";"97.3";"18.2";"37";"37";"36";"1";"0";"457146";"373858"
"V4mis1";"SILVA (only NR);Archaea;Crenarchaeota;Nitrososphaeria;Nitrosocaldales;Nitrosocaldaceae;";"97.3";"18.2";"37";"37";"36";"1";"0";"457146";"373858"
"V4mis1";"SILVA (only NR);Archaea;Crenarchaeota;Nitrososphaeria;Nitrosocaldales;Nitrosocaldaceae;Candidatus Nitrosocaldus;";"94.4";"18.2";"18";"18";"17";"1";"0";"457165";"373877"
"V4mis1";"SILVA (only NR);Archaea;Crenarchaeota;Nitrososphaeria;Nitrosocaldales;Nitrosocaldaceae;uncultured;";"100.0";"18.2";"19";"19";"19";"0";"0";"457164";"373875"
"V4mis1";"SILVA (only NR);Archaea;Crenarchaeota;Nitrososphaeria;Nitrosopumilales;";"95.3";"18.3";"1831";"1810";"1725";"85";"21";"455373";"372169"
"V4mis1";"SILVA (only NR);Archaea;Crenarchaeota;Nitrososphaeria;Nitrosopumilales;Nitrosopumilaceae;";"95.3";"18.3";"1831";"1810";"1725";"85";"21";"455373";"372169"
"V4mis1";"SILVA (only NR);Archaea;Crenarchaeota;Nitrososphaeria;Nitrosopumilales;Nitrosopumilaceae;Candidatus Nitrosopelagicus;";"100.0";"18.2";"51";"49";"49";"0";"2";"457134";"373845"
"V4mis1";"SILVA (only NR);Archaea;Crenarchaeota;Nitrososphaeria;Nitrosopumilales;Nitrosopumilaceae;Candidatus Nitrosopumilus;";"92.4";"18.2";"717";"712";"658";"54";"5";"456471";"373236"
"V4mis1";"SILVA (only NR);Archaea;Crenarchaeota;Nitrososphaeria;Nitrosopumilales;Nitrosopumilaceae;Candidatus Nitrosotenuis;";"90.6";"18.2";"34";"32";"29";"3";"2";"457151";"373865"
"V4mis1";"SILVA (only NR);Archaea;Crenarchaeota;Nitrososphaeria;Nitrosopumilales;Nitrosopumilaceae;Cenarchaeum;";"96.3";"18.2";"27";"27";"26";"1";"0";"457156";"373868"
"V4mis1";"SILVA (only NR);Archaea;Crenarchaeota;Nitrososphaeria;Nitrosopumilales;Nitrosopumilaceae;Nitrosarchaeum;";"95.2";"18.2";"63";"63";"60";"3";"0";"457120";"373834"
"V4mis1";"SILVA (only NR);Archaea;Crenarchaeota;Nitrososphaeria;Nitrososphaerales;";"92.1";"18.2";"603";"598";"551";"47";"5";"456585";"373343"
"V4mis1";"SILVA (only NR);Archaea;Crenarchaeota;Nitrososphaeria;Nitrososphaerales;Nitrososphaeraceae;";"92.1";"18.2";"603";"598";"551";"47";"5";"456585";"373343"
"V4mis1";"SILVA (only NR);Archaea;Crenarchaeota;Nitrososphaeria;Nitrososphaerales;Nitrososphaeraceae;Candidatus Nitrocosmicus;";"91.8";"18.2";"49";"49";"45";"4";"0";"457134";"373849"
"V4mis1";"SILVA (only NR);Archaea;Crenarchaeota;Nitrososphaeria;Nitrososphaerales;Nitrososphaeraceae;Candidatus Nitrososphaera;";"87.8";"18.2";"233";"230";"202";"28";"3";"456953";"373692"
"V4mis1";"SILVA (only NR);Archaea;Crenarchaeota;Nitrososphaeria;Nitrosotaleales;";"94.2";"18.2";"141";"139";"131";"8";"2";"457044";"373763"
"V4mis1";"SILVA (only NR);Archaea;Crenarchaeota;Nitrososphaeria;Nitrosotaleales;Nitrosotaleaceae;";"94.2";"18.2";"141";"139";"131";"8";"2";"457044";"373763"
"V4mis1";"SILVA (only NR);Archaea;Crenarchaeota;Nitrososphaeria;Nitrosotaleales;Nitrosotaleaceae;Candidatus Nitrosotalea;";"94.1";"18.2";"17";"17";"16";"1";"0";"457166";"373878"
"V4mis1";"SILVA (only NR);Archaea;Crenarchaeota;Nitrososphaeria;SCGC AB-179-E04;";"96.4";"18.2";"57";"56";"54";"2";"1";"457127";"373840"
"V4mis1";"SILVA (only NR);Archaea;Crenarchaeota;Nitrososphaeria;uncultured;";"92.9";"18.2";"56";"56";"52";"4";"0";"457127";"373842"
"V4mis1";"SILVA (only NR);Archaea;Crenarchaeota;Thermoprotei;";"96.1";"18.2";"691";"689";"662";"27";"2";"456494";"373232"
"V4mis1";"SILVA (only NR);Archaea;Crenarchaeota;Thermoprotei;Desulfurococcales;";"95.9";"18.2";"219";"219";"210";"9";"0";"456964";"373684"
"V4mis1";"SILVA (only NR);Archaea;Crenarchaeota;Thermoprotei;Desulfurococcales;Acidilobaceae;";"95.8";"18.2";"71";"71";"68";"3";"0";"457112";"373826"
"V4mis1";"SILVA (only NR);Archaea;Crenarchaeota;Thermoprotei;Desulfurococcales;Acidilobaceae;Acidilobus;";"90.0";"18.2";"10";"10";"9";"1";"0";"457173";"373885"
"V4mis1";"SILVA (only NR);Archaea;Crenarchaeota;Thermoprotei;Desulfurococcales;Acidilobaceae;Aeropyrum;";"92.6";"18.2";"27";"27";"25";"2";"0";"457156";"373869"
"V4mis1";"SILVA (only NR);Archaea;Crenarchaeota;Thermoprotei;Desulfurococcales;Acidilobaceae;Caldisphaera;";"100.0";"18.2";"13";"13";"13";"0";"0";"457170";"373881"
"V4mis1";"SILVA (only NR);Archaea;Crenarchaeota;Thermoprotei;Desulfurococcales;Acidilobaceae;Stetteria;";"100.0";"18.2";"4";"4";"4";"0";"0";"457179";"373890"
"V4mis1";"SILVA (only NR);Archaea;Crenarchaeota;Thermoprotei;Desulfurococcales;Acidilobaceae;Thermodiscus;";"100.0";"18.2";"12";"12";"12";"0";"0";"457171";"373882"
"V4mis1";"SILVA (only NR);Archaea;Crenarchaeota;Thermoprotei;Desulfurococcales;Desulfurococcaceae;";"93.2";"18.2";"44";"44";"41";"3";"0";"457139";"373853"
"V4mis1";"SILVA (only NR);Archaea;Crenarchaeota;Thermoprotei;Desulfurococcales;Desulfurococcaceae;Desulfurococcus;";"100.0";"18.2";"9";"9";"9";"0";"0";"457174";"373885"
"V4mis1";"SILVA (only NR);Archaea;Crenarchaeota;Thermoprotei;Desulfurococcales;Desulfurococcaceae;Staphylothermus;";"87.5";"18.2";"16";"16";"14";"2";"0";"457167";"373880"
"V4mis1";"SILVA (only NR);Archaea;Crenarchaeota;Thermoprotei;Desulfurococcales;Desulfurococcaceae;Sulfophobococcus;";"100.0";"18.2";"1";"1";"1";"0";"0";"457182";"373893"
"V4mis1";"SILVA (only NR);Archaea;Crenarchaeota;Thermoprotei;Desulfurococcales;Desulfurococcaceae;Thermogladius;";"100.0";"18.2";"4";"4";"4";"0";"0";"457179";"373890"
"V4mis1";"SILVA (only NR);Archaea;Crenarchaeota;Thermoprotei;Desulfurococcales;Desulfurococcaceae;Thermosphaera;";"88.9";"18.2";"9";"9";"8";"1";"0";"457174";"373886"
"V4mis1";"SILVA (only NR);Archaea;Crenarchaeota;Thermoprotei;Desulfurococcales;Desulfurococcaceae;uncultured;";"100.0";"18.2";"3";"3";"3";"0";"0";"457180";"373891"
"V4mis1";"SILVA (only NR);Archaea;Crenarchaeota;Thermoprotei;Desulfurococcales;Ignicoccaceae;";"90.9";"18.2";"11";"11";"10";"1";"0";"457172";"373884"
"V4mis1";"SILVA (only NR);Archaea;Crenarchaeota;Thermoprotei;Desulfurococcales;Ignicoccaceae;Ignicoccus;";"90.9";"18.2";"11";"11";"10";"1";"0";"457172";"373884"
"V4mis1";"SILVA (only NR);Archaea;Crenarchaeota;Thermoprotei;Desulfurococcales;Ignisphaeraceae;";"98.1";"18.2";"54";"54";"53";"1";"0";"457129";"373841"
"V4mis1";"SILVA (only NR);Archaea;Crenarchaeota;Thermoprotei;Desulfurococcales;Ignisphaeraceae;Ignisphaera;";"100.0";"18.2";"29";"29";"29";"0";"0";"457154";"373865"
"V4mis1";"SILVA (only NR);Archaea;Crenarchaeota;Thermoprotei;Desulfurococcales;Ignisphaeraceae;uncultured;";"95.8";"18.2";"24";"24";"23";"1";"0";"457159";"373871"
"V4mis1";"SILVA (only NR);Archaea;Crenarchaeota;Thermoprotei;Desulfurococcales;Pyrodictiaceae;";"96.7";"18.2";"30";"30";"29";"1";"0";"457153";"373865"
"V4mis1";"SILVA (only NR);Archaea;Crenarchaeota;Thermoprotei;Desulfurococcales;Pyrodictiaceae;Hyperthermus;";"100.0";"18.2";"3";"3";"3";"0";"0";"457180";"373891"
"V4mis1";"SILVA (only NR);Archaea;Crenarchaeota;Thermoprotei;Desulfurococcales;Pyrodictiaceae;Pyrodictium;";"90.0";"18.2";"10";"10";"9";"1";"0";"457173";"373885"
"V4mis1";"SILVA (only NR);Archaea;Crenarchaeota;Thermoprotei;Desulfurococcales;Pyrodictiaceae;uncultured;";"100.0";"18.2";"13";"13";"13";"0";"0";"457170";"373881"
"V4mis1";"SILVA (only NR);Archaea;Crenarchaeota;Thermoprotei;Desulfurococcales;uncultured;";"100.0";"18.2";"8";"8";"8";"0";"0";"457175";"373886"
"V4mis1";"SILVA (only NR);Archaea;Crenarchaeota;Thermoprotei;Fervidicoccales;";"91.7";"18.2";"36";"36";"33";"3";"0";"457147";"373861"
"V4mis1";"SILVA (only NR);Archaea;Crenarchaeota;Thermoprotei;Fervidicoccales;Fervidicoccaceae;";"91.7";"18.2";"36";"36";"33";"3";"0";"457147";"373861"
"V4mis1";"SILVA (only NR);Archaea;Crenarchaeota;Thermoprotei;Fervidicoccales;Fervidicoccaceae;Fervidicoccus;";"100.0";"18.2";"15";"15";"15";"0";"0";"457168";"373879"
"V4mis1";"SILVA (only NR);Archaea;Crenarchaeota;Thermoprotei;Fervidicoccales;Fervidicoccaceae;uncultured;";"85.7";"18.2";"21";"21";"18";"3";"0";"457162";"373876"
"V4mis1";"SILVA (only NR);Archaea;Crenarchaeota;Thermoprotei;Geoarchaeales;";"98.1";"18.2";"54";"54";"53";"1";"0";"457129";"373841"
"V4mis1";"SILVA (only NR);Archaea;Crenarchaeota;Thermoprotei;Geoarchaeales;SCGC AAA261-C22;";"100.0";"18.2";"10";"10";"10";"0";"0";"457173";"373884"
"V4mis1";"SILVA (only NR);Archaea;Crenarchaeota;Thermoprotei;Geoarchaeales;SCGC AAA471-B05;";"100.0";"18.2";"3";"3";"3";"0";"0";"457180";"373891"
"V4mis1";"SILVA (only NR);Archaea;Crenarchaeota;Thermoprotei;Sulfolobales;";"96.2";"18.2";"211";"209";"201";"8";"2";"456974";"373693"
"V4mis1";"SILVA (only NR);Archaea;Crenarchaeota;Thermoprotei;Sulfolobales;Sulfolobaceae;";"96.2";"18.2";"211";"209";"201";"8";"2";"456974";"373693"
"V4mis1";"SILVA (only NR);Archaea;Crenarchaeota;Thermoprotei;Sulfolobales;Sulfolobaceae;Acidianus;";"85.2";"18.2";"27";"27";"23";"4";"0";"457156";"373871"
"V4mis1";"SILVA (only NR);Archaea;Crenarchaeota;Thermoprotei;Sulfolobales;Sulfolobaceae;Metallosphaera;";"97.8";"18.2";"46";"46";"45";"1";"0";"457137";"373849"
"V4mis1";"SILVA (only NR);Archaea;Crenarchaeota;Thermoprotei;Sulfolobales;Sulfolobaceae;Saccharolobus;";"98.0";"18.2";"51";"51";"50";"1";"0";"457132";"373844"
"V4mis1";"SILVA (only NR);Archaea;Crenarchaeota;Thermoprotei;Sulfolobales;Sulfolobaceae;Stygiolobus;";"94.4";"18.2";"18";"18";"17";"1";"0";"457165";"373877"
"V4mis1";"SILVA (only NR);Archaea;Crenarchaeota;Thermoprotei;Sulfolobales;Sulfolobaceae;Sulfolobus;";"100.0";"18.2";"35";"33";"33";"0";"2";"457150";"373861"
"V4mis1";"SILVA (only NR);Archaea;Crenarchaeota;Thermoprotei;Sulfolobales;Sulfolobaceae;Sulfurisphaera;";"100.0";"18.2";"4";"4";"4";"0";"0";"457179";"373890"
"V4mis1";"SILVA (only NR);Archaea;Crenarchaeota;Thermoprotei;Sulfolobales;Sulfolobaceae;uncultured;";"100.0";"18.2";"25";"25";"25";"0";"0";"457158";"373869"
"V4mis1";"SILVA (only NR);Archaea;Crenarchaeota;Thermoprotei;Terrestrial Miscellaneous Gp(TMCG);";"90.0";"18.2";"10";"10";"9";"1";"0";"457173";"373885"
"V4mis1";"SILVA (only NR);Archaea;Crenarchaeota;Thermoprotei;Thermoproteales;";"97.4";"18.2";"156";"156";"152";"4";"0";"457027";"373742"
"V4mis1";"SILVA (only NR);Archaea;Crenarchaeota;Thermoprotei;Thermoproteales;Thermofilaceae;";"95.7";"18.2";"46";"46";"44";"2";"0";"457137";"373850"
"V4mis1";"SILVA (only NR);Archaea;Crenarchaeota;Thermoprotei;Thermoproteales;Thermofilaceae;Thermofilum;";"95.7";"18.2";"46";"46";"44";"2";"0";"457137";"373850"
"V4mis1";"SILVA (only NR);Archaea;Crenarchaeota;Thermoprotei;Thermoproteales;Thermoproteaceae;";"98.2";"18.2";"110";"110";"108";"2";"0";"457073";"373786"
"V4mis1";"SILVA (only NR);Archaea;Crenarchaeota;Thermoprotei;Thermoproteales;Thermoproteaceae;Caldivirga;";"100.0";"18.2";"5";"5";"5";"0";"0";"457178";"373889"
"V4mis1";"SILVA (only NR);Archaea;Crenarchaeota;Thermoprotei;Thermoproteales;Thermoproteaceae;Pyrobaculum;";"96.9";"18.2";"32";"32";"31";"1";"0";"457151";"373863"
"V4mis1";"SILVA (only NR);Archaea;Crenarchaeota;Thermoprotei;Thermoproteales;Thermoproteaceae;Thermocladium;";"100.0";"18.2";"7";"7";"7";"0";"0";"457176";"373887"
"V4mis1";"SILVA (only NR);Archaea;Crenarchaeota;Thermoprotei;Thermoproteales;Thermoproteaceae;Thermoproteus;";"100.0";"18.2";"9";"9";"9";"0";"0";"457174";"373885"
"V4mis1";"SILVA (only NR);Archaea;Crenarchaeota;Thermoprotei;Thermoproteales;Thermoproteaceae;Vulcanisaeta;";"100.0";"18.2";"31";"31";"31";"0";"0";"457152";"373863"
"V4mis1";"SILVA (only NR);Archaea;Crenarchaeota;Thermoprotei;Thermoproteales;Thermoproteaceae;uncultured;";"94.4";"18.2";"18";"18";"17";"1";"0";"457165";"373877"
"V4mis1";"SILVA (only NR);Archaea;Crenarchaeota;Thermoprotei;uncultured;";"66.7";"18.2";"3";"3";"2";"1";"0";"457180";"373892"
"V4mis1";"SILVA (only NR);Archaea;Euryarchaeota;";"95.2";"18.3";"1993";"1988";"1892";"96";"5";"455195";"372002"
"V4mis1";"SILVA (only NR);Archaea;Euryarchaeota;Methanobacteria;";"96.7";"18.3";"1500";"1499";"1449";"50";"1";"455684";"372445"
"V4mis1";"SILVA (only NR);Archaea;Euryarchaeota;Methanobacteria;Methanobacteriales;";"96.7";"18.3";"1500";"1499";"1449";"50";"1";"455684";"372445"
"V4mis1";"SILVA (only NR);Archaea;Euryarchaeota;Methanobacteria;Methanobacteriales;Methanobacteriaceae;";"96.6";"18.3";"1451";"1450";"1401";"49";"1";"455733";"372493"
"V4mis1";"SILVA (only NR);Archaea;Euryarchaeota;Methanobacteria;Methanobacteriales;Methanobacteriaceae;Methanobacterium;";"97.2";"18.2";"216";"215";"209";"6";"1";"456968";"373685"
"V4mis1";"SILVA (only NR);Archaea;Euryarchaeota;Methanobacteria;Methanobacteriales;Methanobacteriaceae;Methanobrevibacter;";"98.2";"18.3";"1030";"1030";"1011";"19";"0";"456153";"372883"
"V4mis1";"SILVA (only NR);Archaea;Euryarchaeota;Methanobacteria;Methanobacteriales;Methanobacteriaceae;Methanosphaera;";"87.9";"18.2";"198";"198";"174";"24";"0";"456985";"373720"
"V4mis1";"SILVA (only NR);Archaea;Euryarchaeota;Methanobacteria;Methanobacteriales;Methanobacteriaceae;uncultured;";"100.0";"18.2";"6";"6";"6";"0";"0";"457177";"373888"
"V4mis1";"SILVA (only NR);Archaea;Euryarchaeota;Methanobacteria;Methanobacteriales;Methanothermaceae;";"100.0";"18.2";"2";"2";"2";"0";"0";"457181";"373892"
"V4mis1";"SILVA (only NR);Archaea;Euryarchaeota;Methanobacteria;Methanobacteriales;Methanothermaceae;Methanothermus;";"100.0";"18.2";"2";"2";"2";"0";"0";"457181";"373892"
"V4mis1";"SILVA (only NR);Archaea;Euryarchaeota;Methanobacteria;Methanobacteriales;Methanothermobacteriaceae;";"97.9";"18.2";"47";"47";"46";"1";"0";"457136";"373848"
"V4mis1";"SILVA (only NR);Archaea;Euryarchaeota;Methanobacteria;Methanobacteriales;Methanothermobacteriaceae;Methanothermobacter;";"97.9";"18.2";"47";"47";"46";"1";"0";"457136";"373848"
"V4mis1";"SILVA (only NR);Archaea;Euryarchaeota;Methanococci;";"91.6";"18.2";"83";"83";"76";"7";"0";"457100";"373818"
"V4mis1";"SILVA (only NR);Archaea;Euryarchaeota;Methanococci;Methanococcales;";"91.6";"18.2";"83";"83";"76";"7";"0";"457100";"373818"
"V4mis1";"SILVA (only NR);Archaea;Euryarchaeota;Methanococci;Methanococcales;Methanocaldococcaceae;";"100.0";"18.2";"27";"27";"27";"0";"0";"457156";"373867"
"V4mis1";"SILVA (only NR);Archaea;Euryarchaeota;Methanococci;Methanococcales;Methanocaldococcaceae;Methanocaldococcus;";"100.0";"18.2";"27";"27";"27";"0";"0";"457156";"373867"
"V4mis1";"SILVA (only NR);Archaea;Euryarchaeota;Methanococci;Methanococcales;Methanococcaceae;";"87.5";"18.2";"56";"56";"49";"7";"0";"457127";"373845"
"V4mis1";"SILVA (only NR);Archaea;Euryarchaeota;Methanococci;Methanococcales;Methanococcaceae;Methanococcus;";"100.0";"18.2";"28";"28";"28";"0";"0";"457155";"373866"
"V4mis1";"SILVA (only NR);Archaea;Euryarchaeota;Methanococci;Methanococcales;Methanococcaceae;Methanothermococcus;";"88.9";"18.2";"9";"9";"8";"1";"0";"457174";"373886"
"V4mis1";"SILVA (only NR);Archaea;Euryarchaeota;Methanococci;Methanococcales;Methanococcaceae;Methanotorris;";"57.1";"18.2";"14";"14";"8";"6";"0";"457169";"373886"
"V4mis1";"SILVA (only NR);Archaea;Euryarchaeota;Methanococci;Methanococcales;Methanococcaceae;uncultured;";"100.0";"18.2";"4";"4";"4";"0";"0";"457179";"373890"
"V4mis1";"SILVA (only NR);Archaea;Euryarchaeota;Methanopyri;";"100.0";"18.2";"9";"9";"9";"0";"0";"457174";"373885"
"V4mis1";"SILVA (only NR);Archaea;Euryarchaeota;Methanopyri;Methanopyrales;";"100.0";"18.2";"9";"9";"9";"0";"0";"457174";"373885"
"V4mis1";"SILVA (only NR);Archaea;Euryarchaeota;Methanopyri;Methanopyrales;Methanopyraceae;";"100.0";"18.2";"9";"9";"9";"0";"0";"457174";"373885"
"V4mis1";"SILVA (only NR);Archaea;Euryarchaeota;Methanopyri;Methanopyrales;Methanopyraceae;Methanopyrus;";"100.0";"18.2";"9";"9";"9";"0";"0";"457174";"373885"
"V4mis1";"SILVA (only NR);Archaea;Euryarchaeota;Thermococci;";"90.2";"18.2";"401";"397";"358";"39";"4";"456786";"373536"
"V4mis1";"SILVA (only NR);Archaea;Euryarchaeota;Thermococci;Methanofastidiosales;";"91.6";"18.2";"195";"191";"175";"16";"4";"456992";"373719"
"V4mis1";"SILVA (only NR);Archaea;Euryarchaeota;Thermococci;Methanofastidiosales;Methanofastidiosaceae;";"91.5";"18.2";"60";"59";"54";"5";"1";"457124";"373840"
"V4mis1";"SILVA (only NR);Archaea;Euryarchaeota;Thermococci;Methanofastidiosales;Methanofastidiosaceae;Candidatus Methanofastidiosum;";"91.5";"18.2";"60";"59";"54";"5";"1";"457124";"373840"
"V4mis1";"SILVA (only NR);Archaea;Euryarchaeota;Thermococci;Methanofastidiosales;uncultured;";"91.5";"18.2";"132";"129";"118";"11";"3";"457054";"373776"
"V4mis1";"SILVA (only NR);Archaea;Euryarchaeota;Thermococci;Thermococcales;";"88.8";"18.2";"206";"206";"183";"23";"0";"456977";"373711"
"V4mis1";"SILVA (only NR);Archaea;Euryarchaeota;Thermococci;Thermococcales;Thermococcaceae;";"88.8";"18.2";"206";"206";"183";"23";"0";"456977";"373711"
"V4mis1";"SILVA (only NR);Archaea;Euryarchaeota;Thermococci;Thermococcales;Thermococcaceae;Palaeococcus;";"100.0";"18.2";"9";"9";"9";"0";"0";"457174";"373885"
"V4mis1";"SILVA (only NR);Archaea;Euryarchaeota;Thermococci;Thermococcales;Thermococcaceae;Pyrococcus;";"95.7";"18.2";"23";"23";"22";"1";"0";"457160";"373872"
"V4mis1";"SILVA (only NR);Archaea;Euryarchaeota;Thermococci;Thermococcales;Thermococcaceae;Thermococcus;";"87.4";"18.2";"174";"174";"152";"22";"0";"457009";"373742"
"V4mis1";"SILVA (only NR);Archaea;Hadarchaeota;";"92.3";"18.2";"300";"299";"276";"23";"1";"456884";"373618"
"V4mis1";"SILVA (only NR);Archaea;Hadarchaeota;Hadarchaeia;";"92.3";"18.2";"300";"299";"276";"23";"1";"456884";"373618"
"V4mis1";"SILVA (only NR);Archaea;Hadarchaeota;Hadarchaeia;Hadarchaeales;";"92.3";"18.2";"300";"299";"276";"23";"1";"456884";"373618"
"V4mis1";"SILVA (only NR);Archaea;Halobacterota;";"95.5";"18.4";"5352";"5297";"5060";"237";"55";"451886";"368834"
"V4mis1";"SILVA (only NR);Archaea;Halobacterota;ANME-1;";"90.1";"18.2";"154";"151";"136";"15";"3";"457032";"373758"
"V4mis1";"SILVA (only NR);Archaea;Halobacterota;ANME-1;ANME-1a;";"83.7";"18.2";"45";"43";"36";"7";"2";"457140";"373858"
"V4mis1";"SILVA (only NR);Archaea;Halobacterota;ANME-1;ANME-1b;";"91.4";"18.2";"94";"93";"85";"8";"1";"457090";"373809"
"V4mis1";"SILVA (only NR);Archaea;Halobacterota;Archaeoglobi;";"98.8";"18.2";"80";"80";"79";"1";"0";"457103";"373815"
"V4mis1";"SILVA (only NR);Archaea;Halobacterota;Archaeoglobi;Archaeoglobales;";"98.8";"18.2";"80";"80";"79";"1";"0";"457103";"373815"
"V4mis1";"SILVA (only NR);Archaea;Halobacterota;Archaeoglobi;Archaeoglobales;Archaeoglobaceae;";"98.8";"18.2";"80";"80";"79";"1";"0";"457103";"373815"
"V4mis1";"SILVA (only NR);Archaea;Halobacterota;Archaeoglobi;Archaeoglobales;Archaeoglobaceae;Archaeoglobus;";"96.9";"18.2";"32";"32";"31";"1";"0";"457151";"373863"
"V4mis1";"SILVA (only NR);Archaea;Halobacterota;Archaeoglobi;Archaeoglobales;Archaeoglobaceae;Ferroglobus;";"100.0";"18.2";"3";"3";"3";"0";"0";"457180";"373891"
"V4mis1";"SILVA (only NR);Archaea;Halobacterota;Archaeoglobi;Archaeoglobales;Archaeoglobaceae;Geoglobus;";"100.0";"18.2";"12";"12";"12";"0";"0";"457171";"373882"
"V4mis1";"SILVA (only NR);Archaea;Halobacterota;Archaeoglobi;Archaeoglobales;Archaeoglobaceae;JdFR-20;";"100.0";"18.2";"2";"2";"2";"0";"0";"457181";"373892"
"V4mis1";"SILVA (only NR);Archaea;Halobacterota;Archaeoglobi;Archaeoglobales;Archaeoglobaceae;uncultured;";"100.0";"18.2";"23";"23";"23";"0";"0";"457160";"373871"
"V4mis1";"SILVA (only NR);Archaea;Halobacterota;Halobacteria;";"96.6";"18.3";"2624";"2603";"2514";"89";"21";"454580";"371380"
"V4mis1";"SILVA (only NR);Archaea;Halobacterota;Halobacteria;Halobacterales;";"96.6";"18.3";"2624";"2603";"2514";"89";"21";"454580";"371380"
"V4mis1";"SILVA (only NR);Archaea;Halobacterota;Halobacteria;Halobacterales;Haloadaptaceae;";"96.9";"18.2";"32";"32";"31";"1";"0";"457151";"373863"
"V4mis1";"SILVA (only NR);Archaea;Halobacterota;Halobacteria;Halobacterales;Haloadaptaceae;Haladaptatus;";"96.9";"18.2";"32";"32";"31";"1";"0";"457151";"373863"
"V4mis1";"SILVA (only NR);Archaea;Halobacterota;Halobacteria;Halobacterales;Halobacteriaceae;";"92.5";"18.2";"147";"146";"135";"11";"1";"457037";"373759"
"V4mis1";"SILVA (only NR);Archaea;Halobacterota;Halobacteria;Halobacterales;Halobacteriaceae;Halanaeroarchaeum;";"100.0";"18.2";"19";"19";"19";"0";"0";"457164";"373875"
"V4mis1";"SILVA (only NR);Archaea;Halobacterota;Halobacteria;Halobacterales;Halobacteriaceae;Halarchaeum;";"100.0";"18.2";"25";"24";"24";"0";"1";"457159";"373870"
"V4mis1";"SILVA (only NR);Archaea;Halobacterota;Halobacteria;Halobacterales;Halobacteriaceae;Halobacterium;";"86.6";"18.2";"82";"82";"71";"11";"0";"457101";"373823"
"V4mis1";"SILVA (only NR);Archaea;Halobacterota;Halobacteria;Halobacterales;Halobacteriaceae;Halocalculus;";"100.0";"18.2";"1";"1";"1";"0";"0";"457182";"373893"
"V4mis1";"SILVA (only NR);Archaea;Halobacterota;Halobacteria;Halobacterales;Halobacteriaceae;Halodesulfurarchaeum;";"100.0";"18.2";"13";"13";"13";"0";"0";"457170";"373881"
"V4mis1";"SILVA (only NR);Archaea;Halobacterota;Halobacteria;Halobacterales;Halobacteriaceae;Salarchaeum;";"100.0";"18.2";"3";"3";"3";"0";"0";"457180";"373891"
"V4mis1";"SILVA (only NR);Archaea;Halobacterota;Halobacteria;Halobacterales;Halobacteriaceae;uncultured;";"100.0";"18.2";"2";"2";"2";"0";"0";"457181";"373892"
"V4mis1";"SILVA (only NR);Archaea;Halobacterota;Halobacteria;Halobacterales;Halococcaceae;";"92.9";"18.2";"86";"85";"79";"6";"1";"457098";"373815"
"V4mis1";"SILVA (only NR);Archaea;Halobacterota;Halobacteria;Halobacterales;Halococcaceae;Halalkalicoccus;";"100.0";"18.2";"14";"14";"14";"0";"0";"457169";"373880"
"V4mis1";"SILVA (only NR);Archaea;Halobacterota;Halobacteria;Halobacterales;Halococcaceae;Halococcus;";"90.5";"18.2";"64";"63";"57";"6";"1";"457120";"373837"
"V4mis1";"SILVA (only NR);Archaea;Halobacterota;Halobacteria;Halobacterales;Halococcaceae;Halostella;";"100.0";"18.2";"5";"5";"5";"0";"0";"457178";"373889"
"V4mis1";"SILVA (only NR);Archaea;Halobacterota;Halobacteria;Halobacterales;Halococcaceae;uncultured;";"100.0";"18.2";"3";"3";"3";"0";"0";"457180";"373891"
"V4mis1";"SILVA (only NR);Archaea;Halobacterota;Halobacteria;Halobacterales;Haloferacaceae;";"96.4";"18.3";"1634";"1619";"1560";"59";"15";"455564";"372334"
"V4mis1";"SILVA (only NR);Archaea;Halobacterota;Halobacteria;Halobacterales;Haloferacaceae;A07HB70;";"100.0";"18.2";"17";"17";"17";"0";"0";"457166";"373877"
"V4mis1";"SILVA (only NR);Archaea;Halobacterota;Halobacteria;Halobacterales;Haloferacaceae;Candidatus Haloectosymbiotes;";"100.0";"18.2";"1";"1";"1";"0";"0";"457182";"373893"
"V4mis1";"SILVA (only NR);Archaea;Halobacterota;Halobacteria;Halobacterales;Haloferacaceae;Haloarchaeobius;";"100.0";"18.2";"23";"23";"23";"0";"0";"457160";"373871"
"V4mis1";"SILVA (only NR);Archaea;Halobacterota;Halobacteria;Halobacterales;Haloferacaceae;Halobaculum;";"100.0";"18.2";"18";"18";"18";"0";"0";"457165";"373876"
"V4mis1";"SILVA (only NR);Archaea;Halobacterota;Halobacteria;Halobacterales;Haloferacaceae;Halobellus;";"97.7";"18.2";"44";"44";"43";"1";"0";"457139";"373851"
"V4mis1";"SILVA (only NR);Archaea;Halobacterota;Halobacteria;Halobacterales;Haloferacaceae;Halobiforma;";"92.9";"18.2";"14";"14";"13";"1";"0";"457169";"373881"
"V4mis1";"SILVA (only NR);Archaea;Halobacterota;Halobacteria;Halobacterales;Haloferacaceae;Haloferax;";"89.3";"18.2";"113";"112";"100";"12";"1";"457071";"373794"
"V4mis1";"SILVA (only NR);Archaea;Halobacterota;Halobacteria;Halobacterales;Haloferacaceae;Halogeometricum;";"94.6";"18.2";"37";"37";"35";"2";"0";"457146";"373859"
"V4mis1";"SILVA (only NR);Archaea;Halobacterota;Halobacteria;Halobacterales;Haloferacaceae;Halogranum;";"100.0";"18.2";"16";"16";"16";"0";"0";"457167";"373878"
"V4mis1";"SILVA (only NR);Archaea;Halobacterota;Halobacteria;Halobacterales;Haloferacaceae;Halohasta;";"94.1";"18.2";"18";"17";"16";"1";"1";"457166";"373878"
"V4mis1";"SILVA (only NR);Archaea;Halobacterota;Halobacteria;Halobacterales;Haloferacaceae;Halolamina;";"98.4";"18.2";"68";"64";"63";"1";"4";"457119";"373831"
"V4mis1";"SILVA (only NR);Archaea;Halobacterota;Halobacteria;Halobacterales;Haloferacaceae;Halonotius;";"100.0";"18.2";"98";"97";"97";"0";"1";"457086";"373797"
"V4mis1";"SILVA (only NR);Archaea;Halobacterota;Halobacteria;Halobacterales;Haloferacaceae;Haloparvum;";"94.7";"18.2";"38";"38";"36";"2";"0";"457145";"373858"
"V4mis1";"SILVA (only NR);Archaea;Halobacterota;Halobacteria;Halobacterales;Haloferacaceae;Halopelagius;";"100.0";"18.2";"8";"8";"8";"0";"0";"457175";"373886"
"V4mis1";"SILVA (only NR);Archaea;Halobacterota;Halobacteria;Halobacterales;Haloferacaceae;Halopenitus;";"100.0";"18.2";"7";"7";"7";"0";"0";"457176";"373887"
"V4mis1";"SILVA (only NR);Archaea;Halobacterota;Halobacteria;Halobacterales;Haloferacaceae;Halopiger;";"96.0";"18.2";"25";"25";"24";"1";"0";"457158";"373870"
"V4mis1";"SILVA (only NR);Archaea;Halobacterota;Halobacteria;Halobacterales;Haloferacaceae;Haloplanus;";"95.5";"18.2";"44";"44";"42";"2";"0";"457139";"373852"
"V4mis1";"SILVA (only NR);Archaea;Halobacterota;Halobacteria;Halobacterales;Haloferacaceae;Haloquadratum;";"100.0";"18.2";"70";"70";"70";"0";"0";"457113";"373824"
"V4mis1";"SILVA (only NR);Archaea;Halobacterota;Halobacteria;Halobacterales;Haloferacaceae;Halorubellus;";"93.8";"18.2";"16";"16";"15";"1";"0";"457167";"373879"
"V4mis1";"SILVA (only NR);Archaea;Halobacterota;Halobacteria;Halobacterales;Haloferacaceae;Halorubrum;";"96.2";"18.2";"345";"342";"329";"13";"3";"456841";"373565"
"V4mis1";"SILVA (only NR);Archaea;Halobacterota;Halobacteria;Halobacterales;Haloferacaceae;Halorussus;";"97.0";"18.2";"33";"33";"32";"1";"0";"457150";"373862"
"V4mis1";"SILVA (only NR);Archaea;Halobacterota;Halobacteria;Halobacterales;Haloferacaceae;Halostagnicola;";"100.0";"18.2";"17";"17";"17";"0";"0";"457166";"373877"
"V4mis1";"SILVA (only NR);Archaea;Halobacterota;Halobacteria;Halobacterales;Haloferacaceae;Haloterrigena;";"97.6";"18.2";"123";"123";"120";"3";"0";"457060";"373774"
"V4mis1";"SILVA (only NR);Archaea;Halobacterota;Halobacteria;Halobacterales;Haloferacaceae;Halovarius;";"100.0";"18.2";"1";"1";"1";"0";"0";"457182";"373893"
"V4mis1";"SILVA (only NR);Archaea;Halobacterota;Halobacteria;Halobacterales;Haloferacaceae;Halovenus;";"100.0";"18.2";"22";"22";"22";"0";"0";"457161";"373872"
"V4mis1";"SILVA (only NR);Archaea;Halobacterota;Halobacteria;Halobacterales;Haloferacaceae;Halovivax;";"100.0";"18.2";"19";"19";"19";"0";"0";"457164";"373875"
"V4mis1";"SILVA (only NR);Archaea;Halobacterota;Halobacteria;Halobacterales;Haloferacaceae;Natrialba;";"91.5";"18.2";"47";"47";"43";"4";"0";"457136";"373851"
"V4mis1";"SILVA (only NR);Archaea;Halobacterota;Halobacteria;Halobacterales;Haloferacaceae;Natribaculum;";"100.0";"18.2";"2";"2";"2";"0";"0";"457181";"373892"
"V4mis1";"SILVA (only NR);Archaea;Halobacterota;Halobacteria;Halobacterales;Haloferacaceae;Natrinema;";"86.2";"18.2";"29";"29";"25";"4";"0";"457154";"373869"
"V4mis1";"SILVA (only NR);Archaea;Halobacterota;Halobacteria;Halobacterales;Haloferacaceae;Natronoarchaeum;";"100.0";"18.2";"26";"26";"26";"0";"0";"457157";"373868"
"V4mis1";"SILVA (only NR);Archaea;Halobacterota;Halobacteria;Halobacterales;Haloferacaceae;Natronobacterium;";"100.0";"18.2";"10";"9";"9";"0";"1";"457174";"373885"
"V4mis1";"SILVA (only NR);Archaea;Halobacterota;Halobacteria;Halobacterales;Haloferacaceae;Natronococcus;";"89.5";"18.2";"38";"38";"34";"4";"0";"457145";"373860"
"V4mis1";"SILVA (only NR);Archaea;Halobacterota;Halobacteria;Halobacterales;Haloferacaceae;Natronolimnobius;";"81.8";"18.2";"12";"11";"9";"2";"1";"457172";"373885"
"V4mis1";"SILVA (only NR);Archaea;Halobacterota;Halobacteria;Halobacterales;Haloferacaceae;Natronorubrum;";"100.0";"18.2";"43";"43";"43";"0";"0";"457140";"373851"
"V4mis1";"SILVA (only NR);Archaea;Halobacterota;Halobacteria;Halobacterales;Haloferacaceae;Salinarchaeum;";"100.0";"18.2";"17";"17";"17";"0";"0";"457166";"373877"
"V4mis1";"SILVA (only NR);Archaea;Halobacterota;Halobacteria;Halobacterales;Haloferacaceae;Salinigranum;";"100.0";"18.2";"19";"19";"19";"0";"0";"457164";"373875"
"V4mis1";"SILVA (only NR);Archaea;Halobacterota;Halobacteria;Halobacterales;Haloferacaceae;Saliphagus;";"100.0";"18.2";"5";"5";"5";"0";"0";"457178";"373889"
"V4mis1";"SILVA (only NR);Archaea;Halobacterota;Halobacteria;Halobacterales;Haloferacaceae;uncultured;";"100.0";"18.2";"116";"114";"114";"0";"2";"457069";"373780"
"V4mis1";"SILVA (only NR);Archaea;Halobacterota;Halobacteria;Halobacterales;Halomicrobiaceae;";"98.1";"18.2";"641";"637";"625";"12";"4";"456546";"373269"
"V4mis1";"SILVA (only NR);Archaea;Halobacterota;Halobacteria;Halobacterales;Halomicrobiaceae;Candidatus Halobonum;";"100.0";"18.2";"19";"19";"19";"0";"0";"457164";"373875"
"V4mis1";"SILVA (only NR);Archaea;Halobacterota;Halobacteria;Halobacterales;Halomicrobiaceae;Halapricum;";"96.0";"18.2";"50";"50";"48";"2";"0";"457133";"373846"
"V4mis1";"SILVA (only NR);Archaea;Halobacterota;Halobacteria;Halobacterales;Halomicrobiaceae;Haloarcula;";"98.1";"18.2";"214";"212";"208";"4";"2";"456971";"373686"
"V4mis1";"SILVA (only NR);Archaea;Halobacterota;Halobacteria;Halobacterales;Halomicrobiaceae;Halomarina;";"100.0";"18.2";"21";"21";"21";"0";"0";"457162";"373873"
"V4mis1";"SILVA (only NR);Archaea;Halobacterota;Halobacteria;Halobacterales;Halomicrobiaceae;Halomicroarcula;";"100.0";"18.2";"40";"40";"40";"0";"0";"457143";"373854"
"V4mis1";"SILVA (only NR);Archaea;Halobacterota;Halobacteria;Halobacterales;Halomicrobiaceae;Halomicrobium;";"98.4";"18.2";"64";"62";"61";"1";"2";"457121";"373833"
"V4mis1";"SILVA (only NR);Archaea;Halobacterota;Halobacteria;Halobacterales;Halomicrobiaceae;Halorhabdus;";"90.0";"18.2";"20";"20";"18";"2";"0";"457163";"373876"
"V4mis1";"SILVA (only NR);Archaea;Halobacterota;Halobacteria;Halobacterales;Halomicrobiaceae;Halorientalis;";"100.0";"18.2";"18";"18";"18";"0";"0";"457165";"373876"
"V4mis1";"SILVA (only NR);Archaea;Halobacterota;Halobacteria;Halobacterales;Halomicrobiaceae;Halosiccatus;";"100.0";"18.2";"3";"3";"3";"0";"0";"457180";"373891"
"V4mis1";"SILVA (only NR);Archaea;Halobacterota;Halobacteria;Halobacterales;Halomicrobiaceae;Halosimplex;";"100.0";"18.2";"38";"38";"38";"0";"0";"457145";"373856"
"V4mis1";"SILVA (only NR);Archaea;Halobacterota;Halobacteria;Halobacterales;Halomicrobiaceae;Natronomonas;";"97.5";"18.2";"79";"79";"77";"2";"0";"457104";"373817"
"V4mis1";"SILVA (only NR);Archaea;Halobacterota;Halobacteria;Halobacterales;Halomicrobiaceae;Salinirubrum;";"100.0";"18.2";"4";"4";"4";"0";"0";"457179";"373890"
"V4mis1";"SILVA (only NR);Archaea;Halobacterota;Halobacteria;Halobacterales;Halomicrobiaceae;uncultured;";"98.4";"18.2";"64";"64";"63";"1";"0";"457119";"373831"
"V4mis1";"SILVA (only NR);Archaea;Halobacterota;Halobacteria;Halobacterales;J07HX5;";"100.0";"18.2";"3";"3";"3";"0";"0";"457180";"373891"
"V4mis1";"SILVA (only NR);Archaea;Halobacterota;Halobacteria;Halobacterales;uncultured;";"100.0";"18.2";"77";"77";"77";"0";"0";"457106";"373817"
"V4mis1";"SILVA (only NR);Archaea;Halobacterota;Methanocellia;";"94.1";"18.2";"101";"101";"95";"6";"0";"457082";"373799"
"V4mis1";"SILVA (only NR);Archaea;Halobacterota;Methanocellia;Methanocellales;";"94.1";"18.2";"101";"101";"95";"6";"0";"457082";"373799"
"V4mis1";"SILVA (only NR);Archaea;Halobacterota;Methanocellia;Methanocellales;Methanocellaceae;";"95.2";"18.2";"83";"83";"79";"4";"0";"457100";"373815"
"V4mis1";"SILVA (only NR);Archaea;Halobacterota;Methanocellia;Methanocellales;Methanocellaceae;Methanocella;";"91.8";"18.2";"49";"49";"45";"4";"0";"457134";"373849"
"V4mis1";"SILVA (only NR);Archaea;Halobacterota;Methanocellia;Methanocellales;Methanocellaceae;Rice Cluster I;";"100.0";"18.2";"33";"33";"33";"0";"0";"457150";"373861"
"V4mis1";"SILVA (only NR);Archaea;Halobacterota;Methanocellia;Methanocellales;uncultured;";"88.9";"18.2";"18";"18";"16";"2";"0";"457165";"373878"
"V4mis1";"SILVA (only NR);Archaea;Halobacterota;Methanomicrobia;";"94.7";"18.2";"891";"876";"830";"46";"15";"456307";"373064"
"V4mis1";"SILVA (only NR);Archaea;Halobacterota;Methanomicrobia;Methanomicrobiales;";"94.7";"18.2";"891";"876";"830";"46";"15";"456307";"373064"
"V4mis1";"SILVA (only NR);Archaea;Halobacterota;Methanomicrobia;Methanomicrobiales;Methanocorpusculaceae;";"94.8";"18.2";"79";"77";"73";"4";"2";"457106";"373821"
"V4mis1";"SILVA (only NR);Archaea;Halobacterota;Methanomicrobia;Methanomicrobiales;Methanocorpusculaceae;Methanocalculus;";"100.0";"18.2";"34";"34";"34";"0";"0";"457149";"373860"
"V4mis1";"SILVA (only NR);Archaea;Halobacterota;Methanomicrobia;Methanomicrobiales;Methanocorpusculaceae;Methanocorpusculum;";"90.7";"18.2";"45";"43";"39";"4";"2";"457140";"373855"
"V4mis1";"SILVA (only NR);Archaea;Halobacterota;Methanomicrobia;Methanomicrobiales;Methanomicrobiaceae;";"96.7";"18.2";"368";"365";"353";"12";"3";"456818";"373541"
"V4mis1";"SILVA (only NR);Archaea;Halobacterota;Methanomicrobia;Methanomicrobiales;Methanomicrobiaceae;Methanoculleus;";"96.5";"18.2";"204";"202";"195";"7";"2";"456981";"373699"
"V4mis1";"SILVA (only NR);Archaea;Halobacterota;Methanomicrobia;Methanomicrobiales;Methanomicrobiaceae;Methanofollis;";"100.0";"18.2";"22";"22";"22";"0";"0";"457161";"373872"
"V4mis1";"SILVA (only NR);Archaea;Halobacterota;Methanomicrobia;Methanomicrobiales;Methanomicrobiaceae;Methanogenium;";"100.0";"18.2";"32";"32";"32";"0";"0";"457151";"373862"
"V4mis1";"SILVA (only NR);Archaea;Halobacterota;Methanomicrobia;Methanomicrobiales;Methanomicrobiaceae;Methanolacinia;";"100.0";"18.2";"6";"6";"6";"0";"0";"457177";"373888"
"V4mis1";"SILVA (only NR);Archaea;Halobacterota;Methanomicrobia;Methanomicrobiales;Methanomicrobiaceae;Methanomicrobium;";"92.3";"18.2";"39";"39";"36";"3";"0";"457144";"373858"
"V4mis1";"SILVA (only NR);Archaea;Halobacterota;Methanomicrobia;Methanomicrobiales;Methanomicrobiaceae;Methanoplanus;";"100.0";"18.2";"5";"5";"5";"0";"0";"457178";"373889"
"V4mis1";"SILVA (only NR);Archaea;Halobacterota;Methanomicrobia;Methanomicrobiales;Methanomicrobiaceae;SDB;";"100.0";"18.2";"2";"2";"2";"0";"0";"457181";"373892"
"V4mis1";"SILVA (only NR);Archaea;Halobacterota;Methanomicrobia;Methanomicrobiales;Methanomicrobiaceae;uncultured;";"96.2";"18.2";"54";"53";"51";"2";"1";"457130";"373843"
"V4mis1";"SILVA (only NR);Archaea;Halobacterota;Methanomicrobia;Methanomicrobiales;Methanoregulaceae;";"91.6";"18.2";"289";"287";"263";"24";"2";"456896";"373631"
"V4mis1";"SILVA (only NR);Archaea;Halobacterota;Methanomicrobia;Methanomicrobiales;Methanoregulaceae;Methanolinea;";"99.0";"18.2";"99";"97";"96";"1";"2";"457086";"373798"
"V4mis1";"SILVA (only NR);Archaea;Halobacterota;Methanomicrobia;Methanomicrobiales;Methanoregulaceae;Methanoregula;";"87.6";"18.2";"186";"186";"163";"23";"0";"456997";"373731"
"V4mis1";"SILVA (only NR);Archaea;Halobacterota;Methanomicrobia;Methanomicrobiales;Methanoregulaceae;Methanosphaerula;";"100.0";"18.2";"4";"4";"4";"0";"0";"457179";"373890"
"V4mis1";"SILVA (only NR);Archaea;Halobacterota;Methanomicrobia;Methanomicrobiales;Methanospirillaceae;";"95.6";"18.2";"115";"113";"108";"5";"2";"457070";"373786"
"V4mis1";"SILVA (only NR);Archaea;Halobacterota;Methanomicrobia;Methanomicrobiales;Methanospirillaceae;Methanospirillum;";"95.6";"18.2";"115";"113";"108";"5";"2";"457070";"373786"
"V4mis1";"SILVA (only NR);Archaea;Halobacterota;Methanomicrobia;Methanomicrobiales;Rice Cluster II;";"100.0";"18.2";"18";"14";"14";"0";"4";"457169";"373880"
"V4mis1";"SILVA (only NR);Archaea;Halobacterota;Methanomicrobia;Methanomicrobiales;uncultured;";"94.7";"18.2";"20";"19";"18";"1";"1";"457164";"373876"
"V4mis1";"SILVA (only NR);Archaea;Halobacterota;Methanonatronarchaeia;";"100.0";"18.2";"15";"15";"15";"0";"0";"457168";"373879"
"V4mis1";"SILVA (only NR);Archaea;Halobacterota;Methanonatronarchaeia;Methanonatronaechaeales;";"100.0";"18.2";"15";"15";"15";"0";"0";"457168";"373879"
"V4mis1";"SILVA (only NR);Archaea;Halobacterota;Methanonatronarchaeia;Methanonatronaechaeales;Methanonatronarchaeaceae;";"100.0";"18.2";"15";"15";"15";"0";"0";"457168";"373879"
"V4mis1";"SILVA (only NR);Archaea;Halobacterota;Methanosarcinia;";"94.6";"18.3";"1470";"1454";"1375";"79";"16";"455729";"372519"
"V4mis1";"SILVA (only NR);Archaea;Halobacterota;Methanosarcinia;Methanosarciniales;";"94.6";"18.3";"1470";"1454";"1375";"79";"16";"455729";"372519"
"V4mis1";"SILVA (only NR);Archaea;Halobacterota;Methanosarcinia;Methanosarciniales;ANME-2a-2b;";"93.6";"18.2";"111";"110";"103";"7";"1";"457073";"373791"
"V4mis1";"SILVA (only NR);Archaea;Halobacterota;Methanosarcinia;Methanosarciniales;ANME-2a-2b;ANME-2b;";"100.0";"18.2";"11";"11";"11";"0";"0";"457172";"373883"
"V4mis1";"SILVA (only NR);Archaea;Halobacterota;Methanosarcinia;Methanosarciniales;ANME-2c;";"91.8";"18.2";"86";"85";"78";"7";"1";"457098";"373816"
"V4mis1";"SILVA (only NR);Archaea;Halobacterota;Methanosarcinia;Methanosarciniales;Methanoperedenaceae;";"99.1";"18.2";"117";"117";"116";"1";"0";"457066";"373778"
"V4mis1";"SILVA (only NR);Archaea;Halobacterota;Methanosarcinia;Methanosarciniales;Methanoperedenaceae;Candidatus Methanoperedens;";"98.9";"18.2";"87";"87";"86";"1";"0";"457096";"373808"
"V4mis1";"SILVA (only NR);Archaea;Halobacterota;Methanosarcinia;Methanosarciniales;Methanosaetaceae;";"93.9";"18.2";"564";"560";"526";"34";"4";"456623";"373368"
"V4mis1";"SILVA (only NR);Archaea;Halobacterota;Methanosarcinia;Methanosarciniales;Methanosaetaceae;Methanosaeta;";"93.9";"18.2";"564";"560";"526";"34";"4";"456623";"373368"
"V4mis1";"SILVA (only NR);Archaea;Halobacterota;Methanosarcinia;Methanosarciniales;Methanosarcinaceae;";"94.5";"18.2";"555";"545";"515";"30";"10";"456638";"373379"
"V4mis1";"SILVA (only NR);Archaea;Halobacterota;Methanosarcinia;Methanosarciniales;Methanosarcinaceae;ANME-3;";"97.8";"18.2";"46";"46";"45";"1";"0";"457137";"373849"
"V4mis1";"SILVA (only NR);Archaea;Halobacterota;Methanosarcinia;Methanosarciniales;Methanosarcinaceae;Methanimicrococcus;";"100.0";"18.2";"34";"34";"34";"0";"0";"457149";"373860"
"V4mis1";"SILVA (only NR);Archaea;Halobacterota;Methanosarcinia;Methanosarciniales;Methanosarcinaceae;Methanococcoides;";"95.6";"18.2";"45";"45";"43";"2";"0";"457138";"373851"
"V4mis1";"SILVA (only NR);Archaea;Halobacterota;Methanosarcinia;Methanosarciniales;Methanosarcinaceae;Methanohalobium;";"100.0";"18.2";"4";"4";"4";"0";"0";"457179";"373890"
"V4mis1";"SILVA (only NR);Archaea;Halobacterota;Methanosarcinia;Methanosarciniales;Methanosarcinaceae;Methanohalophilus;";"92.3";"18.2";"39";"39";"36";"3";"0";"457144";"373858"
"V4mis1";"SILVA (only NR);Archaea;Halobacterota;Methanosarcinia;Methanosarciniales;Methanosarcinaceae;Methanolobus;";"92.4";"18.2";"66";"66";"61";"5";"0";"457117";"373833"
"V4mis1";"SILVA (only NR);Archaea;Halobacterota;Methanosarcinia;Methanosarciniales;Methanosarcinaceae;Methanomethylovorans;";"95.9";"18.2";"49";"49";"47";"2";"0";"457134";"373847"
"V4mis1";"SILVA (only NR);Archaea;Halobacterota;Methanosarcinia;Methanosarciniales;Methanosarcinaceae;Methanosalsum;";"100.0";"18.2";"3";"3";"3";"0";"0";"457180";"373891"
"V4mis1";"SILVA (only NR);Archaea;Halobacterota;Methanosarcinia;Methanosarciniales;Methanosarcinaceae;Methanosarcina;";"93.4";"18.2";"251";"241";"225";"16";"10";"456942";"373669"
"V4mis1";"SILVA (only NR);Archaea;Halobacterota;Methanosarcinia;Methanosarciniales;Methanosarcinaceae;uncultured;";"94.4";"18.2";"18";"18";"17";"1";"0";"457165";"373877"
"V4mis1";"SILVA (only NR);Archaea;Halobacterota;Methanosarcinia;Methanosarciniales;Methermicoccaceae;";"100.0";"18.2";"5";"5";"5";"0";"0";"457178";"373889"
"V4mis1";"SILVA (only NR);Archaea;Halobacterota;Methanosarcinia;Methanosarciniales;Methermicoccaceae;Methermicoccus;";"100.0";"18.2";"4";"4";"4";"0";"0";"457179";"373890"
"V4mis1";"SILVA (only NR);Archaea;Halobacterota;Methanosarcinia;Methanosarciniales;Syntrophoarchaeaceae;";"100.0";"18.2";"28";"28";"28";"0";"0";"457155";"373866"
"V4mis1";"SILVA (only NR);Archaea;Halobacterota;Methanosarcinia;Methanosarciniales;Syntrophoarchaeaceae;Candidatus Syntrophoarchaeum;";"100.0";"18.2";"4";"4";"4";"0";"0";"457179";"373890"
"V4mis1";"SILVA (only NR);Archaea;Halobacterota;uncultured;";"94.1";"18.2";"17";"17";"16";"1";"0";"457166";"373878"
"V4mis1";"SILVA (only NR);Archaea;Hydrothermarchaeota;";"94.8";"18.2";"212";"212";"201";"11";"0";"456971";"373693"
"V4mis1";"SILVA (only NR);Archaea;Hydrothermarchaeota;Hydrothermarchaeia;";"94.8";"18.2";"212";"212";"201";"11";"0";"456971";"373693"
"V4mis1";"SILVA (only NR);Archaea;Hydrothermarchaeota;Hydrothermarchaeia;Hydrothermarchaeales;";"94.8";"18.2";"212";"212";"201";"11";"0";"456971";"373693"
"V4mis1";"SILVA (only NR);Archaea;Iainarchaeota;";"80.0";"18.2";"46";"45";"36";"9";"1";"457138";"373858"
"V4mis1";"SILVA (only NR);Archaea;Iainarchaeota;Iainarchaeia;";"80.0";"18.2";"46";"45";"36";"9";"1";"457138";"373858"
"V4mis1";"SILVA (only NR);Archaea;Iainarchaeota;Iainarchaeia;Iainarchaeales;";"80.0";"18.2";"46";"45";"36";"9";"1";"457138";"373858"
"V4mis1";"SILVA (only NR);Archaea;Iainarchaeota;Iainarchaeia;Iainarchaeales;Candidatus Iainarchaeum;";"73.3";"18.2";"15";"15";"11";"4";"0";"457168";"373883"
"V4mis1";"SILVA (only NR);Archaea;Korarchaeota;";"93.4";"18.2";"62";"61";"57";"4";"1";"457122";"373837"
"V4mis1";"SILVA (only NR);Archaea;Korarchaeota;Korarchaeia;";"93.4";"18.2";"62";"61";"57";"4";"1";"457122";"373837"
"V4mis1";"SILVA (only NR);Archaea;Korarchaeota;Korarchaeia;Korarchaeales;";"93.4";"18.2";"62";"61";"57";"4";"1";"457122";"373837"
"V4mis1";"SILVA (only NR);Archaea;Korarchaeota;Korarchaeia;Korarchaeales;Korarchaeaceae;";"93.4";"18.2";"62";"61";"57";"4";"1";"457122";"373837"
"V4mis1";"SILVA (only NR);Archaea;Korarchaeota;Korarchaeia;Korarchaeales;Korarchaeaceae;Candidatus Korarchaeum;";"93.4";"18.2";"62";"61";"57";"4";"1";"457122";"373837"
"V4mis1";"SILVA (only NR);Archaea;Micrarchaeota;";"57.0";"18.2";"88";"86";"49";"37";"2";"457097";"373845"
"V4mis1";"SILVA (only NR);Archaea;Micrarchaeota;Micrarchaeia;";"57.0";"18.2";"88";"86";"49";"37";"2";"457097";"373845"
"V4mis1";"SILVA (only NR);Archaea;Micrarchaeota;Micrarchaeia;Micrarchaeales;";"57.0";"18.2";"88";"86";"49";"37";"2";"457097";"373845"
"V4mis1";"SILVA (only NR);Archaea;Micrarchaeota;Micrarchaeia;Micrarchaeales;CG1-02-32-21;";"100.0";"18.2";"12";"12";"12";"0";"0";"457171";"373882"
"V4mis1";"SILVA (only NR);Archaea;Micrarchaeota;Micrarchaeia;Micrarchaeales;Candidatus Micrarchaeum;";"0.0";"0";"10";"10";"0";"10";"0";"457173";"373894"
"V4mis1";"SILVA (only NR);Archaea;Nanoarchaeota;";"83.3";"18.2";"550";"514";"428";"86";"36";"456669";"373466"
"V4mis1";"SILVA (only NR);Archaea;Nanoarchaeota;Nanoarchaeia;";"83.3";"18.2";"550";"514";"428";"86";"36";"456669";"373466"
"V4mis1";"SILVA (only NR);Archaea;Nanoarchaeota;Nanoarchaeia;Nanoarchaeales;";"0.0";"0";"40";"39";"0";"39";"1";"457144";"373894"
"V4mis1";"SILVA (only NR);Archaea;Nanoarchaeota;Nanoarchaeia;Nanoarchaeales;Nanoarchaeaceae;";"0.0";"0";"22";"21";"0";"21";"1";"457162";"373894"
"V4mis1";"SILVA (only NR);Archaea;Nanoarchaeota;Nanoarchaeia;Nanoarchaeales;Nanoarchaeaceae;Nanoarchaeum;";"0.0";"0";"22";"21";"0";"21";"1";"457162";"373894"
"V4mis1";"SILVA (only NR);Archaea;Nanoarchaeota;Nanoarchaeia;Nanoarchaeales;Nanopusillaceae;";"0.0";"0";"18";"18";"0";"18";"0";"457165";"373894"
"V4mis1";"SILVA (only NR);Archaea;Nanoarchaeota;Nanoarchaeia;Nanoarchaeales;Nanopusillaceae;Candidatus Nanobsidianus;";"0.0";"0";"11";"11";"0";"11";"0";"457172";"373894"
"V4mis1";"SILVA (only NR);Archaea;Nanoarchaeota;Nanoarchaeia;Nanoarchaeales;Nanopusillaceae;Candidatus Nanopusillus;";"0.0";"0";"7";"7";"0";"7";"0";"457176";"373894"
"V4mis1";"SILVA (only NR);Archaea;Nanoarchaeota;Nanoarchaeia;Woesearchaeales;";"90.1";"18.2";"510";"475";"428";"47";"35";"456708";"373466"
"V4mis1";"SILVA (only NR);Archaea;Nanoarchaeota;Nanoarchaeia;Woesearchaeales;CG1-02-57-44;";"100.0";"18.2";"10";"10";"10";"0";"0";"457173";"373884"
"V4mis1";"SILVA (only NR);Archaea;Nanoarchaeota;Nanoarchaeia;Woesearchaeales;GW2011;";"96.8";"18.2";"32";"31";"30";"1";"1";"457152";"373864"
"V4mis1";"SILVA (only NR);Archaea;Nanoarchaeota;Nanoarchaeia;Woesearchaeales;GW2011;AR15;";"100.0";"18.2";"28";"27";"27";"0";"1";"457156";"373867"
"V4mis1";"SILVA (only NR);Archaea;Nanoarchaeota;Nanoarchaeia;Woesearchaeales;GW2011;AR20;";"75.0";"18.2";"4";"4";"3";"1";"0";"457179";"373891"
"V4mis1";"SILVA (only NR);Archaea;Nanoarchaeota;Nanoarchaeia;Woesearchaeales;GW2011_GWC1_47_15;";"100.0";"18.2";"6";"6";"6";"0";"0";"457177";"373888"
"V4mis1";"SILVA (only NR);Archaea;Nanoarchaeota;Nanoarchaeia;Woesearchaeales;SCGC AAA011-D5;";"100.0";"18.2";"17";"14";"14";"0";"3";"457169";"373880"
"V4mis1";"SILVA (only NR);Archaea;Nanoarchaeota;Nanoarchaeia;Woesearchaeales;SCGC AAA286-E23;";"100.0";"18.2";"6";"6";"6";"0";"0";"457177";"373888"
"V4mis1";"SILVA (only NR);Archaea;Nanohaloarchaeota;";"88.2";"18.2";"34";"34";"30";"4";"0";"457149";"373864"
"V4mis1";"SILVA (only NR);Archaea;Nanohaloarchaeota;Nanosalinia;";"88.2";"18.2";"34";"34";"30";"4";"0";"457149";"373864"
"V4mis1";"SILVA (only NR);Archaea;Nanohaloarchaeota;Nanosalinia;Nanosalinales;";"88.2";"18.2";"34";"34";"30";"4";"0";"457149";"373864"
"V4mis1";"SILVA (only NR);Archaea;Nanohaloarchaeota;Nanosalinia;Nanosalinales;Nanosalinaceae;";"88.2";"18.2";"34";"34";"30";"4";"0";"457149";"373864"
"V4mis1";"SILVA (only NR);Archaea;Nanohaloarchaeota;Nanosalinia;Nanosalinales;Nanosalinaceae;Candidatus Haloredivivus;";"94.4";"18.2";"18";"18";"17";"1";"0";"457165";"373877"
"V4mis1";"SILVA (only NR);Archaea;Nanohaloarchaeota;Nanosalinia;Nanosalinales;Nanosalinaceae;Candidatus Nanosalinarum;";"100.0";"18.2";"6";"6";"6";"0";"0";"457177";"373888"
"V4mis1";"SILVA (only NR);Archaea;Thermoplasmatota;";"95.4";"18.3";"2896";"2872";"2741";"131";"24";"454311";"371153"
"V4mis1";"SILVA (only NR);Archaea;Thermoplasmatota;Thermoplasmata;";"95.3";"18.3";"2819";"2796";"2665";"131";"23";"454387";"371229"
"V4mis1";"SILVA (only NR);Archaea;Thermoplasmatota;Thermoplasmata;A10;";"93.1";"18.2";"29";"29";"27";"2";"0";"457154";"373867"
"V4mis1";"SILVA (only NR);Archaea;Thermoplasmatota;Thermoplasmata;Acidiprofundales;";"100.0";"18.2";"35";"35";"35";"0";"0";"457148";"373859"
"V4mis1";"SILVA (only NR);Archaea;Thermoplasmatota;Thermoplasmata;Acidiprofundales;Aciduliprofundaceae;";"100.0";"18.2";"35";"35";"35";"0";"0";"457148";"373859"
"V4mis1";"SILVA (only NR);Archaea;Thermoplasmatota;Thermoplasmata;Acidiprofundales;Aciduliprofundaceae;Aciduliprofundum;";"100.0";"18.2";"32";"32";"32";"0";"0";"457151";"373862"
"V4mis1";"SILVA (only NR);Archaea;Thermoplasmatota;Thermoplasmata;Acidiprofundales;Aciduliprofundaceae;JdFR-45;";"100.0";"18.2";"3";"3";"3";"0";"0";"457180";"373891"
"V4mis1";"SILVA (only NR);Archaea;Thermoplasmatota;Thermoplasmata;BSLdp215;";"92.0";"18.2";"25";"25";"23";"2";"0";"457158";"373871"
"V4mis1";"SILVA (only NR);Archaea;Thermoplasmatota;Thermoplasmata;JdFR-43;";"63.6";"18.2";"44";"44";"28";"16";"0";"457139";"373866"
"V4mis1";"SILVA (only NR);Archaea;Thermoplasmatota;Thermoplasmata;Marine Benthic Group D and DHVEG-1;";"96.3";"18.2";"765";"758";"730";"28";"7";"456425";"373164"
"V4mis1";"SILVA (only NR);Archaea;Thermoplasmatota;Thermoplasmata;Marine Group II;";"95.3";"18.2";"574";"570";"543";"27";"4";"456613";"373351"
"V4mis1";"SILVA (only NR);Archaea;Thermoplasmatota;Thermoplasmata;Marine Group III;";"97.1";"18.2";"282";"275";"267";"8";"7";"456908";"373627"
"V4mis1";"SILVA (only NR);Archaea;Thermoplasmatota;Thermoplasmata;Methanomassiliicoccales;";"97.2";"18.2";"495";"495";"481";"14";"0";"456688";"373413"
"V4mis1";"SILVA (only NR);Archaea;Thermoplasmatota;Thermoplasmata;Methanomassiliicoccales;Methanomassiliicoccaceae;";"98.4";"18.2";"62";"62";"61";"1";"0";"457121";"373833"
"V4mis1";"SILVA (only NR);Archaea;Thermoplasmatota;Thermoplasmata;Methanomassiliicoccales;Methanomassiliicoccaceae;Methanomassiliicoccus;";"95.0";"18.2";"20";"20";"19";"1";"0";"457163";"373875"
"V4mis1";"SILVA (only NR);Archaea;Thermoplasmatota;Thermoplasmata;Methanomassiliicoccales;Methanomassiliicoccaceae;uncultured;";"100.0";"18.2";"42";"42";"42";"0";"0";"457141";"373852"
"V4mis1";"SILVA (only NR);Archaea;Thermoplasmatota;Thermoplasmata;Methanomassiliicoccales;Methanomethylophilaceae;";"96.8";"18.2";"347";"347";"336";"11";"0";"456836";"373558"
"V4mis1";"SILVA (only NR);Archaea;Thermoplasmatota;Thermoplasmata;Methanomassiliicoccales;Methanomethylophilaceae;Candidatus Methanogranum;";"100.0";"18.2";"7";"7";"7";"0";"0";"457176";"373887"
"V4mis1";"SILVA (only NR);Archaea;Thermoplasmatota;Thermoplasmata;Methanomassiliicoccales;Methanomethylophilaceae;Candidatus Methanomethylophilus;";"93.0";"18.2";"71";"71";"66";"5";"0";"457112";"373828"
"V4mis1";"SILVA (only NR);Archaea;Thermoplasmatota;Thermoplasmata;Methanomassiliicoccales;Methanomethylophilaceae;Candidatus Methanoplasma;";"93.1";"18.2";"29";"29";"27";"2";"0";"457154";"373867"
"V4mis1";"SILVA (only NR);Archaea;Thermoplasmatota;Thermoplasmata;Methanomassiliicoccales;Methanomethylophilaceae;RumEn M2;";"92.3";"18.2";"13";"13";"12";"1";"0";"457170";"373882"
"V4mis1";"SILVA (only NR);Archaea;Thermoplasmatota;Thermoplasmata;Methanomassiliicoccales;Methanomethylophilaceae;uncultured;";"98.7";"18.2";"224";"224";"221";"3";"0";"456959";"373673"
"V4mis1";"SILVA (only NR);Archaea;Thermoplasmatota;Thermoplasmata;Methanomassiliicoccales;uncultured;";"97.7";"18.2";"86";"86";"84";"2";"0";"457097";"373810"
"V4mis1";"SILVA (only NR);Archaea;Thermoplasmatota;Thermoplasmata;SG8-5;";"93.7";"18.2";"63";"63";"59";"4";"0";"457120";"373835"
"V4mis1";"SILVA (only NR);Archaea;Thermoplasmatota;Thermoplasmata;Thermoplasmatales;";"97.5";"18.2";"161";"159";"155";"4";"2";"457024";"373739"
"V4mis1";"SILVA (only NR);Archaea;Thermoplasmatota;Thermoplasmata;Thermoplasmatales;Ferroplasmaceae;";"100.0";"18.2";"69";"68";"68";"0";"1";"457115";"373826"
"V4mis1";"SILVA (only NR);Archaea;Thermoplasmatota;Thermoplasmata;Thermoplasmatales;Ferroplasmaceae;Acidiplasma;";"100.0";"18.2";"8";"7";"7";"0";"1";"457176";"373887"
"V4mis1";"SILVA (only NR);Archaea;Thermoplasmatota;Thermoplasmata;Thermoplasmatales;Ferroplasmaceae;Ferroplasma;";"100.0";"18.2";"38";"38";"38";"0";"0";"457145";"373856"
"V4mis1";"SILVA (only NR);Archaea;Thermoplasmatota;Thermoplasmata;Thermoplasmatales;Ferroplasmaceae;uncultured;";"100.0";"18.2";"15";"15";"15";"0";"0";"457168";"373879"
"V4mis1";"SILVA (only NR);Archaea;Thermoplasmatota;Thermoplasmata;Thermoplasmatales;Picrophilaceae;";"100.0";"18.2";"2";"2";"2";"0";"0";"457181";"373892"
"V4mis1";"SILVA (only NR);Archaea;Thermoplasmatota;Thermoplasmata;Thermoplasmatales;Picrophilaceae;Picrophilus;";"100.0";"18.2";"2";"2";"2";"0";"0";"457181";"373892"
"V4mis1";"SILVA (only NR);Archaea;Thermoplasmatota;Thermoplasmata;Thermoplasmatales;Thermogymnomonas;";"100.0";"18.2";"1";"1";"1";"0";"0";"457182";"373893"
"V4mis1";"SILVA (only NR);Archaea;Thermoplasmatota;Thermoplasmata;Thermoplasmatales;Thermoplasmataceae;";"95.5";"18.2";"89";"88";"84";"4";"1";"457095";"373810"
"V4mis1";"SILVA (only NR);Archaea;Thermoplasmatota;Thermoplasmata;Thermoplasmatales;Thermoplasmataceae;A-plasma;";"92.9";"18.2";"14";"14";"13";"1";"0";"457169";"373881"
"V4mis1";"SILVA (only NR);Archaea;Thermoplasmatota;Thermoplasmata;Thermoplasmatales;Thermoplasmataceae;Cuniculiplasma;";"100.0";"18.2";"12";"12";"12";"0";"0";"457171";"373882"
"V4mis1";"SILVA (only NR);Archaea;Thermoplasmatota;Thermoplasmata;Thermoplasmatales;Thermoplasmataceae;E-plasma;";"100.0";"18.2";"10";"10";"10";"0";"0";"457173";"373884"
"V4mis1";"SILVA (only NR);Archaea;Thermoplasmatota;Thermoplasmata;Thermoplasmatales;Thermoplasmataceae;Thermoplasma;";"100.0";"18.2";"11";"11";"11";"0";"0";"457172";"373883"
"V4mis1";"SILVA (only NR);Archaea;Thermoplasmatota;Thermoplasmata;Thermoplasmatales;Thermoplasmataceae;uncultured;";"92.1";"18.2";"39";"38";"35";"3";"1";"457145";"373859"
"V4mis1";"SILVA (only NR);Archaea;Thermoplasmatota;Thermoplasmata;uncultured;";"92.4";"18.2";"345";"342";"316";"26";"3";"456841";"373578"
"V4mis1";"SILVA (only NR);Archaea;Thermoplasmatota;uncultured;";"100.0";"18.2";"76";"75";"75";"0";"1";"457108";"373819"
"V4mis1";"SILVA (only NR);Archaea;uncultured;";"75.0";"18.2";"8";"8";"6";"2";"0";"457175";"373888"
"V4mis1";"SILVA (only NR);Bacteria;";"92.8";"73.7";"381535";"381528";"353970";"27558";"7";"75655";"19924"
"V4mis1";"SILVA (only NR);Bacteria;10bav-F6;";"100.0";"18.2";"6";"6";"6";"0";"0";"457177";"373888"
"V4mis1";"SILVA (only NR);Bacteria;Abditibacteriota;";"92.6";"18.2";"162";"162";"150";"12";"0";"457021";"373744"
"V4mis1";"SILVA (only NR);Bacteria;Abditibacteriota;Abditibacteria;";"92.6";"18.2";"162";"162";"150";"12";"0";"457021";"373744"
"V4mis1";"SILVA (only NR);Bacteria;Abditibacteriota;Abditibacteria;Abditibacteriales;";"92.6";"18.2";"162";"162";"150";"12";"0";"457021";"373744"
"V4mis1";"SILVA (only NR);Bacteria;Abditibacteriota;Abditibacteria;Abditibacteriales;Abditibacteriaceae;";"92.6";"18.2";"162";"162";"150";"12";"0";"457021";"373744"
"V4mis1";"SILVA (only NR);Bacteria;Abditibacteriota;Abditibacteria;Abditibacteriales;Abditibacteriaceae;Abditibacterium;";"92.6";"18.2";"162";"162";"150";"12";"0";"457021";"373744"
"V4mis1";"SILVA (only NR);Bacteria;Acetothermia;";"97.6";"18.2";"169";"169";"165";"4";"0";"457014";"373729"
"V4mis1";"SILVA (only NR);Bacteria;Acetothermia;Acetothermiia;";"97.6";"18.2";"169";"169";"165";"4";"0";"457014";"373729"
"V4mis1";"SILVA (only NR);Bacteria;Acidobacteriota;";"95.5";"18.6";"11563";"11563";"11039";"524";"0";"445620";"362855"
"V4mis1";"SILVA (only NR);Bacteria;Acidobacteriota;AT-s3-28;";"92.6";"18.2";"27";"27";"25";"2";"0";"457156";"373869"
"V4mis1";"SILVA (only NR);Bacteria;Acidobacteriota;Acidobacteriae;";"96.4";"18.3";"3697";"3697";"3563";"134";"0";"453486";"370331"
"V4mis1";"SILVA (only NR);Bacteria;Acidobacteriota;Acidobacteriae;AKIW659;";"93.1";"18.2";"29";"29";"27";"2";"0";"457154";"373867"
"V4mis1";"SILVA (only NR);Bacteria;Acidobacteriota;Acidobacteriae;AMGG11;";"100.0";"18.2";"5";"5";"5";"0";"0";"457178";"373889"
"V4mis1";"SILVA (only NR);Bacteria;Acidobacteriota;Acidobacteriae;Acidobacteriales;";"96.6";"18.3";"1621";"1621";"1566";"55";"0";"455562";"372328"
"V4mis1";"SILVA (only NR);Bacteria;Acidobacteriota;Acidobacteriae;Acidobacteriales;Acidobacteriaceae (Subgroup 1);";"95.9";"18.2";"740";"740";"710";"30";"0";"456443";"373184"
"V4mis1";"SILVA (only NR);Bacteria;Acidobacteriota;Acidobacteriae;Acidobacteriales;Acidobacteriaceae (Subgroup 1);Acidicapsa;";"94.7";"18.2";"19";"19";"18";"1";"0";"457164";"373876"
"V4mis1";"SILVA (only NR);Bacteria;Acidobacteriota;Acidobacteriae;Acidobacteriales;Acidobacteriaceae (Subgroup 1);Acidipila-Silvibacterium;";"97.6";"18.2";"83";"83";"81";"2";"0";"457100";"373813"
"V4mis1";"SILVA (only NR);Bacteria;Acidobacteriota;Acidobacteriae;Acidobacteriales;Acidobacteriaceae (Subgroup 1);Acidobacterium;";"100.0";"18.2";"12";"12";"12";"0";"0";"457171";"373882"
"V4mis1";"SILVA (only NR);Bacteria;Acidobacteriota;Acidobacteriae;Acidobacteriales;Acidobacteriaceae (Subgroup 1);Bryocella;";"96.4";"18.2";"28";"28";"27";"1";"0";"457155";"373867"
"V4mis1";"SILVA (only NR);Bacteria;Acidobacteriota;Acidobacteriae;Acidobacteriales;Acidobacteriaceae (Subgroup 1);Edaphobacter;";"98.1";"18.2";"52";"52";"51";"1";"0";"457131";"373843"
"V4mis1";"SILVA (only NR);Bacteria;Acidobacteriota;Acidobacteriae;Acidobacteriales;Acidobacteriaceae (Subgroup 1);Granulicella;";"93.2";"18.2";"190";"190";"177";"13";"0";"456993";"373717"
"V4mis1";"SILVA (only NR);Bacteria;Acidobacteriota;Acidobacteriae;Acidobacteriales;Acidobacteriaceae (Subgroup 1);Occallatibacter;";"97.6";"18.2";"126";"126";"123";"3";"0";"457057";"373771"
"V4mis1";"SILVA (only NR);Bacteria;Acidobacteriota;Acidobacteriae;Acidobacteriales;Acidobacteriaceae (Subgroup 1);Telmatobacter;";"100.0";"18.2";"4";"4";"4";"0";"0";"457179";"373890"
"V4mis1";"SILVA (only NR);Bacteria;Acidobacteriota;Acidobacteriae;Acidobacteriales;Acidobacteriaceae (Subgroup 1);Terracidiphilus;";"100.0";"18.2";"9";"9";"9";"0";"0";"457174";"373885"
"V4mis1";"SILVA (only NR);Bacteria;Acidobacteriota;Acidobacteriae;Acidobacteriales;Acidobacteriaceae (Subgroup 1);Terriglobus;";"100.0";"18.2";"27";"27";"27";"0";"0";"457156";"373867"
"V4mis1";"SILVA (only NR);Bacteria;Acidobacteriota;Acidobacteriae;Acidobacteriales;Acidobacteriaceae (Subgroup 1);uncultured;";"95.1";"18.2";"184";"184";"175";"9";"0";"456999";"373719"
"V4mis1";"SILVA (only NR);Bacteria;Acidobacteriota;Acidobacteriae;Acidobacteriales;Koribacteraceae;";"98.9";"18.2";"90";"90";"89";"1";"0";"457093";"373805"
"V4mis1";"SILVA (only NR);Bacteria;Acidobacteriota;Acidobacteriae;Acidobacteriales;Koribacteraceae;Candidatus Koribacter;";"98.9";"18.2";"90";"90";"89";"1";"0";"457093";"373805"
"V4mis1";"SILVA (only NR);Bacteria;Acidobacteriota;Acidobacteriae;Acidobacteriales;uncultured;";"96.9";"18.2";"785";"785";"761";"24";"0";"456398";"373133"
"V4mis1";"SILVA (only NR);Bacteria;Acidobacteriota;Acidobacteriae;Bryobacterales;";"94.3";"18.2";"663";"663";"625";"38";"0";"456520";"373269"
"V4mis1";"SILVA (only NR);Bacteria;Acidobacteriota;Acidobacteriae;Bryobacterales;Bryobacteraceae;";"94.3";"18.2";"663";"663";"625";"38";"0";"456520";"373269"
"V4mis1";"SILVA (only NR);Bacteria;Acidobacteriota;Acidobacteriae;Bryobacterales;Bryobacteraceae;Bryobacter;";"94.3";"18.2";"663";"663";"625";"38";"0";"456520";"373269"
"V4mis1";"SILVA (only NR);Bacteria;Acidobacteriota;Acidobacteriae;Elev-16S-1166;";"100.0";"18.2";"16";"16";"16";"0";"0";"457167";"373878"
"V4mis1";"SILVA (only NR);Bacteria;Acidobacteriota;Acidobacteriae;GOUTB8;";"100.0";"18.2";"16";"16";"16";"0";"0";"457167";"373878"
"V4mis1";"SILVA (only NR);Bacteria;Acidobacteriota;Acidobacteriae;PAUC26f;";"95.2";"18.2";"84";"84";"80";"4";"0";"457099";"373814"
"V4mis1";"SILVA (only NR);Bacteria;Acidobacteriota;Acidobacteriae;Paludibaculum;";"98.1";"18.2";"103";"103";"101";"2";"0";"457080";"373793"
"V4mis1";"SILVA (only NR);Bacteria;Acidobacteriota;Acidobacteriae;Solibacterales;";"96.9";"18.2";"551";"551";"534";"17";"0";"456632";"373360"
"V4mis1";"SILVA (only NR);Bacteria;Acidobacteriota;Acidobacteriae;Solibacterales;Solibacteraceae;";"96.9";"18.2";"551";"551";"534";"17";"0";"456632";"373360"
"V4mis1";"SILVA (only NR);Bacteria;Acidobacteriota;Acidobacteriae;Solibacterales;Solibacteraceae;Candidatus Solibacter;";"96.9";"18.2";"551";"551";"534";"17";"0";"456632";"373360"
"V4mis1";"SILVA (only NR);Bacteria;Acidobacteriota;Acidobacteriae;Subgroup 12;";"100.0";"18.2";"11";"11";"11";"0";"0";"457172";"373883"
"V4mis1";"SILVA (only NR);Bacteria;Acidobacteriota;Acidobacteriae;Subgroup 13;";"97.7";"18.2";"88";"88";"86";"2";"0";"457095";"373808"
"V4mis1";"SILVA (only NR);Bacteria;Acidobacteriota;Acidobacteriae;Subgroup 15;";"96.2";"18.2";"52";"52";"50";"2";"0";"457131";"373844"
"V4mis1";"SILVA (only NR);Bacteria;Acidobacteriota;Acidobacteriae;Subgroup 2;";"97.3";"18.2";"450";"450";"438";"12";"0";"456733";"373456"
"V4mis1";"SILVA (only NR);Bacteria;Acidobacteriota;Acidobacteriae;TSBb06;";"100.0";"18.2";"2";"2";"2";"0";"0";"457181";"373892"
"V4mis1";"SILVA (only NR);Bacteria;Acidobacteriota;Aminicenantia;";"93.9";"18.2";"459";"459";"431";"28";"0";"456724";"373463"
"V4mis1";"SILVA (only NR);Bacteria;Acidobacteriota;Aminicenantia;Aminicenantales;";"93.9";"18.2";"459";"459";"431";"28";"0";"456724";"373463"
"V4mis1";"SILVA (only NR);Bacteria;Acidobacteriota;Blastocatellia;";"94.1";"18.3";"1876";"1876";"1765";"111";"0";"455307";"372129"
"V4mis1";"SILVA (only NR);Bacteria;Acidobacteriota;Blastocatellia;11-24;";"93.8";"18.2";"292";"292";"274";"18";"0";"456891";"373620"
"V4mis1";"SILVA (only NR);Bacteria;Acidobacteriota;Blastocatellia;Blastocatellales;";"96.3";"18.2";"647";"647";"623";"24";"0";"456536";"373271"
"V4mis1";"SILVA (only NR);Bacteria;Acidobacteriota;Blastocatellia;Blastocatellales;Blastocatellaceae;";"96.3";"18.2";"647";"647";"623";"24";"0";"456536";"373271"
"V4mis1";"SILVA (only NR);Bacteria;Acidobacteriota;Blastocatellia;Blastocatellales;Blastocatellaceae;Aridibacter;";"95.8";"18.2";"24";"24";"23";"1";"0";"457159";"373871"
"V4mis1";"SILVA (only NR);Bacteria;Acidobacteriota;Blastocatellia;Blastocatellales;Blastocatellaceae;Blastocatella;";"97.0";"18.2";"165";"165";"160";"5";"0";"457018";"373734"
"V4mis1";"SILVA (only NR);Bacteria;Acidobacteriota;Blastocatellia;Blastocatellales;Blastocatellaceae;JGI 0001001-H03;";"95.5";"18.2";"156";"156";"149";"7";"0";"457027";"373745"
"V4mis1";"SILVA (only NR);Bacteria;Acidobacteriota;Blastocatellia;Blastocatellales;Blastocatellaceae;OLB17;";"100.0";"18.2";"9";"9";"9";"0";"0";"457174";"373885"
"V4mis1";"SILVA (only NR);Bacteria;Acidobacteriota;Blastocatellia;Blastocatellales;Blastocatellaceae;Stenotrophobacter;";"95.2";"18.2";"104";"104";"99";"5";"0";"457079";"373795"
"V4mis1";"SILVA (only NR);Bacteria;Acidobacteriota;Blastocatellia;Blastocatellales;Blastocatellaceae;Tellurimicrobium;";"100.0";"18.2";"4";"4";"4";"0";"0";"457179";"373890"
"V4mis1";"SILVA (only NR);Bacteria;Acidobacteriota;Blastocatellia;Blastocatellales;Blastocatellaceae;uncultured;";"96.7";"18.2";"180";"180";"174";"6";"0";"457003";"373720"
"V4mis1";"SILVA (only NR);Bacteria;Acidobacteriota;Blastocatellia;Chloracidobacteriales;";"100.0";"18.2";"13";"13";"13";"0";"0";"457170";"373881"
"V4mis1";"SILVA (only NR);Bacteria;Acidobacteriota;Blastocatellia;Chloracidobacteriales;Chloracidobacteriaceae;";"100.0";"18.2";"13";"13";"13";"0";"0";"457170";"373881"
"V4mis1";"SILVA (only NR);Bacteria;Acidobacteriota;Blastocatellia;Chloracidobacteriales;Chloracidobacteriaceae;Chloracidobacterium;";"100.0";"18.2";"13";"13";"13";"0";"0";"457170";"373881"
"V4mis1";"SILVA (only NR);Bacteria;Acidobacteriota;Blastocatellia;DS-100;";"97.4";"18.2";"38";"38";"37";"1";"0";"457145";"373857"
"V4mis1";"SILVA (only NR);Bacteria;Acidobacteriota;Blastocatellia;Elev-16S-573;";"100.0";"18.2";"36";"36";"36";"0";"0";"457147";"373858"
"V4mis1";"SILVA (only NR);Bacteria;Acidobacteriota;Blastocatellia;Pyrinomonadales;";"92.0";"18.2";"850";"850";"782";"68";"0";"456333";"373112"
"V4mis1";"SILVA (only NR);Bacteria;Acidobacteriota;Blastocatellia;Pyrinomonadales;Pyrinomonadaceae;";"92.0";"18.2";"850";"850";"782";"68";"0";"456333";"373112"
"V4mis1";"SILVA (only NR);Bacteria;Acidobacteriota;Blastocatellia;Pyrinomonadales;Pyrinomonadaceae;Pyrinomonas;";"100.0";"18.2";"4";"4";"4";"0";"0";"457179";"373890"
"V4mis1";"SILVA (only NR);Bacteria;Acidobacteriota;Blastocatellia;Pyrinomonadales;Pyrinomonadaceae;RB41;";"92.0";"18.2";"846";"846";"778";"68";"0";"456337";"373116"
"V4mis1";"SILVA (only NR);Bacteria;Acidobacteriota;FFCH5909;";"100.0";"18.2";"4";"4";"4";"0";"0";"457179";"373890"
"V4mis1";"SILVA (only NR);Bacteria;Acidobacteriota;GBS-L1-B05;";"100.0";"18.2";"3";"3";"3";"0";"0";"457180";"373891"
"V4mis1";"SILVA (only NR);Bacteria;Acidobacteriota;Holophagae;";"95.4";"18.2";"655";"655";"625";"30";"0";"456528";"373269"
"V4mis1";"SILVA (only NR);Bacteria;Acidobacteriota;Holophagae;Acanthopleuribacterales;";"100.0";"18.2";"34";"34";"34";"0";"0";"457149";"373860"
"V4mis1";"SILVA (only NR);Bacteria;Acidobacteriota;Holophagae;Acanthopleuribacterales;Acanthopleuribacteraceae;";"100.0";"18.2";"34";"34";"34";"0";"0";"457149";"373860"
"V4mis1";"SILVA (only NR);Bacteria;Acidobacteriota;Holophagae;Acanthopleuribacterales;Acanthopleuribacteraceae;Acanthopleuribacter;";"100.0";"18.2";"25";"25";"25";"0";"0";"457158";"373869"
"V4mis1";"SILVA (only NR);Bacteria;Acidobacteriota;Holophagae;Acanthopleuribacterales;Acanthopleuribacteraceae;Thermotomaculum;";"100.0";"18.2";"9";"9";"9";"0";"0";"457174";"373885"
"V4mis1";"SILVA (only NR);Bacteria;Acidobacteriota;Holophagae;Holophagales;";"98.4";"18.2";"184";"184";"181";"3";"0";"456999";"373713"
"V4mis1";"SILVA (only NR);Bacteria;Acidobacteriota;Holophagae;Holophagales;Holophagaceae;";"98.4";"18.2";"184";"184";"181";"3";"0";"456999";"373713"
"V4mis1";"SILVA (only NR);Bacteria;Acidobacteriota;Holophagae;Holophagales;Holophagaceae;Geothrix;";"98.0";"18.2";"50";"50";"49";"1";"0";"457133";"373845"
"V4mis1";"SILVA (only NR);Bacteria;Acidobacteriota;Holophagae;Holophagales;Holophagaceae;Holophaga;";"89.5";"18.2";"19";"19";"17";"2";"0";"457164";"373877"
"V4mis1";"SILVA (only NR);Bacteria;Acidobacteriota;Holophagae;Holophagales;Holophagaceae;marine group;";"100.0";"18.2";"34";"34";"34";"0";"0";"457149";"373860"
"V4mis1";"SILVA (only NR);Bacteria;Acidobacteriota;Holophagae;Holophagales;Holophagaceae;uncultured;";"100.0";"18.2";"70";"70";"70";"0";"0";"457113";"373824"
"V4mis1";"SILVA (only NR);Bacteria;Acidobacteriota;Holophagae;Subgroup 7;";"93.8";"18.2";"437";"437";"410";"27";"0";"456746";"373484"
"V4mis1";"SILVA (only NR);Bacteria;Acidobacteriota;ODP1230B23.02;";"92.3";"18.2";"13";"13";"12";"1";"0";"457170";"373882"
"V4mis1";"SILVA (only NR);Bacteria;Acidobacteriota;Subgroup 11;";"100.0";"18.2";"52";"52";"52";"0";"0";"457131";"373842"
"V4mis1";"SILVA (only NR);Bacteria;Acidobacteriota;Subgroup 18;";"99.2";"18.2";"131";"131";"130";"1";"0";"457052";"373764"
"V4mis1";"SILVA (only NR);Bacteria;Acidobacteriota;Subgroup 19;";"100.0";"18.2";"3";"3";"3";"0";"0";"457180";"373891"
"V4mis1";"SILVA (only NR);Bacteria;Acidobacteriota;Subgroup 20;";"100.0";"18.2";"5";"5";"5";"0";"0";"457178";"373889"
"V4mis1";"SILVA (only NR);Bacteria;Acidobacteriota;Subgroup 21;";"96.6";"18.2";"178";"178";"172";"6";"0";"457005";"373722"
"V4mis1";"SILVA (only NR);Bacteria;Acidobacteriota;Subgroup 22;";"97.3";"18.2";"337";"337";"328";"9";"0";"456846";"373566"
"V4mis1";"SILVA (only NR);Bacteria;Acidobacteriota;Subgroup 25;";"94.9";"18.2";"59";"59";"56";"3";"0";"457124";"373838"
"V4mis1";"SILVA (only NR);Bacteria;Acidobacteriota;Subgroup 26;";"96.6";"18.2";"58";"58";"56";"2";"0";"457125";"373838"
"V4mis1";"SILVA (only NR);Bacteria;Acidobacteriota;Subgroup 5;";"96.9";"18.2";"255";"255";"247";"8";"0";"456928";"373647"
"V4mis1";"SILVA (only NR);Bacteria;Acidobacteriota;Thermoanaerobaculia;";"93.5";"18.2";"602";"602";"563";"39";"0";"456581";"373331"
"V4mis1";"SILVA (only NR);Bacteria;Acidobacteriota;Thermoanaerobaculia;Thermoanaerobaculales;";"93.5";"18.2";"602";"602";"563";"39";"0";"456581";"373331"
"V4mis1";"SILVA (only NR);Bacteria;Acidobacteriota;Thermoanaerobaculia;Thermoanaerobaculales;Thermoanaerobaculaceae;";"93.5";"18.2";"602";"602";"563";"39";"0";"456581";"373331"
"V4mis1";"SILVA (only NR);Bacteria;Acidobacteriota;Thermoanaerobaculia;Thermoanaerobaculales;Thermoanaerobaculaceae;B276-D12;";"100.0";"18.2";"3";"3";"3";"0";"0";"457180";"373891"
"V4mis1";"SILVA (only NR);Bacteria;Acidobacteriota;Thermoanaerobaculia;Thermoanaerobaculales;Thermoanaerobaculaceae;Subgroup 10;";"93.6";"18.2";"425";"425";"398";"27";"0";"456758";"373496"
"V4mis1";"SILVA (only NR);Bacteria;Acidobacteriota;Thermoanaerobaculia;Thermoanaerobaculales;Thermoanaerobaculaceae;Subgroup 23;";"92.2";"18.2";"129";"129";"119";"10";"0";"457054";"373775"
"V4mis1";"SILVA (only NR);Bacteria;Acidobacteriota;Thermoanaerobaculia;Thermoanaerobaculales;Thermoanaerobaculaceae;TPD-58;";"94.4";"18.2";"18";"18";"17";"1";"0";"457165";"373877"
"V4mis1";"SILVA (only NR);Bacteria;Acidobacteriota;Thermoanaerobaculia;Thermoanaerobaculales;Thermoanaerobaculaceae;Thermoanaerobaculum;";"96.3";"18.2";"27";"27";"26";"1";"0";"457156";"373868"
"V4mis1";"SILVA (only NR);Bacteria;Acidobacteriota;Vicinamibacteria;";"95.3";"18.3";"3118";"3118";"2971";"147";"0";"454065";"370923"
"V4mis1";"SILVA (only NR);Bacteria;Acidobacteriota;Vicinamibacteria;11B-2;";"100.0";"18.2";"3";"3";"3";"0";"0";"457180";"373891"
"V4mis1";"SILVA (only NR);Bacteria;Acidobacteriota;Vicinamibacteria;Subgroup 17;";"96.0";"18.2";"227";"227";"218";"9";"0";"456956";"373676"
"V4mis1";"SILVA (only NR);Bacteria;Acidobacteriota;Vicinamibacteria;Subgroup 9;";"95.4";"18.2";"130";"130";"124";"6";"0";"457053";"373770"
"V4mis1";"SILVA (only NR);Bacteria;Acidobacteriota;Vicinamibacteria;Vicinamibacterales;";"95.2";"18.3";"2758";"2758";"2626";"132";"0";"454425";"371268"
"V4mis1";"SILVA (only NR);Bacteria;Acidobacteriota;Vicinamibacteria;Vicinamibacterales;Vicinamibacteraceae;";"94.8";"18.2";"1056";"1056";"1001";"55";"0";"456127";"372893"
"V4mis1";"SILVA (only NR);Bacteria;Acidobacteriota;Vicinamibacteria;Vicinamibacterales;Vicinamibacteraceae;Luteitalea;";"94.7";"18.2";"57";"57";"54";"3";"0";"457126";"373840"
"V4mis1";"SILVA (only NR);Bacteria;Acidobacteriota;Vicinamibacteria;Vicinamibacterales;Vicinamibacteraceae;Vicinamibacter;";"91.7";"18.2";"24";"24";"22";"2";"0";"457159";"373872"
"V4mis1";"SILVA (only NR);Bacteria;Acidobacteriota;Vicinamibacteria;Vicinamibacterales;Vicinamibacteraceae;uncultured;";"92.9";"18.2";"42";"42";"39";"3";"0";"457141";"373855"
"V4mis1";"SILVA (only NR);Bacteria;Acidobacteriota;Vicinamibacteria;Vicinamibacterales;uncultured;";"95.4";"18.3";"1688";"1688";"1611";"77";"0";"455495";"372283"
"V4mis1";"SILVA (only NR);Bacteria;Acidobacteriota;c5LKS83;";"81.8";"18.2";"11";"11";"9";"2";"0";"457172";"373885"
"V4mis1";"SILVA (only NR);Bacteria;Acidobacteriota;d142;";"94.1";"18.2";"17";"17";"16";"1";"0";"457166";"373878"
"V4mis1";"SILVA (only NR);Bacteria;Actinobacteriota;";"91.8";"19.1";"36942";"36942";"33925";"3017";"0";"420241";"339969"
"V4mis1";"SILVA (only NR);Bacteria;Actinobacteriota;Acidimicrobiia;";"94.7";"18.3";"2771";"2771";"2625";"146";"0";"454412";"371269"
"V4mis1";"SILVA (only NR);Bacteria;Actinobacteriota;Acidimicrobiia;Acidimicrobiales;";"98.4";"18.2";"64";"64";"63";"1";"0";"457119";"373831"
"V4mis1";"SILVA (only NR);Bacteria;Actinobacteriota;Acidimicrobiia;Acidimicrobiales;Acidimicrobiaceae;";"98.3";"18.2";"60";"60";"59";"1";"0";"457123";"373835"
"V4mis1";"SILVA (only NR);Bacteria;Actinobacteriota;Acidimicrobiia;Acidimicrobiales;Acidimicrobiaceae;Acidimicrobium;";"100.0";"18.2";"9";"9";"9";"0";"0";"457174";"373885"
"V4mis1";"SILVA (only NR);Bacteria;Actinobacteriota;Acidimicrobiia;Acidimicrobiales;Acidimicrobiaceae;Acidithrix;";"100.0";"18.2";"13";"13";"13";"0";"0";"457170";"373881"
"V4mis1";"SILVA (only NR);Bacteria;Actinobacteriota;Acidimicrobiia;Acidimicrobiales;Acidimicrobiaceae;Ferrimicrobium;";"88.9";"18.2";"9";"9";"8";"1";"0";"457174";"373886"
"V4mis1";"SILVA (only NR);Bacteria;Actinobacteriota;Acidimicrobiia;Acidimicrobiales;Acidimicrobiaceae;Ferrithrix;";"100.0";"18.2";"16";"16";"16";"0";"0";"457167";"373878"
"V4mis1";"SILVA (only NR);Bacteria;Actinobacteriota;Acidimicrobiia;Acidimicrobiales;Acidimicrobiaceae;uncultured;";"100.0";"18.2";"12";"12";"12";"0";"0";"457171";"373882"
"V4mis1";"SILVA (only NR);Bacteria;Actinobacteriota;Acidimicrobiia;Acidimicrobiales;Acidimicrobiales Incertae Sedis;";"100.0";"18.2";"4";"4";"4";"0";"0";"457179";"373890"
"V4mis1";"SILVA (only NR);Bacteria;Actinobacteriota;Acidimicrobiia;Acidimicrobiales;Acidimicrobiales Incertae Sedis;Aciditerrimonas;";"100.0";"18.2";"4";"4";"4";"0";"0";"457179";"373890"
"V4mis1";"SILVA (only NR);Bacteria;Actinobacteriota;Acidimicrobiia;Actinomarinales;";"94.6";"18.2";"666";"666";"630";"36";"0";"456517";"373264"
"V4mis1";"SILVA (only NR);Bacteria;Actinobacteriota;Acidimicrobiia;Actinomarinales;Actinomarinaceae;";"96.1";"18.2";"178";"178";"171";"7";"0";"457005";"373723"
"V4mis1";"SILVA (only NR);Bacteria;Actinobacteriota;Acidimicrobiia;Actinomarinales;Actinomarinaceae;Candidatus Actinomarina;";"96.1";"18.2";"178";"178";"171";"7";"0";"457005";"373723"
"V4mis1";"SILVA (only NR);Bacteria;Actinobacteriota;Acidimicrobiia;Actinomarinales;uncultured;";"94.0";"18.2";"485";"485";"456";"29";"0";"456698";"373438"
"V4mis1";"SILVA (only NR);Bacteria;Actinobacteriota;Acidimicrobiia;IMCC26256;";"95.6";"18.2";"321";"321";"307";"14";"0";"456862";"373587"
"V4mis1";"SILVA (only NR);Bacteria;Actinobacteriota;Acidimicrobiia;Microtrichales;";"94.8";"18.3";"1496";"1496";"1418";"78";"0";"455687";"372476"
"V4mis1";"SILVA (only NR);Bacteria;Actinobacteriota;Acidimicrobiia;Microtrichales;Iamiaceae;";"95.8";"18.2";"144";"144";"138";"6";"0";"457039";"373756"
"V4mis1";"SILVA (only NR);Bacteria;Actinobacteriota;Acidimicrobiia;Microtrichales;Iamiaceae;Iamia;";"95.8";"18.2";"144";"144";"138";"6";"0";"457039";"373756"
"V4mis1";"SILVA (only NR);Bacteria;Actinobacteriota;Acidimicrobiia;Microtrichales;Ilumatobacteraceae;";"93.4";"18.2";"546";"546";"510";"36";"0";"456637";"373384"
"V4mis1";"SILVA (only NR);Bacteria;Actinobacteriota;Acidimicrobiia;Microtrichales;Ilumatobacteraceae;CL500-29 marine group;";"95.7";"18.2";"256";"256";"245";"11";"0";"456927";"373649"
"V4mis1";"SILVA (only NR);Bacteria;Actinobacteriota;Acidimicrobiia;Microtrichales;Ilumatobacteraceae;Ilumatobacter;";"94.8";"18.2";"96";"96";"91";"5";"0";"457087";"373803"
"V4mis1";"SILVA (only NR);Bacteria;Actinobacteriota;Acidimicrobiia;Microtrichales;Ilumatobacteraceae;uncultured;";"89.4";"18.2";"189";"189";"169";"20";"0";"456994";"373725"
"V4mis1";"SILVA (only NR);Bacteria;Actinobacteriota;Acidimicrobiia;Microtrichales;Microtrichaceae;";"95.6";"18.2";"521";"521";"498";"23";"0";"456662";"373396"
"V4mis1";"SILVA (only NR);Bacteria;Actinobacteriota;Acidimicrobiia;Microtrichales;Microtrichaceae;Candidatus Microthrix;";"97.1";"18.2";"35";"35";"34";"1";"0";"457148";"373860"
"V4mis1";"SILVA (only NR);Bacteria;Actinobacteriota;Acidimicrobiia;Microtrichales;Microtrichaceae;IMCC26207;";"100.0";"18.2";"44";"44";"44";"0";"0";"457139";"373850"
"V4mis1";"SILVA (only NR);Bacteria;Actinobacteriota;Acidimicrobiia;Microtrichales;Microtrichaceae;Sva0996 marine group;";"94.5";"18.2";"307";"307";"290";"17";"0";"456876";"373604"
"V4mis1";"SILVA (only NR);Bacteria;Actinobacteriota;Acidimicrobiia;Microtrichales;Microtrichaceae;uncultured;";"96.3";"18.2";"135";"135";"130";"5";"0";"457048";"373764"
"V4mis1";"SILVA (only NR);Bacteria;Actinobacteriota;Acidimicrobiia;Microtrichales;uncultured;";"95.4";"18.2";"281";"281";"268";"13";"0";"456902";"373626"
"V4mis1";"SILVA (only NR);Bacteria;Actinobacteriota;Acidimicrobiia;uncultured;";"92.4";"18.2";"223";"223";"206";"17";"0";"456960";"373688"
"V4mis1";"SILVA (only NR);Bacteria;Actinobacteriota;Actinobacteria;";"91.2";"18.9";"30683";"30683";"27985";"2698";"0";"426500";"345909"
"V4mis1";"SILVA (only NR);Bacteria;Actinobacteriota;Actinobacteria;0319-7L14;";"88.6";"18.2";"35";"35";"31";"4";"0";"457148";"373863"
"V4mis1";"SILVA (only NR);Bacteria;Actinobacteriota;Actinobacteria;Actinomycetales;";"93.9";"18.2";"942";"942";"885";"57";"0";"456241";"373009"
"V4mis1";"SILVA (only NR);Bacteria;Actinobacteriota;Actinobacteria;Actinomycetales;Actinomycetaceae;";"93.8";"18.2";"919";"919";"862";"57";"0";"456264";"373032"
"V4mis1";"SILVA (only NR);Bacteria;Actinobacteriota;Actinobacteria;Actinomycetales;Actinomycetaceae;Actinobaculum;";"100.0";"18.2";"2";"2";"2";"0";"0";"457181";"373892"
"V4mis1";"SILVA (only NR);Bacteria;Actinobacteriota;Actinobacteria;Actinomycetales;Actinomycetaceae;Actinomyces;";"92.8";"18.2";"691";"691";"641";"50";"0";"456492";"373253"
"V4mis1";"SILVA (only NR);Bacteria;Actinobacteriota;Actinobacteria;Actinomycetales;Actinomycetaceae;Actinotignum;";"100.0";"18.2";"15";"15";"15";"0";"0";"457168";"373879"
"V4mis1";"SILVA (only NR);Bacteria;Actinobacteriota;Actinobacteria;Actinomycetales;Actinomycetaceae;Arcanobacterium;";"100.0";"18.2";"30";"30";"30";"0";"0";"457153";"373864"
"V4mis1";"SILVA (only NR);Bacteria;Actinobacteriota;Actinobacteria;Actinomycetales;Actinomycetaceae;F0332;";"95.9";"18.2";"49";"49";"47";"2";"0";"457134";"373847"
"V4mis1";"SILVA (only NR);Bacteria;Actinobacteriota;Actinobacteria;Actinomycetales;Actinomycetaceae;Flaviflexus;";"92.3";"18.2";"13";"13";"12";"1";"0";"457170";"373882"
"V4mis1";"SILVA (only NR);Bacteria;Actinobacteriota;Actinobacteria;Actinomycetales;Actinomycetaceae;Mobiluncus;";"100.0";"18.2";"34";"34";"34";"0";"0";"457149";"373860"
"V4mis1";"SILVA (only NR);Bacteria;Actinobacteriota;Actinobacteria;Actinomycetales;Actinomycetaceae;Trueperella;";"96.7";"18.2";"30";"30";"29";"1";"0";"457153";"373865"
"V4mis1";"SILVA (only NR);Bacteria;Actinobacteriota;Actinobacteria;Actinomycetales;Actinomycetaceae;Varibaculum;";"91.9";"18.2";"37";"37";"34";"3";"0";"457146";"373860"
"V4mis1";"SILVA (only NR);Bacteria;Actinobacteriota;Actinobacteria;Actinomycetales;Actinomycetaceae;uncultured;";"100.0";"18.2";"10";"10";"10";"0";"0";"457173";"373884"
"V4mis1";"SILVA (only NR);Bacteria;Actinobacteriota;Actinobacteria;Actinomycetales;Actinomycetales Incertae Sedis;";"100.0";"18.2";"23";"23";"23";"0";"0";"457160";"373871"
"V4mis1";"SILVA (only NR);Bacteria;Actinobacteriota;Actinobacteria;Actinomycetales;Actinomycetales Incertae Sedis;Candidatus Ancillula;";"100.0";"18.2";"23";"23";"23";"0";"0";"457160";"373871"
"V4mis1";"SILVA (only NR);Bacteria;Actinobacteriota;Actinobacteria;Bifidobacteriales;";"94.5";"18.2";"505";"505";"477";"28";"0";"456678";"373417"
"V4mis1";"SILVA (only NR);Bacteria;Actinobacteriota;Actinobacteria;Bifidobacteriales;Bifidobacteriaceae;";"94.5";"18.2";"505";"505";"477";"28";"0";"456678";"373417"
"V4mis1";"SILVA (only NR);Bacteria;Actinobacteriota;Actinobacteria;Bifidobacteriales;Bifidobacteriaceae;Aeriscardovia;";"100.0";"18.2";"5";"5";"5";"0";"0";"457178";"373889"
"V4mis1";"SILVA (only NR);Bacteria;Actinobacteriota;Actinobacteria;Bifidobacteriales;Bifidobacteriaceae;Alloscardovia;";"100.0";"18.2";"16";"16";"16";"0";"0";"457167";"373878"
"V4mis1";"SILVA (only NR);Bacteria;Actinobacteriota;Actinobacteria;Bifidobacteriales;Bifidobacteriaceae;Bifidobacterium;";"94.0";"18.2";"449";"449";"422";"27";"0";"456734";"373472"
"V4mis1";"SILVA (only NR);Bacteria;Actinobacteriota;Actinobacteria;Bifidobacteriales;Bifidobacteriaceae;Bombiscardovia;";"66.7";"18.2";"3";"3";"2";"1";"0";"457180";"373892"
"V4mis1";"SILVA (only NR);Bacteria;Actinobacteriota;Actinobacteria;Bifidobacteriales;Bifidobacteriaceae;Gardnerella;";"100.0";"18.2";"15";"15";"15";"0";"0";"457168";"373879"
"V4mis1";"SILVA (only NR);Bacteria;Actinobacteriota;Actinobacteria;Bifidobacteriales;Bifidobacteriaceae;Neoscardovia;";"100.0";"18.2";"1";"1";"1";"0";"0";"457182";"373893"
"V4mis1";"SILVA (only NR);Bacteria;Actinobacteriota;Actinobacteria;Bifidobacteriales;Bifidobacteriaceae;Parascardovia;";"100.0";"18.2";"4";"4";"4";"0";"0";"457179";"373890"
"V4mis1";"SILVA (only NR);Bacteria;Actinobacteriota;Actinobacteria;Bifidobacteriales;Bifidobacteriaceae;Pseudoscardovia;";"100.0";"18.2";"3";"3";"3";"0";"0";"457180";"373891"
"V4mis1";"SILVA (only NR);Bacteria;Actinobacteriota;Actinobacteria;Bifidobacteriales;Bifidobacteriaceae;Scardovia;";"100.0";"18.2";"5";"5";"5";"0";"0";"457178";"373889"
"V4mis1";"SILVA (only NR);Bacteria;Actinobacteriota;Actinobacteria;Bifidobacteriales;Bifidobacteriaceae;uncultured;";"100.0";"18.2";"2";"2";"2";"0";"0";"457181";"373892"
"V4mis1";"SILVA (only NR);Bacteria;Actinobacteriota;Actinobacteria;Catenulisporales;";"100.0";"18.2";"36";"36";"36";"0";"0";"457147";"373858"
"V4mis1";"SILVA (only NR);Bacteria;Actinobacteriota;Actinobacteria;Catenulisporales;Actinospicaceae;";"100.0";"18.2";"26";"26";"26";"0";"0";"457157";"373868"
"V4mis1";"SILVA (only NR);Bacteria;Actinobacteriota;Actinobacteria;Catenulisporales;Actinospicaceae;Actinospica;";"100.0";"18.2";"26";"26";"26";"0";"0";"457157";"373868"
"V4mis1";"SILVA (only NR);Bacteria;Actinobacteriota;Actinobacteria;Catenulisporales;Catenulisporaceae;";"100.0";"18.2";"10";"10";"10";"0";"0";"457173";"373884"
"V4mis1";"SILVA (only NR);Bacteria;Actinobacteriota;Actinobacteria;Catenulisporales;Catenulisporaceae;Catenulispora;";"100.0";"18.2";"10";"10";"10";"0";"0";"457173";"373884"
"V4mis1";"SILVA (only NR);Bacteria;Actinobacteriota;Actinobacteria;Corynebacteriales;";"90.6";"18.3";"6456";"6456";"5847";"609";"0";"450727";"368047"
"V4mis1";"SILVA (only NR);Bacteria;Actinobacteriota;Actinobacteria;Corynebacteriales;Corynebacteriaceae;";"84.2";"18.2";"3111";"3111";"2620";"491";"0";"454072";"371274"
"V4mis1";"SILVA (only NR);Bacteria;Actinobacteriota;Actinobacteria;Corynebacteriales;Corynebacteriaceae;Corynebacterium;";"84.7";"18.2";"2941";"2941";"2490";"451";"0";"454242";"371404"
"V4mis1";"SILVA (only NR);Bacteria;Actinobacteriota;Actinobacteria;Corynebacteriales;Corynebacteriaceae;Lawsonella;";"74.6";"18.2";"142";"142";"106";"36";"0";"457041";"373788"
"V4mis1";"SILVA (only NR);Bacteria;Actinobacteriota;Actinobacteria;Corynebacteriales;Corynebacteriaceae;Turicella;";"78.9";"18.2";"19";"19";"15";"4";"0";"457164";"373879"
"V4mis1";"SILVA (only NR);Bacteria;Actinobacteriota;Actinobacteria;Corynebacteriales;Corynebacteriaceae;uncultured;";"100.0";"18.2";"3";"3";"3";"0";"0";"457180";"373891"
"V4mis1";"SILVA (only NR);Bacteria;Actinobacteriota;Actinobacteria;Corynebacteriales;Corynebacteriales Incertae Sedis;";"100.0";"18.2";"6";"6";"6";"0";"0";"457177";"373888"
"V4mis1";"SILVA (only NR);Bacteria;Actinobacteriota;Actinobacteria;Corynebacteriales;Corynebacteriales Incertae Sedis;Tomitella;";"100.0";"18.2";"6";"6";"6";"0";"0";"457177";"373888"
"V4mis1";"SILVA (only NR);Bacteria;Actinobacteriota;Actinobacteria;Corynebacteriales;Dietziaceae;";"88.3";"18.2";"120";"120";"106";"14";"0";"457063";"373788"
"V4mis1";"SILVA (only NR);Bacteria;Actinobacteriota;Actinobacteria;Corynebacteriales;Dietziaceae;Dietzia;";"88.3";"18.2";"120";"120";"106";"14";"0";"457063";"373788"
"V4mis1";"SILVA (only NR);Bacteria;Actinobacteriota;Actinobacteria;Corynebacteriales;Mycobacteriaceae;";"97.8";"18.3";"1535";"1535";"1501";"34";"0";"455648";"372393"
"V4mis1";"SILVA (only NR);Bacteria;Actinobacteriota;Actinobacteria;Corynebacteriales;Mycobacteriaceae;Hoyosella;";"100.0";"18.2";"7";"7";"7";"0";"0";"457176";"373887"
"V4mis1";"SILVA (only NR);Bacteria;Actinobacteriota;Actinobacteria;Corynebacteriales;Mycobacteriaceae;Mycobacterium;";"97.8";"18.3";"1528";"1528";"1494";"34";"0";"455655";"372400"
"V4mis1";"SILVA (only NR);Bacteria;Actinobacteriota;Actinobacteria;Corynebacteriales;Nocardiaceae;";"95.8";"18.3";"1618";"1618";"1550";"68";"0";"455565";"372344"
"V4mis1";"SILVA (only NR);Bacteria;Actinobacteriota;Actinobacteria;Corynebacteriales;Nocardiaceae;Gordonia;";"94.1";"18.2";"238";"238";"224";"14";"0";"456945";"373670"
"V4mis1";"SILVA (only NR);Bacteria;Actinobacteriota;Actinobacteria;Corynebacteriales;Nocardiaceae;Millisia;";"100.0";"18.2";"1";"1";"1";"0";"0";"457182";"373893"
"V4mis1";"SILVA (only NR);Bacteria;Actinobacteriota;Actinobacteria;Corynebacteriales;Nocardiaceae;Nocardia;";"98.7";"18.2";"678";"678";"669";"9";"0";"456505";"373225"
"V4mis1";"SILVA (only NR);Bacteria;Actinobacteriota;Actinobacteria;Corynebacteriales;Nocardiaceae;Rhodococcus;";"93.3";"18.2";"645";"645";"602";"43";"0";"456538";"373292"
"V4mis1";"SILVA (only NR);Bacteria;Actinobacteriota;Actinobacteria;Corynebacteriales;Nocardiaceae;Skermania;";"100.0";"18.2";"4";"4";"4";"0";"0";"457179";"373890"
"V4mis1";"SILVA (only NR);Bacteria;Actinobacteriota;Actinobacteria;Corynebacteriales;Nocardiaceae;Smaragdicoccus;";"87.5";"18.2";"8";"8";"7";"1";"0";"457175";"373887"
"V4mis1";"SILVA (only NR);Bacteria;Actinobacteriota;Actinobacteria;Corynebacteriales;Nocardiaceae;Williamsia;";"97.4";"18.2";"38";"38";"37";"1";"0";"457145";"373857"
"V4mis1";"SILVA (only NR);Bacteria;Actinobacteriota;Actinobacteria;Corynebacteriales;Segniliparaceae;";"100.0";"18.2";"10";"10";"10";"0";"0";"457173";"373884"
"V4mis1";"SILVA (only NR);Bacteria;Actinobacteriota;Actinobacteria;Corynebacteriales;Segniliparaceae;Segniliparus;";"100.0";"18.2";"6";"6";"6";"0";"0";"457177";"373888"
"V4mis1";"SILVA (only NR);Bacteria;Actinobacteriota;Actinobacteria;Corynebacteriales;Segniliparaceae;uncultured;";"100.0";"18.2";"4";"4";"4";"0";"0";"457179";"373890"
"V4mis1";"SILVA (only NR);Bacteria;Actinobacteriota;Actinobacteria;Corynebacteriales;Tsukamurellaceae;";"96.1";"18.2";"51";"51";"49";"2";"0";"457132";"373845"
"V4mis1";"SILVA (only NR);Bacteria;Actinobacteriota;Actinobacteria;Corynebacteriales;Tsukamurellaceae;Tsukamurella;";"96.1";"18.2";"51";"51";"49";"2";"0";"457132";"373845"
"V4mis1";"SILVA (only NR);Bacteria;Actinobacteriota;Actinobacteria;Corynebacteriales;uncultured;";"100.0";"18.2";"4";"4";"4";"0";"0";"457179";"373890"
"V4mis1";"SILVA (only NR);Bacteria;Actinobacteriota;Actinobacteria;Elev-16S-976;";"100.0";"18.2";"4";"4";"4";"0";"0";"457179";"373890"
"V4mis1";"SILVA (only NR);Bacteria;Actinobacteriota;Actinobacteria;Euzebyales;";"82.9";"18.2";"111";"111";"92";"19";"0";"457072";"373802"
"V4mis1";"SILVA (only NR);Bacteria;Actinobacteriota;Actinobacteria;Euzebyales;Euzebyaceae;";"82.9";"18.2";"111";"111";"92";"19";"0";"457072";"373802"
"V4mis1";"SILVA (only NR);Bacteria;Actinobacteriota;Actinobacteria;Euzebyales;Euzebyaceae;Egibacter;";"100.0";"18.2";"4";"4";"4";"0";"0";"457179";"373890"
"V4mis1";"SILVA (only NR);Bacteria;Actinobacteriota;Actinobacteria;Euzebyales;Euzebyaceae;Euzebya;";"100.0";"18.2";"8";"8";"8";"0";"0";"457175";"373886"
"V4mis1";"SILVA (only NR);Bacteria;Actinobacteriota;Actinobacteria;Euzebyales;Euzebyaceae;uncultured;";"80.8";"18.2";"99";"99";"80";"19";"0";"457084";"373814"
"V4mis1";"SILVA (only NR);Bacteria;Actinobacteriota;Actinobacteria;FFCH16263;";"100.0";"18.2";"3";"3";"3";"0";"0";"457180";"373891"
"V4mis1";"SILVA (only NR);Bacteria;Actinobacteriota;Actinobacteria;Frankiales;";"96.2";"18.3";"1118";"1118";"1076";"42";"0";"456065";"372818"
"V4mis1";"SILVA (only NR);Bacteria;Actinobacteriota;Actinobacteria;Frankiales;Acidothermaceae;";"96.9";"18.2";"97";"97";"94";"3";"0";"457086";"373800"
"V4mis1";"SILVA (only NR);Bacteria;Actinobacteriota;Actinobacteria;Frankiales;Acidothermaceae;Acidothermus;";"96.9";"18.2";"97";"97";"94";"3";"0";"457086";"373800"
"V4mis1";"SILVA (only NR);Bacteria;Actinobacteriota;Actinobacteria;Frankiales;Cryptosporangiaceae;";"100.0";"18.2";"17";"17";"17";"0";"0";"457166";"373877"
"V4mis1";"SILVA (only NR);Bacteria;Actinobacteriota;Actinobacteria;Frankiales;Cryptosporangiaceae;Cryptosporangium;";"100.0";"18.2";"15";"15";"15";"0";"0";"457168";"373879"
"V4mis1";"SILVA (only NR);Bacteria;Actinobacteriota;Actinobacteria;Frankiales;Cryptosporangiaceae;Fodinicola;";"100.0";"18.2";"2";"2";"2";"0";"0";"457181";"373892"
"V4mis1";"SILVA (only NR);Bacteria;Actinobacteriota;Actinobacteria;Frankiales;Frankiaceae;";"96.4";"18.2";"140";"140";"135";"5";"0";"457043";"373759"
"V4mis1";"SILVA (only NR);Bacteria;Actinobacteriota;Actinobacteria;Frankiales;Frankiaceae;Frankia;";"95.7";"18.2";"46";"46";"44";"2";"0";"457137";"373850"
"V4mis1";"SILVA (only NR);Bacteria;Actinobacteriota;Actinobacteria;Frankiales;Frankiaceae;Jatrophihabitans;";"96.8";"18.2";"94";"94";"91";"3";"0";"457089";"373803"
"V4mis1";"SILVA (only NR);Bacteria;Actinobacteriota;Actinobacteria;Frankiales;Geodermatophilaceae;";"92.9";"18.2";"239";"239";"222";"17";"0";"456944";"373672"
"V4mis1";"SILVA (only NR);Bacteria;Actinobacteriota;Actinobacteria;Frankiales;Geodermatophilaceae;Antricoccus;";"100.0";"18.2";"14";"14";"14";"0";"0";"457169";"373880"
"V4mis1";"SILVA (only NR);Bacteria;Actinobacteriota;Actinobacteria;Frankiales;Geodermatophilaceae;Blastococcus;";"90.2";"18.2";"102";"102";"92";"10";"0";"457081";"373802"
"V4mis1";"SILVA (only NR);Bacteria;Actinobacteriota;Actinobacteria;Frankiales;Geodermatophilaceae;Geodermatophilus;";"93.7";"18.2";"63";"63";"59";"4";"0";"457120";"373835"
"V4mis1";"SILVA (only NR);Bacteria;Actinobacteriota;Actinobacteria;Frankiales;Geodermatophilaceae;Klenkia;";"100.0";"18.2";"14";"14";"14";"0";"0";"457169";"373880"
"V4mis1";"SILVA (only NR);Bacteria;Actinobacteriota;Actinobacteria;Frankiales;Geodermatophilaceae;Modestobacter;";"93.2";"18.2";"44";"44";"41";"3";"0";"457139";"373853"
"V4mis1";"SILVA (only NR);Bacteria;Actinobacteriota;Actinobacteria;Frankiales;Nakamurellaceae;";"95.2";"18.2";"84";"84";"80";"4";"0";"457099";"373814"
"V4mis1";"SILVA (only NR);Bacteria;Actinobacteriota;Actinobacteria;Frankiales;Nakamurellaceae;Nakamurella;";"95.2";"18.2";"84";"84";"80";"4";"0";"457099";"373814"
"V4mis1";"SILVA (only NR);Bacteria;Actinobacteriota;Actinobacteria;Frankiales;Sporichthyaceae;";"97.6";"18.2";"420";"420";"410";"10";"0";"456763";"373484"
"V4mis1";"SILVA (only NR);Bacteria;Actinobacteriota;Actinobacteria;Frankiales;Sporichthyaceae;Candidatus Planktophila;";"100.0";"18.2";"21";"21";"21";"0";"0";"457162";"373873"
"V4mis1";"SILVA (only NR);Bacteria;Actinobacteriota;Actinobacteria;Frankiales;Sporichthyaceae;Longivirga;";"100.0";"18.2";"8";"8";"8";"0";"0";"457175";"373886"
"V4mis1";"SILVA (only NR);Bacteria;Actinobacteriota;Actinobacteria;Frankiales;Sporichthyaceae;Sporichthya;";"100.0";"18.2";"13";"13";"13";"0";"0";"457170";"373881"
"V4mis1";"SILVA (only NR);Bacteria;Actinobacteriota;Actinobacteria;Frankiales;Sporichthyaceae;hgcI clade;";"97.0";"18.2";"329";"329";"319";"10";"0";"456854";"373575"
"V4mis1";"SILVA (only NR);Bacteria;Actinobacteriota;Actinobacteria;Frankiales;Sporichthyaceae;uncultured;";"100.0";"18.2";"29";"29";"29";"0";"0";"457154";"373865"
"V4mis1";"SILVA (only NR);Bacteria;Actinobacteriota;Actinobacteria;Frankiales;uncultured;";"98.1";"18.2";"108";"108";"106";"2";"0";"457075";"373788"
"V4mis1";"SILVA (only NR);Bacteria;Actinobacteriota;Actinobacteria;Glycomycetales;";"94.0";"18.2";"83";"83";"78";"5";"0";"457100";"373816"
"V4mis1";"SILVA (only NR);Bacteria;Actinobacteriota;Actinobacteria;Glycomycetales;Glycomycetaceae;";"94.0";"18.2";"83";"83";"78";"5";"0";"457100";"373816"
"V4mis1";"SILVA (only NR);Bacteria;Actinobacteriota;Actinobacteria;Glycomycetales;Glycomycetaceae;Glycomyces;";"94.4";"18.2";"71";"71";"67";"4";"0";"457112";"373827"
"V4mis1";"SILVA (only NR);Bacteria;Actinobacteriota;Actinobacteria;Glycomycetales;Glycomycetaceae;Haloglycomyces;";"100.0";"18.2";"1";"1";"1";"0";"0";"457182";"373893"
"V4mis1";"SILVA (only NR);Bacteria;Actinobacteriota;Actinobacteria;Glycomycetales;Glycomycetaceae;Salilacibacter;";"100.0";"18.2";"2";"2";"2";"0";"0";"457181";"373892"
"V4mis1";"SILVA (only NR);Bacteria;Actinobacteriota;Actinobacteria;Glycomycetales;Glycomycetaceae;Salininema;";"100.0";"18.2";"1";"1";"1";"0";"0";"457182";"373893"
"V4mis1";"SILVA (only NR);Bacteria;Actinobacteriota;Actinobacteria;Glycomycetales;Glycomycetaceae;uncultured;";"100.0";"18.2";"6";"6";"6";"0";"0";"457177";"373888"
"V4mis1";"SILVA (only NR);Bacteria;Actinobacteriota;Actinobacteria;KIST-JJY010;";"100.0";"18.2";"5";"5";"5";"0";"0";"457178";"373889"
"V4mis1";"SILVA (only NR);Bacteria;Actinobacteriota;Actinobacteria;Kineosporiales;";"98.6";"18.2";"140";"140";"138";"2";"0";"457043";"373756"
"V4mis1";"SILVA (only NR);Bacteria;Actinobacteriota;Actinobacteria;Kineosporiales;Kineosporiaceae;";"98.6";"18.2";"140";"140";"138";"2";"0";"457043";"373756"
"V4mis1";"SILVA (only NR);Bacteria;Actinobacteriota;Actinobacteria;Kineosporiales;Kineosporiaceae;Angustibacter;";"100.0";"18.2";"16";"16";"16";"0";"0";"457167";"373878"
"V4mis1";"SILVA (only NR);Bacteria;Actinobacteriota;Actinobacteria;Kineosporiales;Kineosporiaceae;Kineococcus;";"97.6";"18.2";"41";"41";"40";"1";"0";"457142";"373854"
"V4mis1";"SILVA (only NR);Bacteria;Actinobacteriota;Actinobacteria;Kineosporiales;Kineosporiaceae;Kineosporia;";"100.0";"18.2";"29";"29";"29";"0";"0";"457154";"373865"
"V4mis1";"SILVA (only NR);Bacteria;Actinobacteriota;Actinobacteria;Kineosporiales;Kineosporiaceae;Pseudokineococcus;";"100.0";"18.2";"5";"5";"5";"0";"0";"457178";"373889"
"V4mis1";"SILVA (only NR);Bacteria;Actinobacteriota;Actinobacteria;Kineosporiales;Kineosporiaceae;Quadrisphaera;";"97.6";"18.2";"41";"41";"40";"1";"0";"457142";"373854"
"V4mis1";"SILVA (only NR);Bacteria;Actinobacteriota;Actinobacteria;Kineosporiales;Kineosporiaceae;uncultured;";"100.0";"18.2";"6";"6";"6";"0";"0";"457177";"373888"
"V4mis1";"SILVA (only NR);Bacteria;Actinobacteriota;Actinobacteria;Micrococcales;";"93.6";"18.4";"7473";"7473";"6991";"482";"0";"449710";"366903"
"V4mis1";"SILVA (only NR);Bacteria;Actinobacteriota;Actinobacteria;Micrococcales;AKAU3644;";"100.0";"18.2";"4";"4";"4";"0";"0";"457179";"373890"
"V4mis1";"SILVA (only NR);Bacteria;Actinobacteriota;Actinobacteria;Micrococcales;Beutenbergiaceae;";"100.0";"18.2";"14";"14";"14";"0";"0";"457169";"373880"
"V4mis1";"SILVA (only NR);Bacteria;Actinobacteriota;Actinobacteria;Micrococcales;Beutenbergiaceae;Beutenbergia;";"100.0";"18.2";"2";"2";"2";"0";"0";"457181";"373892"
"V4mis1";"SILVA (only NR);Bacteria;Actinobacteriota;Actinobacteria;Micrococcales;Beutenbergiaceae;Miniimonas;";"100.0";"18.2";"2";"2";"2";"0";"0";"457181";"373892"
"V4mis1";"SILVA (only NR);Bacteria;Actinobacteriota;Actinobacteria;Micrococcales;Beutenbergiaceae;Salana;";"100.0";"18.2";"5";"5";"5";"0";"0";"457178";"373889"
"V4mis1";"SILVA (only NR);Bacteria;Actinobacteriota;Actinobacteria;Micrococcales;Beutenbergiaceae;Serinibacter;";"100.0";"18.2";"4";"4";"4";"0";"0";"457179";"373890"
"V4mis1";"SILVA (only NR);Bacteria;Actinobacteriota;Actinobacteria;Micrococcales;Bogoriellaceae;";"98.2";"18.2";"56";"56";"55";"1";"0";"457127";"373839"
"V4mis1";"SILVA (only NR);Bacteria;Actinobacteriota;Actinobacteria;Micrococcales;Bogoriellaceae;Bogoriella;";"100.0";"18.2";"7";"7";"7";"0";"0";"457176";"373887"
"V4mis1";"SILVA (only NR);Bacteria;Actinobacteriota;Actinobacteria;Micrococcales;Bogoriellaceae;Georgenia;";"98.0";"18.2";"49";"49";"48";"1";"0";"457134";"373846"
"V4mis1";"SILVA (only NR);Bacteria;Actinobacteriota;Actinobacteria;Micrococcales;Brevibacteriaceae;";"91.1";"18.2";"258";"258";"235";"23";"0";"456925";"373659"
"V4mis1";"SILVA (only NR);Bacteria;Actinobacteriota;Actinobacteria;Micrococcales;Brevibacteriaceae;Brevibacterium;";"91.0";"18.2";"255";"255";"232";"23";"0";"456928";"373662"
"V4mis1";"SILVA (only NR);Bacteria;Actinobacteriota;Actinobacteria;Micrococcales;Brevibacteriaceae;Sediminivirga;";"100.0";"18.2";"1";"1";"1";"0";"0";"457182";"373893"
"V4mis1";"SILVA (only NR);Bacteria;Actinobacteriota;Actinobacteria;Micrococcales;Brevibacteriaceae;Spelaeicoccus;";"100.0";"18.2";"2";"2";"2";"0";"0";"457181";"373892"
"V4mis1";"SILVA (only NR);Bacteria;Actinobacteriota;Actinobacteria;Micrococcales;Cellulomonadaceae;";"96.5";"18.2";"230";"230";"222";"8";"0";"456953";"373672"
"V4mis1";"SILVA (only NR);Bacteria;Actinobacteriota;Actinobacteria;Micrococcales;Cellulomonadaceae;Actinotalea;";"96.2";"18.2";"26";"26";"25";"1";"0";"457157";"373869"
"V4mis1";"SILVA (only NR);Bacteria;Actinobacteriota;Actinobacteria;Micrococcales;Cellulomonadaceae;Cellulomonas;";"96.8";"18.2";"154";"154";"149";"5";"0";"457029";"373745"
"V4mis1";"SILVA (only NR);Bacteria;Actinobacteriota;Actinobacteria;Micrococcales;Cellulomonadaceae;Oerskovia;";"90.5";"18.2";"21";"21";"19";"2";"0";"457162";"373875"
"V4mis1";"SILVA (only NR);Bacteria;Actinobacteriota;Actinobacteria;Micrococcales;Cellulomonadaceae;Paraoerskovia;";"100.0";"18.2";"8";"8";"8";"0";"0";"457175";"373886"
"V4mis1";"SILVA (only NR);Bacteria;Actinobacteriota;Actinobacteria;Micrococcales;Cellulomonadaceae;Pseudactinotalea;";"100.0";"18.2";"13";"13";"13";"0";"0";"457170";"373881"
"V4mis1";"SILVA (only NR);Bacteria;Actinobacteriota;Actinobacteria;Micrococcales;Cellulomonadaceae;Sediminihabitans;";"100.0";"18.2";"1";"1";"1";"0";"0";"457182";"373893"
"V4mis1";"SILVA (only NR);Bacteria;Actinobacteriota;Actinobacteria;Micrococcales;Cellulomonadaceae;Tropheryma;";"100.0";"18.2";"3";"3";"3";"0";"0";"457180";"373891"
"V4mis1";"SILVA (only NR);Bacteria;Actinobacteriota;Actinobacteria;Micrococcales;Cellulomonadaceae;Tropicihabitans;";"100.0";"18.2";"1";"1";"1";"0";"0";"457182";"373893"
"V4mis1";"SILVA (only NR);Bacteria;Actinobacteriota;Actinobacteria;Micrococcales;Demequinaceae;";"98.4";"18.2";"62";"62";"61";"1";"0";"457121";"373833"
"V4mis1";"SILVA (only NR);Bacteria;Actinobacteriota;Actinobacteria;Micrococcales;Demequinaceae;Demequina;";"100.0";"18.2";"41";"41";"41";"0";"0";"457142";"373853"
"V4mis1";"SILVA (only NR);Bacteria;Actinobacteriota;Actinobacteria;Micrococcales;Demequinaceae;Lysinimicrobium;";"93.8";"18.2";"16";"16";"15";"1";"0";"457167";"373879"
"V4mis1";"SILVA (only NR);Bacteria;Actinobacteriota;Actinobacteria;Micrococcales;Demequinaceae;uncultured;";"100.0";"18.2";"4";"4";"4";"0";"0";"457179";"373890"
"V4mis1";"SILVA (only NR);Bacteria;Actinobacteriota;Actinobacteria;Micrococcales;Dermabacteraceae;";"93.6";"18.2";"188";"188";"176";"12";"0";"456995";"373718"
"V4mis1";"SILVA (only NR);Bacteria;Actinobacteriota;Actinobacteria;Micrococcales;Dermabacteraceae;Brachybacterium;";"93.9";"18.2";"148";"148";"139";"9";"0";"457035";"373755"
"V4mis1";"SILVA (only NR);Bacteria;Actinobacteriota;Actinobacteria;Micrococcales;Dermabacteraceae;Dermabacter;";"85.7";"18.2";"21";"21";"18";"3";"0";"457162";"373876"
"V4mis1";"SILVA (only NR);Bacteria;Actinobacteriota;Actinobacteria;Micrococcales;Dermabacteraceae;Devriesea;";"100.0";"18.2";"2";"2";"2";"0";"0";"457181";"373892"
"V4mis1";"SILVA (only NR);Bacteria;Actinobacteriota;Actinobacteria;Micrococcales;Dermabacteraceae;Helcobacillus;";"100.0";"18.2";"13";"13";"13";"0";"0";"457170";"373881"
"V4mis1";"SILVA (only NR);Bacteria;Actinobacteriota;Actinobacteria;Micrococcales;Dermabacteraceae;uncultured;";"100.0";"18.2";"4";"4";"4";"0";"0";"457179";"373890"
"V4mis1";"SILVA (only NR);Bacteria;Actinobacteriota;Actinobacteria;Micrococcales;Dermacoccaceae;";"95.7";"18.2";"70";"70";"67";"3";"0";"457113";"373827"
"V4mis1";"SILVA (only NR);Bacteria;Actinobacteriota;Actinobacteria;Micrococcales;Dermacoccaceae;Allobranchiibius;";"100.0";"18.2";"3";"3";"3";"0";"0";"457180";"373891"
"V4mis1";"SILVA (only NR);Bacteria;Actinobacteriota;Actinobacteria;Micrococcales;Dermacoccaceae;Barrientosiimonas;";"100.0";"18.2";"3";"3";"3";"0";"0";"457180";"373891"
"V4mis1";"SILVA (only NR);Bacteria;Actinobacteriota;Actinobacteria;Micrococcales;Dermacoccaceae;Branchiibius;";"100.0";"18.2";"3";"3";"3";"0";"0";"457180";"373891"
"V4mis1";"SILVA (only NR);Bacteria;Actinobacteriota;Actinobacteria;Micrococcales;Dermacoccaceae;Calidifontibacter;";"100.0";"18.2";"3";"3";"3";"0";"0";"457180";"373891"
"V4mis1";"SILVA (only NR);Bacteria;Actinobacteriota;Actinobacteria;Micrococcales;Dermacoccaceae;Demetria;";"100.0";"18.2";"4";"4";"4";"0";"0";"457179";"373890"
"V4mis1";"SILVA (only NR);Bacteria;Actinobacteriota;Actinobacteria;Micrococcales;Dermacoccaceae;Dermacoccus;";"89.5";"18.2";"19";"19";"17";"2";"0";"457164";"373877"
"V4mis1";"SILVA (only NR);Bacteria;Actinobacteriota;Actinobacteria;Micrococcales;Dermacoccaceae;Flexivirga;";"100.0";"18.2";"10";"10";"10";"0";"0";"457173";"373884"
"V4mis1";"SILVA (only NR);Bacteria;Actinobacteriota;Actinobacteria;Micrococcales;Dermacoccaceae;Kytococcus;";"91.7";"18.2";"12";"12";"11";"1";"0";"457171";"373883"
"V4mis1";"SILVA (only NR);Bacteria;Actinobacteriota;Actinobacteria;Micrococcales;Dermacoccaceae;Luteipulveratus;";"100.0";"18.2";"3";"3";"3";"0";"0";"457180";"373891"
"V4mis1";"SILVA (only NR);Bacteria;Actinobacteriota;Actinobacteria;Micrococcales;Dermacoccaceae;Rudaeicoccus;";"100.0";"18.2";"1";"1";"1";"0";"0";"457182";"373893"
"V4mis1";"SILVA (only NR);Bacteria;Actinobacteriota;Actinobacteria;Micrococcales;Dermacoccaceae;Yimella;";"100.0";"18.2";"2";"2";"2";"0";"0";"457181";"373892"
"V4mis1";"SILVA (only NR);Bacteria;Actinobacteriota;Actinobacteria;Micrococcales;Dermatophilaceae;";"97.7";"18.2";"86";"86";"84";"2";"0";"457097";"373810"
"V4mis1";"SILVA (only NR);Bacteria;Actinobacteriota;Actinobacteria;Micrococcales;Dermatophilaceae;Austwickia;";"100.0";"18.2";"4";"4";"4";"0";"0";"457179";"373890"
"V4mis1";"SILVA (only NR);Bacteria;Actinobacteriota;Actinobacteria;Micrococcales;Dermatophilaceae;Dermatophilus;";"100.0";"18.2";"6";"6";"6";"0";"0";"457177";"373888"
"V4mis1";"SILVA (only NR);Bacteria;Actinobacteriota;Actinobacteria;Micrococcales;Dermatophilaceae;Kineosphaera;";"100.0";"18.2";"4";"4";"4";"0";"0";"457179";"373890"
"V4mis1";"SILVA (only NR);Bacteria;Actinobacteriota;Actinobacteria;Micrococcales;Dermatophilaceae;Mobilicoccus;";"100.0";"18.2";"8";"8";"8";"0";"0";"457175";"373886"
"V4mis1";"SILVA (only NR);Bacteria;Actinobacteriota;Actinobacteria;Micrococcales;Dermatophilaceae;Piscicoccus;";"100.0";"18.2";"2";"2";"2";"0";"0";"457181";"373892"
"V4mis1";"SILVA (only NR);Bacteria;Actinobacteriota;Actinobacteria;Micrococcales;Dermatophilaceae;Tonsilliphilus;";"100.0";"18.2";"2";"2";"2";"0";"0";"457181";"373892"
"V4mis1";"SILVA (only NR);Bacteria;Actinobacteriota;Actinobacteria;Micrococcales;Dermatophilaceae;uncultured;";"96.6";"18.2";"58";"58";"56";"2";"0";"457125";"373838"
"V4mis1";"SILVA (only NR);Bacteria;Actinobacteriota;Actinobacteria;Micrococcales;Intrasporangiaceae;";"95.8";"18.2";"454";"454";"435";"19";"0";"456729";"373459"
"V4mis1";"SILVA (only NR);Bacteria;Actinobacteriota;Actinobacteria;Micrococcales;Intrasporangiaceae;Aquipuribacter;";"88.9";"18.2";"9";"9";"8";"1";"0";"457174";"373886"
"V4mis1";"SILVA (only NR);Bacteria;Actinobacteriota;Actinobacteria;Micrococcales;Intrasporangiaceae;Arsenicicoccus;";"100.0";"18.2";"5";"5";"5";"0";"0";"457178";"373889"
"V4mis1";"SILVA (only NR);Bacteria;Actinobacteriota;Actinobacteria;Micrococcales;Intrasporangiaceae;Fodinibacter;";"100.0";"18.2";"2";"2";"2";"0";"0";"457181";"373892"
"V4mis1";"SILVA (only NR);Bacteria;Actinobacteriota;Actinobacteria;Micrococcales;Intrasporangiaceae;Humibacillus;";"100.0";"18.2";"7";"7";"7";"0";"0";"457176";"373887"
"V4mis1";"SILVA (only NR);Bacteria;Actinobacteriota;Actinobacteria;Micrococcales;Intrasporangiaceae;Intrasporangium;";"95.0";"18.2";"20";"20";"19";"1";"0";"457163";"373875"
"V4mis1";"SILVA (only NR);Bacteria;Actinobacteriota;Actinobacteria;Micrococcales;Intrasporangiaceae;Janibacter;";"91.0";"18.2";"67";"67";"61";"6";"0";"457116";"373833"
"V4mis1";"SILVA (only NR);Bacteria;Actinobacteriota;Actinobacteria;Micrococcales;Intrasporangiaceae;Knoellia;";"94.3";"18.2";"35";"35";"33";"2";"0";"457148";"373861"
"V4mis1";"SILVA (only NR);Bacteria;Actinobacteriota;Actinobacteria;Micrococcales;Intrasporangiaceae;Kribbia;";"100.0";"18.2";"2";"2";"2";"0";"0";"457181";"373892"
"V4mis1";"SILVA (only NR);Bacteria;Actinobacteriota;Actinobacteria;Micrococcales;Intrasporangiaceae;Lapillicoccus;";"100.0";"18.2";"19";"19";"19";"0";"0";"457164";"373875"
"V4mis1";"SILVA (only NR);Bacteria;Actinobacteriota;Actinobacteria;Micrococcales;Intrasporangiaceae;Marihabitans;";"100.0";"18.2";"2";"2";"2";"0";"0";"457181";"373892"
"V4mis1";"SILVA (only NR);Bacteria;Actinobacteriota;Actinobacteria;Micrococcales;Intrasporangiaceae;Ornithinibacter;";"90.0";"18.2";"10";"10";"9";"1";"0";"457173";"373885"
"V4mis1";"SILVA (only NR);Bacteria;Actinobacteriota;Actinobacteria;Micrococcales;Intrasporangiaceae;Ornithinicoccus;";"100.0";"18.2";"18";"18";"18";"0";"0";"457165";"373876"
"V4mis1";"SILVA (only NR);Bacteria;Actinobacteriota;Actinobacteria;Micrococcales;Intrasporangiaceae;Ornithinimicrobium;";"97.6";"18.2";"41";"41";"40";"1";"0";"457142";"373854"
"V4mis1";"SILVA (only NR);Bacteria;Actinobacteriota;Actinobacteria;Micrococcales;Intrasporangiaceae;Oryzihumus;";"95.0";"18.2";"20";"20";"19";"1";"0";"457163";"373875"
"V4mis1";"SILVA (only NR);Bacteria;Actinobacteriota;Actinobacteria;Micrococcales;Intrasporangiaceae;Pedococcus-Phycicoccus;";"97.1";"18.2";"34";"34";"33";"1";"0";"457149";"373861"
"V4mis1";"SILVA (only NR);Bacteria;Actinobacteriota;Actinobacteria;Micrococcales;Intrasporangiaceae;Serinicoccus;";"100.0";"18.2";"10";"10";"10";"0";"0";"457173";"373884"
"V4mis1";"SILVA (only NR);Bacteria;Actinobacteriota;Actinobacteria;Micrococcales;Intrasporangiaceae;Terrabacter;";"97.0";"18.2";"33";"33";"32";"1";"0";"457150";"373862"
"V4mis1";"SILVA (only NR);Bacteria;Actinobacteriota;Actinobacteria;Micrococcales;Intrasporangiaceae;Terracoccus;";"100.0";"18.2";"1";"1";"1";"0";"0";"457182";"373893"
"V4mis1";"SILVA (only NR);Bacteria;Actinobacteriota;Actinobacteria;Micrococcales;Intrasporangiaceae;Tetrasphaera;";"96.6";"18.2";"89";"89";"86";"3";"0";"457094";"373808"
"V4mis1";"SILVA (only NR);Bacteria;Actinobacteriota;Actinobacteria;Micrococcales;Intrasporangiaceae;uncultured;";"95.2";"18.2";"21";"21";"20";"1";"0";"457162";"373874"
"V4mis1";"SILVA (only NR);Bacteria;Actinobacteriota;Actinobacteria;Micrococcales;Jonesiaceae;";"100.0";"18.2";"13";"13";"13";"0";"0";"457170";"373881"
"V4mis1";"SILVA (only NR);Bacteria;Actinobacteriota;Actinobacteria;Micrococcales;Jonesiaceae;Jonesia;";"100.0";"18.2";"13";"13";"13";"0";"0";"457170";"373881"
"V4mis1";"SILVA (only NR);Bacteria;Actinobacteriota;Actinobacteria;Micrococcales;Microbacteriaceae;";"94.9";"18.3";"2679";"2679";"2543";"136";"0";"454504";"371351"
"V4mis1";"SILVA (only NR);Bacteria;Actinobacteriota;Actinobacteria;Micrococcales;Microbacteriaceae;Agreia;";"100.0";"18.2";"5";"5";"5";"0";"0";"457178";"373889"
"V4mis1";"SILVA (only NR);Bacteria;Actinobacteriota;Actinobacteria;Micrococcales;Microbacteriaceae;Agrococcus;";"94.9";"18.2";"78";"78";"74";"4";"0";"457105";"373820"
"V4mis1";"SILVA (only NR);Bacteria;Actinobacteriota;Actinobacteria;Micrococcales;Microbacteriaceae;Agromyces;";"94.4";"18.2";"177";"177";"167";"10";"0";"457006";"373727"
"V4mis1";"SILVA (only NR);Bacteria;Actinobacteriota;Actinobacteria;Micrococcales;Microbacteriaceae;Allohumibacter;";"100.0";"18.2";"1";"1";"1";"0";"0";"457182";"373893"
"V4mis1";"SILVA (only NR);Bacteria;Actinobacteriota;Actinobacteria;Micrococcales;Microbacteriaceae;Alpinimonas;";"100.0";"18.2";"1";"1";"1";"0";"0";"457182";"373893"
"V4mis1";"SILVA (only NR);Bacteria;Actinobacteriota;Actinobacteria;Micrococcales;Microbacteriaceae;Amnibacterium;";"92.9";"18.2";"14";"14";"13";"1";"0";"457169";"373881"
"V4mis1";"SILVA (only NR);Bacteria;Actinobacteriota;Actinobacteria;Micrococcales;Microbacteriaceae;Aurantimicrobium;";"100.0";"18.2";"19";"19";"19";"0";"0";"457164";"373875"
"V4mis1";"SILVA (only NR);Bacteria;Actinobacteriota;Actinobacteria;Micrococcales;Microbacteriaceae;Candidatus Aquiluna;";"92.0";"18.2";"50";"50";"46";"4";"0";"457133";"373848"
"V4mis1";"SILVA (only NR);Bacteria;Actinobacteriota;Actinobacteria;Micrococcales;Microbacteriaceae;Candidatus Flaviluna;";"100.0";"18.2";"3";"3";"3";"0";"0";"457180";"373891"
"V4mis1";"SILVA (only NR);Bacteria;Actinobacteriota;Actinobacteria;Micrococcales;Microbacteriaceae;Candidatus Limnoluna;";"100.0";"18.2";"11";"11";"11";"0";"0";"457172";"373883"
"V4mis1";"SILVA (only NR);Bacteria;Actinobacteriota;Actinobacteria;Micrococcales;Microbacteriaceae;Candidatus Planktoluna;";"88.2";"18.2";"17";"17";"15";"2";"0";"457166";"373879"
"V4mis1";"SILVA (only NR);Bacteria;Actinobacteriota;Actinobacteria;Micrococcales;Microbacteriaceae;Chryseoglobus;";"100.0";"18.2";"11";"11";"11";"0";"0";"457172";"373883"
"V4mis1";"SILVA (only NR);Bacteria;Actinobacteriota;Actinobacteria;Micrococcales;Microbacteriaceae;Clavibacter;";"96.2";"18.2";"53";"53";"51";"2";"0";"457130";"373843"
"V4mis1";"SILVA (only NR);Bacteria;Actinobacteriota;Actinobacteria;Micrococcales;Microbacteriaceae;Cnuibacter;";"100.0";"18.2";"4";"4";"4";"0";"0";"457179";"373890"
"V4mis1";"SILVA (only NR);Bacteria;Actinobacteriota;Actinobacteria;Micrococcales;Microbacteriaceae;Compostimonas;";"100.0";"18.2";"1";"1";"1";"0";"0";"457182";"373893"
"V4mis1";"SILVA (only NR);Bacteria;Actinobacteriota;Actinobacteria;Micrococcales;Microbacteriaceae;Conyzicola;";"100.0";"18.2";"11";"11";"11";"0";"0";"457172";"373883"
"V4mis1";"SILVA (only NR);Bacteria;Actinobacteriota;Actinobacteria;Micrococcales;Microbacteriaceae;Cryobacterium;";"94.8";"18.2";"58";"58";"55";"3";"0";"457125";"373839"
"V4mis1";"SILVA (only NR);Bacteria;Actinobacteriota;Actinobacteria;Micrococcales;Microbacteriaceae;Cryocola;";"100.0";"18.2";"2";"2";"2";"0";"0";"457181";"373892"
"V4mis1";"SILVA (only NR);Bacteria;Actinobacteriota;Actinobacteria;Micrococcales;Microbacteriaceae;Curtobacterium;";"95.0";"18.2";"139";"139";"132";"7";"0";"457044";"373762"
"V4mis1";"SILVA (only NR);Bacteria;Actinobacteriota;Actinobacteria;Micrococcales;Microbacteriaceae;DS001;";"100.0";"18.2";"2";"2";"2";"0";"0";"457181";"373892"
"V4mis1";"SILVA (only NR);Bacteria;Actinobacteriota;Actinobacteria;Micrococcales;Microbacteriaceae;Diaminobutyricibacter;";"100.0";"18.2";"1";"1";"1";"0";"0";"457182";"373893"
"V4mis1";"SILVA (only NR);Bacteria;Actinobacteriota;Actinobacteria;Micrococcales;Microbacteriaceae;Diaminobutyricimonas;";"100.0";"18.2";"7";"7";"7";"0";"0";"457176";"373887"
"V4mis1";"SILVA (only NR);Bacteria;Actinobacteriota;Actinobacteria;Micrococcales;Microbacteriaceae;Frigoribacterium;";"92.6";"18.2";"27";"27";"25";"2";"0";"457156";"373869"
"V4mis1";"SILVA (only NR);Bacteria;Actinobacteriota;Actinobacteria;Micrococcales;Microbacteriaceae;Frondihabitans;";"94.1";"18.2";"17";"17";"16";"1";"0";"457166";"373878"
"V4mis1";"SILVA (only NR);Bacteria;Actinobacteriota;Actinobacteria;Micrococcales;Microbacteriaceae;Galbitalea;";"100.0";"18.2";"23";"23";"23";"0";"0";"457160";"373871"
"V4mis1";"SILVA (only NR);Bacteria;Actinobacteriota;Actinobacteria;Micrococcales;Microbacteriaceae;Glaciibacter;";"100.0";"18.2";"4";"4";"4";"0";"0";"457179";"373890"
"V4mis1";"SILVA (only NR);Bacteria;Actinobacteriota;Actinobacteria;Micrococcales;Microbacteriaceae;Glaciihabitans;";"100.0";"18.2";"6";"6";"6";"0";"0";"457177";"373888"
"V4mis1";"SILVA (only NR);Bacteria;Actinobacteriota;Actinobacteria;Micrococcales;Microbacteriaceae;Gryllotalpicola;";"100.0";"18.2";"17";"17";"17";"0";"0";"457166";"373877"
"V4mis1";"SILVA (only NR);Bacteria;Actinobacteriota;Actinobacteria;Micrococcales;Microbacteriaceae;Gulosibacter;";"100.0";"18.2";"8";"8";"8";"0";"0";"457175";"373886"
"V4mis1";"SILVA (only NR);Bacteria;Actinobacteriota;Actinobacteria;Micrococcales;Microbacteriaceae;Herbiconiux;";"100.0";"18.2";"15";"15";"15";"0";"0";"457168";"373879"
"V4mis1";"SILVA (only NR);Bacteria;Actinobacteriota;Actinobacteria;Micrococcales;Microbacteriaceae;Homoserinibacter;";"100.0";"18.2";"4";"4";"4";"0";"0";"457179";"373890"
"V4mis1";"SILVA (only NR);Bacteria;Actinobacteriota;Actinobacteria;Micrococcales;Microbacteriaceae;Homoserinimonas;";"100.0";"18.2";"3";"3";"3";"0";"0";"457180";"373891"
"V4mis1";"SILVA (only NR);Bacteria;Actinobacteriota;Actinobacteria;Micrococcales;Microbacteriaceae;Huakuichenia;";"100.0";"18.2";"7";"7";"7";"0";"0";"457176";"373887"
"V4mis1";"SILVA (only NR);Bacteria;Actinobacteriota;Actinobacteria;Micrococcales;Microbacteriaceae;Humibacter;";"100.0";"18.2";"12";"12";"12";"0";"0";"457171";"373882"
"V4mis1";"SILVA (only NR);Bacteria;Actinobacteriota;Actinobacteria;Micrococcales;Microbacteriaceae;Klugiella;";"100.0";"18.2";"4";"4";"4";"0";"0";"457179";"373890"
"V4mis1";"SILVA (only NR);Bacteria;Actinobacteriota;Actinobacteria;Micrococcales;Microbacteriaceae;Labedella;";"100.0";"18.2";"4";"4";"4";"0";"0";"457179";"373890"
"V4mis1";"SILVA (only NR);Bacteria;Actinobacteriota;Actinobacteria;Micrococcales;Microbacteriaceae;Leifsonia;";"98.0";"18.2";"98";"98";"96";"2";"0";"457085";"373798"
"V4mis1";"SILVA (only NR);Bacteria;Actinobacteriota;Actinobacteria;Micrococcales;Microbacteriaceae;Leucobacter;";"95.2";"18.2";"227";"227";"216";"11";"0";"456956";"373678"
"V4mis1";"SILVA (only NR);Bacteria;Actinobacteriota;Actinobacteria;Micrococcales;Microbacteriaceae;Luethyella;";"100.0";"18.2";"1";"1";"1";"0";"0";"457182";"373893"
"V4mis1";"SILVA (only NR);Bacteria;Actinobacteriota;Actinobacteria;Micrococcales;Microbacteriaceae;Lysinimonas;";"100.0";"18.2";"15";"15";"15";"0";"0";"457168";"373879"
"V4mis1";"SILVA (only NR);Bacteria;Actinobacteriota;Actinobacteria;Micrococcales;Microbacteriaceae;ML602J-51;";"100.0";"18.2";"9";"9";"9";"0";"0";"457174";"373885"
"V4mis1";"SILVA (only NR);Bacteria;Actinobacteriota;Actinobacteria;Micrococcales;Microbacteriaceae;MWH-Ta3;";"100.0";"18.2";"5";"5";"5";"0";"0";"457178";"373889"
"V4mis1";"SILVA (only NR);Bacteria;Actinobacteriota;Actinobacteria;Micrococcales;Microbacteriaceae;Marisediminicola;";"100.0";"18.2";"12";"12";"12";"0";"0";"457171";"373882"
"V4mis1";"SILVA (only NR);Bacteria;Actinobacteriota;Actinobacteria;Micrococcales;Microbacteriaceae;Microbacterium;";"93.8";"18.2";"1150";"1150";"1079";"71";"0";"456033";"372815"
"V4mis1";"SILVA (only NR);Bacteria;Actinobacteriota;Actinobacteria;Micrococcales;Microbacteriaceae;Microcella;";"100.0";"18.2";"5";"5";"5";"0";"0";"457178";"373889"
"V4mis1";"SILVA (only NR);Bacteria;Actinobacteriota;Actinobacteria;Micrococcales;Microbacteriaceae;Microterricola;";"80.0";"18.2";"5";"5";"4";"1";"0";"457178";"373890"
"V4mis1";"SILVA (only NR);Bacteria;Actinobacteriota;Actinobacteria;Micrococcales;Microbacteriaceae;Mycetocola;";"90.6";"18.2";"32";"32";"29";"3";"0";"457151";"373865"
"V4mis1";"SILVA (only NR);Bacteria;Actinobacteriota;Actinobacteria;Micrococcales;Microbacteriaceae;Naasia;";"75.0";"18.2";"4";"4";"3";"1";"0";"457179";"373891"
"V4mis1";"SILVA (only NR);Bacteria;Actinobacteriota;Actinobacteria;Micrococcales;Microbacteriaceae;Okibacterium;";"88.9";"18.2";"9";"9";"8";"1";"0";"457174";"373886"
"V4mis1";"SILVA (only NR);Bacteria;Actinobacteriota;Actinobacteria;Micrococcales;Microbacteriaceae;Parafrigoribacterium;";"97.9";"18.2";"47";"47";"46";"1";"0";"457136";"373848"
"V4mis1";"SILVA (only NR);Bacteria;Actinobacteriota;Actinobacteria;Micrococcales;Microbacteriaceae;Plantibacter;";"94.7";"18.2";"19";"19";"18";"1";"0";"457164";"373876"
"V4mis1";"SILVA (only NR);Bacteria;Actinobacteriota;Actinobacteria;Micrococcales;Microbacteriaceae;Pontimonas;";"100.0";"18.2";"3";"3";"3";"0";"0";"457180";"373891"
"V4mis1";"SILVA (only NR);Bacteria;Actinobacteriota;Actinobacteria;Micrococcales;Microbacteriaceae;Pseudoclavibacter;";"95.1";"18.2";"41";"41";"39";"2";"0";"457142";"373855"
"V4mis1";"SILVA (only NR);Bacteria;Actinobacteriota;Actinobacteria;Micrococcales;Microbacteriaceae;Rathayibacter;";"88.9";"18.2";"27";"27";"24";"3";"0";"457156";"373870"
"V4mis1";"SILVA (only NR);Bacteria;Actinobacteriota;Actinobacteria;Micrococcales;Microbacteriaceae;Rhodoglobus;";"100.0";"18.2";"8";"8";"8";"0";"0";"457175";"373886"
"V4mis1";"SILVA (only NR);Bacteria;Actinobacteriota;Actinobacteria;Micrococcales;Microbacteriaceae;Rhodoluna;";"100.0";"18.2";"18";"18";"18";"0";"0";"457165";"373876"
"V4mis1";"SILVA (only NR);Bacteria;Actinobacteriota;Actinobacteria;Micrococcales;Microbacteriaceae;Rudaibacter;";"100.0";"18.2";"1";"1";"1";"0";"0";"457182";"373893"
"V4mis1";"SILVA (only NR);Bacteria;Actinobacteriota;Actinobacteria;Micrococcales;Microbacteriaceae;SV1-3;";"100.0";"18.2";"3";"3";"3";"0";"0";"457180";"373891"
"V4mis1";"SILVA (only NR);Bacteria;Actinobacteriota;Actinobacteria;Micrococcales;Microbacteriaceae;Salinibacterium;";"100.0";"18.2";"20";"20";"20";"0";"0";"457163";"373874"
"V4mis1";"SILVA (only NR);Bacteria;Actinobacteriota;Actinobacteria;Micrococcales;Microbacteriaceae;Schumannella;";"100.0";"18.2";"5";"5";"5";"0";"0";"457178";"373889"
"V4mis1";"SILVA (only NR);Bacteria;Actinobacteriota;Actinobacteria;Micrococcales;Microbacteriaceae;Subtercola;";"100.0";"18.2";"18";"18";"18";"0";"0";"457165";"373876"
"V4mis1";"SILVA (only NR);Bacteria;Actinobacteriota;Actinobacteria;Micrococcales;Microbacteriaceae;Yonghaparkia;";"83.3";"18.2";"6";"6";"5";"1";"0";"457177";"373889"
"V4mis1";"SILVA (only NR);Bacteria;Actinobacteriota;Actinobacteria;Micrococcales;Microbacteriaceae;uncultured;";"98.1";"18.2";"54";"54";"53";"1";"0";"457129";"373841"
"V4mis1";"SILVA (only NR);Bacteria;Actinobacteriota;Actinobacteria;Micrococcales;Micrococcaceae;";"91.4";"18.3";"3001";"3001";"2742";"259";"0";"454182";"371152"
"V4mis1";"SILVA (only NR);Bacteria;Actinobacteriota;Actinobacteria;Micrococcales;Micrococcaceae;Acaricomes;";"100.0";"18.2";"3";"3";"3";"0";"0";"457180";"373891"
"V4mis1";"SILVA (only NR);Bacteria;Actinobacteriota;Actinobacteria;Micrococcales;Micrococcaceae;Arthrobacter;";"95.4";"18.2";"690";"690";"658";"32";"0";"456493";"373236"
"V4mis1";"SILVA (only NR);Bacteria;Actinobacteriota;Actinobacteria;Micrococcales;Micrococcaceae;Auritidibacter;";"100.0";"18.2";"4";"4";"4";"0";"0";"457179";"373890"
"V4mis1";"SILVA (only NR);Bacteria;Actinobacteriota;Actinobacteria;Micrococcales;Micrococcaceae;Citricoccus;";"94.1";"18.2";"34";"34";"32";"2";"0";"457149";"373862"
"V4mis1";"SILVA (only NR);Bacteria;Actinobacteriota;Actinobacteria;Micrococcales;Micrococcaceae;Enteractinococcus;";"100.0";"18.2";"17";"17";"17";"0";"0";"457166";"373877"
"V4mis1";"SILVA (only NR);Bacteria;Actinobacteriota;Actinobacteria;Micrococcales;Micrococcaceae;Falsarthrobacter;";"100.0";"18.2";"2";"2";"2";"0";"0";"457181";"373892"
"V4mis1";"SILVA (only NR);Bacteria;Actinobacteriota;Actinobacteria;Micrococcales;Micrococcaceae;Garicola;";"100.0";"18.2";"10";"10";"10";"0";"0";"457173";"373884"
"V4mis1";"SILVA (only NR);Bacteria;Actinobacteriota;Actinobacteria;Micrococcales;Micrococcaceae;Glutamicibacter;";"93.5";"18.2";"170";"170";"159";"11";"0";"457013";"373735"
"V4mis1";"SILVA (only NR);Bacteria;Actinobacteriota;Actinobacteria;Micrococcales;Micrococcaceae;Haematomicrobium;";"100.0";"18.2";"1";"1";"1";"0";"0";"457182";"373893"
"V4mis1";"SILVA (only NR);Bacteria;Actinobacteriota;Actinobacteria;Micrococcales;Micrococcaceae;Kocuria;";"87.2";"18.2";"336";"336";"293";"43";"0";"456847";"373601"
"V4mis1";"SILVA (only NR);Bacteria;Actinobacteriota;Actinobacteria;Micrococcales;Micrococcaceae;Micrococcus;";"84.1";"18.2";"327";"327";"275";"52";"0";"456856";"373619"
"V4mis1";"SILVA (only NR);Bacteria;Actinobacteriota;Actinobacteria;Micrococcales;Micrococcaceae;Neomicrococcus;";"100.0";"18.2";"6";"6";"6";"0";"0";"457177";"373888"
"V4mis1";"SILVA (only NR);Bacteria;Actinobacteriota;Actinobacteria;Micrococcales;Micrococcaceae;Nesterenkonia;";"96.1";"18.2";"76";"76";"73";"3";"0";"457107";"373821"
"V4mis1";"SILVA (only NR);Bacteria;Actinobacteriota;Actinobacteria;Micrococcales;Micrococcaceae;Paenarthrobacter;";"89.6";"18.2";"144";"144";"129";"15";"0";"457039";"373765"
"V4mis1";"SILVA (only NR);Bacteria;Actinobacteriota;Actinobacteria;Micrococcales;Micrococcaceae;Paeniglutamicibacter;";"95.2";"18.2";"62";"62";"59";"3";"0";"457121";"373835"
"V4mis1";"SILVA (only NR);Bacteria;Actinobacteriota;Actinobacteria;Micrococcales;Micrococcaceae;Pseudarthrobacter;";"92.9";"18.2";"439";"439";"408";"31";"0";"456744";"373486"
"V4mis1";"SILVA (only NR);Bacteria;Actinobacteriota;Actinobacteria;Micrococcales;Micrococcaceae;Pseudoglutamicibacter;";"100.0";"18.2";"4";"4";"4";"0";"0";"457179";"373890"
"V4mis1";"SILVA (only NR);Bacteria;Actinobacteriota;Actinobacteria;Micrococcales;Micrococcaceae;Renibacterium;";"100.0";"18.2";"8";"8";"8";"0";"0";"457175";"373886"
"V4mis1";"SILVA (only NR);Bacteria;Actinobacteriota;Actinobacteria;Micrococcales;Micrococcaceae;Rothia;";"90.0";"18.2";"582";"582";"524";"58";"0";"456601";"373370"
"V4mis1";"SILVA (only NR);Bacteria;Actinobacteriota;Actinobacteria;Micrococcales;Micrococcaceae;Sinomonas;";"92.7";"18.2";"41";"41";"38";"3";"0";"457142";"373856"
"V4mis1";"SILVA (only NR);Bacteria;Actinobacteriota;Actinobacteria;Micrococcales;Micrococcaceae;Tersicoccus;";"100.0";"18.2";"4";"4";"4";"0";"0";"457179";"373890"
"V4mis1";"SILVA (only NR);Bacteria;Actinobacteriota;Actinobacteria;Micrococcales;Micrococcaceae;Yaniella;";"100.0";"18.2";"8";"8";"8";"0";"0";"457175";"373886"
"V4mis1";"SILVA (only NR);Bacteria;Actinobacteriota;Actinobacteria;Micrococcales;Micrococcaceae;Zhihengliuella;";"100.0";"18.2";"11";"11";"11";"0";"0";"457172";"373883"
"V4mis1";"SILVA (only NR);Bacteria;Actinobacteriota;Actinobacteria;Micrococcales;Micrococcaceae;uncultured;";"45.5";"18.2";"11";"11";"5";"6";"0";"457172";"373889"
"V4mis1";"SILVA (only NR);Bacteria;Actinobacteriota;Actinobacteria;Micrococcales;Micrococcales Incertae Sedis;";"92.6";"18.2";"27";"27";"25";"2";"0";"457156";"373869"
"V4mis1";"SILVA (only NR);Bacteria;Actinobacteriota;Actinobacteria;Micrococcales;Micrococcales Incertae Sedis;Luteimicrobium;";"100.0";"18.2";"6";"6";"6";"0";"0";"457177";"373888"
"V4mis1";"SILVA (only NR);Bacteria;Actinobacteriota;Actinobacteria;Micrococcales;Micrococcales Incertae Sedis;Timonella;";"90.5";"18.2";"21";"21";"19";"2";"0";"457162";"373875"
"V4mis1";"SILVA (only NR);Bacteria;Actinobacteriota;Actinobacteria;Micrococcales;Promicromonosporaceae;";"95.1";"18.2";"247";"247";"235";"12";"0";"456936";"373659"
"V4mis1";"SILVA (only NR);Bacteria;Actinobacteriota;Actinobacteria;Micrococcales;Promicromonosporaceae;Cellulosimicrobium;";"91.5";"18.2";"82";"82";"75";"7";"0";"457101";"373819"
"V4mis1";"SILVA (only NR);Bacteria;Actinobacteriota;Actinobacteria;Micrococcales;Promicromonosporaceae;Isoptericola;";"93.9";"18.2";"66";"66";"62";"4";"0";"457117";"373832"
"V4mis1";"SILVA (only NR);Bacteria;Actinobacteriota;Actinobacteria;Micrococcales;Promicromonosporaceae;Krasilnikoviella;";"100.0";"18.2";"2";"2";"2";"0";"0";"457181";"373892"
"V4mis1";"SILVA (only NR);Bacteria;Actinobacteriota;Actinobacteria;Micrococcales;Promicromonosporaceae;Myceligenerans;";"100.0";"18.2";"15";"15";"15";"0";"0";"457168";"373879"
"V4mis1";"SILVA (only NR);Bacteria;Actinobacteriota;Actinobacteria;Micrococcales;Promicromonosporaceae;Promicromonospora;";"98.6";"18.2";"70";"70";"69";"1";"0";"457113";"373825"
"V4mis1";"SILVA (only NR);Bacteria;Actinobacteriota;Actinobacteria;Micrococcales;Promicromonosporaceae;Xylanibacterium;";"100.0";"18.2";"1";"1";"1";"0";"0";"457182";"373893"
"V4mis1";"SILVA (only NR);Bacteria;Actinobacteriota;Actinobacteria;Micrococcales;Promicromonosporaceae;Xylanimicrobium;";"100.0";"18.2";"2";"2";"2";"0";"0";"457181";"373892"
"V4mis1";"SILVA (only NR);Bacteria;Actinobacteriota;Actinobacteria;Micrococcales;Promicromonosporaceae;Xylanimonas;";"100.0";"18.2";"2";"2";"2";"0";"0";"457181";"373892"
"V4mis1";"SILVA (only NR);Bacteria;Actinobacteriota;Actinobacteria;Micrococcales;Promicromonosporaceae;uncultured;";"100.0";"18.2";"2";"2";"2";"0";"0";"457181";"373892"
"V4mis1";"SILVA (only NR);Bacteria;Actinobacteriota;Actinobacteria;Micrococcales;Rarobacteraceae;";"100.0";"18.2";"6";"6";"6";"0";"0";"457177";"373888"
"V4mis1";"SILVA (only NR);Bacteria;Actinobacteriota;Actinobacteria;Micrococcales;Rarobacteraceae;Rarobacter;";"100.0";"18.2";"6";"6";"6";"0";"0";"457177";"373888"
"V4mis1";"SILVA (only NR);Bacteria;Actinobacteriota;Actinobacteria;Micrococcales;Ruaniaceae;";"87.5";"18.2";"8";"8";"7";"1";"0";"457175";"373887"
"V4mis1";"SILVA (only NR);Bacteria;Actinobacteriota;Actinobacteria;Micrococcales;Ruaniaceae;Haloactinobacterium;";"66.7";"18.2";"3";"3";"2";"1";"0";"457180";"373892"
"V4mis1";"SILVA (only NR);Bacteria;Actinobacteriota;Actinobacteria;Micrococcales;Ruaniaceae;Ruania;";"100.0";"18.2";"5";"5";"5";"0";"0";"457178";"373889"
"V4mis1";"SILVA (only NR);Bacteria;Actinobacteriota;Actinobacteria;Micrococcales;Sanguibacteraceae;";"93.9";"18.2";"49";"49";"46";"3";"0";"457134";"373848"
"V4mis1";"SILVA (only NR);Bacteria;Actinobacteriota;Actinobacteria;Micrococcales;Sanguibacteraceae;Sanguibacter-Flavimobilis;";"93.9";"18.2";"49";"49";"46";"3";"0";"457134";"373848"
"V4mis1";"SILVA (only NR);Bacteria;Actinobacteriota;Actinobacteria;Micrococcales;uncultured;";"100.0";"18.2";"11";"11";"11";"0";"0";"457172";"373883"
"V4mis1";"SILVA (only NR);Bacteria;Actinobacteriota;Actinobacteria;Micromonosporales;";"96.4";"18.3";"1197";"1197";"1154";"43";"0";"455986";"372740"
"V4mis1";"SILVA (only NR);Bacteria;Actinobacteriota;Actinobacteria;Micromonosporales;Micromonosporaceae;";"96.4";"18.3";"1197";"1197";"1154";"43";"0";"455986";"372740"
"V4mis1";"SILVA (only NR);Bacteria;Actinobacteriota;Actinobacteria;Micromonosporales;Micromonosporaceae;Actinocatenispora;";"100.0";"18.2";"8";"8";"8";"0";"0";"457175";"373886"
"V4mis1";"SILVA (only NR);Bacteria;Actinobacteriota;Actinobacteria;Micromonosporales;Micromonosporaceae;Actinoplanes;";"97.4";"18.2";"232";"232";"226";"6";"0";"456951";"373668"
"V4mis1";"SILVA (only NR);Bacteria;Actinobacteriota;Actinobacteria;Micromonosporales;Micromonosporaceae;Actinorhabdospora;";"100.0";"18.2";"1";"1";"1";"0";"0";"457182";"373893"
"V4mis1";"SILVA (only NR);Bacteria;Actinobacteriota;Actinobacteria;Micromonosporales;Micromonosporaceae;Allocatelliglobosispora;";"100.0";"18.2";"4";"4";"4";"0";"0";"457179";"373890"
"V4mis1";"SILVA (only NR);Bacteria;Actinobacteriota;Actinobacteria;Micromonosporales;Micromonosporaceae;Asanoa;";"91.3";"18.2";"23";"23";"21";"2";"0";"457160";"373873"
"V4mis1";"SILVA (only NR);Bacteria;Actinobacteriota;Actinobacteria;Micromonosporales;Micromonosporaceae;Catellatospora;";"100.0";"18.2";"16";"16";"16";"0";"0";"457167";"373878"
"V4mis1";"SILVA (only NR);Bacteria;Actinobacteriota;Actinobacteria;Micromonosporales;Micromonosporaceae;Catelliglobosispora;";"100.0";"18.2";"2";"2";"2";"0";"0";"457181";"373892"
"V4mis1";"SILVA (only NR);Bacteria;Actinobacteriota;Actinobacteria;Micromonosporales;Micromonosporaceae;Catenuloplanes;";"100.0";"18.2";"19";"19";"19";"0";"0";"457164";"373875"
"V4mis1";"SILVA (only NR);Bacteria;Actinobacteriota;Actinobacteria;Micromonosporales;Micromonosporaceae;Couchioplanes;";"100.0";"18.2";"5";"5";"5";"0";"0";"457178";"373889"
"V4mis1";"SILVA (only NR);Bacteria;Actinobacteriota;Actinobacteria;Micromonosporales;Micromonosporaceae;Dactylosporangium;";"100.0";"18.2";"41";"41";"41";"0";"0";"457142";"373853"
"V4mis1";"SILVA (only NR);Bacteria;Actinobacteriota;Actinobacteria;Micromonosporales;Micromonosporaceae;Hamadaea;";"100.0";"18.2";"9";"9";"9";"0";"0";"457174";"373885"
"V4mis1";"SILVA (only NR);Bacteria;Actinobacteriota;Actinobacteria;Micromonosporales;Micromonosporaceae;Krasilnikovia;";"100.0";"18.2";"8";"8";"8";"0";"0";"457175";"373886"
"V4mis1";"SILVA (only NR);Bacteria;Actinobacteriota;Actinobacteria;Micromonosporales;Micromonosporaceae;Longispora;";"90.5";"18.2";"21";"21";"19";"2";"0";"457162";"373875"
"V4mis1";"SILVA (only NR);Bacteria;Actinobacteriota;Actinobacteria;Micromonosporales;Micromonosporaceae;Luedemannella;";"97.1";"18.2";"34";"34";"33";"1";"0";"457149";"373861"
"V4mis1";"SILVA (only NR);Bacteria;Actinobacteriota;Actinobacteria;Micromonosporales;Micromonosporaceae;Micromonospora;";"95.5";"18.2";"532";"532";"508";"24";"0";"456651";"373386"
"V4mis1";"SILVA (only NR);Bacteria;Actinobacteriota;Actinobacteria;Micromonosporales;Micromonosporaceae;Phytohabitans;";"100.0";"18.2";"13";"13";"13";"0";"0";"457170";"373881"
"V4mis1";"SILVA (only NR);Bacteria;Actinobacteriota;Actinobacteria;Micromonosporales;Micromonosporaceae;Phytomonospora;";"100.0";"18.2";"2";"2";"2";"0";"0";"457181";"373892"
"V4mis1";"SILVA (only NR);Bacteria;Actinobacteriota;Actinobacteria;Micromonosporales;Micromonosporaceae;Pilimelia;";"100.0";"18.2";"5";"5";"5";"0";"0";"457178";"373889"
"V4mis1";"SILVA (only NR);Bacteria;Actinobacteriota;Actinobacteria;Micromonosporales;Micromonosporaceae;Planosporangium;";"100.0";"18.2";"5";"5";"5";"0";"0";"457178";"373889"
"V4mis1";"SILVA (only NR);Bacteria;Actinobacteriota;Actinobacteria;Micromonosporales;Micromonosporaceae;Plantactinospora;";"100.0";"18.2";"21";"21";"21";"0";"0";"457162";"373873"
"V4mis1";"SILVA (only NR);Bacteria;Actinobacteriota;Actinobacteria;Micromonosporales;Micromonosporaceae;Polymorphospora;";"100.0";"18.2";"1";"1";"1";"0";"0";"457182";"373893"
"V4mis1";"SILVA (only NR);Bacteria;Actinobacteriota;Actinobacteria;Micromonosporales;Micromonosporaceae;Pseudosporangium;";"100.0";"18.2";"2";"2";"2";"0";"0";"457181";"373892"
"V4mis1";"SILVA (only NR);Bacteria;Actinobacteriota;Actinobacteria;Micromonosporales;Micromonosporaceae;Rhizocola;";"100.0";"18.2";"4";"4";"4";"0";"0";"457179";"373890"
"V4mis1";"SILVA (only NR);Bacteria;Actinobacteriota;Actinobacteria;Micromonosporales;Micromonosporaceae;Rugosimonospora;";"100.0";"18.2";"2";"2";"2";"0";"0";"457181";"373892"
"V4mis1";"SILVA (only NR);Bacteria;Actinobacteriota;Actinobacteria;Micromonosporales;Micromonosporaceae;Salinispora;";"94.4";"18.2";"36";"36";"34";"2";"0";"457147";"373860"
"V4mis1";"SILVA (only NR);Bacteria;Actinobacteriota;Actinobacteria;Micromonosporales;Micromonosporaceae;Spirilliplanes;";"100.0";"18.2";"2";"2";"2";"0";"0";"457181";"373892"
"V4mis1";"SILVA (only NR);Bacteria;Actinobacteriota;Actinobacteria;Micromonosporales;Micromonosporaceae;Stackebrandtia;";"100.0";"18.2";"9";"9";"9";"0";"0";"457174";"373885"
"V4mis1";"SILVA (only NR);Bacteria;Actinobacteriota;Actinobacteria;Micromonosporales;Micromonosporaceae;Verrucosispora;";"96.3";"18.2";"27";"27";"26";"1";"0";"457156";"373868"
"V4mis1";"SILVA (only NR);Bacteria;Actinobacteriota;Actinobacteria;Micromonosporales;Micromonosporaceae;Virgisporangium;";"100.0";"18.2";"11";"11";"11";"0";"0";"457172";"373883"
"V4mis1";"SILVA (only NR);Bacteria;Actinobacteriota;Actinobacteria;Micromonosporales;Micromonosporaceae;Wangella;";"100.0";"18.2";"4";"4";"4";"0";"0";"457179";"373890"
"V4mis1";"SILVA (only NR);Bacteria;Actinobacteriota;Actinobacteria;Micromonosporales;Micromonosporaceae;Xiangella;";"100.0";"18.2";"2";"2";"2";"0";"0";"457181";"373892"
"V4mis1";"SILVA (only NR);Bacteria;Actinobacteriota;Actinobacteria;Micromonosporales;Micromonosporaceae;uncultured;";"94.3";"18.2";"87";"87";"82";"5";"0";"457096";"373812"
"V4mis1";"SILVA (only NR);Bacteria;Actinobacteriota;Actinobacteria;Nitriliruptorales;";"87.9";"18.2";"66";"66";"58";"8";"0";"457117";"373836"
"V4mis1";"SILVA (only NR);Bacteria;Actinobacteriota;Actinobacteria;Nitriliruptorales;Nitriliruptoraceae;";"87.9";"18.2";"66";"66";"58";"8";"0";"457117";"373836"
"V4mis1";"SILVA (only NR);Bacteria;Actinobacteriota;Actinobacteria;Nitriliruptorales;Nitriliruptoraceae;Egicoccus;";"100.0";"18.2";"8";"8";"8";"0";"0";"457175";"373886"
"V4mis1";"SILVA (only NR);Bacteria;Actinobacteriota;Actinobacteria;Nitriliruptorales;Nitriliruptoraceae;Nitriliruptor;";"100.0";"18.2";"3";"3";"3";"0";"0";"457180";"373891"
"V4mis1";"SILVA (only NR);Bacteria;Actinobacteriota;Actinobacteria;Nitriliruptorales;Nitriliruptoraceae;YC-ZSS-LKJ90;";"100.0";"18.2";"4";"4";"4";"0";"0";"457179";"373890"
"V4mis1";"SILVA (only NR);Bacteria;Actinobacteriota;Actinobacteria;PeM15;";"94.7";"18.2";"95";"95";"90";"5";"0";"457088";"373804"
"V4mis1";"SILVA (only NR);Bacteria;Actinobacteriota;Actinobacteria;Propionibacteriales;";"72.6";"18.1";"3584";"3584";"2602";"982";"0";"453599";"371292"
"V4mis1";"SILVA (only NR);Bacteria;Actinobacteriota;Actinobacteria;Propionibacteriales;Nocardioidaceae;";"95.2";"18.3";"1197";"1197";"1139";"58";"0";"455986";"372755"
"V4mis1";"SILVA (only NR);Bacteria;Actinobacteriota;Actinobacteria;Propionibacteriales;Nocardioidaceae;Actinopolymorpha;";"90.0";"18.2";"10";"10";"9";"1";"0";"457173";"373885"
"V4mis1";"SILVA (only NR);Bacteria;Actinobacteriota;Actinobacteria;Propionibacteriales;Nocardioidaceae;Aeromicrobium;";"93.6";"18.2";"94";"94";"88";"6";"0";"457089";"373806"
"V4mis1";"SILVA (only NR);Bacteria;Actinobacteriota;Actinobacteria;Propionibacteriales;Nocardioidaceae;Flindersiella;";"75.0";"18.2";"4";"4";"3";"1";"0";"457179";"373891"
"V4mis1";"SILVA (only NR);Bacteria;Actinobacteriota;Actinobacteria;Propionibacteriales;Nocardioidaceae;Kribbella;";"90.1";"18.2";"81";"81";"73";"8";"0";"457102";"373821"
"V4mis1";"SILVA (only NR);Bacteria;Actinobacteriota;Actinobacteria;Propionibacteriales;Nocardioidaceae;Marmoricola;";"94.7";"18.2";"75";"75";"71";"4";"0";"457108";"373823"
"V4mis1";"SILVA (only NR);Bacteria;Actinobacteriota;Actinobacteria;Propionibacteriales;Nocardioidaceae;Mumia;";"100.0";"18.2";"7";"7";"7";"0";"0";"457176";"373887"
"V4mis1";"SILVA (only NR);Bacteria;Actinobacteriota;Actinobacteria;Propionibacteriales;Nocardioidaceae;Nocardioides;";"96.4";"18.2";"839";"839";"809";"30";"0";"456344";"373085"
"V4mis1";"SILVA (only NR);Bacteria;Actinobacteriota;Actinobacteria;Propionibacteriales;Nocardioidaceae;Tenggerimyces;";"100.0";"18.2";"3";"3";"3";"0";"0";"457180";"373891"
"V4mis1";"SILVA (only NR);Bacteria;Actinobacteriota;Actinobacteria;Propionibacteriales;Nocardioidaceae;Thermasporomyces;";"100.0";"18.2";"1";"1";"1";"0";"0";"457182";"373893"
"V4mis1";"SILVA (only NR);Bacteria;Actinobacteriota;Actinobacteria;Propionibacteriales;Nocardioidaceae;uncultured;";"91.4";"18.2";"81";"81";"74";"7";"0";"457102";"373820"
"V4mis1";"SILVA (only NR);Bacteria;Actinobacteriota;Actinobacteria;Propionibacteriales;Propionibacteriaceae;";"61.3";"18.1";"2387";"2387";"1463";"924";"0";"454796";"372431"
"V4mis1";"SILVA (only NR);Bacteria;Actinobacteriota;Actinobacteria;Propionibacteriales;Propionibacteriaceae;Acidipropionibacterium;";"90.5";"18.2";"21";"21";"19";"2";"0";"457162";"373875"
"V4mis1";"SILVA (only NR);Bacteria;Actinobacteriota;Actinobacteria;Propionibacteriales;Propionibacteriaceae;Aestuariimicrobium;";"91.7";"18.2";"24";"24";"22";"2";"0";"457159";"373872"
"V4mis1";"SILVA (only NR);Bacteria;Actinobacteriota;Actinobacteria;Propionibacteriales;Propionibacteriaceae;Auraticoccus;";"100.0";"18.2";"4";"4";"4";"0";"0";"457179";"373890"
"V4mis1";"SILVA (only NR);Bacteria;Actinobacteriota;Actinobacteria;Propionibacteriales;Propionibacteriaceae;Brooklawnia;";"87.5";"18.2";"8";"8";"7";"1";"0";"457175";"373887"
"V4mis1";"SILVA (only NR);Bacteria;Actinobacteriota;Actinobacteria;Propionibacteriales;Propionibacteriaceae;Cutibacterium;";"47.7";"18.1";"1643";"1643";"783";"860";"0";"455540";"373111"
"V4mis1";"SILVA (only NR);Bacteria;Actinobacteriota;Actinobacteria;Propionibacteriales;Propionibacteriaceae;Friedmanniella;";"93.8";"18.2";"65";"65";"61";"4";"0";"457118";"373833"
"V4mis1";"SILVA (only NR);Bacteria;Actinobacteriota;Actinobacteria;Propionibacteriales;Propionibacteriaceae;Granulicoccus;";"66.7";"18.2";"3";"3";"2";"1";"0";"457180";"373892"
"V4mis1";"SILVA (only NR);Bacteria;Actinobacteriota;Actinobacteria;Propionibacteriales;Propionibacteriaceae;Haloactinopolyspora;";"96.9";"18.2";"32";"32";"31";"1";"0";"457151";"373863"
"V4mis1";"SILVA (only NR);Bacteria;Actinobacteriota;Actinobacteria;Propionibacteriales;Propionibacteriaceae;Jiangella;";"94.7";"18.2";"19";"19";"18";"1";"0";"457164";"373876"
"V4mis1";"SILVA (only NR);Bacteria;Actinobacteriota;Actinobacteria;Propionibacteriales;Propionibacteriaceae;Luteococcus;";"100.0";"18.2";"13";"13";"13";"0";"0";"457170";"373881"
"V4mis1";"SILVA (only NR);Bacteria;Actinobacteriota;Actinobacteria;Propionibacteriales;Propionibacteriaceae;Marinilutecoccus;";"100.0";"18.2";"10";"10";"10";"0";"0";"457173";"373884"
"V4mis1";"SILVA (only NR);Bacteria;Actinobacteriota;Actinobacteria;Propionibacteriales;Propionibacteriaceae;Microlunatus;";"92.5";"18.2";"80";"80";"74";"6";"0";"457103";"373820"
"V4mis1";"SILVA (only NR);Bacteria;Actinobacteriota;Actinobacteria;Propionibacteriales;Propionibacteriaceae;Micropruina;";"83.3";"18.2";"12";"12";"10";"2";"0";"457171";"373884"
"V4mis1";"SILVA (only NR);Bacteria;Actinobacteriota;Actinobacteria;Propionibacteriales;Propionibacteriaceae;Naumannella;";"100.0";"18.2";"3";"3";"3";"0";"0";"457180";"373891"
"V4mis1";"SILVA (only NR);Bacteria;Actinobacteriota;Actinobacteria;Propionibacteriales;Propionibacteriaceae;Phytoactinopolyspora;";"100.0";"18.2";"10";"10";"10";"0";"0";"457173";"373884"
"V4mis1";"SILVA (only NR);Bacteria;Actinobacteriota;Actinobacteria;Propionibacteriales;Propionibacteriaceae;Propionibacterium;";"96.7";"18.2";"60";"60";"58";"2";"0";"457123";"373836"
"V4mis1";"SILVA (only NR);Bacteria;Actinobacteriota;Actinobacteria;Propionibacteriales;Propionibacteriaceae;Propionicicella;";"80.0";"18.2";"30";"30";"24";"6";"0";"457153";"373870"
"V4mis1";"SILVA (only NR);Bacteria;Actinobacteriota;Actinobacteria;Propionibacteriales;Propionibacteriaceae;Propioniciclava;";"94.9";"18.2";"39";"39";"37";"2";"0";"457144";"373857"
"V4mis1";"SILVA (only NR);Bacteria;Actinobacteriota;Actinobacteria;Propionibacteriales;Propionibacteriaceae;Propionicimonas;";"76.9";"18.2";"13";"13";"10";"3";"0";"457170";"373884"
"V4mis1";"SILVA (only NR);Bacteria;Actinobacteriota;Actinobacteria;Propionibacteriales;Propionibacteriaceae;Propioniferax;";"100.0";"18.2";"3";"3";"3";"0";"0";"457180";"373891"
"V4mis1";"SILVA (only NR);Bacteria;Actinobacteriota;Actinobacteria;Propionibacteriales;Propionibacteriaceae;Propionimicrobium;";"83.3";"18.2";"6";"6";"5";"1";"0";"457177";"373889"
"V4mis1";"SILVA (only NR);Bacteria;Actinobacteriota;Actinobacteria;Propionibacteriales;Propionibacteriaceae;Pseudopropionibacterium;";"92.3";"18.2";"78";"78";"72";"6";"0";"457105";"373822"
"V4mis1";"SILVA (only NR);Bacteria;Actinobacteriota;Actinobacteria;Propionibacteriales;Propionibacteriaceae;Raineyella;";"100.0";"18.2";"11";"11";"11";"0";"0";"457172";"373883"
"V4mis1";"SILVA (only NR);Bacteria;Actinobacteriota;Actinobacteria;Propionibacteriales;Propionibacteriaceae;Tessaracoccus;";"90.3";"18.2";"62";"62";"56";"6";"0";"457121";"373838"
"V4mis1";"SILVA (only NR);Bacteria;Actinobacteriota;Actinobacteria;Propionibacteriales;Propionibacteriaceae;uncultured;";"85.8";"18.2";"127";"127";"109";"18";"0";"457056";"373785"
"V4mis1";"SILVA (only NR);Bacteria;Actinobacteriota;Actinobacteria;Pseudonocardiales;";"94.7";"18.3";"1365";"1365";"1293";"72";"0";"455818";"372601"
"V4mis1";"SILVA (only NR);Bacteria;Actinobacteriota;Actinobacteria;Pseudonocardiales;Pseudonocardiaceae;";"94.7";"18.3";"1365";"1365";"1293";"72";"0";"455818";"372601"
"V4mis1";"SILVA (only NR);Bacteria;Actinobacteriota;Actinobacteria;Pseudonocardiales;Pseudonocardiaceae;Actinoalloteichus;";"100.0";"18.2";"14";"14";"14";"0";"0";"457169";"373880"
"V4mis1";"SILVA (only NR);Bacteria;Actinobacteriota;Actinobacteria;Pseudonocardiales;Pseudonocardiaceae;Actinokineospora;";"100.0";"18.2";"29";"29";"29";"0";"0";"457154";"373865"
"V4mis1";"SILVA (only NR);Bacteria;Actinobacteriota;Actinobacteria;Pseudonocardiales;Pseudonocardiaceae;Actinomycetospora;";"95.0";"18.2";"40";"40";"38";"2";"0";"457143";"373856"
"V4mis1";"SILVA (only NR);Bacteria;Actinobacteriota;Actinobacteria;Pseudonocardiales;Pseudonocardiaceae;Actinophytocola;";"95.9";"18.2";"49";"49";"47";"2";"0";"457134";"373847"
"V4mis1";"SILVA (only NR);Bacteria;Actinobacteriota;Actinobacteria;Pseudonocardiales;Pseudonocardiaceae;Actinopolyspora;";"96.8";"18.2";"31";"31";"30";"1";"0";"457152";"373864"
"V4mis1";"SILVA (only NR);Bacteria;Actinobacteriota;Actinobacteria;Pseudonocardiales;Pseudonocardiaceae;Actinorectispora;";"77.8";"18.2";"9";"9";"7";"2";"0";"457174";"373887"
"V4mis1";"SILVA (only NR);Bacteria;Actinobacteriota;Actinobacteria;Pseudonocardiales;Pseudonocardiaceae;Actinosynnema;";"100.0";"18.2";"8";"8";"8";"0";"0";"457175";"373886"
"V4mis1";"SILVA (only NR);Bacteria;Actinobacteriota;Actinobacteria;Pseudonocardiales;Pseudonocardiaceae;Alloactinosynnema;";"100.0";"18.2";"7";"7";"7";"0";"0";"457176";"373887"
"V4mis1";"SILVA (only NR);Bacteria;Actinobacteriota;Actinobacteria;Pseudonocardiales;Pseudonocardiaceae;Allokutzneria;";"100.0";"18.2";"5";"5";"5";"0";"0";"457178";"373889"
"V4mis1";"SILVA (only NR);Bacteria;Actinobacteriota;Actinobacteria;Pseudonocardiales;Pseudonocardiaceae;Amycolatopsis;";"96.6";"18.2";"261";"261";"252";"9";"0";"456922";"373642"
"V4mis1";"SILVA (only NR);Bacteria;Actinobacteriota;Actinobacteria;Pseudonocardiales;Pseudonocardiaceae;Bounagaea;";"100.0";"18.2";"1";"1";"1";"0";"0";"457182";"373893"
"V4mis1";"SILVA (only NR);Bacteria;Actinobacteriota;Actinobacteria;Pseudonocardiales;Pseudonocardiaceae;Crossiella;";"90.8";"18.2";"142";"142";"129";"13";"0";"457041";"373765"
"V4mis1";"SILVA (only NR);Bacteria;Actinobacteriota;Actinobacteria;Pseudonocardiales;Pseudonocardiaceae;Goodfellowiella;";"100.0";"18.2";"5";"5";"5";"0";"0";"457178";"373889"
"V4mis1";"SILVA (only NR);Bacteria;Actinobacteriota;Actinobacteria;Pseudonocardiales;Pseudonocardiaceae;Haloechinothrix;";"100.0";"18.2";"1";"1";"1";"0";"0";"457182";"373893"
"V4mis1";"SILVA (only NR);Bacteria;Actinobacteriota;Actinobacteria;Pseudonocardiales;Pseudonocardiaceae;Halopolyspora;";"100.0";"18.2";"4";"4";"4";"0";"0";"457179";"373890"
"V4mis1";"SILVA (only NR);Bacteria;Actinobacteriota;Actinobacteria;Pseudonocardiales;Pseudonocardiaceae;Herbihabitans;";"100.0";"18.2";"4";"4";"4";"0";"0";"457179";"373890"
"V4mis1";"SILVA (only NR);Bacteria;Actinobacteriota;Actinobacteria;Pseudonocardiales;Pseudonocardiaceae;Kibdelosporangium;";"91.7";"18.2";"24";"24";"22";"2";"0";"457159";"373872"
"V4mis1";"SILVA (only NR);Bacteria;Actinobacteriota;Actinobacteria;Pseudonocardiales;Pseudonocardiaceae;Kutzneria;";"100.0";"18.2";"6";"6";"6";"0";"0";"457177";"373888"
"V4mis1";"SILVA (only NR);Bacteria;Actinobacteriota;Actinobacteria;Pseudonocardiales;Pseudonocardiaceae;Labedaea;";"100.0";"18.2";"1";"1";"1";"0";"0";"457182";"373893"
"V4mis1";"SILVA (only NR);Bacteria;Actinobacteriota;Actinobacteria;Pseudonocardiales;Pseudonocardiaceae;Lechevalieria;";"100.0";"18.2";"67";"67";"67";"0";"0";"457116";"373827"
"V4mis1";"SILVA (only NR);Bacteria;Actinobacteriota;Actinobacteria;Pseudonocardiales;Pseudonocardiaceae;Longimycelium;";"87.5";"18.2";"8";"8";"7";"1";"0";"457175";"373887"
"V4mis1";"SILVA (only NR);Bacteria;Actinobacteriota;Actinobacteria;Pseudonocardiales;Pseudonocardiaceae;Prauserella;";"100.0";"18.2";"26";"26";"26";"0";"0";"457157";"373868"
"V4mis1";"SILVA (only NR);Bacteria;Actinobacteriota;Actinobacteria;Pseudonocardiales;Pseudonocardiaceae;Pseudonocardia;";"94.2";"18.2";"359";"359";"338";"21";"0";"456824";"373556"
"V4mis1";"SILVA (only NR);Bacteria;Actinobacteriota;Actinobacteria;Pseudonocardiales;Pseudonocardiaceae;Saccharomonospora;";"90.1";"18.2";"71";"71";"64";"7";"0";"457112";"373830"
"V4mis1";"SILVA (only NR);Bacteria;Actinobacteriota;Actinobacteria;Pseudonocardiales;Pseudonocardiaceae;Saccharopolyspora;";"93.9";"18.2";"98";"98";"92";"6";"0";"457085";"373802"
"V4mis1";"SILVA (only NR);Bacteria;Actinobacteriota;Actinobacteria;Pseudonocardiales;Pseudonocardiaceae;Saccharothrix;";"91.2";"18.2";"57";"57";"52";"5";"0";"457126";"373842"
"V4mis1";"SILVA (only NR);Bacteria;Actinobacteriota;Actinobacteria;Pseudonocardiales;Pseudonocardiaceae;Sciscionella;";"100.0";"18.2";"3";"3";"3";"0";"0";"457180";"373891"
"V4mis1";"SILVA (only NR);Bacteria;Actinobacteriota;Actinobacteria;Pseudonocardiales;Pseudonocardiaceae;Streptoalloteichus;";"100.0";"18.2";"4";"4";"4";"0";"0";"457179";"373890"
"V4mis1";"SILVA (only NR);Bacteria;Actinobacteriota;Actinobacteria;Pseudonocardiales;Pseudonocardiaceae;Tamaricihabitans;";"100.0";"18.2";"1";"1";"1";"0";"0";"457182";"373893"
"V4mis1";"SILVA (only NR);Bacteria;Actinobacteriota;Actinobacteria;Pseudonocardiales;Pseudonocardiaceae;Thermocrispum;";"100.0";"18.2";"8";"8";"8";"0";"0";"457175";"373886"
"V4mis1";"SILVA (only NR);Bacteria;Actinobacteriota;Actinobacteria;Pseudonocardiales;Pseudonocardiaceae;Thermotunica;";"100.0";"18.2";"2";"2";"2";"0";"0";"457181";"373892"
"V4mis1";"SILVA (only NR);Bacteria;Actinobacteriota;Actinobacteria;Pseudonocardiales;Pseudonocardiaceae;Umezawaea;";"100.0";"18.2";"3";"3";"3";"0";"0";"457180";"373891"
"V4mis1";"SILVA (only NR);Bacteria;Actinobacteriota;Actinobacteria;Pseudonocardiales;Pseudonocardiaceae;Yuhushiella;";"75.0";"18.2";"4";"4";"3";"1";"0";"457179";"373891"
"V4mis1";"SILVA (only NR);Bacteria;Actinobacteriota;Actinobacteria;Pseudonocardiales;Pseudonocardiaceae;uncultured;";"100.0";"18.2";"3";"3";"3";"0";"0";"457180";"373891"
"V4mis1";"SILVA (only NR);Bacteria;Actinobacteriota;Actinobacteria;Streptomycetales;";"95.4";"18.4";"6216";"6216";"5933";"283";"0";"450967";"367961"
"V4mis1";"SILVA (only NR);Bacteria;Actinobacteriota;Actinobacteria;Streptomycetales;Streptomycetaceae;";"95.4";"18.4";"6216";"6216";"5933";"283";"0";"450967";"367961"
"V4mis1";"SILVA (only NR);Bacteria;Actinobacteriota;Actinobacteria;Streptomycetales;Streptomycetaceae;Allostreptomyces;";"100.0";"18.2";"3";"3";"3";"0";"0";"457180";"373891"
"V4mis1";"SILVA (only NR);Bacteria;Actinobacteriota;Actinobacteria;Streptomycetales;Streptomycetaceae;E1B-B3-114;";"100.0";"18.2";"2";"2";"2";"0";"0";"457181";"373892"
"V4mis1";"SILVA (only NR);Bacteria;Actinobacteriota;Actinobacteria;Streptomycetales;Streptomycetaceae;Kitasatospora;";"97.6";"18.2";"168";"168";"164";"4";"0";"457015";"373730"
"V4mis1";"SILVA (only NR);Bacteria;Actinobacteriota;Actinobacteria;Streptomycetales;Streptomycetaceae;Streptacidiphilus;";"96.8";"18.2";"31";"31";"30";"1";"0";"457152";"373864"
"V4mis1";"SILVA (only NR);Bacteria;Actinobacteriota;Actinobacteria;Streptomycetales;Streptomycetaceae;Streptomyces;";"95.4";"18.4";"6011";"6011";"5733";"278";"0";"451172";"368161"
"V4mis1";"SILVA (only NR);Bacteria;Actinobacteriota;Actinobacteria;Streptosporangiales;";"95.4";"18.3";"1229";"1229";"1172";"57";"0";"455954";"372722"
"V4mis1";"SILVA (only NR);Bacteria;Actinobacteriota;Actinobacteria;Streptosporangiales;Nocardiopsaceae;";"95.8";"18.2";"355";"355";"340";"15";"0";"456828";"373554"
"V4mis1";"SILVA (only NR);Bacteria;Actinobacteriota;Actinobacteria;Streptosporangiales;Nocardiopsaceae;Actinorugispora;";"100.0";"18.2";"1";"1";"1";"0";"0";"457182";"373893"
"V4mis1";"SILVA (only NR);Bacteria;Actinobacteriota;Actinobacteria;Streptosporangiales;Nocardiopsaceae;Allonocardiopsis;";"100.0";"18.2";"1";"1";"1";"0";"0";"457182";"373893"
"V4mis1";"SILVA (only NR);Bacteria;Actinobacteriota;Actinobacteria;Streptosporangiales;Nocardiopsaceae;Allosalinactinospora;";"50.0";"18.2";"2";"2";"1";"1";"0";"457181";"373893"
"V4mis1";"SILVA (only NR);Bacteria;Actinobacteriota;Actinobacteria;Streptosporangiales;Nocardiopsaceae;Haloactinospora;";"100.0";"18.2";"1";"1";"1";"0";"0";"457182";"373893"
"V4mis1";"SILVA (only NR);Bacteria;Actinobacteriota;Actinobacteria;Streptosporangiales;Nocardiopsaceae;Lipingzhangella;";"100.0";"18.2";"5";"5";"5";"0";"0";"457178";"373889"
"V4mis1";"SILVA (only NR);Bacteria;Actinobacteriota;Actinobacteria;Streptosporangiales;Nocardiopsaceae;Marinactinospora;";"100.0";"18.2";"2";"2";"2";"0";"0";"457181";"373892"
"V4mis1";"SILVA (only NR);Bacteria;Actinobacteriota;Actinobacteria;Streptosporangiales;Nocardiopsaceae;Marinateneraspora;";"100.0";"18.2";"1";"1";"1";"0";"0";"457182";"373893"
"V4mis1";"SILVA (only NR);Bacteria;Actinobacteriota;Actinobacteria;Streptosporangiales;Nocardiopsaceae;Murinocardiopsis;";"100.0";"18.2";"1";"1";"1";"0";"0";"457182";"373893"
"V4mis1";"SILVA (only NR);Bacteria;Actinobacteriota;Actinobacteria;Streptosporangiales;Nocardiopsaceae;Nocardiopsis;";"95.9";"18.2";"291";"291";"279";"12";"0";"456892";"373615"
"V4mis1";"SILVA (only NR);Bacteria;Actinobacteriota;Actinobacteria;Streptosporangiales;Nocardiopsaceae;Salinactinospora;";"100.0";"18.2";"1";"1";"1";"0";"0";"457182";"373893"
"V4mis1";"SILVA (only NR);Bacteria;Actinobacteriota;Actinobacteria;Streptosporangiales;Nocardiopsaceae;Spinactinospora;";"100.0";"18.2";"1";"1";"1";"0";"0";"457182";"373893"
"V4mis1";"SILVA (only NR);Bacteria;Actinobacteriota;Actinobacteria;Streptosporangiales;Nocardiopsaceae;Streptomonospora;";"95.7";"18.2";"23";"23";"22";"1";"0";"457160";"373872"
"V4mis1";"SILVA (only NR);Bacteria;Actinobacteriota;Actinobacteria;Streptosporangiales;Nocardiopsaceae;Thermobifida;";"94.7";"18.2";"19";"19";"18";"1";"0";"457164";"373876"
"V4mis1";"SILVA (only NR);Bacteria;Actinobacteriota;Actinobacteria;Streptosporangiales;Nocardiopsaceae;uncultured;";"100.0";"18.2";"2";"2";"2";"0";"0";"457181";"373892"
"V4mis1";"SILVA (only NR);Bacteria;Actinobacteriota;Actinobacteria;Streptosporangiales;Streptosporangiaceae;";"94.6";"18.2";"497";"497";"470";"27";"0";"456686";"373424"
"V4mis1";"SILVA (only NR);Bacteria;Actinobacteriota;Actinobacteria;Streptosporangiales;Streptosporangiaceae;Acrocarpospora;";"100.0";"18.2";"10";"10";"10";"0";"0";"457173";"373884"
"V4mis1";"SILVA (only NR);Bacteria;Actinobacteriota;Actinobacteria;Streptosporangiales;Streptosporangiaceae;Herbidospora;";"100.0";"18.2";"8";"8";"8";"0";"0";"457175";"373886"
"V4mis1";"SILVA (only NR);Bacteria;Actinobacteriota;Actinobacteria;Streptosporangiales;Streptosporangiaceae;Microbispora;";"98.1";"18.2";"53";"53";"52";"1";"0";"457130";"373842"
"V4mis1";"SILVA (only NR);Bacteria;Actinobacteriota;Actinobacteria;Streptosporangiales;Streptosporangiaceae;Microtetraspora;";"100.0";"18.2";"8";"8";"8";"0";"0";"457175";"373886"
"V4mis1";"SILVA (only NR);Bacteria;Actinobacteriota;Actinobacteria;Streptosporangiales;Streptosporangiaceae;Nonomuraea;";"93.8";"18.2";"195";"195";"183";"12";"0";"456988";"373711"
"V4mis1";"SILVA (only NR);Bacteria;Actinobacteriota;Actinobacteria;Streptosporangiales;Streptosporangiaceae;Planobispora;";"100.0";"18.2";"4";"4";"4";"0";"0";"457179";"373890"
"V4mis1";"SILVA (only NR);Bacteria;Actinobacteriota;Actinobacteria;Streptosporangiales;Streptosporangiaceae;Planomonospora;";"100.0";"18.2";"10";"10";"10";"0";"0";"457173";"373884"
"V4mis1";"SILVA (only NR);Bacteria;Actinobacteriota;Actinobacteria;Streptosporangiales;Streptosporangiaceae;Planotetraspora;";"100.0";"18.2";"14";"14";"14";"0";"0";"457169";"373880"
"V4mis1";"SILVA (only NR);Bacteria;Actinobacteriota;Actinobacteria;Streptosporangiales;Streptosporangiaceae;Sinosporangium;";"100.0";"18.2";"3";"3";"3";"0";"0";"457180";"373891"
"V4mis1";"SILVA (only NR);Bacteria;Actinobacteriota;Actinobacteria;Streptosporangiales;Streptosporangiaceae;Sphaerimonospora;";"100.0";"18.2";"6";"6";"6";"0";"0";"457177";"373888"
"V4mis1";"SILVA (only NR);Bacteria;Actinobacteriota;Actinobacteria;Streptosporangiales;Streptosporangiaceae;Sphaerisporangium;";"91.7";"18.2";"48";"48";"44";"4";"0";"457135";"373850"
"V4mis1";"SILVA (only NR);Bacteria;Actinobacteriota;Actinobacteria;Streptosporangiales;Streptosporangiaceae;Streptosporangium;";"92.2";"18.2";"116";"116";"107";"9";"0";"457067";"373787"
"V4mis1";"SILVA (only NR);Bacteria;Actinobacteriota;Actinobacteria;Streptosporangiales;Streptosporangiaceae;Thermoactinospora;";"100.0";"18.2";"1";"1";"1";"0";"0";"457182";"373893"
"V4mis1";"SILVA (only NR);Bacteria;Actinobacteriota;Actinobacteria;Streptosporangiales;Streptosporangiaceae;Thermocatellispora;";"100.0";"18.2";"3";"3";"3";"0";"0";"457180";"373891"
"V4mis1";"SILVA (only NR);Bacteria;Actinobacteriota;Actinobacteria;Streptosporangiales;Streptosporangiaceae;Thermopolyspora;";"100.0";"18.2";"4";"4";"4";"0";"0";"457179";"373890"
"V4mis1";"SILVA (only NR);Bacteria;Actinobacteriota;Actinobacteria;Streptosporangiales;Streptosporangiaceae;uncultured;";"100.0";"18.2";"6";"6";"6";"0";"0";"457177";"373888"
"V4mis1";"SILVA (only NR);Bacteria;Actinobacteriota;Actinobacteria;Streptosporangiales;Streptosporangiales Incertae Sedis;";"100.0";"18.2";"6";"6";"6";"0";"0";"457177";"373888"
"V4mis1";"SILVA (only NR);Bacteria;Actinobacteriota;Actinobacteria;Streptosporangiales;Streptosporangiales Incertae Sedis;Motilibacter;";"100.0";"18.2";"6";"6";"6";"0";"0";"457177";"373888"
"V4mis1";"SILVA (only NR);Bacteria;Actinobacteriota;Actinobacteria;Streptosporangiales;Thermomonosporaceae;";"95.9";"18.2";"369";"369";"354";"15";"0";"456814";"373540"
"V4mis1";"SILVA (only NR);Bacteria;Actinobacteriota;Actinobacteria;Streptosporangiales;Thermomonosporaceae;Actinoallomurus;";"97.6";"18.2";"42";"42";"41";"1";"0";"457141";"373853"
"V4mis1";"SILVA (only NR);Bacteria;Actinobacteriota;Actinobacteria;Streptosporangiales;Thermomonosporaceae;Actinocorallia;";"100.0";"18.2";"26";"26";"26";"0";"0";"457157";"373868"
"V4mis1";"SILVA (only NR);Bacteria;Actinobacteriota;Actinobacteria;Streptosporangiales;Thermomonosporaceae;Actinomadura;";"95.9";"18.2";"242";"242";"232";"10";"0";"456941";"373662"
"V4mis1";"SILVA (only NR);Bacteria;Actinobacteriota;Actinobacteria;Streptosporangiales;Thermomonosporaceae;Spirillospora;";"100.0";"18.2";"7";"7";"7";"0";"0";"457176";"373887"
"V4mis1";"SILVA (only NR);Bacteria;Actinobacteriota;Actinobacteria;Streptosporangiales;Thermomonosporaceae;Thermobispora;";"100.0";"18.2";"9";"9";"9";"0";"0";"457174";"373885"
"V4mis1";"SILVA (only NR);Bacteria;Actinobacteriota;Actinobacteria;Streptosporangiales;Thermomonosporaceae;Thermomonospora;";"100.0";"18.2";"9";"9";"9";"0";"0";"457174";"373885"
"V4mis1";"SILVA (only NR);Bacteria;Actinobacteriota;Actinobacteria;Streptosporangiales;Thermomonosporaceae;Thermostaphylospora;";"100.0";"18.2";"10";"10";"10";"0";"0";"457173";"373884"
"V4mis1";"SILVA (only NR);Bacteria;Actinobacteriota;Actinobacteria;Streptosporangiales;Thermomonosporaceae;[Streptomyces] thermoautotrophicus;";"100.0";"18.2";"3";"3";"3";"0";"0";"457180";"373891"
"V4mis1";"SILVA (only NR);Bacteria;Actinobacteriota;Actinobacteria;Streptosporangiales;Thermomonosporaceae;uncultured;";"75.0";"18.2";"4";"4";"3";"1";"0";"457179";"373891"
"V4mis1";"SILVA (only NR);Bacteria;Actinobacteriota;Actinobacteria;uncultured;";"100.0";"18.2";"15";"15";"15";"0";"0";"457168";"373879"
"V4mis1";"SILVA (only NR);Bacteria;Actinobacteriota;Coriobacteriia;";"96.9";"18.3";"1162";"1162";"1126";"36";"0";"456021";"372768"
"V4mis1";"SILVA (only NR);Bacteria;Actinobacteriota;Coriobacteriia;CG2-30-50-142;";"100.0";"18.2";"8";"8";"8";"0";"0";"457175";"373886"
"V4mis1";"SILVA (only NR);Bacteria;Actinobacteriota;Coriobacteriia;Coriobacteriales;";"96.9";"18.3";"1040";"1040";"1008";"32";"0";"456143";"372886"
"V4mis1";"SILVA (only NR);Bacteria;Actinobacteriota;Coriobacteriia;Coriobacteriales;Atopobiaceae;";"93.8";"18.2";"211";"211";"198";"13";"0";"456972";"373696"
"V4mis1";"SILVA (only NR);Bacteria;Actinobacteriota;Coriobacteriia;Coriobacteriales;Atopobiaceae;Atopobium;";"86.7";"18.2";"75";"75";"65";"10";"0";"457108";"373829"
"V4mis1";"SILVA (only NR);Bacteria;Actinobacteriota;Coriobacteriia;Coriobacteriales;Atopobiaceae;Coriobacteriaceae UCG-002;";"100.0";"18.2";"17";"17";"17";"0";"0";"457166";"373877"
"V4mis1";"SILVA (only NR);Bacteria;Actinobacteriota;Coriobacteriia;Coriobacteriales;Atopobiaceae;Coriobacteriaceae UCG-003;";"100.0";"18.2";"9";"9";"9";"0";"0";"457174";"373885"
"V4mis1";"SILVA (only NR);Bacteria;Actinobacteriota;Coriobacteriia;Coriobacteriales;Atopobiaceae;Libanicoccus;";"100.0";"18.2";"15";"15";"15";"0";"0";"457168";"373879"
"V4mis1";"SILVA (only NR);Bacteria;Actinobacteriota;Coriobacteriia;Coriobacteriales;Atopobiaceae;Olsenella;";"97.7";"18.2";"86";"86";"84";"2";"0";"457097";"373810"
"V4mis1";"SILVA (only NR);Bacteria;Actinobacteriota;Coriobacteriia;Coriobacteriales;Atopobiaceae;uncultured;";"85.7";"18.2";"7";"7";"6";"1";"0";"457176";"373888"
"V4mis1";"SILVA (only NR);Bacteria;Actinobacteriota;Coriobacteriia;Coriobacteriales;Coriobacteriaceae;";"97.7";"18.2";"351";"351";"343";"8";"0";"456832";"373551"
"V4mis1";"SILVA (only NR);Bacteria;Actinobacteriota;Coriobacteriia;Coriobacteriales;Coriobacteriaceae;Collinsella;";"97.6";"18.2";"334";"334";"326";"8";"0";"456849";"373568"
"V4mis1";"SILVA (only NR);Bacteria;Actinobacteriota;Coriobacteriia;Coriobacteriales;Coriobacteriaceae;Coriobacterium;";"100.0";"18.2";"8";"8";"8";"0";"0";"457175";"373886"
"V4mis1";"SILVA (only NR);Bacteria;Actinobacteriota;Coriobacteriia;Coriobacteriales;Coriobacteriaceae;Enorma;";"100.0";"18.2";"9";"9";"9";"0";"0";"457174";"373885"
"V4mis1";"SILVA (only NR);Bacteria;Actinobacteriota;Coriobacteriia;Coriobacteriales;Coriobacteriales Incertae Sedis;";"100.0";"18.2";"68";"68";"68";"0";"0";"457115";"373826"
"V4mis1";"SILVA (only NR);Bacteria;Actinobacteriota;Coriobacteriia;Coriobacteriales;Coriobacteriales Incertae Sedis;Phoenicibacter;";"100.0";"18.2";"8";"8";"8";"0";"0";"457175";"373886"
"V4mis1";"SILVA (only NR);Bacteria;Actinobacteriota;Coriobacteriia;Coriobacteriales;Coriobacteriales Incertae Sedis;Raoultibacter;";"100.0";"18.2";"16";"16";"16";"0";"0";"457167";"373878"
"V4mis1";"SILVA (only NR);Bacteria;Actinobacteriota;Coriobacteriia;Coriobacteriales;Coriobacteriales Incertae Sedis;uncultured;";"100.0";"18.2";"44";"44";"44";"0";"0";"457139";"373850"
"V4mis1";"SILVA (only NR);Bacteria;Actinobacteriota;Coriobacteriia;Coriobacteriales;Eggerthellaceae;";"97.2";"18.2";"387";"387";"376";"11";"0";"456796";"373518"
"V4mis1";"SILVA (only NR);Bacteria;Actinobacteriota;Coriobacteriia;Coriobacteriales;Eggerthellaceae;Adlercreutzia;";"100.0";"18.2";"10";"10";"10";"0";"0";"457173";"373884"
"V4mis1";"SILVA (only NR);Bacteria;Actinobacteriota;Coriobacteriia;Coriobacteriales;Eggerthellaceae;Asaccharobacter;";"100.0";"18.2";"2";"2";"2";"0";"0";"457181";"373892"
"V4mis1";"SILVA (only NR);Bacteria;Actinobacteriota;Coriobacteriia;Coriobacteriales;Eggerthellaceae;CHKCI002;";"100.0";"18.2";"2";"2";"2";"0";"0";"457181";"373892"
"V4mis1";"SILVA (only NR);Bacteria;Actinobacteriota;Coriobacteriia;Coriobacteriales;Eggerthellaceae;Cryptobacterium;";"100.0";"18.2";"3";"3";"3";"0";"0";"457180";"373891"
"V4mis1";"SILVA (only NR);Bacteria;Actinobacteriota;Coriobacteriia;Coriobacteriales;Eggerthellaceae;DNF00809;";"100.0";"18.2";"13";"13";"13";"0";"0";"457170";"373881"
"V4mis1";"SILVA (only NR);Bacteria;Actinobacteriota;Coriobacteriia;Coriobacteriales;Eggerthellaceae;Denitrobacterium;";"100.0";"18.2";"4";"4";"4";"0";"0";"457179";"373890"
"V4mis1";"SILVA (only NR);Bacteria;Actinobacteriota;Coriobacteriia;Coriobacteriales;Eggerthellaceae;Eggerthella;";"96.9";"18.2";"32";"32";"31";"1";"0";"457151";"373863"
"V4mis1";"SILVA (only NR);Bacteria;Actinobacteriota;Coriobacteriia;Coriobacteriales;Eggerthellaceae;Enterorhabdus;";"95.6";"18.2";"136";"136";"130";"6";"0";"457047";"373764"
"V4mis1";"SILVA (only NR);Bacteria;Actinobacteriota;Coriobacteriia;Coriobacteriales;Eggerthellaceae;Enteroscipio;";"100.0";"18.2";"2";"2";"2";"0";"0";"457181";"373892"
"V4mis1";"SILVA (only NR);Bacteria;Actinobacteriota;Coriobacteriia;Coriobacteriales;Eggerthellaceae;Gordonibacter;";"100.0";"18.2";"23";"23";"23";"0";"0";"457160";"373871"
"V4mis1";"SILVA (only NR);Bacteria;Actinobacteriota;Coriobacteriia;Coriobacteriales;Eggerthellaceae;Paraeggerthella;";"100.0";"18.2";"7";"7";"7";"0";"0";"457176";"373887"
"V4mis1";"SILVA (only NR);Bacteria;Actinobacteriota;Coriobacteriia;Coriobacteriales;Eggerthellaceae;Parvibacter;";"100.0";"18.2";"6";"6";"6";"0";"0";"457177";"373888"
"V4mis1";"SILVA (only NR);Bacteria;Actinobacteriota;Coriobacteriia;Coriobacteriales;Eggerthellaceae;Senegalimassilia;";"100.0";"18.2";"24";"24";"24";"0";"0";"457159";"373870"
"V4mis1";"SILVA (only NR);Bacteria;Actinobacteriota;Coriobacteriia;Coriobacteriales;Eggerthellaceae;Slackia;";"96.1";"18.2";"51";"51";"49";"2";"0";"457132";"373845"
"V4mis1";"SILVA (only NR);Bacteria;Actinobacteriota;Coriobacteriia;Coriobacteriales;Eggerthellaceae;uncultured;";"97.2";"18.2";"72";"72";"70";"2";"0";"457111";"373824"
"V4mis1";"SILVA (only NR);Bacteria;Actinobacteriota;Coriobacteriia;Coriobacteriales;uncultured;";"100.0";"18.2";"22";"22";"22";"0";"0";"457161";"373872"
"V4mis1";"SILVA (only NR);Bacteria;Actinobacteriota;Coriobacteriia;FS118-23B-02;";"100.0";"18.2";"11";"11";"11";"0";"0";"457172";"373883"
"V4mis1";"SILVA (only NR);Bacteria;Actinobacteriota;Coriobacteriia;OPB41;";"96.1";"18.2";"103";"103";"99";"4";"0";"457080";"373795"
"V4mis1";"SILVA (only NR);Bacteria;Actinobacteriota;MB-A2-108;";"94.3";"18.2";"194";"194";"183";"11";"0";"456989";"373711"
"V4mis1";"SILVA (only NR);Bacteria;Actinobacteriota;RBG-16-55-12;";"96.9";"18.2";"32";"32";"31";"1";"0";"457151";"373863"
"V4mis1";"SILVA (only NR);Bacteria;Actinobacteriota;Rubrobacteria;";"92.3";"18.2";"261";"261";"241";"20";"0";"456922";"373653"
"V4mis1";"SILVA (only NR);Bacteria;Actinobacteriota;Rubrobacteria;Rubrobacterales;";"92.3";"18.2";"261";"261";"241";"20";"0";"456922";"373653"
"V4mis1";"SILVA (only NR);Bacteria;Actinobacteriota;Rubrobacteria;Rubrobacterales;Rubrobacteriaceae;";"92.3";"18.2";"261";"261";"241";"20";"0";"456922";"373653"
"V4mis1";"SILVA (only NR);Bacteria;Actinobacteriota;Rubrobacteria;Rubrobacterales;Rubrobacteriaceae;Rubrobacter;";"92.3";"18.2";"261";"261";"241";"20";"0";"456922";"373653"
"V4mis1";"SILVA (only NR);Bacteria;Actinobacteriota;Thermoleophilia;";"94.4";"18.3";"1750";"1750";"1652";"98";"0";"455433";"372242"
"V4mis1";"SILVA (only NR);Bacteria;Actinobacteriota;Thermoleophilia;Gaiellales;";"94.8";"18.2";"1029";"1029";"975";"54";"0";"456154";"372919"
"V4mis1";"SILVA (only NR);Bacteria;Actinobacteriota;Thermoleophilia;Gaiellales;Gaiellaceae;";"95.6";"18.2";"203";"203";"194";"9";"0";"456980";"373700"
"V4mis1";"SILVA (only NR);Bacteria;Actinobacteriota;Thermoleophilia;Gaiellales;Gaiellaceae;Gaiella;";"95.6";"18.2";"203";"203";"194";"9";"0";"456980";"373700"
"V4mis1";"SILVA (only NR);Bacteria;Actinobacteriota;Thermoleophilia;Gaiellales;uncultured;";"94.5";"18.2";"823";"823";"778";"45";"0";"456360";"373116"
"V4mis1";"SILVA (only NR);Bacteria;Actinobacteriota;Thermoleophilia;Solirubrobacterales;";"93.8";"18.2";"692";"692";"649";"43";"0";"456491";"373245"
"V4mis1";"SILVA (only NR);Bacteria;Actinobacteriota;Thermoleophilia;Solirubrobacterales;67-14;";"92.7";"18.2";"327";"327";"303";"24";"0";"456856";"373591"
"V4mis1";"SILVA (only NR);Bacteria;Actinobacteriota;Thermoleophilia;Solirubrobacterales;Solirubrobacteraceae;";"94.8";"18.2";"365";"365";"346";"19";"0";"456818";"373548"
"V4mis1";"SILVA (only NR);Bacteria;Actinobacteriota;Thermoleophilia;Solirubrobacterales;Solirubrobacteraceae;Conexibacter;";"97.3";"18.2";"110";"110";"107";"3";"0";"457073";"373787"
"V4mis1";"SILVA (only NR);Bacteria;Actinobacteriota;Thermoleophilia;Solirubrobacterales;Solirubrobacteraceae;JCM 18997;";"100.0";"18.2";"5";"5";"5";"0";"0";"457178";"373889"
"V4mis1";"SILVA (only NR);Bacteria;Actinobacteriota;Thermoleophilia;Solirubrobacterales;Solirubrobacteraceae;Parviterribacter;";"76.9";"18.2";"13";"13";"10";"3";"0";"457170";"373884"
"V4mis1";"SILVA (only NR);Bacteria;Actinobacteriota;Thermoleophilia;Solirubrobacterales;Solirubrobacteraceae;Patulibacter;";"100.0";"18.2";"17";"17";"17";"0";"0";"457166";"373877"
"V4mis1";"SILVA (only NR);Bacteria;Actinobacteriota;Thermoleophilia;Solirubrobacterales;Solirubrobacteraceae;Solirubrobacter;";"94.5";"18.2";"183";"183";"173";"10";"0";"457000";"373721"
"V4mis1";"SILVA (only NR);Bacteria;Actinobacteriota;Thermoleophilia;Solirubrobacterales;Solirubrobacteraceae;uncultured;";"91.2";"18.2";"34";"34";"31";"3";"0";"457149";"373863"
"V4mis1";"SILVA (only NR);Bacteria;Actinobacteriota;Thermoleophilia;Thermophilales;";"100.0";"18.2";"5";"5";"5";"0";"0";"457178";"373889"
"V4mis1";"SILVA (only NR);Bacteria;Actinobacteriota;Thermoleophilia;Thermophilales;Thermoleophilaceae;";"100.0";"18.2";"5";"5";"5";"0";"0";"457178";"373889"
"V4mis1";"SILVA (only NR);Bacteria;Actinobacteriota;Thermoleophilia;Thermophilales;Thermoleophilaceae;Thermoleophilum;";"100.0";"18.2";"5";"5";"5";"0";"0";"457178";"373889"
"V4mis1";"SILVA (only NR);Bacteria;Actinobacteriota;Thermoleophilia;uncultured;";"95.8";"18.2";"24";"24";"23";"1";"0";"457159";"373871"
"V4mis1";"SILVA (only NR);Bacteria;Actinobacteriota;WCHB1-81;";"92.1";"18.2";"89";"89";"82";"7";"0";"457094";"373812"
"V4mis1";"SILVA (only NR);Bacteria;Aerophobota;";"91.4";"18.2";"70";"70";"64";"6";"0";"457113";"373830"
"V4mis1";"SILVA (only NR);Bacteria;Aerophobota;Aerophobia;";"91.4";"18.2";"70";"70";"64";"6";"0";"457113";"373830"
"V4mis1";"SILVA (only NR);Bacteria;Aerophobota;Aerophobia;Aerophobales;";"91.4";"18.2";"70";"70";"64";"6";"0";"457113";"373830"
"V4mis1";"SILVA (only NR);Bacteria;AncK6;";"100.0";"18.2";"23";"23";"23";"0";"0";"457160";"373871"
"V4mis1";"SILVA (only NR);Bacteria;Apal-E12;";"66.7";"18.2";"3";"3";"2";"1";"0";"457180";"373892"
"V4mis1";"SILVA (only NR);Bacteria;Aquificota;";"94.1";"18.2";"253";"253";"238";"15";"0";"456930";"373656"
"V4mis1";"SILVA (only NR);Bacteria;Aquificota;Aquificae;";"93.8";"18.2";"226";"226";"212";"14";"0";"456957";"373682"
"V4mis1";"SILVA (only NR);Bacteria;Aquificota;Aquificae;Aquificales;";"94.6";"18.2";"130";"130";"123";"7";"0";"457053";"373771"
"V4mis1";"SILVA (only NR);Bacteria;Aquificota;Aquificae;Aquificales;Aquificaceae;";"94.4";"18.2";"90";"90";"85";"5";"0";"457093";"373809"
"V4mis1";"SILVA (only NR);Bacteria;Aquificota;Aquificae;Aquificales;Aquificaceae;Aquifex;";"100.0";"18.2";"3";"3";"3";"0";"0";"457180";"373891"
"V4mis1";"SILVA (only NR);Bacteria;Aquificota;Aquificae;Aquificales;Aquificaceae;Hydrogenivirga;";"100.0";"18.2";"4";"4";"4";"0";"0";"457179";"373890"
"V4mis1";"SILVA (only NR);Bacteria;Aquificota;Aquificae;Aquificales;Aquificaceae;Hydrogenobacter;";"90.0";"18.2";"30";"30";"27";"3";"0";"457153";"373867"
"V4mis1";"SILVA (only NR);Bacteria;Aquificota;Aquificae;Aquificales;Aquificaceae;Thermocrinis;";"95.8";"18.2";"48";"48";"46";"2";"0";"457135";"373848"
"V4mis1";"SILVA (only NR);Bacteria;Aquificota;Aquificae;Aquificales;Aquificaceae;uncultured;";"100.0";"18.2";"2";"2";"2";"0";"0";"457181";"373892"
"V4mis1";"SILVA (only NR);Bacteria;Aquificota;Aquificae;Aquificales;Hydrogenobaculaceae;";"95.0";"18.2";"40";"40";"38";"2";"0";"457143";"373856"
"V4mis1";"SILVA (only NR);Bacteria;Aquificota;Aquificae;Aquificales;Hydrogenobaculaceae;Hydrogenobaculum;";"95.0";"18.2";"40";"40";"38";"2";"0";"457143";"373856"
"V4mis1";"SILVA (only NR);Bacteria;Aquificota;Aquificae;Hydrogenothermales;";"92.7";"18.2";"96";"96";"89";"7";"0";"457087";"373805"
"V4mis1";"SILVA (only NR);Bacteria;Aquificota;Aquificae;Hydrogenothermales;Hydrogenothermaceae;";"92.7";"18.2";"96";"96";"89";"7";"0";"457087";"373805"
"V4mis1";"SILVA (only NR);Bacteria;Aquificota;Aquificae;Hydrogenothermales;Hydrogenothermaceae;Hydrogenothermus;";"85.7";"18.2";"7";"7";"6";"1";"0";"457176";"373888"
"V4mis1";"SILVA (only NR);Bacteria;Aquificota;Aquificae;Hydrogenothermales;Hydrogenothermaceae;Persephonella;";"93.8";"18.2";"16";"16";"15";"1";"0";"457167";"373879"
"V4mis1";"SILVA (only NR);Bacteria;Aquificota;Aquificae;Hydrogenothermales;Hydrogenothermaceae;Sulfurihydrogenibium;";"90.7";"18.2";"54";"54";"49";"5";"0";"457129";"373845"
"V4mis1";"SILVA (only NR);Bacteria;Aquificota;Aquificae;Hydrogenothermales;Hydrogenothermaceae;Venenivibrio;";"100.0";"18.2";"9";"9";"9";"0";"0";"457174";"373885"
"V4mis1";"SILVA (only NR);Bacteria;Aquificota;Aquificae;Hydrogenothermales;Hydrogenothermaceae;uncultured;";"100.0";"18.2";"7";"7";"7";"0";"0";"457176";"373887"
"V4mis1";"SILVA (only NR);Bacteria;Aquificota;Desulfurobacteriia;";"96.3";"18.2";"27";"27";"26";"1";"0";"457156";"373868"
"V4mis1";"SILVA (only NR);Bacteria;Aquificota;Desulfurobacteriia;Desulfurobacteriales;";"96.3";"18.2";"27";"27";"26";"1";"0";"457156";"373868"
"V4mis1";"SILVA (only NR);Bacteria;Aquificota;Desulfurobacteriia;Desulfurobacteriales;Desulfurobacteriaceae;";"96.3";"18.2";"27";"27";"26";"1";"0";"457156";"373868"
"V4mis1";"SILVA (only NR);Bacteria;Aquificota;Desulfurobacteriia;Desulfurobacteriales;Desulfurobacteriaceae;Balnearium;";"100.0";"18.2";"2";"2";"2";"0";"0";"457181";"373892"
"V4mis1";"SILVA (only NR);Bacteria;Aquificota;Desulfurobacteriia;Desulfurobacteriales;Desulfurobacteriaceae;Desulfurobacterium;";"94.4";"18.2";"18";"18";"17";"1";"0";"457165";"373877"
"V4mis1";"SILVA (only NR);Bacteria;Aquificota;Desulfurobacteriia;Desulfurobacteriales;Desulfurobacteriaceae;Phorcysia;";"100.0";"18.2";"1";"1";"1";"0";"0";"457182";"373893"
"V4mis1";"SILVA (only NR);Bacteria;Aquificota;Desulfurobacteriia;Desulfurobacteriales;Desulfurobacteriaceae;Thermovibrio;";"100.0";"18.2";"5";"5";"5";"0";"0";"457178";"373889"
"V4mis1";"SILVA (only NR);Bacteria;Armatimonadota;";"95.5";"18.2";"776";"776";"741";"35";"0";"456407";"373153"
"V4mis1";"SILVA (only NR);Bacteria;Armatimonadota;Armatimonadia;";"95.5";"18.2";"156";"156";"149";"7";"0";"457027";"373745"
"V4mis1";"SILVA (only NR);Bacteria;Armatimonadota;Armatimonadia;Armatimonadales;";"95.5";"18.2";"156";"156";"149";"7";"0";"457027";"373745"
"V4mis1";"SILVA (only NR);Bacteria;Armatimonadota;Armatimonadia;Armatimonadales;Armatimonadaceae;";"91.7";"18.2";"12";"12";"11";"1";"0";"457171";"373883"
"V4mis1";"SILVA (only NR);Bacteria;Armatimonadota;Armatimonadia;Armatimonadales;Armatimonadaceae;Armatimonas;";"91.7";"18.2";"12";"12";"11";"1";"0";"457171";"373883"
"V4mis1";"SILVA (only NR);Bacteria;Armatimonadota;Chthonomonadetes;";"97.7";"18.2";"88";"88";"86";"2";"0";"457095";"373808"
"V4mis1";"SILVA (only NR);Bacteria;Armatimonadota;Chthonomonadetes;Chthonomonadales;";"97.7";"18.2";"88";"88";"86";"2";"0";"457095";"373808"
"V4mis1";"SILVA (only NR);Bacteria;Armatimonadota;Chthonomonadetes;Chthonomonadales;Chthonomonadaceae;";"100.0";"18.2";"34";"34";"34";"0";"0";"457149";"373860"
"V4mis1";"SILVA (only NR);Bacteria;Armatimonadota;Chthonomonadetes;Chthonomonadales;Chthonomonadaceae;Chthonomonas;";"100.0";"18.2";"34";"34";"34";"0";"0";"457149";"373860"
"V4mis1";"SILVA (only NR);Bacteria;Armatimonadota;DG-56;";"95.2";"18.2";"21";"21";"20";"1";"0";"457162";"373874"
"V4mis1";"SILVA (only NR);Bacteria;Armatimonadota;Fimbriimonadia;";"96.8";"18.2";"220";"220";"213";"7";"0";"456963";"373681"
"V4mis1";"SILVA (only NR);Bacteria;Armatimonadota;Fimbriimonadia;Fimbriimonadales;";"96.8";"18.2";"220";"220";"213";"7";"0";"456963";"373681"
"V4mis1";"SILVA (only NR);Bacteria;Armatimonadota;Fimbriimonadia;Fimbriimonadales;Fimbriimonadaceae;";"97.7";"18.2";"172";"172";"168";"4";"0";"457011";"373726"
"V4mis1";"SILVA (only NR);Bacteria;Armatimonadota;Fimbriimonadia;Fimbriimonadales;Fimbriimonadaceae;Fimbriimonas;";"100.0";"18.2";"7";"7";"7";"0";"0";"457176";"373887"
"V4mis1";"SILVA (only NR);Bacteria;Armatimonadota;uncultured;";"93.8";"18.2";"291";"291";"273";"18";"0";"456892";"373621"
"V4mis1";"SILVA (only NR);Bacteria;BHI80-139;";"92.7";"18.2";"41";"41";"38";"3";"0";"457142";"373856"
"V4mis1";"SILVA (only NR);Bacteria;Bacteroidota;";"94.7";"19.7";"45751";"45751";"43315";"2436";"0";"411432";"330579"
"V4mis1";"SILVA (only NR);Bacteria;Bacteroidota;Bacteroidia;";"94.7";"19.5";"42694";"42694";"40415";"2279";"0";"414489";"333479"
"V4mis1";"SILVA (only NR);Bacteria;Bacteroidota;Bacteroidia;Bacteroidales;";"93.9";"18.8";"21842";"21842";"20504";"1338";"0";"435341";"353390"
"V4mis1";"SILVA (only NR);Bacteria;Bacteroidota;Bacteroidia;Bacteroidales;009E01-B-SD-P15;";"100.0";"18.2";"9";"9";"9";"0";"0";"457174";"373885"
"V4mis1";"SILVA (only NR);Bacteria;Bacteroidota;Bacteroidia;Bacteroidales;3M1PL1-52 termite group;";"100.0";"18.2";"13";"13";"13";"0";"0";"457170";"373881"
"V4mis1";"SILVA (only NR);Bacteria;Bacteroidota;Bacteroidia;Bacteroidales;Bacteroidaceae;";"93.4";"18.3";"3631";"3631";"3390";"241";"0";"453552";"370504"
"V4mis1";"SILVA (only NR);Bacteria;Bacteroidota;Bacteroidia;Bacteroidales;Bacteroidaceae;Bacteroides;";"93.4";"18.3";"3631";"3631";"3390";"241";"0";"453552";"370504"
"V4mis1";"SILVA (only NR);Bacteria;Bacteroidota;Bacteroidia;Bacteroidales;Bacteroidales BS11 gut group;";"95.9";"18.2";"97";"97";"93";"4";"0";"457086";"373801"
"V4mis1";"SILVA (only NR);Bacteria;Bacteroidota;Bacteroidia;Bacteroidales;Bacteroidales Incertae Sedis;";"100.0";"18.2";"3";"3";"3";"0";"0";"457180";"373891"
"V4mis1";"SILVA (only NR);Bacteria;Bacteroidota;Bacteroidia;Bacteroidales;Bacteroidales Incertae Sedis;Phocaeicola;";"100.0";"18.2";"3";"3";"3";"0";"0";"457180";"373891"
"V4mis1";"SILVA (only NR);Bacteria;Bacteroidota;Bacteroidia;Bacteroidales;Bacteroidales RF16 group;";"98.4";"18.2";"125";"125";"123";"2";"0";"457058";"373771"
"V4mis1";"SILVA (only NR);Bacteria;Bacteroidota;Bacteroidia;Bacteroidales;Bacteroidales UCG-001;";"98.5";"18.2";"133";"133";"131";"2";"0";"457050";"373763"
"V4mis1";"SILVA (only NR);Bacteria;Bacteroidota;Bacteroidia;Bacteroidales;Bacteroidetes BD2-2;";"93.3";"18.2";"586";"586";"547";"39";"0";"456597";"373347"
"V4mis1";"SILVA (only NR);Bacteria;Bacteroidota;Bacteroidia;Bacteroidales;Bacteroidetes vadinHA17;";"95.5";"18.2";"333";"333";"318";"15";"0";"456850";"373576"
"V4mis1";"SILVA (only NR);Bacteria;Bacteroidota;Bacteroidia;Bacteroidales;Barnesiellaceae;";"95.7";"18.2";"140";"140";"134";"6";"0";"457043";"373760"
"V4mis1";"SILVA (only NR);Bacteria;Bacteroidota;Bacteroidia;Bacteroidales;Barnesiellaceae;Barnesiella;";"94.0";"18.2";"84";"84";"79";"5";"0";"457099";"373815"
"V4mis1";"SILVA (only NR);Bacteria;Bacteroidota;Bacteroidia;Bacteroidales;Barnesiellaceae;Coprobacter;";"100.0";"18.2";"26";"26";"26";"0";"0";"457157";"373868"
"V4mis1";"SILVA (only NR);Bacteria;Bacteroidota;Bacteroidia;Bacteroidales;Barnesiellaceae;uncultured;";"96.7";"18.2";"30";"30";"29";"1";"0";"457153";"373865"
"V4mis1";"SILVA (only NR);Bacteria;Bacteroidota;Bacteroidia;Bacteroidales;CAP-aah99b04;";"80.0";"18.2";"5";"5";"4";"1";"0";"457178";"373890"
"V4mis1";"SILVA (only NR);Bacteria;Bacteroidota;Bacteroidia;Bacteroidales;COB P4-1 termite group;";"100.0";"18.2";"11";"11";"11";"0";"0";"457172";"373883"
"V4mis1";"SILVA (only NR);Bacteria;Bacteroidota;Bacteroidia;Bacteroidales;CR-115;";"100.0";"18.2";"4";"4";"4";"0";"0";"457179";"373890"
"V4mis1";"SILVA (only NR);Bacteria;Bacteroidota;Bacteroidia;Bacteroidales;Dysgonomonadaceae;";"95.5";"18.2";"876";"876";"837";"39";"0";"456307";"373057"
"V4mis1";"SILVA (only NR);Bacteria;Bacteroidota;Bacteroidia;Bacteroidales;Dysgonomonadaceae;Candidatus Armantifilum;";"100.0";"18.2";"44";"44";"44";"0";"0";"457139";"373850"
"V4mis1";"SILVA (only NR);Bacteria;Bacteroidota;Bacteroidia;Bacteroidales;Dysgonomonadaceae;Candidatus Azobacteroides;";"100.0";"18.2";"23";"23";"23";"0";"0";"457160";"373871"
"V4mis1";"SILVA (only NR);Bacteria;Bacteroidota;Bacteroidia;Bacteroidales;Dysgonomonadaceae;Candidatus Symbiothrix;";"98.7";"18.2";"75";"75";"74";"1";"0";"457108";"373820"
"V4mis1";"SILVA (only NR);Bacteria;Bacteroidota;Bacteroidia;Bacteroidales;Dysgonomonadaceae;Dysgonomonas;";"95.0";"18.2";"159";"159";"151";"8";"0";"457024";"373743"
"V4mis1";"SILVA (only NR);Bacteria;Bacteroidota;Bacteroidia;Bacteroidales;Dysgonomonadaceae;Fermentimonas;";"94.9";"18.2";"136";"136";"129";"7";"0";"457047";"373765"
"V4mis1";"SILVA (only NR);Bacteria;Bacteroidota;Bacteroidia;Bacteroidales;Dysgonomonadaceae;Petrimonas;";"95.7";"18.2";"47";"47";"45";"2";"0";"457136";"373849"
"V4mis1";"SILVA (only NR);Bacteria;Bacteroidota;Bacteroidia;Bacteroidales;Dysgonomonadaceae;Proteiniphilum;";"93.8";"18.2";"275";"275";"258";"17";"0";"456908";"373636"
"V4mis1";"SILVA (only NR);Bacteria;Bacteroidota;Bacteroidia;Bacteroidales;Dysgonomonadaceae;uncultured;";"96.4";"18.2";"110";"110";"106";"4";"0";"457073";"373788"
"V4mis1";"SILVA (only NR);Bacteria;Bacteroidota;Bacteroidia;Bacteroidales;F082;";"94.3";"18.2";"366";"366";"345";"21";"0";"456817";"373549"
"V4mis1";"SILVA (only NR);Bacteria;Bacteroidota;Bacteroidia;Bacteroidales;FTLpost3;";"88.9";"18.2";"9";"9";"8";"1";"0";"457174";"373886"
"V4mis1";"SILVA (only NR);Bacteria;Bacteroidota;Bacteroidia;Bacteroidales;GZKB124;";"100.0";"18.2";"5";"5";"5";"0";"0";"457178";"373889"
"V4mis1";"SILVA (only NR);Bacteria;Bacteroidota;Bacteroidia;Bacteroidales;HAW-RM37-2;";"100.0";"18.2";"2";"2";"2";"0";"0";"457181";"373892"
"V4mis1";"SILVA (only NR);Bacteria;Bacteroidota;Bacteroidia;Bacteroidales;Ika33;";"100.0";"18.2";"7";"7";"7";"0";"0";"457176";"373887"
"V4mis1";"SILVA (only NR);Bacteria;Bacteroidota;Bacteroidia;Bacteroidales;LKC2.127-25;";"100.0";"18.2";"7";"7";"7";"0";"0";"457176";"373887"
"V4mis1";"SILVA (only NR);Bacteria;Bacteroidota;Bacteroidia;Bacteroidales;M2PB4-65 termite group;";"93.2";"18.2";"44";"44";"41";"3";"0";"457139";"373853"
"V4mis1";"SILVA (only NR);Bacteria;Bacteroidota;Bacteroidia;Bacteroidales;ML635J-40 aquatic group;";"90.0";"18.2";"120";"120";"108";"12";"0";"457063";"373786"
"V4mis1";"SILVA (only NR);Bacteria;Bacteroidota;Bacteroidia;Bacteroidales;Marinifilaceae;";"93.6";"18.2";"472";"472";"442";"30";"0";"456711";"373452"
"V4mis1";"SILVA (only NR);Bacteria;Bacteroidota;Bacteroidia;Bacteroidales;Marinifilaceae;Butyricimonas;";"96.4";"18.2";"56";"56";"54";"2";"0";"457127";"373840"
"V4mis1";"SILVA (only NR);Bacteria;Bacteroidota;Bacteroidia;Bacteroidales;Marinifilaceae;Marinifilum;";"93.3";"18.2";"224";"224";"209";"15";"0";"456959";"373685"
"V4mis1";"SILVA (only NR);Bacteria;Bacteroidota;Bacteroidia;Bacteroidales;Marinifilaceae;Odoribacter;";"89.2";"18.2";"102";"102";"91";"11";"0";"457081";"373803"
"V4mis1";"SILVA (only NR);Bacteria;Bacteroidota;Bacteroidia;Bacteroidales;Marinifilaceae;Sanguibacteroides;";"100.0";"18.2";"8";"8";"8";"0";"0";"457175";"373886"
"V4mis1";"SILVA (only NR);Bacteria;Bacteroidota;Bacteroidia;Bacteroidales;Marinifilaceae;uncultured;";"97.6";"18.2";"82";"82";"80";"2";"0";"457101";"373814"
"V4mis1";"SILVA (only NR);Bacteria;Bacteroidota;Bacteroidia;Bacteroidales;Marinilabiliaceae;";"92.8";"18.2";"611";"611";"567";"44";"0";"456572";"373327"
"V4mis1";"SILVA (only NR);Bacteria;Bacteroidota;Bacteroidia;Bacteroidales;Marinilabiliaceae;Alkaliflexus;";"88.2";"18.2";"17";"17";"15";"2";"0";"457166";"373879"
"V4mis1";"SILVA (only NR);Bacteria;Bacteroidota;Bacteroidia;Bacteroidales;Marinilabiliaceae;Alkalitalea;";"100.0";"18.2";"3";"3";"3";"0";"0";"457180";"373891"
"V4mis1";"SILVA (only NR);Bacteria;Bacteroidota;Bacteroidia;Bacteroidales;Marinilabiliaceae;Anaerophaga;";"95.8";"18.2";"24";"24";"23";"1";"0";"457159";"373871"
"V4mis1";"SILVA (only NR);Bacteria;Bacteroidota;Bacteroidia;Bacteroidales;Marinilabiliaceae;Carboxylicivirga;";"96.1";"18.2";"51";"51";"49";"2";"0";"457132";"373845"
"V4mis1";"SILVA (only NR);Bacteria;Bacteroidota;Bacteroidia;Bacteroidales;Marinilabiliaceae;Geofilum;";"100.0";"18.2";"1";"1";"1";"0";"0";"457182";"373893"
"V4mis1";"SILVA (only NR);Bacteria;Bacteroidota;Bacteroidia;Bacteroidales;Marinilabiliaceae;Labilibacter;";"100.0";"18.2";"14";"14";"14";"0";"0";"457169";"373880"
"V4mis1";"SILVA (only NR);Bacteria;Bacteroidota;Bacteroidia;Bacteroidales;Marinilabiliaceae;Mangroviflexus;";"81.8";"18.2";"11";"11";"9";"2";"0";"457172";"373885"
"V4mis1";"SILVA (only NR);Bacteria;Bacteroidota;Bacteroidia;Bacteroidales;Marinilabiliaceae;Marinilabilia;";"87.5";"18.2";"8";"8";"7";"1";"0";"457175";"373887"
"V4mis1";"SILVA (only NR);Bacteria;Bacteroidota;Bacteroidia;Bacteroidales;Marinilabiliaceae;Natronoflexus;";"100.0";"18.2";"1";"1";"1";"0";"0";"457182";"373893"
"V4mis1";"SILVA (only NR);Bacteria;Bacteroidota;Bacteroidia;Bacteroidales;Marinilabiliaceae;Ruminofilibacter;";"100.0";"18.2";"8";"8";"8";"0";"0";"457175";"373886"
"V4mis1";"SILVA (only NR);Bacteria;Bacteroidota;Bacteroidia;Bacteroidales;Marinilabiliaceae;Saccharicrinis;";"60.0";"18.2";"5";"5";"3";"2";"0";"457178";"373891"
"V4mis1";"SILVA (only NR);Bacteria;Bacteroidota;Bacteroidia;Bacteroidales;Marinilabiliaceae;Thermophagus;";"100.0";"18.2";"1";"1";"1";"0";"0";"457182";"373893"
"V4mis1";"SILVA (only NR);Bacteria;Bacteroidota;Bacteroidia;Bacteroidales;Marinilabiliaceae;[Cytophaga] xylanolytica group;";"100.0";"18.2";"14";"14";"14";"0";"0";"457169";"373880"
"V4mis1";"SILVA (only NR);Bacteria;Bacteroidota;Bacteroidia;Bacteroidales;Marinilabiliaceae;uncultured;";"92.7";"18.2";"449";"449";"416";"33";"0";"456734";"373478"
"V4mis1";"SILVA (only NR);Bacteria;Bacteroidota;Bacteroidia;Bacteroidales;MgMjR-022;";"100.0";"18.2";"7";"7";"7";"0";"0";"457176";"373887"
"V4mis1";"SILVA (only NR);Bacteria;Bacteroidota;Bacteroidia;Bacteroidales;Muribaculaceae;";"91.9";"18.3";"2753";"2753";"2529";"224";"0";"454430";"371365"
"V4mis1";"SILVA (only NR);Bacteria;Bacteroidota;Bacteroidia;Bacteroidales;Muribaculaceae;CAG-873;";"100.0";"18.2";"8";"8";"8";"0";"0";"457175";"373886"
"V4mis1";"SILVA (only NR);Bacteria;Bacteroidota;Bacteroidia;Bacteroidales;Muribaculaceae;Muribaculum;";"100.0";"18.2";"25";"25";"25";"0";"0";"457158";"373869"
"V4mis1";"SILVA (only NR);Bacteria;Bacteroidota;Bacteroidia;Bacteroidales;Paludibacteraceae;";"97.4";"18.2";"391";"391";"381";"10";"0";"456792";"373513"
"V4mis1";"SILVA (only NR);Bacteria;Bacteroidota;Bacteroidia;Bacteroidales;Paludibacteraceae;F0058;";"95.7";"18.2";"47";"47";"45";"2";"0";"457136";"373849"
"V4mis1";"SILVA (only NR);Bacteria;Bacteroidota;Bacteroidia;Bacteroidales;Paludibacteraceae;H1;";"100.0";"18.2";"13";"13";"13";"0";"0";"457170";"373881"
"V4mis1";"SILVA (only NR);Bacteria;Bacteroidota;Bacteroidia;Bacteroidales;Paludibacteraceae;Microbacter;";"90.0";"18.2";"10";"10";"9";"1";"0";"457173";"373885"
"V4mis1";"SILVA (only NR);Bacteria;Bacteroidota;Bacteroidia;Bacteroidales;Paludibacteraceae;Paludibacter;";"98.7";"18.2";"151";"151";"149";"2";"0";"457032";"373745"
"V4mis1";"SILVA (only NR);Bacteria;Bacteroidota;Bacteroidia;Bacteroidales;Paludibacteraceae;uncultured;";"97.1";"18.2";"170";"170";"165";"5";"0";"457013";"373729"
"V4mis1";"SILVA (only NR);Bacteria;Bacteroidota;Bacteroidia;Bacteroidales;PeH15;";"100.0";"18.2";"14";"14";"14";"0";"0";"457169";"373880"
"V4mis1";"SILVA (only NR);Bacteria;Bacteroidota;Bacteroidia;Bacteroidales;Porphyromonadaceae;";"93.0";"18.2";"647";"647";"602";"45";"0";"456536";"373292"
"V4mis1";"SILVA (only NR);Bacteria;Bacteroidota;Bacteroidia;Bacteroidales;Porphyromonadaceae;Falsiporphyromonas;";"100.0";"18.2";"1";"1";"1";"0";"0";"457182";"373893"
"V4mis1";"SILVA (only NR);Bacteria;Bacteroidota;Bacteroidia;Bacteroidales;Porphyromonadaceae;Porphyromonas;";"93.2";"18.2";"644";"644";"600";"44";"0";"456539";"373294"
"V4mis1";"SILVA (only NR);Bacteria;Bacteroidota;Bacteroidia;Bacteroidales;Prevotellaceae;";"94.1";"18.4";"5074";"5074";"4776";"298";"0";"452109";"369118"
"V4mis1";"SILVA (only NR);Bacteria;Bacteroidota;Bacteroidia;Bacteroidales;Prevotellaceae;Alloprevotella;";"91.0";"18.2";"435";"435";"396";"39";"0";"456748";"373498"
"V4mis1";"SILVA (only NR);Bacteria;Bacteroidota;Bacteroidia;Bacteroidales;Prevotellaceae;Paraprevotella;";"93.0";"18.2";"43";"43";"40";"3";"0";"457140";"373854"
"V4mis1";"SILVA (only NR);Bacteria;Bacteroidota;Bacteroidia;Bacteroidales;Prevotellaceae;Prevotella;";"95.1";"18.3";"2164";"2164";"2057";"107";"0";"455019";"371837"
"V4mis1";"SILVA (only NR);Bacteria;Bacteroidota;Bacteroidia;Bacteroidales;Prevotellaceae;Prevotella_7;";"92.3";"18.2";"535";"535";"494";"41";"0";"456648";"373400"
"V4mis1";"SILVA (only NR);Bacteria;Bacteroidota;Bacteroidia;Bacteroidales;Prevotellaceae;Prevotella_9;";"94.5";"18.2";"1041";"1041";"984";"57";"0";"456142";"372910"
"V4mis1";"SILVA (only NR);Bacteria;Bacteroidota;Bacteroidia;Bacteroidales;Prevotellaceae;Prevotellaceae Ga6A1 group;";"100.0";"18.2";"21";"21";"21";"0";"0";"457162";"373873"
"V4mis1";"SILVA (only NR);Bacteria;Bacteroidota;Bacteroidia;Bacteroidales;Prevotellaceae;Prevotellaceae NK3B31 group;";"95.7";"18.2";"115";"115";"110";"5";"0";"457068";"373784"
"V4mis1";"SILVA (only NR);Bacteria;Bacteroidota;Bacteroidia;Bacteroidales;Prevotellaceae;Prevotellaceae UCG-001;";"91.6";"18.2";"321";"321";"294";"27";"0";"456862";"373600"
"V4mis1";"SILVA (only NR);Bacteria;Bacteroidota;Bacteroidia;Bacteroidales;Prevotellaceae;Prevotellaceae UCG-003;";"97.5";"18.2";"158";"158";"154";"4";"0";"457025";"373740"
"V4mis1";"SILVA (only NR);Bacteria;Bacteroidota;Bacteroidia;Bacteroidales;Prevotellaceae;Prevotellaceae UCG-004;";"96.0";"18.2";"100";"100";"96";"4";"0";"457083";"373798"
"V4mis1";"SILVA (only NR);Bacteria;Bacteroidota;Bacteroidia;Bacteroidales;Prevotellaceae;Prevotellaceae YAB2003 group;";"77.8";"18.2";"9";"9";"7";"2";"0";"457174";"373887"
"V4mis1";"SILVA (only NR);Bacteria;Bacteroidota;Bacteroidia;Bacteroidales;Prevotellaceae;uncultured;";"93.0";"18.2";"129";"129";"120";"9";"0";"457054";"373774"
"V4mis1";"SILVA (only NR);Bacteria;Bacteroidota;Bacteroidia;Bacteroidales;Prolixibacteraceae;";"95.9";"18.2";"755";"755";"724";"31";"0";"456428";"373170"
"V4mis1";"SILVA (only NR);Bacteria;Bacteroidota;Bacteroidia;Bacteroidales;Prolixibacteraceae;BSV13;";"95.3";"18.2";"86";"86";"82";"4";"0";"457097";"373812"
"V4mis1";"SILVA (only NR);Bacteria;Bacteroidota;Bacteroidia;Bacteroidales;Prolixibacteraceae;Draconibacterium;";"92.6";"18.2";"54";"54";"50";"4";"0";"457129";"373844"
"V4mis1";"SILVA (only NR);Bacteria;Bacteroidota;Bacteroidia;Bacteroidales;Prolixibacteraceae;Mangrovibacterium;";"100.0";"18.2";"4";"4";"4";"0";"0";"457179";"373890"
"V4mis1";"SILVA (only NR);Bacteria;Bacteroidota;Bacteroidia;Bacteroidales;Prolixibacteraceae;Mariniphaga;";"100.0";"18.2";"7";"7";"7";"0";"0";"457176";"373887"
"V4mis1";"SILVA (only NR);Bacteria;Bacteroidota;Bacteroidia;Bacteroidales;Prolixibacteraceae;Meniscus;";"88.2";"18.2";"17";"17";"15";"2";"0";"457166";"373879"
"V4mis1";"SILVA (only NR);Bacteria;Bacteroidota;Bacteroidia;Bacteroidales;Prolixibacteraceae;Prolixibacter;";"92.9";"18.2";"14";"14";"13";"1";"0";"457169";"373881"
"V4mis1";"SILVA (only NR);Bacteria;Bacteroidota;Bacteroidia;Bacteroidales;Prolixibacteraceae;Roseimarinus;";"95.1";"18.2";"81";"81";"77";"4";"0";"457102";"373817"
"V4mis1";"SILVA (only NR);Bacteria;Bacteroidota;Bacteroidia;Bacteroidales;Prolixibacteraceae;Sunxiuqinia;";"93.3";"18.2";"15";"15";"14";"1";"0";"457168";"373880"
"V4mis1";"SILVA (only NR);Bacteria;Bacteroidota;Bacteroidia;Bacteroidales;Prolixibacteraceae;Tangfeifania;";"81.5";"18.2";"27";"27";"22";"5";"0";"457156";"373872"
"V4mis1";"SILVA (only NR);Bacteria;Bacteroidota;Bacteroidia;Bacteroidales;Prolixibacteraceae;WCHB1-32;";"98.3";"18.2";"176";"176";"173";"3";"0";"457007";"373721"
"V4mis1";"SILVA (only NR);Bacteria;Bacteroidota;Bacteroidia;Bacteroidales;Prolixibacteraceae;uncultured;";"97.3";"18.2";"264";"264";"257";"7";"0";"456919";"373637"
"V4mis1";"SILVA (only NR);Bacteria;Bacteroidota;Bacteroidia;Bacteroidales;RH-aaj90h05;";"100.0";"18.2";"3";"3";"3";"0";"0";"457180";"373891"
"V4mis1";"SILVA (only NR);Bacteria;Bacteroidota;Bacteroidia;Bacteroidales;Rikenellaceae;";"94.5";"18.3";"2859";"2859";"2701";"158";"0";"454324";"371193"
"V4mis1";"SILVA (only NR);Bacteria;Bacteroidota;Bacteroidia;Bacteroidales;Rikenellaceae;Alistipes;";"92.6";"18.2";"554";"554";"513";"41";"0";"456629";"373381"
"V4mis1";"SILVA (only NR);Bacteria;Bacteroidota;Bacteroidia;Bacteroidales;Rikenellaceae;Anaerocella;";"89.5";"18.2";"19";"19";"17";"2";"0";"457164";"373877"
"V4mis1";"SILVA (only NR);Bacteria;Bacteroidota;Bacteroidia;Bacteroidales;Rikenellaceae;Bact-08;";"83.3";"18.2";"6";"6";"5";"1";"0";"457177";"373889"
"V4mis1";"SILVA (only NR);Bacteria;Bacteroidota;Bacteroidia;Bacteroidales;Rikenellaceae;DMER64;";"96.7";"18.2";"152";"152";"147";"5";"0";"457031";"373747"
"V4mis1";"SILVA (only NR);Bacteria;Bacteroidota;Bacteroidia;Bacteroidales;Rikenellaceae;M2PB4-61 termite group;";"86.4";"18.2";"22";"22";"19";"3";"0";"457161";"373875"
"V4mis1";"SILVA (only NR);Bacteria;Bacteroidota;Bacteroidia;Bacteroidales;Rikenellaceae;Mucinivorans;";"75.0";"18.2";"4";"4";"3";"1";"0";"457179";"373891"
"V4mis1";"SILVA (only NR);Bacteria;Bacteroidota;Bacteroidia;Bacteroidales;Rikenellaceae;Rikenella;";"100.0";"18.2";"39";"39";"39";"0";"0";"457144";"373855"
"V4mis1";"SILVA (only NR);Bacteria;Bacteroidota;Bacteroidia;Bacteroidales;Rikenellaceae;Rikenellaceae RC9 gut group;";"95.1";"18.3";"1613";"1613";"1534";"79";"0";"455570";"372360"
"V4mis1";"SILVA (only NR);Bacteria;Bacteroidota;Bacteroidia;Bacteroidales;Rikenellaceae;S50 wastewater-sludge group;";"100.0";"18.2";"5";"5";"5";"0";"0";"457178";"373889"
"V4mis1";"SILVA (only NR);Bacteria;Bacteroidota;Bacteroidia;Bacteroidales;Rikenellaceae;SP3-e08;";"100.0";"18.2";"19";"19";"19";"0";"0";"457164";"373875"
"V4mis1";"SILVA (only NR);Bacteria;Bacteroidota;Bacteroidia;Bacteroidales;Rikenellaceae;U29-B03;";"94.7";"18.2";"19";"19";"18";"1";"0";"457164";"373876"
"V4mis1";"SILVA (only NR);Bacteria;Bacteroidota;Bacteroidia;Bacteroidales;Rikenellaceae;dgA-11 gut group;";"91.1";"18.2";"45";"45";"41";"4";"0";"457138";"373853"
"V4mis1";"SILVA (only NR);Bacteria;Bacteroidota;Bacteroidia;Bacteroidales;Rikenellaceae;hoa5-07d05 gut group;";"100.0";"18.2";"12";"12";"12";"0";"0";"457171";"373882"
"V4mis1";"SILVA (only NR);Bacteria;Bacteroidota;Bacteroidia;Bacteroidales;Rikenellaceae;uncultured;";"93.9";"18.2";"343";"343";"322";"21";"0";"456840";"373572"
"V4mis1";"SILVA (only NR);Bacteria;Bacteroidota;Bacteroidia;Bacteroidales;Rs-E47 termite group;";"99.0";"18.2";"99";"99";"98";"1";"0";"457084";"373796"
"V4mis1";"SILVA (only NR);Bacteria;Bacteroidota;Bacteroidia;Bacteroidales;Rs-E47 termite group;GWE2-42-42;";"98.8";"18.2";"81";"81";"80";"1";"0";"457102";"373814"
"V4mis1";"SILVA (only NR);Bacteria;Bacteroidota;Bacteroidia;Bacteroidales;SB-5;";"92.4";"18.2";"383";"383";"354";"29";"0";"456800";"373540"
"V4mis1";"SILVA (only NR);Bacteria;Bacteroidota;Bacteroidia;Bacteroidales;Salinivirgaceae;";"87.2";"18.2";"179";"179";"156";"23";"0";"457004";"373738"
"V4mis1";"SILVA (only NR);Bacteria;Bacteroidota;Bacteroidia;Bacteroidales;Salinivirgaceae;Salinivirga;";"82.7";"18.2";"52";"52";"43";"9";"0";"457131";"373851"
"V4mis1";"SILVA (only NR);Bacteria;Bacteroidota;Bacteroidia;Bacteroidales;Salinivirgaceae;uncultured;";"89.0";"18.2";"127";"127";"113";"14";"0";"457056";"373781"
"V4mis1";"SILVA (only NR);Bacteria;Bacteroidota;Bacteroidia;Bacteroidales;Tannerellaceae;";"93.8";"18.2";"659";"659";"618";"41";"0";"456524";"373276"
"V4mis1";"SILVA (only NR);Bacteria;Bacteroidota;Bacteroidia;Bacteroidales;Tannerellaceae;Candidatus Vestibaculum;";"97.1";"18.2";"34";"34";"33";"1";"0";"457149";"373861"
"V4mis1";"SILVA (only NR);Bacteria;Bacteroidota;Bacteroidia;Bacteroidales;Tannerellaceae;Macellibacteroides;";"87.1";"18.2";"62";"62";"54";"8";"0";"457121";"373840"
"V4mis1";"SILVA (only NR);Bacteria;Bacteroidota;Bacteroidia;Bacteroidales;Tannerellaceae;Parabacteroides;";"93.9";"18.2";"460";"460";"432";"28";"0";"456723";"373462"
"V4mis1";"SILVA (only NR);Bacteria;Bacteroidota;Bacteroidia;Bacteroidales;Tannerellaceae;Tannerella;";"94.9";"18.2";"78";"78";"74";"4";"0";"457105";"373820"
"V4mis1";"SILVA (only NR);Bacteria;Bacteroidota;Bacteroidia;Bacteroidales;Tannerellaceae;uncultured;";"100.0";"18.2";"21";"21";"21";"0";"0";"457162";"373873"
"V4mis1";"SILVA (only NR);Bacteria;Bacteroidota;Bacteroidia;Bacteroidales;Williamwhitmaniaceae;";"94.1";"18.2";"152";"152";"143";"9";"0";"457031";"373751"
"V4mis1";"SILVA (only NR);Bacteria;Bacteroidota;Bacteroidia;Bacteroidales;Williamwhitmaniaceae;Acetobacteroides;";"92.9";"18.2";"14";"14";"13";"1";"0";"457169";"373881"
"V4mis1";"SILVA (only NR);Bacteria;Bacteroidota;Bacteroidia;Bacteroidales;Williamwhitmaniaceae;BCf9-17 termite group;";"100.0";"18.2";"26";"26";"26";"0";"0";"457157";"373868"
"V4mis1";"SILVA (only NR);Bacteria;Bacteroidota;Bacteroidia;Bacteroidales;Williamwhitmaniaceae;Blvii28 wastewater-sludge group;";"89.3";"18.2";"75";"75";"67";"8";"0";"457108";"373827"
"V4mis1";"SILVA (only NR);Bacteria;Bacteroidota;Bacteroidia;Bacteroidales;Williamwhitmaniaceae;Rs-D38 termite group;";"100.0";"18.2";"22";"22";"22";"0";"0";"457161";"373872"
"V4mis1";"SILVA (only NR);Bacteria;Bacteroidota;Bacteroidia;Bacteroidales;Williamwhitmaniaceae;Williamwhitmania;";"100.0";"18.2";"6";"6";"6";"0";"0";"457177";"373888"
"V4mis1";"SILVA (only NR);Bacteria;Bacteroidota;Bacteroidia;Bacteroidales;Williamwhitmaniaceae;uncultured;";"100.0";"18.2";"8";"8";"8";"0";"0";"457175";"373886"
"V4mis1";"SILVA (only NR);Bacteria;Bacteroidota;Bacteroidia;Bacteroidales;gir-aah93h0;";"100.0";"18.2";"6";"6";"6";"0";"0";"457177";"373888"
"V4mis1";"SILVA (only NR);Bacteria;Bacteroidota;Bacteroidia;Bacteroidales;p-251-o5;";"96.4";"18.2";"139";"139";"134";"5";"0";"457044";"373760"
"V4mis1";"SILVA (only NR);Bacteria;Bacteroidota;Bacteroidia;Bacteroidales;p-2534-18B5 gut group;";"100.0";"18.2";"32";"32";"32";"0";"0";"457151";"373862"
"V4mis1";"SILVA (only NR);Bacteria;Bacteroidota;Bacteroidia;Bacteroidales;uncultured;";"97.1";"18.2";"69";"69";"67";"2";"0";"457114";"373827"
"V4mis1";"SILVA (only NR);Bacteria;Bacteroidota;Bacteroidia;Bacteroidales;vadinHA21;";"75.0";"18.2";"8";"8";"6";"2";"0";"457175";"373888"
"V4mis1";"SILVA (only NR);Bacteria;Bacteroidota;Bacteroidia;Bacteroidetes VC2.1 Bac22;";"98.1";"18.2";"214";"214";"210";"4";"0";"456969";"373684"
"V4mis1";"SILVA (only NR);Bacteria;Bacteroidota;Bacteroidia;Chitinophagales;";"95.1";"18.3";"4399";"4399";"4183";"216";"0";"452784";"369711"
"V4mis1";"SILVA (only NR);Bacteria;Bacteroidota;Bacteroidia;Chitinophagales;37-13;";"98.5";"18.2";"66";"66";"65";"1";"0";"457117";"373829"
"V4mis1";"SILVA (only NR);Bacteria;Bacteroidota;Bacteroidia;Chitinophagales;Chitinophagaceae;";"95.8";"18.3";"2544";"2544";"2436";"108";"0";"454639";"371458"
"V4mis1";"SILVA (only NR);Bacteria;Bacteroidota;Bacteroidia;Chitinophagales;Chitinophagaceae;Arachidicoccus;";"88.9";"18.2";"18";"18";"16";"2";"0";"457165";"373878"
"V4mis1";"SILVA (only NR);Bacteria;Bacteroidota;Bacteroidia;Chitinophagales;Chitinophagaceae;Asinibacterium;";"100.0";"18.2";"8";"8";"8";"0";"0";"457175";"373886"
"V4mis1";"SILVA (only NR);Bacteria;Bacteroidota;Bacteroidia;Chitinophagales;Chitinophagaceae;Aurantisolimonas;";"96.7";"18.2";"61";"61";"59";"2";"0";"457122";"373835"
"V4mis1";"SILVA (only NR);Bacteria;Bacteroidota;Bacteroidia;Chitinophagales;Chitinophagaceae;Chitinophaga;";"96.0";"18.2";"175";"175";"168";"7";"0";"457008";"373726"
"V4mis1";"SILVA (only NR);Bacteria;Bacteroidota;Bacteroidia;Chitinophagales;Chitinophagaceae;Cnuella;";"96.9";"18.2";"32";"32";"31";"1";"0";"457151";"373863"
"V4mis1";"SILVA (only NR);Bacteria;Bacteroidota;Bacteroidia;Chitinophagales;Chitinophagaceae;Crenotalea;";"100.0";"18.2";"1";"1";"1";"0";"0";"457182";"373893"
"V4mis1";"SILVA (only NR);Bacteria;Bacteroidota;Bacteroidia;Chitinophagales;Chitinophagaceae;Dinghuibacter;";"100.0";"18.2";"57";"57";"57";"0";"0";"457126";"373837"
"V4mis1";"SILVA (only NR);Bacteria;Bacteroidota;Bacteroidia;Chitinophagales;Chitinophagaceae;Edaphobaculum;";"98.4";"18.2";"189";"189";"186";"3";"0";"456994";"373708"
"V4mis1";"SILVA (only NR);Bacteria;Bacteroidota;Bacteroidia;Chitinophagales;Chitinophagaceae;Ferruginibacter;";"95.5";"18.2";"308";"308";"294";"14";"0";"456875";"373600"
"V4mis1";"SILVA (only NR);Bacteria;Bacteroidota;Bacteroidia;Chitinophagales;Chitinophagaceae;Filimonas;";"95.5";"18.2";"22";"22";"21";"1";"0";"457161";"373873"
"V4mis1";"SILVA (only NR);Bacteria;Bacteroidota;Bacteroidia;Chitinophagales;Chitinophagaceae;Filobacterium;";"100.0";"18.2";"4";"4";"4";"0";"0";"457179";"373890"
"V4mis1";"SILVA (only NR);Bacteria;Bacteroidota;Bacteroidia;Chitinophagales;Chitinophagaceae;Flaviaesturariibacter;";"94.7";"18.2";"19";"19";"18";"1";"0";"457164";"373876"
"V4mis1";"SILVA (only NR);Bacteria;Bacteroidota;Bacteroidia;Chitinophagales;Chitinophagaceae;Flavihumibacter;";"95.8";"18.2";"24";"24";"23";"1";"0";"457159";"373871"
"V4mis1";"SILVA (only NR);Bacteria;Bacteroidota;Bacteroidia;Chitinophagales;Chitinophagaceae;Flavisolibacter;";"97.4";"18.2";"196";"196";"191";"5";"0";"456987";"373703"
"V4mis1";"SILVA (only NR);Bacteria;Bacteroidota;Bacteroidia;Chitinophagales;Chitinophagaceae;Flavitalea;";"91.3";"18.2";"46";"46";"42";"4";"0";"457137";"373852"
"V4mis1";"SILVA (only NR);Bacteria;Bacteroidota;Bacteroidia;Chitinophagales;Chitinophagaceae;Haoranjiania;";"100.0";"18.2";"6";"6";"6";"0";"0";"457177";"373888"
"V4mis1";"SILVA (only NR);Bacteria;Bacteroidota;Bacteroidia;Chitinophagales;Chitinophagaceae;Heliimonas;";"85.7";"18.2";"7";"7";"6";"1";"0";"457176";"373888"
"V4mis1";"SILVA (only NR);Bacteria;Bacteroidota;Bacteroidia;Chitinophagales;Chitinophagaceae;Hydrobacter;";"100.0";"18.2";"2";"2";"2";"0";"0";"457181";"373892"
"V4mis1";"SILVA (only NR);Bacteria;Bacteroidota;Bacteroidia;Chitinophagales;Chitinophagaceae;Hydrotalea;";"87.5";"18.2";"8";"8";"7";"1";"0";"457175";"373887"
"V4mis1";"SILVA (only NR);Bacteria;Bacteroidota;Bacteroidia;Chitinophagales;Chitinophagaceae;Lacibacter;";"100.0";"18.2";"16";"16";"16";"0";"0";"457167";"373878"
"V4mis1";"SILVA (only NR);Bacteria;Bacteroidota;Bacteroidia;Chitinophagales;Chitinophagaceae;Niabella;";"91.7";"18.2";"60";"60";"55";"5";"0";"457123";"373839"
"V4mis1";"SILVA (only NR);Bacteria;Bacteroidota;Bacteroidia;Chitinophagales;Chitinophagaceae;Niastella;";"96.5";"18.2";"57";"57";"55";"2";"0";"457126";"373839"
"V4mis1";"SILVA (only NR);Bacteria;Bacteroidota;Bacteroidia;Chitinophagales;Chitinophagaceae;Niveitalea;";"100.0";"18.2";"1";"1";"1";"0";"0";"457182";"373893"
"V4mis1";"SILVA (only NR);Bacteria;Bacteroidota;Bacteroidia;Chitinophagales;Chitinophagaceae;Parafilimonas;";"95.0";"18.2";"20";"20";"19";"1";"0";"457163";"373875"
"V4mis1";"SILVA (only NR);Bacteria;Bacteroidota;Bacteroidia;Chitinophagales;Chitinophagaceae;Parasediminibacterium;";"100.0";"18.2";"11";"11";"11";"0";"0";"457172";"373883"
"V4mis1";"SILVA (only NR);Bacteria;Bacteroidota;Bacteroidia;Chitinophagales;Chitinophagaceae;Parasegetibacter;";"94.1";"18.2";"17";"17";"16";"1";"0";"457166";"373878"
"V4mis1";"SILVA (only NR);Bacteria;Bacteroidota;Bacteroidia;Chitinophagales;Chitinophagaceae;Pseudoflavitalea;";"100.0";"18.2";"24";"24";"24";"0";"0";"457159";"373870"
"V4mis1";"SILVA (only NR);Bacteria;Bacteroidota;Bacteroidia;Chitinophagales;Chitinophagaceae;Puia;";"89.9";"18.2";"79";"79";"71";"8";"0";"457104";"373823"
"V4mis1";"SILVA (only NR);Bacteria;Bacteroidota;Bacteroidia;Chitinophagales;Chitinophagaceae;Rurimicrobium;";"100.0";"18.2";"6";"6";"6";"0";"0";"457177";"373888"
"V4mis1";"SILVA (only NR);Bacteria;Bacteroidota;Bacteroidia;Chitinophagales;Chitinophagaceae;Sediminibacterium;";"94.7";"18.2";"95";"95";"90";"5";"0";"457088";"373804"
"V4mis1";"SILVA (only NR);Bacteria;Bacteroidota;Bacteroidia;Chitinophagales;Chitinophagaceae;Segetibacter;";"96.1";"18.2";"128";"128";"123";"5";"0";"457055";"373771"
"V4mis1";"SILVA (only NR);Bacteria;Bacteroidota;Bacteroidia;Chitinophagales;Chitinophagaceae;Taibaiella;";"91.9";"18.2";"99";"99";"91";"8";"0";"457084";"373803"
"V4mis1";"SILVA (only NR);Bacteria;Bacteroidota;Bacteroidia;Chitinophagales;Chitinophagaceae;Terrimonas;";"95.7";"18.2";"211";"211";"202";"9";"0";"456972";"373692"
"V4mis1";"SILVA (only NR);Bacteria;Bacteroidota;Bacteroidia;Chitinophagales;Chitinophagaceae;Thermoflavifilum;";"75.0";"18.2";"4";"4";"3";"1";"0";"457179";"373891"
"V4mis1";"SILVA (only NR);Bacteria;Bacteroidota;Bacteroidia;Chitinophagales;Chitinophagaceae;UTBCD1;";"100.0";"18.2";"13";"13";"13";"0";"0";"457170";"373881"
"V4mis1";"SILVA (only NR);Bacteria;Bacteroidota;Bacteroidia;Chitinophagales;Chitinophagaceae;Vibrionimonas;";"100.0";"18.2";"5";"5";"5";"0";"0";"457178";"373889"
"V4mis1";"SILVA (only NR);Bacteria;Bacteroidota;Bacteroidia;Chitinophagales;Chitinophagaceae;uncultured;";"96.0";"18.2";"505";"505";"485";"20";"0";"456678";"373409"
"V4mis1";"SILVA (only NR);Bacteria;Bacteroidota;Bacteroidia;Chitinophagales;Saprospiraceae;";"93.3";"18.3";"1415";"1415";"1320";"95";"0";"455768";"372574"
"V4mis1";"SILVA (only NR);Bacteria;Bacteroidota;Bacteroidia;Chitinophagales;Saprospiraceae;Aureispira;";"96.3";"18.2";"27";"27";"26";"1";"0";"457156";"373868"
"V4mis1";"SILVA (only NR);Bacteria;Bacteroidota;Bacteroidia;Chitinophagales;Saprospiraceae;Candidatus Aquirestis;";"92.6";"18.2";"27";"27";"25";"2";"0";"457156";"373869"
"V4mis1";"SILVA (only NR);Bacteria;Bacteroidota;Bacteroidia;Chitinophagales;Saprospiraceae;Haliscomenobacter;";"85.3";"18.2";"34";"34";"29";"5";"0";"457149";"373865"
"V4mis1";"SILVA (only NR);Bacteria;Bacteroidota;Bacteroidia;Chitinophagales;Saprospiraceae;Lewinella;";"97.1";"18.2";"136";"136";"132";"4";"0";"457047";"373762"
"V4mis1";"SILVA (only NR);Bacteria;Bacteroidota;Bacteroidia;Chitinophagales;Saprospiraceae;Membranicola;";"85.7";"18.2";"21";"21";"18";"3";"0";"457162";"373876"
"V4mis1";"SILVA (only NR);Bacteria;Bacteroidota;Bacteroidia;Chitinophagales;Saprospiraceae;OLB8;";"94.4";"18.2";"18";"18";"17";"1";"0";"457165";"373877"
"V4mis1";"SILVA (only NR);Bacteria;Bacteroidota;Bacteroidia;Chitinophagales;Saprospiraceae;Phaeodactylibacter;";"88.8";"18.2";"179";"179";"159";"20";"0";"457004";"373735"
"V4mis1";"SILVA (only NR);Bacteria;Bacteroidota;Bacteroidia;Chitinophagales;Saprospiraceae;Portibacter;";"94.1";"18.2";"34";"34";"32";"2";"0";"457149";"373862"
"V4mis1";"SILVA (only NR);Bacteria;Bacteroidota;Bacteroidia;Chitinophagales;Saprospiraceae;Rubidimonas;";"100.0";"18.2";"18";"18";"18";"0";"0";"457165";"373876"
"V4mis1";"SILVA (only NR);Bacteria;Bacteroidota;Bacteroidia;Chitinophagales;Saprospiraceae;Saprospira;";"100.0";"18.2";"12";"12";"12";"0";"0";"457171";"373882"
"V4mis1";"SILVA (only NR);Bacteria;Bacteroidota;Bacteroidia;Chitinophagales;Saprospiraceae;uncultured;";"93.7";"18.2";"909";"909";"852";"57";"0";"456274";"373042"
"V4mis1";"SILVA (only NR);Bacteria;Bacteroidota;Bacteroidia;Chitinophagales;uncultured;";"96.8";"18.2";"374";"374";"362";"12";"0";"456809";"373532"
"V4mis1";"SILVA (only NR);Bacteria;Bacteroidota;Bacteroidia;Cytophagales;";"96.2";"18.3";"3573";"3573";"3436";"137";"0";"453610";"370458"
"V4mis1";"SILVA (only NR);Bacteria;Bacteroidota;Bacteroidia;Cytophagales;Amoebophilaceae;";"91.1";"18.2";"135";"135";"123";"12";"0";"457048";"373771"
"V4mis1";"SILVA (only NR);Bacteria;Bacteroidota;Bacteroidia;Cytophagales;Amoebophilaceae;Candidatus Amoebophilus;";"85.0";"18.2";"60";"60";"51";"9";"0";"457123";"373843"
"V4mis1";"SILVA (only NR);Bacteria;Bacteroidota;Bacteroidia;Cytophagales;Amoebophilaceae;Candidatus Cardinium;";"100.0";"18.2";"23";"23";"23";"0";"0";"457160";"373871"
"V4mis1";"SILVA (only NR);Bacteria;Bacteroidota;Bacteroidia;Cytophagales;Amoebophilaceae;Candidatus Paenicardinium;";"100.0";"18.2";"6";"6";"6";"0";"0";"457177";"373888"
"V4mis1";"SILVA (only NR);Bacteria;Bacteroidota;Bacteroidia;Cytophagales;Amoebophilaceae;uncultured;";"93.0";"18.2";"43";"43";"40";"3";"0";"457140";"373854"
"V4mis1";"SILVA (only NR);Bacteria;Bacteroidota;Bacteroidia;Cytophagales;Bernardetiaceae;";"84.6";"18.2";"13";"13";"11";"2";"0";"457170";"373883"
"V4mis1";"SILVA (only NR);Bacteria;Bacteroidota;Bacteroidia;Cytophagales;Bernardetiaceae;Bernardetia;";"100.0";"18.2";"3";"3";"3";"0";"0";"457180";"373891"
"V4mis1";"SILVA (only NR);Bacteria;Bacteroidota;Bacteroidia;Cytophagales;Bernardetiaceae;Garritya;";"50.0";"18.2";"2";"2";"1";"1";"0";"457181";"373893"
"V4mis1";"SILVA (only NR);Bacteria;Bacteroidota;Bacteroidia;Cytophagales;Bernardetiaceae;Hugenholtzia;";"80.0";"18.2";"5";"5";"4";"1";"0";"457178";"373890"
"V4mis1";"SILVA (only NR);Bacteria;Bacteroidota;Bacteroidia;Cytophagales;Bernardetiaceae;uncultured;";"100.0";"18.2";"3";"3";"3";"0";"0";"457180";"373891"
"V4mis1";"SILVA (only NR);Bacteria;Bacteroidota;Bacteroidia;Cytophagales;Cyclobacteriaceae;";"95.9";"18.2";"953";"953";"914";"39";"0";"456230";"372980"
"V4mis1";"SILVA (only NR);Bacteria;Bacteroidota;Bacteroidia;Cytophagales;Cyclobacteriaceae;Algoriphagus;";"98.2";"18.2";"165";"165";"162";"3";"0";"457018";"373732"
"V4mis1";"SILVA (only NR);Bacteria;Bacteroidota;Bacteroidia;Cytophagales;Cyclobacteriaceae;Anditalea;";"100.0";"18.2";"2";"2";"2";"0";"0";"457181";"373892"
"V4mis1";"SILVA (only NR);Bacteria;Bacteroidota;Bacteroidia;Cytophagales;Cyclobacteriaceae;Aquiflexum;";"100.0";"18.2";"14";"14";"14";"0";"0";"457169";"373880"
"V4mis1";"SILVA (only NR);Bacteria;Bacteroidota;Bacteroidia;Cytophagales;Cyclobacteriaceae;Aureibacter;";"100.0";"18.2";"1";"1";"1";"0";"0";"457182";"373893"
"V4mis1";"SILVA (only NR);Bacteria;Bacteroidota;Bacteroidia;Cytophagales;Cyclobacteriaceae;Belliella;";"100.0";"18.2";"12";"12";"12";"0";"0";"457171";"373882"
"V4mis1";"SILVA (only NR);Bacteria;Bacteroidota;Bacteroidia;Cytophagales;Cyclobacteriaceae;Catalinimonas;";"91.7";"18.2";"12";"12";"11";"1";"0";"457171";"373883"
"V4mis1";"SILVA (only NR);Bacteria;Bacteroidota;Bacteroidia;Cytophagales;Cyclobacteriaceae;Cecembia;";"100.0";"18.2";"6";"6";"6";"0";"0";"457177";"373888"
"V4mis1";"SILVA (only NR);Bacteria;Bacteroidota;Bacteroidia;Cytophagales;Cyclobacteriaceae;Cesiribacter;";"100.0";"18.2";"11";"11";"11";"0";"0";"457172";"373883"
"V4mis1";"SILVA (only NR);Bacteria;Bacteroidota;Bacteroidia;Cytophagales;Cyclobacteriaceae;Cyclobacterium;";"94.1";"18.2";"34";"34";"32";"2";"0";"457149";"373862"
"V4mis1";"SILVA (only NR);Bacteria;Bacteroidota;Bacteroidia;Cytophagales;Cyclobacteriaceae;Echinicola;";"100.0";"18.2";"15";"15";"15";"0";"0";"457168";"373879"
"V4mis1";"SILVA (only NR);Bacteria;Bacteroidota;Bacteroidia;Cytophagales;Cyclobacteriaceae;Ekhidna;";"97.1";"18.2";"34";"34";"33";"1";"0";"457149";"373861"
"V4mis1";"SILVA (only NR);Bacteria;Bacteroidota;Bacteroidia;Cytophagales;Cyclobacteriaceae;Fabibacter;";"95.8";"18.2";"24";"24";"23";"1";"0";"457159";"373871"
"V4mis1";"SILVA (only NR);Bacteria;Bacteroidota;Bacteroidia;Cytophagales;Cyclobacteriaceae;Fontibacter;";"100.0";"18.2";"3";"3";"3";"0";"0";"457180";"373891"
"V4mis1";"SILVA (only NR);Bacteria;Bacteroidota;Bacteroidia;Cytophagales;Cyclobacteriaceae;Fulvitalea;";"100.0";"18.2";"1";"1";"1";"0";"0";"457182";"373893"
"V4mis1";"SILVA (only NR);Bacteria;Bacteroidota;Bacteroidia;Cytophagales;Cyclobacteriaceae;Fulvivirga;";"95.2";"18.2";"42";"42";"40";"2";"0";"457141";"373854"
"V4mis1";"SILVA (only NR);Bacteria;Bacteroidota;Bacteroidia;Cytophagales;Cyclobacteriaceae;Imperialibacter;";"95.0";"18.2";"20";"20";"19";"1";"0";"457163";"373875"
"V4mis1";"SILVA (only NR);Bacteria;Bacteroidota;Bacteroidia;Cytophagales;Cyclobacteriaceae;Indibacter;";"100.0";"18.2";"4";"4";"4";"0";"0";"457179";"373890"
"V4mis1";"SILVA (only NR);Bacteria;Bacteroidota;Bacteroidia;Cytophagales;Cyclobacteriaceae;Litoribacter;";"100.0";"18.2";"2";"2";"2";"0";"0";"457181";"373892"
"V4mis1";"SILVA (only NR);Bacteria;Bacteroidota;Bacteroidia;Cytophagales;Cyclobacteriaceae;Lunatimonas;";"100.0";"18.2";"4";"4";"4";"0";"0";"457179";"373890"
"V4mis1";"SILVA (only NR);Bacteria;Bacteroidota;Bacteroidia;Cytophagales;Cyclobacteriaceae;Mariniradius;";"75.0";"18.2";"4";"4";"3";"1";"0";"457179";"373891"
"V4mis1";"SILVA (only NR);Bacteria;Bacteroidota;Bacteroidia;Cytophagales;Cyclobacteriaceae;Marinoscillum;";"92.0";"18.2";"75";"75";"69";"6";"0";"457108";"373825"
"V4mis1";"SILVA (only NR);Bacteria;Bacteroidota;Bacteroidia;Cytophagales;Cyclobacteriaceae;Marivirga;";"88.5";"18.2";"26";"26";"23";"3";"0";"457157";"373871"
"V4mis1";"SILVA (only NR);Bacteria;Bacteroidota;Bacteroidia;Cytophagales;Cyclobacteriaceae;Mongoliibacter;";"100.0";"18.2";"1";"1";"1";"0";"0";"457182";"373893"
"V4mis1";"SILVA (only NR);Bacteria;Bacteroidota;Bacteroidia;Cytophagales;Cyclobacteriaceae;Mongoliicoccus;";"100.0";"18.2";"4";"4";"4";"0";"0";"457179";"373890"
"V4mis1";"SILVA (only NR);Bacteria;Bacteroidota;Bacteroidia;Cytophagales;Cyclobacteriaceae;Mongoliitalea;";"100.0";"18.2";"5";"5";"5";"0";"0";"457178";"373889"
"V4mis1";"SILVA (only NR);Bacteria;Bacteroidota;Bacteroidia;Cytophagales;Cyclobacteriaceae;Nafulsella;";"100.0";"18.2";"3";"3";"3";"0";"0";"457180";"373891"
"V4mis1";"SILVA (only NR);Bacteria;Bacteroidota;Bacteroidia;Cytophagales;Cyclobacteriaceae;Negadavirga;";"100.0";"18.2";"2";"2";"2";"0";"0";"457181";"373892"
"V4mis1";"SILVA (only NR);Bacteria;Bacteroidota;Bacteroidia;Cytophagales;Cyclobacteriaceae;Nitritalea;";"100.0";"18.2";"2";"2";"2";"0";"0";"457181";"373892"
"V4mis1";"SILVA (only NR);Bacteria;Bacteroidota;Bacteroidia;Cytophagales;Cyclobacteriaceae;Persicobacter;";"85.7";"18.2";"7";"7";"6";"1";"0";"457176";"373888"
"V4mis1";"SILVA (only NR);Bacteria;Bacteroidota;Bacteroidia;Cytophagales;Cyclobacteriaceae;Reichenbachiella;";"100.0";"18.2";"26";"26";"26";"0";"0";"457157";"373868"
"V4mis1";"SILVA (only NR);Bacteria;Bacteroidota;Bacteroidia;Cytophagales;Cyclobacteriaceae;Rhodonellum;";"100.0";"18.2";"2";"2";"2";"0";"0";"457181";"373892"
"V4mis1";"SILVA (only NR);Bacteria;Bacteroidota;Bacteroidia;Cytophagales;Cyclobacteriaceae;Roseivirga;";"100.0";"18.2";"14";"14";"14";"0";"0";"457169";"373880"
"V4mis1";"SILVA (only NR);Bacteria;Bacteroidota;Bacteroidia;Cytophagales;Cyclobacteriaceae;Shivajiella;";"100.0";"18.2";"3";"3";"3";"0";"0";"457180";"373891"
"V4mis1";"SILVA (only NR);Bacteria;Bacteroidota;Bacteroidia;Cytophagales;Cyclobacteriaceae;Tunicatimonas;";"84.6";"18.2";"13";"13";"11";"2";"0";"457170";"373883"
"V4mis1";"SILVA (only NR);Bacteria;Bacteroidota;Bacteroidia;Cytophagales;Cyclobacteriaceae;uncultured;";"95.7";"18.2";"345";"345";"330";"15";"0";"456838";"373564"
"V4mis1";"SILVA (only NR);Bacteria;Bacteroidota;Bacteroidia;Cytophagales;Cytophagaceae;";"90.0";"18.2";"130";"130";"117";"13";"0";"457053";"373777"
"V4mis1";"SILVA (only NR);Bacteria;Bacteroidota;Bacteroidia;Cytophagales;Cytophagaceae;Cytophaga;";"96.1";"18.2";"51";"51";"49";"2";"0";"457132";"373845"
"V4mis1";"SILVA (only NR);Bacteria;Bacteroidota;Bacteroidia;Cytophagales;Cytophagaceae;Rhodocytophaga;";"70.0";"18.2";"30";"30";"21";"9";"0";"457153";"373873"
"V4mis1";"SILVA (only NR);Bacteria;Bacteroidota;Bacteroidia;Cytophagales;Cytophagaceae;Siphonobacter;";"100.0";"18.2";"9";"9";"9";"0";"0";"457174";"373885"
"V4mis1";"SILVA (only NR);Bacteria;Bacteroidota;Bacteroidia;Cytophagales;Cytophagaceae;Sporocytophaga;";"94.4";"18.2";"36";"36";"34";"2";"0";"457147";"373860"
"V4mis1";"SILVA (only NR);Bacteria;Bacteroidota;Bacteroidia;Cytophagales;Cytophagaceae;uncultured;";"100.0";"18.2";"3";"3";"3";"0";"0";"457180";"373891"
"V4mis1";"SILVA (only NR);Bacteria;Bacteroidota;Bacteroidia;Cytophagales;Flammeovirgaceae;";"95.9";"18.2";"97";"97";"93";"4";"0";"457086";"373801"
"V4mis1";"SILVA (only NR);Bacteria;Bacteroidota;Bacteroidia;Cytophagales;Flammeovirgaceae;Algivirga;";"100.0";"18.2";"3";"3";"3";"0";"0";"457180";"373891"
"V4mis1";"SILVA (only NR);Bacteria;Bacteroidota;Bacteroidia;Cytophagales;Flammeovirgaceae;Flammeovirga;";"94.4";"18.2";"36";"36";"34";"2";"0";"457147";"373860"
"V4mis1";"SILVA (only NR);Bacteria;Bacteroidota;Bacteroidia;Cytophagales;Flammeovirgaceae;Flexithrix;";"92.3";"18.2";"26";"26";"24";"2";"0";"457157";"373870"
"V4mis1";"SILVA (only NR);Bacteria;Bacteroidota;Bacteroidia;Cytophagales;Flammeovirgaceae;Limibacter;";"100.0";"18.2";"2";"2";"2";"0";"0";"457181";"373892"
"V4mis1";"SILVA (only NR);Bacteria;Bacteroidota;Bacteroidia;Cytophagales;Flammeovirgaceae;Luteivirga;";"100.0";"18.2";"8";"8";"8";"0";"0";"457175";"373886"
"V4mis1";"SILVA (only NR);Bacteria;Bacteroidota;Bacteroidia;Cytophagales;Flammeovirgaceae;Perexilibacter;";"100.0";"18.2";"3";"3";"3";"0";"0";"457180";"373891"
"V4mis1";"SILVA (only NR);Bacteria;Bacteroidota;Bacteroidia;Cytophagales;Flammeovirgaceae;Rapidithrix;";"100.0";"18.2";"10";"10";"10";"0";"0";"457173";"373884"
"V4mis1";"SILVA (only NR);Bacteria;Bacteroidota;Bacteroidia;Cytophagales;Flammeovirgaceae;Sediminitomix;";"100.0";"18.2";"2";"2";"2";"0";"0";"457181";"373892"
"V4mis1";"SILVA (only NR);Bacteria;Bacteroidota;Bacteroidia;Cytophagales;Flammeovirgaceae;uncultured;";"100.0";"18.2";"6";"6";"6";"0";"0";"457177";"373888"
"V4mis1";"SILVA (only NR);Bacteria;Bacteroidota;Bacteroidia;Cytophagales;Hymenobacteraceae;";"98.0";"18.2";"898";"898";"880";"18";"0";"456285";"373014"
"V4mis1";"SILVA (only NR);Bacteria;Bacteroidota;Bacteroidia;Cytophagales;Hymenobacteraceae;Adhaeribacter;";"98.3";"18.2";"118";"118";"116";"2";"0";"457065";"373778"
"V4mis1";"SILVA (only NR);Bacteria;Bacteroidota;Bacteroidia;Cytophagales;Hymenobacteraceae;Hymenobacter;";"97.7";"18.2";"567";"567";"554";"13";"0";"456616";"373340"
"V4mis1";"SILVA (only NR);Bacteria;Bacteroidota;Bacteroidia;Cytophagales;Hymenobacteraceae;Nibribacter;";"95.2";"18.2";"21";"21";"20";"1";"0";"457162";"373874"
"V4mis1";"SILVA (only NR);Bacteria;Bacteroidota;Bacteroidia;Cytophagales;Hymenobacteraceae;Pontibacter;";"98.8";"18.2";"169";"169";"167";"2";"0";"457014";"373727"
"V4mis1";"SILVA (only NR);Bacteria;Bacteroidota;Bacteroidia;Cytophagales;Hymenobacteraceae;Rufibacter;";"100.0";"18.2";"23";"23";"23";"0";"0";"457160";"373871"
"V4mis1";"SILVA (only NR);Bacteria;Bacteroidota;Bacteroidia;Cytophagales;MWH-CFBk5;";"90.0";"18.2";"40";"40";"36";"4";"0";"457143";"373858"
"V4mis1";"SILVA (only NR);Bacteria;Bacteroidota;Bacteroidia;Cytophagales;Microscillaceae;";"95.6";"18.2";"660";"660";"631";"29";"0";"456523";"373263"
"V4mis1";"SILVA (only NR);Bacteria;Bacteroidota;Bacteroidia;Cytophagales;Microscillaceae;Chryseolinea;";"98.5";"18.2";"65";"65";"64";"1";"0";"457118";"373830"
"V4mis1";"SILVA (only NR);Bacteria;Bacteroidota;Bacteroidia;Cytophagales;Microscillaceae;Eisenibacter;";"85.7";"18.2";"7";"7";"6";"1";"0";"457176";"373888"
"V4mis1";"SILVA (only NR);Bacteria;Bacteroidota;Bacteroidia;Cytophagales;Microscillaceae;Flexibacter;";"88.2";"18.2";"17";"17";"15";"2";"0";"457166";"373879"
"V4mis1";"SILVA (only NR);Bacteria;Bacteroidota;Bacteroidia;Cytophagales;Microscillaceae;Hassallia;";"96.5";"18.2";"57";"57";"55";"2";"0";"457126";"373839"
"V4mis1";"SILVA (only NR);Bacteria;Bacteroidota;Bacteroidia;Cytophagales;Microscillaceae;Microscilla;";"91.7";"18.2";"12";"12";"11";"1";"0";"457171";"373883"
"V4mis1";"SILVA (only NR);Bacteria;Bacteroidota;Bacteroidia;Cytophagales;Microscillaceae;OLB12;";"100.0";"18.2";"36";"36";"36";"0";"0";"457147";"373858"
"V4mis1";"SILVA (only NR);Bacteria;Bacteroidota;Bacteroidia;Cytophagales;Microscillaceae;Ohtaekwangia;";"100.0";"18.2";"53";"53";"53";"0";"0";"457130";"373841"
"V4mis1";"SILVA (only NR);Bacteria;Bacteroidota;Bacteroidia;Cytophagales;Microscillaceae;Thermoflexibacter;";"57.1";"18.2";"7";"7";"4";"3";"0";"457176";"373890"
"V4mis1";"SILVA (only NR);Bacteria;Bacteroidota;Bacteroidia;Cytophagales;Microscillaceae;uncultured;";"95.3";"18.2";"404";"404";"385";"19";"0";"456779";"373509"
"V4mis1";"SILVA (only NR);Bacteria;Bacteroidota;Bacteroidia;Cytophagales;Mooreiaceae;";"100.0";"18.2";"3";"3";"3";"0";"0";"457180";"373891"
"V4mis1";"SILVA (only NR);Bacteria;Bacteroidota;Bacteroidia;Cytophagales;Mooreiaceae;Mooreia;";"100.0";"18.2";"3";"3";"3";"0";"0";"457180";"373891"
"V4mis1";"SILVA (only NR);Bacteria;Bacteroidota;Bacteroidia;Cytophagales;Raineyaceae;";"100.0";"18.2";"16";"16";"16";"0";"0";"457167";"373878"
"V4mis1";"SILVA (only NR);Bacteria;Bacteroidota;Bacteroidia;Cytophagales;Raineyaceae;Raineya;";"100.0";"18.2";"16";"16";"16";"0";"0";"457167";"373878"
"V4mis1";"SILVA (only NR);Bacteria;Bacteroidota;Bacteroidia;Cytophagales;Spirosomaceae;";"97.5";"18.2";"603";"603";"588";"15";"0";"456580";"373306"
"V4mis1";"SILVA (only NR);Bacteria;Bacteroidota;Bacteroidia;Cytophagales;Spirosomaceae;Arcicella;";"100.0";"18.2";"44";"44";"44";"0";"0";"457139";"373850"
"V4mis1";"SILVA (only NR);Bacteria;Bacteroidota;Bacteroidia;Cytophagales;Spirosomaceae;Arsenicibacter;";"100.0";"18.2";"3";"3";"3";"0";"0";"457180";"373891"
"V4mis1";"SILVA (only NR);Bacteria;Bacteroidota;Bacteroidia;Cytophagales;Spirosomaceae;Dyadobacter;";"97.7";"18.2";"133";"133";"130";"3";"0";"457050";"373764"
"V4mis1";"SILVA (only NR);Bacteria;Bacteroidota;Bacteroidia;Cytophagales;Spirosomaceae;Emticicia;";"100.0";"18.2";"31";"31";"31";"0";"0";"457152";"373863"
"V4mis1";"SILVA (only NR);Bacteria;Bacteroidota;Bacteroidia;Cytophagales;Spirosomaceae;Fibrella;";"100.0";"18.2";"13";"13";"13";"0";"0";"457170";"373881"
"V4mis1";"SILVA (only NR);Bacteria;Bacteroidota;Bacteroidia;Cytophagales;Spirosomaceae;Fibrisoma;";"100.0";"18.2";"9";"9";"9";"0";"0";"457174";"373885"
"V4mis1";"SILVA (only NR);Bacteria;Bacteroidota;Bacteroidia;Cytophagales;Spirosomaceae;Flectobacillus;";"94.7";"18.2";"19";"19";"18";"1";"0";"457164";"373876"
"V4mis1";"SILVA (only NR);Bacteria;Bacteroidota;Bacteroidia;Cytophagales;Spirosomaceae;Fluviimonas;";"100.0";"18.2";"3";"3";"3";"0";"0";"457180";"373891"
"V4mis1";"SILVA (only NR);Bacteria;Bacteroidota;Bacteroidia;Cytophagales;Spirosomaceae;Huanghella;";"100.0";"18.2";"1";"1";"1";"0";"0";"457182";"373893"
"V4mis1";"SILVA (only NR);Bacteria;Bacteroidota;Bacteroidia;Cytophagales;Spirosomaceae;Lacihabitans;";"95.0";"18.2";"20";"20";"19";"1";"0";"457163";"373875"
"V4mis1";"SILVA (only NR);Bacteria;Bacteroidota;Bacteroidia;Cytophagales;Spirosomaceae;Larkinella;";"100.0";"18.2";"26";"26";"26";"0";"0";"457157";"373868"
"V4mis1";"SILVA (only NR);Bacteria;Bacteroidota;Bacteroidia;Cytophagales;Spirosomaceae;Leadbetterella;";"94.7";"18.2";"19";"19";"18";"1";"0";"457164";"373876"
"V4mis1";"SILVA (only NR);Bacteria;Bacteroidota;Bacteroidia;Cytophagales;Spirosomaceae;Nibrella;";"100.0";"18.2";"5";"5";"5";"0";"0";"457178";"373889"
"V4mis1";"SILVA (only NR);Bacteria;Bacteroidota;Bacteroidia;Cytophagales;Spirosomaceae;Persicitalea;";"100.0";"18.2";"17";"17";"17";"0";"0";"457166";"373877"
"V4mis1";"SILVA (only NR);Bacteria;Bacteroidota;Bacteroidia;Cytophagales;Spirosomaceae;Pseudarcicella;";"86.7";"18.2";"30";"30";"26";"4";"0";"457153";"373868"
"V4mis1";"SILVA (only NR);Bacteria;Bacteroidota;Bacteroidia;Cytophagales;Spirosomaceae;Rhabdobacter;";"100.0";"18.2";"6";"6";"6";"0";"0";"457177";"373888"
"V4mis1";"SILVA (only NR);Bacteria;Bacteroidota;Bacteroidia;Cytophagales;Spirosomaceae;Rudanella;";"100.0";"18.2";"4";"4";"4";"0";"0";"457179";"373890"
"V4mis1";"SILVA (only NR);Bacteria;Bacteroidota;Bacteroidia;Cytophagales;Spirosomaceae;Runella;";"88.9";"18.2";"36";"36";"32";"4";"0";"457147";"373862"
"V4mis1";"SILVA (only NR);Bacteria;Bacteroidota;Bacteroidia;Cytophagales;Spirosomaceae;Spirosoma;";"100.0";"18.2";"129";"129";"129";"0";"0";"457054";"373765"
"V4mis1";"SILVA (only NR);Bacteria;Bacteroidota;Bacteroidia;Cytophagales;Spirosomaceae;Taeseokella;";"100.0";"18.2";"7";"7";"7";"0";"0";"457176";"373887"
"V4mis1";"SILVA (only NR);Bacteria;Bacteroidota;Bacteroidia;Cytophagales;Spirosomaceae;uncultured;";"97.6";"18.2";"42";"42";"41";"1";"0";"457141";"373853"
"V4mis1";"SILVA (only NR);Bacteria;Bacteroidota;Bacteroidia;Cytophagales;Thermonemataceae;";"100.0";"18.2";"5";"5";"5";"0";"0";"457178";"373889"
"V4mis1";"SILVA (only NR);Bacteria;Bacteroidota;Bacteroidia;Cytophagales;Thermonemataceae;Thermonema;";"100.0";"18.2";"5";"5";"5";"0";"0";"457178";"373889"
"V4mis1";"SILVA (only NR);Bacteria;Bacteroidota;Bacteroidia;Cytophagales;uncultured;";"94.7";"18.2";"19";"19";"18";"1";"0";"457164";"373876"
"V4mis1";"SILVA (only NR);Bacteria;Bacteroidota;Bacteroidia;Flavobacteriales;";"95.4";"18.5";"9773";"9773";"9320";"453";"0";"447410";"364574"
"V4mis1";"SILVA (only NR);Bacteria;Bacteroidota;Bacteroidia;Flavobacteriales;Blattabacteriaceae;";"91.0";"18.2";"267";"267";"243";"24";"0";"456916";"373651"
"V4mis1";"SILVA (only NR);Bacteria;Bacteroidota;Bacteroidia;Flavobacteriales;Blattabacteriaceae;Blattabacterium;";"91.3";"18.2";"46";"46";"42";"4";"0";"457137";"373852"
"V4mis1";"SILVA (only NR);Bacteria;Bacteroidota;Bacteroidia;Flavobacteriales;Blattabacteriaceae;Candidatus Brownia;";"85.7";"18.2";"14";"14";"12";"2";"0";"457169";"373882"
"V4mis1";"SILVA (only NR);Bacteria;Bacteroidota;Bacteroidia;Flavobacteriales;Blattabacteriaceae;Candidatus Sulcia;";"85.5";"18.2";"117";"117";"100";"17";"0";"457066";"373794"
"V4mis1";"SILVA (only NR);Bacteria;Bacteroidota;Bacteroidia;Flavobacteriales;Blattabacteriaceae;Candidatus Uzinura;";"98.6";"18.2";"74";"74";"73";"1";"0";"457109";"373821"
"V4mis1";"SILVA (only NR);Bacteria;Bacteroidota;Bacteroidia;Flavobacteriales;Blattabacteriaceae;uncultured;";"100.0";"18.2";"12";"12";"12";"0";"0";"457171";"373882"
"V4mis1";"SILVA (only NR);Bacteria;Bacteroidota;Bacteroidia;Flavobacteriales;Crocinitomicaceae;";"97.2";"18.2";"387";"387";"376";"11";"0";"456796";"373518"
"V4mis1";"SILVA (only NR);Bacteria;Bacteroidota;Bacteroidia;Flavobacteriales;Crocinitomicaceae;Brumimicrobium;";"100.0";"18.2";"22";"22";"22";"0";"0";"457161";"373872"
"V4mis1";"SILVA (only NR);Bacteria;Bacteroidota;Bacteroidia;Flavobacteriales;Crocinitomicaceae;Crocinitomix;";"94.0";"18.2";"84";"84";"79";"5";"0";"457099";"373815"
"V4mis1";"SILVA (only NR);Bacteria;Bacteroidota;Bacteroidia;Flavobacteriales;Crocinitomicaceae;Fluviicola;";"97.4";"18.2";"230";"230";"224";"6";"0";"456953";"373670"
"V4mis1";"SILVA (only NR);Bacteria;Bacteroidota;Bacteroidia;Flavobacteriales;Crocinitomicaceae;Lishizhenia;";"100.0";"18.2";"3";"3";"3";"0";"0";"457180";"373891"
"V4mis1";"SILVA (only NR);Bacteria;Bacteroidota;Bacteroidia;Flavobacteriales;Crocinitomicaceae;Salinirepens;";"100.0";"18.2";"12";"12";"12";"0";"0";"457171";"373882"
"V4mis1";"SILVA (only NR);Bacteria;Bacteroidota;Bacteroidia;Flavobacteriales;Crocinitomicaceae;Wandonia;";"100.0";"18.2";"7";"7";"7";"0";"0";"457176";"373887"
"V4mis1";"SILVA (only NR);Bacteria;Bacteroidota;Bacteroidia;Flavobacteriales;Crocinitomicaceae;uncultured;";"100.0";"18.2";"29";"29";"29";"0";"0";"457154";"373865"
"V4mis1";"SILVA (only NR);Bacteria;Bacteroidota;Bacteroidia;Flavobacteriales;Cryomorphaceae;";"95.1";"18.2";"425";"425";"404";"21";"0";"456758";"373490"
"V4mis1";"SILVA (only NR);Bacteria;Bacteroidota;Bacteroidia;Flavobacteriales;Cryomorphaceae;Cryomorpha;";"92.0";"18.2";"50";"50";"46";"4";"0";"457133";"373848"
"V4mis1";"SILVA (only NR);Bacteria;Bacteroidota;Bacteroidia;Flavobacteriales;Cryomorphaceae;Luteibaculum;";"100.0";"18.2";"8";"8";"8";"0";"0";"457175";"373886"
"V4mis1";"SILVA (only NR);Bacteria;Bacteroidota;Bacteroidia;Flavobacteriales;Cryomorphaceae;NS10 marine group;";"97.6";"18.2";"41";"41";"40";"1";"0";"457142";"373854"
"V4mis1";"SILVA (only NR);Bacteria;Bacteroidota;Bacteroidia;Flavobacteriales;Cryomorphaceae;Owenweeksia;";"94.1";"18.2";"34";"34";"32";"2";"0";"457149";"373862"
"V4mis1";"SILVA (only NR);Bacteria;Bacteroidota;Bacteroidia;Flavobacteriales;Cryomorphaceae;Phaeocystidibacter;";"100.0";"18.2";"7";"7";"7";"0";"0";"457176";"373887"
"V4mis1";"SILVA (only NR);Bacteria;Bacteroidota;Bacteroidia;Flavobacteriales;Cryomorphaceae;Vicingus;";"91.0";"18.2";"67";"67";"61";"6";"0";"457116";"373833"
"V4mis1";"SILVA (only NR);Bacteria;Bacteroidota;Bacteroidia;Flavobacteriales;Cryomorphaceae;uncultured;";"96.3";"18.2";"215";"215";"207";"8";"0";"456968";"373687"
"V4mis1";"SILVA (only NR);Bacteria;Bacteroidota;Bacteroidia;Flavobacteriales;Flavobacteriaceae;";"95.8";"18.4";"6681";"6681";"6398";"283";"0";"450502";"367496"
"V4mis1";"SILVA (only NR);Bacteria;Bacteroidota;Bacteroidia;Flavobacteriales;Flavobacteriaceae;Actibacter;";"90.0";"18.2";"20";"20";"18";"2";"0";"457163";"373876"
"V4mis1";"SILVA (only NR);Bacteria;Bacteroidota;Bacteroidia;Flavobacteriales;Flavobacteriaceae;Aequorivita;";"97.0";"18.2";"33";"33";"32";"1";"0";"457150";"373862"
"V4mis1";"SILVA (only NR);Bacteria;Bacteroidota;Bacteroidia;Flavobacteriales;Flavobacteriaceae;Aestuariibaculum;";"100.0";"18.2";"7";"7";"7";"0";"0";"457176";"373887"
"V4mis1";"SILVA (only NR);Bacteria;Bacteroidota;Bacteroidia;Flavobacteriales;Flavobacteriaceae;Aestuariimonas;";"100.0";"18.2";"4";"4";"4";"0";"0";"457179";"373890"
"V4mis1";"SILVA (only NR);Bacteria;Bacteroidota;Bacteroidia;Flavobacteriales;Flavobacteriaceae;Aestuariivivens;";"100.0";"18.2";"3";"3";"3";"0";"0";"457180";"373891"
"V4mis1";"SILVA (only NR);Bacteria;Bacteroidota;Bacteroidia;Flavobacteriales;Flavobacteriaceae;Algibacter;";"95.0";"18.2";"40";"40";"38";"2";"0";"457143";"373856"
"V4mis1";"SILVA (only NR);Bacteria;Bacteroidota;Bacteroidia;Flavobacteriales;Flavobacteriaceae;Algitalea;";"90.0";"18.2";"10";"10";"9";"1";"0";"457173";"373885"
"V4mis1";"SILVA (only NR);Bacteria;Bacteroidota;Bacteroidia;Flavobacteriales;Flavobacteriaceae;Antarcticibacterium;";"100.0";"18.2";"30";"30";"30";"0";"0";"457153";"373864"
"V4mis1";"SILVA (only NR);Bacteria;Bacteroidota;Bacteroidia;Flavobacteriales;Flavobacteriaceae;Antarcticimonas;";"100.0";"18.2";"2";"2";"2";"0";"0";"457181";"373892"
"V4mis1";"SILVA (only NR);Bacteria;Bacteroidota;Bacteroidia;Flavobacteriales;Flavobacteriaceae;Aquibacter;";"97.2";"18.2";"108";"108";"105";"3";"0";"457075";"373789"
"V4mis1";"SILVA (only NR);Bacteria;Bacteroidota;Bacteroidia;Flavobacteriales;Flavobacteriaceae;Aquimarina;";"95.5";"18.2";"67";"67";"64";"3";"0";"457116";"373830"
"V4mis1";"SILVA (only NR);Bacteria;Bacteroidota;Bacteroidia;Flavobacteriales;Flavobacteriaceae;Arcticiflavibacter;";"100.0";"18.2";"19";"19";"19";"0";"0";"457164";"373875"
"V4mis1";"SILVA (only NR);Bacteria;Bacteroidota;Bacteroidia;Flavobacteriales;Flavobacteriaceae;Arenibacter;";"100.0";"18.2";"49";"49";"49";"0";"0";"457134";"373845"
"V4mis1";"SILVA (only NR);Bacteria;Bacteroidota;Bacteroidia;Flavobacteriales;Flavobacteriaceae;Arenitalea;";"100.0";"18.2";"1";"1";"1";"0";"0";"457182";"373893"
"V4mis1";"SILVA (only NR);Bacteria;Bacteroidota;Bacteroidia;Flavobacteriales;Flavobacteriaceae;Ascidiimonas;";"100.0";"18.2";"3";"3";"3";"0";"0";"457180";"373891"
"V4mis1";"SILVA (only NR);Bacteria;Bacteroidota;Bacteroidia;Flavobacteriales;Flavobacteriaceae;Aurantiacicella;";"100.0";"18.2";"1";"1";"1";"0";"0";"457182";"373893"
"V4mis1";"SILVA (only NR);Bacteria;Bacteroidota;Bacteroidia;Flavobacteriales;Flavobacteriaceae;Aurantivirga;";"100.0";"18.2";"14";"14";"14";"0";"0";"457169";"373880"
"V4mis1";"SILVA (only NR);Bacteria;Bacteroidota;Bacteroidia;Flavobacteriales;Flavobacteriaceae;Aureicoccus;";"100.0";"18.2";"1";"1";"1";"0";"0";"457182";"373893"
"V4mis1";"SILVA (only NR);Bacteria;Bacteroidota;Bacteroidia;Flavobacteriales;Flavobacteriaceae;Aureimarina;";"100.0";"18.2";"2";"2";"2";"0";"0";"457181";"373892"
"V4mis1";"SILVA (only NR);Bacteria;Bacteroidota;Bacteroidia;Flavobacteriales;Flavobacteriaceae;Aureisphaera;";"100.0";"18.2";"5";"5";"5";"0";"0";"457178";"373889"
"V4mis1";"SILVA (only NR);Bacteria;Bacteroidota;Bacteroidia;Flavobacteriales;Flavobacteriaceae;Aureitalea;";"100.0";"18.2";"2";"2";"2";"0";"0";"457181";"373892"
"V4mis1";"SILVA (only NR);Bacteria;Bacteroidota;Bacteroidia;Flavobacteriales;Flavobacteriaceae;Aureivirga;";"100.0";"18.2";"2";"2";"2";"0";"0";"457181";"373892"
"V4mis1";"SILVA (only NR);Bacteria;Bacteroidota;Bacteroidia;Flavobacteriales;Flavobacteriaceae;Bizionia;";"90.9";"18.2";"22";"22";"20";"2";"0";"457161";"373874"
"V4mis1";"SILVA (only NR);Bacteria;Bacteroidota;Bacteroidia;Flavobacteriales;Flavobacteriaceae;Capnocytophaga;";"94.2";"18.2";"482";"482";"454";"28";"0";"456701";"373440"
"V4mis1";"SILVA (only NR);Bacteria;Bacteroidota;Bacteroidia;Flavobacteriales;Flavobacteriaceae;Cellulophaga;";"95.2";"18.2";"63";"63";"60";"3";"0";"457120";"373834"
"V4mis1";"SILVA (only NR);Bacteria;Bacteroidota;Bacteroidia;Flavobacteriales;Flavobacteriaceae;Changchengzhania;";"100.0";"18.2";"4";"4";"4";"0";"0";"457179";"373890"
"V4mis1";"SILVA (only NR);Bacteria;Bacteroidota;Bacteroidia;Flavobacteriales;Flavobacteriaceae;Citreitalea;";"100.0";"18.2";"9";"9";"9";"0";"0";"457174";"373885"
"V4mis1";"SILVA (only NR);Bacteria;Bacteroidota;Bacteroidia;Flavobacteriales;Flavobacteriaceae;Coenonia;";"80.0";"18.2";"5";"5";"4";"1";"0";"457178";"373890"
"V4mis1";"SILVA (only NR);Bacteria;Bacteroidota;Bacteroidia;Flavobacteriales;Flavobacteriaceae;Confluentibacter;";"100.0";"18.2";"9";"9";"9";"0";"0";"457174";"373885"
"V4mis1";"SILVA (only NR);Bacteria;Bacteroidota;Bacteroidia;Flavobacteriales;Flavobacteriaceae;Corallibacter;";"100.0";"18.2";"3";"3";"3";"0";"0";"457180";"373891"
"V4mis1";"SILVA (only NR);Bacteria;Bacteroidota;Bacteroidia;Flavobacteriales;Flavobacteriaceae;Costertonia;";"100.0";"18.2";"6";"6";"6";"0";"0";"457177";"373888"
"V4mis1";"SILVA (only NR);Bacteria;Bacteroidota;Bacteroidia;Flavobacteriales;Flavobacteriaceae;Croceibacter;";"100.0";"18.2";"4";"4";"4";"0";"0";"457179";"373890"
"V4mis1";"SILVA (only NR);Bacteria;Bacteroidota;Bacteroidia;Flavobacteriales;Flavobacteriaceae;Croceitalea;";"93.8";"18.2";"16";"16";"15";"1";"0";"457167";"373879"
"V4mis1";"SILVA (only NR);Bacteria;Bacteroidota;Bacteroidia;Flavobacteriales;Flavobacteriaceae;Dokdonia;";"100.0";"18.2";"48";"48";"48";"0";"0";"457135";"373846"
"V4mis1";"SILVA (only NR);Bacteria;Bacteroidota;Bacteroidia;Flavobacteriales;Flavobacteriaceae;Eudoraea;";"100.0";"18.2";"9";"9";"9";"0";"0";"457174";"373885"
"V4mis1";"SILVA (only NR);Bacteria;Bacteroidota;Bacteroidia;Flavobacteriales;Flavobacteriaceae;Euzebyella;";"100.0";"18.2";"15";"15";"15";"0";"0";"457168";"373879"
"V4mis1";"SILVA (only NR);Bacteria;Bacteroidota;Bacteroidia;Flavobacteriales;Flavobacteriaceae;Flagellimonas;";"100.0";"18.2";"4";"4";"4";"0";"0";"457179";"373890"
"V4mis1";"SILVA (only NR);Bacteria;Bacteroidota;Bacteroidia;Flavobacteriales;Flavobacteriaceae;Flavicella;";"100.0";"18.2";"10";"10";"10";"0";"0";"457173";"373884"
"V4mis1";"SILVA (only NR);Bacteria;Bacteroidota;Bacteroidia;Flavobacteriales;Flavobacteriaceae;Flavimarina;";"100.0";"18.2";"7";"7";"7";"0";"0";"457176";"373887"
"V4mis1";"SILVA (only NR);Bacteria;Bacteroidota;Bacteroidia;Flavobacteriales;Flavobacteriaceae;Flaviramulus;";"100.0";"18.2";"2";"2";"2";"0";"0";"457181";"373892"
"V4mis1";"SILVA (only NR);Bacteria;Bacteroidota;Bacteroidia;Flavobacteriales;Flavobacteriaceae;Flavirhabdus;";"93.3";"18.2";"15";"15";"14";"1";"0";"457168";"373880"
"V4mis1";"SILVA (only NR);Bacteria;Bacteroidota;Bacteroidia;Flavobacteriales;Flavobacteriaceae;Flavivirga;";"100.0";"18.2";"4";"4";"4";"0";"0";"457179";"373890"
"V4mis1";"SILVA (only NR);Bacteria;Bacteroidota;Bacteroidia;Flavobacteriales;Flavobacteriaceae;Flavobacterium;";"95.5";"18.3";"2191";"2191";"2093";"98";"0";"454992";"371801"
"V4mis1";"SILVA (only NR);Bacteria;Bacteroidota;Bacteroidia;Flavobacteriales;Flavobacteriaceae;Formosa;";"99.0";"18.2";"104";"104";"103";"1";"0";"457079";"373791"
"V4mis1";"SILVA (only NR);Bacteria;Bacteroidota;Bacteroidia;Flavobacteriales;Flavobacteriaceae;Frondibacter;";"100.0";"18.2";"2";"2";"2";"0";"0";"457181";"373892"
"V4mis1";"SILVA (only NR);Bacteria;Bacteroidota;Bacteroidia;Flavobacteriales;Flavobacteriaceae;Fulvibacter;";"100.0";"18.2";"2";"2";"2";"0";"0";"457181";"373892"
"V4mis1";"SILVA (only NR);Bacteria;Bacteroidota;Bacteroidia;Flavobacteriales;Flavobacteriaceae;Gaetbulibacter;";"100.0";"18.2";"17";"17";"17";"0";"0";"457166";"373877"
"V4mis1";"SILVA (only NR);Bacteria;Bacteroidota;Bacteroidia;Flavobacteriales;Flavobacteriaceae;Galbibacter;";"100.0";"18.2";"6";"6";"6";"0";"0";"457177";"373888"
"V4mis1";"SILVA (only NR);Bacteria;Bacteroidota;Bacteroidia;Flavobacteriales;Flavobacteriaceae;Gangjinia;";"100.0";"18.2";"9";"9";"9";"0";"0";"457174";"373885"
"V4mis1";"SILVA (only NR);Bacteria;Bacteroidota;Bacteroidia;Flavobacteriales;Flavobacteriaceae;Gelidibacter;";"100.0";"18.2";"17";"17";"17";"0";"0";"457166";"373877"
"V4mis1";"SILVA (only NR);Bacteria;Bacteroidota;Bacteroidia;Flavobacteriales;Flavobacteriaceae;Geojedonia;";"100.0";"18.2";"3";"3";"3";"0";"0";"457180";"373891"
"V4mis1";"SILVA (only NR);Bacteria;Bacteroidota;Bacteroidia;Flavobacteriales;Flavobacteriaceae;Gillisia;";"100.0";"18.2";"37";"37";"37";"0";"0";"457146";"373857"
"V4mis1";"SILVA (only NR);Bacteria;Bacteroidota;Bacteroidia;Flavobacteriales;Flavobacteriaceae;Gilvibacter;";"100.0";"18.2";"10";"10";"10";"0";"0";"457173";"373884"
"V4mis1";"SILVA (only NR);Bacteria;Bacteroidota;Bacteroidia;Flavobacteriales;Flavobacteriaceae;Gramella;";"97.7";"18.2";"44";"44";"43";"1";"0";"457139";"373851"
"V4mis1";"SILVA (only NR);Bacteria;Bacteroidota;Bacteroidia;Flavobacteriales;Flavobacteriaceae;Hanstruepera;";"100.0";"18.2";"2";"2";"2";"0";"0";"457181";"373892"
"V4mis1";"SILVA (only NR);Bacteria;Bacteroidota;Bacteroidia;Flavobacteriales;Flavobacteriaceae;Hoppeia;";"100.0";"18.2";"12";"12";"12";"0";"0";"457171";"373882"
"V4mis1";"SILVA (only NR);Bacteria;Bacteroidota;Bacteroidia;Flavobacteriales;Flavobacteriaceae;Hwangdonia;";"100.0";"18.2";"3";"3";"3";"0";"0";"457180";"373891"
"V4mis1";"SILVA (only NR);Bacteria;Bacteroidota;Bacteroidia;Flavobacteriales;Flavobacteriaceae;Hyunsoonleella;";"81.8";"18.2";"11";"11";"9";"2";"0";"457172";"373885"
"V4mis1";"SILVA (only NR);Bacteria;Bacteroidota;Bacteroidia;Flavobacteriales;Flavobacteriaceae;Ichthyenterobacterium;";"100.0";"18.2";"3";"3";"3";"0";"0";"457180";"373891"
"V4mis1";"SILVA (only NR);Bacteria;Bacteroidota;Bacteroidia;Flavobacteriales;Flavobacteriaceae;Imtechella;";"100.0";"18.2";"2";"2";"2";"0";"0";"457181";"373892"
"V4mis1";"SILVA (only NR);Bacteria;Bacteroidota;Bacteroidia;Flavobacteriales;Flavobacteriaceae;Jejudonia;";"85.7";"18.2";"7";"7";"6";"1";"0";"457176";"373888"
"V4mis1";"SILVA (only NR);Bacteria;Bacteroidota;Bacteroidia;Flavobacteriales;Flavobacteriaceae;Jejuia;";"100.0";"18.2";"3";"3";"3";"0";"0";"457180";"373891"
"V4mis1";"SILVA (only NR);Bacteria;Bacteroidota;Bacteroidia;Flavobacteriales;Flavobacteriaceae;Joostella;";"100.0";"18.2";"9";"9";"9";"0";"0";"457174";"373885"
"V4mis1";"SILVA (only NR);Bacteria;Bacteroidota;Bacteroidia;Flavobacteriales;Flavobacteriaceae;Kordia;";"100.0";"18.2";"32";"32";"32";"0";"0";"457151";"373862"
"V4mis1";"SILVA (only NR);Bacteria;Bacteroidota;Bacteroidia;Flavobacteriales;Flavobacteriaceae;Kriegella;";"100.0";"18.2";"2";"2";"2";"0";"0";"457181";"373892"
"V4mis1";"SILVA (only NR);Bacteria;Bacteroidota;Bacteroidia;Flavobacteriales;Flavobacteriaceae;Lacinutrix;";"100.0";"18.2";"20";"20";"20";"0";"0";"457163";"373874"
"V4mis1";"SILVA (only NR);Bacteria;Bacteroidota;Bacteroidia;Flavobacteriales;Flavobacteriaceae;Leeuwenhoekiella;";"87.5";"18.2";"24";"24";"21";"3";"0";"457159";"373873"
"V4mis1";"SILVA (only NR);Bacteria;Bacteroidota;Bacteroidia;Flavobacteriales;Flavobacteriaceae;Leptobacterium;";"100.0";"18.2";"2";"2";"2";"0";"0";"457181";"373892"
"V4mis1";"SILVA (only NR);Bacteria;Bacteroidota;Bacteroidia;Flavobacteriales;Flavobacteriaceae;Litoribaculum;";"100.0";"18.2";"1";"1";"1";"0";"0";"457182";"373893"
"V4mis1";"SILVA (only NR);Bacteria;Bacteroidota;Bacteroidia;Flavobacteriales;Flavobacteriaceae;Lutaonella;";"100.0";"18.2";"1";"1";"1";"0";"0";"457182";"373893"
"V4mis1";"SILVA (only NR);Bacteria;Bacteroidota;Bacteroidia;Flavobacteriales;Flavobacteriaceae;Lutibacter;";"100.0";"18.2";"68";"68";"68";"0";"0";"457115";"373826"
"V4mis1";"SILVA (only NR);Bacteria;Bacteroidota;Bacteroidia;Flavobacteriales;Flavobacteriaceae;Lutimonas;";"100.0";"18.2";"14";"14";"14";"0";"0";"457169";"373880"
"V4mis1";"SILVA (only NR);Bacteria;Bacteroidota;Bacteroidia;Flavobacteriales;Flavobacteriaceae;Mangrovimonas;";"100.0";"18.2";"5";"5";"5";"0";"0";"457178";"373889"
"V4mis1";"SILVA (only NR);Bacteria;Bacteroidota;Bacteroidia;Flavobacteriales;Flavobacteriaceae;Maribacter;";"94.4";"18.2";"124";"124";"117";"7";"0";"457059";"373777"
"V4mis1";"SILVA (only NR);Bacteria;Bacteroidota;Bacteroidia;Flavobacteriales;Flavobacteriaceae;Mariniflexile;";"100.0";"18.2";"10";"10";"10";"0";"0";"457173";"373884"
"V4mis1";"SILVA (only NR);Bacteria;Bacteroidota;Bacteroidia;Flavobacteriales;Flavobacteriaceae;Maritimimonas;";"96.3";"18.2";"135";"135";"130";"5";"0";"457048";"373764"
"V4mis1";"SILVA (only NR);Bacteria;Bacteroidota;Bacteroidia;Flavobacteriales;Flavobacteriaceae;Marixanthomonas;";"100.0";"18.2";"10";"10";"10";"0";"0";"457173";"373884"
"V4mis1";"SILVA (only NR);Bacteria;Bacteroidota;Bacteroidia;Flavobacteriales;Flavobacteriaceae;Meridianimaribacter;";"100.0";"18.2";"4";"4";"4";"0";"0";"457179";"373890"
"V4mis1";"SILVA (only NR);Bacteria;Bacteroidota;Bacteroidia;Flavobacteriales;Flavobacteriaceae;Mesoflavibacter;";"95.0";"18.2";"20";"20";"19";"1";"0";"457163";"373875"
"V4mis1";"SILVA (only NR);Bacteria;Bacteroidota;Bacteroidia;Flavobacteriales;Flavobacteriaceae;Mesonia;";"84.0";"18.2";"25";"25";"21";"4";"0";"457158";"373873"
"V4mis1";"SILVA (only NR);Bacteria;Bacteroidota;Bacteroidia;Flavobacteriales;Flavobacteriaceae;Muricauda;";"99.1";"18.2";"111";"111";"110";"1";"0";"457072";"373784"
"V4mis1";"SILVA (only NR);Bacteria;Bacteroidota;Bacteroidia;Flavobacteriales;Flavobacteriaceae;Muriicola;";"100.0";"18.2";"8";"8";"8";"0";"0";"457175";"373886"
"V4mis1";"SILVA (only NR);Bacteria;Bacteroidota;Bacteroidia;Flavobacteriales;Flavobacteriaceae;Myroides;";"92.1";"18.2";"89";"89";"82";"7";"0";"457094";"373812"
"V4mis1";"SILVA (only NR);Bacteria;Bacteroidota;Bacteroidia;Flavobacteriales;Flavobacteriaceae;NS2b marine group;";"100.0";"18.2";"54";"54";"54";"0";"0";"457129";"373840"
"V4mis1";"SILVA (only NR);Bacteria;Bacteroidota;Bacteroidia;Flavobacteriales;Flavobacteriaceae;NS3a marine group;";"94.3";"18.2";"35";"35";"33";"2";"0";"457148";"373861"
"V4mis1";"SILVA (only NR);Bacteria;Bacteroidota;Bacteroidia;Flavobacteriales;Flavobacteriaceae;NS4 marine group;";"97.2";"18.2";"144";"144";"140";"4";"0";"457039";"373754"
"V4mis1";"SILVA (only NR);Bacteria;Bacteroidota;Bacteroidia;Flavobacteriales;Flavobacteriaceae;NS5 marine group;";"98.4";"18.2";"249";"249";"245";"4";"0";"456934";"373649"
"V4mis1";"SILVA (only NR);Bacteria;Bacteroidota;Bacteroidia;Flavobacteriales;Flavobacteriaceae;Neptunitalea;";"100.0";"18.2";"4";"4";"4";"0";"0";"457179";"373890"
"V4mis1";"SILVA (only NR);Bacteria;Bacteroidota;Bacteroidia;Flavobacteriales;Flavobacteriaceae;Nonlabens;";"94.5";"18.2";"55";"55";"52";"3";"0";"457128";"373842"
"V4mis1";"SILVA (only NR);Bacteria;Bacteroidota;Bacteroidia;Flavobacteriales;Flavobacteriaceae;Ochrovirga;";"100.0";"18.2";"1";"1";"1";"0";"0";"457182";"373893"
"V4mis1";"SILVA (only NR);Bacteria;Bacteroidota;Bacteroidia;Flavobacteriales;Flavobacteriaceae;Olleya;";"100.0";"18.2";"20";"20";"20";"0";"0";"457163";"373874"
"V4mis1";"SILVA (only NR);Bacteria;Bacteroidota;Bacteroidia;Flavobacteriales;Flavobacteriaceae;Pibocella;";"100.0";"18.2";"7";"7";"7";"0";"0";"457176";"373887"
"V4mis1";"SILVA (only NR);Bacteria;Bacteroidota;Bacteroidia;Flavobacteriales;Flavobacteriaceae;Planktosalinus;";"100.0";"18.2";"12";"12";"12";"0";"0";"457171";"373882"
"V4mis1";"SILVA (only NR);Bacteria;Bacteroidota;Bacteroidia;Flavobacteriales;Flavobacteriaceae;Polaribacter;";"95.6";"18.2";"181";"181";"173";"8";"0";"457002";"373721"
"V4mis1";"SILVA (only NR);Bacteria;Bacteroidota;Bacteroidia;Flavobacteriales;Flavobacteriaceae;Postechiella;";"100.0";"18.2";"3";"3";"3";"0";"0";"457180";"373891"
"V4mis1";"SILVA (only NR);Bacteria;Bacteroidota;Bacteroidia;Flavobacteriales;Flavobacteriaceae;Pricia;";"80.0";"18.2";"10";"10";"8";"2";"0";"457173";"373886"
"V4mis1";"SILVA (only NR);Bacteria;Bacteroidota;Bacteroidia;Flavobacteriales;Flavobacteriaceae;Pseudofulvibacter;";"93.8";"18.2";"129";"129";"121";"8";"0";"457054";"373773"
"V4mis1";"SILVA (only NR);Bacteria;Bacteroidota;Bacteroidia;Flavobacteriales;Flavobacteriaceae;Pseudozobellia;";"100.0";"18.2";"2";"2";"2";"0";"0";"457181";"373892"
"V4mis1";"SILVA (only NR);Bacteria;Bacteroidota;Bacteroidia;Flavobacteriales;Flavobacteriaceae;Psychroflexus;";"93.2";"18.2";"103";"103";"96";"7";"0";"457080";"373798"
"V4mis1";"SILVA (only NR);Bacteria;Bacteroidota;Bacteroidia;Flavobacteriales;Flavobacteriaceae;Psychroserpens;";"97.1";"18.2";"35";"35";"34";"1";"0";"457148";"373860"
"V4mis1";"SILVA (only NR);Bacteria;Bacteroidota;Bacteroidia;Flavobacteriales;Flavobacteriaceae;Pustulibacterium;";"100.0";"18.2";"1";"1";"1";"0";"0";"457182";"373893"
"V4mis1";"SILVA (only NR);Bacteria;Bacteroidota;Bacteroidia;Flavobacteriales;Flavobacteriaceae;Robertkochia;";"100.0";"18.2";"1";"1";"1";"0";"0";"457182";"373893"
"V4mis1";"SILVA (only NR);Bacteria;Bacteroidota;Bacteroidia;Flavobacteriales;Flavobacteriaceae;Robiginitalea;";"93.5";"18.2";"46";"46";"43";"3";"0";"457137";"373851"
"V4mis1";"SILVA (only NR);Bacteria;Bacteroidota;Bacteroidia;Flavobacteriales;Flavobacteriaceae;Sabulilitoribacter;";"100.0";"18.2";"2";"2";"2";"0";"0";"457181";"373892"
"V4mis1";"SILVA (only NR);Bacteria;Bacteroidota;Bacteroidia;Flavobacteriales;Flavobacteriaceae;Salegentibacter;";"92.7";"18.2";"82";"82";"76";"6";"0";"457101";"373818"
"V4mis1";"SILVA (only NR);Bacteria;Bacteroidota;Bacteroidia;Flavobacteriales;Flavobacteriaceae;Salinimicrobium;";"93.7";"18.2";"79";"79";"74";"5";"0";"457104";"373820"
"V4mis1";"SILVA (only NR);Bacteria;Bacteroidota;Bacteroidia;Flavobacteriales;Flavobacteriaceae;Sediminibacter;";"100.0";"18.2";"4";"4";"4";"0";"0";"457179";"373890"
"V4mis1";"SILVA (only NR);Bacteria;Bacteroidota;Bacteroidia;Flavobacteriales;Flavobacteriaceae;Sediminicola;";"100.0";"18.2";"14";"14";"14";"0";"0";"457169";"373880"
"V4mis1";"SILVA (only NR);Bacteria;Bacteroidota;Bacteroidia;Flavobacteriales;Flavobacteriaceae;Seonamhaeicola;";"100.0";"18.2";"14";"14";"14";"0";"0";"457169";"373880"
"V4mis1";"SILVA (only NR);Bacteria;Bacteroidota;Bacteroidia;Flavobacteriales;Flavobacteriaceae;Siansivirga;";"100.0";"18.2";"3";"3";"3";"0";"0";"457180";"373891"
"V4mis1";"SILVA (only NR);Bacteria;Bacteroidota;Bacteroidia;Flavobacteriales;Flavobacteriaceae;Sinomicrobium;";"100.0";"18.2";"11";"11";"11";"0";"0";"457172";"373883"
"V4mis1";"SILVA (only NR);Bacteria;Bacteroidota;Bacteroidia;Flavobacteriales;Flavobacteriaceae;Snuella;";"100.0";"18.2";"2";"2";"2";"0";"0";"457181";"373892"
"V4mis1";"SILVA (only NR);Bacteria;Bacteroidota;Bacteroidia;Flavobacteriales;Flavobacteriaceae;Spongiibacterium;";"100.0";"18.2";"7";"7";"7";"0";"0";"457176";"373887"
"V4mis1";"SILVA (only NR);Bacteria;Bacteroidota;Bacteroidia;Flavobacteriales;Flavobacteriaceae;Spongiiferula;";"100.0";"18.2";"2";"2";"2";"0";"0";"457181";"373892"
"V4mis1";"SILVA (only NR);Bacteria;Bacteroidota;Bacteroidia;Flavobacteriales;Flavobacteriaceae;Spongiimicrobium;";"100.0";"18.2";"5";"5";"5";"0";"0";"457178";"373889"
"V4mis1";"SILVA (only NR);Bacteria;Bacteroidota;Bacteroidia;Flavobacteriales;Flavobacteriaceae;Spongiimonas;";"100.0";"18.2";"5";"5";"5";"0";"0";"457178";"373889"
"V4mis1";"SILVA (only NR);Bacteria;Bacteroidota;Bacteroidia;Flavobacteriales;Flavobacteriaceae;Spongiivirga;";"100.0";"18.2";"5";"5";"5";"0";"0";"457178";"373889"
"V4mis1";"SILVA (only NR);Bacteria;Bacteroidota;Bacteroidia;Flavobacteriales;Flavobacteriaceae;Subsaxibacter;";"100.0";"18.2";"17";"17";"17";"0";"0";"457166";"373877"
"V4mis1";"SILVA (only NR);Bacteria;Bacteroidota;Bacteroidia;Flavobacteriales;Flavobacteriaceae;Subsaximicrobium;";"75.0";"18.2";"4";"4";"3";"1";"0";"457179";"373891"
"V4mis1";"SILVA (only NR);Bacteria;Bacteroidota;Bacteroidia;Flavobacteriales;Flavobacteriaceae;Sufflavibacter;";"100.0";"18.2";"1";"1";"1";"0";"0";"457182";"373893"
"V4mis1";"SILVA (only NR);Bacteria;Bacteroidota;Bacteroidia;Flavobacteriales;Flavobacteriaceae;Sungkyunkwania;";"100.0";"18.2";"4";"4";"4";"0";"0";"457179";"373890"
"V4mis1";"SILVA (only NR);Bacteria;Bacteroidota;Bacteroidia;Flavobacteriales;Flavobacteriaceae;Tamlana;";"88.9";"18.2";"18";"18";"16";"2";"0";"457165";"373878"
"V4mis1";"SILVA (only NR);Bacteria;Bacteroidota;Bacteroidia;Flavobacteriales;Flavobacteriaceae;Tenacibaculum;";"96.9";"18.2";"227";"227";"220";"7";"0";"456956";"373674"
"V4mis1";"SILVA (only NR);Bacteria;Bacteroidota;Bacteroidia;Flavobacteriales;Flavobacteriaceae;Ulvibacter;";"96.8";"18.2";"63";"63";"61";"2";"0";"457120";"373833"
"V4mis1";"SILVA (only NR);Bacteria;Bacteroidota;Bacteroidia;Flavobacteriales;Flavobacteriaceae;Vitellibacter;";"95.7";"18.2";"23";"23";"22";"1";"0";"457160";"373872"
"V4mis1";"SILVA (only NR);Bacteria;Bacteroidota;Bacteroidia;Flavobacteriales;Flavobacteriaceae;Wenyingzhuangia;";"100.0";"18.2";"12";"12";"12";"0";"0";"457171";"373882"
"V4mis1";"SILVA (only NR);Bacteria;Bacteroidota;Bacteroidia;Flavobacteriales;Flavobacteriaceae;Winogradskyella;";"96.2";"18.2";"131";"131";"126";"5";"0";"457052";"373768"
"V4mis1";"SILVA (only NR);Bacteria;Bacteroidota;Bacteroidia;Flavobacteriales;Flavobacteriaceae;Xanthomarina;";"66.7";"18.2";"6";"6";"4";"2";"0";"457177";"373890"
"V4mis1";"SILVA (only NR);Bacteria;Bacteroidota;Bacteroidia;Flavobacteriales;Flavobacteriaceae;Yeosuana;";"100.0";"18.2";"3";"3";"3";"0";"0";"457180";"373891"
"V4mis1";"SILVA (only NR);Bacteria;Bacteroidota;Bacteroidia;Flavobacteriales;Flavobacteriaceae;Zeaxanthinibacter;";"95.5";"18.2";"22";"22";"21";"1";"0";"457161";"373873"
"V4mis1";"SILVA (only NR);Bacteria;Bacteroidota;Bacteroidia;Flavobacteriales;Flavobacteriaceae;Zhouia;";"100.0";"18.2";"2";"2";"2";"0";"0";"457181";"373892"
"V4mis1";"SILVA (only NR);Bacteria;Bacteroidota;Bacteroidia;Flavobacteriales;Flavobacteriaceae;Zobellia;";"94.7";"18.2";"19";"19";"18";"1";"0";"457164";"373876"
"V4mis1";"SILVA (only NR);Bacteria;Bacteroidota;Bacteroidia;Flavobacteriales;Flavobacteriaceae;Zunongwangia;";"93.8";"18.2";"16";"16";"15";"1";"0";"457167";"373879"
"V4mis1";"SILVA (only NR);Bacteria;Bacteroidota;Bacteroidia;Flavobacteriales;Flavobacteriaceae;uncultured;";"92.2";"18.2";"361";"361";"333";"28";"0";"456822";"373561"
"V4mis1";"SILVA (only NR);Bacteria;Bacteroidota;Bacteroidia;Flavobacteriales;Flavobacteriales Incertae Sedis;";"100.0";"18.2";"11";"11";"11";"0";"0";"457172";"373883"
"V4mis1";"SILVA (only NR);Bacteria;Bacteroidota;Bacteroidia;Flavobacteriales;Flavobacteriales Incertae Sedis;Ichthyobacterium;";"100.0";"18.2";"11";"11";"11";"0";"0";"457172";"373883"
"V4mis1";"SILVA (only NR);Bacteria;Bacteroidota;Bacteroidia;Flavobacteriales;NS7 marine group;";"97.6";"18.2";"42";"42";"41";"1";"0";"457141";"373853"
"V4mis1";"SILVA (only NR);Bacteria;Bacteroidota;Bacteroidia;Flavobacteriales;NS9 marine group;";"96.4";"18.2";"477";"477";"460";"17";"0";"456706";"373434"
"V4mis1";"SILVA (only NR);Bacteria;Bacteroidota;Bacteroidia;Flavobacteriales;Schleiferiaceae;";"100.0";"18.2";"48";"48";"48";"0";"0";"457135";"373846"
"V4mis1";"SILVA (only NR);Bacteria;Bacteroidota;Bacteroidia;Flavobacteriales;Schleiferiaceae;Schleiferia;";"100.0";"18.2";"48";"48";"48";"0";"0";"457135";"373846"
"V4mis1";"SILVA (only NR);Bacteria;Bacteroidota;Bacteroidia;Flavobacteriales;Weeksellaceae;";"93.3";"18.3";"1433";"1433";"1337";"96";"0";"455750";"372557"
"V4mis1";"SILVA (only NR);Bacteria;Bacteroidota;Bacteroidia;Flavobacteriales;Weeksellaceae;Algoriella;";"100.0";"18.2";"2";"2";"2";"0";"0";"457181";"373892"
"V4mis1";"SILVA (only NR);Bacteria;Bacteroidota;Bacteroidia;Flavobacteriales;Weeksellaceae;Apibacter;";"100.0";"18.2";"9";"9";"9";"0";"0";"457174";"373885"
"V4mis1";"SILVA (only NR);Bacteria;Bacteroidota;Bacteroidia;Flavobacteriales;Weeksellaceae;Bergeyella;";"88.4";"18.2";"138";"138";"122";"16";"0";"457045";"373772"
"V4mis1";"SILVA (only NR);Bacteria;Bacteroidota;Bacteroidia;Flavobacteriales;Weeksellaceae;Candidatus Hemobacterium;";"100.0";"18.2";"1";"1";"1";"0";"0";"457182";"373893"
"V4mis1";"SILVA (only NR);Bacteria;Bacteroidota;Bacteroidia;Flavobacteriales;Weeksellaceae;Chishuiella;";"75.0";"18.2";"4";"4";"3";"1";"0";"457179";"373891"
"V4mis1";"SILVA (only NR);Bacteria;Bacteroidota;Bacteroidia;Flavobacteriales;Weeksellaceae;Chryseobacterium;";"97.5";"18.2";"750";"750";"731";"19";"0";"456433";"373163"
"V4mis1";"SILVA (only NR);Bacteria;Bacteroidota;Bacteroidia;Flavobacteriales;Weeksellaceae;Cloacibacterium;";"81.5";"18.2";"227";"227";"185";"42";"0";"456956";"373709"
"V4mis1";"SILVA (only NR);Bacteria;Bacteroidota;Bacteroidia;Flavobacteriales;Weeksellaceae;Cruoricaptor;";"100.0";"18.2";"2";"2";"2";"0";"0";"457181";"373892"
"V4mis1";"SILVA (only NR);Bacteria;Bacteroidota;Bacteroidia;Flavobacteriales;Weeksellaceae;Elizabethkingia;";"95.2";"18.2";"62";"62";"59";"3";"0";"457121";"373835"
"V4mis1";"SILVA (only NR);Bacteria;Bacteroidota;Bacteroidia;Flavobacteriales;Weeksellaceae;Empedobacter;";"85.2";"18.2";"27";"27";"23";"4";"0";"457156";"373871"
"V4mis1";"SILVA (only NR);Bacteria;Bacteroidota;Bacteroidia;Flavobacteriales;Weeksellaceae;Moheibacter;";"88.4";"18.2";"43";"43";"38";"5";"0";"457140";"373856"
"V4mis1";"SILVA (only NR);Bacteria;Bacteroidota;Bacteroidia;Flavobacteriales;Weeksellaceae;Ornithobacterium;";"97.2";"18.2";"36";"36";"35";"1";"0";"457147";"373859"
"V4mis1";"SILVA (only NR);Bacteria;Bacteroidota;Bacteroidia;Flavobacteriales;Weeksellaceae;Riemerella;";"94.1";"18.2";"34";"34";"32";"2";"0";"457149";"373862"
"V4mis1";"SILVA (only NR);Bacteria;Bacteroidota;Bacteroidia;Flavobacteriales;Weeksellaceae;Soonwooa;";"100.0";"18.2";"5";"5";"5";"0";"0";"457178";"373889"
"V4mis1";"SILVA (only NR);Bacteria;Bacteroidota;Bacteroidia;Flavobacteriales;Weeksellaceae;Wautersiella;";"100.0";"18.2";"3";"3";"3";"0";"0";"457180";"373891"
"V4mis1";"SILVA (only NR);Bacteria;Bacteroidota;Bacteroidia;Flavobacteriales;Weeksellaceae;Weeksella;";"100.0";"18.2";"10";"10";"10";"0";"0";"457173";"373884"
"V4mis1";"SILVA (only NR);Bacteria;Bacteroidota;Bacteroidia;Flavobacteriales;Weeksellaceae;uncultured;";"95.8";"18.2";"72";"72";"69";"3";"0";"457111";"373825"
"V4mis1";"SILVA (only NR);Bacteria;Bacteroidota;Bacteroidia;ML602M-17;";"90.0";"18.2";"10";"10";"9";"1";"0";"457173";"373885"
"V4mis1";"SILVA (only NR);Bacteria;Bacteroidota;Bacteroidia;SM1A07;";"96.6";"18.2";"59";"59";"57";"2";"0";"457124";"373837"
"V4mis1";"SILVA (only NR);Bacteria;Bacteroidota;Bacteroidia;Sphingobacteriales;";"95.5";"18.3";"2824";"2824";"2696";"128";"0";"454359";"371198"
"V4mis1";"SILVA (only NR);Bacteria;Bacteroidota;Bacteroidia;Sphingobacteriales;ADurb.Bin408;";"100.0";"18.2";"7";"7";"7";"0";"0";"457176";"373887"
"V4mis1";"SILVA (only NR);Bacteria;Bacteroidota;Bacteroidia;Sphingobacteriales;AKYH767;";"96.2";"18.2";"106";"106";"102";"4";"0";"457077";"373792"
"V4mis1";"SILVA (only NR);Bacteria;Bacteroidota;Bacteroidia;Sphingobacteriales;CMW-169;";"100.0";"18.2";"7";"7";"7";"0";"0";"457176";"373887"
"V4mis1";"SILVA (only NR);Bacteria;Bacteroidota;Bacteroidia;Sphingobacteriales;CWT CU03-E12;";"100.0";"18.2";"6";"6";"6";"0";"0";"457177";"373888"
"V4mis1";"SILVA (only NR);Bacteria;Bacteroidota;Bacteroidia;Sphingobacteriales;E6aC02;";"90.7";"18.2";"86";"86";"78";"8";"0";"457097";"373816"
"V4mis1";"SILVA (only NR);Bacteria;Bacteroidota;Bacteroidia;Sphingobacteriales;FFCH9454;";"100.0";"18.2";"6";"6";"6";"0";"0";"457177";"373888"
"V4mis1";"SILVA (only NR);Bacteria;Bacteroidota;Bacteroidia;Sphingobacteriales;GWF2-29-10;";"100.0";"18.2";"5";"5";"5";"0";"0";"457178";"373889"
"V4mis1";"SILVA (only NR);Bacteria;Bacteroidota;Bacteroidia;Sphingobacteriales;KD1-131;";"100.0";"18.2";"15";"15";"15";"0";"0";"457168";"373879"
"V4mis1";"SILVA (only NR);Bacteria;Bacteroidota;Bacteroidia;Sphingobacteriales;KD3-93;";"100.0";"18.2";"49";"49";"49";"0";"0";"457134";"373845"
"V4mis1";"SILVA (only NR);Bacteria;Bacteroidota;Bacteroidia;Sphingobacteriales;Lentimicrobiaceae;";"94.4";"18.2";"534";"534";"504";"30";"0";"456649";"373390"
"V4mis1";"SILVA (only NR);Bacteria;Bacteroidota;Bacteroidia;Sphingobacteriales;Lentimicrobiaceae;Lentimicrobium;";"94.0";"18.2";"266";"266";"250";"16";"0";"456917";"373644"
"V4mis1";"SILVA (only NR);Bacteria;Bacteroidota;Bacteroidia;Sphingobacteriales;LiUU-11-161;";"95.0";"18.2";"20";"20";"19";"1";"0";"457163";"373875"
"V4mis1";"SILVA (only NR);Bacteria;Bacteroidota;Bacteroidia;Sphingobacteriales;NS11-12 marine group;";"95.4";"18.2";"196";"196";"187";"9";"0";"456987";"373707"
"V4mis1";"SILVA (only NR);Bacteria;Bacteroidota;Bacteroidia;Sphingobacteriales;S15-21;";"100.0";"18.2";"2";"2";"2";"0";"0";"457181";"373892"
"V4mis1";"SILVA (only NR);Bacteria;Bacteroidota;Bacteroidia;Sphingobacteriales;S15A-MN91;";"85.7";"18.2";"14";"14";"12";"2";"0";"457169";"373882"
"V4mis1";"SILVA (only NR);Bacteria;Bacteroidota;Bacteroidia;Sphingobacteriales;SBYC-2600;";"100.0";"18.2";"3";"3";"3";"0";"0";"457180";"373891"
"V4mis1";"SILVA (only NR);Bacteria;Bacteroidota;Bacteroidia;Sphingobacteriales;ST-12K33;";"95.9";"18.2";"49";"49";"47";"2";"0";"457134";"373847"
"V4mis1";"SILVA (only NR);Bacteria;Bacteroidota;Bacteroidia;Sphingobacteriales;Sphingobacteriaceae;";"95.8";"18.3";"1491";"1491";"1429";"62";"0";"455692";"372465"
"V4mis1";"SILVA (only NR);Bacteria;Bacteroidota;Bacteroidia;Sphingobacteriales;Sphingobacteriaceae;Anseongella;";"100.0";"18.2";"8";"8";"8";"0";"0";"457175";"373886"
"V4mis1";"SILVA (only NR);Bacteria;Bacteroidota;Bacteroidia;Sphingobacteriales;Sphingobacteriaceae;Arcticibacter;";"100.0";"18.2";"22";"22";"22";"0";"0";"457161";"373872"
"V4mis1";"SILVA (only NR);Bacteria;Bacteroidota;Bacteroidia;Sphingobacteriales;Sphingobacteriaceae;Mucilaginibacter;";"97.7";"18.2";"309";"309";"302";"7";"0";"456874";"373592"
"V4mis1";"SILVA (only NR);Bacteria;Bacteroidota;Bacteroidia;Sphingobacteriales;Sphingobacteriaceae;Nubsella;";"100.0";"18.2";"21";"21";"21";"0";"0";"457162";"373873"
"V4mis1";"SILVA (only NR);Bacteria;Bacteroidota;Bacteroidia;Sphingobacteriales;Sphingobacteriaceae;Olivibacter;";"100.0";"18.2";"33";"33";"33";"0";"0";"457150";"373861"
"V4mis1";"SILVA (only NR);Bacteria;Bacteroidota;Bacteroidia;Sphingobacteriales;Sphingobacteriaceae;Parapedobacter;";"98.0";"18.2";"51";"51";"50";"1";"0";"457132";"373844"
"V4mis1";"SILVA (only NR);Bacteria;Bacteroidota;Bacteroidia;Sphingobacteriales;Sphingobacteriaceae;Pedobacter;";"97.1";"18.2";"518";"518";"503";"15";"0";"456665";"373391"
"V4mis1";"SILVA (only NR);Bacteria;Bacteroidota;Bacteroidia;Sphingobacteriales;Sphingobacteriaceae;Pelobium;";"100.0";"18.2";"4";"4";"4";"0";"0";"457179";"373890"
"V4mis1";"SILVA (only NR);Bacteria;Bacteroidota;Bacteroidia;Sphingobacteriales;Sphingobacteriaceae;Pseudopedobacter;";"83.3";"18.2";"18";"18";"15";"3";"0";"457165";"373879"
"V4mis1";"SILVA (only NR);Bacteria;Bacteroidota;Bacteroidia;Sphingobacteriales;Sphingobacteriaceae;Pseudosphingobacterium;";"100.0";"18.2";"6";"6";"6";"0";"0";"457177";"373888"
"V4mis1";"SILVA (only NR);Bacteria;Bacteroidota;Bacteroidia;Sphingobacteriales;Sphingobacteriaceae;Solitalea;";"88.2";"18.2";"34";"34";"30";"4";"0";"457149";"373864"
"V4mis1";"SILVA (only NR);Bacteria;Bacteroidota;Bacteroidia;Sphingobacteriales;Sphingobacteriaceae;Sphingobacterium;";"92.4";"18.2";"380";"380";"351";"29";"0";"456803";"373543"
"V4mis1";"SILVA (only NR);Bacteria;Bacteroidota;Bacteroidia;Sphingobacteriales;Sphingobacteriaceae;uncultured;";"96.2";"18.2";"79";"79";"76";"3";"0";"457104";"373818"
"V4mis1";"SILVA (only NR);Bacteria;Bacteroidota;Bacteroidia;Sphingobacteriales;Z4MB62;";"100.0";"18.2";"3";"3";"3";"0";"0";"457180";"373891"
"V4mis1";"SILVA (only NR);Bacteria;Bacteroidota;Bacteroidia;Sphingobacteriales;env.OPS 17;";"95.3";"18.2";"212";"212";"202";"10";"0";"456971";"373692"
"V4mis1";"SILVA (only NR);Bacteria;Bacteroidota;Bacteroidia;Sphingobacteriales;s74e-6049;";"100.0";"18.2";"4";"4";"4";"0";"0";"457179";"373890"
"V4mis1";"SILVA (only NR);Bacteria;Bacteroidota;Bacteroidia;Sphingobacteriales;uncultured;";"100.0";"18.2";"3";"3";"3";"0";"0";"457180";"373891"
"V4mis1";"SILVA (only NR);Bacteria;Bacteroidota;Chlorobia;";"94.8";"18.2";"153";"153";"145";"8";"0";"457030";"373749"
"V4mis1";"SILVA (only NR);Bacteria;Bacteroidota;Chlorobia;Chlorobiales;";"94.8";"18.2";"153";"153";"145";"8";"0";"457030";"373749"
"V4mis1";"SILVA (only NR);Bacteria;Bacteroidota;Chlorobia;Chlorobiales;Chlorobiaceae;";"95.5";"18.2";"134";"134";"128";"6";"0";"457049";"373766"
"V4mis1";"SILVA (only NR);Bacteria;Bacteroidota;Chlorobia;Chlorobiales;Chlorobiaceae;Chlorobaculum;";"94.7";"18.2";"38";"38";"36";"2";"0";"457145";"373858"
"V4mis1";"SILVA (only NR);Bacteria;Bacteroidota;Chlorobia;Chlorobiales;Chlorobiaceae;Chlorobium;";"97.1";"18.2";"70";"70";"68";"2";"0";"457113";"373826"
"V4mis1";"SILVA (only NR);Bacteria;Bacteroidota;Chlorobia;Chlorobiales;Chlorobiaceae;Prosthecochloris;";"91.3";"18.2";"23";"23";"21";"2";"0";"457160";"373873"
"V4mis1";"SILVA (only NR);Bacteria;Bacteroidota;Chlorobia;Chlorobiales;Chlorobiaceae;uncultured;";"100.0";"18.2";"3";"3";"3";"0";"0";"457180";"373891"
"V4mis1";"SILVA (only NR);Bacteria;Bacteroidota;Chlorobia;Chlorobiales;Chloroherpetonaceae;";"89.5";"18.2";"19";"19";"17";"2";"0";"457164";"373877"
"V4mis1";"SILVA (only NR);Bacteria;Bacteroidota;Chlorobia;Chlorobiales;Chloroherpetonaceae;Chloroherpeton;";"100.0";"18.2";"4";"4";"4";"0";"0";"457179";"373890"
"V4mis1";"SILVA (only NR);Bacteria;Bacteroidota;Chlorobia;Chlorobiales;Chloroherpetonaceae;GBChlB;";"86.7";"18.2";"15";"15";"13";"2";"0";"457168";"373881"
"V4mis1";"SILVA (only NR);Bacteria;Bacteroidota;Ignavibacteria;";"95.5";"18.2";"378";"378";"361";"17";"0";"456805";"373533"
"V4mis1";"SILVA (only NR);Bacteria;Bacteroidota;Ignavibacteria;Ignavibacteriales;";"95.4";"18.2";"282";"282";"269";"13";"0";"456901";"373625"
"V4mis1";"SILVA (only NR);Bacteria;Bacteroidota;Ignavibacteria;Ignavibacteriales;BSN166;";"100.0";"18.2";"6";"6";"6";"0";"0";"457177";"373888"
"V4mis1";"SILVA (only NR);Bacteria;Bacteroidota;Ignavibacteria;Ignavibacteriales;BSV40;";"100.0";"18.2";"11";"11";"11";"0";"0";"457172";"373883"
"V4mis1";"SILVA (only NR);Bacteria;Bacteroidota;Ignavibacteria;Ignavibacteriales;Ignavibacteriaceae;";"92.1";"18.2";"76";"76";"70";"6";"0";"457107";"373824"
"V4mis1";"SILVA (only NR);Bacteria;Bacteroidota;Ignavibacteria;Ignavibacteriales;Ignavibacteriaceae;Ignavibacterium;";"92.1";"18.2";"76";"76";"70";"6";"0";"457107";"373824"
"V4mis1";"SILVA (only NR);Bacteria;Bacteroidota;Ignavibacteria;Ignavibacteriales;LD-RB-34;";"100.0";"18.2";"15";"15";"15";"0";"0";"457168";"373879"
"V4mis1";"SILVA (only NR);Bacteria;Bacteroidota;Ignavibacteria;Ignavibacteriales;Melioribacteraceae;";"95.9";"18.2";"73";"73";"70";"3";"0";"457110";"373824"
"V4mis1";"SILVA (only NR);Bacteria;Bacteroidota;Ignavibacteria;Ignavibacteriales;Melioribacteraceae;IheB3-7;";"94.9";"18.2";"59";"59";"56";"3";"0";"457124";"373838"
"V4mis1";"SILVA (only NR);Bacteria;Bacteroidota;Ignavibacteria;Ignavibacteriales;Melioribacteraceae;Melioribacter;";"100.0";"18.2";"13";"13";"13";"0";"0";"457170";"373881"
"V4mis1";"SILVA (only NR);Bacteria;Bacteroidota;Ignavibacteria;Ignavibacteriales;PHOS-HE36;";"97.0";"18.2";"67";"67";"65";"2";"0";"457116";"373829"
"V4mis1";"SILVA (only NR);Bacteria;Bacteroidota;Ignavibacteria;Ignavibacteriales;SM1H02;";"100.0";"18.2";"8";"8";"8";"0";"0";"457175";"373886"
"V4mis1";"SILVA (only NR);Bacteria;Bacteroidota;Ignavibacteria;Ignavibacteriales;SR-FBR-L83;";"90.0";"18.2";"20";"20";"18";"2";"0";"457163";"373876"
"V4mis1";"SILVA (only NR);Bacteria;Bacteroidota;Ignavibacteria;Ignavibacteriales;UA-50;";"100.0";"18.2";"3";"3";"3";"0";"0";"457180";"373891"
"V4mis1";"SILVA (only NR);Bacteria;Bacteroidota;Ignavibacteria;SJA-28;";"95.8";"18.2";"96";"96";"92";"4";"0";"457087";"373802"
"V4mis1";"SILVA (only NR);Bacteria;Bacteroidota;Kapabacteria;";"96.3";"18.2";"246";"246";"237";"9";"0";"456937";"373657"
"V4mis1";"SILVA (only NR);Bacteria;Bacteroidota;Kapabacteria;Kapabacteriales;";"96.3";"18.2";"246";"246";"237";"9";"0";"456937";"373657"
"V4mis1";"SILVA (only NR);Bacteria;Bacteroidota;Kryptonia;";"95.3";"18.2";"170";"170";"162";"8";"0";"457013";"373732"
"V4mis1";"SILVA (only NR);Bacteria;Bacteroidota;Kryptonia;Kryptoniales;";"95.3";"18.2";"170";"170";"162";"8";"0";"457013";"373732"
"V4mis1";"SILVA (only NR);Bacteria;Bacteroidota;Kryptonia;Kryptoniales;BSV26;";"94.7";"18.2";"150";"150";"142";"8";"0";"457033";"373752"
"V4mis1";"SILVA (only NR);Bacteria;Bacteroidota;Kryptonia;Kryptoniales;Kryptoniaceae;";"100.0";"18.2";"7";"7";"7";"0";"0";"457176";"373887"
"V4mis1";"SILVA (only NR);Bacteria;Bacteroidota;Kryptonia;Kryptoniales;Kryptoniaceae;Candidatus Chrysopegis;";"100.0";"18.2";"1";"1";"1";"0";"0";"457182";"373893"
"V4mis1";"SILVA (only NR);Bacteria;Bacteroidota;Kryptonia;Kryptoniales;Kryptoniaceae;Candidatus Kryptobacter;";"100.0";"18.2";"1";"1";"1";"0";"0";"457182";"373893"
"V4mis1";"SILVA (only NR);Bacteria;Bacteroidota;Kryptonia;Kryptoniales;Kryptoniaceae;Candidatus Kryptonium;";"100.0";"18.2";"2";"2";"2";"0";"0";"457181";"373892"
"V4mis1";"SILVA (only NR);Bacteria;Bacteroidota;Kryptonia;Kryptoniales;Kryptoniaceae;Candidatus Thermokryptus;";"100.0";"18.2";"1";"1";"1";"0";"0";"457182";"373893"
"V4mis1";"SILVA (only NR);Bacteria;Bacteroidota;Kryptonia;Kryptoniales;MSB-3C8;";"100.0";"18.2";"13";"13";"13";"0";"0";"457170";"373881"
"V4mis1";"SILVA (only NR);Bacteria;Bacteroidota;OC31;";"75.0";"18.2";"8";"8";"6";"2";"0";"457175";"373888"
"V4mis1";"SILVA (only NR);Bacteria;Bacteroidota;Rhodothermia;";"94.6";"18.3";"2102";"2102";"1989";"113";"0";"455081";"371905"
"V4mis1";"SILVA (only NR);Bacteria;Bacteroidota;Rhodothermia;Balneolales;";"96.6";"18.2";"351";"351";"339";"12";"0";"456832";"373555"
"V4mis1";"SILVA (only NR);Bacteria;Bacteroidota;Rhodothermia;Balneolales;Balneolaceae;";"96.6";"18.2";"351";"351";"339";"12";"0";"456832";"373555"
"V4mis1";"SILVA (only NR);Bacteria;Bacteroidota;Rhodothermia;Balneolales;Balneolaceae;A815;";"100.0";"18.2";"2";"2";"2";"0";"0";"457181";"373892"
"V4mis1";"SILVA (only NR);Bacteria;Bacteroidota;Rhodothermia;Balneolales;Balneolaceae;Aliifodinibius;";"100.0";"18.2";"13";"13";"13";"0";"0";"457170";"373881"
"V4mis1";"SILVA (only NR);Bacteria;Bacteroidota;Rhodothermia;Balneolales;Balneolaceae;B2706-C7;";"100.0";"18.2";"4";"4";"4";"0";"0";"457179";"373890"
"V4mis1";"SILVA (only NR);Bacteria;Bacteroidota;Rhodothermia;Balneolales;Balneolaceae;Balneola;";"97.4";"18.2";"38";"38";"37";"1";"0";"457145";"373857"
"V4mis1";"SILVA (only NR);Bacteria;Bacteroidota;Rhodothermia;Balneolales;Balneolaceae;CK06-06-Mud-MAS4B-21;";"100.0";"18.2";"5";"5";"5";"0";"0";"457178";"373889"
"V4mis1";"SILVA (only NR);Bacteria;Bacteroidota;Rhodothermia;Balneolales;Balneolaceae;F1-37X2;";"100.0";"18.2";"7";"7";"7";"0";"0";"457176";"373887"
"V4mis1";"SILVA (only NR);Bacteria;Bacteroidota;Rhodothermia;Balneolales;Balneolaceae;Fodinibius;";"100.0";"18.2";"6";"6";"6";"0";"0";"457177";"373888"
"V4mis1";"SILVA (only NR);Bacteria;Bacteroidota;Rhodothermia;Balneolales;Balneolaceae;Gracilimonas;";"97.5";"18.2";"40";"40";"39";"1";"0";"457143";"373855"
"V4mis1";"SILVA (only NR);Bacteria;Bacteroidota;Rhodothermia;Balneolales;Balneolaceae;HK-RBC54;";"100.0";"18.2";"2";"2";"2";"0";"0";"457181";"373892"
"V4mis1";"SILVA (only NR);Bacteria;Bacteroidota;Rhodothermia;Balneolales;Balneolaceae;MAT-CR-P4-C12;";"100.0";"18.2";"11";"11";"11";"0";"0";"457172";"373883"
"V4mis1";"SILVA (only NR);Bacteria;Bacteroidota;Rhodothermia;Balneolales;Balneolaceae;ML310M-34;";"100.0";"18.2";"8";"8";"8";"0";"0";"457175";"373886"
"V4mis1";"SILVA (only NR);Bacteria;Bacteroidota;Rhodothermia;Balneolales;Balneolaceae;Rhodohalobacter;";"80.0";"18.2";"5";"5";"4";"1";"0";"457178";"373890"
"V4mis1";"SILVA (only NR);Bacteria;Bacteroidota;Rhodothermia;Balneolales;Balneolaceae;Soortia;";"100.0";"18.2";"2";"2";"2";"0";"0";"457181";"373892"
"V4mis1";"SILVA (only NR);Bacteria;Bacteroidota;Rhodothermia;Balneolales;Balneolaceae;uncultured;";"95.6";"18.2";"203";"203";"194";"9";"0";"456980";"373700"
"V4mis1";"SILVA (only NR);Bacteria;Bacteroidota;Rhodothermia;Rhodothermales;";"94.2";"18.3";"1751";"1751";"1650";"101";"0";"455432";"372244"
"V4mis1";"SILVA (only NR);Bacteria;Bacteroidota;Rhodothermia;Rhodothermales;Rhodothermaceae;";"94.2";"18.3";"1751";"1751";"1650";"101";"0";"455432";"372244"
"V4mis1";"SILVA (only NR);Bacteria;Bacteroidota;Rhodothermia;Rhodothermales;Rhodothermaceae;Longimonas;";"100.0";"18.2";"8";"8";"8";"0";"0";"457175";"373886"
"V4mis1";"SILVA (only NR);Bacteria;Bacteroidota;Rhodothermia;Rhodothermales;Rhodothermaceae;Natronotalea;";"100.0";"18.2";"2";"2";"2";"0";"0";"457181";"373892"
"V4mis1";"SILVA (only NR);Bacteria;Bacteroidota;Rhodothermia;Rhodothermales;Rhodothermaceae;Rhodothermus;";"83.3";"18.2";"18";"18";"15";"3";"0";"457165";"373879"
"V4mis1";"SILVA (only NR);Bacteria;Bacteroidota;Rhodothermia;Rhodothermales;Rhodothermaceae;Rubricoccus;";"100.0";"18.2";"2";"2";"2";"0";"0";"457181";"373892"
"V4mis1";"SILVA (only NR);Bacteria;Bacteroidota;Rhodothermia;Rhodothermales;Rhodothermaceae;Rubrivirga;";"100.0";"18.2";"11";"11";"11";"0";"0";"457172";"373883"
"V4mis1";"SILVA (only NR);Bacteria;Bacteroidota;Rhodothermia;Rhodothermales;Rhodothermaceae;Salinibacter;";"94.6";"18.3";"1559";"1559";"1475";"84";"0";"455624";"372419"
"V4mis1";"SILVA (only NR);Bacteria;Bacteroidota;Rhodothermia;Rhodothermales;Rhodothermaceae;Salisaeta;";"100.0";"18.2";"10";"10";"10";"0";"0";"457173";"373884"
"V4mis1";"SILVA (only NR);Bacteria;Bacteroidota;Rhodothermia;Rhodothermales;Rhodothermaceae;uncultured;";"90.8";"18.2";"131";"131";"119";"12";"0";"457052";"373775"
"V4mis1";"SILVA (only NR);Bacteria;Bdellovibrionota;";"97.0";"18.3";"1665";"1665";"1615";"50";"0";"455518";"372279"
"V4mis1";"SILVA (only NR);Bacteria;Bdellovibrionota;Bdellovibrionia;";"96.9";"18.3";"1013";"1013";"982";"31";"0";"456170";"372912"
"V4mis1";"SILVA (only NR);Bacteria;Bdellovibrionota;Bdellovibrionia;Bacteriovoracales;";"96.7";"18.2";"362";"362";"350";"12";"0";"456821";"373544"
"V4mis1";"SILVA (only NR);Bacteria;Bdellovibrionota;Bdellovibrionia;Bacteriovoracales;Bacteriovoracaceae;";"96.7";"18.2";"362";"362";"350";"12";"0";"456821";"373544"
"V4mis1";"SILVA (only NR);Bacteria;Bdellovibrionota;Bdellovibrionia;Bacteriovoracales;Bacteriovoracaceae;Bacteriovorax;";"100.0";"18.2";"28";"28";"28";"0";"0";"457155";"373866"
"V4mis1";"SILVA (only NR);Bacteria;Bdellovibrionota;Bdellovibrionia;Bacteriovoracales;Bacteriovoracaceae;Halobacteriovorax;";"97.0";"18.2";"101";"101";"98";"3";"0";"457082";"373796"
"V4mis1";"SILVA (only NR);Bacteria;Bdellovibrionota;Bdellovibrionia;Bacteriovoracales;Bacteriovoracaceae;Peredibacter;";"96.8";"18.2";"154";"154";"149";"5";"0";"457029";"373745"
"V4mis1";"SILVA (only NR);Bacteria;Bdellovibrionota;Bdellovibrionia;Bacteriovoracales;Bacteriovoracaceae;uncultured;";"94.7";"18.2";"76";"76";"72";"4";"0";"457107";"373822"
"V4mis1";"SILVA (only NR);Bacteria;Bdellovibrionota;Bdellovibrionia;Bdellovibrionales;";"97.1";"18.2";"651";"651";"632";"19";"0";"456532";"373262"
"V4mis1";"SILVA (only NR);Bacteria;Bdellovibrionota;Bdellovibrionia;Bdellovibrionales;Bdellovibrionaceae;";"97.1";"18.2";"651";"651";"632";"19";"0";"456532";"373262"
"V4mis1";"SILVA (only NR);Bacteria;Bdellovibrionota;Bdellovibrionia;Bdellovibrionales;Bdellovibrionaceae;Bdellovibrio;";"96.5";"18.2";"345";"345";"333";"12";"0";"456838";"373561"
"V4mis1";"SILVA (only NR);Bacteria;Bdellovibrionota;Bdellovibrionia;Bdellovibrionales;Bdellovibrionaceae;OM27 clade;";"97.7";"18.2";"304";"304";"297";"7";"0";"456879";"373597"
"V4mis1";"SILVA (only NR);Bacteria;Bdellovibrionota;Bdellovibrionia;Bdellovibrionales;Bdellovibrionaceae;uncultured;";"100.0";"18.2";"2";"2";"2";"0";"0";"457181";"373892"
"V4mis1";"SILVA (only NR);Bacteria;Bdellovibrionota;Oligoflexia;";"97.1";"18.2";"652";"652";"633";"19";"0";"456531";"373261"
"V4mis1";"SILVA (only NR);Bacteria;Bdellovibrionota;Oligoflexia;0319-6G20;";"96.8";"18.2";"372";"372";"360";"12";"0";"456811";"373534"
"V4mis1";"SILVA (only NR);Bacteria;Bdellovibrionota;Oligoflexia;053A03-B-DI-P58;";"89.3";"18.2";"28";"28";"25";"3";"0";"457155";"373869"
"V4mis1";"SILVA (only NR);Bacteria;Bdellovibrionota;Oligoflexia;Oligoflexales;";"98.2";"18.2";"219";"219";"215";"4";"0";"456964";"373679"
"V4mis1";"SILVA (only NR);Bacteria;Bdellovibrionota;Oligoflexia;Oligoflexales;Oligoflexaceae;";"98.2";"18.2";"219";"219";"215";"4";"0";"456964";"373679"
"V4mis1";"SILVA (only NR);Bacteria;Bdellovibrionota;Oligoflexia;Oligoflexales;Oligoflexaceae;Oligoflexus;";"100.0";"18.2";"31";"31";"31";"0";"0";"457152";"373863"
"V4mis1";"SILVA (only NR);Bacteria;Bdellovibrionota;Oligoflexia;Oligoflexales;Oligoflexaceae;Pseudobacteriovorax;";"100.0";"18.2";"7";"7";"7";"0";"0";"457176";"373887"
"V4mis1";"SILVA (only NR);Bacteria;Bdellovibrionota;Oligoflexia;Oligoflexales;Oligoflexaceae;uncultured;";"97.8";"18.2";"178";"178";"174";"4";"0";"457005";"373720"
"V4mis1";"SILVA (only NR);Bacteria;Bdellovibrionota;Oligoflexia;Silvanigrellales;";"100.0";"18.2";"29";"29";"29";"0";"0";"457154";"373865"
"V4mis1";"SILVA (only NR);Bacteria;Bdellovibrionota;Oligoflexia;Silvanigrellales;Silvanigrellaceae;";"100.0";"18.2";"29";"29";"29";"0";"0";"457154";"373865"
"V4mis1";"SILVA (only NR);Bacteria;Bdellovibrionota;Oligoflexia;Silvanigrellales;Silvanigrellaceae;Candidatus Turbabacter;";"100.0";"18.2";"2";"2";"2";"0";"0";"457181";"373892"
"V4mis1";"SILVA (only NR);Bacteria;Bdellovibrionota;Oligoflexia;Silvanigrellales;Silvanigrellaceae;Silvanigrella;";"100.0";"18.2";"13";"13";"13";"0";"0";"457170";"373881"
"V4mis1";"SILVA (only NR);Bacteria;Bdellovibrionota;Oligoflexia;Silvanigrellales;Silvanigrellaceae;uncultured;";"100.0";"18.2";"12";"12";"12";"0";"0";"457171";"373882"
"V4mis1";"SILVA (only NR);Bacteria;Bdellovibrionota;Oligoflexia;uncultured;";"100.0";"18.2";"3";"3";"3";"0";"0";"457180";"373891"
"V4mis1";"SILVA (only NR);Bacteria;CK-2C2-2;";"90.9";"18.2";"22";"22";"20";"2";"0";"457161";"373874"
"V4mis1";"SILVA (only NR);Bacteria;Caldatribacteriota;";"95.1";"18.2";"391";"391";"372";"19";"0";"456792";"373522"
"V4mis1";"SILVA (only NR);Bacteria;Caldatribacteriota;Caldatribacteriia;";"100.0";"18.2";"48";"48";"48";"0";"0";"457135";"373846"
"V4mis1";"SILVA (only NR);Bacteria;Caldatribacteriota;Caldatribacteriia;Caldatribacteriales;";"100.0";"18.2";"48";"48";"48";"0";"0";"457135";"373846"
"V4mis1";"SILVA (only NR);Bacteria;Caldatribacteriota;Caldatribacteriia;Caldatribacteriales;Caldatribacteriaceae;";"100.0";"18.2";"48";"48";"48";"0";"0";"457135";"373846"
"V4mis1";"SILVA (only NR);Bacteria;Caldatribacteriota;Caldatribacteriia;Caldatribacteriales;Caldatribacteriaceae;Candidatus Caldatribacterium;";"100.0";"18.2";"48";"48";"48";"0";"0";"457135";"373846"
"V4mis1";"SILVA (only NR);Bacteria;Caldatribacteriota;JS1;";"94.5";"18.2";"343";"343";"324";"19";"0";"456840";"373570"
"V4mis1";"SILVA (only NR);Bacteria;Caldisericota;";"89.9";"18.2";"99";"99";"89";"10";"0";"457084";"373805"
"V4mis1";"SILVA (only NR);Bacteria;Caldisericota;Caldisericia;";"89.9";"18.2";"99";"99";"89";"10";"0";"457084";"373805"
"V4mis1";"SILVA (only NR);Bacteria;Caldisericota;Caldisericia;Caldisericales;";"89.9";"18.2";"99";"99";"89";"10";"0";"457084";"373805"
"V4mis1";"SILVA (only NR);Bacteria;Caldisericota;Caldisericia;Caldisericales;Caldisericaceae;";"97.0";"18.2";"33";"33";"32";"1";"0";"457150";"373862"
"V4mis1";"SILVA (only NR);Bacteria;Caldisericota;Caldisericia;Caldisericales;Caldisericaceae;Caldisericum;";"97.0";"18.2";"33";"33";"32";"1";"0";"457150";"373862"
"V4mis1";"SILVA (only NR);Bacteria;Caldisericota;Caldisericia;Caldisericales;LF045;";"86.2";"18.2";"29";"29";"25";"4";"0";"457154";"373869"
"V4mis1";"SILVA (only NR);Bacteria;Caldisericota;Caldisericia;Caldisericales;TTA-B15;";"100.0";"18.2";"3";"3";"3";"0";"0";"457180";"373891"
"V4mis1";"SILVA (only NR);Bacteria;Caldisericota;Caldisericia;Caldisericales;TTA-B1;";"76.5";"18.2";"17";"17";"13";"4";"0";"457166";"373881"
"V4mis1";"SILVA (only NR);Bacteria;Caldisericota;Caldisericia;Caldisericales;WCHB1-02;";"94.1";"18.2";"17";"17";"16";"1";"0";"457166";"373878"
"V4mis1";"SILVA (only NR);Bacteria;Calditrichota;";"91.9";"18.2";"296";"296";"272";"24";"0";"456887";"373622"
"V4mis1";"SILVA (only NR);Bacteria;Calditrichota;Calditrichia;";"91.9";"18.2";"296";"296";"272";"24";"0";"456887";"373622"
"V4mis1";"SILVA (only NR);Bacteria;Calditrichota;Calditrichia;Calditrichales;";"91.9";"18.2";"296";"296";"272";"24";"0";"456887";"373622"
"V4mis1";"SILVA (only NR);Bacteria;Calditrichota;Calditrichia;Calditrichales;Calditrichaceae;";"91.9";"18.2";"296";"296";"272";"24";"0";"456887";"373622"
"V4mis1";"SILVA (only NR);Bacteria;Calditrichota;Calditrichia;Calditrichales;Calditrichaceae;Caldithrix;";"100.0";"18.2";"23";"23";"23";"0";"0";"457160";"373871"
"V4mis1";"SILVA (only NR);Bacteria;Calditrichota;Calditrichia;Calditrichales;Calditrichaceae;Calorithrix;";"100.0";"18.2";"24";"24";"24";"0";"0";"457159";"373870"
"V4mis1";"SILVA (only NR);Bacteria;Calditrichota;Calditrichia;Calditrichales;Calditrichaceae;JdFR-76;";"95.8";"18.2";"24";"24";"23";"1";"0";"457159";"373871"
"V4mis1";"SILVA (only NR);Bacteria;Calditrichota;Calditrichia;Calditrichales;Calditrichaceae;SM23-31;";"96.8";"18.2";"31";"31";"30";"1";"0";"457152";"373864"
"V4mis1";"SILVA (only NR);Bacteria;Calescamantes;";"100.0";"18.2";"3";"3";"3";"0";"0";"457180";"373891"
"V4mis1";"SILVA (only NR);Bacteria;Calescamantes;Calescibacteriia;";"100.0";"18.2";"3";"3";"3";"0";"0";"457180";"373891"
"V4mis1";"SILVA (only NR);Bacteria;Calescamantes;Calescibacteriia;Calescibacteriales;";"100.0";"18.2";"3";"3";"3";"0";"0";"457180";"373891"
"V4mis1";"SILVA (only NR);Bacteria;Calescamantes;Calescibacteriia;Calescibacteriales;Calescibacteriaceae;";"100.0";"18.2";"3";"3";"3";"0";"0";"457180";"373891"
"V4mis1";"SILVA (only NR);Bacteria;Campylobacterota;";"96.1";"18.4";"4220";"4220";"4055";"165";"0";"452963";"369839"
"V4mis1";"SILVA (only NR);Bacteria;Campylobacterota;Campylobacteria;";"96.1";"18.3";"4188";"4188";"4023";"165";"0";"452995";"369871"
"V4mis1";"SILVA (only NR);Bacteria;Campylobacterota;Campylobacteria;Campylobacterales;";"96.1";"18.3";"4127";"4127";"3964";"163";"0";"453056";"369930"
"V4mis1";"SILVA (only NR);Bacteria;Campylobacterota;Campylobacteria;Campylobacterales;Arcobacteraceae;";"94.5";"18.2";"578";"578";"546";"32";"0";"456605";"373348"
"V4mis1";"SILVA (only NR);Bacteria;Campylobacterota;Campylobacteria;Campylobacterales;Arcobacteraceae;Arcobacter;";"91.4";"18.2";"70";"70";"64";"6";"0";"457113";"373830"
"V4mis1";"SILVA (only NR);Bacteria;Campylobacterota;Campylobacteria;Campylobacterales;Arcobacteraceae;Halarcobacter;";"88.2";"18.2";"51";"51";"45";"6";"0";"457132";"373849"
"V4mis1";"SILVA (only NR);Bacteria;Campylobacterota;Campylobacteria;Campylobacterales;Arcobacteraceae;Malaciobacter;";"97.1";"18.2";"34";"34";"33";"1";"0";"457149";"373861"
"V4mis1";"SILVA (only NR);Bacteria;Campylobacterota;Campylobacteria;Campylobacterales;Arcobacteraceae;Poseidonibacter;";"100.0";"18.2";"5";"5";"5";"0";"0";"457178";"373889"
"V4mis1";"SILVA (only NR);Bacteria;Campylobacterota;Campylobacteria;Campylobacterales;Arcobacteraceae;Pseudarcobacter;";"92.4";"18.2";"66";"66";"61";"5";"0";"457117";"373833"
"V4mis1";"SILVA (only NR);Bacteria;Campylobacterota;Campylobacteria;Campylobacterales;Arcobacteraceae;uncultured;";"95.8";"18.2";"331";"331";"317";"14";"0";"456852";"373577"
"V4mis1";"SILVA (only NR);Bacteria;Campylobacterota;Campylobacteria;Campylobacterales;CH8-1-BAC;";"100.0";"18.2";"2";"2";"2";"0";"0";"457181";"373892"
"V4mis1";"SILVA (only NR);Bacteria;Campylobacterota;Campylobacteria;Campylobacterales;Campylobacteraceae;";"97.5";"18.2";"724";"724";"706";"18";"0";"456459";"373188"
"V4mis1";"SILVA (only NR);Bacteria;Campylobacterota;Campylobacteria;Campylobacterales;Campylobacteraceae;Campylobacter;";"97.5";"18.2";"724";"724";"706";"18";"0";"456459";"373188"
"V4mis1";"SILVA (only NR);Bacteria;Campylobacterota;Campylobacteria;Campylobacterales;Helicobacteraceae;";"97.7";"18.2";"514";"514";"502";"12";"0";"456669";"373392"
"V4mis1";"SILVA (only NR);Bacteria;Campylobacterota;Campylobacteria;Campylobacterales;Helicobacteraceae;Helicobacter;";"97.9";"18.2";"469";"469";"459";"10";"0";"456714";"373435"
"V4mis1";"SILVA (only NR);Bacteria;Campylobacterota;Campylobacteria;Campylobacterales;Helicobacteraceae;Wolinella;";"100.0";"18.2";"5";"5";"5";"0";"0";"457178";"373889"
"V4mis1";"SILVA (only NR);Bacteria;Campylobacterota;Campylobacteria;Campylobacterales;Helicobacteraceae;uncultured;";"94.9";"18.2";"39";"39";"37";"2";"0";"457144";"373857"
"V4mis1";"SILVA (only NR);Bacteria;Campylobacterota;Campylobacteria;Campylobacterales;Hydrogenimonadaceae;";"95.0";"18.2";"20";"20";"19";"1";"0";"457163";"373875"
"V4mis1";"SILVA (only NR);Bacteria;Campylobacterota;Campylobacteria;Campylobacterales;Hydrogenimonadaceae;Hydrogenimonas;";"95.0";"18.2";"20";"20";"19";"1";"0";"457163";"373875"
"V4mis1";"SILVA (only NR);Bacteria;Campylobacterota;Campylobacteria;Campylobacterales;Incertae Sedis;";"100.0";"18.2";"7";"7";"7";"0";"0";"457176";"373887"
"V4mis1";"SILVA (only NR);Bacteria;Campylobacterota;Campylobacteria;Campylobacterales;Incertae Sedis;Thiofractor;";"100.0";"18.2";"7";"7";"7";"0";"0";"457176";"373887"
"V4mis1";"SILVA (only NR);Bacteria;Campylobacterota;Campylobacteria;Campylobacterales;Nitratiruptoraceae;";"100.0";"18.2";"18";"18";"18";"0";"0";"457165";"373876"
"V4mis1";"SILVA (only NR);Bacteria;Campylobacterota;Campylobacteria;Campylobacterales;Nitratiruptoraceae;Nitratiruptor;";"100.0";"18.2";"18";"18";"18";"0";"0";"457165";"373876"
"V4mis1";"SILVA (only NR);Bacteria;Campylobacterota;Campylobacteria;Campylobacterales;P6-b51;";"100.0";"18.2";"2";"2";"2";"0";"0";"457181";"373892"
"V4mis1";"SILVA (only NR);Bacteria;Campylobacterota;Campylobacteria;Campylobacterales;PS-B32;";"100.0";"18.2";"2";"2";"2";"0";"0";"457181";"373892"
"V4mis1";"SILVA (only NR);Bacteria;Campylobacterota;Campylobacteria;Campylobacterales;Rs-M59 termite group;";"100.0";"18.2";"12";"12";"12";"0";"0";"457171";"373882"
"V4mis1";"SILVA (only NR);Bacteria;Campylobacterota;Campylobacteria;Campylobacterales;Sulfurimonadaceae;";"95.2";"18.2";"814";"814";"775";"39";"0";"456369";"373119"
"V4mis1";"SILVA (only NR);Bacteria;Campylobacterota;Campylobacteria;Campylobacterales;Sulfurimonadaceae;Sulfuricurvum;";"94.5";"18.2";"164";"164";"155";"9";"0";"457019";"373739"
"V4mis1";"SILVA (only NR);Bacteria;Campylobacterota;Campylobacteria;Campylobacterales;Sulfurimonadaceae;Sulfurimonas;";"95.3";"18.2";"641";"641";"611";"30";"0";"456542";"373283"
"V4mis1";"SILVA (only NR);Bacteria;Campylobacterota;Campylobacteria;Campylobacterales;Sulfurimonadaceae;Thiovulum;";"100.0";"18.2";"9";"9";"9";"0";"0";"457174";"373885"
"V4mis1";"SILVA (only NR);Bacteria;Campylobacterota;Campylobacteria;Campylobacterales;Sulfurospirillaceae;";"94.6";"18.2";"168";"168";"159";"9";"0";"457015";"373735"
"V4mis1";"SILVA (only NR);Bacteria;Campylobacterota;Campylobacteria;Campylobacterales;Sulfurospirillaceae;Sulfurospirillum;";"94.6";"18.2";"168";"168";"159";"9";"0";"457015";"373735"
"V4mis1";"SILVA (only NR);Bacteria;Campylobacterota;Campylobacteria;Campylobacterales;Sulfurovaceae;";"95.8";"18.3";"1219";"1219";"1168";"51";"0";"455964";"372726"
"V4mis1";"SILVA (only NR);Bacteria;Campylobacterota;Campylobacteria;Campylobacterales;Sulfurovaceae;Nitratifractor;";"92.8";"18.2";"83";"83";"77";"6";"0";"457100";"373817"
"V4mis1";"SILVA (only NR);Bacteria;Campylobacterota;Campylobacteria;Campylobacterales;Sulfurovaceae;Sulfurovum;";"96.0";"18.3";"1136";"1136";"1091";"45";"0";"456047";"372803"
"V4mis1";"SILVA (only NR);Bacteria;Campylobacterota;Campylobacteria;Campylobacterales;Thioreductoraceae;";"100.0";"18.2";"7";"7";"7";"0";"0";"457176";"373887"
"V4mis1";"SILVA (only NR);Bacteria;Campylobacterota;Campylobacteria;Campylobacterales;Thioreductoraceae;Thioreductor;";"100.0";"18.2";"7";"7";"7";"0";"0";"457176";"373887"
"V4mis1";"SILVA (only NR);Bacteria;Campylobacterota;Campylobacteria;Campylobacterales;uncultured;";"97.4";"18.2";"39";"39";"38";"1";"0";"457144";"373856"
"V4mis1";"SILVA (only NR);Bacteria;Campylobacterota;Campylobacteria;Nautiliales;";"96.7";"18.2";"61";"61";"59";"2";"0";"457122";"373835"
"V4mis1";"SILVA (only NR);Bacteria;Campylobacterota;Campylobacteria;Nautiliales;Nautiliaceae;";"96.7";"18.2";"61";"61";"59";"2";"0";"457122";"373835"
"V4mis1";"SILVA (only NR);Bacteria;Campylobacterota;Campylobacteria;Nautiliales;Nautiliaceae;Caminibacter;";"96.3";"18.2";"27";"27";"26";"1";"0";"457156";"373868"
"V4mis1";"SILVA (only NR);Bacteria;Campylobacterota;Campylobacteria;Nautiliales;Nautiliaceae;Lebetimonas;";"100.0";"18.2";"8";"8";"8";"0";"0";"457175";"373886"
"V4mis1";"SILVA (only NR);Bacteria;Campylobacterota;Campylobacteria;Nautiliales;Nautiliaceae;Nautilia;";"100.0";"18.2";"8";"8";"8";"0";"0";"457175";"373886"
"V4mis1";"SILVA (only NR);Bacteria;Campylobacterota;Campylobacteria;Nautiliales;Nautiliaceae;uncultured;";"92.9";"18.2";"14";"14";"13";"1";"0";"457169";"373881"
"V4mis1";"SILVA (only NR);Bacteria;Campylobacterota;Desulfurellia;";"100.0";"18.2";"32";"32";"32";"0";"0";"457151";"373862"
"V4mis1";"SILVA (only NR);Bacteria;Campylobacterota;Desulfurellia;Desulfurellales;";"100.0";"18.2";"32";"32";"32";"0";"0";"457151";"373862"
"V4mis1";"SILVA (only NR);Bacteria;Campylobacterota;Desulfurellia;Desulfurellales;Desulfurellaceae;";"100.0";"18.2";"17";"17";"17";"0";"0";"457166";"373877"
"V4mis1";"SILVA (only NR);Bacteria;Campylobacterota;Desulfurellia;Desulfurellales;Desulfurellaceae;Desulfurella;";"100.0";"18.2";"17";"17";"17";"0";"0";"457166";"373877"
"V4mis1";"SILVA (only NR);Bacteria;Campylobacterota;Desulfurellia;Desulfurellales;Hippeaceae;";"100.0";"18.2";"11";"11";"11";"0";"0";"457172";"373883"
"V4mis1";"SILVA (only NR);Bacteria;Campylobacterota;Desulfurellia;Desulfurellales;Hippeaceae;Hippea;";"100.0";"18.2";"11";"11";"11";"0";"0";"457172";"373883"
"V4mis1";"SILVA (only NR);Bacteria;Campylobacterota;Desulfurellia;Desulfurellales;uncultured;";"100.0";"18.2";"4";"4";"4";"0";"0";"457179";"373890"
"V4mis1";"SILVA (only NR);Bacteria;Chloroflexi;";"87.7";"18.3";"9049";"9049";"7934";"1115";"0";"448134";"365960"
"V4mis1";"SILVA (only NR);Bacteria;Chloroflexi;AD3;";"97.8";"18.2";"93";"93";"91";"2";"0";"457090";"373803"
"V4mis1";"SILVA (only NR);Bacteria;Chloroflexi;Anaerolineae;";"83.1";"18.2";"5491";"5491";"4561";"930";"0";"451692";"369333"
"V4mis1";"SILVA (only NR);Bacteria;Chloroflexi;Anaerolineae;1-20;";"100.0";"18.2";"19";"19";"19";"0";"0";"457164";"373875"
"V4mis1";"SILVA (only NR);Bacteria;Chloroflexi;Anaerolineae;ADurb.Bin180;";"100.0";"18.2";"29";"29";"29";"0";"0";"457154";"373865"
"V4mis1";"SILVA (only NR);Bacteria;Chloroflexi;Anaerolineae;Anaerolineales;";"72.2";"18.2";"2052";"2052";"1482";"570";"0";"455131";"372412"
"V4mis1";"SILVA (only NR);Bacteria;Chloroflexi;Anaerolineae;Anaerolineales;Anaerolineaceae;";"72.2";"18.2";"2052";"2052";"1482";"570";"0";"455131";"372412"
"V4mis1";"SILVA (only NR);Bacteria;Chloroflexi;Anaerolineae;Anaerolineales;Anaerolineaceae;ADurb.Bin120;";"91.1";"18.2";"45";"45";"41";"4";"0";"457138";"373853"
"V4mis1";"SILVA (only NR);Bacteria;Chloroflexi;Anaerolineae;Anaerolineales;Anaerolineaceae;Anaerolinea;";"89.2";"18.2";"111";"111";"99";"12";"0";"457072";"373795"
"V4mis1";"SILVA (only NR);Bacteria;Chloroflexi;Anaerolineae;Anaerolineales;Anaerolineaceae;Anaerolineaceae UCG-001;";"95.7";"18.2";"23";"23";"22";"1";"0";"457160";"373872"
"V4mis1";"SILVA (only NR);Bacteria;Chloroflexi;Anaerolineae;Anaerolineales;Anaerolineaceae;Bellilinea;";"91.7";"18.2";"12";"12";"11";"1";"0";"457171";"373883"
"V4mis1";"SILVA (only NR);Bacteria;Chloroflexi;Anaerolineae;Anaerolineales;Anaerolineaceae;Flexilinea;";"90.0";"18.2";"30";"30";"27";"3";"0";"457153";"373867"
"V4mis1";"SILVA (only NR);Bacteria;Chloroflexi;Anaerolineae;Anaerolineales;Anaerolineaceae;GWD2-49-16;";"75.0";"18.2";"4";"4";"3";"1";"0";"457179";"373891"
"V4mis1";"SILVA (only NR);Bacteria;Chloroflexi;Anaerolineae;Anaerolineales;Anaerolineaceae;Leptolinea;";"29.1";"18.2";"127";"127";"37";"90";"0";"457056";"373857"
"V4mis1";"SILVA (only NR);Bacteria;Chloroflexi;Anaerolineae;Anaerolineales;Anaerolineaceae;Levilinea;";"94.1";"18.2";"17";"17";"16";"1";"0";"457166";"373878"
"V4mis1";"SILVA (only NR);Bacteria;Chloroflexi;Anaerolineae;Anaerolineales;Anaerolineaceae;Longilinea;";"86.5";"18.2";"163";"163";"141";"22";"0";"457020";"373753"
"V4mis1";"SILVA (only NR);Bacteria;Chloroflexi;Anaerolineae;Anaerolineales;Anaerolineaceae;Ornatilinea;";"96.0";"18.2";"25";"25";"24";"1";"0";"457158";"373870"
"V4mis1";"SILVA (only NR);Bacteria;Chloroflexi;Anaerolineae;Anaerolineales;Anaerolineaceae;Pelolinea;";"95.7";"18.2";"47";"47";"45";"2";"0";"457136";"373849"
"V4mis1";"SILVA (only NR);Bacteria;Chloroflexi;Anaerolineae;Anaerolineales;Anaerolineaceae;RBG-16-58-14;";"100.0";"18.2";"12";"12";"12";"0";"0";"457171";"373882"
"V4mis1";"SILVA (only NR);Bacteria;Chloroflexi;Anaerolineae;Anaerolineales;Anaerolineaceae;Thermanaerothrix;";"50.0";"18.2";"2";"2";"1";"1";"0";"457181";"373893"
"V4mis1";"SILVA (only NR);Bacteria;Chloroflexi;Anaerolineae;Anaerolineales;Anaerolineaceae;Thermomarinilinea;";"90.9";"18.2";"11";"11";"10";"1";"0";"457172";"373884"
"V4mis1";"SILVA (only NR);Bacteria;Chloroflexi;Anaerolineae;Anaerolineales;Anaerolineaceae;UTCFX1;";"0.0";"0";"41";"41";"0";"41";"0";"457142";"373894"
"V4mis1";"SILVA (only NR);Bacteria;Chloroflexi;Anaerolineae;Anaerolineales;Anaerolineaceae;uncultured;";"71.7";"18.2";"1375";"1375";"986";"389";"0";"455808";"372908"
"V4mis1";"SILVA (only NR);Bacteria;Chloroflexi;Anaerolineae;Ardenticatenales;";"85.1";"18.2";"592";"592";"504";"88";"0";"456591";"373390"
"V4mis1";"SILVA (only NR);Bacteria;Chloroflexi;Anaerolineae;Ardenticatenales;Ardenticatenaceae;";"84.8";"18.2";"66";"66";"56";"10";"0";"457117";"373838"
"V4mis1";"SILVA (only NR);Bacteria;Chloroflexi;Anaerolineae;Ardenticatenales;Ardenticatenaceae;Ardenticatena;";"100.0";"18.2";"4";"4";"4";"0";"0";"457179";"373890"
"V4mis1";"SILVA (only NR);Bacteria;Chloroflexi;Anaerolineae;Ardenticatenales;Ardenticatenaceae;uncultured;";"83.6";"18.2";"61";"61";"51";"10";"0";"457122";"373843"
"V4mis1";"SILVA (only NR);Bacteria;Chloroflexi;Anaerolineae;Ardenticatenales;uncultured;";"85.2";"18.2";"526";"526";"448";"78";"0";"456657";"373446"
"V4mis1";"SILVA (only NR);Bacteria;Chloroflexi;Anaerolineae;C10-SB1A;";"100.0";"18.2";"8";"8";"8";"0";"0";"457175";"373886"
"V4mis1";"SILVA (only NR);Bacteria;Chloroflexi;Anaerolineae;Caldilineales;";"93.6";"18.2";"314";"314";"294";"20";"0";"456869";"373600"
"V4mis1";"SILVA (only NR);Bacteria;Chloroflexi;Anaerolineae;Caldilineales;Caldilineaceae;";"93.6";"18.2";"314";"314";"294";"20";"0";"456869";"373600"
"V4mis1";"SILVA (only NR);Bacteria;Chloroflexi;Anaerolineae;Caldilineales;Caldilineaceae;Caldilinea;";"87.5";"18.2";"8";"8";"7";"1";"0";"457175";"373887"
"V4mis1";"SILVA (only NR);Bacteria;Chloroflexi;Anaerolineae;Caldilineales;Caldilineaceae;Litorilinea;";"82.6";"18.2";"23";"23";"19";"4";"0";"457160";"373875"
"V4mis1";"SILVA (only NR);Bacteria;Chloroflexi;Anaerolineae;Caldilineales;Caldilineaceae;uncultured;";"94.6";"18.2";"280";"280";"265";"15";"0";"456903";"373629"
"V4mis1";"SILVA (only NR);Bacteria;Chloroflexi;Anaerolineae;KZNMV-5-B42;";"100.0";"18.2";"3";"3";"3";"0";"0";"457180";"373891"
"V4mis1";"SILVA (only NR);Bacteria;Chloroflexi;Anaerolineae;MSB-5B2;";"89.5";"18.2";"19";"19";"17";"2";"0";"457164";"373877"
"V4mis1";"SILVA (only NR);Bacteria;Chloroflexi;Anaerolineae;MSB-5E12;";"100.0";"18.2";"7";"7";"7";"0";"0";"457176";"373887"
"V4mis1";"SILVA (only NR);Bacteria;Chloroflexi;Anaerolineae;RBG-13-54-9;";"94.1";"18.2";"270";"270";"254";"16";"0";"456913";"373640"
"V4mis1";"SILVA (only NR);Bacteria;Chloroflexi;Anaerolineae;SBR1031;";"88.5";"18.2";"1974";"1974";"1747";"227";"0";"455209";"372147"
"V4mis1";"SILVA (only NR);Bacteria;Chloroflexi;Anaerolineae;SBR1031;A4b;";"92.2";"18.2";"565";"565";"521";"44";"0";"456618";"373373"
"V4mis1";"SILVA (only NR);Bacteria;Chloroflexi;Anaerolineae;SBR1031;A4b;OLB13;";"86.7";"18.2";"15";"15";"13";"2";"0";"457168";"373881"
"V4mis1";"SILVA (only NR);Bacteria;Chloroflexi;Anaerolineae;SBR1031;A4b;OLB15;";"100.0";"18.2";"2";"2";"2";"0";"0";"457181";"373892"
"V4mis1";"SILVA (only NR);Bacteria;Chloroflexi;Anaerolineae;SJA-15;";"100.0";"18.2";"73";"73";"73";"0";"0";"457110";"373821"
"V4mis1";"SILVA (only NR);Bacteria;Chloroflexi;Anaerolineae;Thermoflexales;";"94.1";"18.2";"51";"51";"48";"3";"0";"457132";"373846"
"V4mis1";"SILVA (only NR);Bacteria;Chloroflexi;Anaerolineae;Thermoflexales;Thermoflexaceae;";"94.1";"18.2";"51";"51";"48";"3";"0";"457132";"373846"
"V4mis1";"SILVA (only NR);Bacteria;Chloroflexi;Anaerolineae;Thermoflexales;Thermoflexaceae;Thermoflexus;";"94.1";"18.2";"51";"51";"48";"3";"0";"457132";"373846"
"V4mis1";"SILVA (only NR);Bacteria;Chloroflexi;Anaerolineae;uncultured;";"97.4";"18.2";"77";"77";"75";"2";"0";"457106";"373819"
"V4mis1";"SILVA (only NR);Bacteria;Chloroflexi;Chloroflexia;";"93.9";"18.2";"700";"700";"657";"43";"0";"456483";"373237"
"V4mis1";"SILVA (only NR);Bacteria;Chloroflexi;Chloroflexia;Chloroflexales;";"94.4";"18.2";"409";"409";"386";"23";"0";"456774";"373508"
"V4mis1";"SILVA (only NR);Bacteria;Chloroflexi;Chloroflexia;Chloroflexales;Chloroflexaceae;";"93.5";"18.2";"201";"201";"188";"13";"0";"456982";"373706"
"V4mis1";"SILVA (only NR);Bacteria;Chloroflexi;Chloroflexia;Chloroflexales;Chloroflexaceae;Candidatus Chloroploca;";"100.0";"18.2";"12";"12";"12";"0";"0";"457171";"373882"
"V4mis1";"SILVA (only NR);Bacteria;Chloroflexi;Chloroflexia;Chloroflexales;Chloroflexaceae;Candidatus Chlorothrix;";"93.8";"18.2";"113";"113";"106";"7";"0";"457070";"373788"
"V4mis1";"SILVA (only NR);Bacteria;Chloroflexi;Chloroflexia;Chloroflexales;Chloroflexaceae;Chloroflexus;";"90.5";"18.2";"42";"42";"38";"4";"0";"457141";"373856"
"V4mis1";"SILVA (only NR);Bacteria;Chloroflexi;Chloroflexia;Chloroflexales;Chloroflexaceae;Chloronema;";"100.0";"18.2";"7";"7";"7";"0";"0";"457176";"373887"
"V4mis1";"SILVA (only NR);Bacteria;Chloroflexi;Chloroflexia;Chloroflexales;Chloroflexaceae;FFCH7168;";"89.5";"18.2";"19";"19";"17";"2";"0";"457164";"373877"
"V4mis1";"SILVA (only NR);Bacteria;Chloroflexi;Chloroflexia;Chloroflexales;Chloroflexaceae;Oscillochloris;";"100.0";"18.2";"5";"5";"5";"0";"0";"457178";"373889"
"V4mis1";"SILVA (only NR);Bacteria;Chloroflexi;Chloroflexia;Chloroflexales;Chloroflexaceae;uncultured;";"100.0";"18.2";"2";"2";"2";"0";"0";"457181";"373892"
"V4mis1";"SILVA (only NR);Bacteria;Chloroflexi;Chloroflexia;Chloroflexales;Herpetosiphonaceae;";"100.0";"18.2";"17";"17";"17";"0";"0";"457166";"373877"
"V4mis1";"SILVA (only NR);Bacteria;Chloroflexi;Chloroflexia;Chloroflexales;Herpetosiphonaceae;Herpetosiphon;";"100.0";"18.2";"17";"17";"17";"0";"0";"457166";"373877"
"V4mis1";"SILVA (only NR);Bacteria;Chloroflexi;Chloroflexia;Chloroflexales;Roseiflexaceae;";"94.8";"18.2";"191";"191";"181";"10";"0";"456992";"373713"
"V4mis1";"SILVA (only NR);Bacteria;Chloroflexi;Chloroflexia;Chloroflexales;Roseiflexaceae;Kouleothrix;";"100.0";"18.2";"10";"10";"10";"0";"0";"457173";"373884"
"V4mis1";"SILVA (only NR);Bacteria;Chloroflexi;Chloroflexia;Chloroflexales;Roseiflexaceae;Roseiflexus;";"96.7";"18.2";"30";"30";"29";"1";"0";"457153";"373865"
"V4mis1";"SILVA (only NR);Bacteria;Chloroflexi;Chloroflexia;Chloroflexales;Roseiflexaceae;uncultured;";"94.0";"18.2";"151";"151";"142";"9";"0";"457032";"373752"
"V4mis1";"SILVA (only NR);Bacteria;Chloroflexi;Chloroflexia;Elev-1554;";"88.9";"18.2";"9";"9";"8";"1";"0";"457174";"373886"
"V4mis1";"SILVA (only NR);Bacteria;Chloroflexi;Chloroflexia;Kallotenuales;";"97.8";"18.2";"46";"46";"45";"1";"0";"457137";"373849"
"V4mis1";"SILVA (only NR);Bacteria;Chloroflexi;Chloroflexia;Kallotenuales;AKIW781;";"97.6";"18.2";"42";"42";"41";"1";"0";"457141";"373853"
"V4mis1";"SILVA (only NR);Bacteria;Chloroflexi;Chloroflexia;Kallotenuales;Kallotenuaceae;";"100.0";"18.2";"4";"4";"4";"0";"0";"457179";"373890"
"V4mis1";"SILVA (only NR);Bacteria;Chloroflexi;Chloroflexia;Kallotenuales;Kallotenuaceae;Kallotenue;";"100.0";"18.2";"4";"4";"4";"0";"0";"457179";"373890"
"V4mis1";"SILVA (only NR);Bacteria;Chloroflexi;Chloroflexia;Thermobaculales;";"100.0";"18.2";"12";"12";"12";"0";"0";"457171";"373882"
"V4mis1";"SILVA (only NR);Bacteria;Chloroflexi;Chloroflexia;Thermobaculales;Thermobaculaceae;";"100.0";"18.2";"12";"12";"12";"0";"0";"457171";"373882"
"V4mis1";"SILVA (only NR);Bacteria;Chloroflexi;Chloroflexia;Thermobaculales;Thermobaculaceae;Thermobaculum;";"100.0";"18.2";"12";"12";"12";"0";"0";"457171";"373882"
"V4mis1";"SILVA (only NR);Bacteria;Chloroflexi;Chloroflexia;Thermomicrobiales;";"92.0";"18.2";"224";"224";"206";"18";"0";"456959";"373688"
"V4mis1";"SILVA (only NR);Bacteria;Chloroflexi;Chloroflexia;Thermomicrobiales;AKYG1722;";"89.6";"18.2";"48";"48";"43";"5";"0";"457135";"373851"
"V4mis1";"SILVA (only NR);Bacteria;Chloroflexi;Chloroflexia;Thermomicrobiales;JG30-KF-CM45;";"93.4";"18.2";"137";"137";"128";"9";"0";"457046";"373766"
"V4mis1";"SILVA (only NR);Bacteria;Chloroflexi;Chloroflexia;Thermomicrobiales;Thermomicrobiaceae;";"89.7";"18.2";"39";"39";"35";"4";"0";"457144";"373859"
"V4mis1";"SILVA (only NR);Bacteria;Chloroflexi;Chloroflexia;Thermomicrobiales;Thermomicrobiaceae;Nitrolancea;";"84.2";"18.2";"19";"19";"16";"3";"0";"457164";"373878"
"V4mis1";"SILVA (only NR);Bacteria;Chloroflexi;Chloroflexia;Thermomicrobiales;Thermomicrobiaceae;Sphaerobacter;";"100.0";"18.2";"7";"7";"7";"0";"0";"457176";"373887"
"V4mis1";"SILVA (only NR);Bacteria;Chloroflexi;Chloroflexia;Thermomicrobiales;Thermomicrobiaceae;Thermomicrobium;";"100.0";"18.2";"10";"10";"10";"0";"0";"457173";"373884"
"V4mis1";"SILVA (only NR);Bacteria;Chloroflexi;Chloroflexia;Thermomicrobiales;Thermomicrobiaceae;Thermorudis;";"50.0";"18.2";"2";"2";"1";"1";"0";"457181";"373893"
"V4mis1";"SILVA (only NR);Bacteria;Chloroflexi;Dehalococcoidia;";"95.9";"18.3";"1601";"1601";"1536";"65";"0";"455582";"372358"
"V4mis1";"SILVA (only NR);Bacteria;Chloroflexi;Dehalococcoidia;1226B1H1-22-FL;";"100.0";"18.2";"3";"3";"3";"0";"0";"457180";"373891"
"V4mis1";"SILVA (only NR);Bacteria;Chloroflexi;Dehalococcoidia;185B01;";"66.7";"18.2";"3";"3";"2";"1";"0";"457180";"373892"
"V4mis1";"SILVA (only NR);Bacteria;Chloroflexi;Dehalococcoidia;3051bac4-16;";"100.0";"18.2";"5";"5";"5";"0";"0";"457178";"373889"
"V4mis1";"SILVA (only NR);Bacteria;Chloroflexi;Dehalococcoidia;661239;";"100.0";"18.2";"16";"16";"16";"0";"0";"457167";"373878"
"V4mis1";"SILVA (only NR);Bacteria;Chloroflexi;Dehalococcoidia;Dehalococcoidales;";"90.9";"18.2";"88";"88";"80";"8";"0";"457095";"373814"
"V4mis1";"SILVA (only NR);Bacteria;Chloroflexi;Dehalococcoidia;Dehalococcoidales;Dehalococcoidaceae;";"94.1";"18.2";"51";"51";"48";"3";"0";"457132";"373846"
"V4mis1";"SILVA (only NR);Bacteria;Chloroflexi;Dehalococcoidia;Dehalococcoidales;Dehalococcoidaceae;Dehalococcoides;";"92.1";"18.2";"38";"38";"35";"3";"0";"457145";"373859"
"V4mis1";"SILVA (only NR);Bacteria;Chloroflexi;Dehalococcoidia;Dehalococcoidales;Dehalococcoidaceae;Dehalogenimonas;";"100.0";"18.2";"13";"13";"13";"0";"0";"457170";"373881"
"V4mis1";"SILVA (only NR);Bacteria;Chloroflexi;Dehalococcoidia;Dehalococcoidales;Dehalococcoidales Incertae Sedis;";"42.9";"18.2";"7";"7";"3";"4";"0";"457176";"373891"
"V4mis1";"SILVA (only NR);Bacteria;Chloroflexi;Dehalococcoidia;Dehalococcoidales;Dehalococcoidales Incertae Sedis;Dehalobium;";"42.9";"18.2";"7";"7";"3";"4";"0";"457176";"373891"
"V4mis1";"SILVA (only NR);Bacteria;Chloroflexi;Dehalococcoidia;Dehalococcoidales;uncultured;";"96.6";"18.2";"29";"29";"28";"1";"0";"457154";"373866"
"V4mis1";"SILVA (only NR);Bacteria;Chloroflexi;Dehalococcoidia;DscP2;";"82.9";"18.2";"111";"111";"92";"19";"0";"457072";"373802"
"V4mis1";"SILVA (only NR);Bacteria;Chloroflexi;Dehalococcoidia;ER-E4-17;";"100.0";"18.2";"4";"4";"4";"0";"0";"457179";"373890"
"V4mis1";"SILVA (only NR);Bacteria;Chloroflexi;Dehalococcoidia;FS117-23B-02;";"95.2";"18.2";"21";"21";"20";"1";"0";"457162";"373874"
"V4mis1";"SILVA (only NR);Bacteria;Chloroflexi;Dehalococcoidia;FW22;";"95.9";"18.2";"49";"49";"47";"2";"0";"457134";"373847"
"V4mis1";"SILVA (only NR);Bacteria;Chloroflexi;Dehalococcoidia;GIF3;";"97.8";"18.2";"91";"91";"89";"2";"0";"457092";"373805"
"V4mis1";"SILVA (only NR);Bacteria;Chloroflexi;Dehalococcoidia;GIF9;";"96.4";"18.2";"137";"137";"132";"5";"0";"457046";"373762"
"V4mis1";"SILVA (only NR);Bacteria;Chloroflexi;Dehalococcoidia;GIF9;AB-539-J10;";"98.8";"18.2";"86";"86";"85";"1";"0";"457097";"373809"
"V4mis1";"SILVA (only NR);Bacteria;Chloroflexi;Dehalococcoidia;GIF9;AB-539-J10;Dsc1;";"100.0";"18.2";"2";"2";"2";"0";"0";"457181";"373892"
"V4mis1";"SILVA (only NR);Bacteria;Chloroflexi;Dehalococcoidia;GIF9;AB-539-J10;SCGC-AB-539-J10;";"100.0";"18.2";"50";"50";"50";"0";"0";"457133";"373844"
"V4mis1";"SILVA (only NR);Bacteria;Chloroflexi;Dehalococcoidia;H3.93;";"100.0";"18.2";"40";"40";"40";"0";"0";"457143";"373854"
"V4mis1";"SILVA (only NR);Bacteria;Chloroflexi;Dehalococcoidia;JdFR-54;";"100.0";"18.2";"2";"2";"2";"0";"0";"457181";"373892"
"V4mis1";"SILVA (only NR);Bacteria;Chloroflexi;Dehalococcoidia;MB-C2-126;";"100.0";"18.2";"9";"9";"9";"0";"0";"457174";"373885"
"V4mis1";"SILVA (only NR);Bacteria;Chloroflexi;Dehalococcoidia;MSBL5;";"98.8";"18.2";"80";"80";"79";"1";"0";"457103";"373815"
"V4mis1";"SILVA (only NR);Bacteria;Chloroflexi;Dehalococcoidia;Napoli-4B-65;";"98.6";"18.2";"71";"71";"70";"1";"0";"457112";"373824"
"V4mis1";"SILVA (only NR);Bacteria;Chloroflexi;Dehalococcoidia;RBG-13-46-9;";"85.7";"18.2";"7";"7";"6";"1";"0";"457176";"373888"
"V4mis1";"SILVA (only NR);Bacteria;Chloroflexi;Dehalococcoidia;S085;";"97.2";"18.2";"180";"180";"175";"5";"0";"457003";"373719"
"V4mis1";"SILVA (only NR);Bacteria;Chloroflexi;Dehalococcoidia;SAR202 clade;";"96.8";"18.2";"475";"475";"460";"15";"0";"456708";"373434"
"V4mis1";"SILVA (only NR);Bacteria;Chloroflexi;Dehalococcoidia;SPG12-343-353-B75;";"100.0";"18.2";"6";"6";"6";"0";"0";"457177";"373888"
"V4mis1";"SILVA (only NR);Bacteria;Chloroflexi;Dehalococcoidia;SPG12-461-471-B8;";"100.0";"18.2";"5";"5";"5";"0";"0";"457178";"373889"
"V4mis1";"SILVA (only NR);Bacteria;Chloroflexi;Dehalococcoidia;Sh765B-AG-111;";"96.3";"18.2";"107";"107";"103";"4";"0";"457076";"373791"
"V4mis1";"SILVA (only NR);Bacteria;Chloroflexi;Dehalococcoidia;Sh765B-TzT-20;";"100.0";"18.2";"10";"10";"10";"0";"0";"457173";"373884"
"V4mis1";"SILVA (only NR);Bacteria;Chloroflexi;Dehalococcoidia;t0.6.f;";"100.0";"18.2";"23";"23";"23";"0";"0";"457160";"373871"
"V4mis1";"SILVA (only NR);Bacteria;Chloroflexi;Dehalococcoidia;vadinBA26;";"100.0";"18.2";"41";"41";"41";"0";"0";"457142";"373853"
"V4mis1";"SILVA (only NR);Bacteria;Chloroflexi;Gitt-GS-136;";"82.1";"18.2";"39";"39";"32";"7";"0";"457144";"373862"
"V4mis1";"SILVA (only NR);Bacteria;Chloroflexi;JG30-KF-CM66;";"96.1";"18.2";"127";"127";"122";"5";"0";"457056";"373772"
"V4mis1";"SILVA (only NR);Bacteria;Chloroflexi;KD4-96;";"90.0";"18.2";"150";"150";"135";"15";"0";"457033";"373759"
"V4mis1";"SILVA (only NR);Bacteria;Chloroflexi;Ktedonobacteria;";"97.7";"18.2";"485";"485";"474";"11";"0";"456698";"373420"
"V4mis1";"SILVA (only NR);Bacteria;Chloroflexi;Ktedonobacteria;B10-SB3A;";"100.0";"18.2";"5";"5";"5";"0";"0";"457178";"373889"
"V4mis1";"SILVA (only NR);Bacteria;Chloroflexi;Ktedonobacteria;B12-WMSP1;";"94.7";"18.2";"19";"19";"18";"1";"0";"457164";"373876"
"V4mis1";"SILVA (only NR);Bacteria;Chloroflexi;Ktedonobacteria;C0119;";"94.4";"18.2";"54";"54";"51";"3";"0";"457129";"373843"
"V4mis1";"SILVA (only NR);Bacteria;Chloroflexi;Ktedonobacteria;Ktedonobacterales;";"98.7";"18.2";"390";"390";"385";"5";"0";"456793";"373509"
"V4mis1";"SILVA (only NR);Bacteria;Chloroflexi;Ktedonobacteria;Ktedonobacterales;JG30-KF-AS9;";"100.0";"18.2";"23";"23";"23";"0";"0";"457160";"373871"
"V4mis1";"SILVA (only NR);Bacteria;Chloroflexi;Ktedonobacteria;Ktedonobacterales;Ktedonobacteraceae;";"98.6";"18.2";"366";"366";"361";"5";"0";"456817";"373533"
"V4mis1";"SILVA (only NR);Bacteria;Chloroflexi;Ktedonobacteria;Ktedonobacterales;Ktedonobacteraceae;1921-2;";"100.0";"18.2";"12";"12";"12";"0";"0";"457171";"373882"
"V4mis1";"SILVA (only NR);Bacteria;Chloroflexi;Ktedonobacteria;Ktedonobacterales;Ktedonobacteraceae;1921-3;";"100.0";"18.2";"24";"24";"24";"0";"0";"457159";"373870"
"V4mis1";"SILVA (only NR);Bacteria;Chloroflexi;Ktedonobacteria;Ktedonobacterales;Ktedonobacteraceae;1959-1;";"92.3";"18.2";"13";"13";"12";"1";"0";"457170";"373882"
"V4mis1";"SILVA (only NR);Bacteria;Chloroflexi;Ktedonobacteria;Ktedonobacterales;Ktedonobacteraceae;BacC-u-018;";"100.0";"18.2";"7";"7";"7";"0";"0";"457176";"373887"
"V4mis1";"SILVA (only NR);Bacteria;Chloroflexi;Ktedonobacteria;Ktedonobacterales;Ktedonobacteraceae;FCPS473;";"100.0";"18.2";"29";"29";"29";"0";"0";"457154";"373865"
"V4mis1";"SILVA (only NR);Bacteria;Chloroflexi;Ktedonobacteria;Ktedonobacterales;Ktedonobacteraceae;G12-WMSP1;";"100.0";"18.2";"16";"16";"16";"0";"0";"457167";"373878"
"V4mis1";"SILVA (only NR);Bacteria;Chloroflexi;Ktedonobacteria;Ktedonobacterales;Ktedonobacteraceae;HSB OF53-F07;";"97.0";"18.2";"33";"33";"32";"1";"0";"457150";"373862"
"V4mis1";"SILVA (only NR);Bacteria;Chloroflexi;Ktedonobacteria;Ktedonobacterales;Ktedonobacteraceae;JG30a-KF-32;";"100.0";"18.2";"21";"21";"21";"0";"0";"457162";"373873"
"V4mis1";"SILVA (only NR);Bacteria;Chloroflexi;Ktedonobacteria;Ktedonobacterales;Ktedonobacteraceae;Ktedonobacter;";"100.0";"18.2";"28";"28";"28";"0";"0";"457155";"373866"
"V4mis1";"SILVA (only NR);Bacteria;Chloroflexi;Ktedonobacteria;Ktedonobacterales;Ktedonobacteraceae;Thermogemmatispora;";"100.0";"18.2";"8";"8";"8";"0";"0";"457175";"373886"
"V4mis1";"SILVA (only NR);Bacteria;Chloroflexi;Ktedonobacteria;Ktedonobacterales;Ktedonobacteraceae;Thermosporothrix;";"100.0";"18.2";"8";"8";"8";"0";"0";"457175";"373886"
"V4mis1";"SILVA (only NR);Bacteria;Chloroflexi;Ktedonobacteria;Ktedonobacterales;Ktedonobacteraceae;uncultured;";"98.2";"18.2";"164";"164";"161";"3";"0";"457019";"373733"
"V4mis1";"SILVA (only NR);Bacteria;Chloroflexi;Ktedonobacteria;MVP-21;";"87.5";"18.2";"16";"16";"14";"2";"0";"457167";"373880"
"V4mis1";"SILVA (only NR);Bacteria;Chloroflexi;N9D0;";"100.0";"18.2";"4";"4";"4";"0";"0";"457179";"373890"
"V4mis1";"SILVA (only NR);Bacteria;Chloroflexi;NLS2-31;";"50.0";"18.2";"2";"2";"1";"1";"0";"457181";"373893"
"V4mis1";"SILVA (only NR);Bacteria;Chloroflexi;OLB14;";"100.0";"18.2";"46";"46";"46";"0";"0";"457137";"373848"
"V4mis1";"SILVA (only NR);Bacteria;Chloroflexi;P2-11E;";"100.0";"18.2";"33";"33";"33";"0";"0";"457150";"373861"
"V4mis1";"SILVA (only NR);Bacteria;Chloroflexi;SHA-26;";"61.9";"18.2";"42";"42";"26";"16";"0";"457141";"373868"
"V4mis1";"SILVA (only NR);Bacteria;Chloroflexi;SL56 marine group;";"100.0";"18.2";"21";"21";"21";"0";"0";"457162";"373873"
"V4mis1";"SILVA (only NR);Bacteria;Chloroflexi;TK10;";"89.8";"18.2";"187";"187";"168";"19";"0";"456996";"373726"
"V4mis1";"SILVA (only NR);Bacteria;Chloroflexi;TK17;";"100.0";"18.2";"18";"18";"18";"0";"0";"457165";"373876"
"V4mis1";"SILVA (only NR);Bacteria;Chloroflexi;TK30;";"83.3";"18.2";"6";"6";"5";"1";"0";"457177";"373889"
"V4mis1";"SILVA (only NR);Bacteria;Chrysiogenetota;";"100.0";"18.2";"8";"8";"8";"0";"0";"457175";"373886"
"V4mis1";"SILVA (only NR);Bacteria;Chrysiogenetota;Chrysiogenetes;";"100.0";"18.2";"8";"8";"8";"0";"0";"457175";"373886"
"V4mis1";"SILVA (only NR);Bacteria;Chrysiogenetota;Chrysiogenetes;Chrysiogenales;";"100.0";"18.2";"8";"8";"8";"0";"0";"457175";"373886"
"V4mis1";"SILVA (only NR);Bacteria;Chrysiogenetota;Chrysiogenetes;Chrysiogenales;Chrysiogenaceae;";"100.0";"18.2";"8";"8";"8";"0";"0";"457175";"373886"
"V4mis1";"SILVA (only NR);Bacteria;Chrysiogenetota;Chrysiogenetes;Chrysiogenales;Chrysiogenaceae;Chrysiogenes;";"100.0";"18.2";"1";"1";"1";"0";"0";"457182";"373893"
"V4mis1";"SILVA (only NR);Bacteria;Chrysiogenetota;Chrysiogenetes;Chrysiogenales;Chrysiogenaceae;Desulfurispira;";"100.0";"18.2";"2";"2";"2";"0";"0";"457181";"373892"
"V4mis1";"SILVA (only NR);Bacteria;Chrysiogenetota;Chrysiogenetes;Chrysiogenales;Chrysiogenaceae;Desulfurispirillum;";"100.0";"18.2";"5";"5";"5";"0";"0";"457178";"373889"
"V4mis1";"SILVA (only NR);Bacteria;Cloacimonadota;";"92.3";"18.2";"299";"299";"276";"23";"0";"456884";"373618"
"V4mis1";"SILVA (only NR);Bacteria;Cloacimonadota;Cloacimonadia;";"92.3";"18.2";"299";"299";"276";"23";"0";"456884";"373618"
"V4mis1";"SILVA (only NR);Bacteria;Cloacimonadota;Cloacimonadia;Cloacimonadales;";"92.0";"18.2";"289";"289";"266";"23";"0";"456894";"373628"
"V4mis1";"SILVA (only NR);Bacteria;Cloacimonadota;Cloacimonadia;Cloacimonadales;CW-1 termite group;";"88.9";"18.2";"9";"9";"8";"1";"0";"457174";"373886"
"V4mis1";"SILVA (only NR);Bacteria;Cloacimonadota;Cloacimonadia;Cloacimonadales;Cloacimonadaceae;";"91.5";"18.2";"165";"165";"151";"14";"0";"457018";"373743"
"V4mis1";"SILVA (only NR);Bacteria;Cloacimonadota;Cloacimonadia;Cloacimonadales;Cloacimonadaceae;C-2;";"66.7";"18.2";"3";"3";"2";"1";"0";"457180";"373892"
"V4mis1";"SILVA (only NR);Bacteria;Cloacimonadota;Cloacimonadia;Cloacimonadales;Cloacimonadaceae;Candidatus Cloacimonas;";"93.3";"18.2";"90";"90";"84";"6";"0";"457093";"373810"
"V4mis1";"SILVA (only NR);Bacteria;Cloacimonadota;Cloacimonadia;Cloacimonadales;Cloacimonadaceae;LNR A2-18;";"100.0";"18.2";"11";"11";"11";"0";"0";"457172";"373883"
"V4mis1";"SILVA (only NR);Bacteria;Cloacimonadota;Cloacimonadia;Cloacimonadales;Cloacimonadaceae;W5;";"88.7";"18.2";"53";"53";"47";"6";"0";"457130";"373847"
"V4mis1";"SILVA (only NR);Bacteria;Cloacimonadota;Cloacimonadia;Cloacimonadales;GZKB75;";"88.9";"18.2";"9";"9";"8";"1";"0";"457174";"373886"
"V4mis1";"SILVA (only NR);Bacteria;Cloacimonadota;Cloacimonadia;Cloacimonadales;LK-44f;";"100.0";"18.2";"13";"13";"13";"0";"0";"457170";"373881"
"V4mis1";"SILVA (only NR);Bacteria;Cloacimonadota;Cloacimonadia;Cloacimonadales;MSBL8;";"92.3";"18.2";"26";"26";"24";"2";"0";"457157";"373870"
"V4mis1";"SILVA (only NR);Bacteria;Cloacimonadota;Cloacimonadia;Cloacimonadales;NK-L14;";"100.0";"18.2";"4";"4";"4";"0";"0";"457179";"373890"
"V4mis1";"SILVA (only NR);Bacteria;Cloacimonadota;Cloacimonadia;Cloacimonadales;PBS-18;";"87.5";"18.2";"16";"16";"14";"2";"0";"457167";"373880"
"V4mis1";"SILVA (only NR);Bacteria;Cloacimonadota;Cloacimonadia;Cloacimonadales;SHA-41;";"80.0";"18.2";"5";"5";"4";"1";"0";"457178";"373890"
"V4mis1";"SILVA (only NR);Bacteria;Cloacimonadota;Cloacimonadia;Cloacimonadales;SHA-4;";"100.0";"18.2";"5";"5";"5";"0";"0";"457178";"373889"
"V4mis1";"SILVA (only NR);Bacteria;Cloacimonadota;Cloacimonadia;Cloacimonadales;W27;";"96.8";"18.2";"31";"31";"30";"1";"0";"457152";"373864"
"V4mis1";"SILVA (only NR);Bacteria;Cloacimonadota;Cloacimonadia;MSBL2;";"100.0";"18.2";"10";"10";"10";"0";"0";"457173";"373884"
"V4mis1";"SILVA (only NR);Bacteria;Coprothermobacterota;";"84.7";"18.2";"98";"98";"83";"15";"0";"457085";"373811"
"V4mis1";"SILVA (only NR);Bacteria;Coprothermobacterota;Coprothermobacteria;";"84.7";"18.2";"98";"98";"83";"15";"0";"457085";"373811"
"V4mis1";"SILVA (only NR);Bacteria;Coprothermobacterota;Coprothermobacteria;Coprothermobacterales;";"84.7";"18.2";"98";"98";"83";"15";"0";"457085";"373811"
"V4mis1";"SILVA (only NR);Bacteria;Coprothermobacterota;Coprothermobacteria;Coprothermobacterales;Coprothermobacteraceae;";"84.7";"18.2";"98";"98";"83";"15";"0";"457085";"373811"
"V4mis1";"SILVA (only NR);Bacteria;Coprothermobacterota;Coprothermobacteria;Coprothermobacterales;Coprothermobacteraceae;Coprothermobacter;";"84.7";"18.2";"98";"98";"83";"15";"0";"457085";"373811"
"V4mis1";"SILVA (only NR);Bacteria;Cyanobacteria;";"89.0";"18.4";"9718";"9717";"8644";"1073";"1";"447466";"365250"
"V4mis1";"SILVA (only NR);Bacteria;Cyanobacteria;Cyanobacteriia;";"88.5";"18.4";"9141";"9140";"8092";"1048";"1";"448043";"365802"
"V4mis1";"SILVA (only NR);Bacteria;Cyanobacteria;Cyanobacteriia;Chloroplast;";"82.9";"18.2";"4441";"4440";"3682";"758";"1";"452743";"370212"
"V4mis1";"SILVA (only NR);Bacteria;Cyanobacteria;Cyanobacteriia;Cyanobacteriales;";"93.9";"18.3";"2985";"2985";"2804";"181";"0";"454198";"371090"
"V4mis1";"SILVA (only NR);Bacteria;Cyanobacteria;Cyanobacteriia;Cyanobacteriales;Chamaesiphonaceae;";"100.0";"18.2";"4";"4";"4";"0";"0";"457179";"373890"
"V4mis1";"SILVA (only NR);Bacteria;Cyanobacteria;Cyanobacteriia;Cyanobacteriales;Chamaesiphonaceae;Chamaesiphon PCC-6605;";"100.0";"18.2";"4";"4";"4";"0";"0";"457179";"373890"
"V4mis1";"SILVA (only NR);Bacteria;Cyanobacteria;Cyanobacteriia;Cyanobacteriales;Chroococcidiopsaceae;";"96.3";"18.2";"298";"298";"287";"11";"0";"456885";"373607"
"V4mis1";"SILVA (only NR);Bacteria;Cyanobacteria;Cyanobacteriia;Cyanobacteriales;Chroococcidiopsaceae;Aliterella;";"91.9";"18.2";"37";"37";"34";"3";"0";"457146";"373860"
"V4mis1";"SILVA (only NR);Bacteria;Cyanobacteria;Cyanobacteriia;Cyanobacteriales;Chroococcidiopsaceae;Chlorogloea SAG 10.99;";"100.0";"18.2";"3";"3";"3";"0";"0";"457180";"373891"
"V4mis1";"SILVA (only NR);Bacteria;Cyanobacteria;Cyanobacteriia;Cyanobacteriales;Chroococcidiopsaceae;Chroococcidiopsis CC1;";"100.0";"18.2";"8";"8";"8";"0";"0";"457175";"373886"
"V4mis1";"SILVA (only NR);Bacteria;Cyanobacteria;Cyanobacteriia;Cyanobacteriales;Chroococcidiopsaceae;Chroococcidiopsis PCC 7203;";"100.0";"18.2";"19";"19";"19";"0";"0";"457164";"373875"
"V4mis1";"SILVA (only NR);Bacteria;Cyanobacteria;Cyanobacteriia;Cyanobacteriales;Chroococcidiopsaceae;Chroococcidiopsis SAG 2023;";"100.0";"18.2";"29";"29";"29";"0";"0";"457154";"373865"
"V4mis1";"SILVA (only NR);Bacteria;Cyanobacteria;Cyanobacteriia;Cyanobacteriales;Chroococcidiopsaceae;Crinalium SAG 22.89;";"100.0";"18.2";"10";"10";"10";"0";"0";"457173";"373884"
"V4mis1";"SILVA (only NR);Bacteria;Cyanobacteria;Cyanobacteriia;Cyanobacteriales;Chroococcidiopsaceae;Dapisostemonum CCIBt 3536;";"100.0";"18.2";"10";"10";"10";"0";"0";"457173";"373884"
"V4mis1";"SILVA (only NR);Bacteria;Cyanobacteria;Cyanobacteriia;Cyanobacteriales;Chroococcidiopsaceae;Gloeocapsa PCC-7428;";"100.0";"18.2";"8";"8";"8";"0";"0";"457175";"373886"
"V4mis1";"SILVA (only NR);Bacteria;Cyanobacteria;Cyanobacteriia;Cyanobacteriales;Chroococcidiopsaceae;Myxosarcina SAG 30.84;";"100.0";"18.2";"10";"10";"10";"0";"0";"457173";"373884"
"V4mis1";"SILVA (only NR);Bacteria;Cyanobacteria;Cyanobacteriia;Cyanobacteriales;Chroococcidiopsaceae;uncultured;";"95.0";"18.2";"161";"161";"153";"8";"0";"457022";"373741"
"V4mis1";"SILVA (only NR);Bacteria;Cyanobacteria;Cyanobacteriia;Cyanobacteriales;Coleofasciculaceae;";"86.1";"18.2";"402";"402";"346";"56";"0";"456781";"373548"
"V4mis1";"SILVA (only NR);Bacteria;Cyanobacteria;Cyanobacteriia;Cyanobacteriales;Coleofasciculaceae;Caldora VP642b;";"100.0";"18.2";"6";"6";"6";"0";"0";"457177";"373888"
"V4mis1";"SILVA (only NR);Bacteria;Cyanobacteria;Cyanobacteriia;Cyanobacteriales;Coleofasciculaceae;Coleofasciculus PCC-7420;";"81.1";"18.2";"291";"291";"236";"55";"0";"456892";"373658"
"V4mis1";"SILVA (only NR);Bacteria;Cyanobacteria;Cyanobacteriia;Cyanobacteriales;Coleofasciculaceae;Microcoleus CENA344;";"100.0";"18.2";"2";"2";"2";"0";"0";"457181";"373892"
"V4mis1";"SILVA (only NR);Bacteria;Cyanobacteria;Cyanobacteriia;Cyanobacteriales;Coleofasciculaceae;Microcoleus Es-Yyy1400;";"100.0";"18.2";"7";"7";"7";"0";"0";"457176";"373887"
"V4mis1";"SILVA (only NR);Bacteria;Cyanobacteria;Cyanobacteriia;Cyanobacteriales;Coleofasciculaceae;Microcoleus PCC-7113;";"100.0";"18.2";"4";"4";"4";"0";"0";"457179";"373890"
"V4mis1";"SILVA (only NR);Bacteria;Cyanobacteria;Cyanobacteriia;Cyanobacteriales;Coleofasciculaceae;Microcoleus SAG 1449-1a;";"100.0";"18.2";"20";"20";"20";"0";"0";"457163";"373874"
"V4mis1";"SILVA (only NR);Bacteria;Cyanobacteria;Cyanobacteriia;Cyanobacteriales;Coleofasciculaceae;Moorea;";"100.0";"18.2";"9";"9";"9";"0";"0";"457174";"373885"
"V4mis1";"SILVA (only NR);Bacteria;Cyanobacteria;Cyanobacteriia;Cyanobacteriales;Coleofasciculaceae;Potamolinea 1PC;";"100.0";"18.2";"6";"6";"6";"0";"0";"457177";"373888"
"V4mis1";"SILVA (only NR);Bacteria;Cyanobacteria;Cyanobacteriia;Cyanobacteriales;Coleofasciculaceae;Symploca PCC-8002;";"100.0";"18.2";"5";"5";"5";"0";"0";"457178";"373889"
"V4mis1";"SILVA (only NR);Bacteria;Cyanobacteria;Cyanobacteriia;Cyanobacteriales;Coleofasciculaceae;Symplocastrum CPER-KK1;";"100.0";"18.2";"4";"4";"4";"0";"0";"457179";"373890"
"V4mis1";"SILVA (only NR);Bacteria;Cyanobacteria;Cyanobacteriia;Cyanobacteriales;Coleofasciculaceae;Wilmottia Ant-Ph58;";"96.2";"18.2";"26";"26";"25";"1";"0";"457157";"373869"
"V4mis1";"SILVA (only NR);Bacteria;Cyanobacteria;Cyanobacteriia;Cyanobacteriales;Coleofasciculaceae;uncultured;";"100.0";"18.2";"17";"17";"17";"0";"0";"457166";"373877"
"V4mis1";"SILVA (only NR);Bacteria;Cyanobacteria;Cyanobacteriia;Cyanobacteriales;Cyanobacteriaceae;";"95.2";"18.2";"125";"125";"119";"6";"0";"457058";"373775"
"V4mis1";"SILVA (only NR);Bacteria;Cyanobacteria;Cyanobacteriia;Cyanobacteriales;Cyanobacteriaceae;Annamia HOs24;";"90.0";"18.2";"10";"10";"9";"1";"0";"457173";"373885"
"V4mis1";"SILVA (only NR);Bacteria;Cyanobacteria;Cyanobacteriia;Cyanobacteriales;Cyanobacteriaceae;Chroococcus HUW 799;";"100.0";"18.2";"2";"2";"2";"0";"0";"457181";"373892"
"V4mis1";"SILVA (only NR);Bacteria;Cyanobacteria;Cyanobacteriia;Cyanobacteriales;Cyanobacteriaceae;Cyanobacterium PCC-10605;";"100.0";"18.2";"7";"7";"7";"0";"0";"457176";"373887"
"V4mis1";"SILVA (only NR);Bacteria;Cyanobacteria;Cyanobacteriia;Cyanobacteriales;Cyanobacteriaceae;Cyanobacterium PCC-7202;";"88.9";"18.2";"9";"9";"8";"1";"0";"457174";"373886"
"V4mis1";"SILVA (only NR);Bacteria;Cyanobacteria;Cyanobacteriia;Cyanobacteriales;Cyanobacteriaceae;Geitlerinema LD9;";"100.0";"18.2";"3";"3";"3";"0";"0";"457180";"373891"
"V4mis1";"SILVA (only NR);Bacteria;Cyanobacteria;Cyanobacteriia;Cyanobacteriales;Cyanobacteriaceae;Geminobacterium;";"100.0";"18.2";"17";"17";"17";"0";"0";"457166";"373877"
"V4mis1";"SILVA (only NR);Bacteria;Cyanobacteria;Cyanobacteriia;Cyanobacteriales;Cyanobacteriaceae;Geminocystis PCC-6308;";"88.2";"18.2";"17";"17";"15";"2";"0";"457166";"373879"
"V4mis1";"SILVA (only NR);Bacteria;Cyanobacteria;Cyanobacteriia;Cyanobacteriales;Cyanobacteriaceae;Merismopedia AICB1015;";"100.0";"18.2";"2";"2";"2";"0";"0";"457181";"373892"
"V4mis1";"SILVA (only NR);Bacteria;Cyanobacteria;Cyanobacteriia;Cyanobacteriales;Cyanobacteriaceae;Symphothece PCC-7002;";"100.0";"18.2";"29";"29";"29";"0";"0";"457154";"373865"
"V4mis1";"SILVA (only NR);Bacteria;Cyanobacteria;Cyanobacteriia;Cyanobacteriales;Cyanobacteriaceae;Synechocystis SAG 90.79;";"100.0";"18.2";"3";"3";"3";"0";"0";"457180";"373891"
"V4mis1";"SILVA (only NR);Bacteria;Cyanobacteria;Cyanobacteriia;Cyanobacteriales;Cyanobacteriaceae;uncultured;";"91.3";"18.2";"23";"23";"21";"2";"0";"457160";"373873"
"V4mis1";"SILVA (only NR);Bacteria;Cyanobacteria;Cyanobacteriia;Cyanobacteriales;Cyanobacteriales Incertae Sedis;";"100.0";"18.2";"17";"17";"17";"0";"0";"457166";"373877"
"V4mis1";"SILVA (only NR);Bacteria;Cyanobacteria;Cyanobacteriia;Cyanobacteriales;Cyanobacteriales Incertae Sedis;Microseira Carmichael-Alabama;";"100.0";"18.2";"11";"11";"11";"0";"0";"457172";"373883"
"V4mis1";"SILVA (only NR);Bacteria;Cyanobacteria;Cyanobacteriia;Cyanobacteriales;Cyanobacteriales Incertae Sedis;Phormidium SAG 81.79;";"100.0";"18.2";"2";"2";"2";"0";"0";"457181";"373892"
"V4mis1";"SILVA (only NR);Bacteria;Cyanobacteria;Cyanobacteriia;Cyanobacteriales;Cyanobacteriales Incertae Sedis;uncultured;";"100.0";"18.2";"2";"2";"2";"0";"0";"457181";"373892"
"V4mis1";"SILVA (only NR);Bacteria;Cyanobacteria;Cyanobacteriia;Cyanobacteriales;Desertifilaceae;";"93.5";"18.2";"31";"31";"29";"2";"0";"457152";"373865"
"V4mis1";"SILVA (only NR);Bacteria;Cyanobacteria;Cyanobacteriia;Cyanobacteriales;Desertifilaceae;CENA533;";"100.0";"18.2";"2";"2";"2";"0";"0";"457181";"373892"
"V4mis1";"SILVA (only NR);Bacteria;Cyanobacteria;Cyanobacteriia;Cyanobacteriales;Desertifilaceae;Desertifilum KR2012-2;";"100.0";"18.2";"3";"3";"3";"0";"0";"457180";"373891"
"V4mis1";"SILVA (only NR);Bacteria;Cyanobacteria;Cyanobacteriia;Cyanobacteriales;Desertifilaceae;Hormoscilla SI04-45;";"83.3";"18.2";"12";"12";"10";"2";"0";"457171";"373884"
"V4mis1";"SILVA (only NR);Bacteria;Cyanobacteria;Cyanobacteriia;Cyanobacteriales;Desertifilaceae;Oscillatoria SAG8.92;";"100.0";"18.2";"2";"2";"2";"0";"0";"457181";"373892"
"V4mis1";"SILVA (only NR);Bacteria;Cyanobacteria;Cyanobacteriia;Cyanobacteriales;Desertifilaceae;Oscillatoria;";"100.0";"18.2";"1";"1";"1";"0";"0";"457182";"373893"
"V4mis1";"SILVA (only NR);Bacteria;Cyanobacteria;Cyanobacteriia;Cyanobacteriales;Desertifilaceae;Roseofilum AO1-A;";"100.0";"18.2";"9";"9";"9";"0";"0";"457174";"373885"
"V4mis1";"SILVA (only NR);Bacteria;Cyanobacteria;Cyanobacteriia;Cyanobacteriales;Geitlerinemaceae;";"92.6";"18.2";"27";"27";"25";"2";"0";"457156";"373869"
"V4mis1";"SILVA (only NR);Bacteria;Cyanobacteria;Cyanobacteriia;Cyanobacteriales;Geitlerinemaceae;Geitlerinema PCC-7105;";"90.9";"18.2";"22";"22";"20";"2";"0";"457161";"373874"
"V4mis1";"SILVA (only NR);Bacteria;Cyanobacteria;Cyanobacteriia;Cyanobacteriales;Geitlerinemaceae;Geitlerinema PCC-9228;";"100.0";"18.2";"4";"4";"4";"0";"0";"457179";"373890"
"V4mis1";"SILVA (only NR);Bacteria;Cyanobacteria;Cyanobacteriia;Cyanobacteriales;Gloeocapsaceae;";"100.0";"18.2";"18";"18";"18";"0";"0";"457165";"373876"
"V4mis1";"SILVA (only NR);Bacteria;Cyanobacteria;Cyanobacteriia;Cyanobacteriales;Gloeocapsaceae;Gloeocapsa;";"100.0";"18.2";"18";"18";"18";"0";"0";"457165";"373876"
"V4mis1";"SILVA (only NR);Bacteria;Cyanobacteria;Cyanobacteriia;Cyanobacteriales;Microcystaceae;";"92.3";"18.2";"182";"182";"168";"14";"0";"457001";"373726"
"V4mis1";"SILVA (only NR);Bacteria;Cyanobacteria;Cyanobacteriia;Cyanobacteriales;Microcystaceae;Aphanotece;";"100.0";"18.2";"1";"1";"1";"0";"0";"457182";"373893"
"V4mis1";"SILVA (only NR);Bacteria;Cyanobacteria;Cyanobacteriia;Cyanobacteriales;Microcystaceae;Atelocyanobacterium (UCYN-A);";"100.0";"18.2";"3";"3";"3";"0";"0";"457180";"373891"
"V4mis1";"SILVA (only NR);Bacteria;Cyanobacteria;Cyanobacteriia;Cyanobacteriales;Microcystaceae;Chalicogloea CCALA 975;";"90.9";"18.2";"11";"11";"10";"1";"0";"457172";"373884"
"V4mis1";"SILVA (only NR);Bacteria;Cyanobacteria;Cyanobacteriia;Cyanobacteriales;Microcystaceae;Crocosphaera;";"100.0";"18.2";"1";"1";"1";"0";"0";"457182";"373893"
"V4mis1";"SILVA (only NR);Bacteria;Cyanobacteria;Cyanobacteriia;Cyanobacteriales;Microcystaceae;Cyanothece ATCC 51142 (UCYN-C);";"100.0";"18.2";"3";"3";"3";"0";"0";"457180";"373891"
"V4mis1";"SILVA (only NR);Bacteria;Cyanobacteria;Cyanobacteriia;Cyanobacteriales;Microcystaceae;Cyanothece PCC-7424;";"100.0";"18.2";"6";"6";"6";"0";"0";"457177";"373888"
"V4mis1";"SILVA (only NR);Bacteria;Cyanobacteria;Cyanobacteriia;Cyanobacteriales;Microcystaceae;Cyanothece PCC-8801;";"100.0";"18.2";"4";"4";"4";"0";"0";"457179";"373890"
"V4mis1";"SILVA (only NR);Bacteria;Cyanobacteria;Cyanobacteriia;Cyanobacteriales;Microcystaceae;Gloeothece PCC-6501;";"100.0";"18.2";"3";"3";"3";"0";"0";"457180";"373891"
"V4mis1";"SILVA (only NR);Bacteria;Cyanobacteria;Cyanobacteriia;Cyanobacteriales;Microcystaceae;Merismopedia 0BB39S01;";"66.7";"18.2";"3";"3";"2";"1";"0";"457180";"373892"
"V4mis1";"SILVA (only NR);Bacteria;Cyanobacteria;Cyanobacteriia;Cyanobacteriales;Microcystaceae;Microcystis PCC-7914;";"89.0";"18.2";"73";"73";"65";"8";"0";"457110";"373829"
"V4mis1";"SILVA (only NR);Bacteria;Cyanobacteria;Cyanobacteriia;Cyanobacteriales;Microcystaceae;Pleurocapsa PCC-7327;";"100.0";"18.2";"5";"5";"5";"0";"0";"457178";"373889"
"V4mis1";"SILVA (only NR);Bacteria;Cyanobacteria;Cyanobacteriia;Cyanobacteriales;Microcystaceae;SU2 symbiont group;";"100.0";"18.2";"7";"7";"7";"0";"0";"457176";"373887"
"V4mis1";"SILVA (only NR);Bacteria;Cyanobacteria;Cyanobacteriia;Cyanobacteriales;Microcystaceae;Snowella 0TU37S04;";"100.0";"18.2";"12";"12";"12";"0";"0";"457171";"373882"
"V4mis1";"SILVA (only NR);Bacteria;Cyanobacteria;Cyanobacteriia;Cyanobacteriales;Microcystaceae;Synechocystis BDHKU-20401;";"75.0";"18.2";"12";"12";"9";"3";"0";"457171";"373885"
"V4mis1";"SILVA (only NR);Bacteria;Cyanobacteria;Cyanobacteriia;Cyanobacteriales;Microcystaceae;Synechocystis CCALA 700;";"100.0";"18.2";"4";"4";"4";"0";"0";"457179";"373890"
"V4mis1";"SILVA (only NR);Bacteria;Cyanobacteria;Cyanobacteriia;Cyanobacteriales;Microcystaceae;Synechocystis PCC-6803;";"100.0";"18.2";"27";"27";"27";"0";"0";"457156";"373867"
"V4mis1";"SILVA (only NR);Bacteria;Cyanobacteria;Cyanobacteriia;Cyanobacteriales;Microcystaceae;UCYN-C;";"100.0";"18.2";"2";"2";"2";"0";"0";"457181";"373892"
"V4mis1";"SILVA (only NR);Bacteria;Cyanobacteria;Cyanobacteriia;Cyanobacteriales;Microcystaceae;uncultured;";"100.0";"18.2";"2";"2";"2";"0";"0";"457181";"373892"
"V4mis1";"SILVA (only NR);Bacteria;Cyanobacteria;Cyanobacteriia;Cyanobacteriales;Nostocaceae;";"96.2";"18.3";"1092";"1092";"1051";"41";"0";"456091";"372843"
"V4mis1";"SILVA (only NR);Bacteria;Cyanobacteria;Cyanobacteriia;Cyanobacteriales;Nostocaceae;Aetokthonos AEL04;";"100.0";"18.2";"2";"2";"2";"0";"0";"457181";"373892"
"V4mis1";"SILVA (only NR);Bacteria;Cyanobacteria;Cyanobacteriia;Cyanobacteriales;Nostocaceae;Anabaena BECID22;";"100.0";"18.2";"3";"3";"3";"0";"0";"457180";"373891"
"V4mis1";"SILVA (only NR);Bacteria;Cyanobacteria;Cyanobacteriia;Cyanobacteriales;Nostocaceae;Anabaena HBU1;";"100.0";"18.2";"2";"2";"2";"0";"0";"457181";"373892"
"V4mis1";"SILVA (only NR);Bacteria;Cyanobacteria;Cyanobacteriia;Cyanobacteriales;Nostocaceae;Anabaena PCC-7108;";"100.0";"18.2";"5";"5";"5";"0";"0";"457178";"373889"
"V4mis1";"SILVA (only NR);Bacteria;Cyanobacteria;Cyanobacteriia;Cyanobacteriales;Nostocaceae;Anabaena PCC-7122;";"100.0";"18.2";"23";"23";"23";"0";"0";"457160";"373871"
"V4mis1";"SILVA (only NR);Bacteria;Cyanobacteria;Cyanobacteriia;Cyanobacteriales;Nostocaceae;Anabaena XPORK15F;";"100.0";"18.2";"5";"5";"5";"0";"0";"457178";"373889"
"V4mis1";"SILVA (only NR);Bacteria;Cyanobacteria;Cyanobacteriia;Cyanobacteriales;Nostocaceae;Anabaenopsis;";"100.0";"18.2";"1";"1";"1";"0";"0";"457182";"373893"
"V4mis1";"SILVA (only NR);Bacteria;Cyanobacteria;Cyanobacteriia;Cyanobacteriales;Nostocaceae;Ancylothrix 8PC;";"100.0";"18.2";"4";"4";"4";"0";"0";"457179";"373890"
"V4mis1";"SILVA (only NR);Bacteria;Cyanobacteria;Cyanobacteriia;Cyanobacteriales;Nostocaceae;Aphanizomenon MDT14a;";"90.9";"18.2";"11";"11";"10";"1";"0";"457172";"373884"
"V4mis1";"SILVA (only NR);Bacteria;Cyanobacteria;Cyanobacteriia;Cyanobacteriales;Nostocaceae;Aphanizomenon NIES81;";"96.3";"18.2";"27";"27";"26";"1";"0";"457156";"373868"
"V4mis1";"SILVA (only NR);Bacteria;Cyanobacteria;Cyanobacteriia;Cyanobacteriales;Nostocaceae;Calothrix NIES-2100;";"100.0";"18.2";"2";"2";"2";"0";"0";"457181";"373892"
"V4mis1";"SILVA (only NR);Bacteria;Cyanobacteria;Cyanobacteriia;Cyanobacteriales;Nostocaceae;Calothrix PCC-6303;";"93.3";"18.2";"89";"89";"83";"6";"0";"457094";"373811"
"V4mis1";"SILVA (only NR);Bacteria;Cyanobacteria;Cyanobacteriia;Cyanobacteriales;Nostocaceae;Calothrix PCC-7507;";"100.0";"18.2";"3";"3";"3";"0";"0";"457180";"373891"
"V4mis1";"SILVA (only NR);Bacteria;Cyanobacteria;Cyanobacteriia;Cyanobacteriales;Nostocaceae;Calothrix PMC232.04;";"100.0";"18.2";"3";"3";"3";"0";"0";"457180";"373891"
"V4mis1";"SILVA (only NR);Bacteria;Cyanobacteria;Cyanobacteriia;Cyanobacteriales;Nostocaceae;Calothrix UAM 374;";"90.9";"18.2";"11";"11";"10";"1";"0";"457172";"373884"
"V4mis1";"SILVA (only NR);Bacteria;Cyanobacteria;Cyanobacteriia;Cyanobacteriales;Nostocaceae;Chlorogloeopsis PCC-7518;";"100.0";"18.2";"8";"8";"8";"0";"0";"457175";"373886"
"V4mis1";"SILVA (only NR);Bacteria;Cyanobacteria;Cyanobacteriia;Cyanobacteriales;Nostocaceae;Cuspidothrix LMECYA 163;";"100.0";"18.2";"10";"10";"10";"0";"0";"457173";"373884"
"V4mis1";"SILVA (only NR);Bacteria;Cyanobacteria;Cyanobacteriia;Cyanobacteriales;Nostocaceae;Cylindrospermopsis CRJ1;";"94.1";"18.2";"17";"17";"16";"1";"0";"457166";"373878"
"V4mis1";"SILVA (only NR);Bacteria;Cyanobacteria;Cyanobacteriia;Cyanobacteriales;Nostocaceae;Cylindrospermum CENA33;";"100.0";"18.2";"2";"2";"2";"0";"0";"457181";"373892"
"V4mis1";"SILVA (only NR);Bacteria;Cyanobacteria;Cyanobacteriia;Cyanobacteriales;Nostocaceae;Cylindrospermum NQAIF308;";"100.0";"18.2";"2";"2";"2";"0";"0";"457181";"373892"
"V4mis1";"SILVA (only NR);Bacteria;Cyanobacteria;Cyanobacteriia;Cyanobacteriales;Nostocaceae;Cylindrospermum PCC-7417;";"100.0";"18.2";"9";"9";"9";"0";"0";"457174";"373885"
"V4mis1";"SILVA (only NR);Bacteria;Cyanobacteria;Cyanobacteriia;Cyanobacteriales;Nostocaceae;Cylindrospermum PMC238.04;";"100.0";"18.2";"2";"2";"2";"0";"0";"457181";"373892"
"V4mis1";"SILVA (only NR);Bacteria;Cyanobacteria;Cyanobacteriia;Cyanobacteriales;Nostocaceae;Cylindrospermum SAG 11.82;";"100.0";"18.2";"2";"2";"2";"0";"0";"457181";"373892"
"V4mis1";"SILVA (only NR);Bacteria;Cyanobacteria;Cyanobacteriia;Cyanobacteriales;Nostocaceae;Desmonostoc PCC-6302;";"100.0";"18.2";"3";"3";"3";"0";"0";"457180";"373891"
"V4mis1";"SILVA (only NR);Bacteria;Cyanobacteria;Cyanobacteriia;Cyanobacteriales;Nostocaceae;Desmonostoc PCC-7422;";"94.7";"18.2";"38";"38";"36";"2";"0";"457145";"373858"
"V4mis1";"SILVA (only NR);Bacteria;Cyanobacteria;Cyanobacteriia;Cyanobacteriales;Nostocaceae;Dolichospermum NIES41;";"100.0";"18.2";"52";"52";"52";"0";"0";"457131";"373842"
"V4mis1";"SILVA (only NR);Bacteria;Cyanobacteria;Cyanobacteriia;Cyanobacteriales;Nostocaceae;Ewamiania TS0513;";"50.0";"18.2";"2";"2";"1";"1";"0";"457181";"373893"
"V4mis1";"SILVA (only NR);Bacteria;Cyanobacteria;Cyanobacteriia;Cyanobacteriales;Nostocaceae;Fischerella CENA298;";"100.0";"18.2";"2";"2";"2";"0";"0";"457181";"373892"
"V4mis1";"SILVA (only NR);Bacteria;Cyanobacteria;Cyanobacteriia;Cyanobacteriales;Nostocaceae;Fischerella PCC-9339;";"96.3";"18.2";"54";"54";"52";"2";"0";"457129";"373842"
"V4mis1";"SILVA (only NR);Bacteria;Cyanobacteria;Cyanobacteriia;Cyanobacteriales;Nostocaceae;Fortiea PCC-7126;";"100.0";"18.2";"1";"1";"1";"0";"0";"457182";"373893"
"V4mis1";"SILVA (only NR);Bacteria;Cyanobacteria;Cyanobacteriia;Cyanobacteriales;Nostocaceae;Gloeotrichia PYH6;";"100.0";"18.2";"2";"2";"2";"0";"0";"457181";"373892"
"V4mis1";"SILVA (only NR);Bacteria;Cyanobacteria;Cyanobacteriia;Cyanobacteriales;Nostocaceae;Gloeotrichia SAG 32.84;";"66.7";"18.2";"3";"3";"2";"1";"0";"457180";"373892"
"V4mis1";"SILVA (only NR);Bacteria;Cyanobacteria;Cyanobacteriia;Cyanobacteriales;Nostocaceae;Halotia CENA158;";"100.0";"18.2";"3";"3";"3";"0";"0";"457180";"373891"
"V4mis1";"SILVA (only NR);Bacteria;Cyanobacteria;Cyanobacteriia;Cyanobacteriales;Nostocaceae;Iphinoe LOS-B1;";"100.0";"18.2";"4";"4";"4";"0";"0";"457179";"373890"
"V4mis1";"SILVA (only NR);Bacteria;Cyanobacteria;Cyanobacteriia;Cyanobacteriales;Nostocaceae;Mastigocladopsis PCC-10914;";"94.4";"18.2";"18";"18";"17";"1";"0";"457165";"373877"
"V4mis1";"SILVA (only NR);Bacteria;Cyanobacteria;Cyanobacteriia;Cyanobacteriales;Nostocaceae;Mastigocoleus BC008;";"100.0";"18.2";"2";"2";"2";"0";"0";"457181";"373892"
"V4mis1";"SILVA (only NR);Bacteria;Cyanobacteria;Cyanobacteriia;Cyanobacteriales;Nostocaceae;Nodularia PCC-9350;";"100.0";"18.2";"41";"41";"41";"0";"0";"457142";"373853"
"V4mis1";"SILVA (only NR);Bacteria;Cyanobacteria;Cyanobacteriia;Cyanobacteriales;Nostocaceae;Nostoc 0708;";"100.0";"18.2";"1";"1";"1";"0";"0";"457182";"373893"
"V4mis1";"SILVA (only NR);Bacteria;Cyanobacteria;Cyanobacteriia;Cyanobacteriales;Nostocaceae;Nostoc BDU-40302;";"85.7";"18.2";"7";"7";"6";"1";"0";"457176";"373888"
"V4mis1";"SILVA (only NR);Bacteria;Cyanobacteria;Cyanobacteriia;Cyanobacteriales;Nostocaceae;Nostoc PCC-7107;";"93.8";"18.2";"48";"48";"45";"3";"0";"457135";"373849"
"V4mis1";"SILVA (only NR);Bacteria;Cyanobacteria;Cyanobacteriia;Cyanobacteriales;Nostocaceae;Nostoc PCC-73102;";"98.6";"18.2";"145";"145";"143";"2";"0";"457038";"373751"
"V4mis1";"SILVA (only NR);Bacteria;Cyanobacteria;Cyanobacteriia;Cyanobacteriales;Nostocaceae;Nostoc PCC-7524;";"92.7";"18.2";"55";"55";"51";"4";"0";"457128";"373843"
"V4mis1";"SILVA (only NR);Bacteria;Cyanobacteria;Cyanobacteriia;Cyanobacteriales;Nostocaceae;Nostoc PCC-8976;";"96.8";"18.2";"31";"31";"30";"1";"0";"457152";"373864"
"V4mis1";"SILVA (only NR);Bacteria;Cyanobacteria;Cyanobacteriia;Cyanobacteriales;Nostocaceae;Nostoc SAG 60.79;";"100.0";"18.2";"6";"6";"6";"0";"0";"457177";"373888"
"V4mis1";"SILVA (only NR);Bacteria;Cyanobacteria;Cyanobacteriia;Cyanobacteriales;Nostocaceae;Nostoc;";"100.0";"18.2";"1";"1";"1";"0";"0";"457182";"373893"
"V4mis1";"SILVA (only NR);Bacteria;Cyanobacteria;Cyanobacteriia;Cyanobacteriales;Nostocaceae;Petalonema ANT.LG2.8;";"100.0";"18.2";"8";"8";"8";"0";"0";"457175";"373886"
"V4mis1";"SILVA (only NR);Bacteria;Cyanobacteria;Cyanobacteriia;Cyanobacteriales;Nostocaceae;Phyllonema CENA325;";"100.0";"18.2";"2";"2";"2";"0";"0";"457181";"373892"
"V4mis1";"SILVA (only NR);Bacteria;Cyanobacteria;Cyanobacteriia;Cyanobacteriales;Nostocaceae;Richelia HH01;";"100.0";"18.2";"5";"5";"5";"0";"0";"457178";"373889"
"V4mis1";"SILVA (only NR);Bacteria;Cyanobacteria;Cyanobacteriia;Cyanobacteriales;Nostocaceae;Rivularia PCC-7116;";"85.7";"18.2";"42";"42";"36";"6";"0";"457141";"373858"
"V4mis1";"SILVA (only NR);Bacteria;Cyanobacteria;Cyanobacteriia;Cyanobacteriales;Nostocaceae;Scytonema PCC-7110;";"89.5";"18.2";"19";"19";"17";"2";"0";"457164";"373877"
"V4mis1";"SILVA (only NR);Bacteria;Cyanobacteria;Cyanobacteriia;Cyanobacteriales;Nostocaceae;Scytonema UCFS19;";"100.0";"18.2";"4";"4";"4";"0";"0";"457179";"373890"
"V4mis1";"SILVA (only NR);Bacteria;Cyanobacteria;Cyanobacteriia;Cyanobacteriales;Nostocaceae;Scytonema UTEX 2349;";"97.3";"18.2";"37";"37";"36";"1";"0";"457146";"373858"
"V4mis1";"SILVA (only NR);Bacteria;Cyanobacteria;Cyanobacteriia;Cyanobacteriales;Nostocaceae;Scytonema VB-61278;";"96.0";"18.2";"25";"25";"24";"1";"0";"457158";"373870"
"V4mis1";"SILVA (only NR);Bacteria;Cyanobacteria;Cyanobacteriia;Cyanobacteriales;Nostocaceae;Sphaerospermopsis BCCUSP55;";"96.2";"18.2";"26";"26";"25";"1";"0";"457157";"373869"
"V4mis1";"SILVA (only NR);Bacteria;Cyanobacteria;Cyanobacteriia;Cyanobacteriales;Nostocaceae;Stigonema SAG 48.90;";"100.0";"18.2";"31";"31";"31";"0";"0";"457152";"373863"
"V4mis1";"SILVA (only NR);Bacteria;Cyanobacteria;Cyanobacteriia;Cyanobacteriales;Nostocaceae;Synechococcus PCC-7902;";"100.0";"18.2";"2";"2";"2";"0";"0";"457181";"373892"
"V4mis1";"SILVA (only NR);Bacteria;Cyanobacteria;Cyanobacteriia;Cyanobacteriales;Nostocaceae;Tolypothrix;";"98.4";"18.2";"63";"63";"62";"1";"0";"457120";"373832"
"V4mis1";"SILVA (only NR);Bacteria;Cyanobacteria;Cyanobacteriia;Cyanobacteriales;Nostocaceae;Trichormus HINDAK 2001-4;";"80.0";"18.2";"5";"5";"4";"1";"0";"457178";"373890"
"V4mis1";"SILVA (only NR);Bacteria;Cyanobacteria;Cyanobacteriia;Cyanobacteriales;Nostocaceae;uncultured;";"100.0";"18.2";"30";"30";"30";"0";"0";"457153";"373864"
"V4mis1";"SILVA (only NR);Bacteria;Cyanobacteria;Cyanobacteriia;Cyanobacteriales;Oscillatoriaceae;";"93.8";"18.2";"65";"65";"61";"4";"0";"457118";"373833"
"V4mis1";"SILVA (only NR);Bacteria;Cyanobacteria;Cyanobacteriia;Cyanobacteriales;Oscillatoriaceae;Oscillatoria PCC-10802;";"100.0";"18.2";"21";"21";"21";"0";"0";"457162";"373873"
"V4mis1";"SILVA (only NR);Bacteria;Cyanobacteria;Cyanobacteriia;Cyanobacteriales;Oscillatoriaceae;Oscillatoria PCC-6304;";"89.5";"18.2";"19";"19";"17";"2";"0";"457164";"373877"
"V4mis1";"SILVA (only NR);Bacteria;Cyanobacteria;Cyanobacteriia;Cyanobacteriales;Oscillatoriaceae;Oxynema BDU 92071;";"80.0";"18.2";"5";"5";"4";"1";"0";"457178";"373890"
"V4mis1";"SILVA (only NR);Bacteria;Cyanobacteria;Cyanobacteriia;Cyanobacteriales;Oscillatoriaceae;Phormidium ETS-05;";"100.0";"18.2";"5";"5";"5";"0";"0";"457178";"373889"
"V4mis1";"SILVA (only NR);Bacteria;Cyanobacteria;Cyanobacteriia;Cyanobacteriales;Oscillatoriaceae;Planktothricoides SR001;";"88.9";"18.2";"9";"9";"8";"1";"0";"457174";"373886"
"V4mis1";"SILVA (only NR);Bacteria;Cyanobacteria;Cyanobacteriia;Cyanobacteriales;Oscillatoriaceae;uncultured;";"100.0";"18.2";"6";"6";"6";"0";"0";"457177";"373888"
"V4mis1";"SILVA (only NR);Bacteria;Cyanobacteria;Cyanobacteriia;Cyanobacteriales;Paraspirulinaceae;";"91.9";"18.2";"62";"62";"57";"5";"0";"457121";"373837"
"V4mis1";"SILVA (only NR);Bacteria;Cyanobacteria;Cyanobacteriia;Cyanobacteriales;Paraspirulinaceae;ESFC-1;";"61.5";"18.2";"13";"13";"8";"5";"0";"457170";"373886"
"V4mis1";"SILVA (only NR);Bacteria;Cyanobacteria;Cyanobacteriia;Cyanobacteriales;Paraspirulinaceae;Halospirulina CCC Baja-95 Cl.2;";"100.0";"18.2";"10";"10";"10";"0";"0";"457173";"373884"
"V4mis1";"SILVA (only NR);Bacteria;Cyanobacteria;Cyanobacteriia;Cyanobacteriales;Paraspirulinaceae;Spirulina CCC Snake P-Y-85;";"100.0";"18.2";"12";"12";"12";"0";"0";"457171";"373882"
"V4mis1";"SILVA (only NR);Bacteria;Cyanobacteria;Cyanobacteriia;Cyanobacteriales;Paraspirulinaceae;Spirulina DRTO-55.2;";"100.0";"18.2";"4";"4";"4";"0";"0";"457179";"373890"
"V4mis1";"SILVA (only NR);Bacteria;Cyanobacteria;Cyanobacteriia;Cyanobacteriales;Paraspirulinaceae;Spirulina P7;";"100.0";"18.2";"4";"4";"4";"0";"0";"457179";"373890"
"V4mis1";"SILVA (only NR);Bacteria;Cyanobacteria;Cyanobacteriia;Cyanobacteriales;Paraspirulinaceae;Spirulina PCC-6313;";"100.0";"18.2";"6";"6";"6";"0";"0";"457177";"373888"
"V4mis1";"SILVA (only NR);Bacteria;Cyanobacteria;Cyanobacteriia;Cyanobacteriales;Paraspirulinaceae;Spirulina PCC-9445;";"100.0";"18.2";"5";"5";"5";"0";"0";"457178";"373889"
"V4mis1";"SILVA (only NR);Bacteria;Cyanobacteria;Cyanobacteriia;Cyanobacteriales;Paraspirulinaceae;uncultured;";"100.0";"18.2";"5";"5";"5";"0";"0";"457178";"373889"
"V4mis1";"SILVA (only NR);Bacteria;Cyanobacteria;Cyanobacteriia;Cyanobacteriales;Phormidiaceae;";"95.1";"18.2";"307";"307";"292";"15";"0";"456876";"373602"
"V4mis1";"SILVA (only NR);Bacteria;Cyanobacteria;Cyanobacteriia;Cyanobacteriales;Phormidiaceae;Aerosakkonema Lao26;";"100.0";"18.2";"2";"2";"2";"0";"0";"457181";"373892"
"V4mis1";"SILVA (only NR);Bacteria;Cyanobacteria;Cyanobacteriia;Cyanobacteriales;Phormidiaceae;Arthrospira PCC-7345;";"92.1";"18.2";"38";"38";"35";"3";"0";"457145";"373859"
"V4mis1";"SILVA (only NR);Bacteria;Cyanobacteria;Cyanobacteriia;Cyanobacteriales;Phormidiaceae;Cephalothrix SAG 75.79;";"100.0";"18.2";"14";"14";"14";"0";"0";"457169";"373880"
"V4mis1";"SILVA (only NR);Bacteria;Cyanobacteria;Cyanobacteriia;Cyanobacteriales;Phormidiaceae;Kamptonema PCC-6407;";"100.0";"18.2";"10";"10";"10";"0";"0";"457173";"373884"
"V4mis1";"SILVA (only NR);Bacteria;Cyanobacteria;Cyanobacteriia;Cyanobacteriales;Phormidiaceae;Lyngbya PCC-7419;";"84.1";"18.2";"44";"44";"37";"7";"0";"457139";"373857"
"V4mis1";"SILVA (only NR);Bacteria;Cyanobacteria;Cyanobacteriia;Cyanobacteriales;Phormidiaceae;Phormidium IAM M-71;";"94.1";"18.2";"17";"17";"16";"1";"0";"457166";"373878"
"V4mis1";"SILVA (only NR);Bacteria;Cyanobacteria;Cyanobacteriia;Cyanobacteriales;Phormidiaceae;Planktothrix NIVA-CYA 15;";"100.0";"18.2";"61";"61";"61";"0";"0";"457122";"373833"
"V4mis1";"SILVA (only NR);Bacteria;Cyanobacteria;Cyanobacteriia;Cyanobacteriales;Phormidiaceae;Trichocoleus SAG 26.92;";"100.0";"18.2";"6";"6";"6";"0";"0";"457177";"373888"
"V4mis1";"SILVA (only NR);Bacteria;Cyanobacteria;Cyanobacteriia;Cyanobacteriales;Phormidiaceae;Trichodesmium IMS101;";"97.5";"18.2";"40";"40";"39";"1";"0";"457143";"373855"
"V4mis1";"SILVA (only NR);Bacteria;Cyanobacteria;Cyanobacteriia;Cyanobacteriales;Phormidiaceae;Tychonema CCAP 1459-11B;";"94.7";"18.2";"57";"57";"54";"3";"0";"457126";"373840"
"V4mis1";"SILVA (only NR);Bacteria;Cyanobacteria;Cyanobacteriia;Cyanobacteriales;Phormidiaceae;uncultured;";"100.0";"18.2";"13";"13";"13";"0";"0";"457170";"373881"
"V4mis1";"SILVA (only NR);Bacteria;Cyanobacteria;Cyanobacteriia;Cyanobacteriales;Prochloraceae;";"100.0";"18.2";"14";"14";"14";"0";"0";"457169";"373880"
"V4mis1";"SILVA (only NR);Bacteria;Cyanobacteria;Cyanobacteriia;Cyanobacteriales;Prochloraceae;Prochloron P1-Palau;";"100.0";"18.2";"14";"14";"14";"0";"0";"457169";"373880"
"V4mis1";"SILVA (only NR);Bacteria;Cyanobacteria;Cyanobacteriia;Cyanobacteriales;Rubidibacteraceae;";"91.0";"18.2";"89";"89";"81";"8";"0";"457094";"373813"
"V4mis1";"SILVA (only NR);Bacteria;Cyanobacteria;Cyanobacteriia;Cyanobacteriales;Rubidibacteraceae;Dactylococcopsis PCC-8305;";"90.2";"18.2";"82";"82";"74";"8";"0";"457101";"373820"
"V4mis1";"SILVA (only NR);Bacteria;Cyanobacteria;Cyanobacteriia;Cyanobacteriales;Rubidibacteraceae;Rubidibacter KORDI 51-2;";"100.0";"18.2";"2";"2";"2";"0";"0";"457181";"373892"
"V4mis1";"SILVA (only NR);Bacteria;Cyanobacteria;Cyanobacteriia;Cyanobacteriales;Rubidibacteraceae;uncultured;";"100.0";"18.2";"5";"5";"5";"0";"0";"457178";"373889"
"V4mis1";"SILVA (only NR);Bacteria;Cyanobacteria;Cyanobacteriia;Cyanobacteriales;Xenococcaceae;";"92.7";"18.2";"123";"123";"114";"9";"0";"457060";"373780"
"V4mis1";"SILVA (only NR);Bacteria;Cyanobacteria;Cyanobacteriia;Cyanobacteriales;Xenococcaceae;Chroococcidiopsis PCC-6712;";"100.0";"18.2";"6";"6";"6";"0";"0";"457177";"373888"
"V4mis1";"SILVA (only NR);Bacteria;Cyanobacteria;Cyanobacteriia;Cyanobacteriales;Xenococcaceae;Chroococcopsis;";"100.0";"18.2";"1";"1";"1";"0";"0";"457182";"373893"
"V4mis1";"SILVA (only NR);Bacteria;Cyanobacteria;Cyanobacteriia;Cyanobacteriales;Xenococcaceae;Foliisarcina;";"100.0";"18.2";"1";"1";"1";"0";"0";"457182";"373893"
"V4mis1";"SILVA (only NR);Bacteria;Cyanobacteria;Cyanobacteriia;Cyanobacteriales;Xenococcaceae;Gloeocapsopsis BDHKU 35101;";"100.0";"18.2";"2";"2";"2";"0";"0";"457181";"373892"
"V4mis1";"SILVA (only NR);Bacteria;Cyanobacteria;Cyanobacteriia;Cyanobacteriales;Xenococcaceae;Myxosarcina GI1;";"100.0";"18.2";"2";"2";"2";"0";"0";"457181";"373892"
"V4mis1";"SILVA (only NR);Bacteria;Cyanobacteria;Cyanobacteriia;Cyanobacteriales;Xenococcaceae;Pleurocapsa PCC-7319;";"93.1";"18.2";"58";"58";"54";"4";"0";"457125";"373840"
"V4mis1";"SILVA (only NR);Bacteria;Cyanobacteria;Cyanobacteriia;Cyanobacteriales;Xenococcaceae;Stanieria PCC-7437;";"100.0";"18.2";"4";"4";"4";"0";"0";"457179";"373890"
"V4mis1";"SILVA (only NR);Bacteria;Cyanobacteria;Cyanobacteriia;Cyanobacteriales;Xenococcaceae;Xenococcus CRM;";"100.0";"18.2";"7";"7";"7";"0";"0";"457176";"373887"
"V4mis1";"SILVA (only NR);Bacteria;Cyanobacteria;Cyanobacteriia;Cyanobacteriales;Xenococcaceae;Xenococcus PCC-7305;";"94.4";"18.2";"18";"18";"17";"1";"0";"457165";"373877"
"V4mis1";"SILVA (only NR);Bacteria;Cyanobacteria;Cyanobacteriia;Cyanobacteriales;Xenococcaceae;uncultured;";"82.6";"18.2";"23";"23";"19";"4";"0";"457160";"373875"
"V4mis1";"SILVA (only NR);Bacteria;Cyanobacteria;Cyanobacteriia;Cyanobacteriales;uncultured;";"93.8";"18.2";"128";"128";"120";"8";"0";"457055";"373774"
"V4mis1";"SILVA (only NR);Bacteria;Cyanobacteria;Cyanobacteriia;Eurycoccales;";"100.0";"18.2";"41";"41";"41";"0";"0";"457142";"373853"
"V4mis1";"SILVA (only NR);Bacteria;Cyanobacteria;Cyanobacteriia;Eurycoccales;Eurycoccales Incertae Sedis;";"100.0";"18.2";"20";"20";"20";"0";"0";"457163";"373874"
"V4mis1";"SILVA (only NR);Bacteria;Cyanobacteria;Cyanobacteriia;Eurycoccales;Eurycoccales Incertae Sedis;Candidatus Gloeomargarita;";"100.0";"18.2";"12";"12";"12";"0";"0";"457171";"373882"
"V4mis1";"SILVA (only NR);Bacteria;Cyanobacteria;Cyanobacteriia;Eurycoccales;Eurycoccales Incertae Sedis;Synechococcus PCC-7336;";"100.0";"18.2";"8";"8";"8";"0";"0";"457175";"373886"
"V4mis1";"SILVA (only NR);Bacteria;Cyanobacteria;Cyanobacteriia;Eurycoccales;Leptococcaceae;";"100.0";"18.2";"11";"11";"11";"0";"0";"457172";"373883"
"V4mis1";"SILVA (only NR);Bacteria;Cyanobacteria;Cyanobacteriia;Eurycoccales;Leptococcaceae;Leptococcus JA-3-3Ab;";"100.0";"18.2";"11";"11";"11";"0";"0";"457172";"373883"
"V4mis1";"SILVA (only NR);Bacteria;Cyanobacteria;Cyanobacteriia;Eurycoccales;uncultured;";"100.0";"18.2";"10";"10";"10";"0";"0";"457173";"373884"
"V4mis1";"SILVA (only NR);Bacteria;Cyanobacteria;Cyanobacteriia;Geitlerinematales;";"100.0";"18.2";"1";"1";"1";"0";"0";"457182";"373893"
"V4mis1";"SILVA (only NR);Bacteria;Cyanobacteria;Cyanobacteriia;Geitlerinematales;Geitlerinemataceae;";"100.0";"18.2";"1";"1";"1";"0";"0";"457182";"373893"
"V4mis1";"SILVA (only NR);Bacteria;Cyanobacteria;Cyanobacteriia;Geitlerinematales;Geitlerinemataceae;Geitlerinema;";"100.0";"18.2";"1";"1";"1";"0";"0";"457182";"373893"
"V4mis1";"SILVA (only NR);Bacteria;Cyanobacteria;Cyanobacteriia;Gloeobacterales;";"100.0";"18.2";"6";"6";"6";"0";"0";"457177";"373888"
"V4mis1";"SILVA (only NR);Bacteria;Cyanobacteria;Cyanobacteriia;Gloeobacterales;Gloeobacteraceae;";"100.0";"18.2";"6";"6";"6";"0";"0";"457177";"373888"
"V4mis1";"SILVA (only NR);Bacteria;Cyanobacteria;Cyanobacteriia;Gloeobacterales;Gloeobacteraceae;Gloeobacter PCC-7421;";"100.0";"18.2";"6";"6";"6";"0";"0";"457177";"373888"
"V4mis1";"SILVA (only NR);Bacteria;Cyanobacteria;Cyanobacteriia;Leptolyngbyales;";"93.7";"18.2";"617";"617";"578";"39";"0";"456566";"373316"
"V4mis1";"SILVA (only NR);Bacteria;Cyanobacteria;Cyanobacteriia;Leptolyngbyales;Leptolyngbyaceae;";"93.7";"18.2";"617";"617";"578";"39";"0";"456566";"373316"
"V4mis1";"SILVA (only NR);Bacteria;Cyanobacteria;Cyanobacteriia;Leptolyngbyales;Leptolyngbyaceae;Alkalinema CENA528;";"100.0";"18.2";"2";"2";"2";"0";"0";"457181";"373892"
"V4mis1";"SILVA (only NR);Bacteria;Cyanobacteria;Cyanobacteriia;Leptolyngbyales;Leptolyngbyaceae;Arthronema SAG 12.89;";"100.0";"18.2";"4";"4";"4";"0";"0";"457179";"373890"
"V4mis1";"SILVA (only NR);Bacteria;Cyanobacteria;Cyanobacteriia;Leptolyngbyales;Leptolyngbyaceae;BMM02;";"100.0";"18.2";"3";"3";"3";"0";"0";"457180";"373891"
"V4mis1";"SILVA (only NR);Bacteria;Cyanobacteria;Cyanobacteriia;Leptolyngbyales;Leptolyngbyaceae;CENA359;";"100.0";"18.2";"13";"13";"13";"0";"0";"457170";"373881"
"V4mis1";"SILVA (only NR);Bacteria;Cyanobacteria;Cyanobacteriia;Leptolyngbyales;Leptolyngbyaceae;CENA384;";"100.0";"18.2";"2";"2";"2";"0";"0";"457181";"373892"
"V4mis1";"SILVA (only NR);Bacteria;Cyanobacteria;Cyanobacteriia;Leptolyngbyales;Leptolyngbyaceae;CENA518;";"100.0";"18.2";"3";"3";"3";"0";"0";"457180";"373891"
"V4mis1";"SILVA (only NR);Bacteria;Cyanobacteria;Cyanobacteriia;Leptolyngbyales;Leptolyngbyaceae;Calenema;";"100.0";"18.2";"7";"7";"7";"0";"0";"457176";"373887"
"V4mis1";"SILVA (only NR);Bacteria;Cyanobacteria;Cyanobacteriia;Leptolyngbyales;Leptolyngbyaceae;Calothrix KVSF5;";"100.0";"18.2";"14";"14";"14";"0";"0";"457169";"373880"
"V4mis1";"SILVA (only NR);Bacteria;Cyanobacteria;Cyanobacteriia;Leptolyngbyales;Leptolyngbyaceae;Chamaesiphon PCC-7430;";"100.0";"18.2";"19";"19";"19";"0";"0";"457164";"373875"
"V4mis1";"SILVA (only NR);Bacteria;Cyanobacteria;Cyanobacteriia;Leptolyngbyales;Leptolyngbyaceae;EcFYyy-200;";"100.0";"18.2";"6";"6";"6";"0";"0";"457177";"373888"
"V4mis1";"SILVA (only NR);Bacteria;Cyanobacteria;Cyanobacteriia;Leptolyngbyales;Leptolyngbyaceae;Fr127;";"100.0";"18.2";"5";"5";"5";"0";"0";"457178";"373889"
"V4mis1";"SILVA (only NR);Bacteria;Cyanobacteria;Cyanobacteriia;Leptolyngbyales;Leptolyngbyaceae;Geitlerinema PCC-8501;";"88.9";"18.2";"18";"18";"16";"2";"0";"457165";"373878"
"V4mis1";"SILVA (only NR);Bacteria;Cyanobacteria;Cyanobacteriia;Leptolyngbyales;Leptolyngbyaceae;Greenland-10;";"100.0";"18.2";"2";"2";"2";"0";"0";"457181";"373892"
"V4mis1";"SILVA (only NR);Bacteria;Cyanobacteria;Cyanobacteriia;Leptolyngbyales;Leptolyngbyaceae;HAVOmat113;";"100.0";"18.2";"8";"8";"8";"0";"0";"457175";"373886"
"V4mis1";"SILVA (only NR);Bacteria;Cyanobacteria;Cyanobacteriia;Leptolyngbyales;Leptolyngbyaceae;JSC-12;";"100.0";"18.2";"9";"9";"9";"0";"0";"457174";"373885"
"V4mis1";"SILVA (only NR);Bacteria;Cyanobacteria;Cyanobacteriia;Leptolyngbyales;Leptolyngbyaceae;LB3-76;";"100.0";"18.2";"9";"9";"9";"0";"0";"457174";"373885"
"V4mis1";"SILVA (only NR);Bacteria;Cyanobacteria;Cyanobacteriia;Leptolyngbyales;Leptolyngbyaceae;Leptolyngbya ANT.L52.2;";"97.6";"18.2";"41";"41";"40";"1";"0";"457142";"373854"
"V4mis1";"SILVA (only NR);Bacteria;Cyanobacteria;Cyanobacteriia;Leptolyngbyales;Leptolyngbyaceae;Leptolyngbya ANT.L67.1;";"100.0";"18.2";"11";"11";"11";"0";"0";"457172";"373883"
"V4mis1";"SILVA (only NR);Bacteria;Cyanobacteria;Cyanobacteriia;Leptolyngbyales;Leptolyngbyaceae;Leptolyngbya BN43;";"100.0";"18.2";"3";"3";"3";"0";"0";"457180";"373891"
"V4mis1";"SILVA (only NR);Bacteria;Cyanobacteria;Cyanobacteriia;Leptolyngbyales;Leptolyngbyaceae;Leptolyngbya Es-Yyy1000;";"80.0";"18.2";"5";"5";"4";"1";"0";"457178";"373890"
"V4mis1";"SILVA (only NR);Bacteria;Cyanobacteria;Cyanobacteriia;Leptolyngbyales;Leptolyngbyaceae;Leptolyngbya FYG;";"100.0";"18.2";"8";"8";"8";"0";"0";"457175";"373886"
"V4mis1";"SILVA (only NR);Bacteria;Cyanobacteria;Cyanobacteriia;Leptolyngbyales;Leptolyngbyaceae;Leptolyngbya PCC-6306;";"97.1";"18.2";"35";"35";"34";"1";"0";"457148";"373860"
"V4mis1";"SILVA (only NR);Bacteria;Cyanobacteria;Cyanobacteriia;Leptolyngbyales;Leptolyngbyaceae;Leptolyngbya RV74;";"100.0";"18.2";"5";"5";"5";"0";"0";"457178";"373889"
"V4mis1";"SILVA (only NR);Bacteria;Cyanobacteria;Cyanobacteriia;Leptolyngbyales;Leptolyngbyaceae;Leptolyngbya SAG 2411;";"100.0";"18.2";"3";"3";"3";"0";"0";"457180";"373891"
"V4mis1";"SILVA (only NR);Bacteria;Cyanobacteria;Cyanobacteriia;Leptolyngbyales;Leptolyngbyaceae;Leptolyngbya VRUC 135;";"92.9";"18.2";"28";"28";"26";"2";"0";"457155";"373868"
"V4mis1";"SILVA (only NR);Bacteria;Cyanobacteria;Cyanobacteriia;Leptolyngbyales;Leptolyngbyaceae;Limnolyngbya CHAB4449;";"100.0";"18.2";"4";"4";"4";"0";"0";"457179";"373890"
"V4mis1";"SILVA (only NR);Bacteria;Cyanobacteria;Cyanobacteriia;Leptolyngbyales;Leptolyngbyaceae;MIZ36;";"100.0";"18.2";"7";"7";"7";"0";"0";"457176";"373887"
"V4mis1";"SILVA (only NR);Bacteria;Cyanobacteria;Cyanobacteriia;Leptolyngbyales;Leptolyngbyaceae;MTP1;";"100.0";"18.2";"3";"3";"3";"0";"0";"457180";"373891"
"V4mis1";"SILVA (only NR);Bacteria;Cyanobacteria;Cyanobacteriia;Leptolyngbyales;Leptolyngbyaceae;Oscillatoria SAG 1459-8;";"100.0";"18.2";"6";"6";"6";"0";"0";"457177";"373888"
"V4mis1";"SILVA (only NR);Bacteria;Cyanobacteria;Cyanobacteriia;Leptolyngbyales;Leptolyngbyaceae;Pantalinema;";"75.0";"18.2";"4";"4";"3";"1";"0";"457179";"373891"
"V4mis1";"SILVA (only NR);Bacteria;Cyanobacteria;Cyanobacteriia;Leptolyngbyales;Leptolyngbyaceae;Phormidesmis ANT.L52.6;";"100.0";"18.2";"26";"26";"26";"0";"0";"457157";"373868"
"V4mis1";"SILVA (only NR);Bacteria;Cyanobacteria;Cyanobacteriia;Leptolyngbyales;Leptolyngbyaceae;Phormidium CYN64;";"100.0";"18.2";"13";"13";"13";"0";"0";"457170";"373881"
"V4mis1";"SILVA (only NR);Bacteria;Cyanobacteria;Cyanobacteriia;Leptolyngbyales;Leptolyngbyaceae;Phormidium SAG 37.90;";"93.8";"18.2";"16";"16";"15";"1";"0";"457167";"373879"
"V4mis1";"SILVA (only NR);Bacteria;Cyanobacteria;Cyanobacteriia;Leptolyngbyales;Leptolyngbyaceae;RD011;";"85.7";"18.2";"7";"7";"6";"1";"0";"457176";"373888"
"V4mis1";"SILVA (only NR);Bacteria;Cyanobacteria;Cyanobacteriia;Leptolyngbyales;Leptolyngbyaceae;Scytolyngbya XSP1;";"100.0";"18.2";"2";"2";"2";"0";"0";"457181";"373892"
"V4mis1";"SILVA (only NR);Bacteria;Cyanobacteria;Cyanobacteriia;Leptolyngbyales;Leptolyngbyaceae;TG-45;";"100.0";"18.2";"2";"2";"2";"0";"0";"457181";"373892"
"V4mis1";"SILVA (only NR);Bacteria;Cyanobacteria;Cyanobacteriia;Leptolyngbyales;Leptolyngbyaceae;YB-42;";"60.0";"18.2";"5";"5";"3";"2";"0";"457178";"373891"
"V4mis1";"SILVA (only NR);Bacteria;Cyanobacteria;Cyanobacteriia;Leptolyngbyales;Leptolyngbyaceae;YT-3;";"100.0";"18.2";"2";"2";"2";"0";"0";"457181";"373892"
"V4mis1";"SILVA (only NR);Bacteria;Cyanobacteria;Cyanobacteriia;Leptolyngbyales;Leptolyngbyaceae;uncultured;";"88.7";"18.2";"239";"239";"212";"27";"0";"456944";"373682"
"V4mis1";"SILVA (only NR);Bacteria;Cyanobacteria;Cyanobacteriia;Limnotrichales;";"97.0";"18.2";"33";"33";"32";"1";"0";"457150";"373862"
"V4mis1";"SILVA (only NR);Bacteria;Cyanobacteria;Cyanobacteriia;Limnotrichales;Limnotrichaceae;";"97.0";"18.2";"33";"33";"32";"1";"0";"457150";"373862"
"V4mis1";"SILVA (only NR);Bacteria;Cyanobacteria;Cyanobacteriia;Limnotrichales;Limnotrichaceae;Limnothrix;";"97.0";"18.2";"33";"33";"32";"1";"0";"457150";"373862"
"V4mis1";"SILVA (only NR);Bacteria;Cyanobacteria;Cyanobacteriia;Neosynechococcales;";"100.0";"18.2";"1";"1";"1";"0";"0";"457182";"373893"
"V4mis1";"SILVA (only NR);Bacteria;Cyanobacteria;Cyanobacteriia;Neosynechococcales;Neosynechococcaceae;";"100.0";"18.2";"1";"1";"1";"0";"0";"457182";"373893"
"V4mis1";"SILVA (only NR);Bacteria;Cyanobacteria;Cyanobacteriia;Neosynechococcales;Neosynechococcaceae;Neosynechococcus;";"100.0";"18.2";"1";"1";"1";"0";"0";"457182";"373893"
"V4mis1";"SILVA (only NR);Bacteria;Cyanobacteria;Cyanobacteriia;Oxyphotobacteria Incertae Sedis;";"97.0";"18.2";"33";"33";"32";"1";"0";"457150";"373862"
"V4mis1";"SILVA (only NR);Bacteria;Cyanobacteria;Cyanobacteriia;Oxyphotobacteria Incertae Sedis;Unknown Family;";"97.0";"18.2";"33";"33";"32";"1";"0";"457150";"373862"
"V4mis1";"SILVA (only NR);Bacteria;Cyanobacteria;Cyanobacteriia;Oxyphotobacteria Incertae Sedis;Unknown Family;Leptolyngbya EcFYyyy-00;";"100.0";"18.2";"12";"12";"12";"0";"0";"457171";"373882"
"V4mis1";"SILVA (only NR);Bacteria;Cyanobacteria;Cyanobacteriia;Oxyphotobacteria Incertae Sedis;Unknown Family;Leptolyngbya LEGE-06070;";"66.7";"18.2";"3";"3";"2";"1";"0";"457180";"373892"
"V4mis1";"SILVA (only NR);Bacteria;Cyanobacteria;Cyanobacteriia;Oxyphotobacteria Incertae Sedis;Unknown Family;Pseudanabaena NgrPSln22;";"100.0";"18.2";"3";"3";"3";"0";"0";"457180";"373891"
"V4mis1";"SILVA (only NR);Bacteria;Cyanobacteria;Cyanobacteriia;Oxyphotobacteria Incertae Sedis;Unknown Family;uncultured;";"100.0";"18.2";"12";"12";"12";"0";"0";"457171";"373882"
"V4mis1";"SILVA (only NR);Bacteria;Cyanobacteria;Cyanobacteriia;Phormidesmiales;";"97.6";"18.2";"248";"248";"242";"6";"0";"456935";"373652"
"V4mis1";"SILVA (only NR);Bacteria;Cyanobacteria;Cyanobacteriia;Phormidesmiales;Nodosilineaceae;";"97.7";"18.2";"129";"129";"126";"3";"0";"457054";"373768"
"V4mis1";"SILVA (only NR);Bacteria;Cyanobacteria;Cyanobacteriia;Phormidesmiales;Nodosilineaceae;Halomicronema C2206;";"100.0";"18.2";"2";"2";"2";"0";"0";"457181";"373892"
"V4mis1";"SILVA (only NR);Bacteria;Cyanobacteria;Cyanobacteriia;Phormidesmiales;Nodosilineaceae;Halomicronema TFEP1;";"100.0";"18.2";"6";"6";"6";"0";"0";"457177";"373888"
"V4mis1";"SILVA (only NR);Bacteria;Cyanobacteria;Cyanobacteriia;Phormidesmiales;Nodosilineaceae;Halomicronema;";"100.0";"18.2";"1";"1";"1";"0";"0";"457182";"373893"
"V4mis1";"SILVA (only NR);Bacteria;Cyanobacteria;Cyanobacteriia;Phormidesmiales;Nodosilineaceae;Leptolyngbya PCC-6406;";"100.0";"18.2";"5";"5";"5";"0";"0";"457178";"373889"
"V4mis1";"SILVA (only NR);Bacteria;Cyanobacteria;Cyanobacteriia;Phormidesmiales;Nodosilineaceae;MBIC10086;";"100.0";"18.2";"5";"5";"5";"0";"0";"457178";"373889"
"V4mis1";"SILVA (only NR);Bacteria;Cyanobacteria;Cyanobacteriia;Phormidesmiales;Nodosilineaceae;Nodosilinea PCC-7104;";"97.7";"18.2";"88";"88";"86";"2";"0";"457095";"373808"
"V4mis1";"SILVA (only NR);Bacteria;Cyanobacteria;Cyanobacteriia;Phormidesmiales;Nodosilineaceae;uncultured;";"94.4";"18.2";"18";"18";"17";"1";"0";"457165";"373877"
"V4mis1";"SILVA (only NR);Bacteria;Cyanobacteria;Cyanobacteriia;Phormidesmiales;Phormidesmiaceae;";"97.4";"18.2";"117";"117";"114";"3";"0";"457066";"373780"
"V4mis1";"SILVA (only NR);Bacteria;Cyanobacteria;Cyanobacteriia;Phormidesmiales;Phormidesmiaceae;Acrophormium PCC-7375;";"100.0";"18.2";"24";"24";"24";"0";"0";"457159";"373870"
"V4mis1";"SILVA (only NR);Bacteria;Cyanobacteria;Cyanobacteriia;Phormidesmiales;Phormidesmiaceae;Phormidesmis ANT.LACV5.1;";"100.0";"18.2";"37";"37";"37";"0";"0";"457146";"373857"
"V4mis1";"SILVA (only NR);Bacteria;Cyanobacteria;Cyanobacteriia;Phormidesmiales;Phormidesmiaceae;Phormidium MBIC10002;";"100.0";"18.2";"3";"3";"3";"0";"0";"457180";"373891"
"V4mis1";"SILVA (only NR);Bacteria;Cyanobacteria;Cyanobacteriia;Phormidesmiales;Phormidesmiaceae;Phormidium MBIC10003;";"100.0";"18.2";"42";"42";"42";"0";"0";"457141";"373852"
"V4mis1";"SILVA (only NR);Bacteria;Cyanobacteria;Cyanobacteriia;Phormidesmiales;Phormidesmiaceae;uncultured;";"66.7";"18.2";"9";"9";"6";"3";"0";"457174";"373888"
"V4mis1";"SILVA (only NR);Bacteria;Cyanobacteria;Cyanobacteriia;Phormidesmiales;uncultured;";"100.0";"18.2";"2";"2";"2";"0";"0";"457181";"373892"
"V4mis1";"SILVA (only NR);Bacteria;Cyanobacteria;Cyanobacteriia;Pseudanabaenales;";"100.0";"18.2";"96";"96";"96";"0";"0";"457087";"373798"
"V4mis1";"SILVA (only NR);Bacteria;Cyanobacteria;Cyanobacteriia;Pseudanabaenales;Pseudanabaenaceae;";"100.0";"18.2";"96";"96";"96";"0";"0";"457087";"373798"
"V4mis1";"SILVA (only NR);Bacteria;Cyanobacteria;Cyanobacteriia;Pseudanabaenales;Pseudanabaenaceae;Pseudanabaena PCC-6802;";"100.0";"18.2";"4";"4";"4";"0";"0";"457179";"373890"
"V4mis1";"SILVA (only NR);Bacteria;Cyanobacteria;Cyanobacteriia;Pseudanabaenales;Pseudanabaenaceae;Pseudanabaena PCC-7367;";"100.0";"18.2";"9";"9";"9";"0";"0";"457174";"373885"
"V4mis1";"SILVA (only NR);Bacteria;Cyanobacteria;Cyanobacteriia;Pseudanabaenales;Pseudanabaenaceae;Pseudanabaena PCC-7403;";"100.0";"18.2";"2";"2";"2";"0";"0";"457181";"373892"
"V4mis1";"SILVA (only NR);Bacteria;Cyanobacteria;Cyanobacteriia;Pseudanabaenales;Pseudanabaenaceae;Pseudanabaena PCC-7429;";"100.0";"18.2";"36";"36";"36";"0";"0";"457147";"373858"
"V4mis1";"SILVA (only NR);Bacteria;Cyanobacteria;Cyanobacteriia;Pseudanabaenales;Pseudanabaenaceae;Synechococcus PCC-7502;";"100.0";"18.2";"12";"12";"12";"0";"0";"457171";"373882"
"V4mis1";"SILVA (only NR);Bacteria;Cyanobacteria;Cyanobacteriia;Pseudanabaenales;Pseudanabaenaceae;uncultured;";"100.0";"18.2";"30";"30";"30";"0";"0";"457153";"373864"
"V4mis1";"SILVA (only NR);Bacteria;Cyanobacteria;Cyanobacteriia;RD017;";"92.3";"18.2";"13";"13";"12";"1";"0";"457170";"373882"
"V4mis1";"SILVA (only NR);Bacteria;Cyanobacteria;Cyanobacteriia;SepB-3;";"100.0";"18.2";"8";"8";"8";"0";"0";"457175";"373886"
"V4mis1";"SILVA (only NR);Bacteria;Cyanobacteria;Cyanobacteriia;Synechococcales;";"89.7";"18.2";"563";"563";"505";"58";"0";"456620";"373389"
"V4mis1";"SILVA (only NR);Bacteria;Cyanobacteria;Cyanobacteriia;Synechococcales;Cyanobiaceae;";"89.2";"18.2";"529";"529";"472";"57";"0";"456654";"373422"
"V4mis1";"SILVA (only NR);Bacteria;Cyanobacteria;Cyanobacteriia;Synechococcales;Cyanobiaceae;Cyanobium PCC-6307;";"94.6";"18.2";"204";"204";"193";"11";"0";"456979";"373701"
"V4mis1";"SILVA (only NR);Bacteria;Cyanobacteria;Cyanobacteriia;Synechococcales;Cyanobiaceae;Prochlorococcus MIT9313;";"77.9";"18.2";"136";"136";"106";"30";"0";"457047";"373788"
"V4mis1";"SILVA (only NR);Bacteria;Cyanobacteria;Cyanobacteriia;Synechococcales;Cyanobiaceae;Synechococcus CC9902;";"91.1";"18.2";"168";"168";"153";"15";"0";"457015";"373741"
"V4mis1";"SILVA (only NR);Bacteria;Cyanobacteria;Cyanobacteriia;Synechococcales;Cyanobiaceae;Synechococcus MBIC10613;";"100.0";"18.2";"4";"4";"4";"0";"0";"457179";"373890"
"V4mis1";"SILVA (only NR);Bacteria;Cyanobacteria;Cyanobacteriia;Synechococcales;Cyanobiaceae;[Synechococcus] spongiarum group;";"100.0";"18.2";"14";"14";"14";"0";"0";"457169";"373880"
"V4mis1";"SILVA (only NR);Bacteria;Cyanobacteria;Cyanobacteriia;Synechococcales;Prochlorotrichaceae;";"100.0";"18.2";"9";"9";"9";"0";"0";"457174";"373885"
"V4mis1";"SILVA (only NR);Bacteria;Cyanobacteria;Cyanobacteriia;Synechococcales;Prochlorotrichaceae;Prochlorothrix PCC-9006;";"100.0";"18.2";"9";"9";"9";"0";"0";"457174";"373885"
"V4mis1";"SILVA (only NR);Bacteria;Cyanobacteria;Cyanobacteriia;Synechococcales;Synechococcaceae;";"93.3";"18.2";"15";"15";"14";"1";"0";"457168";"373880"
"V4mis1";"SILVA (only NR);Bacteria;Cyanobacteria;Cyanobacteriia;Synechococcales;Synechococcaceae;Microcystis NIES42;";"100.0";"18.2";"2";"2";"2";"0";"0";"457181";"373892"
"V4mis1";"SILVA (only NR);Bacteria;Cyanobacteria;Cyanobacteriia;Synechococcales;Synechococcaceae;Synechococcus PCC-7942;";"100.0";"18.2";"10";"10";"10";"0";"0";"457173";"373884"
"V4mis1";"SILVA (only NR);Bacteria;Cyanobacteria;Cyanobacteriia;Synechococcales;Synechococcaceae;uncultured;";"66.7";"18.2";"3";"3";"2";"1";"0";"457180";"373892"
"V4mis1";"SILVA (only NR);Bacteria;Cyanobacteria;Cyanobacteriia;Synechococcales;Synechococcales Incertae Sedis;";"100.0";"18.2";"10";"10";"10";"0";"0";"457173";"373884"
"V4mis1";"SILVA (only NR);Bacteria;Cyanobacteria;Cyanobacteriia;Synechococcales;Synechococcales Incertae Sedis;Schizothrix LEGE 07164;";"100.0";"18.2";"10";"10";"10";"0";"0";"457173";"373884"
"V4mis1";"SILVA (only NR);Bacteria;Cyanobacteria;Cyanobacteriia;Thermosynechococcales;";"93.8";"18.2";"48";"48";"45";"3";"0";"457135";"373849"
"V4mis1";"SILVA (only NR);Bacteria;Cyanobacteria;Cyanobacteriia;Thermosynechococcales;Acaryochloridaceae;";"83.3";"18.2";"12";"12";"10";"2";"0";"457171";"373884"
"V4mis1";"SILVA (only NR);Bacteria;Cyanobacteria;Cyanobacteriia;Thermosynechococcales;Acaryochloridaceae;Acaryochloris MBIC11017;";"83.3";"18.2";"12";"12";"10";"2";"0";"457171";"373884"
"V4mis1";"SILVA (only NR);Bacteria;Cyanobacteria;Cyanobacteriia;Thermosynechococcales;Thermosynechococcaceae;";"97.2";"18.2";"36";"36";"35";"1";"0";"457147";"373859"
"V4mis1";"SILVA (only NR);Bacteria;Cyanobacteria;Cyanobacteriia;Thermosynechococcales;Thermosynechococcaceae;Cyanothece PCC 7425;";"100.0";"18.2";"9";"9";"9";"0";"0";"457174";"373885"
"V4mis1";"SILVA (only NR);Bacteria;Cyanobacteria;Cyanobacteriia;Thermosynechococcales;Thermosynechococcaceae;Loriellopsis LF-B5;";"83.3";"18.2";"6";"6";"5";"1";"0";"457177";"373889"
"V4mis1";"SILVA (only NR);Bacteria;Cyanobacteria;Cyanobacteriia;Thermosynechococcales;Thermosynechococcaceae;Synechococcus IR11;";"100.0";"18.2";"6";"6";"6";"0";"0";"457177";"373888"
"V4mis1";"SILVA (only NR);Bacteria;Cyanobacteria;Cyanobacteriia;Thermosynechococcales;Thermosynechococcaceae;Synechococcus PCC-6312;";"100.0";"18.2";"2";"2";"2";"0";"0";"457181";"373892"
"V4mis1";"SILVA (only NR);Bacteria;Cyanobacteria;Cyanobacteriia;Thermosynechococcales;Thermosynechococcaceae;Synechococcus;";"100.0";"18.2";"1";"1";"1";"0";"0";"457182";"373893"
"V4mis1";"SILVA (only NR);Bacteria;Cyanobacteria;Cyanobacteriia;Thermosynechococcales;Thermosynechococcaceae;Thermosynechococcus BP-1;";"100.0";"18.2";"9";"9";"9";"0";"0";"457174";"373885"
"V4mis1";"SILVA (only NR);Bacteria;Cyanobacteria;Cyanobacteriia;Thermosynechococcales;Thermosynechococcaceae;uncultured;";"100.0";"18.2";"3";"3";"3";"0";"0";"457180";"373891"
"V4mis1";"SILVA (only NR);Bacteria;Cyanobacteria;Cyanobacteriia;uncultured;";"100.0";"18.2";"5";"5";"5";"0";"0";"457178";"373889"
"V4mis1";"SILVA (only NR);Bacteria;Cyanobacteria;Sericytochromatia;";"95.2";"18.2";"83";"83";"79";"4";"0";"457100";"373815"
"V4mis1";"SILVA (only NR);Bacteria;Cyanobacteria;Vampirivibrionia;";"95.7";"18.2";"494";"494";"473";"21";"0";"456689";"373421"
"V4mis1";"SILVA (only NR);Bacteria;Cyanobacteria;Vampirivibrionia;Caenarcaniphilales;";"100.0";"18.2";"19";"19";"19";"0";"0";"457164";"373875"
"V4mis1";"SILVA (only NR);Bacteria;Cyanobacteria;Vampirivibrionia;Gastranaerophilales;";"95.4";"18.2";"324";"324";"309";"15";"0";"456859";"373585"
"V4mis1";"SILVA (only NR);Bacteria;Cyanobacteria;Vampirivibrionia;Obscuribacterales;";"96.1";"18.2";"77";"77";"74";"3";"0";"457106";"373820"
"V4mis1";"SILVA (only NR);Bacteria;Cyanobacteria;Vampirivibrionia;Obscuribacterales;Obscuribacteraceae;";"96.1";"18.2";"77";"77";"74";"3";"0";"457106";"373820"
"V4mis1";"SILVA (only NR);Bacteria;Cyanobacteria;Vampirivibrionia;Obscuribacterales;Obscuribacteraceae;Candidatus Obscuribacter;";"100.0";"18.2";"13";"13";"13";"0";"0";"457170";"373881"
"V4mis1";"SILVA (only NR);Bacteria;Cyanobacteria;Vampirivibrionia;Vampirovibrionales;";"95.9";"18.2";"74";"74";"71";"3";"0";"457109";"373823"
"V4mis1";"SILVA (only NR);Bacteria;Cyanobacteria;Vampirivibrionia;Vampirovibrionales;Vampirovibrionaceae;";"91.4";"18.2";"35";"35";"32";"3";"0";"457148";"373862"
"V4mis1";"SILVA (only NR);Bacteria;Cyanobacteria;Vampirivibrionia;Vampirovibrionales;Vampirovibrionaceae;Vampirovibrio;";"90.5";"18.2";"21";"21";"19";"2";"0";"457162";"373875"
"V4mis1";"SILVA (only NR);Bacteria;DTB120;";"96.2";"18.2";"78";"78";"75";"3";"0";"457105";"373819"
"V4mis1";"SILVA (only NR);Bacteria;Dadabacteria;";"95.9";"18.2";"172";"172";"165";"7";"0";"457011";"373729"
"V4mis1";"SILVA (only NR);Bacteria;Dadabacteria;Dadabacteriia;";"95.9";"18.2";"172";"172";"165";"7";"0";"457011";"373729"
"V4mis1";"SILVA (only NR);Bacteria;Dadabacteria;Dadabacteriia;Dadabacteriales;";"95.9";"18.2";"172";"172";"165";"7";"0";"457011";"373729"
"V4mis1";"SILVA (only NR);Bacteria;Deferribacterota;";"95.8";"18.2";"118";"118";"113";"5";"0";"457065";"373781"
"V4mis1";"SILVA (only NR);Bacteria;Deferribacterota;Deferribacteres;";"95.8";"18.2";"118";"118";"113";"5";"0";"457065";"373781"
"V4mis1";"SILVA (only NR);Bacteria;Deferribacterota;Deferribacteres;Deferribacterales;";"95.8";"18.2";"118";"118";"113";"5";"0";"457065";"373781"
"V4mis1";"SILVA (only NR);Bacteria;Deferribacterota;Deferribacteres;Deferribacterales;Deferribacteraceae;";"95.8";"18.2";"118";"118";"113";"5";"0";"457065";"373781"
"V4mis1";"SILVA (only NR);Bacteria;Deferribacterota;Deferribacteres;Deferribacterales;Deferribacteraceae;Calditerrivibrio;";"100.0";"18.2";"11";"11";"11";"0";"0";"457172";"373883"
"V4mis1";"SILVA (only NR);Bacteria;Deferribacterota;Deferribacteres;Deferribacterales;Deferribacteraceae;Deferribacter;";"100.0";"18.2";"10";"10";"10";"0";"0";"457173";"373884"
"V4mis1";"SILVA (only NR);Bacteria;Deferribacterota;Deferribacteres;Deferribacterales;Deferribacteraceae;Denitrovibrio;";"100.0";"18.2";"4";"4";"4";"0";"0";"457179";"373890"
"V4mis1";"SILVA (only NR);Bacteria;Deferribacterota;Deferribacteres;Deferribacterales;Deferribacteraceae;Flexistipes;";"80.0";"18.2";"5";"5";"4";"1";"0";"457178";"373890"
"V4mis1";"SILVA (only NR);Bacteria;Deferribacterota;Deferribacteres;Deferribacterales;Deferribacteraceae;Geovibrio;";"75.0";"18.2";"8";"8";"6";"2";"0";"457175";"373888"
"V4mis1";"SILVA (only NR);Bacteria;Deferribacterota;Deferribacteres;Deferribacterales;Deferribacteraceae;Mucispirillum;";"92.3";"18.2";"26";"26";"24";"2";"0";"457157";"373870"
"V4mis1";"SILVA (only NR);Bacteria;Deferribacterota;Deferribacteres;Deferribacterales;Deferribacteraceae;Seleniivibrio;";"100.0";"18.2";"3";"3";"3";"0";"0";"457180";"373891"
"V4mis1";"SILVA (only NR);Bacteria;Deferribacterota;Deferribacteres;Deferribacterales;Deferribacteraceae;uncultured;";"100.0";"18.2";"50";"50";"50";"0";"0";"457133";"373844"
"V4mis1";"SILVA (only NR);Bacteria;Deferrisomatota;";"88.5";"18.2";"26";"26";"23";"3";"0";"457157";"373871"
"V4mis1";"SILVA (only NR);Bacteria;Deferrisomatota;Defferrisomatia;";"88.5";"18.2";"26";"26";"23";"3";"0";"457157";"373871"
"V4mis1";"SILVA (only NR);Bacteria;Deferrisomatota;Defferrisomatia;Defferrisomatales;";"88.5";"18.2";"26";"26";"23";"3";"0";"457157";"373871"
"V4mis1";"SILVA (only NR);Bacteria;Deferrisomatota;Defferrisomatia;Defferrisomatales;Defferrisomataceae;";"88.5";"18.2";"26";"26";"23";"3";"0";"457157";"373871"
"V4mis1";"SILVA (only NR);Bacteria;Deferrisomatota;Defferrisomatia;Defferrisomatales;Defferrisomataceae;Deferrisoma;";"88.5";"18.2";"26";"26";"23";"3";"0";"457157";"373871"
"V4mis1";"SILVA (only NR);Bacteria;Deinococcota;";"96.0";"18.2";"832";"832";"799";"33";"0";"456351";"373095"
"V4mis1";"SILVA (only NR);Bacteria;Deinococcota;Deinococci;";"96.0";"18.2";"832";"832";"799";"33";"0";"456351";"373095"
"V4mis1";"SILVA (only NR);Bacteria;Deinococcota;Deinococci;Deinococcales;";"95.7";"18.2";"557";"557";"533";"24";"0";"456626";"373361"
"V4mis1";"SILVA (only NR);Bacteria;Deinococcota;Deinococci;Deinococcales;Deinococcaceae;";"97.0";"18.2";"328";"328";"318";"10";"0";"456855";"373576"
"V4mis1";"SILVA (only NR);Bacteria;Deinococcota;Deinococci;Deinococcales;Deinococcaceae;Deinobacterium;";"100.0";"18.2";"2";"2";"2";"0";"0";"457181";"373892"
"V4mis1";"SILVA (only NR);Bacteria;Deinococcota;Deinococci;Deinococcales;Deinococcaceae;Deinococcus;";"96.7";"18.2";"302";"302";"292";"10";"0";"456881";"373602"
"V4mis1";"SILVA (only NR);Bacteria;Deinococcota;Deinococci;Deinococcales;Deinococcaceae;uncultured;";"100.0";"18.2";"23";"23";"23";"0";"0";"457160";"373871"
"V4mis1";"SILVA (only NR);Bacteria;Deinococcota;Deinococci;Deinococcales;Trueperaceae;";"93.9";"18.2";"229";"229";"215";"14";"0";"456954";"373679"
"V4mis1";"SILVA (only NR);Bacteria;Deinococcota;Deinococci;Deinococcales;Trueperaceae;Truepera;";"93.9";"18.2";"229";"229";"215";"14";"0";"456954";"373679"
"V4mis1";"SILVA (only NR);Bacteria;Deinococcota;Deinococci;Thermales;";"96.7";"18.2";"275";"275";"266";"9";"0";"456908";"373628"
"V4mis1";"SILVA (only NR);Bacteria;Deinococcota;Deinococci;Thermales;Thermaceae;";"96.7";"18.2";"275";"275";"266";"9";"0";"456908";"373628"
"V4mis1";"SILVA (only NR);Bacteria;Deinococcota;Deinococci;Thermales;Thermaceae;Marinithermus;";"100.0";"18.2";"2";"2";"2";"0";"0";"457181";"373892"
"V4mis1";"SILVA (only NR);Bacteria;Deinococcota;Deinococci;Thermales;Thermaceae;Meiothermus;";"96.5";"18.2";"86";"86";"83";"3";"0";"457097";"373811"
"V4mis1";"SILVA (only NR);Bacteria;Deinococcota;Deinococci;Thermales;Thermaceae;Oceanithermus;";"100.0";"18.2";"7";"7";"7";"0";"0";"457176";"373887"
"V4mis1";"SILVA (only NR);Bacteria;Deinococcota;Deinococci;Thermales;Thermaceae;Rhabdothermus;";"100.0";"18.2";"2";"2";"2";"0";"0";"457181";"373892"
"V4mis1";"SILVA (only NR);Bacteria;Deinococcota;Deinococci;Thermales;Thermaceae;Thermus;";"96.6";"18.2";"175";"175";"169";"6";"0";"457008";"373725"
"V4mis1";"SILVA (only NR);Bacteria;Deinococcota;Deinococci;Thermales;Thermaceae;Vulcanithermus;";"100.0";"18.2";"1";"1";"1";"0";"0";"457182";"373893"
"V4mis1";"SILVA (only NR);Bacteria;Dependentiae;";"97.1";"18.2";"583";"583";"566";"17";"0";"456600";"373328"
"V4mis1";"SILVA (only NR);Bacteria;Dependentiae;Babeliae;";"97.1";"18.2";"583";"583";"566";"17";"0";"456600";"373328"
"V4mis1";"SILVA (only NR);Bacteria;Dependentiae;Babeliae;Babeliales;";"97.1";"18.2";"583";"583";"566";"17";"0";"456600";"373328"
"V4mis1";"SILVA (only NR);Bacteria;Dependentiae;Babeliae;Babeliales;Babeliaceae;";"95.6";"18.2";"68";"68";"65";"3";"0";"457115";"373829"
"V4mis1";"SILVA (only NR);Bacteria;Dependentiae;Babeliae;Babeliales;Babeliaceae;Candidatus Babela;";"100.0";"18.2";"3";"3";"3";"0";"0";"457180";"373891"
"V4mis1";"SILVA (only NR);Bacteria;Dependentiae;Babeliae;Babeliales;UBA12409;";"98.5";"18.2";"68";"68";"67";"1";"0";"457115";"373827"
"V4mis1";"SILVA (only NR);Bacteria;Dependentiae;Babeliae;Babeliales;UBA12411;";"94.1";"18.2";"17";"17";"16";"1";"0";"457166";"373878"
"V4mis1";"SILVA (only NR);Bacteria;Dependentiae;Babeliae;Babeliales;Vermiphilaceae;";"98.1";"18.2";"211";"211";"207";"4";"0";"456972";"373687"
"V4mis1";"SILVA (only NR);Bacteria;Desantisbacteria;";"100.0";"18.2";"2";"2";"2";"0";"0";"457181";"373892"
"V4mis1";"SILVA (only NR);Bacteria;Desulfobacterota;";"94.9";"18.4";"7818";"7818";"7418";"400";"0";"449365";"366476"
"V4mis1";"SILVA (only NR);Bacteria;Desulfobacterota;Desulfarculia;";"96.6";"18.2";"29";"29";"28";"1";"0";"457154";"373866"
"V4mis1";"SILVA (only NR);Bacteria;Desulfobacterota;Desulfarculia;Desulfarculales;";"96.6";"18.2";"29";"29";"28";"1";"0";"457154";"373866"
"V4mis1";"SILVA (only NR);Bacteria;Desulfobacterota;Desulfarculia;Desulfarculales;Desulfarculaceae;";"96.4";"18.2";"28";"28";"27";"1";"0";"457155";"373867"
"V4mis1";"SILVA (only NR);Bacteria;Desulfobacterota;Desulfarculia;Desulfarculales;Desulfarculaceae;Desulfarculus;";"100.0";"18.2";"4";"4";"4";"0";"0";"457179";"373890"
"V4mis1";"SILVA (only NR);Bacteria;Desulfobacterota;Desulfarculia;Desulfarculales;Desulfarculaceae;Desulfocarbo;";"100.0";"18.2";"13";"13";"13";"0";"0";"457170";"373881"
"V4mis1";"SILVA (only NR);Bacteria;Desulfobacterota;Desulfarculia;Desulfarculales;Desulfarculaceae;Dethiosulfatarculus;";"100.0";"18.2";"1";"1";"1";"0";"0";"457182";"373893"
"V4mis1";"SILVA (only NR);Bacteria;Desulfobacterota;Desulfarculia;Desulfarculales;Desulfarculaceae;uncultured;";"90.0";"18.2";"10";"10";"9";"1";"0";"457173";"373885"
"V4mis1";"SILVA (only NR);Bacteria;Desulfobacterota;Desulfobaccia;";"94.6";"18.2";"74";"74";"70";"4";"0";"457109";"373824"
"V4mis1";"SILVA (only NR);Bacteria;Desulfobacterota;Desulfobaccia;Desulfobaccales;";"94.6";"18.2";"74";"74";"70";"4";"0";"457109";"373824"
"V4mis1";"SILVA (only NR);Bacteria;Desulfobacterota;Desulfobaccia;Desulfobaccales;Desulfobaccaceae;";"94.6";"18.2";"74";"74";"70";"4";"0";"457109";"373824"
"V4mis1";"SILVA (only NR);Bacteria;Desulfobacterota;Desulfobaccia;Desulfobaccales;Desulfobaccaceae;Desulfobacca;";"94.6";"18.2";"74";"74";"70";"4";"0";"457109";"373824"
"V4mis1";"SILVA (only NR);Bacteria;Desulfobacterota;Desulfobacteria;";"93.6";"18.3";"2521";"2521";"2360";"161";"0";"454662";"371534"
"V4mis1";"SILVA (only NR);Bacteria;Desulfobacterota;Desulfobacteria;Desulfatiglandales;";"93.7";"18.2";"447";"447";"419";"28";"0";"456736";"373475"
"V4mis1";"SILVA (only NR);Bacteria;Desulfobacterota;Desulfobacteria;Desulfatiglandales;Desulfatiglandaceae;";"93.7";"18.2";"447";"447";"419";"28";"0";"456736";"373475"
"V4mis1";"SILVA (only NR);Bacteria;Desulfobacterota;Desulfobacteria;Desulfatiglandales;Desulfatiglandaceae;Desulfatiglans;";"93.7";"18.2";"447";"447";"419";"28";"0";"456736";"373475"
"V4mis1";"SILVA (only NR);Bacteria;Desulfobacterota;Desulfobacteria;Desulfobacterales;";"93.6";"18.3";"2074";"2074";"1941";"133";"0";"455109";"371953"
"V4mis1";"SILVA (only NR);Bacteria;Desulfobacterota;Desulfobacteria;Desulfobacterales;Desulfatiferula;";"100.0";"18.2";"13";"13";"13";"0";"0";"457170";"373881"
"V4mis1";"SILVA (only NR);Bacteria;Desulfobacterota;Desulfobacteria;Desulfobacterales;Desulfobacteraceae;";"96.6";"18.2";"415";"415";"401";"14";"0";"456768";"373493"
"V4mis1";"SILVA (only NR);Bacteria;Desulfobacterota;Desulfobacteria;Desulfobacterales;Desulfobacteraceae;Candidatus Desulfamplus;";"100.0";"18.2";"2";"2";"2";"0";"0";"457181";"373892"
"V4mis1";"SILVA (only NR);Bacteria;Desulfobacterota;Desulfobacteria;Desulfobacterales;Desulfobacteraceae;Desulfobacter;";"96.6";"18.2";"87";"87";"84";"3";"0";"457096";"373810"
"V4mis1";"SILVA (only NR);Bacteria;Desulfobacterota;Desulfobacteria;Desulfobacterales;Desulfobacteraceae;Desulfobacterium;";"91.9";"18.2";"37";"37";"34";"3";"0";"457146";"373860"
"V4mis1";"SILVA (only NR);Bacteria;Desulfobacterota;Desulfobacteria;Desulfobacterales;Desulfobacteraceae;Desulfobacula;";"100.0";"18.2";"17";"17";"17";"0";"0";"457166";"373877"
"V4mis1";"SILVA (only NR);Bacteria;Desulfobacterota;Desulfobacteria;Desulfobacterales;Desulfobacteraceae;Desulfobotulus;";"100.0";"18.2";"10";"10";"10";"0";"0";"457173";"373884"
"V4mis1";"SILVA (only NR);Bacteria;Desulfobacterota;Desulfobacteria;Desulfobacterales;Desulfobacteraceae;Desulfocella;";"100.0";"18.2";"15";"15";"15";"0";"0";"457168";"373879"
"V4mis1";"SILVA (only NR);Bacteria;Desulfobacterota;Desulfobacteria;Desulfobacterales;Desulfobacteraceae;Desulfoconvexum;";"93.3";"18.2";"30";"30";"28";"2";"0";"457153";"373866"
"V4mis1";"SILVA (only NR);Bacteria;Desulfobacterota;Desulfobacteria;Desulfobacterales;Desulfobacteraceae;Desulfospira;";"100.0";"18.2";"2";"2";"2";"0";"0";"457181";"373892"
"V4mis1";"SILVA (only NR);Bacteria;Desulfobacterota;Desulfobacteria;Desulfobacterales;Desulfobacteraceae;Desulfotignum;";"93.2";"18.2";"44";"44";"41";"3";"0";"457139";"373853"
"V4mis1";"SILVA (only NR);Bacteria;Desulfobacterota;Desulfobacteria;Desulfobacterales;Desulfobacteraceae;uncultured;";"98.2";"18.2";"165";"165";"162";"3";"0";"457018";"373732"
"V4mis1";"SILVA (only NR);Bacteria;Desulfobacterota;Desulfobacteria;Desulfobacterales;Desulfococcaceae;";"86.5";"18.2";"483";"483";"418";"65";"0";"456700";"373476"
"V4mis1";"SILVA (only NR);Bacteria;Desulfobacterota;Desulfobacteria;Desulfobacterales;Desulfococcaceae;Desulfococcus;";"100.0";"18.2";"8";"8";"8";"0";"0";"457175";"373886"
"V4mis1";"SILVA (only NR);Bacteria;Desulfobacterota;Desulfobacteria;Desulfobacterales;Desulfococcaceae;Desulfonema;";"83.8";"18.2";"234";"234";"196";"38";"0";"456949";"373698"
"V4mis1";"SILVA (only NR);Bacteria;Desulfobacterota;Desulfobacteria;Desulfobacterales;Desulfococcaceae;uncultured;";"88.8";"18.2";"240";"240";"213";"27";"0";"456943";"373681"
"V4mis1";"SILVA (only NR);Bacteria;Desulfobacterota;Desulfobacteria;Desulfobacterales;Desulfolunaceae;";"92.3";"18.2";"39";"39";"36";"3";"0";"457144";"373858"
"V4mis1";"SILVA (only NR);Bacteria;Desulfobacterota;Desulfobacteria;Desulfobacterales;Desulfolunaceae;Desulfofaba;";"90.9";"18.2";"11";"11";"10";"1";"0";"457172";"373884"
"V4mis1";"SILVA (only NR);Bacteria;Desulfobacterota;Desulfobacteria;Desulfobacterales;Desulfolunaceae;Desulfofrigus;";"91.7";"18.2";"12";"12";"11";"1";"0";"457171";"373883"
"V4mis1";"SILVA (only NR);Bacteria;Desulfobacterota;Desulfobacteria;Desulfobacterales;Desulfolunaceae;Desulfoluna;";"100.0";"18.2";"3";"3";"3";"0";"0";"457180";"373891"
"V4mis1";"SILVA (only NR);Bacteria;Desulfobacterota;Desulfobacteria;Desulfobacterales;Desulfolunaceae;uncultured;";"91.7";"18.2";"12";"12";"11";"1";"0";"457171";"373883"
"V4mis1";"SILVA (only NR);Bacteria;Desulfobacterota;Desulfobacteria;Desulfobacterales;Desulforegulaceae;";"100.0";"18.2";"4";"4";"4";"0";"0";"457179";"373890"
"V4mis1";"SILVA (only NR);Bacteria;Desulfobacterota;Desulfobacteria;Desulfobacterales;Desulforegulaceae;Desulforegula;";"100.0";"18.2";"4";"4";"4";"0";"0";"457179";"373890"
"V4mis1";"SILVA (only NR);Bacteria;Desulfobacterota;Desulfobacteria;Desulfobacterales;Desulfosarcinaceae;";"95.4";"18.2";"1073";"1073";"1024";"49";"0";"456110";"372870"
"V4mis1";"SILVA (only NR);Bacteria;Desulfobacterota;Desulfobacteria;Desulfobacterales;Desulfosarcinaceae;Algorimarina;";"100.0";"18.2";"1";"1";"1";"0";"0";"457182";"373893"
"V4mis1";"SILVA (only NR);Bacteria;Desulfobacterota;Desulfobacteria;Desulfobacterales;Desulfosarcinaceae;Candidatus Magnetananas;";"100.0";"18.2";"14";"14";"14";"0";"0";"457169";"373880"
"V4mis1";"SILVA (only NR);Bacteria;Desulfobacterota;Desulfobacteria;Desulfobacterales;Desulfosarcinaceae;Candidatus Magnetoglobus;";"100.0";"18.2";"14";"14";"14";"0";"0";"457169";"373880"
"V4mis1";"SILVA (only NR);Bacteria;Desulfobacterota;Desulfobacteria;Desulfobacterales;Desulfosarcinaceae;Candidatus Magnetomorum;";"100.0";"18.2";"1";"1";"1";"0";"0";"457182";"373893"
"V4mis1";"SILVA (only NR);Bacteria;Desulfobacterota;Desulfobacteria;Desulfobacterales;Desulfosarcinaceae;Desulfatibacillum;";"92.9";"18.2";"14";"14";"13";"1";"0";"457169";"373881"
"V4mis1";"SILVA (only NR);Bacteria;Desulfobacterota;Desulfobacteria;Desulfobacterales;Desulfosarcinaceae;Desulfatirhabdium;";"85.3";"18.2";"34";"34";"29";"5";"0";"457149";"373865"
"V4mis1";"SILVA (only NR);Bacteria;Desulfobacterota;Desulfobacteria;Desulfobacterales;Desulfosarcinaceae;Desulfatitalea;";"95.5";"18.2";"22";"22";"21";"1";"0";"457161";"373873"
"V4mis1";"SILVA (only NR);Bacteria;Desulfobacterota;Desulfobacteria;Desulfobacterales;Desulfosarcinaceae;Desulfonatronobacter;";"100.0";"18.2";"10";"10";"10";"0";"0";"457173";"373884"
"V4mis1";"SILVA (only NR);Bacteria;Desulfobacterota;Desulfobacteria;Desulfobacterales;Desulfosarcinaceae;Desulfosalsimonas;";"100.0";"18.2";"10";"10";"10";"0";"0";"457173";"373884"
"V4mis1";"SILVA (only NR);Bacteria;Desulfobacterota;Desulfobacteria;Desulfobacterales;Desulfosarcinaceae;Desulfosarcina;";"95.6";"18.2";"45";"45";"43";"2";"0";"457138";"373851"
"V4mis1";"SILVA (only NR);Bacteria;Desulfobacterota;Desulfobacteria;Desulfobacterales;Desulfosarcinaceae;Incertae Sedis;";"94.3";"18.2";"35";"35";"33";"2";"0";"457148";"373861"
"V4mis1";"SILVA (only NR);Bacteria;Desulfobacterota;Desulfobacteria;Desulfobacterales;Desulfosarcinaceae;LCP-80;";"96.1";"18.2";"51";"51";"49";"2";"0";"457132";"373845"
"V4mis1";"SILVA (only NR);Bacteria;Desulfobacterota;Desulfobacteria;Desulfobacterales;Desulfosarcinaceae;SEEP-SRB1;";"95.4";"18.2";"304";"304";"290";"14";"0";"456879";"373604"
"V4mis1";"SILVA (only NR);Bacteria;Desulfobacterota;Desulfobacteria;Desulfobacterales;Desulfosarcinaceae;Sva0081 sediment group;";"94.7";"18.2";"206";"206";"195";"11";"0";"456977";"373699"
"V4mis1";"SILVA (only NR);Bacteria;Desulfobacterota;Desulfobacteria;Desulfobacterales;Desulfosarcinaceae;uncultured;";"96.3";"18.2";"301";"301";"290";"11";"0";"456882";"373604"
"V4mis1";"SILVA (only NR);Bacteria;Desulfobacterota;Desulfobacteria;Desulfobacterales;uncultured;";"95.7";"18.2";"46";"46";"44";"2";"0";"457137";"373850"
"V4mis1";"SILVA (only NR);Bacteria;Desulfobacterota;Desulfobulbia;";"95.6";"18.3";"1427";"1427";"1364";"63";"0";"455756";"372530"
"V4mis1";"SILVA (only NR);Bacteria;Desulfobacterota;Desulfobulbia;Desulfobulbales;";"95.6";"18.3";"1427";"1427";"1364";"63";"0";"455756";"372530"
"V4mis1";"SILVA (only NR);Bacteria;Desulfobacterota;Desulfobulbia;Desulfobulbales;Desulfobulbaceae;";"96.3";"18.2";"410";"410";"395";"15";"0";"456773";"373499"
"V4mis1";"SILVA (only NR);Bacteria;Desulfobacterota;Desulfobulbia;Desulfobulbales;Desulfobulbaceae;Candidatus Electronema;";"100.0";"18.2";"11";"11";"11";"0";"0";"457172";"373883"
"V4mis1";"SILVA (only NR);Bacteria;Desulfobacterota;Desulfobulbia;Desulfobulbales;Desulfobulbaceae;Candidatus Electrothrix;";"100.0";"18.2";"13";"13";"13";"0";"0";"457170";"373881"
"V4mis1";"SILVA (only NR);Bacteria;Desulfobacterota;Desulfobulbia;Desulfobulbales;Desulfobulbaceae;Desulfobulbus;";"95.7";"18.2";"210";"210";"201";"9";"0";"456973";"373693"
"V4mis1";"SILVA (only NR);Bacteria;Desulfobacterota;Desulfobulbia;Desulfobulbales;Desulfobulbaceae;uncultured;";"96.5";"18.2";"173";"173";"167";"6";"0";"457010";"373727"
"V4mis1";"SILVA (only NR);Bacteria;Desulfobacterota;Desulfobulbia;Desulfobulbales;Desulfocapsaceae;";"95.4";"18.2";"878";"878";"838";"40";"0";"456305";"373056"
"V4mis1";"SILVA (only NR);Bacteria;Desulfobacterota;Desulfobulbia;Desulfobulbales;Desulfocapsaceae;Desulfocapsa;";"92.5";"18.2";"213";"213";"197";"16";"0";"456970";"373697"
"V4mis1";"SILVA (only NR);Bacteria;Desulfobacterota;Desulfobulbia;Desulfobulbales;Desulfocapsaceae;Desulfofustis;";"91.4";"18.2";"35";"35";"32";"3";"0";"457148";"373862"
"V4mis1";"SILVA (only NR);Bacteria;Desulfobacterota;Desulfobulbia;Desulfobulbales;Desulfocapsaceae;Desulfopila;";"96.3";"18.2";"54";"54";"52";"2";"0";"457129";"373842"
"V4mis1";"SILVA (only NR);Bacteria;Desulfobacterota;Desulfobulbia;Desulfobulbales;Desulfocapsaceae;Desulfoprunum;";"100.0";"18.2";"13";"13";"13";"0";"0";"457170";"373881"
"V4mis1";"SILVA (only NR);Bacteria;Desulfobacterota;Desulfobulbia;Desulfobulbales;Desulfocapsaceae;Desulforhopalus;";"92.9";"18.2";"113";"113";"105";"8";"0";"457070";"373789"
"V4mis1";"SILVA (only NR);Bacteria;Desulfobacterota;Desulfobulbia;Desulfobulbales;Desulfocapsaceae;Desulfotalea;";"95.0";"18.2";"20";"20";"19";"1";"0";"457163";"373875"
"V4mis1";"SILVA (only NR);Bacteria;Desulfobacterota;Desulfobulbia;Desulfobulbales;Desulfocapsaceae;SEEP-SRB4;";"100.0";"18.2";"47";"47";"47";"0";"0";"457136";"373847"
"V4mis1";"SILVA (only NR);Bacteria;Desulfobacterota;Desulfobulbia;Desulfobulbales;Desulfocapsaceae;[Desulfobacterium] catecholicum group;";"96.1";"18.2";"128";"128";"123";"5";"0";"457055";"373771"
"V4mis1";"SILVA (only NR);Bacteria;Desulfobacterota;Desulfobulbia;Desulfobulbales;Desulfocapsaceae;uncultured;";"98.4";"18.2";"251";"251";"247";"4";"0";"456932";"373647"
"V4mis1";"SILVA (only NR);Bacteria;Desulfobacterota;Desulfobulbia;Desulfobulbales;Desulfurivibrionaceae;";"94.8";"18.2";"96";"96";"91";"5";"0";"457087";"373803"
"V4mis1";"SILVA (only NR);Bacteria;Desulfobacterota;Desulfobulbia;Desulfobulbales;Desulfurivibrionaceae;Desulfurivibrio;";"100.0";"18.2";"43";"43";"43";"0";"0";"457140";"373851"
"V4mis1";"SILVA (only NR);Bacteria;Desulfobacterota;Desulfobulbia;Desulfobulbales;Desulfurivibrionaceae;MSBL7;";"90.2";"18.2";"51";"51";"46";"5";"0";"457132";"373848"
"V4mis1";"SILVA (only NR);Bacteria;Desulfobacterota;Desulfobulbia;Desulfobulbales;Desulfurivibrionaceae;uncultured;";"100.0";"18.2";"2";"2";"2";"0";"0";"457181";"373892"
"V4mis1";"SILVA (only NR);Bacteria;Desulfobacterota;Desulfobulbia;Desulfobulbales;uncultured;";"93.0";"18.2";"43";"43";"40";"3";"0";"457140";"373854"
"V4mis1";"SILVA (only NR);Bacteria;Desulfobacterota;Desulfofervidia;";"88.9";"18.2";"9";"9";"8";"1";"0";"457174";"373886"
"V4mis1";"SILVA (only NR);Bacteria;Desulfobacterota;Desulfofervidia;Desulfofervidales;";"88.9";"18.2";"9";"9";"8";"1";"0";"457174";"373886"
"V4mis1";"SILVA (only NR);Bacteria;Desulfobacterota;Desulfofervidia;Desulfofervidales;Desulfofervidaceae;";"88.9";"18.2";"9";"9";"8";"1";"0";"457174";"373886"
"V4mis1";"SILVA (only NR);Bacteria;Desulfobacterota;Desulfofervidia;Desulfofervidales;Desulfofervidaceae;Candidatus Desulfofervidus;";"88.9";"18.2";"9";"9";"8";"1";"0";"457174";"373886"
"V4mis1";"SILVA (only NR);Bacteria;Desulfobacterota;Desulfomonilia;";"91.8";"18.2";"61";"61";"56";"5";"0";"457122";"373838"
"V4mis1";"SILVA (only NR);Bacteria;Desulfobacterota;Desulfomonilia;Desulfomonilales;";"91.8";"18.2";"61";"61";"56";"5";"0";"457122";"373838"
"V4mis1";"SILVA (only NR);Bacteria;Desulfobacterota;Desulfomonilia;Desulfomonilales;Desulfomonilaceae;";"91.8";"18.2";"61";"61";"56";"5";"0";"457122";"373838"
"V4mis1";"SILVA (only NR);Bacteria;Desulfobacterota;Desulfomonilia;Desulfomonilales;Desulfomonilaceae;Desulfomonile;";"91.8";"18.2";"61";"61";"56";"5";"0";"457122";"373838"
"V4mis1";"SILVA (only NR);Bacteria;Desulfobacterota;Desulfovibrionia;";"93.5";"18.2";"1124";"1124";"1051";"73";"0";"456059";"372843"
"V4mis1";"SILVA (only NR);Bacteria;Desulfobacterota;Desulfovibrionia;Desulfovibrionales;";"93.5";"18.2";"1124";"1124";"1051";"73";"0";"456059";"372843"
"V4mis1";"SILVA (only NR);Bacteria;Desulfobacterota;Desulfovibrionia;Desulfovibrionales;Desulfohalobiaceae;";"87.3";"18.2";"134";"134";"117";"17";"0";"457049";"373777"
"V4mis1";"SILVA (only NR);Bacteria;Desulfobacterota;Desulfovibrionia;Desulfovibrionales;Desulfohalobiaceae;Desulfohalobium;";"100.0";"18.2";"3";"3";"3";"0";"0";"457180";"373891"
"V4mis1";"SILVA (only NR);Bacteria;Desulfobacterota;Desulfovibrionia;Desulfovibrionales;Desulfohalobiaceae;Desulfovermiculus;";"87.0";"18.2";"131";"131";"114";"17";"0";"457052";"373780"
"V4mis1";"SILVA (only NR);Bacteria;Desulfobacterota;Desulfovibrionia;Desulfovibrionales;Desulfomicrobiaceae;";"95.7";"18.2";"94";"94";"90";"4";"0";"457089";"373804"
"V4mis1";"SILVA (only NR);Bacteria;Desulfobacterota;Desulfovibrionia;Desulfovibrionales;Desulfomicrobiaceae;Desulfomicrobium;";"95.7";"18.2";"94";"94";"90";"4";"0";"457089";"373804"
"V4mis1";"SILVA (only NR);Bacteria;Desulfobacterota;Desulfovibrionia;Desulfovibrionales;Desulfonatronaceae;";"100.0";"18.2";"19";"19";"19";"0";"0";"457164";"373875"
"V4mis1";"SILVA (only NR);Bacteria;Desulfobacterota;Desulfovibrionia;Desulfovibrionales;Desulfonatronaceae;Desulfonatronum;";"100.0";"18.2";"19";"19";"19";"0";"0";"457164";"373875"
"V4mis1";"SILVA (only NR);Bacteria;Desulfobacterota;Desulfovibrionia;Desulfovibrionales;Desulfonatronovibrionaceae;";"95.0";"18.2";"20";"20";"19";"1";"0";"457163";"373875"
"V4mis1";"SILVA (only NR);Bacteria;Desulfobacterota;Desulfovibrionia;Desulfovibrionales;Desulfonatronovibrionaceae;Desulfonatronospira;";"100.0";"18.2";"10";"10";"10";"0";"0";"457173";"373884"
"V4mis1";"SILVA (only NR);Bacteria;Desulfobacterota;Desulfovibrionia;Desulfovibrionales;Desulfonatronovibrionaceae;Desulfonatronovibrio;";"88.9";"18.2";"9";"9";"8";"1";"0";"457174";"373886"
"V4mis1";"SILVA (only NR);Bacteria;Desulfobacterota;Desulfovibrionia;Desulfovibrionales;Desulfonauticaceae;";"100.0";"18.2";"8";"8";"8";"0";"0";"457175";"373886"
"V4mis1";"SILVA (only NR);Bacteria;Desulfobacterota;Desulfovibrionia;Desulfovibrionales;Desulfonauticaceae;Desulfonauticus;";"100.0";"18.2";"4";"4";"4";"0";"0";"457179";"373890"
"V4mis1";"SILVA (only NR);Bacteria;Desulfobacterota;Desulfovibrionia;Desulfovibrionales;Desulfonauticaceae;Desulfothermus;";"100.0";"18.2";"3";"3";"3";"0";"0";"457180";"373891"
"V4mis1";"SILVA (only NR);Bacteria;Desulfobacterota;Desulfovibrionia;Desulfovibrionales;Desulfoplanaceae;";"92.0";"18.2";"25";"25";"23";"2";"0";"457158";"373871"
"V4mis1";"SILVA (only NR);Bacteria;Desulfobacterota;Desulfovibrionia;Desulfovibrionales;Desulfoplanaceae;Desulfoplanes;";"92.0";"18.2";"25";"25";"23";"2";"0";"457158";"373871"
"V4mis1";"SILVA (only NR);Bacteria;Desulfobacterota;Desulfovibrionia;Desulfovibrionales;Desulfovibrionaceae;";"94.1";"18.2";"824";"824";"775";"49";"0";"456359";"373119"
"V4mis1";"SILVA (only NR);Bacteria;Desulfobacterota;Desulfovibrionia;Desulfovibrionales;Desulfovibrionaceae;Bilophila;";"100.0";"18.2";"24";"24";"24";"0";"0";"457159";"373870"
"V4mis1";"SILVA (only NR);Bacteria;Desulfobacterota;Desulfovibrionia;Desulfovibrionales;Desulfovibrionaceae;Desulfobaculum;";"100.0";"18.2";"1";"1";"1";"0";"0";"457182";"373893"
"V4mis1";"SILVA (only NR);Bacteria;Desulfobacterota;Desulfovibrionia;Desulfovibrionales;Desulfovibrionaceae;Desulfocurvus;";"100.0";"18.2";"8";"8";"8";"0";"0";"457175";"373886"
"V4mis1";"SILVA (only NR);Bacteria;Desulfobacterota;Desulfovibrionia;Desulfovibrionales;Desulfovibrionaceae;Desulfovibrio;";"93.5";"18.2";"616";"616";"576";"40";"0";"456567";"373318"
"V4mis1";"SILVA (only NR);Bacteria;Desulfobacterota;Desulfovibrionia;Desulfovibrionales;Desulfovibrionaceae;Halodesulfovibrio;";"94.6";"18.2";"37";"37";"35";"2";"0";"457146";"373859"
"V4mis1";"SILVA (only NR);Bacteria;Desulfobacterota;Desulfovibrionia;Desulfovibrionales;Desulfovibrionaceae;Lawsonia;";"100.0";"18.2";"7";"7";"7";"0";"0";"457176";"373887"
"V4mis1";"SILVA (only NR);Bacteria;Desulfobacterota;Desulfovibrionia;Desulfovibrionales;Desulfovibrionaceae;Mailhella;";"90.0";"18.2";"10";"10";"9";"1";"0";"457173";"373885"
"V4mis1";"SILVA (only NR);Bacteria;Desulfobacterota;Desulfovibrionia;Desulfovibrionales;Desulfovibrionaceae;uncultured;";"94.9";"18.2";"117";"117";"111";"6";"0";"457066";"373783"
"V4mis1";"SILVA (only NR);Bacteria;Desulfobacterota;Desulfuromonadia;";"96.8";"18.3";"1402";"1402";"1357";"45";"0";"455781";"372537"
"V4mis1";"SILVA (only NR);Bacteria;Desulfobacterota;Desulfuromonadia;Bradymonadales;";"96.6";"18.2";"235";"235";"227";"8";"0";"456948";"373667"
"V4mis1";"SILVA (only NR);Bacteria;Desulfobacterota;Desulfuromonadia;Bradymonadales;Bradymonadaceae;";"99.0";"18.2";"97";"97";"96";"1";"0";"457086";"373798"
"V4mis1";"SILVA (only NR);Bacteria;Desulfobacterota;Desulfuromonadia;Bradymonadales;Bradymonadaceae;Bradymonas;";"100.0";"18.2";"4";"4";"4";"0";"0";"457179";"373890"
"V4mis1";"SILVA (only NR);Bacteria;Desulfobacterota;Desulfuromonadia;Desulfuromonadales;";"95.9";"18.2";"417";"417";"400";"17";"0";"456766";"373494"
"V4mis1";"SILVA (only NR);Bacteria;Desulfobacterota;Desulfuromonadia;Desulfuromonadales;C8S-102;";"100.0";"18.2";"5";"5";"5";"0";"0";"457178";"373889"
"V4mis1";"SILVA (only NR);Bacteria;Desulfobacterota;Desulfuromonadia;Desulfuromonadales;Desulfuromonadaceae;";"98.6";"18.2";"145";"145";"143";"2";"0";"457038";"373751"
"V4mis1";"SILVA (only NR);Bacteria;Desulfobacterota;Desulfuromonadia;Desulfuromonadales;Desulfuromonadaceae;Candidatus Deferrimonas;";"100.0";"18.2";"3";"3";"3";"0";"0";"457180";"373891"
"V4mis1";"SILVA (only NR);Bacteria;Desulfobacterota;Desulfuromonadia;Desulfuromonadales;Desulfuromonadaceae;Desulfuromonas;";"99.0";"18.2";"103";"103";"102";"1";"0";"457080";"373792"
"V4mis1";"SILVA (only NR);Bacteria;Desulfobacterota;Desulfuromonadia;Desulfuromonadales;Desulfuromonadaceae;Trichloromonas;";"91.7";"18.2";"12";"12";"11";"1";"0";"457171";"373883"
"V4mis1";"SILVA (only NR);Bacteria;Desulfobacterota;Desulfuromonadia;Desulfuromonadales;Geoalkalibacteraceae;";"95.0";"18.2";"20";"20";"19";"1";"0";"457163";"373875"
"V4mis1";"SILVA (only NR);Bacteria;Desulfobacterota;Desulfuromonadia;Desulfuromonadales;Geoalkalibacteraceae;Geoalkalibacter;";"95.0";"18.2";"20";"20";"19";"1";"0";"457163";"373875"
"V4mis1";"SILVA (only NR);Bacteria;Desulfobacterota;Desulfuromonadia;Desulfuromonadales;Geopsychrobacteraceae;";"94.6";"18.2";"93";"93";"88";"5";"0";"457090";"373806"
"V4mis1";"SILVA (only NR);Bacteria;Desulfobacterota;Desulfuromonadia;Desulfuromonadales;Geopsychrobacteraceae;Desulfuromusa;";"93.7";"18.2";"63";"63";"59";"4";"0";"457120";"373835"
"V4mis1";"SILVA (only NR);Bacteria;Desulfobacterota;Desulfuromonadia;Desulfuromonadales;Geopsychrobacteraceae;Geopsychrobacter;";"100.0";"18.2";"16";"16";"16";"0";"0";"457167";"373878"
"V4mis1";"SILVA (only NR);Bacteria;Desulfobacterota;Desulfuromonadia;Desulfuromonadales;Geopsychrobacteraceae;Malonomonas;";"87.5";"18.2";"8";"8";"7";"1";"0";"457175";"373887"
"V4mis1";"SILVA (only NR);Bacteria;Desulfobacterota;Desulfuromonadia;Desulfuromonadales;Geopsychrobacteraceae;Pelobacter;";"100.0";"18.2";"5";"5";"5";"0";"0";"457178";"373889"
"V4mis1";"SILVA (only NR);Bacteria;Desulfobacterota;Desulfuromonadia;Desulfuromonadales;Geothermobacteraceae;";"97.7";"18.2";"44";"44";"43";"1";"0";"457139";"373851"
"V4mis1";"SILVA (only NR);Bacteria;Desulfobacterota;Desulfuromonadia;Desulfuromonadales;Geothermobacteraceae;Geothermobacter;";"97.7";"18.2";"44";"44";"43";"1";"0";"457139";"373851"
"V4mis1";"SILVA (only NR);Bacteria;Desulfobacterota;Desulfuromonadia;Desulfuromonadales;MA-28-I98C;";"100.0";"18.2";"7";"7";"7";"0";"0";"457176";"373887"
"V4mis1";"SILVA (only NR);Bacteria;Desulfobacterota;Desulfuromonadia;Desulfuromonadales;Sva1033;";"92.1";"18.2";"63";"63";"58";"5";"0";"457120";"373836"
"V4mis1";"SILVA (only NR);Bacteria;Desulfobacterota;Desulfuromonadia;Desulfuromonadales;Syntrophotaleaceae;";"91.4";"18.2";"35";"35";"32";"3";"0";"457148";"373862"
"V4mis1";"SILVA (only NR);Bacteria;Desulfobacterota;Desulfuromonadia;Desulfuromonadales;Syntrophotaleaceae;Syntrophotalea;";"91.4";"18.2";"35";"35";"32";"3";"0";"457148";"373862"
"V4mis1";"SILVA (only NR);Bacteria;Desulfobacterota;Desulfuromonadia;Desulfuromonadales;uncultured;";"100.0";"18.2";"2";"2";"2";"0";"0";"457181";"373892"
"V4mis1";"SILVA (only NR);Bacteria;Desulfobacterota;Desulfuromonadia;Geobacterales;";"96.9";"18.2";"575";"575";"557";"18";"0";"456608";"373337"
"V4mis1";"SILVA (only NR);Bacteria;Desulfobacterota;Desulfuromonadia;Geobacterales;Geobacteraceae;";"96.8";"18.2";"571";"571";"553";"18";"0";"456612";"373341"
"V4mis1";"SILVA (only NR);Bacteria;Desulfobacterota;Desulfuromonadia;Geobacterales;Geobacteraceae;Citrifermentans;";"97.5";"18.2";"121";"121";"118";"3";"0";"457062";"373776"
"V4mis1";"SILVA (only NR);Bacteria;Desulfobacterota;Desulfuromonadia;Geobacterales;Geobacteraceae;Geobacter;";"96.8";"18.2";"219";"219";"212";"7";"0";"456964";"373682"
"V4mis1";"SILVA (only NR);Bacteria;Desulfobacterota;Desulfuromonadia;Geobacterales;Geobacteraceae;Geotalea;";"100.0";"18.2";"14";"14";"14";"0";"0";"457169";"373880"
"V4mis1";"SILVA (only NR);Bacteria;Desulfobacterota;Desulfuromonadia;Geobacterales;Geobacteraceae;Trichlorobacter;";"100.0";"18.2";"33";"33";"33";"0";"0";"457150";"373861"
"V4mis1";"SILVA (only NR);Bacteria;Desulfobacterota;Desulfuromonadia;Geobacterales;Geobacteraceae;uncultured;";"95.7";"18.2";"162";"162";"155";"7";"0";"457021";"373739"
"V4mis1";"SILVA (only NR);Bacteria;Desulfobacterota;Desulfuromonadia;Geobacterales;Pseudopelobacteraceae;";"100.0";"18.2";"4";"4";"4";"0";"0";"457179";"373890"
"V4mis1";"SILVA (only NR);Bacteria;Desulfobacterota;Desulfuromonadia;Geobacterales;Pseudopelobacteraceae;Pseudopelobacter;";"100.0";"18.2";"4";"4";"4";"0";"0";"457179";"373890"
"V4mis1";"SILVA (only NR);Bacteria;Desulfobacterota;Desulfuromonadia;PB19;";"98.8";"18.2";"171";"171";"169";"2";"0";"457012";"373725"
"V4mis1";"SILVA (only NR);Bacteria;Desulfobacterota;Desulfuromonadia;uncultured;";"100.0";"18.2";"2";"2";"2";"0";"0";"457181";"373892"
"V4mis1";"SILVA (only NR);Bacteria;Desulfobacterota;Dissulfuribacteria;";"93.8";"18.2";"80";"80";"75";"5";"0";"457103";"373819"
"V4mis1";"SILVA (only NR);Bacteria;Desulfobacterota;Dissulfuribacteria;Dissulfuribacterales;";"93.8";"18.2";"80";"80";"75";"5";"0";"457103";"373819"
"V4mis1";"SILVA (only NR);Bacteria;Desulfobacterota;Dissulfuribacteria;Dissulfuribacterales;Dissulfuribacteraceae;";"93.8";"18.2";"80";"80";"75";"5";"0";"457103";"373819"
"V4mis1";"SILVA (only NR);Bacteria;Desulfobacterota;Dissulfuribacteria;Dissulfuribacterales;Dissulfuribacteraceae;Dissulfuribacter;";"100.0";"18.2";"3";"3";"3";"0";"0";"457180";"373891"
"V4mis1";"SILVA (only NR);Bacteria;Desulfobacterota;Dissulfuribacteria;Dissulfuribacterales;Dissulfuribacteraceae;Dissulfurimicrobium;";"100.0";"18.2";"12";"12";"12";"0";"0";"457171";"373882"
"V4mis1";"SILVA (only NR);Bacteria;Desulfobacterota;Dissulfuribacteria;Dissulfuribacterales;Dissulfuribacteraceae;Dissulfurirhabdus;";"100.0";"18.2";"2";"2";"2";"0";"0";"457181";"373892"
"V4mis1";"SILVA (only NR);Bacteria;Desulfobacterota;Dissulfuribacteria;Dissulfuribacterales;Dissulfuribacteraceae;SEEP-SRB2;";"88.9";"18.2";"36";"36";"32";"4";"0";"457147";"373862"
"V4mis1";"SILVA (only NR);Bacteria;Desulfobacterota;Dissulfuribacteria;Dissulfuribacterales;Dissulfuribacteraceae;uncultured;";"95.8";"18.2";"24";"24";"23";"1";"0";"457159";"373871"
"V4mis1";"SILVA (only NR);Bacteria;Desulfobacterota;Incertae Sedis;";"88.9";"18.2";"9";"9";"8";"1";"0";"457174";"373886"
"V4mis1";"SILVA (only NR);Bacteria;Desulfobacterota;Syntrophia;";"96.0";"18.2";"451";"451";"433";"18";"0";"456732";"373461"
"V4mis1";"SILVA (only NR);Bacteria;Desulfobacterota;Syntrophia;Syntrophales;";"96.0";"18.2";"451";"451";"433";"18";"0";"456732";"373461"
"V4mis1";"SILVA (only NR);Bacteria;Desulfobacterota;Syntrophia;Syntrophales;Smithellaceae;";"93.3";"18.2";"119";"119";"111";"8";"0";"457064";"373783"
"V4mis1";"SILVA (only NR);Bacteria;Desulfobacterota;Syntrophia;Syntrophales;Smithellaceae;Smithella;";"93.3";"18.2";"119";"119";"111";"8";"0";"457064";"373783"
"V4mis1";"SILVA (only NR);Bacteria;Desulfobacterota;Syntrophia;Syntrophales;Syntrophaceae;";"96.8";"18.2";"221";"221";"214";"7";"0";"456962";"373680"
"V4mis1";"SILVA (only NR);Bacteria;Desulfobacterota;Syntrophia;Syntrophales;Syntrophaceae;Syntrophus;";"96.8";"18.2";"221";"221";"214";"7";"0";"456962";"373680"
"V4mis1";"SILVA (only NR);Bacteria;Desulfobacterota;Syntrophia;Syntrophales;uncultured;";"97.2";"18.2";"109";"109";"106";"3";"0";"457074";"373788"
"V4mis1";"SILVA (only NR);Bacteria;Desulfobacterota;Syntrophobacteria;";"95.2";"18.2";"228";"228";"217";"11";"0";"456955";"373677"
"V4mis1";"SILVA (only NR);Bacteria;Desulfobacterota;Syntrophobacteria;Syntrophobacterales;";"95.2";"18.2";"228";"228";"217";"11";"0";"456955";"373677"
"V4mis1";"SILVA (only NR);Bacteria;Desulfobacterota;Syntrophobacteria;Syntrophobacterales;Syntrophobacteraceae;";"95.0";"18.2";"161";"161";"153";"8";"0";"457022";"373741"
"V4mis1";"SILVA (only NR);Bacteria;Desulfobacterota;Syntrophobacteria;Syntrophobacterales;Syntrophobacteraceae;Desulfacinum;";"75.0";"18.2";"4";"4";"3";"1";"0";"457179";"373891"
"V4mis1";"SILVA (only NR);Bacteria;Desulfobacterota;Syntrophobacteria;Syntrophobacterales;Syntrophobacteraceae;Desulfoglaeba;";"100.0";"18.2";"1";"1";"1";"0";"0";"457182";"373893"
"V4mis1";"SILVA (only NR);Bacteria;Desulfobacterota;Syntrophobacteria;Syntrophobacterales;Syntrophobacteraceae;Desulforhabdus;";"100.0";"18.2";"11";"11";"11";"0";"0";"457172";"373883"
"V4mis1";"SILVA (only NR);Bacteria;Desulfobacterota;Syntrophobacteria;Syntrophobacterales;Syntrophobacteraceae;Desulfosoma;";"100.0";"18.2";"2";"2";"2";"0";"0";"457181";"373892"
"V4mis1";"SILVA (only NR);Bacteria;Desulfobacterota;Syntrophobacteria;Syntrophobacterales;Syntrophobacteraceae;Desulfovirga;";"100.0";"18.2";"12";"12";"12";"0";"0";"457171";"373882"
"V4mis1";"SILVA (only NR);Bacteria;Desulfobacterota;Syntrophobacteria;Syntrophobacterales;Syntrophobacteraceae;Syntrophobacter;";"95.7";"18.2";"94";"94";"90";"4";"0";"457089";"373804"
"V4mis1";"SILVA (only NR);Bacteria;Desulfobacterota;Syntrophobacteria;Syntrophobacterales;Syntrophobacteraceae;uncultured;";"91.4";"18.2";"35";"35";"32";"3";"0";"457148";"373862"
"V4mis1";"SILVA (only NR);Bacteria;Desulfobacterota;Syntrophobacteria;Syntrophobacterales;Thermodesulforhabdaceae;";"100.0";"18.2";"6";"6";"6";"0";"0";"457177";"373888"
"V4mis1";"SILVA (only NR);Bacteria;Desulfobacterota;Syntrophobacteria;Syntrophobacterales;Thermodesulforhabdaceae;Thermodesulforhabdus;";"100.0";"18.2";"6";"6";"6";"0";"0";"457177";"373888"
"V4mis1";"SILVA (only NR);Bacteria;Desulfobacterota;Syntrophobacteria;Syntrophobacterales;uncultured;";"95.1";"18.2";"61";"61";"58";"3";"0";"457122";"373836"
"V4mis1";"SILVA (only NR);Bacteria;Desulfobacterota;Syntrophorhabdia;";"97.6";"18.2";"168";"168";"164";"4";"0";"457015";"373730"
"V4mis1";"SILVA (only NR);Bacteria;Desulfobacterota;Syntrophorhabdia;Syntrophorhabdales;";"97.6";"18.2";"168";"168";"164";"4";"0";"457015";"373730"
"V4mis1";"SILVA (only NR);Bacteria;Desulfobacterota;Syntrophorhabdia;Syntrophorhabdales;Syntrophorhabdaceae;";"97.6";"18.2";"168";"168";"164";"4";"0";"457015";"373730"
"V4mis1";"SILVA (only NR);Bacteria;Desulfobacterota;Syntrophorhabdia;Syntrophorhabdales;Syntrophorhabdaceae;Syntrophorhabdus;";"97.6";"18.2";"168";"168";"164";"4";"0";"457015";"373730"
"V4mis1";"SILVA (only NR);Bacteria;Desulfobacterota;Thermodesulfobacteria;";"100.0";"18.2";"62";"62";"62";"0";"0";"457121";"373832"
"V4mis1";"SILVA (only NR);Bacteria;Desulfobacterota;Thermodesulfobacteria;Thermodesulfobacteriales;";"100.0";"18.2";"62";"62";"62";"0";"0";"457121";"373832"
"V4mis1";"SILVA (only NR);Bacteria;Desulfobacterota;Thermodesulfobacteria;Thermodesulfobacteriales;Thermodesulfobacteriaceae;";"100.0";"18.2";"62";"62";"62";"0";"0";"457121";"373832"
"V4mis1";"SILVA (only NR);Bacteria;Desulfobacterota;Thermodesulfobacteria;Thermodesulfobacteriales;Thermodesulfobacteriaceae;Caldimicrobium;";"100.0";"18.2";"28";"28";"28";"0";"0";"457155";"373866"
"V4mis1";"SILVA (only NR);Bacteria;Desulfobacterota;Thermodesulfobacteria;Thermodesulfobacteriales;Thermodesulfobacteriaceae;Geothermobacterium;";"100.0";"18.2";"4";"4";"4";"0";"0";"457179";"373890"
"V4mis1";"SILVA (only NR);Bacteria;Desulfobacterota;Thermodesulfobacteria;Thermodesulfobacteriales;Thermodesulfobacteriaceae;Thermodesulfatator;";"100.0";"18.2";"5";"5";"5";"0";"0";"457178";"373889"
"V4mis1";"SILVA (only NR);Bacteria;Desulfobacterota;Thermodesulfobacteria;Thermodesulfobacteriales;Thermodesulfobacteriaceae;Thermodesulfobacterium;";"100.0";"18.2";"10";"10";"10";"0";"0";"457173";"373884"
"V4mis1";"SILVA (only NR);Bacteria;Desulfobacterota;Thermodesulfobacteria;Thermodesulfobacteriales;Thermodesulfobacteriaceae;Thermosulfurimonas;";"100.0";"18.2";"2";"2";"2";"0";"0";"457181";"373892"
"V4mis1";"SILVA (only NR);Bacteria;Desulfobacterota;Thermodesulfobacteria;Thermodesulfobacteriales;Thermodesulfobacteriaceae;Thermosulfuriphilus;";"100.0";"18.2";"1";"1";"1";"0";"0";"457182";"373893"
"V4mis1";"SILVA (only NR);Bacteria;Desulfobacterota;Thermodesulfobacteria;Thermodesulfobacteriales;Thermodesulfobacteriaceae;uncultured;";"100.0";"18.2";"10";"10";"10";"0";"0";"457173";"373884"
"V4mis1";"SILVA (only NR);Bacteria;Desulfobacterota;uncultured;";"95.4";"18.2";"173";"173";"165";"8";"0";"457010";"373729"
"V4mis1";"SILVA (only NR);Bacteria;Dictyoglomota;";"87.5";"18.2";"8";"8";"7";"1";"0";"457175";"373887"
"V4mis1";"SILVA (only NR);Bacteria;Dictyoglomota;Dictyoglomia;";"87.5";"18.2";"8";"8";"7";"1";"0";"457175";"373887"
"V4mis1";"SILVA (only NR);Bacteria;Dictyoglomota;Dictyoglomia;Dictyoglomales;";"87.5";"18.2";"8";"8";"7";"1";"0";"457175";"373887"
"V4mis1";"SILVA (only NR);Bacteria;Dictyoglomota;Dictyoglomia;Dictyoglomales;Dictyoglomaceae;";"87.5";"18.2";"8";"8";"7";"1";"0";"457175";"373887"
"V4mis1";"SILVA (only NR);Bacteria;Dictyoglomota;Dictyoglomia;Dictyoglomales;Dictyoglomaceae;Dictyoglomus;";"87.5";"18.2";"8";"8";"7";"1";"0";"457175";"373887"
"V4mis1";"SILVA (only NR);Bacteria;Edwardsbacteria;";"100.0";"18.2";"4";"4";"4";"0";"0";"457179";"373890"
"V4mis1";"SILVA (only NR);Bacteria;Elusimicrobiota;";"95.7";"18.2";"418";"418";"400";"18";"0";"456765";"373494"
"V4mis1";"SILVA (only NR);Bacteria;Elusimicrobiota;4-29;";"96.0";"18.2";"25";"25";"24";"1";"0";"457158";"373870"
"V4mis1";"SILVA (only NR);Bacteria;Elusimicrobiota;Elusimicrobia;";"94.7";"18.2";"114";"114";"108";"6";"0";"457069";"373786"
"V4mis1";"SILVA (only NR);Bacteria;Elusimicrobiota;Elusimicrobia;Elusimicrobiales;";"100.0";"18.2";"17";"17";"17";"0";"0";"457166";"373877"
"V4mis1";"SILVA (only NR);Bacteria;Elusimicrobiota;Elusimicrobia;Elusimicrobiales;Elusimicrobiaceae;";"100.0";"18.2";"17";"17";"17";"0";"0";"457166";"373877"
"V4mis1";"SILVA (only NR);Bacteria;Elusimicrobiota;Elusimicrobia;Elusimicrobiales;Elusimicrobiaceae;Elusimicrobium;";"100.0";"18.2";"17";"17";"17";"0";"0";"457166";"373877"
"V4mis1";"SILVA (only NR);Bacteria;Elusimicrobiota;Elusimicrobia;FCPU453;";"100.0";"18.2";"2";"2";"2";"0";"0";"457181";"373892"
"V4mis1";"SILVA (only NR);Bacteria;Elusimicrobiota;Elusimicrobia;Lineage IV;";"97.1";"18.2";"68";"68";"66";"2";"0";"457115";"373828"
"V4mis1";"SILVA (only NR);Bacteria;Elusimicrobiota;Elusimicrobia;MD2894-B20;";"100.0";"18.2";"6";"6";"6";"0";"0";"457177";"373888"
"V4mis1";"SILVA (only NR);Bacteria;Elusimicrobiota;Elusimicrobia;MVP-88;";"81.0";"18.2";"21";"21";"17";"4";"0";"457162";"373877"
"V4mis1";"SILVA (only NR);Bacteria;Elusimicrobiota;Endomicrobia;";"96.8";"18.2";"158";"158";"153";"5";"0";"457025";"373741"
"V4mis1";"SILVA (only NR);Bacteria;Elusimicrobiota;Endomicrobia;Endomicrobiales;";"96.8";"18.2";"158";"158";"153";"5";"0";"457025";"373741"
"V4mis1";"SILVA (only NR);Bacteria;Elusimicrobiota;Endomicrobia;Endomicrobiales;Endomicrobiaceae;";"96.8";"18.2";"158";"158";"153";"5";"0";"457025";"373741"
"V4mis1";"SILVA (only NR);Bacteria;Elusimicrobiota;Endomicrobia;Endomicrobiales;Endomicrobiaceae;Endomicrobium;";"96.8";"18.2";"158";"158";"153";"5";"0";"457025";"373741"
"V4mis1";"SILVA (only NR);Bacteria;Elusimicrobiota;Lineage IIa;";"92.3";"18.2";"52";"52";"48";"4";"0";"457131";"373846"
"V4mis1";"SILVA (only NR);Bacteria;Elusimicrobiota;Lineage IIb;";"93.8";"18.2";"32";"32";"30";"2";"0";"457151";"373864"
"V4mis1";"SILVA (only NR);Bacteria;Elusimicrobiota;Lineage IIc;";"100.0";"18.2";"21";"21";"21";"0";"0";"457162";"373873"
"V4mis1";"SILVA (only NR);Bacteria;Elusimicrobiota;Rs-M47;";"100.0";"18.2";"13";"13";"13";"0";"0";"457170";"373881"
"V4mis1";"SILVA (only NR);Bacteria;Entotheonellaeota;";"95.4";"18.2";"152";"152";"145";"7";"0";"457031";"373749"
"V4mis1";"SILVA (only NR);Bacteria;Entotheonellaeota;Entotheonellia;";"95.4";"18.2";"152";"152";"145";"7";"0";"457031";"373749"
"V4mis1";"SILVA (only NR);Bacteria;Entotheonellaeota;Entotheonellia;Entotheonellales;";"95.4";"18.2";"152";"152";"145";"7";"0";"457031";"373749"
"V4mis1";"SILVA (only NR);Bacteria;Entotheonellaeota;Entotheonellia;Entotheonellales;Entotheonellaceae;";"95.4";"18.2";"152";"152";"145";"7";"0";"457031";"373749"
"V4mis1";"SILVA (only NR);Bacteria;Entotheonellaeota;Entotheonellia;Entotheonellales;Entotheonellaceae;Candidatus Entotheonella;";"83.9";"18.2";"31";"31";"26";"5";"0";"457152";"373868"
"V4mis1";"SILVA (only NR);Bacteria;FCPU426;";"92.1";"18.2";"38";"38";"35";"3";"0";"457145";"373859"
"V4mis1";"SILVA (only NR);Bacteria;FW113;";"94.7";"18.2";"19";"19";"18";"1";"0";"457164";"373876"
"V4mis1";"SILVA (only NR);Bacteria;Fermentibacterota;";"92.6";"18.2";"54";"54";"50";"4";"0";"457129";"373844"
"V4mis1";"SILVA (only NR);Bacteria;Fermentibacterota;Fermentibacteria;";"92.6";"18.2";"54";"54";"50";"4";"0";"457129";"373844"
"V4mis1";"SILVA (only NR);Bacteria;Fermentibacterota;Fermentibacteria;Fermentibacterales;";"92.6";"18.2";"54";"54";"50";"4";"0";"457129";"373844"
"V4mis1";"SILVA (only NR);Bacteria;Fermentibacterota;Fermentibacteria;Fermentibacterales;Fermentibacteraceae;";"92.6";"18.2";"54";"54";"50";"4";"0";"457129";"373844"
"V4mis1";"SILVA (only NR);Bacteria;Fervidibacteria;";"100.0";"18.2";"4";"4";"4";"0";"0";"457179";"373890"
"V4mis1";"SILVA (only NR);Bacteria;Fibrobacterota;";"92.4";"18.2";"739";"739";"683";"56";"0";"456444";"373211"
"V4mis1";"SILVA (only NR);Bacteria;Fibrobacterota;Chitinivibrionia;";"96.4";"18.2";"55";"55";"53";"2";"0";"457128";"373841"
"V4mis1";"SILVA (only NR);Bacteria;Fibrobacterota;Chitinivibrionia;Chitinivibrionales;";"100.0";"18.2";"10";"10";"10";"0";"0";"457173";"373884"
"V4mis1";"SILVA (only NR);Bacteria;Fibrobacterota;Chitinivibrionia;Chitinivibrionales;Chitinivibrionaceae;";"100.0";"18.2";"10";"10";"10";"0";"0";"457173";"373884"
"V4mis1";"SILVA (only NR);Bacteria;Fibrobacterota;Chitinivibrionia;Chitinivibrionales;Chitinivibrionaceae;Chitinivibrio;";"100.0";"18.2";"2";"2";"2";"0";"0";"457181";"373892"
"V4mis1";"SILVA (only NR);Bacteria;Fibrobacterota;Chitinivibrionia;Chitinivibrionales;Chitinivibrionaceae;possible genus 03;";"100.0";"18.2";"8";"8";"8";"0";"0";"457175";"373886"
"V4mis1";"SILVA (only NR);Bacteria;Fibrobacterota;Chitinivibrionia;Chitinivibrionia Incertae Sedis;";"92.3";"18.2";"13";"13";"12";"1";"0";"457170";"373882"
"V4mis1";"SILVA (only NR);Bacteria;Fibrobacterota;Chitinivibrionia;Chitinivibrionia Incertae Sedis;Unknown Family;";"92.3";"18.2";"13";"13";"12";"1";"0";"457170";"373882"
"V4mis1";"SILVA (only NR);Bacteria;Fibrobacterota;Chitinivibrionia;Chitinivibrionia Incertae Sedis;Unknown Family;possible genus 02;";"92.3";"18.2";"13";"13";"12";"1";"0";"457170";"373882"
"V4mis1";"SILVA (only NR);Bacteria;Fibrobacterota;Chitinivibrionia;uncultured;";"96.9";"18.2";"32";"32";"31";"1";"0";"457151";"373863"
"V4mis1";"SILVA (only NR);Bacteria;Fibrobacterota;Fibrobacteria;";"92.1";"18.2";"684";"684";"630";"54";"0";"456499";"373264"
"V4mis1";"SILVA (only NR);Bacteria;Fibrobacterota;Fibrobacteria;Fibrobacterales;";"92.1";"18.2";"684";"684";"630";"54";"0";"456499";"373264"
"V4mis1";"SILVA (only NR);Bacteria;Fibrobacterota;Fibrobacteria;Fibrobacterales;09D2Z48;";"70.7";"18.2";"41";"41";"29";"12";"0";"457142";"373865"
"V4mis1";"SILVA (only NR);Bacteria;Fibrobacterota;Fibrobacteria;Fibrobacterales;B122;";"100.0";"18.2";"10";"10";"10";"0";"0";"457173";"373884"
"V4mis1";"SILVA (only NR);Bacteria;Fibrobacterota;Fibrobacteria;Fibrobacterales;B18;";"100.0";"18.2";"6";"6";"6";"0";"0";"457177";"373888"
"V4mis1";"SILVA (only NR);Bacteria;Fibrobacterota;Fibrobacteria;Fibrobacterales;B5-096;";"100.0";"18.2";"2";"2";"2";"0";"0";"457181";"373892"
"V4mis1";"SILVA (only NR);Bacteria;Fibrobacterota;Fibrobacteria;Fibrobacterales;BBMC-4;";"89.5";"18.2";"38";"38";"34";"4";"0";"457145";"373860"
"V4mis1";"SILVA (only NR);Bacteria;Fibrobacterota;Fibrobacteria;Fibrobacterales;Candidatus Raymondbacteria;";"61.5";"18.2";"13";"13";"8";"5";"0";"457170";"373886"
"V4mis1";"SILVA (only NR);Bacteria;Fibrobacterota;Fibrobacteria;Fibrobacterales;Chitinispirillum;";"100.0";"18.2";"1";"1";"1";"0";"0";"457182";"373893"
"V4mis1";"SILVA (only NR);Bacteria;Fibrobacterota;Fibrobacteria;Fibrobacterales;Fibrobacteraceae;";"96.9";"18.2";"324";"324";"314";"10";"0";"456859";"373580"
"V4mis1";"SILVA (only NR);Bacteria;Fibrobacterota;Fibrobacteria;Fibrobacterales;Fibrobacteraceae;Fibrobacter;";"97.2";"18.2";"177";"177";"172";"5";"0";"457006";"373722"
"V4mis1";"SILVA (only NR);Bacteria;Fibrobacterota;Fibrobacteria;Fibrobacterales;Fibrobacteraceae;possible genus 04;";"90.0";"18.2";"20";"20";"18";"2";"0";"457163";"373876"
"V4mis1";"SILVA (only NR);Bacteria;Fibrobacterota;Fibrobacteria;Fibrobacterales;Fibrobacteraceae;possible genus 05;";"100.0";"18.2";"51";"51";"51";"0";"0";"457132";"373843"
"V4mis1";"SILVA (only NR);Bacteria;Fibrobacterota;Fibrobacteria;Fibrobacterales;Fibrobacteraceae;possible genus 06;";"100.0";"18.2";"2";"2";"2";"0";"0";"457181";"373892"
"V4mis1";"SILVA (only NR);Bacteria;Fibrobacterota;Fibrobacteria;Fibrobacterales;Fibrobacteraceae;uncultured;";"95.8";"18.2";"72";"72";"69";"3";"0";"457111";"373825"
"V4mis1";"SILVA (only NR);Bacteria;Fibrobacterota;Fibrobacteria;Fibrobacterales;MAT-CR-H6-H10;";"86.1";"18.2";"72";"72";"62";"10";"0";"457111";"373832"
"V4mis1";"SILVA (only NR);Bacteria;Fibrobacterota;Fibrobacteria;Fibrobacterales;SBXY-748;";"90.9";"18.2";"11";"11";"10";"1";"0";"457172";"373884"
"V4mis1";"SILVA (only NR);Bacteria;Fibrobacterota;Fibrobacteria;Fibrobacterales;SBYC;";"85.0";"18.2";"20";"20";"17";"3";"0";"457163";"373877"
"V4mis1";"SILVA (only NR);Bacteria;Fibrobacterota;Fibrobacteria;Fibrobacterales;SBYS-2995;";"100.0";"18.2";"4";"4";"4";"0";"0";"457179";"373890"
"V4mis1";"SILVA (only NR);Bacteria;Fibrobacterota;Fibrobacteria;Fibrobacterales;SBYZ-1017;";"90.9";"18.2";"11";"11";"10";"1";"0";"457172";"373884"
"V4mis1";"SILVA (only NR);Bacteria;Fibrobacterota;Fibrobacteria;Fibrobacterales;TG3;";"92.5";"18.2";"40";"40";"37";"3";"0";"457143";"373857"
"V4mis1";"SILVA (only NR);Bacteria;Fibrobacterota;Fibrobacteria;Fibrobacterales;uncultured;";"94.4";"18.2";"90";"90";"85";"5";"0";"457093";"373809"
"V4mis1";"SILVA (only NR);Bacteria;Firestonebacteria;";"100.0";"18.2";"4";"4";"4";"0";"0";"457179";"373890"
"V4mis1";"SILVA (only NR);Bacteria;Firmicutes;";"92.0";"21.1";"100538";"100538";"92543";"7995";"0";"356645";"281351"
"V4mis1";"SILVA (only NR);Bacteria;Firmicutes;BRH-c20a;";"96.9";"18.2";"32";"32";"31";"1";"0";"457151";"373863"
"V4mis1";"SILVA (only NR);Bacteria;Firmicutes;Bacilli;";"88.9";"18.9";"42707";"42707";"37948";"4759";"0";"414476";"335946"
"V4mis1";"SILVA (only NR);Bacteria;Firmicutes;Bacilli;Acholeplasmatales;";"92.8";"18.2";"752";"752";"698";"54";"0";"456431";"373196"
"V4mis1";"SILVA (only NR);Bacteria;Firmicutes;Bacilli;Acholeplasmatales;Acholeplasmataceae;";"92.8";"18.2";"752";"752";"698";"54";"0";"456431";"373196"
"V4mis1";"SILVA (only NR);Bacteria;Firmicutes;Bacilli;Acholeplasmatales;Acholeplasmataceae;Acholeplasma;";"94.6";"18.2";"203";"203";"192";"11";"0";"456980";"373702"
"V4mis1";"SILVA (only NR);Bacteria;Firmicutes;Bacilli;Acholeplasmatales;Acholeplasmataceae;Anaeroplasma;";"100.0";"18.2";"63";"63";"63";"0";"0";"457120";"373831"
"V4mis1";"SILVA (only NR);Bacteria;Firmicutes;Bacilli;Acholeplasmatales;Acholeplasmataceae;Candidatus Phytoplasma;";"90.8";"18.2";"468";"468";"425";"43";"0";"456715";"373469"
"V4mis1";"SILVA (only NR);Bacteria;Firmicutes;Bacilli;Acholeplasmatales;Acholeplasmataceae;DMI;";"100.0";"18.2";"4";"4";"4";"0";"0";"457179";"373890"
"V4mis1";"SILVA (only NR);Bacteria;Firmicutes;Bacilli;Acholeplasmatales;Acholeplasmataceae;EMP-G18;";"100.0";"18.2";"4";"4";"4";"0";"0";"457179";"373890"
"V4mis1";"SILVA (only NR);Bacteria;Firmicutes;Bacilli;Acholeplasmatales;Acholeplasmataceae;EUB33-2;";"100.0";"18.2";"5";"5";"5";"0";"0";"457178";"373889"
"V4mis1";"SILVA (only NR);Bacteria;Firmicutes;Bacilli;Acholeplasmatales;Acholeplasmataceae;NED5E9;";"100.0";"18.2";"3";"3";"3";"0";"0";"457180";"373891"
"V4mis1";"SILVA (only NR);Bacteria;Firmicutes;Bacilli;Acholeplasmatales;Acholeplasmataceae;T2WK15B57;";"100.0";"18.2";"2";"2";"2";"0";"0";"457181";"373892"
"V4mis1";"SILVA (only NR);Bacteria;Firmicutes;Bacilli;Alicyclobacillales;";"94.2";"18.2";"327";"327";"308";"19";"0";"456856";"373586"
"V4mis1";"SILVA (only NR);Bacteria;Firmicutes;Bacilli;Alicyclobacillales;Alicyclobacillaceae;";"94.2";"18.2";"327";"327";"308";"19";"0";"456856";"373586"
"V4mis1";"SILVA (only NR);Bacteria;Firmicutes;Bacilli;Alicyclobacillales;Alicyclobacillaceae;Acidibacillus;";"94.4";"18.2";"36";"36";"34";"2";"0";"457147";"373860"
"V4mis1";"SILVA (only NR);Bacteria;Firmicutes;Bacilli;Alicyclobacillales;Alicyclobacillaceae;Alicyclobacillus;";"96.9";"18.2";"161";"161";"156";"5";"0";"457022";"373738"
"V4mis1";"SILVA (only NR);Bacteria;Firmicutes;Bacilli;Alicyclobacillales;Alicyclobacillaceae;Effusibacillus;";"100.0";"18.2";"23";"23";"23";"0";"0";"457160";"373871"
"V4mis1";"SILVA (only NR);Bacteria;Firmicutes;Bacilli;Alicyclobacillales;Alicyclobacillaceae;Tumebacillus;";"88.8";"18.2";"107";"107";"95";"12";"0";"457076";"373799"
"V4mis1";"SILVA (only NR);Bacteria;Firmicutes;Bacilli;Aneurinibacillales;";"94.0";"18.2";"67";"67";"63";"4";"0";"457116";"373831"
"V4mis1";"SILVA (only NR);Bacteria;Firmicutes;Bacilli;Aneurinibacillales;Aneurinibacillaceae;";"94.0";"18.2";"67";"67";"63";"4";"0";"457116";"373831"
"V4mis1";"SILVA (only NR);Bacteria;Firmicutes;Bacilli;Aneurinibacillales;Aneurinibacillaceae;Aneurinibacillus;";"94.0";"18.2";"67";"67";"63";"4";"0";"457116";"373831"
"V4mis1";"SILVA (only NR);Bacteria;Firmicutes;Bacilli;Bacillales;";"88.9";"18.5";"15844";"15844";"14092";"1752";"0";"441339";"359802"
"V4mis1";"SILVA (only NR);Bacteria;Firmicutes;Bacilli;Bacillales;Bacillaceae;";"88.3";"18.4";"13753";"13753";"12148";"1605";"0";"443430";"361746"
"V4mis1";"SILVA (only NR);Bacteria;Firmicutes;Bacilli;Bacillales;Bacillaceae;Aeribacillus;";"92.2";"18.2";"51";"51";"47";"4";"0";"457132";"373847"
"V4mis1";"SILVA (only NR);Bacteria;Firmicutes;Bacilli;Bacillales;Bacillaceae;Alkalibacillus;";"88.2";"18.2";"17";"17";"15";"2";"0";"457166";"373879"
"V4mis1";"SILVA (only NR);Bacteria;Firmicutes;Bacilli;Bacillales;Bacillaceae;Allobacillus;";"71.4";"18.2";"7";"7";"5";"2";"0";"457176";"373889"
"V4mis1";"SILVA (only NR);Bacteria;Firmicutes;Bacilli;Bacillales;Bacillaceae;Amphibacillus;";"95.5";"18.2";"22";"22";"21";"1";"0";"457161";"373873"
"V4mis1";"SILVA (only NR);Bacteria;Firmicutes;Bacilli;Bacillales;Bacillaceae;Anaerobacillus;";"81.4";"18.2";"43";"43";"35";"8";"0";"457140";"373859"
"V4mis1";"SILVA (only NR);Bacteria;Firmicutes;Bacilli;Bacillales;Bacillaceae;Anoxybacillus;";"78.5";"18.2";"753";"753";"591";"162";"0";"456430";"373303"
"V4mis1";"SILVA (only NR);Bacteria;Firmicutes;Bacilli;Bacillales;Bacillaceae;Aquibacillus;";"75.0";"18.2";"8";"8";"6";"2";"0";"457175";"373888"
"V4mis1";"SILVA (only NR);Bacteria;Firmicutes;Bacilli;Bacillales;Bacillaceae;Aquisalibacillus;";"66.7";"18.2";"3";"3";"2";"1";"0";"457180";"373892"
"V4mis1";"SILVA (only NR);Bacteria;Firmicutes;Bacilli;Bacillales;Bacillaceae;Aureibacillus;";"100.0";"18.2";"4";"4";"4";"0";"0";"457179";"373890"
"V4mis1";"SILVA (only NR);Bacteria;Firmicutes;Bacilli;Bacillales;Bacillaceae;Bacillus;";"88.5";"18.4";"11146";"11146";"9860";"1286";"0";"446037";"364034"
"V4mis1";"SILVA (only NR);Bacteria;Firmicutes;Bacilli;Bacillales;Bacillaceae;Caldibacillus;";"93.3";"18.2";"15";"15";"14";"1";"0";"457168";"373880"
"V4mis1";"SILVA (only NR);Bacteria;Firmicutes;Bacilli;Bacillales;Bacillaceae;Calditerricola;";"100.0";"18.2";"4";"4";"4";"0";"0";"457179";"373890"
"V4mis1";"SILVA (only NR);Bacteria;Firmicutes;Bacilli;Bacillales;Bacillaceae;Cerasibacillus;";"62.5";"18.2";"8";"8";"5";"3";"0";"457175";"373889"
"V4mis1";"SILVA (only NR);Bacteria;Firmicutes;Bacilli;Bacillales;Bacillaceae;Falsibacillus;";"100.0";"18.2";"2";"2";"2";"0";"0";"457181";"373892"
"V4mis1";"SILVA (only NR);Bacteria;Firmicutes;Bacilli;Bacillales;Bacillaceae;Fictibacillus;";"89.5";"18.2";"86";"86";"77";"9";"0";"457097";"373817"
"V4mis1";"SILVA (only NR);Bacteria;Firmicutes;Bacilli;Bacillales;Bacillaceae;Filobacillus;";"100.0";"18.2";"2";"2";"2";"0";"0";"457181";"373892"
"V4mis1";"SILVA (only NR);Bacteria;Firmicutes;Bacilli;Bacillales;Bacillaceae;Geobacillus;";"87.4";"18.2";"595";"595";"520";"75";"0";"456588";"373374"
"V4mis1";"SILVA (only NR);Bacteria;Firmicutes;Bacilli;Bacillales;Bacillaceae;Gracilibacillus;";"89.6";"18.2";"48";"48";"43";"5";"0";"457135";"373851"
"V4mis1";"SILVA (only NR);Bacteria;Firmicutes;Bacilli;Bacillales;Bacillaceae;Halalkalibacillus;";"100.0";"18.2";"3";"3";"3";"0";"0";"457180";"373891"
"V4mis1";"SILVA (only NR);Bacteria;Firmicutes;Bacilli;Bacillales;Bacillaceae;Halobacillus;";"93.9";"18.2";"164";"164";"154";"10";"0";"457019";"373740"
"V4mis1";"SILVA (only NR);Bacteria;Firmicutes;Bacilli;Bacillales;Bacillaceae;Halolactibacillus;";"100.0";"18.2";"33";"33";"33";"0";"0";"457150";"373861"
"V4mis1";"SILVA (only NR);Bacteria;Firmicutes;Bacilli;Bacillales;Bacillaceae;Lentibacillus;";"100.0";"18.2";"21";"21";"21";"0";"0";"457162";"373873"
"V4mis1";"SILVA (only NR);Bacteria;Firmicutes;Bacilli;Bacillales;Bacillaceae;Microaerobacter;";"100.0";"18.2";"1";"1";"1";"0";"0";"457182";"373893"
"V4mis1";"SILVA (only NR);Bacteria;Firmicutes;Bacilli;Bacillales;Bacillaceae;Natronobacillus;";"100.0";"18.2";"1";"1";"1";"0";"0";"457182";"373893"
"V4mis1";"SILVA (only NR);Bacteria;Firmicutes;Bacilli;Bacillales;Bacillaceae;Oceanobacillus;";"93.4";"18.2";"198";"198";"185";"13";"0";"456985";"373709"
"V4mis1";"SILVA (only NR);Bacteria;Firmicutes;Bacilli;Bacillales;Bacillaceae;Ornithinibacillus;";"95.7";"18.2";"23";"23";"22";"1";"0";"457160";"373872"
"V4mis1";"SILVA (only NR);Bacteria;Firmicutes;Bacilli;Bacillales;Bacillaceae;Paraliobacillus;";"100.0";"18.2";"18";"18";"18";"0";"0";"457165";"373876"
"V4mis1";"SILVA (only NR);Bacteria;Firmicutes;Bacilli;Bacillales;Bacillaceae;Paucisalibacillus;";"90.0";"18.2";"10";"10";"9";"1";"0";"457173";"373885"
"V4mis1";"SILVA (only NR);Bacteria;Firmicutes;Bacilli;Bacillales;Bacillaceae;Pelagirhabdus;";"100.0";"18.2";"3";"3";"3";"0";"0";"457180";"373891"
"V4mis1";"SILVA (only NR);Bacteria;Firmicutes;Bacilli;Bacillales;Bacillaceae;Piscibacillus;";"100.0";"18.2";"11";"11";"11";"0";"0";"457172";"373883"
"V4mis1";"SILVA (only NR);Bacteria;Firmicutes;Bacilli;Bacillales;Bacillaceae;Pontibacillus;";"96.3";"18.2";"27";"27";"26";"1";"0";"457156";"373868"
"V4mis1";"SILVA (only NR);Bacteria;Firmicutes;Bacilli;Bacillales;Bacillaceae;Pseudogracilibacillus;";"100.0";"18.2";"18";"18";"18";"0";"0";"457165";"373876"
"V4mis1";"SILVA (only NR);Bacteria;Firmicutes;Bacilli;Bacillales;Bacillaceae;Saccharococcus;";"100.0";"18.2";"2";"2";"2";"0";"0";"457181";"373892"
"V4mis1";"SILVA (only NR);Bacteria;Firmicutes;Bacilli;Bacillales;Bacillaceae;Salimicrobium;";"96.2";"18.2";"26";"26";"25";"1";"0";"457157";"373869"
"V4mis1";"SILVA (only NR);Bacteria;Firmicutes;Bacilli;Bacillales;Bacillaceae;Salinibacillus;";"100.0";"18.2";"4";"4";"4";"0";"0";"457179";"373890"
"V4mis1";"SILVA (only NR);Bacteria;Firmicutes;Bacilli;Bacillales;Bacillaceae;Salirhabdus;";"83.3";"18.2";"6";"6";"5";"1";"0";"457177";"373889"
"V4mis1";"SILVA (only NR);Bacteria;Firmicutes;Bacilli;Bacillales;Bacillaceae;Saliterribacillus;";"100.0";"18.2";"3";"3";"3";"0";"0";"457180";"373891"
"V4mis1";"SILVA (only NR);Bacteria;Firmicutes;Bacilli;Bacillales;Bacillaceae;Sediminibacillus;";"100.0";"18.2";"7";"7";"7";"0";"0";"457176";"373887"
"V4mis1";"SILVA (only NR);Bacteria;Firmicutes;Bacilli;Bacillales;Bacillaceae;Sinibacillus;";"100.0";"18.2";"4";"4";"4";"0";"0";"457179";"373890"
"V4mis1";"SILVA (only NR);Bacteria;Firmicutes;Bacilli;Bacillales;Bacillaceae;Streptohalobacillus;";"100.0";"18.2";"1";"1";"1";"0";"0";"457182";"373893"
"V4mis1";"SILVA (only NR);Bacteria;Firmicutes;Bacilli;Bacillales;Bacillaceae;Tenuibacillus;";"100.0";"18.2";"3";"3";"3";"0";"0";"457180";"373891"
"V4mis1";"SILVA (only NR);Bacteria;Firmicutes;Bacilli;Bacillales;Bacillaceae;Tepidibacillus;";"100.0";"18.2";"6";"6";"6";"0";"0";"457177";"373888"
"V4mis1";"SILVA (only NR);Bacteria;Firmicutes;Bacilli;Bacillales;Bacillaceae;Terribacillus;";"95.5";"18.2";"22";"22";"21";"1";"0";"457161";"373873"
"V4mis1";"SILVA (only NR);Bacteria;Firmicutes;Bacilli;Bacillales;Bacillaceae;Thalassobacillus;";"94.7";"18.2";"19";"19";"18";"1";"0";"457164";"373876"
"V4mis1";"SILVA (only NR);Bacteria;Firmicutes;Bacilli;Bacillales;Bacillaceae;Thermolongibacillus;";"0.0";"0";"2";"2";"0";"2";"0";"457181";"373894"
"V4mis1";"SILVA (only NR);Bacteria;Firmicutes;Bacilli;Bacillales;Bacillaceae;Ureibacillus;";"92.9";"18.2";"28";"28";"26";"2";"0";"457155";"373868"
"V4mis1";"SILVA (only NR);Bacteria;Firmicutes;Bacilli;Bacillales;Bacillaceae;Virgibacillus;";"95.9";"18.2";"172";"172";"165";"7";"0";"457011";"373729"
"V4mis1";"SILVA (only NR);Bacteria;Firmicutes;Bacilli;Bacillales;Bacillaceae;Vulcanibacillus;";"93.8";"18.2";"16";"16";"15";"1";"0";"457167";"373879"
"V4mis1";"SILVA (only NR);Bacteria;Firmicutes;Bacilli;Bacillales;Bacillaceae;uncultured;";"96.8";"18.2";"62";"62";"60";"2";"0";"457121";"373834"
"V4mis1";"SILVA (only NR);Bacteria;Firmicutes;Bacilli;Bacillales;Marinococcaceae;";"90.5";"18.2";"105";"105";"95";"10";"0";"457078";"373799"
"V4mis1";"SILVA (only NR);Bacteria;Firmicutes;Bacilli;Bacillales;Marinococcaceae;Alteribacillus;";"95.0";"18.2";"20";"20";"19";"1";"0";"457163";"373875"
"V4mis1";"SILVA (only NR);Bacteria;Firmicutes;Bacilli;Bacillales;Marinococcaceae;Geomicrobium;";"77.8";"18.2";"9";"9";"7";"2";"0";"457174";"373887"
"V4mis1";"SILVA (only NR);Bacteria;Firmicutes;Bacilli;Bacillales;Marinococcaceae;Marinococcus;";"89.4";"18.2";"47";"47";"42";"5";"0";"457136";"373852"
"V4mis1";"SILVA (only NR);Bacteria;Firmicutes;Bacilli;Bacillales;Marinococcaceae;Natribacillus;";"100.0";"18.2";"5";"5";"5";"0";"0";"457178";"373889"
"V4mis1";"SILVA (only NR);Bacteria;Firmicutes;Bacilli;Bacillales;Marinococcaceae;Salibacterium;";"100.0";"18.2";"11";"11";"11";"0";"0";"457172";"373883"
"V4mis1";"SILVA (only NR);Bacteria;Firmicutes;Bacilli;Bacillales;Marinococcaceae;Salsuginibacillus;";"100.0";"18.2";"5";"5";"5";"0";"0";"457178";"373889"
"V4mis1";"SILVA (only NR);Bacteria;Firmicutes;Bacilli;Bacillales;Marinococcaceae;Sinobaca;";"75.0";"18.2";"4";"4";"3";"1";"0";"457179";"373891"
"V4mis1";"SILVA (only NR);Bacteria;Firmicutes;Bacilli;Bacillales;Planococcaceae;";"93.0";"18.3";"1802";"1802";"1675";"127";"0";"455381";"372219"
"V4mis1";"SILVA (only NR);Bacteria;Firmicutes;Bacilli;Bacillales;Planococcaceae;Bhargavaea;";"90.0";"18.2";"30";"30";"27";"3";"0";"457153";"373867"
"V4mis1";"SILVA (only NR);Bacteria;Firmicutes;Bacilli;Bacillales;Planococcaceae;Caryophanon;";"100.0";"18.2";"9";"9";"9";"0";"0";"457174";"373885"
"V4mis1";"SILVA (only NR);Bacteria;Firmicutes;Bacilli;Bacillales;Planococcaceae;Chryseomicrobium;";"88.9";"18.2";"27";"27";"24";"3";"0";"457156";"373870"
"V4mis1";"SILVA (only NR);Bacteria;Firmicutes;Bacilli;Bacillales;Planococcaceae;Chungangia;";"100.0";"18.2";"6";"6";"6";"0";"0";"457177";"373888"
"V4mis1";"SILVA (only NR);Bacteria;Firmicutes;Bacilli;Bacillales;Planococcaceae;Domibacillus;";"95.2";"18.2";"42";"42";"40";"2";"0";"457141";"373854"
"V4mis1";"SILVA (only NR);Bacteria;Firmicutes;Bacilli;Bacillales;Planococcaceae;Filibacter;";"100.0";"18.2";"3";"3";"3";"0";"0";"457180";"373891"
"V4mis1";"SILVA (only NR);Bacteria;Firmicutes;Bacilli;Bacillales;Planococcaceae;Jeotgalibacillus;";"100.0";"18.2";"31";"31";"31";"0";"0";"457152";"373863"
"V4mis1";"SILVA (only NR);Bacteria;Firmicutes;Bacilli;Bacillales;Planococcaceae;Kurthia;";"100.0";"18.2";"55";"55";"55";"0";"0";"457128";"373839"
"V4mis1";"SILVA (only NR);Bacteria;Firmicutes;Bacilli;Bacillales;Planococcaceae;Lysinibacillus;";"89.8";"18.2";"709";"709";"637";"72";"0";"456474";"373257"
"V4mis1";"SILVA (only NR);Bacteria;Firmicutes;Bacilli;Bacillales;Planococcaceae;Paenisporosarcina;";"97.9";"18.2";"47";"47";"46";"1";"0";"457136";"373848"
"V4mis1";"SILVA (only NR);Bacteria;Firmicutes;Bacilli;Bacillales;Planococcaceae;Planococcus;";"91.0";"18.2";"199";"199";"181";"18";"0";"456984";"373713"
"V4mis1";"SILVA (only NR);Bacteria;Firmicutes;Bacilli;Bacillales;Planococcaceae;Planomicrobium;";"95.3";"18.2";"128";"128";"122";"6";"0";"457055";"373772"
"V4mis1";"SILVA (only NR);Bacteria;Firmicutes;Bacilli;Bacillales;Planococcaceae;Psychrobacillus;";"89.1";"18.2";"64";"64";"57";"7";"0";"457119";"373837"
"V4mis1";"SILVA (only NR);Bacteria;Firmicutes;Bacilli;Bacillales;Planococcaceae;Rummeliibacillus;";"96.8";"18.2";"31";"31";"30";"1";"0";"457152";"373864"
"V4mis1";"SILVA (only NR);Bacteria;Firmicutes;Bacilli;Bacillales;Planococcaceae;Savagea;";"66.7";"18.2";"3";"3";"2";"1";"0";"457180";"373892"
"V4mis1";"SILVA (only NR);Bacteria;Firmicutes;Bacilli;Bacillales;Planococcaceae;Solibacillus;";"95.5";"18.2";"132";"132";"126";"6";"0";"457051";"373768"
"V4mis1";"SILVA (only NR);Bacteria;Firmicutes;Bacilli;Bacillales;Planococcaceae;Sporosarcina;";"98.0";"18.2";"204";"204";"200";"4";"0";"456979";"373694"
"V4mis1";"SILVA (only NR);Bacteria;Firmicutes;Bacilli;Bacillales;Planococcaceae;Viridibacillus;";"100.0";"18.2";"9";"9";"9";"0";"0";"457174";"373885"
"V4mis1";"SILVA (only NR);Bacteria;Firmicutes;Bacilli;Bacillales;Planococcaceae;[Renibacterium] salmoninarum group;";"100.0";"18.2";"2";"2";"2";"0";"0";"457181";"373892"
"V4mis1";"SILVA (only NR);Bacteria;Firmicutes;Bacilli;Bacillales;Planococcaceae;uncultured;";"95.2";"18.2";"62";"62";"59";"3";"0";"457121";"373835"
"V4mis1";"SILVA (only NR);Bacteria;Firmicutes;Bacilli;Bacillales;Salisediminibacteriaceae;";"93.4";"18.2";"91";"91";"85";"6";"0";"457092";"373809"
"V4mis1";"SILVA (only NR);Bacteria;Firmicutes;Bacilli;Bacillales;Salisediminibacteriaceae;Alkalicoccus;";"100.0";"18.2";"13";"13";"13";"0";"0";"457170";"373881"
"V4mis1";"SILVA (only NR);Bacteria;Firmicutes;Bacilli;Bacillales;Salisediminibacteriaceae;Salipaludibacillus;";"91.3";"18.2";"69";"69";"63";"6";"0";"457114";"373831"
"V4mis1";"SILVA (only NR);Bacteria;Firmicutes;Bacilli;Bacillales;Salisediminibacteriaceae;Salisediminibacterium;";"100.0";"18.2";"7";"7";"7";"0";"0";"457176";"373887"
"V4mis1";"SILVA (only NR);Bacteria;Firmicutes;Bacilli;Bacillales;Salisediminibacteriaceae;Texcoconibacillus;";"100.0";"18.2";"2";"2";"2";"0";"0";"457181";"373892"
"V4mis1";"SILVA (only NR);Bacteria;Firmicutes;Bacilli;Bacillales;Sporolactobacillaceae;";"95.7";"18.2";"93";"93";"89";"4";"0";"457090";"373805"
"V4mis1";"SILVA (only NR);Bacteria;Firmicutes;Bacilli;Bacillales;Sporolactobacillaceae;Pullulanibacillus;";"100.0";"18.2";"12";"12";"12";"0";"0";"457171";"373882"
"V4mis1";"SILVA (only NR);Bacteria;Firmicutes;Bacilli;Bacillales;Sporolactobacillaceae;Scopulibacillus;";"100.0";"18.2";"4";"4";"4";"0";"0";"457179";"373890"
"V4mis1";"SILVA (only NR);Bacteria;Firmicutes;Bacilli;Bacillales;Sporolactobacillaceae;Sporolactobacillus;";"94.0";"18.2";"67";"67";"63";"4";"0";"457116";"373831"
"V4mis1";"SILVA (only NR);Bacteria;Firmicutes;Bacilli;Bacillales;Sporolactobacillaceae;Terrilactibacillus;";"100.0";"18.2";"3";"3";"3";"0";"0";"457180";"373891"
"V4mis1";"SILVA (only NR);Bacteria;Firmicutes;Bacilli;Bacillales;Sporolactobacillaceae;Tuberibacillus;";"100.0";"18.2";"5";"5";"5";"0";"0";"457178";"373889"
"V4mis1";"SILVA (only NR);Bacteria;Firmicutes;Bacilli;Bacillales;Sporolactobacillaceae;uncultured;";"100.0";"18.2";"2";"2";"2";"0";"0";"457181";"373892"
"V4mis1";"SILVA (only NR);Bacteria;Firmicutes;Bacilli;Brevibacillales;";"92.1";"18.2";"405";"405";"373";"32";"0";"456778";"373521"
"V4mis1";"SILVA (only NR);Bacteria;Firmicutes;Bacilli;Brevibacillales;Brevibacillaceae;";"92.1";"18.2";"405";"405";"373";"32";"0";"456778";"373521"
"V4mis1";"SILVA (only NR);Bacteria;Firmicutes;Bacilli;Brevibacillales;Brevibacillaceae;Brevibacillus;";"92.1";"18.2";"405";"405";"373";"32";"0";"456778";"373521"
"V4mis1";"SILVA (only NR);Bacteria;Firmicutes;Bacilli;Caldalkalibacillales;";"100.0";"18.2";"7";"7";"7";"0";"0";"457176";"373887"
"V4mis1";"SILVA (only NR);Bacteria;Firmicutes;Bacilli;Caldalkalibacillales;Caldalkalibacillaceae;";"100.0";"18.2";"7";"7";"7";"0";"0";"457176";"373887"
"V4mis1";"SILVA (only NR);Bacteria;Firmicutes;Bacilli;Caldalkalibacillales;Caldalkalibacillaceae;Caldalkalibacillus;";"100.0";"18.2";"7";"7";"7";"0";"0";"457176";"373887"
"V4mis1";"SILVA (only NR);Bacteria;Firmicutes;Bacilli;Desulfuribacillales;";"90.9";"18.2";"11";"11";"10";"1";"0";"457172";"373884"
"V4mis1";"SILVA (only NR);Bacteria;Firmicutes;Bacilli;Desulfuribacillales;Desulfuribacillaceae;";"90.9";"18.2";"11";"11";"10";"1";"0";"457172";"373884"
"V4mis1";"SILVA (only NR);Bacteria;Firmicutes;Bacilli;Desulfuribacillales;Desulfuribacillaceae;Desulfuribacillus;";"90.9";"18.2";"11";"11";"10";"1";"0";"457172";"373884"
"V4mis1";"SILVA (only NR);Bacteria;Firmicutes;Bacilli;Entomoplasmatales;";"96.7";"18.2";"307";"307";"297";"10";"0";"456876";"373597"
"V4mis1";"SILVA (only NR);Bacteria;Firmicutes;Bacilli;Entomoplasmatales;Candidatus Spiroplasma;";"28.6";"18.2";"7";"7";"2";"5";"0";"457176";"373892"
"V4mis1";"SILVA (only NR);Bacteria;Firmicutes;Bacilli;Entomoplasmatales;Entomoplasmataceae;";"99.0";"18.2";"101";"101";"100";"1";"0";"457082";"373794"
"V4mis1";"SILVA (only NR);Bacteria;Firmicutes;Bacilli;Entomoplasmatales;Entomoplasmataceae;Entomoplasma;";"100.0";"18.2";"11";"11";"11";"0";"0";"457172";"373883"
"V4mis1";"SILVA (only NR);Bacteria;Firmicutes;Bacilli;Entomoplasmatales;Entomoplasmataceae;Mesoplasma;";"97.9";"18.2";"48";"48";"47";"1";"0";"457135";"373847"
"V4mis1";"SILVA (only NR);Bacteria;Firmicutes;Bacilli;Entomoplasmatales;Entomoplasmataceae;[Mycoplasma] group;";"100.0";"18.2";"42";"42";"42";"0";"0";"457141";"373852"
"V4mis1";"SILVA (only NR);Bacteria;Firmicutes;Bacilli;Entomoplasmatales;Entomoplasmatales Incertae Sedis;";"97.1";"18.2";"34";"34";"33";"1";"0";"457149";"373861"
"V4mis1";"SILVA (only NR);Bacteria;Firmicutes;Bacilli;Entomoplasmatales;Entomoplasmatales Incertae Sedis;Candidatus Hepatoplasma;";"97.1";"18.2";"34";"34";"33";"1";"0";"457149";"373861"
"V4mis1";"SILVA (only NR);Bacteria;Firmicutes;Bacilli;Entomoplasmatales;Spiroplasmataceae;";"98.1";"18.2";"154";"154";"151";"3";"0";"457029";"373743"
"V4mis1";"SILVA (only NR);Bacteria;Firmicutes;Bacilli;Entomoplasmatales;Spiroplasmataceae;Spiroplasma;";"98.1";"18.2";"154";"154";"151";"3";"0";"457029";"373743"
"V4mis1";"SILVA (only NR);Bacteria;Firmicutes;Bacilli;Entomoplasmatales;type III;";"100.0";"18.2";"11";"11";"11";"0";"0";"457172";"373883"
"V4mis1";"SILVA (only NR);Bacteria;Firmicutes;Bacilli;Erysipelotrichales;";"93.2";"18.3";"2343";"2343";"2184";"159";"0";"454840";"371710"
"V4mis1";"SILVA (only NR);Bacteria;Firmicutes;Bacilli;Erysipelotrichales;Erysipelatoclostridiaceae;";"93.7";"18.2";"743";"743";"696";"47";"0";"456440";"373198"
"V4mis1";"SILVA (only NR);Bacteria;Firmicutes;Bacilli;Erysipelotrichales;Erysipelatoclostridiaceae;Asteroleplasma;";"77.8";"18.2";"18";"18";"14";"4";"0";"457165";"373880"
"V4mis1";"SILVA (only NR);Bacteria;Firmicutes;Bacilli;Erysipelotrichales;Erysipelatoclostridiaceae;Candidatus Stoquefichus;";"92.5";"18.2";"40";"40";"37";"3";"0";"457143";"373857"
"V4mis1";"SILVA (only NR);Bacteria;Firmicutes;Bacilli;Erysipelotrichales;Erysipelatoclostridiaceae;Catenibacterium;";"93.8";"18.2";"130";"130";"122";"8";"0";"457053";"373772"
"V4mis1";"SILVA (only NR);Bacteria;Firmicutes;Bacilli;Erysipelotrichales;Erysipelatoclostridiaceae;Coprobacillus;";"100.0";"18.2";"10";"10";"10";"0";"0";"457173";"373884"
"V4mis1";"SILVA (only NR);Bacteria;Firmicutes;Bacilli;Erysipelotrichales;Erysipelatoclostridiaceae;Eggerthia;";"100.0";"18.2";"10";"10";"10";"0";"0";"457173";"373884"
"V4mis1";"SILVA (only NR);Bacteria;Firmicutes;Bacilli;Erysipelotrichales;Erysipelatoclostridiaceae;Erysipelatoclostridium;";"93.0";"18.2";"158";"158";"147";"11";"0";"457025";"373747"
"V4mis1";"SILVA (only NR);Bacteria;Firmicutes;Bacilli;Erysipelotrichales;Erysipelatoclostridiaceae;Erysipelotrichaceae UCG-002;";"92.5";"18.2";"40";"40";"37";"3";"0";"457143";"373857"
"V4mis1";"SILVA (only NR);Bacteria;Firmicutes;Bacilli;Erysipelotrichales;Erysipelatoclostridiaceae;Erysipelotrichaceae UCG-003;";"93.2";"18.2";"118";"118";"110";"8";"0";"457065";"373784"
"V4mis1";"SILVA (only NR);Bacteria;Firmicutes;Bacilli;Erysipelotrichales;Erysipelatoclostridiaceae;Kandleria;";"100.0";"18.2";"2";"2";"2";"0";"0";"457181";"373892"
"V4mis1";"SILVA (only NR);Bacteria;Firmicutes;Bacilli;Erysipelotrichales;Erysipelatoclostridiaceae;Sharpea;";"100.0";"18.2";"7";"7";"7";"0";"0";"457176";"373887"
"V4mis1";"SILVA (only NR);Bacteria;Firmicutes;Bacilli;Erysipelotrichales;Erysipelatoclostridiaceae;UCG-004;";"94.7";"18.2";"187";"187";"177";"10";"0";"456996";"373717"
"V4mis1";"SILVA (only NR);Bacteria;Firmicutes;Bacilli;Erysipelotrichales;Erysipelatoclostridiaceae;uncultured;";"100.0";"18.2";"17";"17";"17";"0";"0";"457166";"373877"
"V4mis1";"SILVA (only NR);Bacteria;Firmicutes;Bacilli;Erysipelotrichales;Erysipelotrichaceae;";"93.1";"18.3";"1589";"1589";"1479";"110";"0";"455594";"372415"
"V4mis1";"SILVA (only NR);Bacteria;Firmicutes;Bacilli;Erysipelotrichales;Erysipelotrichaceae;Allobaculum;";"100.0";"18.2";"16";"16";"16";"0";"0";"457167";"373878"
"V4mis1";"SILVA (only NR);Bacteria;Firmicutes;Bacilli;Erysipelotrichales;Erysipelotrichaceae;Breznakia;";"100.0";"18.2";"10";"10";"10";"0";"0";"457173";"373884"
"V4mis1";"SILVA (only NR);Bacteria;Firmicutes;Bacilli;Erysipelotrichales;Erysipelotrichaceae;Bulleidia;";"100.0";"18.2";"4";"4";"4";"0";"0";"457179";"373890"
"V4mis1";"SILVA (only NR);Bacteria;Firmicutes;Bacilli;Erysipelotrichales;Erysipelotrichaceae;Catenisphaera;";"100.0";"18.2";"21";"21";"21";"0";"0";"457162";"373873"
"V4mis1";"SILVA (only NR);Bacteria;Firmicutes;Bacilli;Erysipelotrichales;Erysipelotrichaceae;Dielma;";"96.2";"18.2";"26";"26";"25";"1";"0";"457157";"373869"
"V4mis1";"SILVA (only NR);Bacteria;Firmicutes;Bacilli;Erysipelotrichales;Erysipelotrichaceae;Dubosiella;";"97.3";"18.2";"73";"73";"71";"2";"0";"457110";"373823"
"V4mis1";"SILVA (only NR);Bacteria;Firmicutes;Bacilli;Erysipelotrichales;Erysipelotrichaceae;Erysipelothrix;";"96.8";"18.2";"190";"190";"184";"6";"0";"456993";"373710"
"V4mis1";"SILVA (only NR);Bacteria;Firmicutes;Bacilli;Erysipelotrichales;Erysipelotrichaceae;Erysipelotrichaceae UCG-006;";"94.1";"18.2";"17";"17";"16";"1";"0";"457166";"373878"
"V4mis1";"SILVA (only NR);Bacteria;Firmicutes;Bacilli;Erysipelotrichales;Erysipelotrichaceae;Erysipelotrichaceae UCG-007;";"55.6";"18.2";"18";"18";"10";"8";"0";"457165";"373884"
"V4mis1";"SILVA (only NR);Bacteria;Firmicutes;Bacilli;Erysipelotrichales;Erysipelotrichaceae;Erysipelotrichaceae UCG-008;";"100.0";"18.2";"2";"2";"2";"0";"0";"457181";"373892"
"V4mis1";"SILVA (only NR);Bacteria;Firmicutes;Bacilli;Erysipelotrichales;Erysipelotrichaceae;Erysipelotrichaceae UCG-009;";"100.0";"18.2";"14";"14";"14";"0";"0";"457169";"373880"
"V4mis1";"SILVA (only NR);Bacteria;Firmicutes;Bacilli;Erysipelotrichales;Erysipelotrichaceae;Faecalibaculum;";"92.5";"18.2";"424";"424";"392";"32";"0";"456759";"373502"
"V4mis1";"SILVA (only NR);Bacteria;Firmicutes;Bacilli;Erysipelotrichales;Erysipelotrichaceae;Faecalicoccus;";"100.0";"18.2";"5";"5";"5";"0";"0";"457178";"373889"
"V4mis1";"SILVA (only NR);Bacteria;Firmicutes;Bacilli;Erysipelotrichales;Erysipelotrichaceae;Faecalitalea;";"95.8";"18.2";"48";"48";"46";"2";"0";"457135";"373848"
"V4mis1";"SILVA (only NR);Bacteria;Firmicutes;Bacilli;Erysipelotrichales;Erysipelotrichaceae;Holdemanella;";"92.3";"18.2";"182";"182";"168";"14";"0";"457001";"373726"
"V4mis1";"SILVA (only NR);Bacteria;Firmicutes;Bacilli;Erysipelotrichales;Erysipelotrichaceae;Holdemania;";"85.7";"18.2";"7";"7";"6";"1";"0";"457176";"373888"
"V4mis1";"SILVA (only NR);Bacteria;Firmicutes;Bacilli;Erysipelotrichales;Erysipelotrichaceae;Ileibacterium;";"100.0";"18.2";"7";"7";"7";"0";"0";"457176";"373887"
"V4mis1";"SILVA (only NR);Bacteria;Firmicutes;Bacilli;Erysipelotrichales;Erysipelotrichaceae;Merdibacter;";"100.0";"18.2";"5";"5";"5";"0";"0";"457178";"373889"
"V4mis1";"SILVA (only NR);Bacteria;Firmicutes;Bacilli;Erysipelotrichales;Erysipelotrichaceae;Solobacterium;";"97.8";"18.2";"89";"89";"87";"2";"0";"457094";"373807"
"V4mis1";"SILVA (only NR);Bacteria;Firmicutes;Bacilli;Erysipelotrichales;Erysipelotrichaceae;Turicibacter;";"90.3";"18.2";"144";"144";"130";"14";"0";"457039";"373764"
"V4mis1";"SILVA (only NR);Bacteria;Firmicutes;Bacilli;Erysipelotrichales;Erysipelotrichaceae;ZOR0006;";"100.0";"18.2";"40";"40";"40";"0";"0";"457143";"373854"
"V4mis1";"SILVA (only NR);Bacteria;Firmicutes;Bacilli;Erysipelotrichales;Erysipelotrichaceae;[Anaerorhabdus] furcosa group;";"97.7";"18.2";"44";"44";"43";"1";"0";"457139";"373851"
"V4mis1";"SILVA (only NR);Bacteria;Firmicutes;Bacilli;Erysipelotrichales;Erysipelotrichaceae;[Clostridium] innocuum group;";"80.0";"18.2";"105";"105";"84";"21";"0";"457078";"373810"
"V4mis1";"SILVA (only NR);Bacteria;Firmicutes;Bacilli;Erysipelotrichales;Erysipelotrichaceae;uncultured;";"95.8";"18.2";"95";"95";"91";"4";"0";"457088";"373803"
"V4mis1";"SILVA (only NR);Bacteria;Firmicutes;Bacilli;Erysipelotrichales;uncultured;";"81.8";"18.2";"11";"11";"9";"2";"0";"457172";"373885"
"V4mis1";"SILVA (only NR);Bacteria;Firmicutes;Bacilli;Exiguobacterales;";"85.5";"18.2";"317";"317";"271";"46";"0";"456866";"373623"
"V4mis1";"SILVA (only NR);Bacteria;Firmicutes;Bacilli;Exiguobacterales;Exiguobacteraceae;";"85.5";"18.2";"317";"317";"271";"46";"0";"456866";"373623"
"V4mis1";"SILVA (only NR);Bacteria;Firmicutes;Bacilli;Exiguobacterales;Exiguobacteraceae;Exiguobacterium;";"85.5";"18.2";"317";"317";"271";"46";"0";"456866";"373623"
"V4mis1";"SILVA (only NR);Bacteria;Firmicutes;Bacilli;Haloplasmatales;";"92.9";"18.2";"28";"28";"26";"2";"0";"457155";"373868"
"V4mis1";"SILVA (only NR);Bacteria;Firmicutes;Bacilli;Haloplasmatales;Haloplasmataceae;";"92.9";"18.2";"28";"28";"26";"2";"0";"457155";"373868"
"V4mis1";"SILVA (only NR);Bacteria;Firmicutes;Bacilli;Haloplasmatales;Haloplasmataceae;Haloplasma;";"92.9";"18.2";"28";"28";"26";"2";"0";"457155";"373868"
"V4mis1";"SILVA (only NR);Bacteria;Firmicutes;Bacilli;Izemoplasmatales;";"91.6";"18.2";"107";"107";"98";"9";"0";"457076";"373796"
"V4mis1";"SILVA (only NR);Bacteria;Firmicutes;Bacilli;Izemoplasmatales;Izemoplasmataceae;";"86.8";"18.2";"38";"38";"33";"5";"0";"457145";"373861"
"V4mis1";"SILVA (only NR);Bacteria;Firmicutes;Bacilli;Izemoplasmatales;Izemoplasmataceae;Izimaplasma;";"91.3";"18.2";"23";"23";"21";"2";"0";"457160";"373873"
"V4mis1";"SILVA (only NR);Bacteria;Firmicutes;Bacilli;Kyrpidiales;";"95.0";"18.2";"20";"20";"19";"1";"0";"457163";"373875"
"V4mis1";"SILVA (only NR);Bacteria;Firmicutes;Bacilli;Kyrpidiales;Kyrpidiaceae;";"95.0";"18.2";"20";"20";"19";"1";"0";"457163";"373875"
"V4mis1";"SILVA (only NR);Bacteria;Firmicutes;Bacilli;Kyrpidiales;Kyrpidiaceae;Kyrpidia;";"95.0";"18.2";"20";"20";"19";"1";"0";"457163";"373875"
"V4mis1";"SILVA (only NR);Bacteria;Firmicutes;Bacilli;Lactobacillales;";"89.2";"18.4";"13176";"13176";"11754";"1422";"0";"444007";"362140"
"V4mis1";"SILVA (only NR);Bacteria;Firmicutes;Bacilli;Lactobacillales;Aerococcaceae;";"89.0";"18.2";"264";"264";"235";"29";"0";"456919";"373659"
"V4mis1";"SILVA (only NR);Bacteria;Firmicutes;Bacilli;Lactobacillales;Aerococcaceae;Abiotrophia;";"88.4";"18.2";"43";"43";"38";"5";"0";"457140";"373856"
"V4mis1";"SILVA (only NR);Bacteria;Firmicutes;Bacilli;Lactobacillales;Aerococcaceae;Aerococcus;";"82.3";"18.2";"113";"113";"93";"20";"0";"457070";"373801"
"V4mis1";"SILVA (only NR);Bacteria;Firmicutes;Bacilli;Lactobacillales;Aerococcaceae;Aerosphaera;";"100.0";"18.2";"11";"11";"11";"0";"0";"457172";"373883"
"V4mis1";"SILVA (only NR);Bacteria;Firmicutes;Bacilli;Lactobacillales;Aerococcaceae;Atopobacter;";"100.0";"18.2";"1";"1";"1";"0";"0";"457182";"373893"
"V4mis1";"SILVA (only NR);Bacteria;Firmicutes;Bacilli;Lactobacillales;Aerococcaceae;Bavariicoccus;";"100.0";"18.2";"3";"3";"3";"0";"0";"457180";"373891"
"V4mis1";"SILVA (only NR);Bacteria;Firmicutes;Bacilli;Lactobacillales;Aerococcaceae;Dolosicoccus;";"100.0";"18.2";"2";"2";"2";"0";"0";"457181";"373892"
"V4mis1";"SILVA (only NR);Bacteria;Firmicutes;Bacilli;Lactobacillales;Aerococcaceae;Eremococcus;";"85.7";"18.2";"7";"7";"6";"1";"0";"457176";"373888"
"V4mis1";"SILVA (only NR);Bacteria;Firmicutes;Bacilli;Lactobacillales;Aerococcaceae;Facklamia;";"97.6";"18.2";"41";"41";"40";"1";"0";"457142";"373854"
"V4mis1";"SILVA (only NR);Bacteria;Firmicutes;Bacilli;Lactobacillales;Aerococcaceae;Globicatella;";"92.9";"18.2";"14";"14";"13";"1";"0";"457169";"373881"
"V4mis1";"SILVA (only NR);Bacteria;Firmicutes;Bacilli;Lactobacillales;Aerococcaceae;Ignavigranum;";"100.0";"18.2";"17";"17";"17";"0";"0";"457166";"373877"
"V4mis1";"SILVA (only NR);Bacteria;Firmicutes;Bacilli;Lactobacillales;Aerococcaceae;uncultured;";"88.9";"18.2";"9";"9";"8";"1";"0";"457174";"373886"
"V4mis1";"SILVA (only NR);Bacteria;Firmicutes;Bacilli;Lactobacillales;Carnobacteriaceae;";"87.4";"18.2";"772";"772";"675";"97";"0";"456411";"373219"
"V4mis1";"SILVA (only NR);Bacteria;Firmicutes;Bacilli;Lactobacillales;Carnobacteriaceae;Alkalibacterium;";"97.5";"18.2";"40";"40";"39";"1";"0";"457143";"373855"
"V4mis1";"SILVA (only NR);Bacteria;Firmicutes;Bacilli;Lactobacillales;Carnobacteriaceae;Allofustis;";"100.0";"18.2";"4";"4";"4";"0";"0";"457179";"373890"
"V4mis1";"SILVA (only NR);Bacteria;Firmicutes;Bacilli;Lactobacillales;Carnobacteriaceae;Alloiococcus;";"84.6";"18.2";"26";"26";"22";"4";"0";"457157";"373872"
"V4mis1";"SILVA (only NR);Bacteria;Firmicutes;Bacilli;Lactobacillales;Carnobacteriaceae;Atopococcus;";"87.5";"18.2";"8";"8";"7";"1";"0";"457175";"373887"
"V4mis1";"SILVA (only NR);Bacteria;Firmicutes;Bacilli;Lactobacillales;Carnobacteriaceae;Atopostipes;";"95.0";"18.2";"60";"60";"57";"3";"0";"457123";"373837"
"V4mis1";"SILVA (only NR);Bacteria;Firmicutes;Bacilli;Lactobacillales;Carnobacteriaceae;Carnobacterium;";"95.6";"18.2";"68";"68";"65";"3";"0";"457115";"373829"
"V4mis1";"SILVA (only NR);Bacteria;Firmicutes;Bacilli;Lactobacillales;Carnobacteriaceae;Desemzia;";"92.6";"18.2";"27";"27";"25";"2";"0";"457156";"373869"
"V4mis1";"SILVA (only NR);Bacteria;Firmicutes;Bacilli;Lactobacillales;Carnobacteriaceae;Dolosigranulum;";"76.8";"18.2";"125";"125";"96";"29";"0";"457058";"373798"
"V4mis1";"SILVA (only NR);Bacteria;Firmicutes;Bacilli;Lactobacillales;Carnobacteriaceae;Granulicatella;";"78.2";"18.2";"225";"225";"176";"49";"0";"456958";"373718"
"V4mis1";"SILVA (only NR);Bacteria;Firmicutes;Bacilli;Lactobacillales;Carnobacteriaceae;Isobaculum;";"100.0";"18.2";"1";"1";"1";"0";"0";"457182";"373893"
"V4mis1";"SILVA (only NR);Bacteria;Firmicutes;Bacilli;Lactobacillales;Carnobacteriaceae;Jeotgalibaca;";"93.2";"18.2";"44";"44";"41";"3";"0";"457139";"373853"
"V4mis1";"SILVA (only NR);Bacteria;Firmicutes;Bacilli;Lactobacillales;Carnobacteriaceae;Lacticigenium;";"100.0";"18.2";"5";"5";"5";"0";"0";"457178";"373889"
"V4mis1";"SILVA (only NR);Bacteria;Firmicutes;Bacilli;Lactobacillales;Carnobacteriaceae;Marinilactibacillus;";"100.0";"18.2";"33";"33";"33";"0";"0";"457150";"373861"
"V4mis1";"SILVA (only NR);Bacteria;Firmicutes;Bacilli;Lactobacillales;Carnobacteriaceae;Nostocoida;";"100.0";"18.2";"1";"1";"1";"0";"0";"457182";"373893"
"V4mis1";"SILVA (only NR);Bacteria;Firmicutes;Bacilli;Lactobacillales;Carnobacteriaceae;Pisciglobus;";"100.0";"18.2";"3";"3";"3";"0";"0";"457180";"373891"
"V4mis1";"SILVA (only NR);Bacteria;Firmicutes;Bacilli;Lactobacillales;Carnobacteriaceae;Trichococcus;";"100.0";"18.2";"75";"75";"75";"0";"0";"457108";"373819"
"V4mis1";"SILVA (only NR);Bacteria;Firmicutes;Bacilli;Lactobacillales;Carnobacteriaceae;uncultured;";"100.0";"18.2";"22";"22";"22";"0";"0";"457161";"373872"
"V4mis1";"SILVA (only NR);Bacteria;Firmicutes;Bacilli;Lactobacillales;Catellicoccaceae;";"100.0";"18.2";"7";"7";"7";"0";"0";"457176";"373887"
"V4mis1";"SILVA (only NR);Bacteria;Firmicutes;Bacilli;Lactobacillales;Catellicoccaceae;Catellicoccus;";"100.0";"18.2";"7";"7";"7";"0";"0";"457176";"373887"
"V4mis1";"SILVA (only NR);Bacteria;Firmicutes;Bacilli;Lactobacillales;Enterococcaceae;";"92.1";"18.3";"1600";"1600";"1474";"126";"0";"455583";"372420"
"V4mis1";"SILVA (only NR);Bacteria;Firmicutes;Bacilli;Lactobacillales;Enterococcaceae;Enterococcus;";"91.9";"18.3";"1551";"1551";"1426";"125";"0";"455632";"372468"
"V4mis1";"SILVA (only NR);Bacteria;Firmicutes;Bacilli;Lactobacillales;Enterococcaceae;Melissococcus;";"100.0";"18.2";"9";"9";"9";"0";"0";"457174";"373885"
"V4mis1";"SILVA (only NR);Bacteria;Firmicutes;Bacilli;Lactobacillales;Enterococcaceae;Tetragenococcus;";"97.4";"18.2";"39";"39";"38";"1";"0";"457144";"373856"
"V4mis1";"SILVA (only NR);Bacteria;Firmicutes;Bacilli;Lactobacillales;Lactobacillaceae;";"90.5";"18.3";"4739";"4739";"4289";"450";"0";"452444";"369605"
"V4mis1";"SILVA (only NR);Bacteria;Firmicutes;Bacilli;Lactobacillales;Lactobacillaceae;Agrilactobacillus;";"100.0";"18.2";"3";"3";"3";"0";"0";"457180";"373891"
"V4mis1";"SILVA (only NR);Bacteria;Firmicutes;Bacilli;Lactobacillales;Lactobacillaceae;Amylolactobacillus;";"100.0";"18.2";"10";"10";"10";"0";"0";"457173";"373884"
"V4mis1";"SILVA (only NR);Bacteria;Firmicutes;Bacilli;Lactobacillales;Lactobacillaceae;Apilactobacillus;";"100.0";"18.2";"42";"42";"42";"0";"0";"457141";"373852"
"V4mis1";"SILVA (only NR);Bacteria;Firmicutes;Bacilli;Lactobacillales;Lactobacillaceae;Bombilactobacillus;";"100.0";"18.2";"19";"19";"19";"0";"0";"457164";"373875"
"V4mis1";"SILVA (only NR);Bacteria;Firmicutes;Bacilli;Lactobacillales;Lactobacillaceae;Companilactobacillus;";"97.3";"18.2";"73";"73";"71";"2";"0";"457110";"373823"
"V4mis1";"SILVA (only NR);Bacteria;Firmicutes;Bacilli;Lactobacillales;Lactobacillaceae;Dellaglioa;";"100.0";"18.2";"2";"2";"2";"0";"0";"457181";"373892"
"V4mis1";"SILVA (only NR);Bacteria;Firmicutes;Bacilli;Lactobacillales;Lactobacillaceae;Fructilactobacillus;";"96.8";"18.2";"31";"31";"30";"1";"0";"457152";"373864"
"V4mis1";"SILVA (only NR);Bacteria;Firmicutes;Bacilli;Lactobacillales;Lactobacillaceae;Fructobacillus;";"91.3";"18.2";"23";"23";"21";"2";"0";"457160";"373873"
"V4mis1";"SILVA (only NR);Bacteria;Firmicutes;Bacilli;Lactobacillales;Lactobacillaceae;Furfurilactobacillus;";"100.0";"18.2";"12";"12";"12";"0";"0";"457171";"373882"
"V4mis1";"SILVA (only NR);Bacteria;Firmicutes;Bacilli;Lactobacillales;Lactobacillaceae;HT002;";"100.0";"18.2";"12";"12";"12";"0";"0";"457171";"373882"
"V4mis1";"SILVA (only NR);Bacteria;Firmicutes;Bacilli;Lactobacillales;Lactobacillaceae;Holzapfelia;";"100.0";"18.2";"1";"1";"1";"0";"0";"457182";"373893"
"V4mis1";"SILVA (only NR);Bacteria;Firmicutes;Bacilli;Lactobacillales;Lactobacillaceae;Lacticaseibacillus;";"90.3";"18.2";"411";"411";"371";"40";"0";"456772";"373523"
"V4mis1";"SILVA (only NR);Bacteria;Firmicutes;Bacilli;Lactobacillales;Lactobacillaceae;Lactiplantibacillus;";"89.0";"18.2";"671";"671";"597";"74";"0";"456512";"373297"
"V4mis1";"SILVA (only NR);Bacteria;Firmicutes;Bacilli;Lactobacillales;Lactobacillaceae;Lactobacillus;";"90.5";"18.2";"1068";"1068";"967";"101";"0";"456115";"372927"
"V4mis1";"SILVA (only NR);Bacteria;Firmicutes;Bacilli;Lactobacillales;Lactobacillaceae;Lapidilactobacillus;";"100.0";"18.2";"4";"4";"4";"0";"0";"457179";"373890"
"V4mis1";"SILVA (only NR);Bacteria;Firmicutes;Bacilli;Lactobacillales;Lactobacillaceae;Latilactobacillus;";"95.4";"18.2";"130";"130";"124";"6";"0";"457053";"373770"
"V4mis1";"SILVA (only NR);Bacteria;Firmicutes;Bacilli;Lactobacillales;Lactobacillaceae;Lentilactobacillus;";"94.2";"18.2";"120";"120";"113";"7";"0";"457063";"373781"
"V4mis1";"SILVA (only NR);Bacteria;Firmicutes;Bacilli;Lactobacillales;Lactobacillaceae;Leuconostoc;";"86.6";"18.2";"336";"336";"291";"45";"0";"456847";"373603"
"V4mis1";"SILVA (only NR);Bacteria;Firmicutes;Bacilli;Lactobacillales;Lactobacillaceae;Levilactobacillus;";"88.0";"18.2";"158";"158";"139";"19";"0";"457025";"373755"
"V4mis1";"SILVA (only NR);Bacteria;Firmicutes;Bacilli;Lactobacillales;Lactobacillaceae;Ligilactobacillus;";"86.9";"18.2";"328";"328";"285";"43";"0";"456855";"373609"
"V4mis1";"SILVA (only NR);Bacteria;Firmicutes;Bacilli;Lactobacillales;Lactobacillaceae;Limosilactobacillus;";"91.2";"18.2";"616";"616";"562";"54";"0";"456567";"373332"
"V4mis1";"SILVA (only NR);Bacteria;Firmicutes;Bacilli;Lactobacillales;Lactobacillaceae;Liquorilactobacillus;";"89.2";"18.2";"37";"37";"33";"4";"0";"457146";"373861"
"V4mis1";"SILVA (only NR);Bacteria;Firmicutes;Bacilli;Lactobacillales;Lactobacillaceae;Loigolactobacillus;";"97.8";"18.2";"45";"45";"44";"1";"0";"457138";"373850"
"V4mis1";"SILVA (only NR);Bacteria;Firmicutes;Bacilli;Lactobacillales;Lactobacillaceae;Oenococcus;";"100.0";"18.2";"16";"16";"16";"0";"0";"457167";"373878"
"V4mis1";"SILVA (only NR);Bacteria;Firmicutes;Bacilli;Lactobacillales;Lactobacillaceae;Paralactobacillus;";"100.0";"18.2";"3";"3";"3";"0";"0";"457180";"373891"
"V4mis1";"SILVA (only NR);Bacteria;Firmicutes;Bacilli;Lactobacillales;Lactobacillaceae;Paucilactobacillus;";"88.0";"18.2";"25";"25";"22";"3";"0";"457158";"373872"
"V4mis1";"SILVA (only NR);Bacteria;Firmicutes;Bacilli;Lactobacillales;Lactobacillaceae;Pediococcus;";"92.1";"18.2";"229";"229";"211";"18";"0";"456954";"373683"
"V4mis1";"SILVA (only NR);Bacteria;Firmicutes;Bacilli;Lactobacillales;Lactobacillaceae;Schleiferilactobacillus;";"92.9";"18.2";"14";"14";"13";"1";"0";"457169";"373881"
"V4mis1";"SILVA (only NR);Bacteria;Firmicutes;Bacilli;Lactobacillales;Lactobacillaceae;Secundilactobacillus;";"100.0";"18.2";"30";"30";"30";"0";"0";"457153";"373864"
"V4mis1";"SILVA (only NR);Bacteria;Firmicutes;Bacilli;Lactobacillales;Lactobacillaceae;Weissella;";"89.1";"18.2";"256";"256";"228";"28";"0";"456927";"373666"
"V4mis1";"SILVA (only NR);Bacteria;Firmicutes;Bacilli;Lactobacillales;Lactobacillaceae;uncultured;";"91.7";"18.2";"12";"12";"11";"1";"0";"457171";"373883"
"V4mis1";"SILVA (only NR);Bacteria;Firmicutes;Bacilli;Lactobacillales;Listeriaceae;";"97.3";"18.2";"337";"337";"328";"9";"0";"456846";"373566"
"V4mis1";"SILVA (only NR);Bacteria;Firmicutes;Bacilli;Lactobacillales;Listeriaceae;Brochothrix;";"93.3";"18.2";"30";"30";"28";"2";"0";"457153";"373866"
"V4mis1";"SILVA (only NR);Bacteria;Firmicutes;Bacilli;Lactobacillales;Listeriaceae;Listeria;";"97.7";"18.2";"307";"307";"300";"7";"0";"456876";"373594"
"V4mis1";"SILVA (only NR);Bacteria;Firmicutes;Bacilli;Lactobacillales;P5D1-392;";"90.9";"18.2";"22";"22";"20";"2";"0";"457161";"373874"
"V4mis1";"SILVA (only NR);Bacteria;Firmicutes;Bacilli;Lactobacillales;Streptococcaceae;";"86.9";"18.3";"5371";"5371";"4665";"706";"0";"451812";"369229"
"V4mis1";"SILVA (only NR);Bacteria;Firmicutes;Bacilli;Lactobacillales;Streptococcaceae;Floricoccus;";"100.0";"18.2";"5";"5";"5";"0";"0";"457178";"373889"
"V4mis1";"SILVA (only NR);Bacteria;Firmicutes;Bacilli;Lactobacillales;Streptococcaceae;Lactococcus;";"91.9";"18.2";"420";"420";"386";"34";"0";"456763";"373508"
"V4mis1";"SILVA (only NR);Bacteria;Firmicutes;Bacilli;Lactobacillales;Streptococcaceae;Lactovum;";"100.0";"18.2";"15";"15";"15";"0";"0";"457168";"373879"
"V4mis1";"SILVA (only NR);Bacteria;Firmicutes;Bacilli;Lactobacillales;Streptococcaceae;Pilibacter;";"100.0";"18.2";"7";"7";"7";"0";"0";"457176";"373887"
"V4mis1";"SILVA (only NR);Bacteria;Firmicutes;Bacilli;Lactobacillales;Streptococcaceae;Streptococcus;";"86.4";"18.3";"4924";"4924";"4252";"672";"0";"452259";"369642"
"V4mis1";"SILVA (only NR);Bacteria;Firmicutes;Bacilli;Lactobacillales;Vagococcaceae;";"95.7";"18.2";"46";"46";"44";"2";"0";"457137";"373850"
"V4mis1";"SILVA (only NR);Bacteria;Firmicutes;Bacilli;Lactobacillales;Vagococcaceae;Vagococcus;";"95.7";"18.2";"46";"46";"44";"2";"0";"457137";"373850"
"V4mis1";"SILVA (only NR);Bacteria;Firmicutes;Bacilli;Lactobacillales;uncultured;";"93.3";"18.2";"15";"15";"14";"1";"0";"457168";"373880"
"V4mis1";"SILVA (only NR);Bacteria;Firmicutes;Bacilli;Mycoplasmatales;";"98.7";"18.2";"743";"743";"733";"10";"0";"456440";"373161"
"V4mis1";"SILVA (only NR);Bacteria;Firmicutes;Bacilli;Mycoplasmatales;Mycoplasmataceae;";"98.7";"18.2";"743";"743";"733";"10";"0";"456440";"373161"
"V4mis1";"SILVA (only NR);Bacteria;Firmicutes;Bacilli;Mycoplasmatales;Mycoplasmataceae;Candidatus Bacilloplasma;";"100.0";"18.2";"13";"13";"13";"0";"0";"457170";"373881"
"V4mis1";"SILVA (only NR);Bacteria;Firmicutes;Bacilli;Mycoplasmatales;Mycoplasmataceae;Candidatus Lumbricincola;";"100.0";"18.2";"5";"5";"5";"0";"0";"457178";"373889"
"V4mis1";"SILVA (only NR);Bacteria;Firmicutes;Bacilli;Mycoplasmatales;Mycoplasmataceae;Mycoplasma;";"98.5";"18.2";"607";"607";"598";"9";"0";"456576";"373296"
"V4mis1";"SILVA (only NR);Bacteria;Firmicutes;Bacilli;Mycoplasmatales;Mycoplasmataceae;Ureaplasma;";"99.1";"18.2";"107";"107";"106";"1";"0";"457076";"373788"
"V4mis1";"SILVA (only NR);Bacteria;Firmicutes;Bacilli;Mycoplasmatales;Mycoplasmataceae;uncultured;";"100.0";"18.2";"11";"11";"11";"0";"0";"457172";"373883"
"V4mis1";"SILVA (only NR);Bacteria;Firmicutes;Bacilli;Paenibacillales;";"95.5";"18.3";"2551";"2551";"2435";"116";"0";"454632";"371459"
"V4mis1";"SILVA (only NR);Bacteria;Firmicutes;Bacilli;Paenibacillales;Paenibacillaceae;";"95.5";"18.3";"2551";"2551";"2435";"116";"0";"454632";"371459"
"V4mis1";"SILVA (only NR);Bacteria;Firmicutes;Bacilli;Paenibacillales;Paenibacillaceae;Ammoniibacillus;";"100.0";"18.2";"4";"4";"4";"0";"0";"457179";"373890"
"V4mis1";"SILVA (only NR);Bacteria;Firmicutes;Bacilli;Paenibacillales;Paenibacillaceae;Ammoniphilus;";"100.0";"18.2";"24";"24";"24";"0";"0";"457159";"373870"
"V4mis1";"SILVA (only NR);Bacteria;Firmicutes;Bacilli;Paenibacillales;Paenibacillaceae;Cohnella;";"93.5";"18.2";"154";"154";"144";"10";"0";"457029";"373750"
"V4mis1";"SILVA (only NR);Bacteria;Firmicutes;Bacilli;Paenibacillales;Paenibacillaceae;Fontibacillus;";"100.0";"18.2";"9";"9";"9";"0";"0";"457174";"373885"
"V4mis1";"SILVA (only NR);Bacteria;Firmicutes;Bacilli;Paenibacillales;Paenibacillaceae;Oxalophagus;";"100.0";"18.2";"3";"3";"3";"0";"0";"457180";"373891"
"V4mis1";"SILVA (only NR);Bacteria;Firmicutes;Bacilli;Paenibacillales;Paenibacillaceae;Paenibacillus;";"95.3";"18.3";"2264";"2264";"2158";"106";"0";"454919";"371736"
"V4mis1";"SILVA (only NR);Bacteria;Firmicutes;Bacilli;Paenibacillales;Paenibacillaceae;Saccharibacillus;";"100.0";"18.2";"18";"18";"18";"0";"0";"457165";"373876"
"V4mis1";"SILVA (only NR);Bacteria;Firmicutes;Bacilli;Paenibacillales;Paenibacillaceae;Thermobacillus;";"100.0";"18.2";"32";"32";"32";"0";"0";"457151";"373862"
"V4mis1";"SILVA (only NR);Bacteria;Firmicutes;Bacilli;Paenibacillales;Paenibacillaceae;Xylanibacillus;";"100.0";"18.2";"5";"5";"5";"0";"0";"457178";"373889"
"V4mis1";"SILVA (only NR);Bacteria;Firmicutes;Bacilli;Paenibacillales;Paenibacillaceae;uncultured;";"100.0";"18.2";"28";"28";"28";"0";"0";"457155";"373866"
"V4mis1";"SILVA (only NR);Bacteria;Firmicutes;Bacilli;RF39;";"97.2";"18.2";"635";"635";"617";"18";"0";"456548";"373277"
"V4mis1";"SILVA (only NR);Bacteria;Firmicutes;Bacilli;RsaHf231;";"100.0";"18.2";"8";"8";"8";"0";"0";"457175";"373886"
"V4mis1";"SILVA (only NR);Bacteria;Firmicutes;Bacilli;Staphylococcales;";"77.5";"18.2";"4825";"4825";"3738";"1087";"0";"452358";"370156"
"V4mis1";"SILVA (only NR);Bacteria;Firmicutes;Bacilli;Staphylococcales;Gemellaceae;";"86.5";"18.2";"355";"355";"307";"48";"0";"456828";"373587"
"V4mis1";"SILVA (only NR);Bacteria;Firmicutes;Bacilli;Staphylococcales;Gemellaceae;Gemella;";"86.5";"18.2";"355";"355";"307";"48";"0";"456828";"373587"
"V4mis1";"SILVA (only NR);Bacteria;Firmicutes;Bacilli;Staphylococcales;Staphylococcaceae;";"76.8";"18.2";"4470";"4470";"3431";"1039";"0";"452713";"370463"
"V4mis1";"SILVA (only NR);Bacteria;Firmicutes;Bacilli;Staphylococcales;Staphylococcaceae;Aliicoccus;";"100.0";"18.2";"4";"4";"4";"0";"0";"457179";"373890"
"V4mis1";"SILVA (only NR);Bacteria;Firmicutes;Bacilli;Staphylococcales;Staphylococcaceae;Auricoccus-Abyssicoccus;";"100.0";"18.2";"5";"5";"5";"0";"0";"457178";"373889"
"V4mis1";"SILVA (only NR);Bacteria;Firmicutes;Bacilli;Staphylococcales;Staphylococcaceae;Corticicoccus;";"100.0";"18.2";"2";"2";"2";"0";"0";"457181";"373892"
"V4mis1";"SILVA (only NR);Bacteria;Firmicutes;Bacilli;Staphylococcales;Staphylococcaceae;Jeotgalicoccus;";"93.3";"18.2";"60";"60";"56";"4";"0";"457123";"373838"
"V4mis1";"SILVA (only NR);Bacteria;Firmicutes;Bacilli;Staphylococcales;Staphylococcaceae;Macrococcus;";"91.7";"18.2";"36";"36";"33";"3";"0";"457147";"373861"
"V4mis1";"SILVA (only NR);Bacteria;Firmicutes;Bacilli;Staphylococcales;Staphylococcaceae;Nosocomiicoccus;";"66.7";"18.2";"18";"18";"12";"6";"0";"457165";"373882"
"V4mis1";"SILVA (only NR);Bacteria;Firmicutes;Bacilli;Staphylococcales;Staphylococcaceae;Salinicoccus;";"91.3";"18.2";"69";"69";"63";"6";"0";"457114";"373831"
"V4mis1";"SILVA (only NR);Bacteria;Firmicutes;Bacilli;Staphylococcales;Staphylococcaceae;Staphylococcus;";"76.1";"18.2";"4274";"4274";"3254";"1020";"0";"452909";"370640"
"V4mis1";"SILVA (only NR);Bacteria;Firmicutes;Bacilli;Thermicanales;";"70.7";"18.2";"41";"41";"29";"12";"0";"457142";"373865"
"V4mis1";"SILVA (only NR);Bacteria;Firmicutes;Bacilli;Thermicanales;Thermicanaceae;";"70.7";"18.2";"41";"41";"29";"12";"0";"457142";"373865"
"V4mis1";"SILVA (only NR);Bacteria;Firmicutes;Bacilli;Thermicanales;Thermicanaceae;Hydrogenibacillus;";"100.0";"18.2";"5";"5";"5";"0";"0";"457178";"373889"
"V4mis1";"SILVA (only NR);Bacteria;Firmicutes;Bacilli;Thermicanales;Thermicanaceae;Thermicanus;";"66.7";"18.2";"36";"36";"24";"12";"0";"457147";"373870"
"V4mis1";"SILVA (only NR);Bacteria;Firmicutes;Bacilli;Thermoactinomycetales;";"97.8";"18.2";"183";"183";"179";"4";"0";"457000";"373715"
"V4mis1";"SILVA (only NR);Bacteria;Firmicutes;Bacilli;Thermoactinomycetales;Thermoactinomycetaceae;";"97.8";"18.2";"183";"183";"179";"4";"0";"457000";"373715"
"V4mis1";"SILVA (only NR);Bacteria;Firmicutes;Bacilli;Thermoactinomycetales;Thermoactinomycetaceae;Baia;";"100.0";"18.2";"5";"5";"5";"0";"0";"457178";"373889"
"V4mis1";"SILVA (only NR);Bacteria;Firmicutes;Bacilli;Thermoactinomycetales;Thermoactinomycetaceae;Desmospora;";"100.0";"18.2";"2";"2";"2";"0";"0";"457181";"373892"
"V4mis1";"SILVA (only NR);Bacteria;Firmicutes;Bacilli;Thermoactinomycetales;Thermoactinomycetaceae;Geothermomicrobium;";"100.0";"18.2";"4";"4";"4";"0";"0";"457179";"373890"
"V4mis1";"SILVA (only NR);Bacteria;Firmicutes;Bacilli;Thermoactinomycetales;Thermoactinomycetaceae;Hazenella;";"100.0";"18.2";"3";"3";"3";"0";"0";"457180";"373891"
"V4mis1";"SILVA (only NR);Bacteria;Firmicutes;Bacilli;Thermoactinomycetales;Thermoactinomycetaceae;Kroppenstedtia;";"100.0";"18.2";"11";"11";"11";"0";"0";"457172";"373883"
"V4mis1";"SILVA (only NR);Bacteria;Firmicutes;Bacilli;Thermoactinomycetales;Thermoactinomycetaceae;Laceyella;";"94.1";"18.2";"17";"17";"16";"1";"0";"457166";"373878"
"V4mis1";"SILVA (only NR);Bacteria;Firmicutes;Bacilli;Thermoactinomycetales;Thermoactinomycetaceae;Lihuaxuella;";"100.0";"18.2";"3";"3";"3";"0";"0";"457180";"373891"
"V4mis1";"SILVA (only NR);Bacteria;Firmicutes;Bacilli;Thermoactinomycetales;Thermoactinomycetaceae;Marininema;";"100.0";"18.2";"2";"2";"2";"0";"0";"457181";"373892"
"V4mis1";"SILVA (only NR);Bacteria;Firmicutes;Bacilli;Thermoactinomycetales;Thermoactinomycetaceae;Mechercharimyces;";"100.0";"18.2";"4";"4";"4";"0";"0";"457179";"373890"
"V4mis1";"SILVA (only NR);Bacteria;Firmicutes;Bacilli;Thermoactinomycetales;Thermoactinomycetaceae;Melghirimyces;";"100.0";"18.2";"7";"7";"7";"0";"0";"457176";"373887"
"V4mis1";"SILVA (only NR);Bacteria;Firmicutes;Bacilli;Thermoactinomycetales;Thermoactinomycetaceae;Novibacillus;";"100.0";"18.2";"7";"7";"7";"0";"0";"457176";"373887"
"V4mis1";"SILVA (only NR);Bacteria;Firmicutes;Bacilli;Thermoactinomycetales;Thermoactinomycetaceae;Pasteuria;";"95.7";"18.2";"23";"23";"22";"1";"0";"457160";"373872"
"V4mis1";"SILVA (only NR);Bacteria;Firmicutes;Bacilli;Thermoactinomycetales;Thermoactinomycetaceae;Planifilum;";"92.9";"18.2";"14";"14";"13";"1";"0";"457169";"373881"
"V4mis1";"SILVA (only NR);Bacteria;Firmicutes;Bacilli;Thermoactinomycetales;Thermoactinomycetaceae;Polycladomyces;";"100.0";"18.2";"3";"3";"3";"0";"0";"457180";"373891"
"V4mis1";"SILVA (only NR);Bacteria;Firmicutes;Bacilli;Thermoactinomycetales;Thermoactinomycetaceae;Risungbinella;";"100.0";"18.2";"4";"4";"4";"0";"0";"457179";"373890"
"V4mis1";"SILVA (only NR);Bacteria;Firmicutes;Bacilli;Thermoactinomycetales;Thermoactinomycetaceae;Salinithrix;";"100.0";"18.2";"1";"1";"1";"0";"0";"457182";"373893"
"V4mis1";"SILVA (only NR);Bacteria;Firmicutes;Bacilli;Thermoactinomycetales;Thermoactinomycetaceae;Seinonella;";"100.0";"18.2";"2";"2";"2";"0";"0";"457181";"373892"
"V4mis1";"SILVA (only NR);Bacteria;Firmicutes;Bacilli;Thermoactinomycetales;Thermoactinomycetaceae;Shimazuella;";"100.0";"18.2";"18";"18";"18";"0";"0";"457165";"373876"
"V4mis1";"SILVA (only NR);Bacteria;Firmicutes;Bacilli;Thermoactinomycetales;Thermoactinomycetaceae;Thermoactinomyces;";"100.0";"18.2";"20";"20";"20";"0";"0";"457163";"373874"
"V4mis1";"SILVA (only NR);Bacteria;Firmicutes;Bacilli;Thermoactinomycetales;Thermoactinomycetaceae;Thermoflavimicrobium;";"100.0";"18.2";"7";"7";"7";"0";"0";"457176";"373887"
"V4mis1";"SILVA (only NR);Bacteria;Firmicutes;Bacilli;Thermoactinomycetales;Thermoactinomycetaceae;uncultured;";"100.0";"18.2";"21";"21";"21";"0";"0";"457162";"373873"
"V4mis1";"SILVA (only NR);Bacteria;Firmicutes;Bacilli;uncultured;";"100.0";"18.2";"7";"7";"7";"0";"0";"457176";"373887"
"V4mis1";"SILVA (only NR);Bacteria;Firmicutes;Clostridia;";"94.5";"19.8";"50639";"50639";"47835";"2804";"0";"406544";"326059"
"V4mis1";"SILVA (only NR);Bacteria;Firmicutes;Clostridia;Caldicoprobacterales;";"95.9";"18.2";"121";"121";"116";"5";"0";"457062";"373778"
"V4mis1";"SILVA (only NR);Bacteria;Firmicutes;Clostridia;Caldicoprobacterales;Caldicoprobacteraceae;";"95.9";"18.2";"121";"121";"116";"5";"0";"457062";"373778"
"V4mis1";"SILVA (only NR);Bacteria;Firmicutes;Clostridia;Caldicoprobacterales;Caldicoprobacteraceae;Caldicoprobacter;";"95.9";"18.2";"121";"121";"116";"5";"0";"457062";"373778"
"V4mis1";"SILVA (only NR);Bacteria;Firmicutes;Clostridia;Christensenellales;";"96.2";"18.3";"2472";"2472";"2378";"94";"0";"454711";"371516"
"V4mis1";"SILVA (only NR);Bacteria;Firmicutes;Clostridia;Christensenellales;Christensenellaceae;";"96.2";"18.3";"2472";"2472";"2378";"94";"0";"454711";"371516"
"V4mis1";"SILVA (only NR);Bacteria;Firmicutes;Clostridia;Christensenellales;Christensenellaceae;Catabacter;";"100.0";"18.2";"3";"3";"3";"0";"0";"457180";"373891"
"V4mis1";"SILVA (only NR);Bacteria;Firmicutes;Clostridia;Christensenellales;Christensenellaceae;Christensenella;";"100.0";"18.2";"5";"5";"5";"0";"0";"457178";"373889"
"V4mis1";"SILVA (only NR);Bacteria;Firmicutes;Clostridia;Christensenellales;Christensenellaceae;Christensenellaceae R-7 group;";"96.0";"18.3";"2301";"2301";"2208";"93";"0";"454882";"371686"
"V4mis1";"SILVA (only NR);Bacteria;Firmicutes;Clostridia;Christensenellales;Christensenellaceae;uncultured;";"99.4";"18.2";"157";"157";"156";"1";"0";"457026";"373738"
"V4mis1";"SILVA (only NR);Bacteria;Firmicutes;Clostridia;Clostridia UCG-014;";"96.9";"18.3";"1146";"1146";"1111";"35";"0";"456037";"372783"
"V4mis1";"SILVA (only NR);Bacteria;Firmicutes;Clostridia;Clostridia vadinBB60 group;";"97.2";"18.2";"432";"432";"420";"12";"0";"456751";"373474"
"V4mis1";"SILVA (only NR);Bacteria;Firmicutes;Clostridia;Clostridiales;";"93.8";"18.3";"2914";"2914";"2734";"180";"0";"454269";"371160"
"V4mis1";"SILVA (only NR);Bacteria;Firmicutes;Clostridia;Clostridiales;Caloramatoraceae;";"91.5";"18.2";"247";"247";"226";"21";"0";"456936";"373668"
"V4mis1";"SILVA (only NR);Bacteria;Firmicutes;Clostridia;Clostridiales;Caloramatoraceae;Caloramator;";"93.5";"18.2";"92";"92";"86";"6";"0";"457091";"373808"
"V4mis1";"SILVA (only NR);Bacteria;Firmicutes;Clostridia;Clostridiales;Caloramatoraceae;Clostridium;";"100.0";"18.2";"1";"1";"1";"0";"0";"457182";"373893"
"V4mis1";"SILVA (only NR);Bacteria;Firmicutes;Clostridia;Clostridiales;Caloramatoraceae;Fervidicella;";"100.0";"18.2";"2";"2";"2";"0";"0";"457181";"373892"
"V4mis1";"SILVA (only NR);Bacteria;Firmicutes;Clostridia;Clostridiales;Caloramatoraceae;Fonticella;";"97.0";"18.2";"66";"66";"64";"2";"0";"457117";"373830"
"V4mis1";"SILVA (only NR);Bacteria;Firmicutes;Clostridia;Clostridiales;Caloramatoraceae;Thermobrachium;";"81.4";"18.2";"43";"43";"35";"8";"0";"457140";"373859"
"V4mis1";"SILVA (only NR);Bacteria;Firmicutes;Clostridia;Clostridiales;Caloramatoraceae;uncultured;";"86.8";"18.2";"38";"38";"33";"5";"0";"457145";"373861"
"V4mis1";"SILVA (only NR);Bacteria;Firmicutes;Clostridia;Clostridiales;Clostridiaceae;";"93.9";"18.3";"2571";"2571";"2414";"157";"0";"454612";"371480"
"V4mis1";"SILVA (only NR);Bacteria;Firmicutes;Clostridia;Clostridiales;Clostridiaceae;Anaerobacter;";"100.0";"18.2";"3";"3";"3";"0";"0";"457180";"373891"
"V4mis1";"SILVA (only NR);Bacteria;Firmicutes;Clostridia;Clostridiales;Clostridiaceae;Candidatus Arthromitus;";"76.5";"18.2";"34";"34";"26";"8";"0";"457149";"373868"
"V4mis1";"SILVA (only NR);Bacteria;Firmicutes;Clostridia;Clostridiales;Clostridiaceae;Clostridium sensu stricto 10;";"97.1";"18.2";"35";"35";"34";"1";"0";"457148";"373860"
"V4mis1";"SILVA (only NR);Bacteria;Firmicutes;Clostridia;Clostridiales;Clostridiaceae;Clostridium sensu stricto 11;";"98.1";"18.2";"53";"53";"52";"1";"0";"457130";"373842"
"V4mis1";"SILVA (only NR);Bacteria;Firmicutes;Clostridia;Clostridiales;Clostridiaceae;Clostridium sensu stricto 12;";"94.8";"18.2";"172";"172";"163";"9";"0";"457011";"373731"
"V4mis1";"SILVA (only NR);Bacteria;Firmicutes;Clostridia;Clostridiales;Clostridiaceae;Clostridium sensu stricto 13;";"95.3";"18.2";"150";"150";"143";"7";"0";"457033";"373751"
"V4mis1";"SILVA (only NR);Bacteria;Firmicutes;Clostridia;Clostridiales;Clostridiaceae;Clostridium sensu stricto 14;";"100.0";"18.2";"12";"12";"12";"0";"0";"457171";"373882"
"V4mis1";"SILVA (only NR);Bacteria;Firmicutes;Clostridia;Clostridiales;Clostridiaceae;Clostridium sensu stricto 15;";"92.3";"18.2";"13";"13";"12";"1";"0";"457170";"373882"
"V4mis1";"SILVA (only NR);Bacteria;Firmicutes;Clostridia;Clostridiales;Clostridiaceae;Clostridium sensu stricto 16;";"100.0";"18.2";"10";"10";"10";"0";"0";"457173";"373884"
"V4mis1";"SILVA (only NR);Bacteria;Firmicutes;Clostridia;Clostridiales;Clostridiaceae;Clostridium sensu stricto 17;";"100.0";"18.2";"2";"2";"2";"0";"0";"457181";"373892"
"V4mis1";"SILVA (only NR);Bacteria;Firmicutes;Clostridia;Clostridiales;Clostridiaceae;Clostridium sensu stricto 18;";"98.0";"18.2";"101";"101";"99";"2";"0";"457082";"373795"
"V4mis1";"SILVA (only NR);Bacteria;Firmicutes;Clostridia;Clostridiales;Clostridiaceae;Clostridium sensu stricto 19;";"100.0";"18.2";"4";"4";"4";"0";"0";"457179";"373890"
"V4mis1";"SILVA (only NR);Bacteria;Firmicutes;Clostridia;Clostridiales;Clostridiaceae;Clostridium sensu stricto 1;";"93.2";"18.3";"1447";"1447";"1348";"99";"0";"455736";"372546"
"V4mis1";"SILVA (only NR);Bacteria;Firmicutes;Clostridia;Clostridiales;Clostridiaceae;Clostridium sensu stricto 2;";"90.9";"18.2";"11";"11";"10";"1";"0";"457172";"373884"
"V4mis1";"SILVA (only NR);Bacteria;Firmicutes;Clostridia;Clostridiales;Clostridiaceae;Clostridium sensu stricto 3;";"93.8";"18.2";"32";"32";"30";"2";"0";"457151";"373864"
"V4mis1";"SILVA (only NR);Bacteria;Firmicutes;Clostridia;Clostridiales;Clostridiaceae;Clostridium sensu stricto 4;";"100.0";"18.2";"4";"4";"4";"0";"0";"457179";"373890"
"V4mis1";"SILVA (only NR);Bacteria;Firmicutes;Clostridia;Clostridiales;Clostridiaceae;Clostridium sensu stricto 5;";"95.5";"18.2";"22";"22";"21";"1";"0";"457161";"373873"
"V4mis1";"SILVA (only NR);Bacteria;Firmicutes;Clostridia;Clostridiales;Clostridiaceae;Clostridium sensu stricto 6;";"81.3";"18.2";"16";"16";"13";"3";"0";"457167";"373881"
"V4mis1";"SILVA (only NR);Bacteria;Firmicutes;Clostridia;Clostridiales;Clostridiaceae;Clostridium sensu stricto 7;";"94.7";"18.2";"57";"57";"54";"3";"0";"457126";"373840"
"V4mis1";"SILVA (only NR);Bacteria;Firmicutes;Clostridia;Clostridiales;Clostridiaceae;Clostridium sensu stricto 8;";"96.0";"18.2";"50";"50";"48";"2";"0";"457133";"373846"
"V4mis1";"SILVA (only NR);Bacteria;Firmicutes;Clostridia;Clostridiales;Clostridiaceae;Clostridium sensu stricto 9;";"100.0";"18.2";"29";"29";"29";"0";"0";"457154";"373865"
"V4mis1";"SILVA (only NR);Bacteria;Firmicutes;Clostridia;Clostridiales;Clostridiaceae;Haloimpatiens;";"100.0";"18.2";"20";"20";"20";"0";"0";"457163";"373874"
"V4mis1";"SILVA (only NR);Bacteria;Firmicutes;Clostridia;Clostridiales;Clostridiaceae;Hathewaya;";"100.0";"18.2";"10";"10";"10";"0";"0";"457173";"373884"
"V4mis1";"SILVA (only NR);Bacteria;Firmicutes;Clostridia;Clostridiales;Clostridiaceae;Oceanirhabdus;";"100.0";"18.2";"3";"3";"3";"0";"0";"457180";"373891"
"V4mis1";"SILVA (only NR);Bacteria;Firmicutes;Clostridia;Clostridiales;Clostridiaceae;Proteiniclasticum;";"92.1";"18.2";"63";"63";"58";"5";"0";"457120";"373836"
"V4mis1";"SILVA (only NR);Bacteria;Firmicutes;Clostridia;Clostridiales;Clostridiaceae;Sarcina;";"93.5";"18.2";"169";"169";"158";"11";"0";"457014";"373736"
"V4mis1";"SILVA (only NR);Bacteria;Firmicutes;Clostridia;Clostridiales;Clostridiaceae;Youngiibacter;";"100.0";"18.2";"9";"9";"9";"0";"0";"457174";"373885"
"V4mis1";"SILVA (only NR);Bacteria;Firmicutes;Clostridia;Clostridiales;Clostridiaceae;uncultured;";"97.2";"18.2";"36";"36";"35";"1";"0";"457147";"373859"
"V4mis1";"SILVA (only NR);Bacteria;Firmicutes;Clostridia;Clostridiales;Oxobacteraceae;";"98.4";"18.2";"62";"62";"61";"1";"0";"457121";"373833"
"V4mis1";"SILVA (only NR);Bacteria;Firmicutes;Clostridia;Clostridiales;Oxobacteraceae;Oxobacter;";"98.4";"18.2";"62";"62";"61";"1";"0";"457121";"373833"
"V4mis1";"SILVA (only NR);Bacteria;Firmicutes;Clostridia;Clostridiales;uncultured;";"97.1";"18.2";"34";"34";"33";"1";"0";"457149";"373861"
"V4mis1";"SILVA (only NR);Bacteria;Firmicutes;Clostridia;Eubacteriales;";"96.4";"18.2";"247";"247";"238";"9";"0";"456936";"373656"
"V4mis1";"SILVA (only NR);Bacteria;Firmicutes;Clostridia;Eubacteriales;Alkalibacteraceae;";"100.0";"18.2";"10";"10";"10";"0";"0";"457173";"373884"
"V4mis1";"SILVA (only NR);Bacteria;Firmicutes;Clostridia;Eubacteriales;Alkalibacteraceae;Alkalibacter;";"100.0";"18.2";"10";"10";"10";"0";"0";"457173";"373884"
"V4mis1";"SILVA (only NR);Bacteria;Firmicutes;Clostridia;Eubacteriales;Alkalibaculum;";"100.0";"18.2";"5";"5";"5";"0";"0";"457178";"373889"
"V4mis1";"SILVA (only NR);Bacteria;Firmicutes;Clostridia;Eubacteriales;Anaerofustaceae;";"100.0";"18.2";"37";"37";"37";"0";"0";"457146";"373857"
"V4mis1";"SILVA (only NR);Bacteria;Firmicutes;Clostridia;Eubacteriales;Anaerofustaceae;Anaerofustis;";"100.0";"18.2";"37";"37";"37";"0";"0";"457146";"373857"
"V4mis1";"SILVA (only NR);Bacteria;Firmicutes;Clostridia;Eubacteriales;Eubacteriaceae;";"94.9";"18.2";"177";"177";"168";"9";"0";"457006";"373726"
"V4mis1";"SILVA (only NR);Bacteria;Firmicutes;Clostridia;Eubacteriales;Eubacteriaceae;Acetobacterium;";"96.7";"18.2";"92";"92";"89";"3";"0";"457091";"373805"
"V4mis1";"SILVA (only NR);Bacteria;Firmicutes;Clostridia;Eubacteriales;Eubacteriaceae;Eubacterium;";"89.3";"18.2";"56";"56";"50";"6";"0";"457127";"373844"
"V4mis1";"SILVA (only NR);Bacteria;Firmicutes;Clostridia;Eubacteriales;Eubacteriaceae;Pseudoramibacter;";"100.0";"18.2";"14";"14";"14";"0";"0";"457169";"373880"
"V4mis1";"SILVA (only NR);Bacteria;Firmicutes;Clostridia;Eubacteriales;Eubacteriaceae;uncultured;";"100.0";"18.2";"14";"14";"14";"0";"0";"457169";"373880"
"V4mis1";"SILVA (only NR);Bacteria;Firmicutes;Clostridia;Eubacteriales;Garciellaceae;";"100.0";"18.2";"18";"18";"18";"0";"0";"457165";"373876"
"V4mis1";"SILVA (only NR);Bacteria;Firmicutes;Clostridia;Eubacteriales;Garciellaceae;Garciella;";"100.0";"18.2";"8";"8";"8";"0";"0";"457175";"373886"
"V4mis1";"SILVA (only NR);Bacteria;Firmicutes;Clostridia;Eubacteriales;Garciellaceae;Irregularibacter;";"100.0";"18.2";"9";"9";"9";"0";"0";"457174";"373885"
"V4mis1";"SILVA (only NR);Bacteria;Firmicutes;Clostridia;Eubacteriales;Garciellaceae;Rhabdanaerobium;";"100.0";"18.2";"1";"1";"1";"0";"0";"457182";"373893"
"V4mis1";"SILVA (only NR);Bacteria;Firmicutes;Clostridia;Gracilibacteraceae;";"94.0";"18.2";"201";"201";"189";"12";"0";"456982";"373705"
"V4mis1";"SILVA (only NR);Bacteria;Firmicutes;Clostridia;Gracilibacteraceae;Gracilibacter;";"88.5";"18.2";"52";"52";"46";"6";"0";"457131";"373848"
"V4mis1";"SILVA (only NR);Bacteria;Firmicutes;Clostridia;Gracilibacteraceae;Lutispora;";"96.9";"18.2";"96";"96";"93";"3";"0";"457087";"373801"
"V4mis1";"SILVA (only NR);Bacteria;Firmicutes;Clostridia;Gracilibacteraceae;uncultured;";"94.2";"18.2";"52";"52";"49";"3";"0";"457131";"373845"
"V4mis1";"SILVA (only NR);Bacteria;Firmicutes;Clostridia;Lachnospirales;";"93.8";"18.9";"23121";"23121";"21698";"1423";"0";"434062";"352196"
"V4mis1";"SILVA (only NR);Bacteria;Firmicutes;Clostridia;Lachnospirales;Defluviitaleaceae;";"97.1";"18.2";"136";"136";"132";"4";"0";"457047";"373762"
"V4mis1";"SILVA (only NR);Bacteria;Firmicutes;Clostridia;Lachnospirales;Defluviitaleaceae;Defluviitalea;";"97.0";"18.2";"33";"33";"32";"1";"0";"457150";"373862"
"V4mis1";"SILVA (only NR);Bacteria;Firmicutes;Clostridia;Lachnospirales;Defluviitaleaceae;Defluviitaleaceae UCG-011;";"97.1";"18.2";"103";"103";"100";"3";"0";"457080";"373794"
"V4mis1";"SILVA (only NR);Bacteria;Firmicutes;Clostridia;Lachnospirales;Lachnospiraceae;";"93.8";"18.9";"22974";"22974";"21556";"1418";"0";"434209";"352338"
"V4mis1";"SILVA (only NR);Bacteria;Firmicutes;Clostridia;Lachnospirales;Lachnospiraceae;28-4;";"100.0";"18.2";"3";"3";"3";"0";"0";"457180";"373891"
"V4mis1";"SILVA (only NR);Bacteria;Firmicutes;Clostridia;Lachnospirales;Lachnospiraceae;A2;";"89.1";"18.2";"175";"175";"156";"19";"0";"457008";"373738"
"V4mis1";"SILVA (only NR);Bacteria;Firmicutes;Clostridia;Lachnospirales;Lachnospiraceae;ASF356;";"96.7";"18.2";"30";"30";"29";"1";"0";"457153";"373865"
"V4mis1";"SILVA (only NR);Bacteria;Firmicutes;Clostridia;Lachnospirales;Lachnospiraceae;Abyssivirga;";"100.0";"18.2";"4";"4";"4";"0";"0";"457179";"373890"
"V4mis1";"SILVA (only NR);Bacteria;Firmicutes;Clostridia;Lachnospirales;Lachnospiraceae;Acetatifactor;";"96.0";"18.2";"25";"25";"24";"1";"0";"457158";"373870"
"V4mis1";"SILVA (only NR);Bacteria;Firmicutes;Clostridia;Lachnospirales;Lachnospiraceae;Acetitomaculum;";"95.1";"18.2";"182";"182";"173";"9";"0";"457001";"373721"
"V4mis1";"SILVA (only NR);Bacteria;Firmicutes;Clostridia;Lachnospirales;Lachnospiraceae;Agathobacter;";"91.8";"18.2";"769";"769";"706";"63";"0";"456414";"373188"
"V4mis1";"SILVA (only NR);Bacteria;Firmicutes;Clostridia;Lachnospirales;Lachnospiraceae;Anaerobium;";"100.0";"18.2";"3";"3";"3";"0";"0";"457180";"373891"
"V4mis1";"SILVA (only NR);Bacteria;Firmicutes;Clostridia;Lachnospirales;Lachnospiraceae;Anaerocolumna;";"93.5";"18.2";"46";"46";"43";"3";"0";"457137";"373851"
"V4mis1";"SILVA (only NR);Bacteria;Firmicutes;Clostridia;Lachnospirales;Lachnospiraceae;Anaerosporobacter;";"91.6";"18.2";"83";"83";"76";"7";"0";"457100";"373818"
"V4mis1";"SILVA (only NR);Bacteria;Firmicutes;Clostridia;Lachnospirales;Lachnospiraceae;Anaerostignum;";"94.6";"18.2";"37";"37";"35";"2";"0";"457146";"373859"
"V4mis1";"SILVA (only NR);Bacteria;Firmicutes;Clostridia;Lachnospirales;Lachnospiraceae;Anaerostipes;";"90.9";"18.2";"483";"483";"439";"44";"0";"456700";"373455"
"V4mis1";"SILVA (only NR);Bacteria;Firmicutes;Clostridia;Lachnospirales;Lachnospiraceae;Blautia;";"94.5";"18.3";"3075";"3075";"2905";"170";"0";"454108";"370989"
"V4mis1";"SILVA (only NR);Bacteria;Firmicutes;Clostridia;Lachnospirales;Lachnospiraceae;Butyrivibrio;";"97.7";"18.2";"303";"303";"296";"7";"0";"456880";"373598"
"V4mis1";"SILVA (only NR);Bacteria;Firmicutes;Clostridia;Lachnospirales;Lachnospiraceae;CAG-56;";"93.3";"18.2";"30";"30";"28";"2";"0";"457153";"373866"
"V4mis1";"SILVA (only NR);Bacteria;Firmicutes;Clostridia;Lachnospirales;Lachnospiraceae;CHKCI001;";"100.0";"18.2";"5";"5";"5";"0";"0";"457178";"373889"
"V4mis1";"SILVA (only NR);Bacteria;Firmicutes;Clostridia;Lachnospirales;Lachnospiraceae;Catenibacillus;";"100.0";"18.2";"8";"8";"8";"0";"0";"457175";"373886"
"V4mis1";"SILVA (only NR);Bacteria;Firmicutes;Clostridia;Lachnospirales;Lachnospiraceae;Catonella;";"96.1";"18.2";"51";"51";"49";"2";"0";"457132";"373845"
"V4mis1";"SILVA (only NR);Bacteria;Firmicutes;Clostridia;Lachnospirales;Lachnospiraceae;Cellulosilyticum;";"100.0";"18.2";"41";"41";"41";"0";"0";"457142";"373853"
"V4mis1";"SILVA (only NR);Bacteria;Firmicutes;Clostridia;Lachnospirales;Lachnospiraceae;Coprococcus;";"94.9";"18.2";"372";"372";"353";"19";"0";"456811";"373541"
"V4mis1";"SILVA (only NR);Bacteria;Firmicutes;Clostridia;Lachnospirales;Lachnospiraceae;Cuneatibacter;";"100.0";"18.2";"1";"1";"1";"0";"0";"457182";"373893"
"V4mis1";"SILVA (only NR);Bacteria;Firmicutes;Clostridia;Lachnospirales;Lachnospiraceae;Dorea;";"91.9";"18.2";"409";"409";"376";"33";"0";"456774";"373518"
"V4mis1";"SILVA (only NR);Bacteria;Firmicutes;Clostridia;Lachnospirales;Lachnospiraceae;Eisenbergiella;";"93.2";"18.2";"74";"74";"69";"5";"0";"457109";"373825"
"V4mis1";"SILVA (only NR);Bacteria;Firmicutes;Clostridia;Lachnospirales;Lachnospiraceae;Epulopiscium;";"93.3";"18.2";"193";"193";"180";"13";"0";"456990";"373714"
"V4mis1";"SILVA (only NR);Bacteria;Firmicutes;Clostridia;Lachnospirales;Lachnospiraceae;FD2005;";"95.5";"18.2";"22";"22";"21";"1";"0";"457161";"373873"
"V4mis1";"SILVA (only NR);Bacteria;Firmicutes;Clostridia;Lachnospirales;Lachnospiraceae;Frisingicoccus;";"93.9";"18.2";"33";"33";"31";"2";"0";"457150";"373863"
"V4mis1";"SILVA (only NR);Bacteria;Firmicutes;Clostridia;Lachnospirales;Lachnospiraceae;Fusicatenibacter;";"93.3";"18.2";"403";"403";"376";"27";"0";"456780";"373518"
"V4mis1";"SILVA (only NR);Bacteria;Firmicutes;Clostridia;Lachnospirales;Lachnospiraceae;GCA-900066575;";"97.2";"18.2";"107";"107";"104";"3";"0";"457076";"373790"
"V4mis1";"SILVA (only NR);Bacteria;Firmicutes;Clostridia;Lachnospirales;Lachnospiraceae;GCA-900066755;";"100.0";"18.2";"6";"6";"6";"0";"0";"457177";"373888"
"V4mis1";"SILVA (only NR);Bacteria;Firmicutes;Clostridia;Lachnospirales;Lachnospiraceae;Herbinix;";"97.8";"18.2";"46";"46";"45";"1";"0";"457137";"373849"
"V4mis1";"SILVA (only NR);Bacteria;Firmicutes;Clostridia;Lachnospirales;Lachnospiraceae;Hespellia;";"100.0";"18.2";"6";"6";"6";"0";"0";"457177";"373888"
"V4mis1";"SILVA (only NR);Bacteria;Firmicutes;Clostridia;Lachnospirales;Lachnospiraceae;Howardella;";"93.3";"18.2";"30";"30";"28";"2";"0";"457153";"373866"
"V4mis1";"SILVA (only NR);Bacteria;Firmicutes;Clostridia;Lachnospirales;Lachnospiraceae;Hungatella;";"86.4";"18.2";"132";"132";"114";"18";"0";"457051";"373780"
"V4mis1";"SILVA (only NR);Bacteria;Firmicutes;Clostridia;Lachnospirales;Lachnospiraceae;Incertae Sedis;";"100.0";"18.2";"12";"12";"12";"0";"0";"457171";"373882"
"V4mis1";"SILVA (only NR);Bacteria;Firmicutes;Clostridia;Lachnospirales;Lachnospiraceae;Johnsonella;";"88.9";"18.2";"36";"36";"32";"4";"0";"457147";"373862"
"V4mis1";"SILVA (only NR);Bacteria;Firmicutes;Clostridia;Lachnospirales;Lachnospiraceae;Lachnoanaerobaculum;";"94.4";"18.2";"54";"54";"51";"3";"0";"457129";"373843"
"V4mis1";"SILVA (only NR);Bacteria;Firmicutes;Clostridia;Lachnospirales;Lachnospiraceae;Lachnobacterium;";"50.0";"18.2";"2";"2";"1";"1";"0";"457181";"373893"
"V4mis1";"SILVA (only NR);Bacteria;Firmicutes;Clostridia;Lachnospirales;Lachnospiraceae;Lachnoclostridium;";"91.4";"18.2";"1418";"1418";"1296";"122";"0";"455765";"372598"
"V4mis1";"SILVA (only NR);Bacteria;Firmicutes;Clostridia;Lachnospirales;Lachnospiraceae;Lachnospira;";"94.3";"18.2";"141";"141";"133";"8";"0";"457042";"373761"
"V4mis1";"SILVA (only NR);Bacteria;Firmicutes;Clostridia;Lachnospirales;Lachnospiraceae;Lachnospiraceae AC2044 group;";"96.7";"18.2";"209";"209";"202";"7";"0";"456974";"373692"
"V4mis1";"SILVA (only NR);Bacteria;Firmicutes;Clostridia;Lachnospirales;Lachnospiraceae;Lachnospiraceae FCS020 group;";"96.8";"18.2";"157";"157";"152";"5";"0";"457026";"373742"
"V4mis1";"SILVA (only NR);Bacteria;Firmicutes;Clostridia;Lachnospirales;Lachnospiraceae;Lachnospiraceae FE2018 group;";"93.3";"18.2";"15";"15";"14";"1";"0";"457168";"373880"
"V4mis1";"SILVA (only NR);Bacteria;Firmicutes;Clostridia;Lachnospirales;Lachnospiraceae;Lachnospiraceae NC2004 group;";"96.5";"18.2";"171";"171";"165";"6";"0";"457012";"373729"
"V4mis1";"SILVA (only NR);Bacteria;Firmicutes;Clostridia;Lachnospirales;Lachnospiraceae;Lachnospiraceae ND3007 group;";"97.1";"18.2";"239";"239";"232";"7";"0";"456944";"373662"
"V4mis1";"SILVA (only NR);Bacteria;Firmicutes;Clostridia;Lachnospirales;Lachnospiraceae;Lachnospiraceae NK3A20 group;";"95.5";"18.2";"359";"359";"343";"16";"0";"456824";"373551"
"V4mis1";"SILVA (only NR);Bacteria;Firmicutes;Clostridia;Lachnospirales;Lachnospiraceae;Lachnospiraceae NK4A136 group;";"93.0";"18.3";"2259";"2259";"2100";"159";"0";"454924";"371794"
"V4mis1";"SILVA (only NR);Bacteria;Firmicutes;Clostridia;Lachnospirales;Lachnospiraceae;Lachnospiraceae NK4B4 group;";"100.0";"18.2";"18";"18";"18";"0";"0";"457165";"373876"
"V4mis1";"SILVA (only NR);Bacteria;Firmicutes;Clostridia;Lachnospirales;Lachnospiraceae;Lachnospiraceae UCG-001;";"93.4";"18.2";"376";"376";"351";"25";"0";"456807";"373543"
"V4mis1";"SILVA (only NR);Bacteria;Firmicutes;Clostridia;Lachnospirales;Lachnospiraceae;Lachnospiraceae UCG-002;";"95.7";"18.2";"23";"23";"22";"1";"0";"457160";"373872"
"V4mis1";"SILVA (only NR);Bacteria;Firmicutes;Clostridia;Lachnospirales;Lachnospiraceae;Lachnospiraceae UCG-003;";"100.0";"18.2";"23";"23";"23";"0";"0";"457160";"373871"
"V4mis1";"SILVA (only NR);Bacteria;Firmicutes;Clostridia;Lachnospirales;Lachnospiraceae;Lachnospiraceae UCG-004;";"96.9";"18.2";"191";"191";"185";"6";"0";"456992";"373709"
"V4mis1";"SILVA (only NR);Bacteria;Firmicutes;Clostridia;Lachnospirales;Lachnospiraceae;Lachnospiraceae UCG-006;";"94.7";"18.2";"188";"188";"178";"10";"0";"456995";"373716"
"V4mis1";"SILVA (only NR);Bacteria;Firmicutes;Clostridia;Lachnospirales;Lachnospiraceae;Lachnospiraceae UCG-007;";"85.7";"18.2";"7";"7";"6";"1";"0";"457176";"373888"
"V4mis1";"SILVA (only NR);Bacteria;Firmicutes;Clostridia;Lachnospirales;Lachnospiraceae;Lachnospiraceae UCG-008;";"96.8";"18.2";"692";"692";"670";"22";"0";"456491";"373224"
"V4mis1";"SILVA (only NR);Bacteria;Firmicutes;Clostridia;Lachnospirales;Lachnospiraceae;Lachnospiraceae UCG-009;";"100.0";"18.2";"27";"27";"27";"0";"0";"457156";"373867"
"V4mis1";"SILVA (only NR);Bacteria;Firmicutes;Clostridia;Lachnospirales;Lachnospiraceae;Lachnospiraceae UCG-010;";"90.0";"18.2";"20";"20";"18";"2";"0";"457163";"373876"
"V4mis1";"SILVA (only NR);Bacteria;Firmicutes;Clostridia;Lachnospirales;Lachnospiraceae;Lachnospiraceae XPB1014 group;";"98.5";"18.2";"204";"204";"201";"3";"0";"456979";"373693"
"V4mis1";"SILVA (only NR);Bacteria;Firmicutes;Clostridia;Lachnospirales;Lachnospiraceae;Lachnotalea;";"83.3";"18.2";"6";"6";"5";"1";"0";"457177";"373889"
"V4mis1";"SILVA (only NR);Bacteria;Firmicutes;Clostridia;Lachnospirales;Lachnospiraceae;Lactonifactor;";"100.0";"18.2";"6";"6";"6";"0";"0";"457177";"373888"
"V4mis1";"SILVA (only NR);Bacteria;Firmicutes;Clostridia;Lachnospirales;Lachnospiraceae;Marvinbryantia;";"97.6";"18.2";"250";"250";"244";"6";"0";"456933";"373650"
"V4mis1";"SILVA (only NR);Bacteria;Firmicutes;Clostridia;Lachnospirales;Lachnospiraceae;Mobilisporobacter;";"100.0";"18.2";"1";"1";"1";"0";"0";"457182";"373893"
"V4mis1";"SILVA (only NR);Bacteria;Firmicutes;Clostridia;Lachnospirales;Lachnospiraceae;Mobilitalea;";"100.0";"18.2";"11";"11";"11";"0";"0";"457172";"373883"
"V4mis1";"SILVA (only NR);Bacteria;Firmicutes;Clostridia;Lachnospirales;Lachnospiraceae;Moryella;";"94.6";"18.2";"56";"56";"53";"3";"0";"457127";"373841"
"V4mis1";"SILVA (only NR);Bacteria;Firmicutes;Clostridia;Lachnospirales;Lachnospiraceae;Murimonas;";"100.0";"18.2";"2";"2";"2";"0";"0";"457181";"373892"
"V4mis1";"SILVA (only NR);Bacteria;Firmicutes;Clostridia;Lachnospirales;Lachnospiraceae;Natranaerovirga;";"100.0";"18.2";"5";"5";"5";"0";"0";"457178";"373889"
"V4mis1";"SILVA (only NR);Bacteria;Firmicutes;Clostridia;Lachnospirales;Lachnospiraceae;Oribacterium;";"97.4";"18.2";"154";"154";"150";"4";"0";"457029";"373744"
"V4mis1";"SILVA (only NR);Bacteria;Firmicutes;Clostridia;Lachnospirales;Lachnospiraceae;Parasporobacterium;";"100.0";"18.2";"1";"1";"1";"0";"0";"457182";"373893"
"V4mis1";"SILVA (only NR);Bacteria;Firmicutes;Clostridia;Lachnospirales;Lachnospiraceae;Pseudobutyrivibrio;";"95.7";"18.2";"116";"116";"111";"5";"0";"457067";"373783"
"V4mis1";"SILVA (only NR);Bacteria;Firmicutes;Clostridia;Lachnospirales;Lachnospiraceae;Robinsoniella;";"100.0";"18.2";"19";"19";"19";"0";"0";"457164";"373875"
"V4mis1";"SILVA (only NR);Bacteria;Firmicutes;Clostridia;Lachnospirales;Lachnospiraceae;Roseburia;";"92.3";"18.3";"1592";"1592";"1470";"122";"0";"455591";"372424"
"V4mis1";"SILVA (only NR);Bacteria;Firmicutes;Clostridia;Lachnospirales;Lachnospiraceae;Sellimonas;";"96.7";"18.2";"30";"30";"29";"1";"0";"457153";"373865"
"V4mis1";"SILVA (only NR);Bacteria;Firmicutes;Clostridia;Lachnospirales;Lachnospiraceae;Shuttleworthia;";"94.9";"18.2";"78";"78";"74";"4";"0";"457105";"373820"
"V4mis1";"SILVA (only NR);Bacteria;Firmicutes;Clostridia;Lachnospirales;Lachnospiraceae;Sporobacterium;";"100.0";"18.2";"1";"1";"1";"0";"0";"457182";"373893"
"V4mis1";"SILVA (only NR);Bacteria;Firmicutes;Clostridia;Lachnospirales;Lachnospiraceae;Stomatobaculum;";"100.0";"18.2";"12";"12";"12";"0";"0";"457171";"373882"
"V4mis1";"SILVA (only NR);Bacteria;Firmicutes;Clostridia;Lachnospirales;Lachnospiraceae;Syntrophococcus;";"92.6";"18.2";"54";"54";"50";"4";"0";"457129";"373844"
"V4mis1";"SILVA (only NR);Bacteria;Firmicutes;Clostridia;Lachnospirales;Lachnospiraceae;Tuzzerella;";"90.9";"18.2";"33";"33";"30";"3";"0";"457150";"373864"
"V4mis1";"SILVA (only NR);Bacteria;Firmicutes;Clostridia;Lachnospirales;Lachnospiraceae;Tyzzerella;";"93.8";"18.2";"389";"389";"365";"24";"0";"456794";"373529"
"V4mis1";"SILVA (only NR);Bacteria;Firmicutes;Clostridia;Lachnospirales;Lachnospiraceae;UC5-1-2E3;";"75.0";"18.2";"4";"4";"3";"1";"0";"457179";"373891"
"V4mis1";"SILVA (only NR);Bacteria;Firmicutes;Clostridia;Lachnospirales;Lachnospiraceae;Vallitalea;";"100.0";"18.2";"13";"13";"13";"0";"0";"457170";"373881"
"V4mis1";"SILVA (only NR);Bacteria;Firmicutes;Clostridia;Lachnospirales;Lachnospiraceae;XBB1006;";"94.1";"18.2";"17";"17";"16";"1";"0";"457166";"373878"
"V4mis1";"SILVA (only NR);Bacteria;Firmicutes;Clostridia;Lachnospirales;Lachnospiraceae;[Acetivibrio] ethanolgignens group;";"100.0";"18.2";"3";"3";"3";"0";"0";"457180";"373891"
"V4mis1";"SILVA (only NR);Bacteria;Firmicutes;Clostridia;Lachnospirales;Lachnospiraceae;[Bacteroides] pectinophilus group;";"100.0";"18.2";"16";"16";"16";"0";"0";"457167";"373878"
"V4mis1";"SILVA (only NR);Bacteria;Firmicutes;Clostridia;Lachnospirales;Lachnospiraceae;[Eubacterium] cellulosolvens group;";"100.0";"18.2";"6";"6";"6";"0";"0";"457177";"373888"
"V4mis1";"SILVA (only NR);Bacteria;Firmicutes;Clostridia;Lachnospirales;Lachnospiraceae;[Eubacterium] eligens group;";"92.1";"18.2";"76";"76";"70";"6";"0";"457107";"373824"
"V4mis1";"SILVA (only NR);Bacteria;Firmicutes;Clostridia;Lachnospirales;Lachnospiraceae;[Eubacterium] fissicatena group;";"93.0";"18.2";"43";"43";"40";"3";"0";"457140";"373854"
"V4mis1";"SILVA (only NR);Bacteria;Firmicutes;Clostridia;Lachnospirales;Lachnospiraceae;[Eubacterium] hallii group;";"95.5";"18.2";"448";"448";"428";"20";"0";"456735";"373466"
"V4mis1";"SILVA (only NR);Bacteria;Firmicutes;Clostridia;Lachnospirales;Lachnospiraceae;[Eubacterium] oxidoreducens group;";"97.6";"18.2";"124";"124";"121";"3";"0";"457059";"373773"
"V4mis1";"SILVA (only NR);Bacteria;Firmicutes;Clostridia;Lachnospirales;Lachnospiraceae;[Eubacterium] ruminantium group;";"99.4";"18.2";"160";"160";"159";"1";"0";"457023";"373735"
"V4mis1";"SILVA (only NR);Bacteria;Firmicutes;Clostridia;Lachnospirales;Lachnospiraceae;[Eubacterium] ventriosum group;";"92.9";"18.2";"113";"113";"105";"8";"0";"457070";"373789"
"V4mis1";"SILVA (only NR);Bacteria;Firmicutes;Clostridia;Lachnospirales;Lachnospiraceae;[Eubacterium] xylanophilum group;";"94.5";"18.2";"164";"164";"155";"9";"0";"457019";"373739"
"V4mis1";"SILVA (only NR);Bacteria;Firmicutes;Clostridia;Lachnospirales;Lachnospiraceae;[Ruminococcus] gauvreauii group;";"95.2";"18.2";"331";"331";"315";"16";"0";"456852";"373579"
"V4mis1";"SILVA (only NR);Bacteria;Firmicutes;Clostridia;Lachnospirales;Lachnospiraceae;[Ruminococcus] gnavus group;";"89.2";"18.2";"250";"250";"223";"27";"0";"456933";"373671"
"V4mis1";"SILVA (only NR);Bacteria;Firmicutes;Clostridia;Lachnospirales;Lachnospiraceae;[Ruminococcus] torques group;";"93.5";"18.2";"848";"848";"793";"55";"0";"456335";"373101"
"V4mis1";"SILVA (only NR);Bacteria;Firmicutes;Clostridia;Lachnospirales;Lachnospiraceae;possible genus Sk003-Sk004;";"77.8";"18.2";"9";"9";"7";"2";"0";"457174";"373887"
"V4mis1";"SILVA (only NR);Bacteria;Firmicutes;Clostridia;Lachnospirales;Lachnospiraceae;possible genus Sk018;";"100.0";"18.2";"4";"4";"4";"0";"0";"457179";"373890"
"V4mis1";"SILVA (only NR);Bacteria;Firmicutes;Clostridia;Lachnospirales;Lachnospiraceae;probable genus 10;";"100.0";"18.2";"36";"36";"36";"0";"0";"457147";"373858"
"V4mis1";"SILVA (only NR);Bacteria;Firmicutes;Clostridia;Lachnospirales;Lachnospiraceae;uncultured;";"93.4";"18.3";"3415";"3415";"3191";"224";"0";"453768";"370703"
"V4mis1";"SILVA (only NR);Bacteria;Firmicutes;Clostridia;Lachnospirales;uncultured;";"100.0";"18.2";"9";"9";"9";"0";"0";"457174";"373885"
"V4mis1";"SILVA (only NR);Bacteria;Firmicutes;Clostridia;MAT-CR-H4-C10;";"100.0";"18.2";"4";"4";"4";"0";"0";"457179";"373890"
"V4mis1";"SILVA (only NR);Bacteria;Firmicutes;Clostridia;Monoglobales;";"96.6";"18.2";"351";"351";"339";"12";"0";"456832";"373555"
"V4mis1";"SILVA (only NR);Bacteria;Firmicutes;Clostridia;Monoglobales;Monoglobaceae;";"96.6";"18.2";"351";"351";"339";"12";"0";"456832";"373555"
"V4mis1";"SILVA (only NR);Bacteria;Firmicutes;Clostridia;Monoglobales;Monoglobaceae;Monoglobus;";"96.6";"18.2";"351";"351";"339";"12";"0";"456832";"373555"
"V4mis1";"SILVA (only NR);Bacteria;Firmicutes;Clostridia;Oscillospirales;";"95.2";"18.6";"14250";"14250";"13561";"689";"0";"442933";"360333"
"V4mis1";"SILVA (only NR);Bacteria;Firmicutes;Clostridia;Oscillospirales;Butyricicoccaceae;";"92.1";"18.2";"316";"316";"291";"25";"0";"456867";"373603"
"V4mis1";"SILVA (only NR);Bacteria;Firmicutes;Clostridia;Oscillospirales;Butyricicoccaceae;Butyricicoccus;";"90.0";"18.2";"180";"180";"162";"18";"0";"457003";"373732"
"V4mis1";"SILVA (only NR);Bacteria;Firmicutes;Clostridia;Oscillospirales;Butyricicoccaceae;UCG-008;";"100.0";"18.2";"31";"31";"31";"0";"0";"457152";"373863"
"V4mis1";"SILVA (only NR);Bacteria;Firmicutes;Clostridia;Oscillospirales;Butyricicoccaceae;UCG-009;";"92.8";"18.2";"97";"97";"90";"7";"0";"457086";"373804"
"V4mis1";"SILVA (only NR);Bacteria;Firmicutes;Clostridia;Oscillospirales;Butyricicoccaceae;uncultured;";"100.0";"18.2";"8";"8";"8";"0";"0";"457175";"373886"
"V4mis1";"SILVA (only NR);Bacteria;Firmicutes;Clostridia;Oscillospirales;Ethanoligenenaceae;";"95.7";"18.2";"47";"47";"45";"2";"0";"457136";"373849"
"V4mis1";"SILVA (only NR);Bacteria;Firmicutes;Clostridia;Oscillospirales;Ethanoligenenaceae;Acetanaerobacterium;";"90.0";"18.2";"10";"10";"9";"1";"0";"457173";"373885"
"V4mis1";"SILVA (only NR);Bacteria;Firmicutes;Clostridia;Oscillospirales;Ethanoligenenaceae;Ethanoligenens;";"100.0";"18.2";"11";"11";"11";"0";"0";"457172";"373883"
"V4mis1";"SILVA (only NR);Bacteria;Firmicutes;Clostridia;Oscillospirales;Ethanoligenenaceae;Incertae Sedis;";"95.7";"18.2";"23";"23";"22";"1";"0";"457160";"373872"
"V4mis1";"SILVA (only NR);Bacteria;Firmicutes;Clostridia;Oscillospirales;Ethanoligenenaceae;uncultured;";"100.0";"18.2";"2";"2";"2";"0";"0";"457181";"373892"
"V4mis1";"SILVA (only NR);Bacteria;Firmicutes;Clostridia;Oscillospirales;Hungateiclostridiaceae;";"95.5";"18.3";"1418";"1418";"1354";"64";"0";"455765";"372540"
"V4mis1";"SILVA (only NR);Bacteria;Firmicutes;Clostridia;Oscillospirales;Hungateiclostridiaceae;Acetivibrio;";"100.0";"18.2";"28";"28";"28";"0";"0";"457155";"373866"
"V4mis1";"SILVA (only NR);Bacteria;Firmicutes;Clostridia;Oscillospirales;Hungateiclostridiaceae;Anaerobacterium;";"100.0";"18.2";"13";"13";"13";"0";"0";"457170";"373881"
"V4mis1";"SILVA (only NR);Bacteria;Firmicutes;Clostridia;Oscillospirales;Hungateiclostridiaceae;Cellulosibacter;";"100.0";"18.2";"2";"2";"2";"0";"0";"457181";"373892"
"V4mis1";"SILVA (only NR);Bacteria;Firmicutes;Clostridia;Oscillospirales;Hungateiclostridiaceae;Ercella;";"100.0";"18.2";"35";"35";"35";"0";"0";"457148";"373859"
"V4mis1";"SILVA (only NR);Bacteria;Firmicutes;Clostridia;Oscillospirales;Hungateiclostridiaceae;Fastidiosipila;";"94.1";"18.2";"290";"290";"273";"17";"0";"456893";"373621"
"V4mis1";"SILVA (only NR);Bacteria;Firmicutes;Clostridia;Oscillospirales;Hungateiclostridiaceae;HN-HF0106;";"97.5";"18.2";"80";"80";"78";"2";"0";"457103";"373816"
"V4mis1";"SILVA (only NR);Bacteria;Firmicutes;Clostridia;Oscillospirales;Hungateiclostridiaceae;Hungateiclostridium;";"92.0";"18.2";"25";"25";"23";"2";"0";"457158";"373871"
"V4mis1";"SILVA (only NR);Bacteria;Firmicutes;Clostridia;Oscillospirales;Hungateiclostridiaceae;Mageeibacillus;";"100.0";"18.2";"9";"9";"9";"0";"0";"457174";"373885"
"V4mis1";"SILVA (only NR);Bacteria;Firmicutes;Clostridia;Oscillospirales;Hungateiclostridiaceae;Pseudobacteroides;";"100.0";"18.2";"9";"9";"9";"0";"0";"457174";"373885"
"V4mis1";"SILVA (only NR);Bacteria;Firmicutes;Clostridia;Oscillospirales;Hungateiclostridiaceae;Pseudoclostridium;";"92.9";"18.2";"14";"14";"13";"1";"0";"457169";"373881"
"V4mis1";"SILVA (only NR);Bacteria;Firmicutes;Clostridia;Oscillospirales;Hungateiclostridiaceae;Ruminiclostridium;";"98.1";"18.2";"263";"263";"258";"5";"0";"456920";"373636"
"V4mis1";"SILVA (only NR);Bacteria;Firmicutes;Clostridia;Oscillospirales;Hungateiclostridiaceae;Saccharofermentans;";"93.0";"18.2";"201";"201";"187";"14";"0";"456982";"373707"
"V4mis1";"SILVA (only NR);Bacteria;Firmicutes;Clostridia;Oscillospirales;Hungateiclostridiaceae;Thermoclostridium;";"95.7";"18.2";"23";"23";"22";"1";"0";"457160";"373872"
"V4mis1";"SILVA (only NR);Bacteria;Firmicutes;Clostridia;Oscillospirales;Hungateiclostridiaceae;UCG-012;";"87.0";"18.2";"77";"77";"67";"10";"0";"457106";"373827"
"V4mis1";"SILVA (only NR);Bacteria;Firmicutes;Clostridia;Oscillospirales;Hungateiclostridiaceae;uncultured;";"96.5";"18.2";"344";"344";"332";"12";"0";"456839";"373562"
"V4mis1";"SILVA (only NR);Bacteria;Firmicutes;Clostridia;Oscillospirales;Hydrogenoanaerobacterium;";"100.0";"18.2";"27";"27";"27";"0";"0";"457156";"373867"
"V4mis1";"SILVA (only NR);Bacteria;Firmicutes;Clostridia;Oscillospirales;Oscillospiraceae;";"95.8";"18.4";"4400";"4400";"4213";"187";"0";"452783";"369681"
"V4mis1";"SILVA (only NR);Bacteria;Firmicutes;Clostridia;Oscillospirales;Oscillospiraceae;Colidextribacter;";"95.6";"18.2";"384";"384";"367";"17";"0";"456799";"373527"
"V4mis1";"SILVA (only NR);Bacteria;Firmicutes;Clostridia;Oscillospirales;Oscillospiraceae;Flavonifractor;";"93.8";"18.2";"48";"48";"45";"3";"0";"457135";"373849"
"V4mis1";"SILVA (only NR);Bacteria;Firmicutes;Clostridia;Oscillospirales;Oscillospiraceae;Intestinimonas;";"97.7";"18.2";"43";"43";"42";"1";"0";"457140";"373852"
"V4mis1";"SILVA (only NR);Bacteria;Firmicutes;Clostridia;Oscillospirales;Oscillospiraceae;NK4A214 group;";"96.4";"18.2";"687";"687";"662";"25";"0";"456496";"373232"
"V4mis1";"SILVA (only NR);Bacteria;Firmicutes;Clostridia;Oscillospirales;Oscillospiraceae;Oscillibacter;";"92.9";"18.2";"268";"268";"249";"19";"0";"456915";"373645"
"V4mis1";"SILVA (only NR);Bacteria;Firmicutes;Clostridia;Oscillospirales;Oscillospiraceae;Oscillospira;";"100.0";"18.2";"29";"29";"29";"0";"0";"457154";"373865"
"V4mis1";"SILVA (only NR);Bacteria;Firmicutes;Clostridia;Oscillospirales;Oscillospiraceae;Papillibacter;";"100.0";"18.2";"73";"73";"73";"0";"0";"457110";"373821"
"V4mis1";"SILVA (only NR);Bacteria;Firmicutes;Clostridia;Oscillospirales;Oscillospiraceae;Pseudoflavonifractor;";"100.0";"18.2";"4";"4";"4";"0";"0";"457179";"373890"
"V4mis1";"SILVA (only NR);Bacteria;Firmicutes;Clostridia;Oscillospirales;Oscillospiraceae;Sporobacter;";"100.0";"18.2";"14";"14";"14";"0";"0";"457169";"373880"
"V4mis1";"SILVA (only NR);Bacteria;Firmicutes;Clostridia;Oscillospirales;Oscillospiraceae;UCG-002;";"95.3";"18.2";"511";"511";"487";"24";"0";"456672";"373407"
"V4mis1";"SILVA (only NR);Bacteria;Firmicutes;Clostridia;Oscillospirales;Oscillospiraceae;UCG-003;";"91.5";"18.2";"71";"71";"65";"6";"0";"457112";"373829"
"V4mis1";"SILVA (only NR);Bacteria;Firmicutes;Clostridia;Oscillospirales;Oscillospiraceae;UCG-005;";"95.9";"18.3";"1479";"1479";"1419";"60";"0";"455704";"372475"
"V4mis1";"SILVA (only NR);Bacteria;Firmicutes;Clostridia;Oscillospirales;Oscillospiraceae;UCG-007;";"100.0";"18.2";"8";"8";"8";"0";"0";"457175";"373886"
"V4mis1";"SILVA (only NR);Bacteria;Firmicutes;Clostridia;Oscillospirales;Oscillospiraceae;V9D2013 group;";"93.5";"18.2";"31";"31";"29";"2";"0";"457152";"373865"
"V4mis1";"SILVA (only NR);Bacteria;Firmicutes;Clostridia;Oscillospirales;Oscillospiraceae;uncultured;";"96.0";"18.2";"741";"741";"711";"30";"0";"456442";"373183"
"V4mis1";"SILVA (only NR);Bacteria;Firmicutes;Clostridia;Oscillospirales;Ruminococcaceae;";"94.3";"18.4";"5875";"5875";"5538";"337";"0";"451308";"368356"
"V4mis1";"SILVA (only NR);Bacteria;Firmicutes;Clostridia;Oscillospirales;Ruminococcaceae;Anaerofilum;";"100.0";"18.2";"20";"20";"20";"0";"0";"457163";"373874"
"V4mis1";"SILVA (only NR);Bacteria;Firmicutes;Clostridia;Oscillospirales;Ruminococcaceae;Anaerotruncus;";"94.1";"18.2";"51";"51";"48";"3";"0";"457132";"373846"
"V4mis1";"SILVA (only NR);Bacteria;Firmicutes;Clostridia;Oscillospirales;Ruminococcaceae;Angelakisella;";"100.0";"18.2";"4";"4";"4";"0";"0";"457179";"373890"
"V4mis1";"SILVA (only NR);Bacteria;Firmicutes;Clostridia;Oscillospirales;Ruminococcaceae;CAG-352;";"90.4";"18.2";"73";"73";"66";"7";"0";"457110";"373828"
"V4mis1";"SILVA (only NR);Bacteria;Firmicutes;Clostridia;Oscillospirales;Ruminococcaceae;Candidatus Soleaferrea;";"97.9";"18.2";"146";"146";"143";"3";"0";"457037";"373751"
"V4mis1";"SILVA (only NR);Bacteria;Firmicutes;Clostridia;Oscillospirales;Ruminococcaceae;Caproiciproducens;";"92.7";"18.2";"109";"109";"101";"8";"0";"457074";"373793"
"V4mis1";"SILVA (only NR);Bacteria;Firmicutes;Clostridia;Oscillospirales;Ruminococcaceae;DTU089;";"90.0";"18.2";"10";"10";"9";"1";"0";"457173";"373885"
"V4mis1";"SILVA (only NR);Bacteria;Firmicutes;Clostridia;Oscillospirales;Ruminococcaceae;Faecalibacterium;";"92.2";"18.3";"1930";"1930";"1780";"150";"0";"455253";"372114"
"V4mis1";"SILVA (only NR);Bacteria;Firmicutes;Clostridia;Oscillospirales;Ruminococcaceae;Fournierella;";"96.8";"18.2";"31";"31";"30";"1";"0";"457152";"373864"
"V4mis1";"SILVA (only NR);Bacteria;Firmicutes;Clostridia;Oscillospirales;Ruminococcaceae;Harryflintia;";"90.9";"18.2";"11";"11";"10";"1";"0";"457172";"373884"
"V4mis1";"SILVA (only NR);Bacteria;Firmicutes;Clostridia;Oscillospirales;Ruminococcaceae;Incertae Sedis;";"96.1";"18.2";"335";"335";"322";"13";"0";"456848";"373572"
"V4mis1";"SILVA (only NR);Bacteria;Firmicutes;Clostridia;Oscillospirales;Ruminococcaceae;Negativibacillus;";"100.0";"18.2";"62";"62";"62";"0";"0";"457121";"373832"
"V4mis1";"SILVA (only NR);Bacteria;Firmicutes;Clostridia;Oscillospirales;Ruminococcaceae;Paludicola;";"100.0";"18.2";"29";"29";"29";"0";"0";"457154";"373865"
"V4mis1";"SILVA (only NR);Bacteria;Firmicutes;Clostridia;Oscillospirales;Ruminococcaceae;Phocea;";"75.0";"18.2";"4";"4";"3";"1";"0";"457179";"373891"
"V4mis1";"SILVA (only NR);Bacteria;Firmicutes;Clostridia;Oscillospirales;Ruminococcaceae;Pygmaiobacter;";"100.0";"18.2";"13";"13";"13";"0";"0";"457170";"373881"
"V4mis1";"SILVA (only NR);Bacteria;Firmicutes;Clostridia;Oscillospirales;Ruminococcaceae;Ruminococcus;";"94.6";"18.3";"1437";"1437";"1360";"77";"0";"455746";"372534"
"V4mis1";"SILVA (only NR);Bacteria;Firmicutes;Clostridia;Oscillospirales;Ruminococcaceae;Subdoligranulum;";"96.5";"18.2";"741";"741";"715";"26";"0";"456442";"373179"
"V4mis1";"SILVA (only NR);Bacteria;Firmicutes;Clostridia;Oscillospirales;Ruminococcaceae;UBA1819;";"92.5";"18.2";"40";"40";"37";"3";"0";"457143";"373857"
"V4mis1";"SILVA (only NR);Bacteria;Firmicutes;Clostridia;Oscillospirales;Ruminococcaceae;UCG-001;";"93.8";"18.2";"16";"16";"15";"1";"0";"457167";"373879"
"V4mis1";"SILVA (only NR);Bacteria;Firmicutes;Clostridia;Oscillospirales;Ruminococcaceae;[Eubacterium] siraeum group;";"87.7";"18.2";"73";"73";"64";"9";"0";"457110";"373830"
"V4mis1";"SILVA (only NR);Bacteria;Firmicutes;Clostridia;Oscillospirales;Ruminococcaceae;uncultured;";"95.5";"18.2";"649";"649";"620";"29";"0";"456534";"373274"
"V4mis1";"SILVA (only NR);Bacteria;Firmicutes;Clostridia;Oscillospirales;UCG-010;";"96.3";"18.2";"838";"838";"807";"31";"0";"456345";"373087"
"V4mis1";"SILVA (only NR);Bacteria;Firmicutes;Clostridia;Oscillospirales;UCG-011;";"98.7";"18.2";"79";"79";"78";"1";"0";"457104";"373816"
"V4mis1";"SILVA (only NR);Bacteria;Firmicutes;Clostridia;Oscillospirales;[Clostridium] methylpentosum group;";"95.7";"18.2";"23";"23";"22";"1";"0";"457160";"373872"
"V4mis1";"SILVA (only NR);Bacteria;Firmicutes;Clostridia;Oscillospirales;[Eubacterium] coprostanoligenes group;";"97.0";"18.3";"1058";"1058";"1026";"32";"0";"456125";"372868"
"V4mis1";"SILVA (only NR);Bacteria;Firmicutes;Clostridia;Oscillospirales;uncultured;";"94.6";"18.2";"167";"167";"158";"9";"0";"457016";"373736"
"V4mis1";"SILVA (only NR);Bacteria;Firmicutes;Clostridia;Peptococcales;";"94.8";"18.2";"229";"229";"217";"12";"0";"456954";"373677"
"V4mis1";"SILVA (only NR);Bacteria;Firmicutes;Clostridia;Peptococcales;Peptococcaceae;";"94.8";"18.2";"229";"229";"217";"12";"0";"456954";"373677"
"V4mis1";"SILVA (only NR);Bacteria;Firmicutes;Clostridia;Peptococcales;Peptococcaceae;Dehalobacterium;";"100.0";"18.2";"9";"9";"9";"0";"0";"457174";"373885"
"V4mis1";"SILVA (only NR);Bacteria;Firmicutes;Clostridia;Peptococcales;Peptococcaceae;Desulfitispora;";"100.0";"18.2";"4";"4";"4";"0";"0";"457179";"373890"
"V4mis1";"SILVA (only NR);Bacteria;Firmicutes;Clostridia;Peptococcales;Peptococcaceae;Desulfonispora;";"100.0";"18.2";"2";"2";"2";"0";"0";"457181";"373892"
"V4mis1";"SILVA (only NR);Bacteria;Firmicutes;Clostridia;Peptococcales;Peptococcaceae;Peptococcus;";"98.0";"18.2";"51";"51";"50";"1";"0";"457132";"373844"
"V4mis1";"SILVA (only NR);Bacteria;Firmicutes;Clostridia;Peptococcales;Peptococcaceae;uncultured;";"93.2";"18.2";"162";"162";"151";"11";"0";"457021";"373743"
"V4mis1";"SILVA (only NR);Bacteria;Firmicutes;Clostridia;Peptostreptococcales-Tissierellales;";"93.8";"18.3";"4931";"4931";"4623";"308";"0";"452252";"369271"
"V4mis1";"SILVA (only NR);Bacteria;Firmicutes;Clostridia;Peptostreptococcales-Tissierellales;Acidaminobacteraceae;";"100.0";"18.2";"49";"49";"49";"0";"0";"457134";"373845"
"V4mis1";"SILVA (only NR);Bacteria;Firmicutes;Clostridia;Peptostreptococcales-Tissierellales;Acidaminobacteraceae;Acidaminobacter;";"100.0";"18.2";"49";"49";"49";"0";"0";"457134";"373845"
"V4mis1";"SILVA (only NR);Bacteria;Firmicutes;Clostridia;Peptostreptococcales-Tissierellales;Alkaliphilus;";"94.3";"18.2";"70";"70";"66";"4";"0";"457113";"373828"
"V4mis1";"SILVA (only NR);Bacteria;Firmicutes;Clostridia;Peptostreptococcales-Tissierellales;Anaeromicrobium;";"100.0";"18.2";"8";"8";"8";"0";"0";"457175";"373886"
"V4mis1";"SILVA (only NR);Bacteria;Firmicutes;Clostridia;Peptostreptococcales-Tissierellales;Anaerovirgula;";"100.0";"18.2";"2";"2";"2";"0";"0";"457181";"373892"
"V4mis1";"SILVA (only NR);Bacteria;Firmicutes;Clostridia;Peptostreptococcales-Tissierellales;Anaerovoracaceae;";"95.8";"18.2";"1018";"1018";"975";"43";"0";"456165";"372919"
"V4mis1";"SILVA (only NR);Bacteria;Firmicutes;Clostridia;Peptostreptococcales-Tissierellales;Anaerovoracaceae;Amnipila;";"100.0";"18.2";"20";"20";"20";"0";"0";"457163";"373874"
"V4mis1";"SILVA (only NR);Bacteria;Firmicutes;Clostridia;Peptostreptococcales-Tissierellales;Anaerovoracaceae;Anaerovorax;";"97.2";"18.2";"217";"217";"211";"6";"0";"456966";"373683"
"V4mis1";"SILVA (only NR);Bacteria;Firmicutes;Clostridia;Peptostreptococcales-Tissierellales;Anaerovoracaceae;Family XIII AD3011 group;";"94.0";"18.2";"183";"183";"172";"11";"0";"457000";"373722"
"V4mis1";"SILVA (only NR);Bacteria;Firmicutes;Clostridia;Peptostreptococcales-Tissierellales;Anaerovoracaceae;Family XIII UCG-001;";"100.0";"18.2";"37";"37";"37";"0";"0";"457146";"373857"
"V4mis1";"SILVA (only NR);Bacteria;Firmicutes;Clostridia;Peptostreptococcales-Tissierellales;Anaerovoracaceae;Mogibacterium;";"95.5";"18.2";"178";"178";"170";"8";"0";"457005";"373724"
"V4mis1";"SILVA (only NR);Bacteria;Firmicutes;Clostridia;Peptostreptococcales-Tissierellales;Anaerovoracaceae;S5-A14a;";"96.0";"18.2";"25";"25";"24";"1";"0";"457158";"373870"
"V4mis1";"SILVA (only NR);Bacteria;Firmicutes;Clostridia;Peptostreptococcales-Tissierellales;Anaerovoracaceae;[Eubacterium] brachy group;";"97.3";"18.2";"74";"74";"72";"2";"0";"457109";"373822"
"V4mis1";"SILVA (only NR);Bacteria;Firmicutes;Clostridia;Peptostreptococcales-Tissierellales;Anaerovoracaceae;[Eubacterium] nodatum group;";"93.4";"18.2";"167";"167";"156";"11";"0";"457016";"373738"
"V4mis1";"SILVA (only NR);Bacteria;Firmicutes;Clostridia;Peptostreptococcales-Tissierellales;Anaerovoracaceae;[Eubacterium] saphenum group;";"88.9";"18.2";"9";"9";"8";"1";"0";"457174";"373886"
"V4mis1";"SILVA (only NR);Bacteria;Firmicutes;Clostridia;Peptostreptococcales-Tissierellales;Anaerovoracaceae;uncultured;";"97.1";"18.2";"104";"104";"101";"3";"0";"457079";"373793"
"V4mis1";"SILVA (only NR);Bacteria;Firmicutes;Clostridia;Peptostreptococcales-Tissierellales;Anoxynatronum;";"93.8";"18.2";"16";"16";"15";"1";"0";"457167";"373879"
"V4mis1";"SILVA (only NR);Bacteria;Firmicutes;Clostridia;Peptostreptococcales-Tissierellales;Brassicibacter;";"93.3";"18.2";"15";"15";"14";"1";"0";"457168";"373880"
"V4mis1";"SILVA (only NR);Bacteria;Firmicutes;Clostridia;Peptostreptococcales-Tissierellales;Caldisalinibacter;";"100.0";"18.2";"1";"1";"1";"0";"0";"457182";"373893"
"V4mis1";"SILVA (only NR);Bacteria;Firmicutes;Clostridia;Peptostreptococcales-Tissierellales;Caloranaerobacter;";"100.0";"18.2";"17";"17";"17";"0";"0";"457166";"373877"
"V4mis1";"SILVA (only NR);Bacteria;Firmicutes;Clostridia;Peptostreptococcales-Tissierellales;Caminicellaceae;";"84.7";"18.2";"59";"59";"50";"9";"0";"457124";"373844"
"V4mis1";"SILVA (only NR);Bacteria;Firmicutes;Clostridia;Peptostreptococcales-Tissierellales;Caminicellaceae;Caminicella;";"79.5";"18.2";"39";"39";"31";"8";"0";"457144";"373863"
"V4mis1";"SILVA (only NR);Bacteria;Firmicutes;Clostridia;Peptostreptococcales-Tissierellales;Caminicellaceae;Paramaledivibacter;";"95.0";"18.2";"20";"20";"19";"1";"0";"457163";"373875"
"V4mis1";"SILVA (only NR);Bacteria;Firmicutes;Clostridia;Peptostreptococcales-Tissierellales;Clostridiisalibacter;";"96.7";"18.2";"30";"30";"29";"1";"0";"457153";"373865"
"V4mis1";"SILVA (only NR);Bacteria;Firmicutes;Clostridia;Peptostreptococcales-Tissierellales;Clostridium sensu stricto;";"92.3";"18.2";"13";"13";"12";"1";"0";"457170";"373882"
"V4mis1";"SILVA (only NR);Bacteria;Firmicutes;Clostridia;Peptostreptococcales-Tissierellales;Dethiosulfatibacteraceae;";"100.0";"18.2";"37";"37";"37";"0";"0";"457146";"373857"
"V4mis1";"SILVA (only NR);Bacteria;Firmicutes;Clostridia;Peptostreptococcales-Tissierellales;Dethiosulfatibacteraceae;Dethiosulfatibacter;";"100.0";"18.2";"37";"37";"37";"0";"0";"457146";"373857"
"V4mis1";"SILVA (only NR);Bacteria;Firmicutes;Clostridia;Peptostreptococcales-Tissierellales;Family XI;";"92.3";"18.3";"1632";"1632";"1506";"126";"0";"455551";"372388"
"V4mis1";"SILVA (only NR);Bacteria;Firmicutes;Clostridia;Peptostreptococcales-Tissierellales;Family XI;Anaerococcus;";"93.1";"18.2";"496";"496";"462";"34";"0";"456687";"373432"
"V4mis1";"SILVA (only NR);Bacteria;Firmicutes;Clostridia;Peptostreptococcales-Tissierellales;Family XI;Anaerosalibacter;";"84.2";"18.2";"19";"19";"16";"3";"0";"457164";"373878"
"V4mis1";"SILVA (only NR);Bacteria;Firmicutes;Clostridia;Peptostreptococcales-Tissierellales;Family XI;Anaerosphaera;";"100.0";"18.2";"3";"3";"3";"0";"0";"457180";"373891"
"V4mis1";"SILVA (only NR);Bacteria;Firmicutes;Clostridia;Peptostreptococcales-Tissierellales;Family XI;Ezakiella;";"80.6";"18.2";"36";"36";"29";"7";"0";"457147";"373865"
"V4mis1";"SILVA (only NR);Bacteria;Firmicutes;Clostridia;Peptostreptococcales-Tissierellales;Family XI;Fenollaria;";"87.0";"18.2";"54";"54";"47";"7";"0";"457129";"373847"
"V4mis1";"SILVA (only NR);Bacteria;Firmicutes;Clostridia;Peptostreptococcales-Tissierellales;Family XI;Finegoldia;";"85.1";"18.2";"161";"161";"137";"24";"0";"457022";"373757"
"V4mis1";"SILVA (only NR);Bacteria;Firmicutes;Clostridia;Peptostreptococcales-Tissierellales;Family XI;Gallicola;";"89.3";"18.2";"28";"28";"25";"3";"0";"457155";"373869"
"V4mis1";"SILVA (only NR);Bacteria;Firmicutes;Clostridia;Peptostreptococcales-Tissierellales;Family XI;Helcococcus;";"97.1";"18.2";"68";"68";"66";"2";"0";"457115";"373828"
"V4mis1";"SILVA (only NR);Bacteria;Firmicutes;Clostridia;Peptostreptococcales-Tissierellales;Family XI;Keratinibaculum;";"75.0";"18.2";"8";"8";"6";"2";"0";"457175";"373888"
"V4mis1";"SILVA (only NR);Bacteria;Firmicutes;Clostridia;Peptostreptococcales-Tissierellales;Family XI;Murdochiella;";"95.2";"18.2";"21";"21";"20";"1";"0";"457162";"373874"
"V4mis1";"SILVA (only NR);Bacteria;Firmicutes;Clostridia;Peptostreptococcales-Tissierellales;Family XI;Parvimonas;";"92.6";"18.2";"94";"94";"87";"7";"0";"457089";"373807"
"V4mis1";"SILVA (only NR);Bacteria;Firmicutes;Clostridia;Peptostreptococcales-Tissierellales;Family XI;Peptoniphilus;";"92.1";"18.2";"203";"203";"187";"16";"0";"456980";"373707"
"V4mis1";"SILVA (only NR);Bacteria;Firmicutes;Clostridia;Peptostreptococcales-Tissierellales;Family XI;Soehngenia;";"84.8";"18.2";"33";"33";"28";"5";"0";"457150";"373866"
"V4mis1";"SILVA (only NR);Bacteria;Firmicutes;Clostridia;Peptostreptococcales-Tissierellales;Family XI;Sporanaerobacter;";"88.9";"18.2";"27";"27";"24";"3";"0";"457156";"373870"
"V4mis1";"SILVA (only NR);Bacteria;Firmicutes;Clostridia;Peptostreptococcales-Tissierellales;Family XI;Tepidimicrobium;";"97.3";"18.2";"75";"75";"73";"2";"0";"457108";"373821"
"V4mis1";"SILVA (only NR);Bacteria;Firmicutes;Clostridia;Peptostreptococcales-Tissierellales;Family XI;Tissierella;";"93.8";"18.2";"162";"162";"152";"10";"0";"457021";"373742"
"V4mis1";"SILVA (only NR);Bacteria;Firmicutes;Clostridia;Peptostreptococcales-Tissierellales;Family XI;W5053;";"100.0";"18.2";"86";"86";"86";"0";"0";"457097";"373808"
"V4mis1";"SILVA (only NR);Bacteria;Firmicutes;Clostridia;Peptostreptococcales-Tissierellales;Family XI;uncultured;";"100.0";"18.2";"50";"50";"50";"0";"0";"457133";"373844"
"V4mis1";"SILVA (only NR);Bacteria;Firmicutes;Clostridia;Peptostreptococcales-Tissierellales;Fusibacteraceae;";"95.8";"18.2";"331";"331";"317";"14";"0";"456852";"373577"
"V4mis1";"SILVA (only NR);Bacteria;Firmicutes;Clostridia;Peptostreptococcales-Tissierellales;Fusibacteraceae;Fusibacter;";"95.8";"18.2";"331";"331";"317";"14";"0";"456852";"373577"
"V4mis1";"SILVA (only NR);Bacteria;Firmicutes;Clostridia;Peptostreptococcales-Tissierellales;GoM-GC232-4463-Bac1;";"71.4";"18.2";"7";"7";"5";"2";"0";"457176";"373889"
"V4mis1";"SILVA (only NR);Bacteria;Firmicutes;Clostridia;Peptostreptococcales-Tissierellales;Gottschalkia;";"100.0";"18.2";"13";"13";"13";"0";"0";"457170";"373881"
"V4mis1";"SILVA (only NR);Bacteria;Firmicutes;Clostridia;Peptostreptococcales-Tissierellales;Guggenheimella;";"95.2";"18.2";"63";"63";"60";"3";"0";"457120";"373834"
"V4mis1";"SILVA (only NR);Bacteria;Firmicutes;Clostridia;Peptostreptococcales-Tissierellales;JTB215;";"100.0";"18.2";"12";"12";"12";"0";"0";"457171";"373882"
"V4mis1";"SILVA (only NR);Bacteria;Firmicutes;Clostridia;Peptostreptococcales-Tissierellales;MCWD3;";"100.0";"18.2";"3";"3";"3";"0";"0";"457180";"373891"
"V4mis1";"SILVA (only NR);Bacteria;Firmicutes;Clostridia;Peptostreptococcales-Tissierellales;Natronincola;";"88.9";"18.2";"9";"9";"8";"1";"0";"457174";"373886"
"V4mis1";"SILVA (only NR);Bacteria;Firmicutes;Clostridia;Peptostreptococcales-Tissierellales;Peptostreptococcaceae;";"93.3";"18.2";"1217";"1217";"1135";"82";"0";"455966";"372759"
"V4mis1";"SILVA (only NR);Bacteria;Firmicutes;Clostridia;Peptostreptococcales-Tissierellales;Peptostreptococcaceae;Acetoanaerobium;";"93.3";"18.2";"30";"30";"28";"2";"0";"457153";"373866"
"V4mis1";"SILVA (only NR);Bacteria;Firmicutes;Clostridia;Peptostreptococcales-Tissierellales;Peptostreptococcaceae;Asaccharospora;";"100.0";"18.2";"2";"2";"2";"0";"0";"457181";"373892"
"V4mis1";"SILVA (only NR);Bacteria;Firmicutes;Clostridia;Peptostreptococcales-Tissierellales;Peptostreptococcaceae;Clostridioides;";"98.0";"18.2";"100";"100";"98";"2";"0";"457083";"373796"
"V4mis1";"SILVA (only NR);Bacteria;Firmicutes;Clostridia;Peptostreptococcales-Tissierellales;Peptostreptococcaceae;Criibacterium;";"100.0";"18.2";"1";"1";"1";"0";"0";"457182";"373893"
"V4mis1";"SILVA (only NR);Bacteria;Firmicutes;Clostridia;Peptostreptococcales-Tissierellales;Peptostreptococcaceae;Filifactor;";"100.0";"18.2";"15";"15";"15";"0";"0";"457168";"373879"
"V4mis1";"SILVA (only NR);Bacteria;Firmicutes;Clostridia;Peptostreptococcales-Tissierellales;Peptostreptococcaceae;Intestinibacter;";"86.2";"18.2";"58";"58";"50";"8";"0";"457125";"373844"
"V4mis1";"SILVA (only NR);Bacteria;Firmicutes;Clostridia;Peptostreptococcales-Tissierellales;Peptostreptococcaceae;Paeniclostridium;";"95.5";"18.2";"44";"44";"42";"2";"0";"457139";"373852"
"V4mis1";"SILVA (only NR);Bacteria;Firmicutes;Clostridia;Peptostreptococcales-Tissierellales;Peptostreptococcaceae;Paraclostridium;";"87.0";"18.2";"108";"108";"94";"14";"0";"457075";"373800"
"V4mis1";"SILVA (only NR);Bacteria;Firmicutes;Clostridia;Peptostreptococcales-Tissierellales;Peptostreptococcaceae;Peptoanaerobacter;";"100.0";"18.2";"2";"2";"2";"0";"0";"457181";"373892"
"V4mis1";"SILVA (only NR);Bacteria;Firmicutes;Clostridia;Peptostreptococcales-Tissierellales;Peptostreptococcaceae;Peptoclostridium;";"94.3";"18.2";"159";"159";"150";"9";"0";"457024";"373744"
"V4mis1";"SILVA (only NR);Bacteria;Firmicutes;Clostridia;Peptostreptococcales-Tissierellales;Peptostreptococcaceae;Peptostreptococcus;";"84.5";"18.2";"58";"58";"49";"9";"0";"457125";"373845"
"V4mis1";"SILVA (only NR);Bacteria;Firmicutes;Clostridia;Peptostreptococcales-Tissierellales;Peptostreptococcaceae;Proteocatella;";"83.3";"18.2";"18";"18";"15";"3";"0";"457165";"373879"
"V4mis1";"SILVA (only NR);Bacteria;Firmicutes;Clostridia;Peptostreptococcales-Tissierellales;Peptostreptococcaceae;Romboutsia;";"91.3";"18.2";"311";"311";"284";"27";"0";"456872";"373610"
"V4mis1";"SILVA (only NR);Bacteria;Firmicutes;Clostridia;Peptostreptococcales-Tissierellales;Peptostreptococcaceae;Sporacetigenium;";"100.0";"18.2";"11";"11";"11";"0";"0";"457172";"373883"
"V4mis1";"SILVA (only NR);Bacteria;Firmicutes;Clostridia;Peptostreptococcales-Tissierellales;Peptostreptococcaceae;Tepidibacter;";"93.8";"18.2";"16";"16";"15";"1";"0";"457167";"373879"
"V4mis1";"SILVA (only NR);Bacteria;Firmicutes;Clostridia;Peptostreptococcales-Tissierellales;Peptostreptococcaceae;Terrisporobacter;";"96.4";"18.2";"110";"110";"106";"4";"0";"457073";"373788"
"V4mis1";"SILVA (only NR);Bacteria;Firmicutes;Clostridia;Peptostreptococcales-Tissierellales;Peptostreptococcaceae;[Eubacterium] tenue group;";"100.0";"18.2";"3";"3";"3";"0";"0";"457180";"373891"
"V4mis1";"SILVA (only NR);Bacteria;Firmicutes;Clostridia;Peptostreptococcales-Tissierellales;Peptostreptococcaceae;[Eubacterium] yurii group;";"97.0";"18.2";"33";"33";"32";"1";"0";"457150";"373862"
"V4mis1";"SILVA (only NR);Bacteria;Firmicutes;Clostridia;Peptostreptococcales-Tissierellales;Peptostreptococcaceae;uncultured;";"100.0";"18.2";"128";"128";"128";"0";"0";"457055";"373766"
"V4mis1";"SILVA (only NR);Bacteria;Firmicutes;Clostridia;Peptostreptococcales-Tissierellales;Proteiniboraceae;";"100.0";"18.2";"11";"11";"11";"0";"0";"457172";"373883"
"V4mis1";"SILVA (only NR);Bacteria;Firmicutes;Clostridia;Peptostreptococcales-Tissierellales;Proteiniboraceae;Proteiniborus;";"100.0";"18.2";"11";"11";"11";"0";"0";"457172";"373883"
"V4mis1";"SILVA (only NR);Bacteria;Firmicutes;Clostridia;Peptostreptococcales-Tissierellales;Sedimentibacteraceae;";"91.4";"18.2";"186";"186";"170";"16";"0";"456997";"373724"
"V4mis1";"SILVA (only NR);Bacteria;Firmicutes;Clostridia;Peptostreptococcales-Tissierellales;Sedimentibacteraceae;Sedimentibacter;";"91.4";"18.2";"186";"186";"170";"16";"0";"456997";"373724"
"V4mis1";"SILVA (only NR);Bacteria;Firmicutes;Clostridia;Peptostreptococcales-Tissierellales;Serpentinicella;";"93.3";"18.2";"15";"15";"14";"1";"0";"457168";"373880"
"V4mis1";"SILVA (only NR);Bacteria;Firmicutes;Clostridia;Peptostreptococcales-Tissierellales;Sporosalibacterium;";"100.0";"18.2";"8";"8";"8";"0";"0";"457175";"373886"
"V4mis1";"SILVA (only NR);Bacteria;Firmicutes;Clostridia;Peptostreptococcales-Tissierellales;Thermohalobacter;";"100.0";"18.2";"2";"2";"2";"0";"0";"457181";"373892"
"V4mis1";"SILVA (only NR);Bacteria;Firmicutes;Clostridia;Peptostreptococcales-Tissierellales;Thermotaleaceae;";"93.3";"18.2";"30";"30";"28";"2";"0";"457153";"373866"
"V4mis1";"SILVA (only NR);Bacteria;Firmicutes;Clostridia;Peptostreptococcales-Tissierellales;Thermotaleaceae;Anaerosolibacter;";"100.0";"18.2";"7";"7";"7";"0";"0";"457176";"373887"
"V4mis1";"SILVA (only NR);Bacteria;Firmicutes;Clostridia;Peptostreptococcales-Tissierellales;Thermotaleaceae;Crassaminicella;";"80.0";"18.2";"10";"10";"8";"2";"0";"457173";"373886"
"V4mis1";"SILVA (only NR);Bacteria;Firmicutes;Clostridia;Peptostreptococcales-Tissierellales;Thermotaleaceae;Geosporobacter;";"100.0";"18.2";"4";"4";"4";"0";"0";"457179";"373890"
"V4mis1";"SILVA (only NR);Bacteria;Firmicutes;Clostridia;Peptostreptococcales-Tissierellales;Thermotaleaceae;Salimesophilobacter;";"100.0";"18.2";"3";"3";"3";"0";"0";"457180";"373891"
"V4mis1";"SILVA (only NR);Bacteria;Firmicutes;Clostridia;Peptostreptococcales-Tissierellales;Thermotaleaceae;Thermotalea;";"100.0";"18.2";"3";"3";"3";"0";"0";"457180";"373891"
"V4mis1";"SILVA (only NR);Bacteria;Firmicutes;Clostridia;Peptostreptococcales-Tissierellales;Thermotaleaceae;uncultured;";"100.0";"18.2";"3";"3";"3";"0";"0";"457180";"373891"
"V4mis1";"SILVA (only NR);Bacteria;Firmicutes;Clostridia;Peptostreptococcales-Tissierellales;Tindallia;";"100.0";"18.2";"11";"11";"11";"0";"0";"457172";"373883"
"V4mis1";"SILVA (only NR);Bacteria;Firmicutes;Clostridia;Peptostreptococcales-Tissierellales;livecontrolB21;";"100.0";"18.2";"4";"4";"4";"0";"0";"457179";"373890"
"V4mis1";"SILVA (only NR);Bacteria;Firmicutes;Clostridia;Peptostreptococcales-Tissierellales;uncultured;";"97.2";"18.2";"36";"36";"35";"1";"0";"457147";"373859"
"V4mis1";"SILVA (only NR);Bacteria;Firmicutes;Clostridia;Proteinivoracales;";"94.7";"18.2";"95";"95";"90";"5";"0";"457088";"373804"
"V4mis1";"SILVA (only NR);Bacteria;Firmicutes;Clostridia;Proteinivoracales;Anaerobranca;";"90.5";"18.2";"21";"21";"19";"2";"0";"457162";"373875"
"V4mis1";"SILVA (only NR);Bacteria;Firmicutes;Clostridia;Proteinivoracales;Proteinivorax;";"100.0";"18.2";"3";"3";"3";"0";"0";"457180";"373891"
"V4mis1";"SILVA (only NR);Bacteria;Firmicutes;Clostridia;Proteinivoracales;uncultured;";"95.7";"18.2";"69";"69";"66";"3";"0";"457114";"373828"
"V4mis1";"SILVA (only NR);Bacteria;Firmicutes;Clostridia;Thermincolales;";"92.5";"18.2";"80";"80";"74";"6";"0";"457103";"373820"
"V4mis1";"SILVA (only NR);Bacteria;Firmicutes;Clostridia;Thermincolales;Thermincolaceae;";"92.5";"18.2";"80";"80";"74";"6";"0";"457103";"373820"
"V4mis1";"SILVA (only NR);Bacteria;Firmicutes;Clostridia;Thermincolales;Thermincolaceae;Thermincola;";"92.5";"18.2";"80";"80";"74";"6";"0";"457103";"373820"
"V4mis1";"SILVA (only NR);Bacteria;Firmicutes;Clostridia;uncultured;";"95.5";"18.2";"44";"44";"42";"2";"0";"457139";"373852"
"V4mis1";"SILVA (only NR);Bacteria;Firmicutes;D8A-2;";"94.5";"18.2";"165";"165";"156";"9";"0";"457018";"373738"
"V4mis1";"SILVA (only NR);Bacteria;Firmicutes;Desulfitobacteriia;";"97.4";"18.2";"539";"539";"525";"14";"0";"456644";"373369"
"V4mis1";"SILVA (only NR);Bacteria;Firmicutes;Desulfitobacteriia;Desulfitobacteriales;";"97.4";"18.2";"539";"539";"525";"14";"0";"456644";"373369"
"V4mis1";"SILVA (only NR);Bacteria;Firmicutes;Desulfitobacteriia;Desulfitobacteriales;Desulfitobacteriaceae;";"97.2";"18.2";"354";"354";"344";"10";"0";"456829";"373550"
"V4mis1";"SILVA (only NR);Bacteria;Firmicutes;Desulfitobacteriia;Desulfitobacteriales;Desulfitobacteriaceae;Desulfitobacterium;";"98.5";"18.2";"68";"68";"67";"1";"0";"457115";"373827"
"V4mis1";"SILVA (only NR);Bacteria;Firmicutes;Desulfitobacteriia;Desulfitobacteriales;Desulfitobacteriaceae;Desulfosporosinus;";"96.9";"18.2";"286";"286";"277";"9";"0";"456897";"373617"
"V4mis1";"SILVA (only NR);Bacteria;Firmicutes;Desulfitobacteriia;Desulfitobacteriales;Heliobacteriaceae;";"96.2";"18.2";"52";"52";"50";"2";"0";"457131";"373844"
"V4mis1";"SILVA (only NR);Bacteria;Firmicutes;Desulfitobacteriia;Desulfitobacteriales;Heliobacteriaceae;Candidatus Heliomonas;";"100.0";"18.2";"1";"1";"1";"0";"0";"457182";"373893"
"V4mis1";"SILVA (only NR);Bacteria;Firmicutes;Desulfitobacteriia;Desulfitobacteriales;Heliobacteriaceae;Heliobacillus;";"100.0";"18.2";"7";"7";"7";"0";"0";"457176";"373887"
"V4mis1";"SILVA (only NR);Bacteria;Firmicutes;Desulfitobacteriia;Desulfitobacteriales;Heliobacteriaceae;Heliobacterium;";"90.0";"18.2";"10";"10";"9";"1";"0";"457173";"373885"
"V4mis1";"SILVA (only NR);Bacteria;Firmicutes;Desulfitobacteriia;Desulfitobacteriales;Heliobacteriaceae;Heliophilum;";"100.0";"18.2";"3";"3";"3";"0";"0";"457180";"373891"
"V4mis1";"SILVA (only NR);Bacteria;Firmicutes;Desulfitobacteriia;Desulfitobacteriales;Heliobacteriaceae;Heliorestis;";"100.0";"18.2";"5";"5";"5";"0";"0";"457178";"373889"
"V4mis1";"SILVA (only NR);Bacteria;Firmicutes;Desulfitobacteriia;Desulfitobacteriales;Heliobacteriaceae;uncultured;";"95.7";"18.2";"23";"23";"22";"1";"0";"457160";"373872"
"V4mis1";"SILVA (only NR);Bacteria;Firmicutes;Desulfitobacteriia;Desulfitobacteriales;Syntrophobotulaceae;";"97.0";"18.2";"33";"33";"32";"1";"0";"457150";"373862"
"V4mis1";"SILVA (only NR);Bacteria;Firmicutes;Desulfitobacteriia;Desulfitobacteriales;Syntrophobotulaceae;Candidatus Dichloromethanomonas;";"100.0";"18.2";"6";"6";"6";"0";"0";"457177";"373888"
"V4mis1";"SILVA (only NR);Bacteria;Firmicutes;Desulfitobacteriia;Desulfitobacteriales;Syntrophobotulaceae;Dehalobacter;";"96.2";"18.2";"26";"26";"25";"1";"0";"457157";"373869"
"V4mis1";"SILVA (only NR);Bacteria;Firmicutes;Desulfitobacteriia;Desulfitobacteriales;Syntrophobotulaceae;Syntrophobotulus;";"100.0";"18.2";"1";"1";"1";"0";"0";"457182";"373893"
"V4mis1";"SILVA (only NR);Bacteria;Firmicutes;Desulfitobacteriia;Desulfitobacteriales;TC1;";"100.0";"18.2";"10";"10";"10";"0";"0";"457173";"373884"
"V4mis1";"SILVA (only NR);Bacteria;Firmicutes;Desulfitobacteriia;Desulfitobacteriales;uncultured;";"98.9";"18.2";"89";"89";"88";"1";"0";"457094";"373806"
"V4mis1";"SILVA (only NR);Bacteria;Firmicutes;Desulfotomaculia;";"94.1";"18.2";"691";"691";"650";"41";"0";"456492";"373244"
"V4mis1";"SILVA (only NR);Bacteria;Firmicutes;Desulfotomaculia;Ammonifexales;";"86.4";"18.2";"44";"44";"38";"6";"0";"457139";"373856"
"V4mis1";"SILVA (only NR);Bacteria;Firmicutes;Desulfotomaculia;Ammonifexales;Ammonificaceae;";"100.0";"18.2";"20";"20";"20";"0";"0";"457163";"373874"
"V4mis1";"SILVA (only NR);Bacteria;Firmicutes;Desulfotomaculia;Ammonifexales;Ammonificaceae;Ammonifex;";"100.0";"18.2";"2";"2";"2";"0";"0";"457181";"373892"
"V4mis1";"SILVA (only NR);Bacteria;Firmicutes;Desulfotomaculia;Ammonifexales;Ammonificaceae;Desulfothermobacter;";"100.0";"18.2";"2";"2";"2";"0";"0";"457181";"373892"
"V4mis1";"SILVA (only NR);Bacteria;Firmicutes;Desulfotomaculia;Ammonifexales;Ammonificaceae;Thermodesulfitimonas;";"100.0";"18.2";"7";"7";"7";"0";"0";"457176";"373887"
"V4mis1";"SILVA (only NR);Bacteria;Firmicutes;Desulfotomaculia;Ammonifexales;Ammonificaceae;uncultured;";"100.0";"18.2";"6";"6";"6";"0";"0";"457177";"373888"
"V4mis1";"SILVA (only NR);Bacteria;Firmicutes;Desulfotomaculia;Ammonifexales;Desulforudaceae;";"73.9";"18.2";"23";"23";"17";"6";"0";"457160";"373877"
"V4mis1";"SILVA (only NR);Bacteria;Firmicutes;Desulfotomaculia;Ammonifexales;Desulforudaceae;Candidatus Desulforudis;";"73.9";"18.2";"23";"23";"17";"6";"0";"457160";"373877"
"V4mis1";"SILVA (only NR);Bacteria;Firmicutes;Desulfotomaculia;Carboxydothermales;";"100.0";"18.2";"11";"11";"11";"0";"0";"457172";"373883"
"V4mis1";"SILVA (only NR);Bacteria;Firmicutes;Desulfotomaculia;Carboxydothermales;Carboxydothermaceae;";"100.0";"18.2";"11";"11";"11";"0";"0";"457172";"373883"
"V4mis1";"SILVA (only NR);Bacteria;Firmicutes;Desulfotomaculia;Carboxydothermales;Carboxydothermaceae;Carboxydothermus;";"100.0";"18.2";"11";"11";"11";"0";"0";"457172";"373883"
"V4mis1";"SILVA (only NR);Bacteria;Firmicutes;Desulfotomaculia;Desulfotomaculales;";"94.5";"18.2";"636";"636";"601";"35";"0";"456547";"373293"
"V4mis1";"SILVA (only NR);Bacteria;Firmicutes;Desulfotomaculia;Desulfotomaculales;Desulfotomaculaceae;";"93.1";"18.2";"333";"333";"310";"23";"0";"456850";"373584"
"V4mis1";"SILVA (only NR);Bacteria;Firmicutes;Desulfotomaculia;Desulfotomaculales;Desulfotomaculaceae;Desulfofarcimen;";"91.4";"18.2";"244";"244";"223";"21";"0";"456939";"373671"
"V4mis1";"SILVA (only NR);Bacteria;Firmicutes;Desulfotomaculia;Desulfotomaculales;Desulfotomaculaceae;Desulfohalotomaculum;";"97.6";"18.2";"42";"42";"41";"1";"0";"457141";"373853"
"V4mis1";"SILVA (only NR);Bacteria;Firmicutes;Desulfotomaculia;Desulfotomaculales;Desulfotomaculaceae;Desulfotomaculum;";"97.9";"18.2";"47";"47";"46";"1";"0";"457136";"373848"
"V4mis1";"SILVA (only NR);Bacteria;Firmicutes;Desulfotomaculia;Desulfotomaculales;Desulfotomaculales Incertae Sedis;";"95.8";"18.2";"71";"71";"68";"3";"0";"457112";"373826"
"V4mis1";"SILVA (only NR);Bacteria;Firmicutes;Desulfotomaculia;Desulfotomaculales;Desulfotomaculales Incertae Sedis;Desulfallas-Sporotomaculum;";"95.1";"18.2";"61";"61";"58";"3";"0";"457122";"373836"
"V4mis1";"SILVA (only NR);Bacteria;Firmicutes;Desulfotomaculia;Desulfotomaculales;Desulfotomaculales Incertae Sedis;uncultured;";"100.0";"18.2";"10";"10";"10";"0";"0";"457173";"373884"
"V4mis1";"SILVA (only NR);Bacteria;Firmicutes;Desulfotomaculia;Desulfotomaculales;Desulfurisporaceae;";"96.6";"18.2";"118";"118";"114";"4";"0";"457065";"373780"
"V4mis1";"SILVA (only NR);Bacteria;Firmicutes;Desulfotomaculia;Desulfotomaculales;Desulfurisporaceae;Desulfofundulus;";"100.0";"18.2";"37";"37";"37";"0";"0";"457146";"373857"
"V4mis1";"SILVA (only NR);Bacteria;Firmicutes;Desulfotomaculia;Desulfotomaculales;Desulfurisporaceae;Desulfurispora;";"96.2";"18.2";"52";"52";"50";"2";"0";"457131";"373844"
"V4mis1";"SILVA (only NR);Bacteria;Firmicutes;Desulfotomaculia;Desulfotomaculales;Desulfurisporaceae;SCADC1-2-3;";"93.1";"18.2";"29";"29";"27";"2";"0";"457154";"373867"
"V4mis1";"SILVA (only NR);Bacteria;Firmicutes;Desulfotomaculia;Desulfotomaculales;Pelotomaculaceae;";"95.6";"18.2";"114";"114";"109";"5";"0";"457069";"373785"
"V4mis1";"SILVA (only NR);Bacteria;Firmicutes;Desulfotomaculia;Desulfotomaculales;Pelotomaculaceae;Cryptanaerobacter;";"97.1";"18.2";"34";"34";"33";"1";"0";"457149";"373861"
"V4mis1";"SILVA (only NR);Bacteria;Firmicutes;Desulfotomaculia;Desulfotomaculales;Pelotomaculaceae;Pelotomaculum;";"95.5";"18.2";"66";"66";"63";"3";"0";"457117";"373831"
"V4mis1";"SILVA (only NR);Bacteria;Firmicutes;Desulfotomaculia;Desulfotomaculales;Pelotomaculaceae;uncultured;";"92.9";"18.2";"14";"14";"13";"1";"0";"457169";"373881"
"V4mis1";"SILVA (only NR);Bacteria;Firmicutes;Dethiobacteria;";"94.9";"18.2";"137";"137";"130";"7";"0";"457046";"373764"
"V4mis1";"SILVA (only NR);Bacteria;Firmicutes;Dethiobacteria;Dethiobacterales;";"94.9";"18.2";"137";"137";"130";"7";"0";"457046";"373764"
"V4mis1";"SILVA (only NR);Bacteria;Firmicutes;Dethiobacteria;Dethiobacterales;Dethiobacteraceae;";"94.9";"18.2";"137";"137";"130";"7";"0";"457046";"373764"
"V4mis1";"SILVA (only NR);Bacteria;Firmicutes;Dethiobacteria;Dethiobacterales;Dethiobacteraceae;Candidatus Contubernalis;";"100.0";"18.2";"8";"8";"8";"0";"0";"457175";"373886"
"V4mis1";"SILVA (only NR);Bacteria;Firmicutes;Dethiobacteria;Dethiobacterales;Dethiobacteraceae;Dethiobacter;";"95.1";"18.2";"61";"61";"58";"3";"0";"457122";"373836"
"V4mis1";"SILVA (only NR);Bacteria;Firmicutes;Dethiobacteria;Dethiobacterales;Dethiobacteraceae;uncultured;";"94.0";"18.2";"67";"67";"63";"4";"0";"457116";"373831"
"V4mis1";"SILVA (only NR);Bacteria;Firmicutes;Incertae Sedis;";"97.6";"18.2";"250";"250";"244";"6";"0";"456933";"373650"
"V4mis1";"SILVA (only NR);Bacteria;Firmicutes;Incertae Sedis;DTU014;";"97.3";"18.2";"223";"223";"217";"6";"0";"456960";"373677"
"V4mis1";"SILVA (only NR);Bacteria;Firmicutes;Incertae Sedis;Gelria;";"100.0";"18.2";"14";"14";"14";"0";"0";"457169";"373880"
"V4mis1";"SILVA (only NR);Bacteria;Firmicutes;Incertae Sedis;Thermolithobacterales;";"100.0";"18.2";"13";"13";"13";"0";"0";"457170";"373881"
"V4mis1";"SILVA (only NR);Bacteria;Firmicutes;Incertae Sedis;Thermolithobacterales;Thermolithobacteraceae;";"100.0";"18.2";"13";"13";"13";"0";"0";"457170";"373881"
"V4mis1";"SILVA (only NR);Bacteria;Firmicutes;Incertae Sedis;Thermolithobacterales;Thermolithobacteraceae;Thermolithobacter;";"100.0";"18.2";"13";"13";"13";"0";"0";"457170";"373881"
"V4mis1";"SILVA (only NR);Bacteria;Firmicutes;Limnochordia;";"95.7";"18.2";"460";"460";"440";"20";"0";"456723";"373454"
"V4mis1";"SILVA (only NR);Bacteria;Firmicutes;Limnochordia;B55-F-B-G02;";"100.0";"18.2";"7";"7";"7";"0";"0";"457176";"373887"
"V4mis1";"SILVA (only NR);Bacteria;Firmicutes;Limnochordia;Hydrogenispora;";"95.2";"18.2";"146";"146";"139";"7";"0";"457037";"373755"
"V4mis1";"SILVA (only NR);Bacteria;Firmicutes;Limnochordia;Limnochordales;";"94.6";"18.2";"92";"92";"87";"5";"0";"457091";"373807"
"V4mis1";"SILVA (only NR);Bacteria;Firmicutes;Limnochordia;Limnochordales;Limnochordaceae;";"96.9";"18.2";"65";"65";"63";"2";"0";"457118";"373831"
"V4mis1";"SILVA (only NR);Bacteria;Firmicutes;Limnochordia;Limnochordales;Limnochordaceae;Limnochorda;";"100.0";"18.2";"6";"6";"6";"0";"0";"457177";"373888"
"V4mis1";"SILVA (only NR);Bacteria;Firmicutes;Limnochordia;Limnochordales;uncultured;";"88.9";"18.2";"27";"27";"24";"3";"0";"457156";"373870"
"V4mis1";"SILVA (only NR);Bacteria;Firmicutes;Limnochordia;M55-D21;";"100.0";"18.2";"23";"23";"23";"0";"0";"457160";"373871"
"V4mis1";"SILVA (only NR);Bacteria;Firmicutes;Limnochordia;MBA03;";"95.5";"18.2";"157";"157";"150";"7";"0";"457026";"373744"
"V4mis1";"SILVA (only NR);Bacteria;Firmicutes;Limnochordia;uncultured;";"94.4";"18.2";"18";"18";"17";"1";"0";"457165";"373877"
"V4mis1";"SILVA (only NR);Bacteria;Firmicutes;Moorellia;";"96.6";"18.2";"87";"87";"84";"3";"0";"457096";"373810"
"V4mis1";"SILVA (only NR);Bacteria;Firmicutes;Moorellia;Calderihabitantales;";"50.0";"18.2";"2";"2";"1";"1";"0";"457181";"373893"
"V4mis1";"SILVA (only NR);Bacteria;Firmicutes;Moorellia;Calderihabitantales;Calderihabitantaceae;";"50.0";"18.2";"2";"2";"1";"1";"0";"457181";"373893"
"V4mis1";"SILVA (only NR);Bacteria;Firmicutes;Moorellia;Calderihabitantales;Calderihabitantaceae;Calderihabitans;";"0.0";"0";"1";"1";"0";"1";"0";"457182";"373894"
"V4mis1";"SILVA (only NR);Bacteria;Firmicutes;Moorellia;Desulfitibacterales;";"97.6";"18.2";"41";"41";"40";"1";"0";"457142";"373854"
"V4mis1";"SILVA (only NR);Bacteria;Firmicutes;Moorellia;Desulfitibacterales;Desulfitibacteraceae;";"97.6";"18.2";"41";"41";"40";"1";"0";"457142";"373854"
"V4mis1";"SILVA (only NR);Bacteria;Firmicutes;Moorellia;Desulfitibacterales;Desulfitibacteraceae;Desulfitibacter;";"97.6";"18.2";"41";"41";"40";"1";"0";"457142";"373854"
"V4mis1";"SILVA (only NR);Bacteria;Firmicutes;Moorellia;Moorellales;";"97.4";"18.2";"38";"38";"37";"1";"0";"457145";"373857"
"V4mis1";"SILVA (only NR);Bacteria;Firmicutes;Moorellia;Moorellales;Moorellaceae;";"97.4";"18.2";"38";"38";"37";"1";"0";"457145";"373857"
"V4mis1";"SILVA (only NR);Bacteria;Firmicutes;Moorellia;Moorellales;Moorellaceae;Moorella;";"97.4";"18.2";"38";"38";"37";"1";"0";"457145";"373857"
"V4mis1";"SILVA (only NR);Bacteria;Firmicutes;Moorellia;NRB23;";"100.0";"18.2";"6";"6";"6";"0";"0";"457177";"373888"
"V4mis1";"SILVA (only NR);Bacteria;Firmicutes;Natranaerobiia;";"96.2";"18.2";"26";"26";"25";"1";"0";"457157";"373869"
"V4mis1";"SILVA (only NR);Bacteria;Firmicutes;Natranaerobiia;Natranaerobiales;";"96.2";"18.2";"26";"26";"25";"1";"0";"457157";"373869"
"V4mis1";"SILVA (only NR);Bacteria;Firmicutes;Natranaerobiia;Natranaerobiales;Natranaerobiaceae;";"96.2";"18.2";"26";"26";"25";"1";"0";"457157";"373869"
"V4mis1";"SILVA (only NR);Bacteria;Firmicutes;Natranaerobiia;Natranaerobiales;Natranaerobiaceae;Natranaerobius;";"100.0";"18.2";"14";"14";"14";"0";"0";"457169";"373880"
"V4mis1";"SILVA (only NR);Bacteria;Firmicutes;Natranaerobiia;Natranaerobiales;Natranaerobiaceae;Natronovirga;";"80.0";"18.2";"5";"5";"4";"1";"0";"457178";"373890"
"V4mis1";"SILVA (only NR);Bacteria;Firmicutes;Natranaerobiia;Natranaerobiales;Natranaerobiaceae;uncultured;";"100.0";"18.2";"6";"6";"6";"0";"0";"457177";"373888"
"V4mis1";"SILVA (only NR);Bacteria;Firmicutes;Negativicutes;";"92.6";"18.3";"3241";"3241";"3001";"240";"0";"453942";"370893"
"V4mis1";"SILVA (only NR);Bacteria;Firmicutes;Negativicutes;Acidaminococcales;";"90.5";"18.2";"464";"464";"420";"44";"0";"456719";"373474"
"V4mis1";"SILVA (only NR);Bacteria;Firmicutes;Negativicutes;Acidaminococcales;Acidaminococcaceae;";"90.5";"18.2";"464";"464";"420";"44";"0";"456719";"373474"
"V4mis1";"SILVA (only NR);Bacteria;Firmicutes;Negativicutes;Acidaminococcales;Acidaminococcaceae;Acidaminococcus;";"83.9";"18.2";"31";"31";"26";"5";"0";"457152";"373868"
"V4mis1";"SILVA (only NR);Bacteria;Firmicutes;Negativicutes;Acidaminococcales;Acidaminococcaceae;Phascolarctobacterium;";"91.2";"18.2";"205";"205";"187";"18";"0";"456978";"373707"
"V4mis1";"SILVA (only NR);Bacteria;Firmicutes;Negativicutes;Acidaminococcales;Acidaminococcaceae;Succiniclasticum;";"87.9";"18.2";"165";"165";"145";"20";"0";"457018";"373749"
"V4mis1";"SILVA (only NR);Bacteria;Firmicutes;Negativicutes;Acidaminococcales;Acidaminococcaceae;Succinispira;";"100.0";"18.2";"5";"5";"5";"0";"0";"457178";"373889"
"V4mis1";"SILVA (only NR);Bacteria;Firmicutes;Negativicutes;Acidaminococcales;Acidaminococcaceae;uncultured;";"98.3";"18.2";"58";"58";"57";"1";"0";"457125";"373837"
"V4mis1";"SILVA (only NR);Bacteria;Firmicutes;Negativicutes;Veillonellales-Selenomonadales;";"92.9";"18.3";"2757";"2757";"2561";"196";"0";"454426";"371333"
"V4mis1";"SILVA (only NR);Bacteria;Firmicutes;Negativicutes;Veillonellales-Selenomonadales;Selenomonadaceae;";"95.9";"18.2";"945";"945";"906";"39";"0";"456238";"372988"
"V4mis1";"SILVA (only NR);Bacteria;Firmicutes;Negativicutes;Veillonellales-Selenomonadales;Selenomonadaceae;Anaerovibrio;";"95.9";"18.2";"73";"73";"70";"3";"0";"457110";"373824"
"V4mis1";"SILVA (only NR);Bacteria;Firmicutes;Negativicutes;Veillonellales-Selenomonadales;Selenomonadaceae;Centipeda;";"92.3";"18.2";"13";"13";"12";"1";"0";"457170";"373882"
"V4mis1";"SILVA (only NR);Bacteria;Firmicutes;Negativicutes;Veillonellales-Selenomonadales;Selenomonadaceae;Megamonas;";"94.0";"18.2";"67";"67";"63";"4";"0";"457116";"373831"
"V4mis1";"SILVA (only NR);Bacteria;Firmicutes;Negativicutes;Veillonellales-Selenomonadales;Selenomonadaceae;Mitsuokella;";"97.4";"18.2";"39";"39";"38";"1";"0";"457144";"373856"
"V4mis1";"SILVA (only NR);Bacteria;Firmicutes;Negativicutes;Veillonellales-Selenomonadales;Selenomonadaceae;Pectinatus;";"92.9";"18.2";"14";"14";"13";"1";"0";"457169";"373881"
"V4mis1";"SILVA (only NR);Bacteria;Firmicutes;Negativicutes;Veillonellales-Selenomonadales;Selenomonadaceae;Propionispira;";"100.0";"18.2";"4";"4";"4";"0";"0";"457179";"373890"
"V4mis1";"SILVA (only NR);Bacteria;Firmicutes;Negativicutes;Veillonellales-Selenomonadales;Selenomonadaceae;Quinella;";"100.0";"18.2";"48";"48";"48";"0";"0";"457135";"373846"
"V4mis1";"SILVA (only NR);Bacteria;Firmicutes;Negativicutes;Veillonellales-Selenomonadales;Selenomonadaceae;Schwartzia;";"88.9";"18.2";"9";"9";"8";"1";"0";"457174";"373886"
"V4mis1";"SILVA (only NR);Bacteria;Firmicutes;Negativicutes;Veillonellales-Selenomonadales;Selenomonadaceae;Selenomonas;";"97.0";"18.2";"506";"506";"491";"15";"0";"456677";"373403"
"V4mis1";"SILVA (only NR);Bacteria;Firmicutes;Negativicutes;Veillonellales-Selenomonadales;Selenomonadaceae;Veillonellaceae UCG-001;";"92.7";"18.2";"41";"41";"38";"3";"0";"457142";"373856"
"V4mis1";"SILVA (only NR);Bacteria;Firmicutes;Negativicutes;Veillonellales-Selenomonadales;Selenomonadaceae;Zymophilus;";"100.0";"18.2";"4";"4";"4";"0";"0";"457179";"373890"
"V4mis1";"SILVA (only NR);Bacteria;Firmicutes;Negativicutes;Veillonellales-Selenomonadales;Selenomonadaceae;uncultured;";"92.0";"18.2";"125";"125";"115";"10";"0";"457058";"373779"
"V4mis1";"SILVA (only NR);Bacteria;Firmicutes;Negativicutes;Veillonellales-Selenomonadales;Sporomusaceae;";"95.3";"18.2";"402";"402";"383";"19";"0";"456781";"373511"
"V4mis1";"SILVA (only NR);Bacteria;Firmicutes;Negativicutes;Veillonellales-Selenomonadales;Sporomusaceae;Acetonema;";"100.0";"18.2";"5";"5";"5";"0";"0";"457178";"373889"
"V4mis1";"SILVA (only NR);Bacteria;Firmicutes;Negativicutes;Veillonellales-Selenomonadales;Sporomusaceae;Anaeromusa-Anaeroarcus;";"95.2";"18.2";"21";"21";"20";"1";"0";"457162";"373874"
"V4mis1";"SILVA (only NR);Bacteria;Firmicutes;Negativicutes;Veillonellales-Selenomonadales;Sporomusaceae;Anaerosinus;";"100.0";"18.2";"12";"12";"12";"0";"0";"457171";"373882"
"V4mis1";"SILVA (only NR);Bacteria;Firmicutes;Negativicutes;Veillonellales-Selenomonadales;Sporomusaceae;Anaerospora;";"82.4";"18.2";"34";"34";"28";"6";"0";"457149";"373866"
"V4mis1";"SILVA (only NR);Bacteria;Firmicutes;Negativicutes;Veillonellales-Selenomonadales;Sporomusaceae;Anaerosporomusa;";"100.0";"18.2";"17";"17";"17";"0";"0";"457166";"373877"
"V4mis1";"SILVA (only NR);Bacteria;Firmicutes;Negativicutes;Veillonellales-Selenomonadales;Sporomusaceae;Dendrosporobacter;";"100.0";"18.2";"7";"7";"7";"0";"0";"457176";"373887"
"V4mis1";"SILVA (only NR);Bacteria;Firmicutes;Negativicutes;Veillonellales-Selenomonadales;Sporomusaceae;Methylomusa;";"100.0";"18.2";"2";"2";"2";"0";"0";"457181";"373892"
"V4mis1";"SILVA (only NR);Bacteria;Firmicutes;Negativicutes;Veillonellales-Selenomonadales;Sporomusaceae;Pelosinus;";"94.6";"18.2";"92";"92";"87";"5";"0";"457091";"373807"
"V4mis1";"SILVA (only NR);Bacteria;Firmicutes;Negativicutes;Veillonellales-Selenomonadales;Sporomusaceae;Propionispora;";"85.7";"18.2";"7";"7";"6";"1";"0";"457176";"373888"
"V4mis1";"SILVA (only NR);Bacteria;Firmicutes;Negativicutes;Veillonellales-Selenomonadales;Sporomusaceae;Sporolituus;";"100.0";"18.2";"2";"2";"2";"0";"0";"457181";"373892"
"V4mis1";"SILVA (only NR);Bacteria;Firmicutes;Negativicutes;Veillonellales-Selenomonadales;Sporomusaceae;Sporomusa;";"99.0";"18.2";"97";"97";"96";"1";"0";"457086";"373798"
"V4mis1";"SILVA (only NR);Bacteria;Firmicutes;Negativicutes;Veillonellales-Selenomonadales;Sporomusaceae;Thermosinus;";"96.8";"18.2";"31";"31";"30";"1";"0";"457152";"373864"
"V4mis1";"SILVA (only NR);Bacteria;Firmicutes;Negativicutes;Veillonellales-Selenomonadales;Sporomusaceae;uncultured;";"94.4";"18.2";"72";"72";"68";"4";"0";"457111";"373826"
"V4mis1";"SILVA (only NR);Bacteria;Firmicutes;Negativicutes;Veillonellales-Selenomonadales;Veillonellaceae;";"90.0";"18.2";"1376";"1376";"1238";"138";"0";"455807";"372656"
"V4mis1";"SILVA (only NR);Bacteria;Firmicutes;Negativicutes;Veillonellales-Selenomonadales;Veillonellaceae;Allisonella;";"100.0";"18.2";"7";"7";"7";"0";"0";"457176";"373887"
"V4mis1";"SILVA (only NR);Bacteria;Firmicutes;Negativicutes;Veillonellales-Selenomonadales;Veillonellaceae;Anaeroglobus;";"80.0";"18.2";"5";"5";"4";"1";"0";"457178";"373890"
"V4mis1";"SILVA (only NR);Bacteria;Firmicutes;Negativicutes;Veillonellales-Selenomonadales;Veillonellaceae;Dialister;";"85.8";"18.2";"401";"401";"344";"57";"0";"456782";"373550"
"V4mis1";"SILVA (only NR);Bacteria;Firmicutes;Negativicutes;Veillonellales-Selenomonadales;Veillonellaceae;Megasphaera;";"94.1";"18.2";"135";"135";"127";"8";"0";"457048";"373767"
"V4mis1";"SILVA (only NR);Bacteria;Firmicutes;Negativicutes;Veillonellales-Selenomonadales;Veillonellaceae;Negativicoccus;";"81.8";"18.2";"11";"11";"9";"2";"0";"457172";"373885"
"V4mis1";"SILVA (only NR);Bacteria;Firmicutes;Negativicutes;Veillonellales-Selenomonadales;Veillonellaceae;Veillonella;";"91.3";"18.2";"805";"805";"735";"70";"0";"456378";"373159"
"V4mis1";"SILVA (only NR);Bacteria;Firmicutes;Negativicutes;Veillonellales-Selenomonadales;Veillonellaceae;uncultured;";"100.0";"18.2";"8";"8";"8";"0";"0";"457175";"373886"
"V4mis1";"SILVA (only NR);Bacteria;Firmicutes;Negativicutes;Veillonellales-Selenomonadales;uncultured;";"100.0";"18.2";"33";"33";"33";"0";"0";"457150";"373861"
"V4mis1";"SILVA (only NR);Bacteria;Firmicutes;Negativicutes;uncultured;";"100.0";"18.2";"20";"20";"20";"0";"0";"457163";"373874"
"V4mis1";"SILVA (only NR);Bacteria;Firmicutes;Sulfobacillia;";"94.3";"18.2";"105";"105";"99";"6";"0";"457078";"373795"
"V4mis1";"SILVA (only NR);Bacteria;Firmicutes;Sulfobacillia;Sulfobacillales;";"94.3";"18.2";"105";"105";"99";"6";"0";"457078";"373795"
"V4mis1";"SILVA (only NR);Bacteria;Firmicutes;Sulfobacillia;Sulfobacillales;Sulfobacillaceae;";"94.3";"18.2";"105";"105";"99";"6";"0";"457078";"373795"
"V4mis1";"SILVA (only NR);Bacteria;Firmicutes;Sulfobacillia;Sulfobacillales;Sulfobacillaceae;Sulfobacillus;";"94.4";"18.2";"72";"72";"68";"4";"0";"457111";"373826"
"V4mis1";"SILVA (only NR);Bacteria;Firmicutes;Sulfobacillia;Sulfobacillales;Sulfobacillaceae;uncultured;";"93.9";"18.2";"33";"33";"31";"2";"0";"457150";"373863"
"V4mis1";"SILVA (only NR);Bacteria;Firmicutes;Symbiobacteriia;";"95.4";"18.2";"452";"452";"431";"21";"0";"456731";"373463"
"V4mis1";"SILVA (only NR);Bacteria;Firmicutes;Symbiobacteriia;Symbiobacteriales;";"95.4";"18.2";"452";"452";"431";"21";"0";"456731";"373463"
"V4mis1";"SILVA (only NR);Bacteria;Firmicutes;Symbiobacteriia;Symbiobacteriales;Caldinitratiruptor;";"100.0";"18.2";"3";"3";"3";"0";"0";"457180";"373891"
"V4mis1";"SILVA (only NR);Bacteria;Firmicutes;Symbiobacteriia;Symbiobacteriales;Symbiobacteraceae;";"95.1";"18.2";"428";"428";"407";"21";"0";"456755";"373487"
"V4mis1";"SILVA (only NR);Bacteria;Firmicutes;Symbiobacteriia;Symbiobacteriales;Symbiobacteraceae;Symbiobacterium;";"100.0";"18.2";"19";"19";"19";"0";"0";"457164";"373875"
"V4mis1";"SILVA (only NR);Bacteria;Firmicutes;Symbiobacteriia;Symbiobacteriales;Symbiobacteraceae;uncultured;";"94.9";"18.2";"409";"409";"388";"21";"0";"456774";"373506"
"V4mis1";"SILVA (only NR);Bacteria;Firmicutes;Symbiobacteriia;Symbiobacteriales;uncultured;";"100.0";"18.2";"20";"20";"20";"0";"0";"457163";"373874"
"V4mis1";"SILVA (only NR);Bacteria;Firmicutes;Syntrophomonadia;";"94.5";"18.2";"309";"309";"292";"17";"0";"456874";"373602"
"V4mis1";"SILVA (only NR);Bacteria;Firmicutes;Syntrophomonadia;Syntrophomonadales;";"94.5";"18.2";"309";"309";"292";"17";"0";"456874";"373602"
"V4mis1";"SILVA (only NR);Bacteria;Firmicutes;Syntrophomonadia;Syntrophomonadales;Syntrophomonadaceae;";"94.5";"18.2";"309";"309";"292";"17";"0";"456874";"373602"
"V4mis1";"SILVA (only NR);Bacteria;Firmicutes;Syntrophomonadia;Syntrophomonadales;Syntrophomonadaceae;Pelospora;";"95.5";"18.2";"22";"22";"21";"1";"0";"457161";"373873"
"V4mis1";"SILVA (only NR);Bacteria;Firmicutes;Syntrophomonadia;Syntrophomonadales;Syntrophomonadaceae;Syntrophomonas;";"94.9";"18.2";"177";"177";"168";"9";"0";"457006";"373726"
"V4mis1";"SILVA (only NR);Bacteria;Firmicutes;Syntrophomonadia;Syntrophomonadales;Syntrophomonadaceae;Syntrophothermus;";"100.0";"18.2";"6";"6";"6";"0";"0";"457177";"373888"
"V4mis1";"SILVA (only NR);Bacteria;Firmicutes;Syntrophomonadia;Syntrophomonadales;Syntrophomonadaceae;Thermosyntropha;";"100.0";"18.2";"9";"9";"9";"0";"0";"457174";"373885"
"V4mis1";"SILVA (only NR);Bacteria;Firmicutes;Syntrophomonadia;Syntrophomonadales;Syntrophomonadaceae;uncultured;";"93.4";"18.2";"91";"91";"85";"6";"0";"457092";"373809"
"V4mis1";"SILVA (only NR);Bacteria;Firmicutes;TSAC18;";"89.2";"18.2";"37";"37";"33";"4";"0";"457146";"373861"
"V4mis1";"SILVA (only NR);Bacteria;Firmicutes;TTA-B61;";"88.9";"18.2";"9";"9";"8";"1";"0";"457174";"373886"
"V4mis1";"SILVA (only NR);Bacteria;Firmicutes;Thermacetogenia;";"94.9";"18.2";"59";"59";"56";"3";"0";"457124";"373838"
"V4mis1";"SILVA (only NR);Bacteria;Firmicutes;Thermacetogenia;Thermacetogeniales;";"94.9";"18.2";"59";"59";"56";"3";"0";"457124";"373838"
"V4mis1";"SILVA (only NR);Bacteria;Firmicutes;Thermacetogenia;Thermacetogeniales;Thermacetogeniaceae;";"94.9";"18.2";"59";"59";"56";"3";"0";"457124";"373838"
"V4mis1";"SILVA (only NR);Bacteria;Firmicutes;Thermacetogenia;Thermacetogeniales;Thermacetogeniaceae;Syntrophaceticus;";"100.0";"18.2";"20";"20";"20";"0";"0";"457163";"373874"
"V4mis1";"SILVA (only NR);Bacteria;Firmicutes;Thermacetogenia;Thermacetogeniales;Thermacetogeniaceae;Thermacetogenium;";"100.0";"18.2";"13";"13";"13";"0";"0";"457170";"373881"
"V4mis1";"SILVA (only NR);Bacteria;Firmicutes;Thermacetogenia;Thermacetogeniales;Thermacetogeniaceae;uncultured;";"88.0";"18.2";"25";"25";"22";"3";"0";"457158";"373872"
"V4mis1";"SILVA (only NR);Bacteria;Firmicutes;Thermaerobacteria;";"100.0";"18.2";"10";"10";"10";"0";"0";"457173";"373884"
"V4mis1";"SILVA (only NR);Bacteria;Firmicutes;Thermaerobacteria;Thermaerobacterales;";"100.0";"18.2";"10";"10";"10";"0";"0";"457173";"373884"
"V4mis1";"SILVA (only NR);Bacteria;Firmicutes;Thermaerobacteria;Thermaerobacterales;Thermaerobacteraceae;";"100.0";"18.2";"10";"10";"10";"0";"0";"457173";"373884"
"V4mis1";"SILVA (only NR);Bacteria;Firmicutes;Thermaerobacteria;Thermaerobacterales;Thermaerobacteraceae;Thermaerobacter;";"100.0";"18.2";"10";"10";"10";"0";"0";"457173";"373884"
"V4mis1";"SILVA (only NR);Bacteria;Firmicutes;Thermincolia;";"87.5";"18.2";"8";"8";"7";"1";"0";"457175";"373887"
"V4mis1";"SILVA (only NR);Bacteria;Firmicutes;Thermincolia;Carboxydocellales;";"87.5";"18.2";"8";"8";"7";"1";"0";"457175";"373887"
"V4mis1";"SILVA (only NR);Bacteria;Firmicutes;Thermincolia;Carboxydocellales;Carboxydocellaceae;";"87.5";"18.2";"8";"8";"7";"1";"0";"457175";"373887"
"V4mis1";"SILVA (only NR);Bacteria;Firmicutes;Thermincolia;Carboxydocellales;Carboxydocellaceae;Carboxydocella;";"87.5";"18.2";"8";"8";"7";"1";"0";"457175";"373887"
"V4mis1";"SILVA (only NR);Bacteria;Firmicutes;Thermoanaerobacteria;";"92.6";"18.2";"431";"431";"399";"32";"0";"456752";"373495"
"V4mis1";"SILVA (only NR);Bacteria;Firmicutes;Thermoanaerobacteria;Caldicellulosiruptorales;";"89.1";"18.2";"174";"174";"155";"19";"0";"457009";"373739"
"V4mis1";"SILVA (only NR);Bacteria;Firmicutes;Thermoanaerobacteria;Caldicellulosiruptorales;Caldicellulosiraptoraceae;";"88.2";"18.2";"153";"153";"135";"18";"0";"457030";"373759"
"V4mis1";"SILVA (only NR);Bacteria;Firmicutes;Thermoanaerobacteria;Caldicellulosiruptorales;Caldicellulosiraptoraceae;Caldicellulosiruptor;";"88.2";"18.2";"153";"153";"135";"18";"0";"457030";"373759"
"V4mis1";"SILVA (only NR);Bacteria;Firmicutes;Thermoanaerobacteria;Caldicellulosiruptorales;uncultured;";"95.2";"18.2";"21";"21";"20";"1";"0";"457162";"373874"
"V4mis1";"SILVA (only NR);Bacteria;Firmicutes;Thermoanaerobacteria;Thermoanaerobacterales;";"94.9";"18.2";"257";"257";"244";"13";"0";"456926";"373650"
"V4mis1";"SILVA (only NR);Bacteria;Firmicutes;Thermoanaerobacteria;Thermoanaerobacterales;Family III;";"93.6";"18.2";"47";"47";"44";"3";"0";"457136";"373850"
"V4mis1";"SILVA (only NR);Bacteria;Firmicutes;Thermoanaerobacteria;Thermoanaerobacterales;Family III;Thermoanaerobacterium;";"93.6";"18.2";"47";"47";"44";"3";"0";"457136";"373850"
"V4mis1";"SILVA (only NR);Bacteria;Firmicutes;Thermoanaerobacteria;Thermoanaerobacterales;Family IV;";"100.0";"18.2";"6";"6";"6";"0";"0";"457177";"373888"
"V4mis1";"SILVA (only NR);Bacteria;Firmicutes;Thermoanaerobacteria;Thermoanaerobacterales;Family IV;Mahella;";"100.0";"18.2";"6";"6";"6";"0";"0";"457177";"373888"
"V4mis1";"SILVA (only NR);Bacteria;Firmicutes;Thermoanaerobacteria;Thermoanaerobacterales;SRB2;";"96.9";"18.2";"32";"32";"31";"1";"0";"457151";"373863"
"V4mis1";"SILVA (only NR);Bacteria;Firmicutes;Thermoanaerobacteria;Thermoanaerobacterales;Thermoanaerobacteraceae;";"94.8";"18.2";"172";"172";"163";"9";"0";"457011";"373731"
"V4mis1";"SILVA (only NR);Bacteria;Firmicutes;Thermoanaerobacteria;Thermoanaerobacterales;Thermoanaerobacteraceae;Brockia;";"100.0";"18.2";"3";"3";"3";"0";"0";"457180";"373891"
"V4mis1";"SILVA (only NR);Bacteria;Firmicutes;Thermoanaerobacteria;Thermoanaerobacterales;Thermoanaerobacteraceae;Caldanaerobacter;";"98.1";"18.2";"53";"53";"52";"1";"0";"457130";"373842"
"V4mis1";"SILVA (only NR);Bacteria;Firmicutes;Thermoanaerobacteria;Thermoanaerobacterales;Thermoanaerobacteraceae;Caldanaerobius;";"87.5";"18.2";"8";"8";"7";"1";"0";"457175";"373887"
"V4mis1";"SILVA (only NR);Bacteria;Firmicutes;Thermoanaerobacteria;Thermoanaerobacterales;Thermoanaerobacteraceae;Caloribacterium;";"100.0";"18.2";"5";"5";"5";"0";"0";"457178";"373889"
"V4mis1";"SILVA (only NR);Bacteria;Firmicutes;Thermoanaerobacteria;Thermoanaerobacterales;Thermoanaerobacteraceae;Desulfovirgula;";"100.0";"18.2";"1";"1";"1";"0";"0";"457182";"373893"
"V4mis1";"SILVA (only NR);Bacteria;Firmicutes;Thermoanaerobacteria;Thermoanaerobacterales;Thermoanaerobacteraceae;Thermanaeromonas;";"92.3";"18.2";"13";"13";"12";"1";"0";"457170";"373882"
"V4mis1";"SILVA (only NR);Bacteria;Firmicutes;Thermoanaerobacteria;Thermoanaerobacterales;Thermoanaerobacteraceae;Thermoanaerobacter;";"93.3";"18.2";"89";"89";"83";"6";"0";"457094";"373811"
"V4mis1";"SILVA (only NR);Bacteria;Firmicutes;Thermovenabulia;";"93.7";"18.2";"63";"63";"59";"4";"0";"457120";"373835"
"V4mis1";"SILVA (only NR);Bacteria;Firmicutes;Thermovenabulia;Thermovenabulales;";"93.7";"18.2";"63";"63";"59";"4";"0";"457120";"373835"
"V4mis1";"SILVA (only NR);Bacteria;Firmicutes;Thermovenabulia;Thermovenabulales;Caldanaerovirga;";"100.0";"18.2";"1";"1";"1";"0";"0";"457182";"373893"
"V4mis1";"SILVA (only NR);Bacteria;Firmicutes;Thermovenabulia;Thermovenabulales;Fervidicola;";"100.0";"18.2";"1";"1";"1";"0";"0";"457182";"373893"
"V4mis1";"SILVA (only NR);Bacteria;Firmicutes;Thermovenabulia;Thermovenabulales;Tepidanaerobacter;";"92.5";"18.2";"40";"40";"37";"3";"0";"457143";"373857"
"V4mis1";"SILVA (only NR);Bacteria;Firmicutes;Thermovenabulia;Thermovenabulales;Thermosediminibacter;";"100.0";"18.2";"4";"4";"4";"0";"0";"457179";"373890"
"V4mis1";"SILVA (only NR);Bacteria;Firmicutes;Thermovenabulia;Thermovenabulales;Thermovenabulum;";"83.3";"18.2";"6";"6";"5";"1";"0";"457177";"373889"
"V4mis1";"SILVA (only NR);Bacteria;Firmicutes;Thermovenabulia;Thermovenabulales;Thermovorax;";"100.0";"18.2";"1";"1";"1";"0";"0";"457182";"373893"
"V4mis1";"SILVA (only NR);Bacteria;Firmicutes;Thermovenabulia;Thermovenabulales;uncultured;";"100.0";"18.2";"8";"8";"8";"0";"0";"457175";"373886"
"V4mis1";"SILVA (only NR);Bacteria;Firmicutes;YNPFFP2;";"100.0";"18.2";"3";"3";"3";"0";"0";"457180";"373891"
"V4mis1";"SILVA (only NR);Bacteria;Firmicutes;uncultured;";"98.7";"18.2";"77";"77";"76";"1";"0";"457106";"373818"
"V4mis1";"SILVA (only NR);Bacteria;Fusobacteriota;";"91.3";"18.3";"1628";"1628";"1486";"142";"0";"455555";"372408"
"V4mis1";"SILVA (only NR);Bacteria;Fusobacteriota;Fusobacteriia;";"91.3";"18.3";"1628";"1628";"1486";"142";"0";"455555";"372408"
"V4mis1";"SILVA (only NR);Bacteria;Fusobacteriota;Fusobacteriia;Fusobacteriales;";"91.3";"18.3";"1628";"1628";"1486";"142";"0";"455555";"372408"
"V4mis1";"SILVA (only NR);Bacteria;Fusobacteriota;Fusobacteriia;Fusobacteriales;Fusobacteriaceae;";"90.1";"18.2";"1166";"1166";"1050";"116";"0";"456017";"372844"
"V4mis1";"SILVA (only NR);Bacteria;Fusobacteriota;Fusobacteriia;Fusobacteriales;Fusobacteriaceae;Cetobacterium;";"91.2";"18.2";"136";"136";"124";"12";"0";"457047";"373770"
"V4mis1";"SILVA (only NR);Bacteria;Fusobacteriota;Fusobacteriia;Fusobacteriales;Fusobacteriaceae;Fusobacterium;";"89.8";"18.2";"988";"988";"887";"101";"0";"456195";"373007"
"V4mis1";"SILVA (only NR);Bacteria;Fusobacteriota;Fusobacteriia;Fusobacteriales;Fusobacteriaceae;Ilyobacter;";"100.0";"18.2";"6";"6";"6";"0";"0";"457177";"373888"
"V4mis1";"SILVA (only NR);Bacteria;Fusobacteriota;Fusobacteriia;Fusobacteriales;Fusobacteriaceae;Propionigenium;";"86.7";"18.2";"15";"15";"13";"2";"0";"457168";"373881"
"V4mis1";"SILVA (only NR);Bacteria;Fusobacteriota;Fusobacteriia;Fusobacteriales;Fusobacteriaceae;Psychrilyobacter;";"95.0";"18.2";"20";"20";"19";"1";"0";"457163";"373875"
"V4mis1";"SILVA (only NR);Bacteria;Fusobacteriota;Fusobacteriia;Fusobacteriales;Leptotrichiaceae;";"94.4";"18.2";"462";"462";"436";"26";"0";"456721";"373458"
"V4mis1";"SILVA (only NR);Bacteria;Fusobacteriota;Fusobacteriia;Fusobacteriales;Leptotrichiaceae;Caviibacter;";"100.0";"18.2";"3";"3";"3";"0";"0";"457180";"373891"
"V4mis1";"SILVA (only NR);Bacteria;Fusobacteriota;Fusobacteriia;Fusobacteriales;Leptotrichiaceae;Hypnocyclicus;";"94.4";"18.2";"18";"18";"17";"1";"0";"457165";"373877"
"V4mis1";"SILVA (only NR);Bacteria;Fusobacteriota;Fusobacteriia;Fusobacteriales;Leptotrichiaceae;Leptotrichia;";"93.7";"18.2";"334";"334";"313";"21";"0";"456849";"373581"
"V4mis1";"SILVA (only NR);Bacteria;Fusobacteriota;Fusobacteriia;Fusobacteriales;Leptotrichiaceae;Oceanivirga;";"100.0";"18.2";"40";"40";"40";"0";"0";"457143";"373854"
"V4mis1";"SILVA (only NR);Bacteria;Fusobacteriota;Fusobacteriia;Fusobacteriales;Leptotrichiaceae;Sebaldella;";"100.0";"18.2";"4";"4";"4";"0";"0";"457179";"373890"
"V4mis1";"SILVA (only NR);Bacteria;Fusobacteriota;Fusobacteriia;Fusobacteriales;Leptotrichiaceae;Sneathia;";"88.9";"18.2";"9";"9";"8";"1";"0";"457174";"373886"
"V4mis1";"SILVA (only NR);Bacteria;Fusobacteriota;Fusobacteriia;Fusobacteriales;Leptotrichiaceae;Streptobacillus;";"90.9";"18.2";"22";"22";"20";"2";"0";"457161";"373874"
"V4mis1";"SILVA (only NR);Bacteria;Fusobacteriota;Fusobacteriia;Fusobacteriales;Leptotrichiaceae;uncultured;";"96.9";"18.2";"32";"32";"31";"1";"0";"457151";"373863"
"V4mis1";"SILVA (only NR);Bacteria;GAL15;";"93.5";"18.2";"46";"46";"43";"3";"0";"457137";"373851"
"V4mis1";"SILVA (only NR);Bacteria;GN01;";"83.1";"18.2";"136";"136";"113";"23";"0";"457047";"373781"
"V4mis1";"SILVA (only NR);Bacteria;Gemmatimonadota;";"93.5";"18.3";"2119";"2119";"1982";"137";"0";"455064";"371912"
"V4mis1";"SILVA (only NR);Bacteria;Gemmatimonadota;AKAU4049;";"100.0";"18.2";"9";"9";"9";"0";"0";"457174";"373885"
"V4mis1";"SILVA (only NR);Bacteria;Gemmatimonadota;BD2-11 terrestrial group;";"94.6";"18.2";"386";"386";"365";"21";"0";"456797";"373529"
"V4mis1";"SILVA (only NR);Bacteria;Gemmatimonadota;Gemmatimonadetes;";"95.0";"18.3";"1196";"1196";"1136";"60";"0";"455987";"372758"
"V4mis1";"SILVA (only NR);Bacteria;Gemmatimonadota;Gemmatimonadetes;Gemmatimonadales;";"95.0";"18.3";"1196";"1196";"1136";"60";"0";"455987";"372758"
"V4mis1";"SILVA (only NR);Bacteria;Gemmatimonadota;Gemmatimonadetes;Gemmatimonadales;Gemmatimonadaceae;";"95.0";"18.3";"1196";"1196";"1136";"60";"0";"455987";"372758"
"V4mis1";"SILVA (only NR);Bacteria;Gemmatimonadota;Gemmatimonadetes;Gemmatimonadales;Gemmatimonadaceae;Gemmatimonas;";"96.1";"18.2";"259";"259";"249";"10";"0";"456924";"373645"
"V4mis1";"SILVA (only NR);Bacteria;Gemmatimonadota;Gemmatimonadetes;Gemmatimonadales;Gemmatimonadaceae;Gemmatirosa;";"85.7";"18.2";"7";"7";"6";"1";"0";"457176";"373888"
"V4mis1";"SILVA (only NR);Bacteria;Gemmatimonadota;Gemmatimonadetes;Gemmatimonadales;Gemmatimonadaceae;Roseisolibacter;";"100.0";"18.2";"8";"8";"8";"0";"0";"457175";"373886"
"V4mis1";"SILVA (only NR);Bacteria;Gemmatimonadota;Gemmatimonadetes;Gemmatimonadales;Gemmatimonadaceae;uncultured;";"94.8";"18.2";"916";"916";"868";"48";"0";"456267";"373026"
"V4mis1";"SILVA (only NR);Bacteria;Gemmatimonadota;Longimicrobia;";"83.1";"18.2";"219";"219";"182";"37";"0";"456964";"373712"
"V4mis1";"SILVA (only NR);Bacteria;Gemmatimonadota;Longimicrobia;Longimicrobiales;";"83.1";"18.2";"219";"219";"182";"37";"0";"456964";"373712"
"V4mis1";"SILVA (only NR);Bacteria;Gemmatimonadota;Longimicrobia;Longimicrobiales;Longimicrobiaceae;";"83.1";"18.2";"219";"219";"182";"37";"0";"456964";"373712"
"V4mis1";"SILVA (only NR);Bacteria;Gemmatimonadota;Longimicrobia;Longimicrobiales;Longimicrobiaceae;Longimicrobium;";"93.3";"18.2";"15";"15";"14";"1";"0";"457168";"373880"
"V4mis1";"SILVA (only NR);Bacteria;Gemmatimonadota;Longimicrobia;Longimicrobiales;Longimicrobiaceae;YC-ZSS-LKJ147;";"89.5";"18.2";"38";"38";"34";"4";"0";"457145";"373860"
"V4mis1";"SILVA (only NR);Bacteria;Gemmatimonadota;MD2902-B12;";"78.9";"18.2";"19";"19";"15";"4";"0";"457164";"373879"
"V4mis1";"SILVA (only NR);Bacteria;Gemmatimonadota;PAUC43f marine benthic group;";"95.9";"18.2";"98";"98";"94";"4";"0";"457085";"373800"
"V4mis1";"SILVA (only NR);Bacteria;Gemmatimonadota;S0134 terrestrial group;";"94.3";"18.2";"192";"192";"181";"11";"0";"456991";"373713"
"V4mis1";"SILVA (only NR);Bacteria;Halanaerobiaeota;";"93.0";"18.2";"244";"244";"227";"17";"0";"456939";"373667"
"V4mis1";"SILVA (only NR);Bacteria;Halanaerobiaeota;Halanaerobiia;";"93.0";"18.2";"244";"244";"227";"17";"0";"456939";"373667"
"V4mis1";"SILVA (only NR);Bacteria;Halanaerobiaeota;Halanaerobiia;Halanaerobiales;";"93.0";"18.2";"244";"244";"227";"17";"0";"456939";"373667"
"V4mis1";"SILVA (only NR);Bacteria;Halanaerobiaeota;Halanaerobiia;Halanaerobiales;Halanaerobiaceae;";"93.5";"18.2";"169";"169";"158";"11";"0";"457014";"373736"
"V4mis1";"SILVA (only NR);Bacteria;Halanaerobiaeota;Halanaerobiia;Halanaerobiales;Halanaerobiaceae;Halanaerobium;";"92.4";"18.2";"131";"131";"121";"10";"0";"457052";"373773"
"V4mis1";"SILVA (only NR);Bacteria;Halanaerobiaeota;Halanaerobiia;Halanaerobiales;Halanaerobiaceae;Halarsenatibacter;";"91.7";"18.2";"12";"12";"11";"1";"0";"457171";"373883"
"V4mis1";"SILVA (only NR);Bacteria;Halanaerobiaeota;Halanaerobiia;Halanaerobiales;Halanaerobiaceae;Halocella;";"100.0";"18.2";"23";"23";"23";"0";"0";"457160";"373871"
"V4mis1";"SILVA (only NR);Bacteria;Halanaerobiaeota;Halanaerobiia;Halanaerobiales;Halanaerobiaceae;Halothermothrix;";"100.0";"18.2";"3";"3";"3";"0";"0";"457180";"373891"
"V4mis1";"SILVA (only NR);Bacteria;Halanaerobiaeota;Halanaerobiia;Halanaerobiales;Halobacteroidaceae;";"92.0";"18.2";"75";"75";"69";"6";"0";"457108";"373825"
"V4mis1";"SILVA (only NR);Bacteria;Halanaerobiaeota;Halanaerobiia;Halanaerobiales;Halobacteroidaceae;Acetohalobium;";"66.7";"18.2";"3";"3";"2";"1";"0";"457180";"373892"
"V4mis1";"SILVA (only NR);Bacteria;Halanaerobiaeota;Halanaerobiia;Halanaerobiales;Halobacteroidaceae;Fuchsiella;";"100.0";"18.2";"3";"3";"3";"0";"0";"457180";"373891"
"V4mis1";"SILVA (only NR);Bacteria;Halanaerobiaeota;Halanaerobiia;Halanaerobiales;Halobacteroidaceae;Halanaerobacter;";"100.0";"18.2";"10";"10";"10";"0";"0";"457173";"373884"
"V4mis1";"SILVA (only NR);Bacteria;Halanaerobiaeota;Halanaerobiia;Halanaerobiales;Halobacteroidaceae;Halanaerobaculum;";"100.0";"18.2";"2";"2";"2";"0";"0";"457181";"373892"
"V4mis1";"SILVA (only NR);Bacteria;Halanaerobiaeota;Halanaerobiia;Halanaerobiales;Halobacteroidaceae;Halobacteroides;";"100.0";"18.2";"5";"5";"5";"0";"0";"457178";"373889"
"V4mis1";"SILVA (only NR);Bacteria;Halanaerobiaeota;Halanaerobiia;Halanaerobiales;Halobacteroidaceae;Halonatronum;";"66.7";"18.2";"3";"3";"2";"1";"0";"457180";"373892"
"V4mis1";"SILVA (only NR);Bacteria;Halanaerobiaeota;Halanaerobiia;Halanaerobiales;Halobacteroidaceae;Natroniella;";"100.0";"18.2";"4";"4";"4";"0";"0";"457179";"373890"
"V4mis1";"SILVA (only NR);Bacteria;Halanaerobiaeota;Halanaerobiia;Halanaerobiales;Halobacteroidaceae;Orenia;";"89.5";"18.2";"19";"19";"17";"2";"0";"457164";"373877"
"V4mis1";"SILVA (only NR);Bacteria;Halanaerobiaeota;Halanaerobiia;Halanaerobiales;Halobacteroidaceae;Selenihalanaerobacter;";"100.0";"18.2";"1";"1";"1";"0";"0";"457182";"373893"
"V4mis1";"SILVA (only NR);Bacteria;Halanaerobiaeota;Halanaerobiia;Halanaerobiales;Halobacteroidaceae;Sporohalobacter;";"100.0";"18.2";"4";"4";"4";"0";"0";"457179";"373890"
"V4mis1";"SILVA (only NR);Bacteria;Halanaerobiaeota;Halanaerobiia;Halanaerobiales;Halobacteroidaceae;uncultured;";"89.5";"18.2";"19";"19";"17";"2";"0";"457164";"373877"
"V4mis1";"SILVA (only NR);Bacteria;Hydrogenedentes;";"94.7";"18.2";"263";"263";"249";"14";"0";"456920";"373645"
"V4mis1";"SILVA (only NR);Bacteria;Hydrogenedentes;Hydrogenedentia;";"94.7";"18.2";"263";"263";"249";"14";"0";"456920";"373645"
"V4mis1";"SILVA (only NR);Bacteria;Hydrogenedentes;Hydrogenedentia;Hydrogenedentiales;";"94.7";"18.2";"263";"263";"249";"14";"0";"456920";"373645"
"V4mis1";"SILVA (only NR);Bacteria;Hydrogenedentes;Hydrogenedentia;Hydrogenedentiales;Hydrogenedensaceae;";"94.7";"18.2";"263";"263";"249";"14";"0";"456920";"373645"
"V4mis1";"SILVA (only NR);Bacteria;Hydrogenedentes;Hydrogenedentia;Hydrogenedentiales;Hydrogenedensaceae;Candidatus Hydrogenedens;";"100.0";"18.2";"3";"3";"3";"0";"0";"457180";"373891"
"V4mis1";"SILVA (only NR);Bacteria;Hydrogenedentes;Hydrogenedentia;Hydrogenedentiales;Hydrogenedensaceae;YC-ZSS-LKJ63;";"91.7";"18.2";"24";"24";"22";"2";"0";"457159";"373872"
"V4mis1";"SILVA (only NR);Bacteria;Hydrothermae;";"97.4";"18.2";"39";"39";"38";"1";"0";"457144";"373856"
"V4mis1";"SILVA (only NR);Bacteria;LCP-89;";"97.9";"18.2";"48";"48";"47";"1";"0";"457135";"373847"
"V4mis1";"SILVA (only NR);Bacteria;Latescibacterota;";"95.4";"18.2";"505";"505";"482";"23";"0";"456678";"373412"
"V4mis1";"SILVA (only NR);Bacteria;Latescibacterota;Latescibacteria;";"97.3";"18.2";"184";"184";"179";"5";"0";"456999";"373715"
"V4mis1";"SILVA (only NR);Bacteria;Latescibacterota;Latescibacteria;Latescibacterales;";"97.3";"18.2";"184";"184";"179";"5";"0";"456999";"373715"
"V4mis1";"SILVA (only NR);Bacteria;Latescibacterota;Latescibacteria;Latescibacterales;Latescibacteraceae;";"97.3";"18.2";"184";"184";"179";"5";"0";"456999";"373715"
"V4mis1";"SILVA (only NR);Bacteria;Latescibacterota;Latescibacteria;Latescibacterales;Latescibacteraceae;Candidatus Latescibacter;";"98.2";"18.2";"55";"55";"54";"1";"0";"457128";"373840"
"V4mis1";"SILVA (only NR);Bacteria;MAT-CR-M4-B07;";"92.9";"18.2";"28";"28";"26";"2";"0";"457155";"373868"
"V4mis1";"SILVA (only NR);Bacteria;MBNT15;";"97.5";"18.2";"160";"160";"156";"4";"0";"457023";"373738"
"V4mis1";"SILVA (only NR);Bacteria;Margulisbacteria;";"97.7";"18.2";"87";"87";"85";"2";"0";"457096";"373809"
"V4mis1";"SILVA (only NR);Bacteria;Marinimicrobia (SAR406 clade);";"95.8";"18.2";"664";"664";"636";"28";"0";"456519";"373258"
"V4mis1";"SILVA (only NR);Bacteria;Methylomirabilota;";"93.8";"18.2";"370";"370";"347";"23";"0";"456813";"373547"
"V4mis1";"SILVA (only NR);Bacteria;Methylomirabilota;Methylomirabilia;";"93.8";"18.2";"370";"370";"347";"23";"0";"456813";"373547"
"V4mis1";"SILVA (only NR);Bacteria;Methylomirabilota;Methylomirabilia;Methylomirabilales;";"97.2";"18.2";"108";"108";"105";"3";"0";"457075";"373789"
"V4mis1";"SILVA (only NR);Bacteria;Methylomirabilota;Methylomirabilia;Methylomirabilales;Methylomirabilaceae;";"97.2";"18.2";"108";"108";"105";"3";"0";"457075";"373789"
"V4mis1";"SILVA (only NR);Bacteria;Methylomirabilota;Methylomirabilia;Methylomirabilales;Methylomirabilaceae;Candidatus Methylomirabilis;";"100.0";"18.2";"25";"25";"25";"0";"0";"457158";"373869"
"V4mis1";"SILVA (only NR);Bacteria;Methylomirabilota;Methylomirabilia;Methylomirabilales;Methylomirabilaceae;MIZ14;";"100.0";"18.2";"2";"2";"2";"0";"0";"457181";"373892"
"V4mis1";"SILVA (only NR);Bacteria;Methylomirabilota;Methylomirabilia;Methylomirabilales;Methylomirabilaceae;MIZ17;";"100.0";"18.2";"7";"7";"7";"0";"0";"457176";"373887"
"V4mis1";"SILVA (only NR);Bacteria;Methylomirabilota;Methylomirabilia;Methylomirabilales;Methylomirabilaceae;Sh765B-TzT-35;";"96.9";"18.2";"32";"32";"31";"1";"0";"457151";"373863"
"V4mis1";"SILVA (only NR);Bacteria;Methylomirabilota;Methylomirabilia;Methylomirabilales;Methylomirabilaceae;Z114MB74;";"100.0";"18.2";"5";"5";"5";"0";"0";"457178";"373889"
"V4mis1";"SILVA (only NR);Bacteria;Methylomirabilota;Methylomirabilia;Methylomirabilales;Methylomirabilaceae;wb1-A12;";"94.6";"18.2";"37";"37";"35";"2";"0";"457146";"373859"
"V4mis1";"SILVA (only NR);Bacteria;Methylomirabilota;Methylomirabilia;Rokubacteriales;";"92.4";"18.2";"262";"262";"242";"20";"0";"456921";"373652"
"V4mis1";"SILVA (only NR);Bacteria;Methylomirabilota;Methylomirabilia;Rokubacteriales;WX65;";"85.7";"18.2";"21";"21";"18";"3";"0";"457162";"373876"
"V4mis1";"SILVA (only NR);Bacteria;Modulibacteria;";"83.5";"18.2";"248";"248";"207";"41";"0";"456935";"373687"
"V4mis1";"SILVA (only NR);Bacteria;Modulibacteria;Moduliflexia;";"83.5";"18.2";"248";"248";"207";"41";"0";"456935";"373687"
"V4mis1";"SILVA (only NR);Bacteria;Modulibacteria;Moduliflexia;Moduliflexales;";"83.5";"18.2";"248";"248";"207";"41";"0";"456935";"373687"
"V4mis1";"SILVA (only NR);Bacteria;Modulibacteria;Moduliflexia;Moduliflexales;Moduliflexaceae;";"83.5";"18.2";"248";"248";"207";"41";"0";"456935";"373687"
"V4mis1";"SILVA (only NR);Bacteria;Modulibacteria;Moduliflexia;Moduliflexales;Moduliflexaceae;Candidatus Moduliflexus;";"66.7";"18.2";"3";"3";"2";"1";"0";"457180";"373892"
"V4mis1";"SILVA (only NR);Bacteria;Myxococcota;";"96.0";"18.3";"3013";"3013";"2891";"122";"0";"454170";"371003"
"V4mis1";"SILVA (only NR);Bacteria;Myxococcota;Myxococcia;";"95.8";"18.2";"731";"731";"700";"31";"0";"456452";"373194"
"V4mis1";"SILVA (only NR);Bacteria;Myxococcota;Myxococcia;Myxococcales;";"95.8";"18.2";"731";"731";"700";"31";"0";"456452";"373194"
"V4mis1";"SILVA (only NR);Bacteria;Myxococcota;Myxococcia;Myxococcales;27F-1492R;";"72.7";"18.2";"11";"11";"8";"3";"0";"457172";"373886"
"V4mis1";"SILVA (only NR);Bacteria;Myxococcota;Myxococcia;Myxococcales;Anaeromyxobacteraceae;";"97.3";"18.2";"110";"110";"107";"3";"0";"457073";"373787"
"V4mis1";"SILVA (only NR);Bacteria;Myxococcota;Myxococcia;Myxococcales;Anaeromyxobacteraceae;Anaeromyxobacter;";"97.3";"18.2";"110";"110";"107";"3";"0";"457073";"373787"
"V4mis1";"SILVA (only NR);Bacteria;Myxococcota;Myxococcia;Myxococcales;Myxococcaceae;";"95.8";"18.2";"591";"591";"566";"25";"0";"456592";"373328"
"V4mis1";"SILVA (only NR);Bacteria;Myxococcota;Myxococcia;Myxococcales;Myxococcaceae;Aggregicoccus;";"100.0";"18.2";"2";"2";"2";"0";"0";"457181";"373892"
"V4mis1";"SILVA (only NR);Bacteria;Myxococcota;Myxococcia;Myxococcales;Myxococcaceae;Angiococcus;";"80.0";"18.2";"5";"5";"4";"1";"0";"457178";"373890"
"V4mis1";"SILVA (only NR);Bacteria;Myxococcota;Myxococcia;Myxococcales;Myxococcaceae;Archangium;";"94.4";"18.2";"18";"18";"17";"1";"0";"457165";"373877"
"V4mis1";"SILVA (only NR);Bacteria;Myxococcota;Myxococcia;Myxococcales;Myxococcaceae;Corallococcus;";"93.9";"18.2";"66";"66";"62";"4";"0";"457117";"373832"
"V4mis1";"SILVA (only NR);Bacteria;Myxococcota;Myxococcia;Myxococcales;Myxococcaceae;Cystobacter;";"94.4";"18.2";"18";"18";"17";"1";"0";"457165";"373877"
"V4mis1";"SILVA (only NR);Bacteria;Myxococcota;Myxococcia;Myxococcales;Myxococcaceae;Hyalangium;";"100.0";"18.2";"1";"1";"1";"0";"0";"457182";"373893"
"V4mis1";"SILVA (only NR);Bacteria;Myxococcota;Myxococcia;Myxococcales;Myxococcaceae;KD3-10;";"100.0";"18.2";"23";"23";"23";"0";"0";"457160";"373871"
"V4mis1";"SILVA (only NR);Bacteria;Myxococcota;Myxococcia;Myxococcales;Myxococcaceae;Melittangium;";"85.7";"18.2";"7";"7";"6";"1";"0";"457176";"373888"
"V4mis1";"SILVA (only NR);Bacteria;Myxococcota;Myxococcia;Myxococcales;Myxococcaceae;Myxococcus;";"97.0";"18.2";"101";"101";"98";"3";"0";"457082";"373796"
"V4mis1";"SILVA (only NR);Bacteria;Myxococcota;Myxococcia;Myxococcales;Myxococcaceae;P3OB-42;";"96.3";"18.2";"268";"268";"258";"10";"0";"456915";"373636"
"V4mis1";"SILVA (only NR);Bacteria;Myxococcota;Myxococcia;Myxococcales;Myxococcaceae;Pyxidicoccus;";"100.0";"18.2";"4";"4";"4";"0";"0";"457179";"373890"
"V4mis1";"SILVA (only NR);Bacteria;Myxococcota;Myxococcia;Myxococcales;Myxococcaceae;Stigmatella;";"100.0";"18.2";"13";"13";"13";"0";"0";"457170";"373881"
"V4mis1";"SILVA (only NR);Bacteria;Myxococcota;Myxococcia;Myxococcales;Myxococcaceae;Vitiosangium;";"100.0";"18.2";"2";"2";"2";"0";"0";"457181";"373892"
"V4mis1";"SILVA (only NR);Bacteria;Myxococcota;Myxococcia;Myxococcales;Myxococcaceae;uncultured;";"92.3";"18.2";"52";"52";"48";"4";"0";"457131";"373846"
"V4mis1";"SILVA (only NR);Bacteria;Myxococcota;Myxococcia;Myxococcales;Vulgatibacteraceae;";"100.0";"18.2";"19";"19";"19";"0";"0";"457164";"373875"
"V4mis1";"SILVA (only NR);Bacteria;Myxococcota;Myxococcia;Myxococcales;Vulgatibacteraceae;Vulgatibacter;";"100.0";"18.2";"19";"19";"19";"0";"0";"457164";"373875"
"V4mis1";"SILVA (only NR);Bacteria;Myxococcota;Polyangia;";"96.0";"18.3";"1911";"1911";"1835";"76";"0";"455272";"372059"
"V4mis1";"SILVA (only NR);Bacteria;Myxococcota;Polyangia;Blfdi19;";"98.4";"18.2";"63";"63";"62";"1";"0";"457120";"373832"
"V4mis1";"SILVA (only NR);Bacteria;Myxococcota;Polyangia;FFCH16767;";"66.7";"18.2";"3";"3";"2";"1";"0";"457180";"373892"
"V4mis1";"SILVA (only NR);Bacteria;Myxococcota;Polyangia;Haliangiales;";"97.3";"18.2";"560";"560";"545";"15";"0";"456623";"373349"
"V4mis1";"SILVA (only NR);Bacteria;Myxococcota;Polyangia;Haliangiales;Haliangiaceae;";"97.3";"18.2";"560";"560";"545";"15";"0";"456623";"373349"
"V4mis1";"SILVA (only NR);Bacteria;Myxococcota;Polyangia;Haliangiales;Haliangiaceae;Haliangium;";"97.3";"18.2";"560";"560";"545";"15";"0";"456623";"373349"
"V4mis1";"SILVA (only NR);Bacteria;Myxococcota;Polyangia;MSB-4B10;";"100.0";"18.2";"15";"15";"15";"0";"0";"457168";"373879"
"V4mis1";"SILVA (only NR);Bacteria;Myxococcota;Polyangia;MidBa8;";"87.3";"18.2";"63";"63";"55";"8";"0";"457120";"373839"
"V4mis1";"SILVA (only NR);Bacteria;Myxococcota;Polyangia;Nannocystales;";"91.9";"18.2";"123";"123";"113";"10";"0";"457060";"373781"
"V4mis1";"SILVA (only NR);Bacteria;Myxococcota;Polyangia;Nannocystales;Nannocystaceae;";"91.9";"18.2";"123";"123";"113";"10";"0";"457060";"373781"
"V4mis1";"SILVA (only NR);Bacteria;Myxococcota;Polyangia;Nannocystales;Nannocystaceae;Enhygromyxa;";"85.7";"18.2";"7";"7";"6";"1";"0";"457176";"373888"
"V4mis1";"SILVA (only NR);Bacteria;Myxococcota;Polyangia;Nannocystales;Nannocystaceae;Nannocystis;";"93.1";"18.2";"58";"58";"54";"4";"0";"457125";"373840"
"V4mis1";"SILVA (only NR);Bacteria;Myxococcota;Polyangia;Nannocystales;Nannocystaceae;Plesiocystis;";"100.0";"18.2";"5";"5";"5";"0";"0";"457178";"373889"
"V4mis1";"SILVA (only NR);Bacteria;Myxococcota;Polyangia;Nannocystales;Nannocystaceae;Pseudenhygromyxa;";"100.0";"18.2";"7";"7";"7";"0";"0";"457176";"373887"
"V4mis1";"SILVA (only NR);Bacteria;Myxococcota;Polyangia;Nannocystales;Nannocystaceae;uncultured;";"86.5";"18.2";"37";"37";"32";"5";"0";"457146";"373862"
"V4mis1";"SILVA (only NR);Bacteria;Myxococcota;Polyangia;PS-B29;";"92.0";"18.2";"25";"25";"23";"2";"0";"457158";"373871"
"V4mis1";"SILVA (only NR);Bacteria;Myxococcota;Polyangia;Polyangiales;";"96.0";"18.2";"907";"907";"871";"36";"0";"456276";"373023"
"V4mis1";"SILVA (only NR);Bacteria;Myxococcota;Polyangia;Polyangiales;Amb-16S-1034;";"100.0";"18.2";"3";"3";"3";"0";"0";"457180";"373891"
"V4mis1";"SILVA (only NR);Bacteria;Myxococcota;Polyangia;Polyangiales;BIrii41;";"95.3";"18.2";"171";"171";"163";"8";"0";"457012";"373731"
"V4mis1";"SILVA (only NR);Bacteria;Myxococcota;Polyangia;Polyangiales;Eel-36e1D6;";"100.0";"18.2";"17";"17";"17";"0";"0";"457166";"373877"
"V4mis1";"SILVA (only NR);Bacteria;Myxococcota;Polyangia;Polyangiales;Phaselicystidaceae;";"99.0";"18.2";"102";"102";"101";"1";"0";"457081";"373793"
"V4mis1";"SILVA (only NR);Bacteria;Myxococcota;Polyangia;Polyangiales;Phaselicystidaceae;Phaselicystis;";"99.0";"18.2";"102";"102";"101";"1";"0";"457081";"373793"
"V4mis1";"SILVA (only NR);Bacteria;Myxococcota;Polyangia;Polyangiales;Polyangiaceae;";"95.2";"18.2";"293";"293";"279";"14";"0";"456890";"373615"
"V4mis1";"SILVA (only NR);Bacteria;Myxococcota;Polyangia;Polyangiales;Polyangiaceae;Aetherobacter;";"100.0";"18.2";"8";"8";"8";"0";"0";"457175";"373886"
"V4mis1";"SILVA (only NR);Bacteria;Myxococcota;Polyangia;Polyangiales;Polyangiaceae;Byssovorax;";"100.0";"18.2";"2";"2";"2";"0";"0";"457181";"373892"
"V4mis1";"SILVA (only NR);Bacteria;Myxococcota;Polyangia;Polyangiales;Polyangiaceae;Chondromyces;";"100.0";"18.2";"7";"7";"7";"0";"0";"457176";"373887"
"V4mis1";"SILVA (only NR);Bacteria;Myxococcota;Polyangia;Polyangiales;Polyangiaceae;Jahnella;";"66.7";"18.2";"3";"3";"2";"1";"0";"457180";"373892"
"V4mis1";"SILVA (only NR);Bacteria;Myxococcota;Polyangia;Polyangiales;Polyangiaceae;Labilithrix;";"100.0";"18.2";"7";"7";"7";"0";"0";"457176";"373887"
"V4mis1";"SILVA (only NR);Bacteria;Myxococcota;Polyangia;Polyangiales;Polyangiaceae;Minicystis;";"90.0";"18.2";"10";"10";"9";"1";"0";"457173";"373885"
"V4mis1";"SILVA (only NR);Bacteria;Myxococcota;Polyangia;Polyangiales;Polyangiaceae;Pajaroellobacter;";"96.1";"18.2";"128";"128";"123";"5";"0";"457055";"373771"
"V4mis1";"SILVA (only NR);Bacteria;Myxococcota;Polyangia;Polyangiales;Polyangiaceae;Polyangium;";"100.0";"18.2";"24";"24";"24";"0";"0";"457159";"373870"
"V4mis1";"SILVA (only NR);Bacteria;Myxococcota;Polyangia;Polyangiales;Polyangiaceae;Sorangium;";"91.2";"18.2";"68";"68";"62";"6";"0";"457115";"373832"
"V4mis1";"SILVA (only NR);Bacteria;Myxococcota;Polyangia;Polyangiales;Polyangiaceae;uncultured;";"100.0";"18.2";"31";"31";"31";"0";"0";"457152";"373863"
"V4mis1";"SILVA (only NR);Bacteria;Myxococcota;Polyangia;Polyangiales;Sandaracinaceae;";"95.9";"18.2";"318";"318";"305";"13";"0";"456865";"373589"
"V4mis1";"SILVA (only NR);Bacteria;Myxococcota;Polyangia;Polyangiales;Sandaracinaceae;Sandaracinus;";"95.6";"18.2";"45";"45";"43";"2";"0";"457138";"373851"
"V4mis1";"SILVA (only NR);Bacteria;Myxococcota;Polyangia;Polyangiales;Sandaracinaceae;uncultured;";"96.0";"18.2";"273";"273";"262";"11";"0";"456910";"373632"
"V4mis1";"SILVA (only NR);Bacteria;Myxococcota;Polyangia;Polyangiales;uncultured;";"100.0";"18.2";"3";"3";"3";"0";"0";"457180";"373891"
"V4mis1";"SILVA (only NR);Bacteria;Myxococcota;Polyangia;UASB-TL25;";"95.9";"18.2";"49";"49";"47";"2";"0";"457134";"373847"
"V4mis1";"SILVA (only NR);Bacteria;Myxococcota;Polyangia;VHS-B3-70;";"100.0";"18.2";"29";"29";"29";"0";"0";"457154";"373865"
"V4mis1";"SILVA (only NR);Bacteria;Myxococcota;Polyangia;VHS-B4-70;";"100.0";"18.2";"12";"12";"12";"0";"0";"457171";"373882"
"V4mis1";"SILVA (only NR);Bacteria;Myxococcota;Polyangia;mle1-27;";"98.3";"18.2";"60";"60";"59";"1";"0";"457123";"373835"
"V4mis1";"SILVA (only NR);Bacteria;Myxococcota;bacteriap25;";"96.0";"18.2";"371";"371";"356";"15";"0";"456812";"373538"
"V4mis1";"SILVA (only NR);Bacteria;NB1-j;";"97.7";"18.2";"484";"484";"473";"11";"0";"456699";"373421"
"V4mis1";"SILVA (only NR);Bacteria;NKB15;";"86.3";"18.2";"51";"51";"44";"7";"0";"457132";"373850"
"V4mis1";"SILVA (only NR);Bacteria;Nitrospinota;";"96.1";"18.2";"311";"311";"299";"12";"0";"456872";"373595"
"V4mis1";"SILVA (only NR);Bacteria;Nitrospinota;MT5B39;";"85.7";"18.2";"7";"7";"6";"1";"0";"457176";"373888"
"V4mis1";"SILVA (only NR);Bacteria;Nitrospinota;Nitrospinia;";"95.3";"18.2";"235";"235";"224";"11";"0";"456948";"373670"
"V4mis1";"SILVA (only NR);Bacteria;Nitrospinota;Nitrospinia;Nitrospinales;";"95.3";"18.2";"235";"235";"224";"11";"0";"456948";"373670"
"V4mis1";"SILVA (only NR);Bacteria;Nitrospinota;Nitrospinia;Nitrospinales;Nitrospinaceae;";"95.3";"18.2";"235";"235";"224";"11";"0";"456948";"373670"
"V4mis1";"SILVA (only NR);Bacteria;Nitrospinota;Nitrospinia;Nitrospinales;Nitrospinaceae;LS-NOB;";"92.9";"18.2";"84";"84";"78";"6";"0";"457099";"373816"
"V4mis1";"SILVA (only NR);Bacteria;Nitrospinota;Nitrospinia;Nitrospinales;Nitrospinaceae;Nitrospina;";"96.4";"18.2";"139";"139";"134";"5";"0";"457044";"373760"
"V4mis1";"SILVA (only NR);Bacteria;Nitrospinota;Nitrospinia;Nitrospinales;Nitrospinaceae;uncultured;";"100.0";"18.2";"12";"12";"12";"0";"0";"457171";"373882"
"V4mis1";"SILVA (only NR);Bacteria;Nitrospinota;P9X2b3D02;";"100.0";"18.2";"68";"68";"68";"0";"0";"457115";"373826"
"V4mis1";"SILVA (only NR);Bacteria;Nitrospirota;";"95.3";"18.3";"1246";"1246";"1187";"59";"0";"455937";"372707"
"V4mis1";"SILVA (only NR);Bacteria;Nitrospirota;4-29-1;";"93.8";"18.2";"65";"65";"61";"4";"0";"457118";"373833"
"V4mis1";"SILVA (only NR);Bacteria;Nitrospirota;661256;";"100.0";"18.2";"2";"2";"2";"0";"0";"457181";"373892"
"V4mis1";"SILVA (only NR);Bacteria;Nitrospirota;BMS9AB35;";"100.0";"18.2";"26";"26";"26";"0";"0";"457157";"373868"
"V4mis1";"SILVA (only NR);Bacteria;Nitrospirota;HDB-SIOI1093;";"100.0";"18.2";"4";"4";"4";"0";"0";"457179";"373890"
"V4mis1";"SILVA (only NR);Bacteria;Nitrospirota;Leptospirillia;";"92.1";"18.2";"177";"177";"163";"14";"0";"457006";"373731"
"V4mis1";"SILVA (only NR);Bacteria;Nitrospirota;Leptospirillia;Leptospirillales;";"92.1";"18.2";"177";"177";"163";"14";"0";"457006";"373731"
"V4mis1";"SILVA (only NR);Bacteria;Nitrospirota;Leptospirillia;Leptospirillales;Leptospirillaceae;";"92.1";"18.2";"177";"177";"163";"14";"0";"457006";"373731"
"V4mis1";"SILVA (only NR);Bacteria;Nitrospirota;Leptospirillia;Leptospirillales;Leptospirillaceae;Leptospirillum;";"92.1";"18.2";"177";"177";"163";"14";"0";"457006";"373731"
"V4mis1";"SILVA (only NR);Bacteria;Nitrospirota;Nitrospiria;";"95.0";"18.2";"539";"539";"512";"27";"0";"456644";"373382"
"V4mis1";"SILVA (only NR);Bacteria;Nitrospirota;Nitrospiria;Nitrospirales;";"95.0";"18.2";"539";"539";"512";"27";"0";"456644";"373382"
"V4mis1";"SILVA (only NR);Bacteria;Nitrospirota;Nitrospiria;Nitrospirales;Nitrospiraceae;";"95.0";"18.2";"539";"539";"512";"27";"0";"456644";"373382"
"V4mis1";"SILVA (only NR);Bacteria;Nitrospirota;Nitrospiria;Nitrospirales;Nitrospiraceae;Nitrospira;";"95.0";"18.2";"539";"539";"512";"27";"0";"456644";"373382"
"V4mis1";"SILVA (only NR);Bacteria;Nitrospirota;Thermodesulfovibrionia;";"96.8";"18.2";"433";"433";"419";"14";"0";"456750";"373475"
"V4mis1";"SILVA (only NR);Bacteria;Nitrospirota;Thermodesulfovibrionia;Magnetobacteriales;";"100.0";"18.2";"11";"11";"11";"0";"0";"457172";"373883"
"V4mis1";"SILVA (only NR);Bacteria;Nitrospirota;Thermodesulfovibrionia;Magnetobacteriales;Magnetobacteriaceae;";"100.0";"18.2";"11";"11";"11";"0";"0";"457172";"373883"
"V4mis1";"SILVA (only NR);Bacteria;Nitrospirota;Thermodesulfovibrionia;Magnetobacteriales;Magnetobacteriaceae;Candidatus Magnetobacterium;";"100.0";"18.2";"6";"6";"6";"0";"0";"457177";"373888"
"V4mis1";"SILVA (only NR);Bacteria;Nitrospirota;Thermodesulfovibrionia;Magnetobacteriales;Magnetobacteriaceae;Candidatus Magnetoovum;";"100.0";"18.2";"5";"5";"5";"0";"0";"457178";"373889"
"V4mis1";"SILVA (only NR);Bacteria;Nitrospirota;Thermodesulfovibrionia;Thermodesulfovibrionales;";"91.5";"18.2";"59";"59";"54";"5";"0";"457124";"373840"
"V4mis1";"SILVA (only NR);Bacteria;Nitrospirota;Thermodesulfovibrionia;Thermodesulfovibrionales;Thermodesulfovibrionaceae;";"91.5";"18.2";"59";"59";"54";"5";"0";"457124";"373840"
"V4mis1";"SILVA (only NR);Bacteria;Nitrospirota;Thermodesulfovibrionia;Thermodesulfovibrionales;Thermodesulfovibrionaceae;Thermodesulfovibrio;";"91.5";"18.2";"59";"59";"54";"5";"0";"457124";"373840"
"V4mis1";"SILVA (only NR);Bacteria;Nitrospirota;Thermodesulfovibrionia;uncultured;";"97.5";"18.2";"363";"363";"354";"9";"0";"456820";"373540"
"V4mis1";"SILVA (only NR);Bacteria;PAUC34f;";"97.8";"18.2";"93";"93";"91";"2";"0";"457090";"373803"
"V4mis1";"SILVA (only NR);Bacteria;Patescibacteria;";"68.8";"18.1";"4543";"4543";"3127";"1416";"0";"452640";"370767"
"V4mis1";"SILVA (only NR);Bacteria;Patescibacteria;ABY1;";"90.8";"18.2";"402";"402";"365";"37";"0";"456781";"373529"
"V4mis1";"SILVA (only NR);Bacteria;Patescibacteria;ABY1;Candidatus Buchananbacteria;";"93.3";"18.2";"15";"15";"14";"1";"0";"457168";"373880"
"V4mis1";"SILVA (only NR);Bacteria;Patescibacteria;ABY1;Candidatus Falkowbacteria;";"91.7";"18.2";"84";"84";"77";"7";"0";"457099";"373817"
"V4mis1";"SILVA (only NR);Bacteria;Patescibacteria;ABY1;Candidatus Jacksonbacteria;";"83.3";"18.2";"6";"6";"5";"1";"0";"457177";"373889"
"V4mis1";"SILVA (only NR);Bacteria;Patescibacteria;ABY1;Candidatus Kerfeldbacteria;";"95.8";"18.2";"71";"71";"68";"3";"0";"457112";"373826"
"V4mis1";"SILVA (only NR);Bacteria;Patescibacteria;ABY1;Candidatus Komeilibacteria;";"96.6";"18.2";"29";"29";"28";"1";"0";"457154";"373866"
"V4mis1";"SILVA (only NR);Bacteria;Patescibacteria;ABY1;Candidatus Kuenenbacteria;";"80.0";"18.2";"35";"35";"28";"7";"0";"457148";"373866"
"V4mis1";"SILVA (only NR);Bacteria;Patescibacteria;ABY1;Candidatus Magasanikbacteria;";"86.9";"18.2";"107";"107";"93";"14";"0";"457076";"373801"
"V4mis1";"SILVA (only NR);Bacteria;Patescibacteria;ABY1;Candidatus Uhrbacteria;";"94.5";"18.2";"55";"55";"52";"3";"0";"457128";"373842"
"V4mis1";"SILVA (only NR);Bacteria;Patescibacteria;Berkelbacteria;";"79.7";"18.2";"59";"59";"47";"12";"0";"457124";"373847"
"V4mis1";"SILVA (only NR);Bacteria;Patescibacteria;CPR2;";"84.2";"18.2";"19";"19";"16";"3";"0";"457164";"373878"
"V4mis1";"SILVA (only NR);Bacteria;Patescibacteria;Dojkabacteria;";"2.4";"18.2";"166";"166";"4";"162";"0";"457017";"373890"
"V4mis1";"SILVA (only NR);Bacteria;Patescibacteria;Gracilibacteria;";"96.1";"18.2";"876";"876";"842";"34";"0";"456307";"373052"
"V4mis1";"SILVA (only NR);Bacteria;Patescibacteria;Gracilibacteria;Absconditabacteriales (SR1);";"95.4";"18.2";"217";"217";"207";"10";"0";"456966";"373687"
"V4mis1";"SILVA (only NR);Bacteria;Patescibacteria;Gracilibacteria;Candidatus Abawacabacteria;";"93.3";"18.2";"15";"15";"14";"1";"0";"457168";"373880"
"V4mis1";"SILVA (only NR);Bacteria;Patescibacteria;Gracilibacteria;Candidatus Peregrinibacteria;";"97.7";"18.2";"132";"132";"129";"3";"0";"457051";"373765"
"V4mis1";"SILVA (only NR);Bacteria;Patescibacteria;Gracilibacteria;Candidatus Peribacteria;";"100.0";"18.2";"93";"93";"93";"0";"0";"457090";"373801"
"V4mis1";"SILVA (only NR);Bacteria;Patescibacteria;Gracilibacteria;JGI 0000069-P22;";"97.5";"18.2";"163";"163";"159";"4";"0";"457020";"373735"
"V4mis1";"SILVA (only NR);Bacteria;Patescibacteria;Kazania;";"87.5";"18.2";"16";"16";"14";"2";"0";"457167";"373880"
"V4mis1";"SILVA (only NR);Bacteria;Patescibacteria;MD2896-B216;";"100.0";"18.2";"4";"4";"4";"0";"0";"457179";"373890"
"V4mis1";"SILVA (only NR);Bacteria;Patescibacteria;Microgenomatia;";"23.1";"18.1";"832";"832";"192";"640";"0";"456351";"373702"
"V4mis1";"SILVA (only NR);Bacteria;Patescibacteria;Microgenomatia;Candidatus Amesbacteria;";"72.7";"18.2";"11";"11";"8";"3";"0";"457172";"373886"
"V4mis1";"SILVA (only NR);Bacteria;Patescibacteria;Microgenomatia;Candidatus Beckwithbacteria;";"20.0";"18.2";"20";"20";"4";"16";"0";"457163";"373890"
"V4mis1";"SILVA (only NR);Bacteria;Patescibacteria;Microgenomatia;Candidatus Chisholmbacteria;";"43.8";"18.2";"16";"16";"7";"9";"0";"457167";"373887"
"V4mis1";"SILVA (only NR);Bacteria;Patescibacteria;Microgenomatia;Candidatus Collierbacteria;";"0.0";"0";"50";"50";"0";"50";"0";"457133";"373894"
"V4mis1";"SILVA (only NR);Bacteria;Patescibacteria;Microgenomatia;Candidatus Curtissbacteria;";"75.0";"18.2";"20";"20";"15";"5";"0";"457163";"373879"
"V4mis1";"SILVA (only NR);Bacteria;Patescibacteria;Microgenomatia;Candidatus Daviesbacteria;";"0.0";"0";"46";"46";"0";"46";"0";"457137";"373894"
"V4mis1";"SILVA (only NR);Bacteria;Patescibacteria;Microgenomatia;Candidatus Gottesmanbacteria;";"4.3";"18.2";"46";"46";"2";"44";"0";"457137";"373892"
"V4mis1";"SILVA (only NR);Bacteria;Patescibacteria;Microgenomatia;Candidatus Levybacteria;";"0.0";"0";"72";"72";"0";"72";"0";"457111";"373894"
"V4mis1";"SILVA (only NR);Bacteria;Patescibacteria;Microgenomatia;Candidatus Pacebacteria;";"0.0";"0";"134";"134";"0";"134";"0";"457049";"373894"
"V4mis1";"SILVA (only NR);Bacteria;Patescibacteria;Microgenomatia;Candidatus Roizmanbacteria;";"3.7";"18.2";"161";"161";"6";"155";"0";"457022";"373888"
"V4mis1";"SILVA (only NR);Bacteria;Patescibacteria;Microgenomatia;Candidatus Shapirobacteria;";"3.1";"18.2";"65";"65";"2";"63";"0";"457118";"373892"
"V4mis1";"SILVA (only NR);Bacteria;Patescibacteria;Microgenomatia;Candidatus Woesebacteria;";"72.9";"18.2";"133";"133";"97";"36";"0";"457050";"373797"
"V4mis1";"SILVA (only NR);Bacteria;Patescibacteria;Microgenomatia;Candidatus Woykebacteria;";"96.3";"18.2";"27";"27";"26";"1";"0";"457156";"373868"
"V4mis1";"SILVA (only NR);Bacteria;Patescibacteria;Parcubacteria;";"50.5";"18.2";"853";"853";"431";"422";"0";"456330";"373463"
"V4mis1";"SILVA (only NR);Bacteria;Patescibacteria;Parcubacteria;32-520;";"4.3";"18.2";"23";"23";"1";"22";"0";"457160";"373893"
"V4mis1";"SILVA (only NR);Bacteria;Patescibacteria;Parcubacteria;CG1-02-40-25;";"75.0";"18.2";"4";"4";"3";"1";"0";"457179";"373891"
"V4mis1";"SILVA (only NR);Bacteria;Patescibacteria;Parcubacteria;CG1-02-42-13;";"66.7";"18.2";"12";"12";"8";"4";"0";"457171";"373886"
"V4mis1";"SILVA (only NR);Bacteria;Patescibacteria;Parcubacteria;Candidatus Adlerbacteria;";"0.0";"0";"35";"35";"0";"35";"0";"457148";"373894"
"V4mis1";"SILVA (only NR);Bacteria;Patescibacteria;Parcubacteria;Candidatus Azambacteria;";"84.6";"18.2";"26";"26";"22";"4";"0";"457157";"373872"
"V4mis1";"SILVA (only NR);Bacteria;Patescibacteria;Parcubacteria;Candidatus Brennerbacteria;";"100.0";"18.2";"4";"4";"4";"0";"0";"457179";"373890"
"V4mis1";"SILVA (only NR);Bacteria;Patescibacteria;Parcubacteria;Candidatus Campbellbacteria;";"30.0";"18.2";"30";"30";"9";"21";"0";"457153";"373885"
"V4mis1";"SILVA (only NR);Bacteria;Patescibacteria;Parcubacteria;Candidatus Colwellbacteria;";"100.0";"18.2";"6";"6";"6";"0";"0";"457177";"373888"
"V4mis1";"SILVA (only NR);Bacteria;Patescibacteria;Parcubacteria;Candidatus Doudnabacteria;";"100.0";"18.2";"2";"2";"2";"0";"0";"457181";"373892"
"V4mis1";"SILVA (only NR);Bacteria;Patescibacteria;Parcubacteria;Candidatus Giovannonibacteria;";"50.0";"18.2";"4";"4";"2";"2";"0";"457179";"373892"
"V4mis1";"SILVA (only NR);Bacteria;Patescibacteria;Parcubacteria;Candidatus Jorgensenbacteria;";"70.0";"18.2";"10";"10";"7";"3";"0";"457173";"373887"
"V4mis1";"SILVA (only NR);Bacteria;Patescibacteria;Parcubacteria;Candidatus Kaiserbacteria;";"6.8";"18.2";"192";"192";"13";"179";"0";"456991";"373881"
"V4mis1";"SILVA (only NR);Bacteria;Patescibacteria;Parcubacteria;Candidatus Liptonbacteria;";"33.3";"18.2";"3";"3";"1";"2";"0";"457180";"373893"
"V4mis1";"SILVA (only NR);Bacteria;Patescibacteria;Parcubacteria;Candidatus Lloydbacteria;";"75.0";"18.2";"8";"8";"6";"2";"0";"457175";"373888"
"V4mis1";"SILVA (only NR);Bacteria;Patescibacteria;Parcubacteria;Candidatus Moranbacteria;";"35.6";"18.2";"45";"45";"16";"29";"0";"457138";"373878"
"V4mis1";"SILVA (only NR);Bacteria;Patescibacteria;Parcubacteria;Candidatus Nealsonbacteria;";"83.3";"18.2";"6";"6";"5";"1";"0";"457177";"373889"
"V4mis1";"SILVA (only NR);Bacteria;Patescibacteria;Parcubacteria;Candidatus Nomurabacteria;";"36.4";"18.2";"55";"55";"20";"35";"0";"457128";"373874"
"V4mis1";"SILVA (only NR);Bacteria;Patescibacteria;Parcubacteria;Candidatus Portnoybacteria;";"50.0";"18.2";"16";"16";"8";"8";"0";"457167";"373886"
"V4mis1";"SILVA (only NR);Bacteria;Patescibacteria;Parcubacteria;Candidatus Ryanbacteria;";"100.0";"18.2";"3";"3";"3";"0";"0";"457180";"373891"
"V4mis1";"SILVA (only NR);Bacteria;Patescibacteria;Parcubacteria;Candidatus Spechtbacteria;";"100.0";"18.2";"5";"5";"5";"0";"0";"457178";"373889"
"V4mis1";"SILVA (only NR);Bacteria;Patescibacteria;Parcubacteria;Candidatus Staskawiczbacteria;";"18.2";"18.2";"11";"11";"2";"9";"0";"457172";"373892"
"V4mis1";"SILVA (only NR);Bacteria;Patescibacteria;Parcubacteria;Candidatus Terrybacteria;";"60.0";"18.2";"5";"5";"3";"2";"0";"457178";"373891"
"V4mis1";"SILVA (only NR);Bacteria;Patescibacteria;Parcubacteria;Candidatus Vogelbacteria;";"87.5";"18.2";"16";"16";"14";"2";"0";"457167";"373880"
"V4mis1";"SILVA (only NR);Bacteria;Patescibacteria;Parcubacteria;Candidatus Wolfebacteria;";"86.7";"18.2";"15";"15";"13";"2";"0";"457168";"373881"
"V4mis1";"SILVA (only NR);Bacteria;Patescibacteria;Parcubacteria;Candidatus Yanofskybacteria;";"78.6";"18.2";"42";"42";"33";"9";"0";"457141";"373861"
"V4mis1";"SILVA (only NR);Bacteria;Patescibacteria;Parcubacteria;Candidatus Yonathbacteria;";"75.0";"18.2";"4";"4";"3";"1";"0";"457179";"373891"
"V4mis1";"SILVA (only NR);Bacteria;Patescibacteria;Parcubacteria;Candidatus Zambryskibacteria;";"90.9";"18.2";"11";"11";"10";"1";"0";"457172";"373884"
"V4mis1";"SILVA (only NR);Bacteria;Patescibacteria;Parcubacteria;GW2011-GWA2-46-7;";"72.4";"18.2";"29";"29";"21";"8";"0";"457154";"373873"
"V4mis1";"SILVA (only NR);Bacteria;Patescibacteria;Parcubacteria;GWA2-38-13b;";"86.7";"18.2";"45";"45";"39";"6";"0";"457138";"373855"
"V4mis1";"SILVA (only NR);Bacteria;Patescibacteria;Parcubacteria;GWB1-42-6;";"12.5";"18.2";"8";"8";"1";"7";"0";"457175";"373893"
"V4mis1";"SILVA (only NR);Bacteria;Patescibacteria;Parcubacteria;Paceibacterales;";"72.7";"18.2";"11";"11";"8";"3";"0";"457172";"373886"
"V4mis1";"SILVA (only NR);Bacteria;Patescibacteria;Parcubacteria;Paceibacterales;Paceibacteraceae;";"72.7";"18.2";"11";"11";"8";"3";"0";"457172";"373886"
"V4mis1";"SILVA (only NR);Bacteria;Patescibacteria;Parcubacteria;Paceibacterales;Paceibacteraceae;Candidatus Paceibacter;";"72.7";"18.2";"11";"11";"8";"3";"0";"457172";"373886"
"V4mis1";"SILVA (only NR);Bacteria;Patescibacteria;Parcubacteria;UBA9983;";"100.0";"18.2";"8";"8";"8";"0";"0";"457175";"373886"
"V4mis1";"SILVA (only NR);Bacteria;Patescibacteria;Saccharimonadia;";"95.2";"18.3";"1217";"1217";"1158";"59";"0";"455966";"372736"
"V4mis1";"SILVA (only NR);Bacteria;Patescibacteria;Saccharimonadia;Saccharimonadales;";"95.2";"18.3";"1217";"1217";"1158";"59";"0";"455966";"372736"
"V4mis1";"SILVA (only NR);Bacteria;Patescibacteria;Saccharimonadia;Saccharimonadales;LWQ8;";"97.5";"18.2";"81";"81";"79";"2";"0";"457102";"373815"
"V4mis1";"SILVA (only NR);Bacteria;Patescibacteria;Saccharimonadia;Saccharimonadales;Saccharimonadaceae;";"95.2";"18.2";"310";"310";"295";"15";"0";"456873";"373599"
"V4mis1";"SILVA (only NR);Bacteria;Patescibacteria;Saccharimonadia;Saccharimonadales;Saccharimonadaceae;Candidatus Saccharimonas;";"95.5";"18.2";"110";"110";"105";"5";"0";"457073";"373789"
"V4mis1";"SILVA (only NR);Bacteria;Patescibacteria;Saccharimonadia;Saccharimonadales;Saccharimonadaceae;GTL1;";"100.0";"18.2";"1";"1";"1";"0";"0";"457182";"373893"
"V4mis1";"SILVA (only NR);Bacteria;Patescibacteria;Saccharimonadia;Saccharimonadales;Saccharimonadaceae;TM7a;";"96.2";"18.2";"79";"79";"76";"3";"0";"457104";"373818"
"V4mis1";"SILVA (only NR);Bacteria;Patescibacteria;Saccharimonadia;Saccharimonadales;Saccharimonadaceae;TM7x;";"93.5";"18.2";"62";"62";"58";"4";"0";"457121";"373836"
"V4mis1";"SILVA (only NR);Bacteria;Patescibacteria;Saccharimonadia;Saccharimonadales;WWH38;";"90.9";"18.2";"33";"33";"30";"3";"0";"457150";"373864"
"V4mis1";"SILVA (only NR);Bacteria;Patescibacteria;Saccharimonadia;Saccharimonadales;YM_S32_TM7_50_20;";"100.0";"18.2";"21";"21";"21";"0";"0";"457162";"373873"
"V4mis1";"SILVA (only NR);Bacteria;Patescibacteria;WWE3;";"48.3";"18.2";"87";"87";"42";"45";"0";"457096";"373852"
"V4mis1";"SILVA (only NR);Bacteria;Patescibacteria;uncultured;";"100.0";"18.2";"12";"12";"12";"0";"0";"457171";"373882"
"V4mis1";"SILVA (only NR);Bacteria;Planctomycetota;";"94.1";"18.5";"8657";"8657";"8144";"513";"0";"448526";"365750"
"V4mis1";"SILVA (only NR);Bacteria;Planctomycetota;028H05-P-BN-P5;";"100.0";"18.2";"9";"9";"9";"0";"0";"457174";"373885"
"V4mis1";"SILVA (only NR);Bacteria;Planctomycetota;BD7-11;";"100.0";"18.2";"79";"79";"79";"0";"0";"457104";"373815"
"V4mis1";"SILVA (only NR);Bacteria;Planctomycetota;Brocadiae;";"90.2";"18.2";"143";"143";"129";"14";"0";"457040";"373765"
"V4mis1";"SILVA (only NR);Bacteria;Planctomycetota;Brocadiae;Brocadiales;";"90.0";"18.2";"140";"140";"126";"14";"0";"457043";"373768"
"V4mis1";"SILVA (only NR);Bacteria;Planctomycetota;Brocadiae;Brocadiales;Brocadiaceae;";"83.8";"18.2";"74";"74";"62";"12";"0";"457109";"373832"
"V4mis1";"SILVA (only NR);Bacteria;Planctomycetota;Brocadiae;Brocadiales;Brocadiaceae;Candidatus Anammoxoglobus;";"66.7";"18.2";"3";"3";"2";"1";"0";"457180";"373892"
"V4mis1";"SILVA (only NR);Bacteria;Planctomycetota;Brocadiae;Brocadiales;Brocadiaceae;Candidatus Brocadia;";"90.6";"18.2";"32";"32";"29";"3";"0";"457151";"373865"
"V4mis1";"SILVA (only NR);Bacteria;Planctomycetota;Brocadiae;Brocadiales;Brocadiaceae;Candidatus Jettenia;";"87.5";"18.2";"16";"16";"14";"2";"0";"457167";"373880"
"V4mis1";"SILVA (only NR);Bacteria;Planctomycetota;Brocadiae;Brocadiales;Brocadiaceae;Candidatus Kuenenia;";"86.7";"18.2";"15";"15";"13";"2";"0";"457168";"373881"
"V4mis1";"SILVA (only NR);Bacteria;Planctomycetota;Brocadiae;Brocadiales;Brocadiaceae;uncultured;";"42.9";"18.2";"7";"7";"3";"4";"0";"457176";"373891"
"V4mis1";"SILVA (only NR);Bacteria;Planctomycetota;Brocadiae;Brocadiales;GWA2-50-13;";"100.0";"18.2";"11";"11";"11";"0";"0";"457172";"373883"
"V4mis1";"SILVA (only NR);Bacteria;Planctomycetota;Brocadiae;Brocadiales;Scalinduaceae;";"98.1";"18.2";"54";"54";"53";"1";"0";"457129";"373841"
"V4mis1";"SILVA (only NR);Bacteria;Planctomycetota;Brocadiae;Brocadiales;Scalinduaceae;Candidatus Scalindua;";"98.1";"18.2";"54";"54";"53";"1";"0";"457129";"373841"
"V4mis1";"SILVA (only NR);Bacteria;Planctomycetota;Brocadiae;SM23-32;";"100.0";"18.2";"3";"3";"3";"0";"0";"457180";"373891"
"V4mis1";"SILVA (only NR);Bacteria;Planctomycetota;ODP123;";"80.0";"18.2";"20";"20";"16";"4";"0";"457163";"373878"
"V4mis1";"SILVA (only NR);Bacteria;Planctomycetota;OM190;";"92.8";"18.2";"418";"418";"388";"30";"0";"456765";"373506"
"V4mis1";"SILVA (only NR);Bacteria;Planctomycetota;Phycisphaerae;";"95.3";"18.3";"2484";"2484";"2367";"117";"0";"454699";"371527"
"V4mis1";"SILVA (only NR);Bacteria;Planctomycetota;Phycisphaerae;Amsterdam-1B-07;";"100.0";"18.2";"5";"5";"5";"0";"0";"457178";"373889"
"V4mis1";"SILVA (only NR);Bacteria;Planctomycetota;Phycisphaerae;B103G10;";"100.0";"18.2";"2";"2";"2";"0";"0";"457181";"373892"
"V4mis1";"SILVA (only NR);Bacteria;Planctomycetota;Phycisphaerae;C86;";"93.3";"18.2";"15";"15";"14";"1";"0";"457168";"373880"
"V4mis1";"SILVA (only NR);Bacteria;Planctomycetota;Phycisphaerae;CCM11a;";"95.5";"18.2";"112";"112";"107";"5";"0";"457071";"373787"
"V4mis1";"SILVA (only NR);Bacteria;Planctomycetota;Phycisphaerae;DG-20;";"100.0";"18.2";"16";"16";"16";"0";"0";"457167";"373878"
"V4mis1";"SILVA (only NR);Bacteria;Planctomycetota;Phycisphaerae;MSBL9;";"96.7";"18.2";"823";"823";"796";"27";"0";"456360";"373098"
"V4mis1";"SILVA (only NR);Bacteria;Planctomycetota;Phycisphaerae;MSBL9;4572-13;";"100.0";"18.2";"18";"18";"18";"0";"0";"457165";"373876"
"V4mis1";"SILVA (only NR);Bacteria;Planctomycetota;Phycisphaerae;MSBL9;GWC2-45-44;";"100.0";"18.2";"9";"9";"9";"0";"0";"457174";"373885"
"V4mis1";"SILVA (only NR);Bacteria;Planctomycetota;Phycisphaerae;MSBL9;KCLunmb-38-53;";"100.0";"18.2";"18";"18";"18";"0";"0";"457165";"373876"
"V4mis1";"SILVA (only NR);Bacteria;Planctomycetota;Phycisphaerae;MSBL9;L21-RPul-D3;";"100.0";"18.2";"20";"20";"20";"0";"0";"457163";"373874"
"V4mis1";"SILVA (only NR);Bacteria;Planctomycetota;Phycisphaerae;MSBL9;SG8-4;";"96.4";"18.2";"668";"668";"644";"24";"0";"456515";"373250"
"V4mis1";"SILVA (only NR);Bacteria;Planctomycetota;Phycisphaerae;MSBL9;SM23-30;";"97.6";"18.2";"41";"41";"40";"1";"0";"457142";"373854"
"V4mis1";"SILVA (only NR);Bacteria;Planctomycetota;Phycisphaerae;MSBL9;ST-NAGAB-D1;";"95.6";"18.2";"45";"45";"43";"2";"0";"457138";"373851"
"V4mis1";"SILVA (only NR);Bacteria;Planctomycetota;Phycisphaerae;Phycisphaerales;";"95.3";"18.2";"971";"971";"925";"46";"0";"456212";"372969"
"V4mis1";"SILVA (only NR);Bacteria;Planctomycetota;Phycisphaerae;Phycisphaerales;AKAU3564 sediment group;";"94.2";"18.2";"274";"274";"258";"16";"0";"456909";"373636"
"V4mis1";"SILVA (only NR);Bacteria;Planctomycetota;Phycisphaerae;Phycisphaerales;Phycisphaeraceae;";"95.7";"18.2";"697";"697";"667";"30";"0";"456486";"373227"
"V4mis1";"SILVA (only NR);Bacteria;Planctomycetota;Phycisphaerae;Phycisphaerales;Phycisphaeraceae;AKYG587;";"92.9";"18.2";"42";"42";"39";"3";"0";"457141";"373855"
"V4mis1";"SILVA (only NR);Bacteria;Planctomycetota;Phycisphaerae;Phycisphaerales;Phycisphaeraceae;Algisphaera;";"100.0";"18.2";"8";"8";"8";"0";"0";"457175";"373886"
"V4mis1";"SILVA (only NR);Bacteria;Planctomycetota;Phycisphaerae;Phycisphaerales;Phycisphaeraceae;CL500-3;";"95.7";"18.2";"47";"47";"45";"2";"0";"457136";"373849"
"V4mis1";"SILVA (only NR);Bacteria;Planctomycetota;Phycisphaerae;Phycisphaerales;Phycisphaeraceae;FS140-16B-02 marine group;";"100.0";"18.2";"17";"17";"17";"0";"0";"457166";"373877"
"V4mis1";"SILVA (only NR);Bacteria;Planctomycetota;Phycisphaerae;Phycisphaerales;Phycisphaeraceae;I-8;";"100.0";"18.2";"12";"12";"12";"0";"0";"457171";"373882"
"V4mis1";"SILVA (only NR);Bacteria;Planctomycetota;Phycisphaerae;Phycisphaerales;Phycisphaeraceae;JL-ETNP-F27;";"100.0";"18.2";"28";"28";"28";"0";"0";"457155";"373866"
"V4mis1";"SILVA (only NR);Bacteria;Planctomycetota;Phycisphaerae;Phycisphaerales;Phycisphaeraceae;Phycisphaera;";"94.7";"18.2";"19";"19";"18";"1";"0";"457164";"373876"
"V4mis1";"SILVA (only NR);Bacteria;Planctomycetota;Phycisphaerae;Phycisphaerales;Phycisphaeraceae;SM1A02;";"95.1";"18.2";"283";"283";"269";"14";"0";"456900";"373625"
"V4mis1";"SILVA (only NR);Bacteria;Planctomycetota;Phycisphaerae;Phycisphaerales;Phycisphaeraceae;Urania-1B-19 marine sediment group;";"95.4";"18.2";"65";"65";"62";"3";"0";"457118";"373832"
"V4mis1";"SILVA (only NR);Bacteria;Planctomycetota;Phycisphaerae;Phycisphaerales;Phycisphaeraceae;Z195MB87;";"100.0";"18.2";"4";"4";"4";"0";"0";"457179";"373890"
"V4mis1";"SILVA (only NR);Bacteria;Planctomycetota;Phycisphaerae;Phycisphaerales;Phycisphaeraceae;uncultured;";"96.4";"18.2";"168";"168";"162";"6";"0";"457015";"373732"
"V4mis1";"SILVA (only NR);Bacteria;Planctomycetota;Phycisphaerae;Pla1 lineage;";"92.9";"18.2";"70";"70";"65";"5";"0";"457113";"373829"
"V4mis1";"SILVA (only NR);Bacteria;Planctomycetota;Phycisphaerae;S-70;";"100.0";"18.2";"30";"30";"30";"0";"0";"457153";"373864"
"V4mis1";"SILVA (only NR);Bacteria;Planctomycetota;Phycisphaerae;Tepidisphaerales;";"93.1";"18.2";"333";"333";"310";"23";"0";"456850";"373584"
"V4mis1";"SILVA (only NR);Bacteria;Planctomycetota;Phycisphaerae;Tepidisphaerales;CPla-3 termite group;";"100.0";"18.2";"16";"16";"16";"0";"0";"457167";"373878"
"V4mis1";"SILVA (only NR);Bacteria;Planctomycetota;Phycisphaerae;Tepidisphaerales;Tepidisphaeraceae;";"79.2";"18.2";"24";"24";"19";"5";"0";"457159";"373875"
"V4mis1";"SILVA (only NR);Bacteria;Planctomycetota;Phycisphaerae;Tepidisphaerales;Tepidisphaeraceae;Tepidisphaera;";"85.7";"18.2";"7";"7";"6";"1";"0";"457176";"373888"
"V4mis1";"SILVA (only NR);Bacteria;Planctomycetota;Phycisphaerae;Tepidisphaerales;WD2101 soil group;";"94.1";"18.2";"290";"290";"273";"17";"0";"456893";"373621"
"V4mis1";"SILVA (only NR);Bacteria;Planctomycetota;Phycisphaerae;mle1-8;";"90.7";"18.2";"107";"107";"97";"10";"0";"457076";"373797"
"V4mis1";"SILVA (only NR);Bacteria;Planctomycetota;Pla3 lineage;";"92.2";"18.2";"129";"129";"119";"10";"0";"457054";"373775"
"V4mis1";"SILVA (only NR);Bacteria;Planctomycetota;Pla4 lineage;";"94.3";"18.2";"158";"158";"149";"9";"0";"457025";"373745"
"V4mis1";"SILVA (only NR);Bacteria;Planctomycetota;Planctomycetes;";"93.5";"18.3";"4871";"4871";"4555";"316";"0";"452312";"369339"
"V4mis1";"SILVA (only NR);Bacteria;Planctomycetota;Planctomycetes;Gemmatales;";"96.0";"18.2";"931";"931";"894";"37";"0";"456252";"373000"
"V4mis1";"SILVA (only NR);Bacteria;Planctomycetota;Planctomycetes;Gemmatales;Gemmataceae;";"96.0";"18.2";"931";"931";"894";"37";"0";"456252";"373000"
"V4mis1";"SILVA (only NR);Bacteria;Planctomycetota;Planctomycetes;Gemmatales;Gemmataceae;Fimbriiglobus;";"97.4";"18.2";"76";"76";"74";"2";"0";"457107";"373820"
"V4mis1";"SILVA (only NR);Bacteria;Planctomycetota;Planctomycetes;Gemmatales;Gemmataceae;Gemmata;";"96.8";"18.2";"185";"185";"179";"6";"0";"456998";"373715"
"V4mis1";"SILVA (only NR);Bacteria;Planctomycetota;Planctomycetes;Gemmatales;Gemmataceae;Telmatocola;";"100.0";"18.2";"5";"5";"5";"0";"0";"457178";"373889"
"V4mis1";"SILVA (only NR);Bacteria;Planctomycetota;Planctomycetes;Gemmatales;Gemmataceae;Tuwongella;";"100.0";"18.2";"7";"7";"7";"0";"0";"457176";"373887"
"V4mis1";"SILVA (only NR);Bacteria;Planctomycetota;Planctomycetes;Gemmatales;Gemmataceae;Zavarzinella;";"100.0";"18.2";"8";"8";"8";"0";"0";"457175";"373886"
"V4mis1";"SILVA (only NR);Bacteria;Planctomycetota;Planctomycetes;Gemmatales;Gemmataceae;uncultured;";"95.6";"18.2";"642";"642";"614";"28";"0";"456541";"373280"
"V4mis1";"SILVA (only NR);Bacteria;Planctomycetota;Planctomycetes;Isosphaerales;";"95.6";"18.2";"431";"431";"412";"19";"0";"456752";"373482"
"V4mis1";"SILVA (only NR);Bacteria;Planctomycetota;Planctomycetes;Isosphaerales;Isosphaeraceae;";"95.6";"18.2";"431";"431";"412";"19";"0";"456752";"373482"
"V4mis1";"SILVA (only NR);Bacteria;Planctomycetota;Planctomycetes;Isosphaerales;Isosphaeraceae;Aquisphaera;";"98.0";"18.2";"51";"51";"50";"1";"0";"457132";"373844"
"V4mis1";"SILVA (only NR);Bacteria;Planctomycetota;Planctomycetes;Isosphaerales;Isosphaeraceae;Candidatus Nostocoida;";"84.6";"18.2";"13";"13";"11";"2";"0";"457170";"373883"
"V4mis1";"SILVA (only NR);Bacteria;Planctomycetota;Planctomycetes;Isosphaerales;Isosphaeraceae;Isosphaera;";"100.0";"18.2";"16";"16";"16";"0";"0";"457167";"373878"
"V4mis1";"SILVA (only NR);Bacteria;Planctomycetota;Planctomycetes;Isosphaerales;Isosphaeraceae;Paludisphaera;";"100.0";"18.2";"20";"20";"20";"0";"0";"457163";"373874"
"V4mis1";"SILVA (only NR);Bacteria;Planctomycetota;Planctomycetes;Isosphaerales;Isosphaeraceae;Singulisphaera;";"97.3";"18.2";"73";"73";"71";"2";"0";"457110";"373823"
"V4mis1";"SILVA (only NR);Bacteria;Planctomycetota;Planctomycetes;Isosphaerales;Isosphaeraceae;Tundrisphaera;";"95.4";"18.2";"65";"65";"62";"3";"0";"457118";"373832"
"V4mis1";"SILVA (only NR);Bacteria;Planctomycetota;Planctomycetes;Isosphaerales;Isosphaeraceae;uncultured;";"94.8";"18.2";"192";"192";"182";"10";"0";"456991";"373712"
"V4mis1";"SILVA (only NR);Bacteria;Planctomycetota;Planctomycetes;Pirellulales;";"92.7";"18.3";"2487";"2487";"2305";"182";"0";"454696";"371589"
"V4mis1";"SILVA (only NR);Bacteria;Planctomycetota;Planctomycetes;Pirellulales;Pirellulaceae;";"92.7";"18.3";"2487";"2487";"2305";"182";"0";"454696";"371589"
"V4mis1";"SILVA (only NR);Bacteria;Planctomycetota;Planctomycetes;Pirellulales;Pirellulaceae;Blastopirellula;";"90.7";"18.2";"324";"324";"294";"30";"0";"456859";"373600"
"V4mis1";"SILVA (only NR);Bacteria;Planctomycetota;Planctomycetes;Pirellulales;Pirellulaceae;Bythopirellula;";"95.8";"18.2";"24";"24";"23";"1";"0";"457159";"373871"
"V4mis1";"SILVA (only NR);Bacteria;Planctomycetota;Planctomycetes;Pirellulales;Pirellulaceae;CPla-4 termite group;";"100.0";"18.2";"10";"10";"10";"0";"0";"457173";"373884"
"V4mis1";"SILVA (only NR);Bacteria;Planctomycetota;Planctomycetes;Pirellulales;Pirellulaceae;Candidatus Anammoximicrobium;";"100.0";"18.2";"12";"12";"12";"0";"0";"457171";"373882"
"V4mis1";"SILVA (only NR);Bacteria;Planctomycetota;Planctomycetes;Pirellulales;Pirellulaceae;Pir1 lineage;";"100.0";"18.2";"7";"7";"7";"0";"0";"457176";"373887"
"V4mis1";"SILVA (only NR);Bacteria;Planctomycetota;Planctomycetes;Pirellulales;Pirellulaceae;Pir2 lineage;";"100.0";"18.2";"10";"10";"10";"0";"0";"457173";"373884"
"V4mis1";"SILVA (only NR);Bacteria;Planctomycetota;Planctomycetes;Pirellulales;Pirellulaceae;Pir3 lineage;";"100.0";"18.2";"7";"7";"7";"0";"0";"457176";"373887"
"V4mis1";"SILVA (only NR);Bacteria;Planctomycetota;Planctomycetes;Pirellulales;Pirellulaceae;Pir4 lineage;";"91.8";"18.2";"546";"546";"501";"45";"0";"456637";"373393"
"V4mis1";"SILVA (only NR);Bacteria;Planctomycetota;Planctomycetes;Pirellulales;Pirellulaceae;Pirellula;";"94.9";"18.2";"412";"412";"391";"21";"0";"456771";"373503"
"V4mis1";"SILVA (only NR);Bacteria;Planctomycetota;Planctomycetes;Pirellulales;Pirellulaceae;Rhodopirellula;";"94.2";"18.2";"292";"292";"275";"17";"0";"456891";"373619"
"V4mis1";"SILVA (only NR);Bacteria;Planctomycetota;Planctomycetes;Pirellulales;Pirellulaceae;Roseimaritima;";"88.9";"18.2";"9";"9";"8";"1";"0";"457174";"373886"
"V4mis1";"SILVA (only NR);Bacteria;Planctomycetota;Planctomycetes;Pirellulales;Pirellulaceae;Rubripirellula;";"77.8";"18.2";"54";"54";"42";"12";"0";"457129";"373852"
"V4mis1";"SILVA (only NR);Bacteria;Planctomycetota;Planctomycetes;Pirellulales;Pirellulaceae;Termite planctomycete cluster;";"90.5";"18.2";"63";"63";"57";"6";"0";"457120";"373837"
"V4mis1";"SILVA (only NR);Bacteria;Planctomycetota;Planctomycetes;Pirellulales;Pirellulaceae;Thermogutta;";"94.1";"18.2";"17";"17";"16";"1";"0";"457166";"373878"
"V4mis1";"SILVA (only NR);Bacteria;Planctomycetota;Planctomycetes;Pirellulales;Pirellulaceae;Thermostilla;";"100.0";"18.2";"1";"1";"1";"0";"0";"457182";"373893"
"V4mis1";"SILVA (only NR);Bacteria;Planctomycetota;Planctomycetes;Pirellulales;Pirellulaceae;p-1088-a5 gut group;";"100.0";"18.2";"41";"41";"41";"0";"0";"457142";"373853"
"V4mis1";"SILVA (only NR);Bacteria;Planctomycetota;Planctomycetes;Pirellulales;Pirellulaceae;uncultured;";"92.7";"18.2";"654";"654";"606";"48";"0";"456529";"373288"
"V4mis1";"SILVA (only NR);Bacteria;Planctomycetota;Planctomycetes;Planctomycetales;";"92.1";"18.2";"956";"956";"880";"76";"0";"456227";"373014"
"V4mis1";"SILVA (only NR);Bacteria;Planctomycetota;Planctomycetes;Planctomycetales;Gimesiaceae;";"90.9";"18.2";"121";"121";"110";"11";"0";"457062";"373784"
"V4mis1";"SILVA (only NR);Bacteria;Planctomycetota;Planctomycetes;Planctomycetales;Gimesiaceae;Gimesia;";"83.3";"18.2";"12";"12";"10";"2";"0";"457171";"373884"
"V4mis1";"SILVA (only NR);Bacteria;Planctomycetota;Planctomycetes;Planctomycetales;Gimesiaceae;uncultured;";"91.7";"18.2";"109";"109";"100";"9";"0";"457074";"373794"
"V4mis1";"SILVA (only NR);Bacteria;Planctomycetota;Planctomycetes;Planctomycetales;Rubinisphaeraceae;";"92.2";"18.2";"385";"385";"355";"30";"0";"456798";"373539"
"V4mis1";"SILVA (only NR);Bacteria;Planctomycetota;Planctomycetes;Planctomycetales;Rubinisphaeraceae;Fuerstia;";"100.0";"18.2";"18";"18";"18";"0";"0";"457165";"373876"
"V4mis1";"SILVA (only NR);Bacteria;Planctomycetota;Planctomycetes;Planctomycetales;Rubinisphaeraceae;Planctomicrobium;";"93.5";"18.2";"77";"77";"72";"5";"0";"457106";"373822"
"V4mis1";"SILVA (only NR);Bacteria;Planctomycetota;Planctomycetes;Planctomycetales;Rubinisphaeraceae;Rubinisphaera;";"92.3";"18.2";"26";"26";"24";"2";"0";"457157";"373870"
"V4mis1";"SILVA (only NR);Bacteria;Planctomycetota;Planctomycetes;Planctomycetales;Rubinisphaeraceae;SH-PL14;";"92.9";"18.2";"98";"98";"91";"7";"0";"457085";"373803"
"V4mis1";"SILVA (only NR);Bacteria;Planctomycetota;Planctomycetes;Planctomycetales;Rubinisphaeraceae;uncultured;";"90.3";"18.2";"165";"165";"149";"16";"0";"457018";"373745"
"V4mis1";"SILVA (only NR);Bacteria;Planctomycetota;Planctomycetes;Planctomycetales;Schlesneriaceae;";"97.4";"18.2";"116";"116";"113";"3";"0";"457067";"373781"
"V4mis1";"SILVA (only NR);Bacteria;Planctomycetota;Planctomycetes;Planctomycetales;Schlesneriaceae;Planctopirus;";"98.6";"18.2";"69";"69";"68";"1";"0";"457114";"373826"
"V4mis1";"SILVA (only NR);Bacteria;Planctomycetota;Planctomycetes;Planctomycetales;Schlesneriaceae;Schlesneria;";"95.7";"18.2";"46";"46";"44";"2";"0";"457137";"373850"
"V4mis1";"SILVA (only NR);Bacteria;Planctomycetota;Planctomycetes;Planctomycetales;uncultured;";"90.6";"18.2";"331";"331";"300";"31";"0";"456852";"373594"
"V4mis1";"SILVA (only NR);Bacteria;Planctomycetota;Planctomycetes;uncultured;";"97.0";"18.2";"66";"66";"64";"2";"0";"457117";"373830"
"V4mis1";"SILVA (only NR);Bacteria;Planctomycetota;SGST604;";"100.0";"18.2";"9";"9";"9";"0";"0";"457174";"373885"
"V4mis1";"SILVA (only NR);Bacteria;Planctomycetota;SPG12-343-353-B69;";"100.0";"18.2";"7";"7";"7";"0";"0";"457176";"373887"
"V4mis1";"SILVA (only NR);Bacteria;Planctomycetota;vadinHA49;";"96.1";"18.2";"330";"330";"317";"13";"0";"456853";"373577"
"V4mis1";"SILVA (only NR);Bacteria;Poribacteria;";"90.4";"18.2";"52";"52";"47";"5";"0";"457131";"373847"
"V4mis1";"SILVA (only NR);Bacteria;Proteobacteria;";"93.5";"21.9";"109146";"109140";"102058";"7082";"6";"348043";"271836"
"V4mis1";"SILVA (only NR);Bacteria;Proteobacteria;Alphaproteobacteria;";"94.9";"19.3";"33787";"33781";"32052";"1729";"6";"423402";"341842"
"V4mis1";"SILVA (only NR);Bacteria;Proteobacteria;Alphaproteobacteria;AT-s3-44;";"92.7";"18.2";"82";"82";"76";"6";"0";"457101";"373818"
"V4mis1";"SILVA (only NR);Bacteria;Proteobacteria;Alphaproteobacteria;Acetobacterales;";"96.9";"18.3";"1558";"1558";"1510";"48";"0";"455625";"372384"
"V4mis1";"SILVA (only NR);Bacteria;Proteobacteria;Alphaproteobacteria;Acetobacterales;Acetobacteraceae;";"96.9";"18.3";"1548";"1548";"1500";"48";"0";"455635";"372394"
"V4mis1";"SILVA (only NR);Bacteria;Proteobacteria;Alphaproteobacteria;Acetobacterales;Acetobacteraceae;Acetobacter;";"94.3";"18.2";"246";"246";"232";"14";"0";"456937";"373662"
"V4mis1";"SILVA (only NR);Bacteria;Proteobacteria;Alphaproteobacteria;Acetobacterales;Acetobacteraceae;Acidicaldus;";"96.0";"18.2";"25";"25";"24";"1";"0";"457158";"373870"
"V4mis1";"SILVA (only NR);Bacteria;Proteobacteria;Alphaproteobacteria;Acetobacterales;Acetobacteraceae;Acidiphilium;";"97.4";"18.2";"151";"151";"147";"4";"0";"457032";"373747"
"V4mis1";"SILVA (only NR);Bacteria;Proteobacteria;Alphaproteobacteria;Acetobacterales;Acetobacteraceae;Acidisoma;";"100.0";"18.2";"15";"15";"15";"0";"0";"457168";"373879"
"V4mis1";"SILVA (only NR);Bacteria;Proteobacteria;Alphaproteobacteria;Acetobacterales;Acetobacteraceae;Acidisphaera;";"100.0";"18.2";"12";"12";"12";"0";"0";"457171";"373882"
"V4mis1";"SILVA (only NR);Bacteria;Proteobacteria;Alphaproteobacteria;Acetobacterales;Acetobacteraceae;Acidocella;";"100.0";"18.2";"32";"32";"32";"0";"0";"457151";"373862"
"V4mis1";"SILVA (only NR);Bacteria;Proteobacteria;Alphaproteobacteria;Acetobacterales;Acetobacteraceae;Acidomonas;";"100.0";"18.2";"8";"8";"8";"0";"0";"457175";"373886"
"V4mis1";"SILVA (only NR);Bacteria;Proteobacteria;Alphaproteobacteria;Acetobacterales;Acetobacteraceae;Ameyamaea;";"100.0";"18.2";"5";"5";"5";"0";"0";"457178";"373889"
"V4mis1";"SILVA (only NR);Bacteria;Proteobacteria;Alphaproteobacteria;Acetobacterales;Acetobacteraceae;Asaia;";"94.0";"18.2";"50";"50";"47";"3";"0";"457133";"373847"
"V4mis1";"SILVA (only NR);Bacteria;Proteobacteria;Alphaproteobacteria;Acetobacterales;Acetobacteraceae;Belnapia;";"91.7";"18.2";"12";"12";"11";"1";"0";"457171";"373883"
"V4mis1";"SILVA (only NR);Bacteria;Proteobacteria;Alphaproteobacteria;Acetobacterales;Acetobacteraceae;Bombella;";"100.0";"18.2";"11";"11";"11";"0";"0";"457172";"373883"
"V4mis1";"SILVA (only NR);Bacteria;Proteobacteria;Alphaproteobacteria;Acetobacterales;Acetobacteraceae;Commensalibacter;";"94.1";"18.2";"17";"17";"16";"1";"0";"457166";"373878"
"V4mis1";"SILVA (only NR);Bacteria;Proteobacteria;Alphaproteobacteria;Acetobacterales;Acetobacteraceae;Craurococcus-Caldovatus;";"97.1";"18.2";"35";"35";"34";"1";"0";"457148";"373860"
"V4mis1";"SILVA (only NR);Bacteria;Proteobacteria;Alphaproteobacteria;Acetobacterales;Acetobacteraceae;Crenalkalicoccus;";"100.0";"18.2";"1";"1";"1";"0";"0";"457182";"373893"
"V4mis1";"SILVA (only NR);Bacteria;Proteobacteria;Alphaproteobacteria;Acetobacterales;Acetobacteraceae;Endobacter;";"100.0";"18.2";"13";"13";"13";"0";"0";"457170";"373881"
"V4mis1";"SILVA (only NR);Bacteria;Proteobacteria;Alphaproteobacteria;Acetobacterales;Acetobacteraceae;Gluconacetobacter;";"96.9";"18.2";"64";"64";"62";"2";"0";"457119";"373832"
"V4mis1";"SILVA (only NR);Bacteria;Proteobacteria;Alphaproteobacteria;Acetobacterales;Acetobacteraceae;Gluconobacter;";"100.0";"18.2";"125";"125";"125";"0";"0";"457058";"373769"
"V4mis1";"SILVA (only NR);Bacteria;Proteobacteria;Alphaproteobacteria;Acetobacterales;Acetobacteraceae;Granulibacter;";"100.0";"18.2";"12";"12";"12";"0";"0";"457171";"373882"
"V4mis1";"SILVA (only NR);Bacteria;Proteobacteria;Alphaproteobacteria;Acetobacterales;Acetobacteraceae;Humitalea;";"100.0";"18.2";"1";"1";"1";"0";"0";"457182";"373893"
"V4mis1";"SILVA (only NR);Bacteria;Proteobacteria;Alphaproteobacteria;Acetobacterales;Acetobacteraceae;Komagataeibacter;";"100.0";"18.2";"152";"152";"152";"0";"0";"457031";"373742"
"V4mis1";"SILVA (only NR);Bacteria;Proteobacteria;Alphaproteobacteria;Acetobacterales;Acetobacteraceae;Kozakia;";"90.9";"18.2";"11";"11";"10";"1";"0";"457172";"373884"
"V4mis1";"SILVA (only NR);Bacteria;Proteobacteria;Alphaproteobacteria;Acetobacterales;Acetobacteraceae;Muricoccus;";"50.0";"18.2";"2";"2";"1";"1";"0";"457181";"373893"
"V4mis1";"SILVA (only NR);Bacteria;Proteobacteria;Alphaproteobacteria;Acetobacterales;Acetobacteraceae;Neoasaia;";"100.0";"18.2";"4";"4";"4";"0";"0";"457179";"373890"
"V4mis1";"SILVA (only NR);Bacteria;Proteobacteria;Alphaproteobacteria;Acetobacterales;Acetobacteraceae;Neokomagataea;";"100.0";"18.2";"3";"3";"3";"0";"0";"457180";"373891"
"V4mis1";"SILVA (only NR);Bacteria;Proteobacteria;Alphaproteobacteria;Acetobacterales;Acetobacteraceae;Nguyenibacter;";"100.0";"18.2";"2";"2";"2";"0";"0";"457181";"373892"
"V4mis1";"SILVA (only NR);Bacteria;Proteobacteria;Alphaproteobacteria;Acetobacterales;Acetobacteraceae;Paracraurococcus;";"100.0";"18.2";"2";"2";"2";"0";"0";"457181";"373892"
"V4mis1";"SILVA (only NR);Bacteria;Proteobacteria;Alphaproteobacteria;Acetobacterales;Acetobacteraceae;Rhodopila;";"100.0";"18.2";"9";"9";"9";"0";"0";"457174";"373885"
"V4mis1";"SILVA (only NR);Bacteria;Proteobacteria;Alphaproteobacteria;Acetobacterales;Acetobacteraceae;Rhodovarius;";"94.7";"18.2";"19";"19";"18";"1";"0";"457164";"373876"
"V4mis1";"SILVA (only NR);Bacteria;Proteobacteria;Alphaproteobacteria;Acetobacterales;Acetobacteraceae;Rhodovastum;";"95.2";"18.2";"21";"21";"20";"1";"0";"457162";"373874"
"V4mis1";"SILVA (only NR);Bacteria;Proteobacteria;Alphaproteobacteria;Acetobacterales;Acetobacteraceae;Roseococcus;";"90.5";"18.2";"21";"21";"19";"2";"0";"457162";"373875"
"V4mis1";"SILVA (only NR);Bacteria;Proteobacteria;Alphaproteobacteria;Acetobacterales;Acetobacteraceae;Roseomonas;";"94.3";"18.2";"193";"193";"182";"11";"0";"456990";"373712"
"V4mis1";"SILVA (only NR);Bacteria;Proteobacteria;Alphaproteobacteria;Acetobacterales;Acetobacteraceae;Rubritepida;";"100.0";"18.2";"13";"13";"13";"0";"0";"457170";"373881"
"V4mis1";"SILVA (only NR);Bacteria;Proteobacteria;Alphaproteobacteria;Acetobacterales;Acetobacteraceae;Saccharibacter;";"100.0";"18.2";"5";"5";"5";"0";"0";"457178";"373889"
"V4mis1";"SILVA (only NR);Bacteria;Proteobacteria;Alphaproteobacteria;Acetobacterales;Acetobacteraceae;Siccirubricoccus;";"100.0";"18.2";"1";"1";"1";"0";"0";"457182";"373893"
"V4mis1";"SILVA (only NR);Bacteria;Proteobacteria;Alphaproteobacteria;Acetobacterales;Acetobacteraceae;Swaminathania;";"100.0";"18.2";"4";"4";"4";"0";"0";"457179";"373890"
"V4mis1";"SILVA (only NR);Bacteria;Proteobacteria;Alphaproteobacteria;Acetobacterales;Acetobacteraceae;Tanticharoenia;";"100.0";"18.2";"5";"5";"5";"0";"0";"457178";"373889"
"V4mis1";"SILVA (only NR);Bacteria;Proteobacteria;Alphaproteobacteria;Acetobacterales;Acetobacteraceae;uncultured;";"98.3";"18.2";"234";"234";"230";"4";"0";"456949";"373664"
"V4mis1";"SILVA (only NR);Bacteria;Proteobacteria;Alphaproteobacteria;Acetobacterales;Elioraeaceae;";"100.0";"18.2";"6";"6";"6";"0";"0";"457177";"373888"
"V4mis1";"SILVA (only NR);Bacteria;Proteobacteria;Alphaproteobacteria;Acetobacterales;Elioraeaceae;Elioraea;";"100.0";"18.2";"6";"6";"6";"0";"0";"457177";"373888"
"V4mis1";"SILVA (only NR);Bacteria;Proteobacteria;Alphaproteobacteria;Alphaproteobacteria Incertae Sedis;";"94.2";"18.2";"52";"52";"49";"3";"0";"457131";"373845"
"V4mis1";"SILVA (only NR);Bacteria;Proteobacteria;Alphaproteobacteria;Alphaproteobacteria Incertae Sedis;Unknown Family;";"94.2";"18.2";"52";"52";"49";"3";"0";"457131";"373845"
"V4mis1";"SILVA (only NR);Bacteria;Proteobacteria;Alphaproteobacteria;Alphaproteobacteria Incertae Sedis;Unknown Family;Acuticoccus;";"100.0";"18.2";"15";"15";"15";"0";"0";"457168";"373879"
"V4mis1";"SILVA (only NR);Bacteria;Proteobacteria;Alphaproteobacteria;Alphaproteobacteria Incertae Sedis;Unknown Family;Neomegalonema;";"88.9";"18.2";"9";"9";"8";"1";"0";"457174";"373886"
"V4mis1";"SILVA (only NR);Bacteria;Proteobacteria;Alphaproteobacteria;Alphaproteobacteria Incertae Sedis;Unknown Family;uncultured;";"92.3";"18.2";"26";"26";"24";"2";"0";"457157";"373870"
"V4mis1";"SILVA (only NR);Bacteria;Proteobacteria;Alphaproteobacteria;Azospirillales;";"92.0";"18.2";"499";"499";"459";"40";"0";"456684";"373435"
"V4mis1";"SILVA (only NR);Bacteria;Proteobacteria;Alphaproteobacteria;Azospirillales;Azospirillaceae;";"91.6";"18.2";"430";"430";"394";"36";"0";"456753";"373500"
"V4mis1";"SILVA (only NR);Bacteria;Proteobacteria;Alphaproteobacteria;Azospirillales;Azospirillaceae;Azospirillum;";"93.0";"18.2";"286";"286";"266";"20";"0";"456897";"373628"
"V4mis1";"SILVA (only NR);Bacteria;Proteobacteria;Alphaproteobacteria;Azospirillales;Azospirillaceae;Desertibacter;";"100.0";"18.2";"3";"3";"3";"0";"0";"457180";"373891"
"V4mis1";"SILVA (only NR);Bacteria;Proteobacteria;Alphaproteobacteria;Azospirillales;Azospirillaceae;Nitrospirillum;";"100.0";"18.2";"17";"17";"17";"0";"0";"457166";"373877"
"V4mis1";"SILVA (only NR);Bacteria;Proteobacteria;Alphaproteobacteria;Azospirillales;Azospirillaceae;Niveispirillum;";"88.2";"18.2";"34";"34";"30";"4";"0";"457149";"373864"
"V4mis1";"SILVA (only NR);Bacteria;Proteobacteria;Alphaproteobacteria;Azospirillales;Azospirillaceae;Rhodocista;";"100.0";"18.2";"5";"5";"5";"0";"0";"457178";"373889"
"V4mis1";"SILVA (only NR);Bacteria;Proteobacteria;Alphaproteobacteria;Azospirillales;Azospirillaceae;Skermanella;";"87.9";"18.2";"66";"66";"58";"8";"0";"457117";"373836"
"V4mis1";"SILVA (only NR);Bacteria;Proteobacteria;Alphaproteobacteria;Azospirillales;Azospirillaceae;uncultured;";"75.0";"18.2";"16";"16";"12";"4";"0";"457167";"373882"
"V4mis1";"SILVA (only NR);Bacteria;Proteobacteria;Alphaproteobacteria;Azospirillales;Azospirillales Incertae Sedis;";"100.0";"18.2";"12";"12";"12";"0";"0";"457171";"373882"
"V4mis1";"SILVA (only NR);Bacteria;Proteobacteria;Alphaproteobacteria;Azospirillales;Azospirillales Incertae Sedis;Stella;";"100.0";"18.2";"12";"12";"12";"0";"0";"457171";"373882"
"V4mis1";"SILVA (only NR);Bacteria;Proteobacteria;Alphaproteobacteria;Azospirillales;Inquilinaceae;";"97.1";"18.2";"35";"35";"34";"1";"0";"457148";"373860"
"V4mis1";"SILVA (only NR);Bacteria;Proteobacteria;Alphaproteobacteria;Azospirillales;Inquilinaceae;Inquilinus;";"97.1";"18.2";"35";"35";"34";"1";"0";"457148";"373860"
"V4mis1";"SILVA (only NR);Bacteria;Proteobacteria;Alphaproteobacteria;Azospirillales;uncultured;";"86.4";"18.2";"22";"22";"19";"3";"0";"457161";"373875"
"V4mis1";"SILVA (only NR);Bacteria;Proteobacteria;Alphaproteobacteria;Caedibacterales;";"90.9";"18.2";"22";"22";"20";"2";"0";"457161";"373874"
"V4mis1";"SILVA (only NR);Bacteria;Proteobacteria;Alphaproteobacteria;Caedibacterales;Caedibacteraceae;";"90.9";"18.2";"22";"22";"20";"2";"0";"457161";"373874"
"V4mis1";"SILVA (only NR);Bacteria;Proteobacteria;Alphaproteobacteria;Caedibacterales;Caedibacteraceae;Caedibacter;";"91.7";"18.2";"12";"12";"11";"1";"0";"457171";"373883"
"V4mis1";"SILVA (only NR);Bacteria;Proteobacteria;Alphaproteobacteria;Caedibacterales;Caedibacteraceae;Candidatus Nucleicultrix;";"80.0";"18.2";"5";"5";"4";"1";"0";"457178";"373890"
"V4mis1";"SILVA (only NR);Bacteria;Proteobacteria;Alphaproteobacteria;Caedibacterales;Caedibacteraceae;uncultured;";"100.0";"18.2";"5";"5";"5";"0";"0";"457178";"373889"
"V4mis1";"SILVA (only NR);Bacteria;Proteobacteria;Alphaproteobacteria;Caulobacterales;";"95.0";"18.3";"1775";"1775";"1686";"89";"0";"455408";"372208"
"V4mis1";"SILVA (only NR);Bacteria;Proteobacteria;Alphaproteobacteria;Caulobacterales;Caulobacteraceae;";"93.9";"18.2";"1097";"1097";"1030";"67";"0";"456086";"372864"
"V4mis1";"SILVA (only NR);Bacteria;Proteobacteria;Alphaproteobacteria;Caulobacterales;Caulobacteraceae;Asticcacaulis;";"93.3";"18.2";"45";"45";"42";"3";"0";"457138";"373852"
"V4mis1";"SILVA (only NR);Bacteria;Proteobacteria;Alphaproteobacteria;Caulobacterales;Caulobacteraceae;Brevundimonas;";"91.1";"18.2";"541";"541";"493";"48";"0";"456642";"373401"
"V4mis1";"SILVA (only NR);Bacteria;Proteobacteria;Alphaproteobacteria;Caulobacterales;Caulobacteraceae;Caulobacter;";"98.9";"18.2";"177";"177";"175";"2";"0";"457006";"373719"
"V4mis1";"SILVA (only NR);Bacteria;Proteobacteria;Alphaproteobacteria;Caulobacterales;Caulobacteraceae;PMMR1;";"100.0";"18.2";"22";"22";"22";"0";"0";"457161";"373872"
"V4mis1";"SILVA (only NR);Bacteria;Proteobacteria;Alphaproteobacteria;Caulobacterales;Caulobacteraceae;Phenylobacterium;";"94.2";"18.2";"173";"173";"163";"10";"0";"457010";"373731"
"V4mis1";"SILVA (only NR);Bacteria;Proteobacteria;Alphaproteobacteria;Caulobacterales;Caulobacteraceae;uncultured;";"97.1";"18.2";"136";"136";"132";"4";"0";"457047";"373762"
"V4mis1";"SILVA (only NR);Bacteria;Proteobacteria;Alphaproteobacteria;Caulobacterales;Hyphomonadaceae;";"97.4";"18.2";"569";"569";"554";"15";"0";"456614";"373340"
"V4mis1";"SILVA (only NR);Bacteria;Proteobacteria;Alphaproteobacteria;Caulobacterales;Hyphomonadaceae;Algimonas;";"100.0";"18.2";"11";"11";"11";"0";"0";"457172";"373883"
"V4mis1";"SILVA (only NR);Bacteria;Proteobacteria;Alphaproteobacteria;Caulobacterales;Hyphomonadaceae;Euryhalocaulis;";"100.0";"18.2";"8";"8";"8";"0";"0";"457175";"373886"
"V4mis1";"SILVA (only NR);Bacteria;Proteobacteria;Alphaproteobacteria;Caulobacterales;Hyphomonadaceae;Fretibacter;";"100.0";"18.2";"2";"2";"2";"0";"0";"457181";"373892"
"V4mis1";"SILVA (only NR);Bacteria;Proteobacteria;Alphaproteobacteria;Caulobacterales;Hyphomonadaceae;Glycocaulis;";"100.0";"18.2";"3";"3";"3";"0";"0";"457180";"373891"
"V4mis1";"SILVA (only NR);Bacteria;Proteobacteria;Alphaproteobacteria;Caulobacterales;Hyphomonadaceae;Hellea;";"100.0";"18.2";"9";"9";"9";"0";"0";"457174";"373885"
"V4mis1";"SILVA (only NR);Bacteria;Proteobacteria;Alphaproteobacteria;Caulobacterales;Hyphomonadaceae;Henriciella;";"100.0";"18.2";"15";"15";"15";"0";"0";"457168";"373879"
"V4mis1";"SILVA (only NR);Bacteria;Proteobacteria;Alphaproteobacteria;Caulobacterales;Hyphomonadaceae;Hirschia;";"96.7";"18.2";"60";"60";"58";"2";"0";"457123";"373836"
"V4mis1";"SILVA (only NR);Bacteria;Proteobacteria;Alphaproteobacteria;Caulobacterales;Hyphomonadaceae;Hyphobacterium;";"90.0";"18.2";"10";"10";"9";"1";"0";"457173";"373885"
"V4mis1";"SILVA (only NR);Bacteria;Proteobacteria;Alphaproteobacteria;Caulobacterales;Hyphomonadaceae;Hyphomonas;";"95.3";"18.2";"106";"106";"101";"5";"0";"457077";"373793"
"V4mis1";"SILVA (only NR);Bacteria;Proteobacteria;Alphaproteobacteria;Caulobacterales;Hyphomonadaceae;Litorimonas;";"100.0";"18.2";"12";"12";"12";"0";"0";"457171";"373882"
"V4mis1";"SILVA (only NR);Bacteria;Proteobacteria;Alphaproteobacteria;Caulobacterales;Hyphomonadaceae;Maricaulis;";"100.0";"18.2";"30";"30";"30";"0";"0";"457153";"373864"
"V4mis1";"SILVA (only NR);Bacteria;Proteobacteria;Alphaproteobacteria;Caulobacterales;Hyphomonadaceae;Oceanicaulis;";"98.0";"18.2";"51";"51";"50";"1";"0";"457132";"373844"
"V4mis1";"SILVA (only NR);Bacteria;Proteobacteria;Alphaproteobacteria;Caulobacterales;Hyphomonadaceae;Ponticaulis;";"100.0";"18.2";"9";"9";"9";"0";"0";"457174";"373885"
"V4mis1";"SILVA (only NR);Bacteria;Proteobacteria;Alphaproteobacteria;Caulobacterales;Hyphomonadaceae;Robiginitomaculum;";"100.0";"18.2";"27";"27";"27";"0";"0";"457156";"373867"
"V4mis1";"SILVA (only NR);Bacteria;Proteobacteria;Alphaproteobacteria;Caulobacterales;Hyphomonadaceae;SWB02;";"98.0";"18.2";"99";"99";"97";"2";"0";"457084";"373797"
"V4mis1";"SILVA (only NR);Bacteria;Proteobacteria;Alphaproteobacteria;Caulobacterales;Hyphomonadaceae;UKL13-1;";"100.0";"18.2";"9";"9";"9";"0";"0";"457174";"373885"
"V4mis1";"SILVA (only NR);Bacteria;Proteobacteria;Alphaproteobacteria;Caulobacterales;Hyphomonadaceae;Woodsholea;";"100.0";"18.2";"2";"2";"2";"0";"0";"457181";"373892"
"V4mis1";"SILVA (only NR);Bacteria;Proteobacteria;Alphaproteobacteria;Caulobacterales;Hyphomonadaceae;uncultured;";"96.1";"18.2";"103";"103";"99";"4";"0";"457080";"373795"
"V4mis1";"SILVA (only NR);Bacteria;Proteobacteria;Alphaproteobacteria;Caulobacterales;Parvularculaceae;";"93.3";"18.2";"104";"104";"97";"7";"0";"457079";"373797"
"V4mis1";"SILVA (only NR);Bacteria;Proteobacteria;Alphaproteobacteria;Caulobacterales;Parvularculaceae;Amphiplicatus;";"89.7";"18.2";"39";"39";"35";"4";"0";"457144";"373859"
"V4mis1";"SILVA (only NR);Bacteria;Proteobacteria;Alphaproteobacteria;Caulobacterales;Parvularculaceae;Hyphococcus;";"100.0";"18.2";"10";"10";"10";"0";"0";"457173";"373884"
"V4mis1";"SILVA (only NR);Bacteria;Proteobacteria;Alphaproteobacteria;Caulobacterales;Parvularculaceae;Marinicaulis;";"95.0";"18.2";"20";"20";"19";"1";"0";"457163";"373875"
"V4mis1";"SILVA (only NR);Bacteria;Proteobacteria;Alphaproteobacteria;Caulobacterales;Parvularculaceae;Parvularcula;";"95.7";"18.2";"23";"23";"22";"1";"0";"457160";"373872"
"V4mis1";"SILVA (only NR);Bacteria;Proteobacteria;Alphaproteobacteria;Caulobacterales;Parvularculaceae;uncultured;";"91.7";"18.2";"12";"12";"11";"1";"0";"457171";"373883"
"V4mis1";"SILVA (only NR);Bacteria;Proteobacteria;Alphaproteobacteria;Caulobacterales;uncultured;";"100.0";"18.2";"5";"5";"5";"0";"0";"457178";"373889"
"V4mis1";"SILVA (only NR);Bacteria;Proteobacteria;Alphaproteobacteria;Defluviicoccales;";"95.8";"18.2";"334";"334";"320";"14";"0";"456849";"373574"
"V4mis1";"SILVA (only NR);Bacteria;Proteobacteria;Alphaproteobacteria;Defluviicoccales;Defluviicoccaceae;";"96.0";"18.2";"75";"75";"72";"3";"0";"457108";"373822"
"V4mis1";"SILVA (only NR);Bacteria;Proteobacteria;Alphaproteobacteria;Defluviicoccales;Defluviicoccaceae;Defluviicoccus;";"96.0";"18.2";"75";"75";"72";"3";"0";"457108";"373822"
"V4mis1";"SILVA (only NR);Bacteria;Proteobacteria;Alphaproteobacteria;Defluviicoccales;uncultured;";"95.8";"18.2";"259";"259";"248";"11";"0";"456924";"373646"
"V4mis1";"SILVA (only NR);Bacteria;Proteobacteria;Alphaproteobacteria;Dongiales;";"90.3";"18.2";"134";"134";"121";"13";"0";"457049";"373773"
"V4mis1";"SILVA (only NR);Bacteria;Proteobacteria;Alphaproteobacteria;Dongiales;Dongiaceae;";"90.3";"18.2";"134";"134";"121";"13";"0";"457049";"373773"
"V4mis1";"SILVA (only NR);Bacteria;Proteobacteria;Alphaproteobacteria;Dongiales;Dongiaceae;Dongia;";"90.3";"18.2";"134";"134";"121";"13";"0";"457049";"373773"
"V4mis1";"SILVA (only NR);Bacteria;Proteobacteria;Alphaproteobacteria;Dstr-E11;";"75.0";"18.2";"12";"12";"9";"3";"0";"457171";"373885"
"V4mis1";"SILVA (only NR);Bacteria;Proteobacteria;Alphaproteobacteria;Elsterales;";"96.0";"18.2";"300";"300";"288";"12";"0";"456883";"373606"
"V4mis1";"SILVA (only NR);Bacteria;Proteobacteria;Alphaproteobacteria;Elsterales;Elsteraceae;";"96.0";"18.2";"50";"50";"48";"2";"0";"457133";"373846"
"V4mis1";"SILVA (only NR);Bacteria;Proteobacteria;Alphaproteobacteria;Elsterales;Elsteraceae;Aliidongia;";"100.0";"18.2";"2";"2";"2";"0";"0";"457181";"373892"
"V4mis1";"SILVA (only NR);Bacteria;Proteobacteria;Alphaproteobacteria;Elsterales;Elsteraceae;Elstera;";"83.3";"18.2";"6";"6";"5";"1";"0";"457177";"373889"
"V4mis1";"SILVA (only NR);Bacteria;Proteobacteria;Alphaproteobacteria;Elsterales;Elsteraceae;Lacibacterium;";"100.0";"18.2";"1";"1";"1";"0";"0";"457182";"373893"
"V4mis1";"SILVA (only NR);Bacteria;Proteobacteria;Alphaproteobacteria;Elsterales;Elsteraceae;uncultured;";"97.5";"18.2";"40";"40";"39";"1";"0";"457143";"373855"
"V4mis1";"SILVA (only NR);Bacteria;Proteobacteria;Alphaproteobacteria;Elsterales;URHD0088;";"100.0";"18.2";"9";"9";"9";"0";"0";"457174";"373885"
"V4mis1";"SILVA (only NR);Bacteria;Proteobacteria;Alphaproteobacteria;Elsterales;uncultured;";"95.9";"18.2";"241";"241";"231";"10";"0";"456942";"373663"
"V4mis1";"SILVA (only NR);Bacteria;Proteobacteria;Alphaproteobacteria;Emcibacterales;";"100.0";"18.2";"3";"3";"3";"0";"0";"457180";"373891"
"V4mis1";"SILVA (only NR);Bacteria;Proteobacteria;Alphaproteobacteria;Emcibacterales;Emcibacteraceae;";"100.0";"18.2";"3";"3";"3";"0";"0";"457180";"373891"
"V4mis1";"SILVA (only NR);Bacteria;Proteobacteria;Alphaproteobacteria;Emcibacterales;Emcibacteraceae;Emcibacter;";"100.0";"18.2";"3";"3";"3";"0";"0";"457180";"373891"
"V4mis1";"SILVA (only NR);Bacteria;Proteobacteria;Alphaproteobacteria;Ferrovibrionales;";"100.0";"18.2";"30";"30";"30";"0";"0";"457153";"373864"
"V4mis1";"SILVA (only NR);Bacteria;Proteobacteria;Alphaproteobacteria;Ferrovibrionales;Ferrovibrionaceae;";"100.0";"18.2";"16";"16";"16";"0";"0";"457167";"373878"
"V4mis1";"SILVA (only NR);Bacteria;Proteobacteria;Alphaproteobacteria;Ferrovibrionales;Ferrovibrionaceae;Ferrovibrio;";"100.0";"18.2";"16";"16";"16";"0";"0";"457167";"373878"
"V4mis1";"SILVA (only NR);Bacteria;Proteobacteria;Alphaproteobacteria;Ferrovibrionales;Marinibaculum;";"100.0";"18.2";"1";"1";"1";"0";"0";"457182";"373893"
"V4mis1";"SILVA (only NR);Bacteria;Proteobacteria;Alphaproteobacteria;Ferrovibrionales;Taonella;";"100.0";"18.2";"6";"6";"6";"0";"0";"457177";"373888"
"V4mis1";"SILVA (only NR);Bacteria;Proteobacteria;Alphaproteobacteria;Ferrovibrionales;uncultured;";"100.0";"18.2";"7";"7";"7";"0";"0";"457176";"373887"
"V4mis1";"SILVA (only NR);Bacteria;Proteobacteria;Alphaproteobacteria;Holosporales;";"97.2";"18.2";"72";"72";"70";"2";"0";"457111";"373824"
"V4mis1";"SILVA (only NR);Bacteria;Proteobacteria;Alphaproteobacteria;Holosporales;Holosporaceae;";"97.2";"18.2";"72";"72";"70";"2";"0";"457111";"373824"
"V4mis1";"SILVA (only NR);Bacteria;Proteobacteria;Alphaproteobacteria;Holosporales;Holosporaceae;Candidatus Bealeia;";"87.5";"18.2";"8";"8";"7";"1";"0";"457175";"373887"
"V4mis1";"SILVA (only NR);Bacteria;Proteobacteria;Alphaproteobacteria;Holosporales;Holosporaceae;Candidatus Gortzia;";"100.0";"18.2";"4";"4";"4";"0";"0";"457179";"373890"
"V4mis1";"SILVA (only NR);Bacteria;Proteobacteria;Alphaproteobacteria;Holosporales;Holosporaceae;Candidatus Paraholospora;";"100.0";"18.2";"2";"2";"2";"0";"0";"457181";"373892"
"V4mis1";"SILVA (only NR);Bacteria;Proteobacteria;Alphaproteobacteria;Holosporales;Holosporaceae;Holospora;";"100.0";"18.2";"9";"9";"9";"0";"0";"457174";"373885"
"V4mis1";"SILVA (only NR);Bacteria;Proteobacteria;Alphaproteobacteria;Holosporales;Holosporaceae;uncultured;";"97.8";"18.2";"46";"46";"45";"1";"0";"457137";"373849"
"V4mis1";"SILVA (only NR);Bacteria;Proteobacteria;Alphaproteobacteria;Kiloniellales;";"96.7";"18.2";"361";"361";"349";"12";"0";"456822";"373545"
"V4mis1";"SILVA (only NR);Bacteria;Proteobacteria;Alphaproteobacteria;Kiloniellales;Fodinicurvataceae;";"94.7";"18.2";"75";"75";"71";"4";"0";"457108";"373823"
"V4mis1";"SILVA (only NR);Bacteria;Proteobacteria;Alphaproteobacteria;Kiloniellales;Fodinicurvataceae;Fodinicurvata;";"100.0";"18.2";"9";"9";"9";"0";"0";"457174";"373885"
"V4mis1";"SILVA (only NR);Bacteria;Proteobacteria;Alphaproteobacteria;Kiloniellales;Fodinicurvataceae;Limimonas;";"90.9";"18.2";"11";"11";"10";"1";"0";"457172";"373884"
"V4mis1";"SILVA (only NR);Bacteria;Proteobacteria;Alphaproteobacteria;Kiloniellales;Fodinicurvataceae;Rhodovibrio;";"93.3";"18.2";"30";"30";"28";"2";"0";"457153";"373866"
"V4mis1";"SILVA (only NR);Bacteria;Proteobacteria;Alphaproteobacteria;Kiloniellales;Fodinicurvataceae;uncultured;";"96.0";"18.2";"25";"25";"24";"1";"0";"457158";"373870"
"V4mis1";"SILVA (only NR);Bacteria;Proteobacteria;Alphaproteobacteria;Kiloniellales;Kiloniellaceae;";"97.2";"18.2";"286";"286";"278";"8";"0";"456897";"373616"
"V4mis1";"SILVA (only NR);Bacteria;Proteobacteria;Alphaproteobacteria;Kiloniellales;Kiloniellaceae;Kiloniella;";"100.0";"18.2";"7";"7";"7";"0";"0";"457176";"373887"
"V4mis1";"SILVA (only NR);Bacteria;Proteobacteria;Alphaproteobacteria;Kiloniellales;Kiloniellaceae;Limibacillus;";"100.0";"18.2";"11";"11";"11";"0";"0";"457172";"373883"
"V4mis1";"SILVA (only NR);Bacteria;Proteobacteria;Alphaproteobacteria;Kiloniellales;Kiloniellaceae;Pelagibius;";"100.0";"18.2";"44";"44";"44";"0";"0";"457139";"373850"
"V4mis1";"SILVA (only NR);Bacteria;Proteobacteria;Alphaproteobacteria;Kiloniellales;Kiloniellaceae;Tagaea;";"100.0";"18.2";"5";"5";"5";"0";"0";"457178";"373889"
"V4mis1";"SILVA (only NR);Bacteria;Proteobacteria;Alphaproteobacteria;Kiloniellales;Kiloniellaceae;Tistlia;";"96.7";"18.2";"30";"30";"29";"1";"0";"457153";"373865"
"V4mis1";"SILVA (only NR);Bacteria;Proteobacteria;Alphaproteobacteria;Kiloniellales;Kiloniellaceae;uncultured;";"96.3";"18.2";"189";"189";"182";"7";"0";"456994";"373712"
"V4mis1";"SILVA (only NR);Bacteria;Proteobacteria;Alphaproteobacteria;Kordiimonadales;";"94.5";"18.2";"127";"127";"120";"7";"0";"457056";"373774"
"V4mis1";"SILVA (only NR);Bacteria;Proteobacteria;Alphaproteobacteria;Kordiimonadales;Iodidimonadaceae;";"100.0";"18.2";"10";"10";"10";"0";"0";"457173";"373884"
"V4mis1";"SILVA (only NR);Bacteria;Proteobacteria;Alphaproteobacteria;Kordiimonadales;Iodidimonadaceae;Iodidimonas;";"100.0";"18.2";"10";"10";"10";"0";"0";"457173";"373884"
"V4mis1";"SILVA (only NR);Bacteria;Proteobacteria;Alphaproteobacteria;Kordiimonadales;Kordiimonadaceae;";"97.4";"18.2";"78";"78";"76";"2";"0";"457105";"373818"
"V4mis1";"SILVA (only NR);Bacteria;Proteobacteria;Alphaproteobacteria;Kordiimonadales;Kordiimonadaceae;Kordiimonas;";"97.4";"18.2";"78";"78";"76";"2";"0";"457105";"373818"
"V4mis1";"SILVA (only NR);Bacteria;Proteobacteria;Alphaproteobacteria;Kordiimonadales;Kordiimonadales Incertae Sedis;";"100.0";"18.2";"2";"2";"2";"0";"0";"457181";"373892"
"V4mis1";"SILVA (only NR);Bacteria;Proteobacteria;Alphaproteobacteria;Kordiimonadales;Kordiimonadales Incertae Sedis;Eilatimonas;";"100.0";"18.2";"2";"2";"2";"0";"0";"457181";"373892"
"V4mis1";"SILVA (only NR);Bacteria;Proteobacteria;Alphaproteobacteria;Kordiimonadales;Temperatibacteraceae;";"100.0";"18.2";"2";"2";"2";"0";"0";"457181";"373892"
"V4mis1";"SILVA (only NR);Bacteria;Proteobacteria;Alphaproteobacteria;Kordiimonadales;Temperatibacteraceae;Temperatibacter;";"100.0";"18.2";"2";"2";"2";"0";"0";"457181";"373892"
"V4mis1";"SILVA (only NR);Bacteria;Proteobacteria;Alphaproteobacteria;Kordiimonadales;uncultured;";"85.7";"18.2";"35";"35";"30";"5";"0";"457148";"373864"
"V4mis1";"SILVA (only NR);Bacteria;Proteobacteria;Alphaproteobacteria;Micavibrionales;";"97.7";"18.2";"303";"303";"296";"7";"0";"456880";"373598"
"V4mis1";"SILVA (only NR);Bacteria;Proteobacteria;Alphaproteobacteria;Micavibrionales;Micavibrionaceae;";"98.0";"18.2";"153";"153";"150";"3";"0";"457030";"373744"
"V4mis1";"SILVA (only NR);Bacteria;Proteobacteria;Alphaproteobacteria;Micavibrionales;Micavibrionaceae;Micavibrio;";"100.0";"18.2";"3";"3";"3";"0";"0";"457180";"373891"
"V4mis1";"SILVA (only NR);Bacteria;Proteobacteria;Alphaproteobacteria;Micavibrionales;Micavibrionaceae;uncultured;";"98.0";"18.2";"150";"150";"147";"3";"0";"457033";"373747"
"V4mis1";"SILVA (only NR);Bacteria;Proteobacteria;Alphaproteobacteria;Micavibrionales;uncultured;";"97.3";"18.2";"148";"148";"144";"4";"0";"457035";"373750"
"V4mis1";"SILVA (only NR);Bacteria;Proteobacteria;Alphaproteobacteria;Micropepsales;";"97.9";"18.2";"146";"146";"143";"3";"0";"457037";"373751"
"V4mis1";"SILVA (only NR);Bacteria;Proteobacteria;Alphaproteobacteria;Micropepsales;Micropepsaceae;";"97.9";"18.2";"146";"146";"143";"3";"0";"457037";"373751"
"V4mis1";"SILVA (only NR);Bacteria;Proteobacteria;Alphaproteobacteria;Micropepsales;Micropepsaceae;Micropepsis;";"100.0";"18.2";"7";"7";"7";"0";"0";"457176";"373887"
"V4mis1";"SILVA (only NR);Bacteria;Proteobacteria;Alphaproteobacteria;Micropepsales;Micropepsaceae;Rhizomicrobium;";"100.0";"18.2";"6";"6";"6";"0";"0";"457177";"373888"
"V4mis1";"SILVA (only NR);Bacteria;Proteobacteria;Alphaproteobacteria;Micropepsales;Micropepsaceae;uncultured;";"97.7";"18.2";"128";"128";"125";"3";"0";"457055";"373769"
"V4mis1";"SILVA (only NR);Bacteria;Proteobacteria;Alphaproteobacteria;NRL2;";"96.0";"18.2";"25";"25";"24";"1";"0";"457158";"373870"
"V4mis1";"SILVA (only NR);Bacteria;Proteobacteria;Alphaproteobacteria;Paracaedibacterales;";"95.9";"18.2";"146";"146";"140";"6";"0";"457037";"373754"
"V4mis1";"SILVA (only NR);Bacteria;Proteobacteria;Alphaproteobacteria;Paracaedibacterales;Paracaedibacteraceae;";"95.9";"18.2";"146";"146";"140";"6";"0";"457037";"373754"
"V4mis1";"SILVA (only NR);Bacteria;Proteobacteria;Alphaproteobacteria;Paracaedibacterales;Paracaedibacteraceae;Candidatus Captivus;";"100.0";"18.2";"20";"20";"20";"0";"0";"457163";"373874"
"V4mis1";"SILVA (only NR);Bacteria;Proteobacteria;Alphaproteobacteria;Paracaedibacterales;Paracaedibacteraceae;Candidatus Finniella;";"90.9";"18.2";"11";"11";"10";"1";"0";"457172";"373884"
"V4mis1";"SILVA (only NR);Bacteria;Proteobacteria;Alphaproteobacteria;Paracaedibacterales;Paracaedibacteraceae;Candidatus Odyssella;";"100.0";"18.2";"2";"2";"2";"0";"0";"457181";"373892"
"V4mis1";"SILVA (only NR);Bacteria;Proteobacteria;Alphaproteobacteria;Paracaedibacterales;Paracaedibacteraceae;Candidatus Paracaedibacter;";"100.0";"18.2";"34";"34";"34";"0";"0";"457149";"373860"
"V4mis1";"SILVA (only NR);Bacteria;Proteobacteria;Alphaproteobacteria;Paracaedibacterales;Paracaedibacteraceae;uncultured;";"94.7";"18.2";"76";"76";"72";"4";"0";"457107";"373822"
"V4mis1";"SILVA (only NR);Bacteria;Proteobacteria;Alphaproteobacteria;Parvibaculales;";"94.4";"18.2";"215";"215";"203";"12";"0";"456968";"373691"
"V4mis1";"SILVA (only NR);Bacteria;Proteobacteria;Alphaproteobacteria;Parvibaculales;OCS116 clade;";"93.5";"18.2";"46";"46";"43";"3";"0";"457137";"373851"
"V4mis1";"SILVA (only NR);Bacteria;Proteobacteria;Alphaproteobacteria;Parvibaculales;PS1 clade;";"93.2";"18.2";"73";"73";"68";"5";"0";"457110";"373826"
"V4mis1";"SILVA (only NR);Bacteria;Proteobacteria;Alphaproteobacteria;Parvibaculales;Parvibaculaceae;";"95.6";"18.2";"91";"91";"87";"4";"0";"457092";"373807"
"V4mis1";"SILVA (only NR);Bacteria;Proteobacteria;Alphaproteobacteria;Parvibaculales;Parvibaculaceae;Candidatus Phaeomarinobacter;";"100.0";"18.2";"1";"1";"1";"0";"0";"457182";"373893"
"V4mis1";"SILVA (only NR);Bacteria;Proteobacteria;Alphaproteobacteria;Parvibaculales;Parvibaculaceae;Mf105b01;";"92.9";"18.2";"14";"14";"13";"1";"0";"457169";"373881"
"V4mis1";"SILVA (only NR);Bacteria;Proteobacteria;Alphaproteobacteria;Parvibaculales;Parvibaculaceae;Parvibaculum;";"95.9";"18.2";"49";"49";"47";"2";"0";"457134";"373847"
"V4mis1";"SILVA (only NR);Bacteria;Proteobacteria;Alphaproteobacteria;Parvibaculales;Parvibaculaceae;Pyruvatibacter;";"100.0";"18.2";"1";"1";"1";"0";"0";"457182";"373893"
"V4mis1";"SILVA (only NR);Bacteria;Proteobacteria;Alphaproteobacteria;Parvibaculales;Parvibaculaceae;Rhodoligotrophos;";"100.0";"18.2";"5";"5";"5";"0";"0";"457178";"373889"
"V4mis1";"SILVA (only NR);Bacteria;Proteobacteria;Alphaproteobacteria;Parvibaculales;Parvibaculaceae;Tepidicaulis;";"75.0";"18.2";"4";"4";"3";"1";"0";"457179";"373891"
"V4mis1";"SILVA (only NR);Bacteria;Proteobacteria;Alphaproteobacteria;Parvibaculales;Parvibaculaceae;uncultured;";"100.0";"18.2";"12";"12";"12";"0";"0";"457171";"373882"
"V4mis1";"SILVA (only NR);Bacteria;Proteobacteria;Alphaproteobacteria;Parvibaculales;uncultured;";"100.0";"18.2";"4";"4";"4";"0";"0";"457179";"373890"
"V4mis1";"SILVA (only NR);Bacteria;Proteobacteria;Alphaproteobacteria;Puniceispirillales;";"95.8";"18.2";"307";"307";"294";"13";"0";"456876";"373600"
"V4mis1";"SILVA (only NR);Bacteria;Proteobacteria;Alphaproteobacteria;Puniceispirillales;EF100-94H03;";"92.0";"18.2";"25";"25";"23";"2";"0";"457158";"373871"
"V4mis1";"SILVA (only NR);Bacteria;Proteobacteria;Alphaproteobacteria;Puniceispirillales;Puniceispirillales Incertae Sedis;";"81.8";"18.2";"22";"22";"18";"4";"0";"457161";"373876"
"V4mis1";"SILVA (only NR);Bacteria;Proteobacteria;Alphaproteobacteria;Puniceispirillales;Puniceispirillales Incertae Sedis;Constrictibacter;";"81.8";"18.2";"22";"22";"18";"4";"0";"457161";"373876"
"V4mis1";"SILVA (only NR);Bacteria;Proteobacteria;Alphaproteobacteria;Puniceispirillales;SAR116 clade;";"96.9";"18.2";"226";"226";"219";"7";"0";"456957";"373675"
"V4mis1";"SILVA (only NR);Bacteria;Proteobacteria;Alphaproteobacteria;Puniceispirillales;SAR116 clade;Candidatus Puniceispirillum;";"93.8";"18.2";"16";"16";"15";"1";"0";"457167";"373879"
"V4mis1";"SILVA (only NR);Bacteria;Proteobacteria;Alphaproteobacteria;Puniceispirillales;uncultured;";"100.0";"18.2";"32";"32";"32";"0";"0";"457151";"373862"
"V4mis1";"SILVA (only NR);Bacteria;Proteobacteria;Alphaproteobacteria;Reyranellales;";"95.0";"18.2";"179";"179";"170";"9";"0";"457004";"373724"
"V4mis1";"SILVA (only NR);Bacteria;Proteobacteria;Alphaproteobacteria;Reyranellales;Reyranellaceae;";"95.0";"18.2";"179";"179";"170";"9";"0";"457004";"373724"
"V4mis1";"SILVA (only NR);Bacteria;Proteobacteria;Alphaproteobacteria;Reyranellales;Reyranellaceae;Reyranella;";"93.5";"18.2";"124";"124";"116";"8";"0";"457059";"373778"
"V4mis1";"SILVA (only NR);Bacteria;Proteobacteria;Alphaproteobacteria;Reyranellales;Reyranellaceae;uncultured;";"98.2";"18.2";"55";"55";"54";"1";"0";"457128";"373840"
"V4mis1";"SILVA (only NR);Bacteria;Proteobacteria;Alphaproteobacteria;Rhizobiales;";"94.8";"18.5";"10862";"10862";"10294";"568";"0";"446321";"363600"
"V4mis1";"SILVA (only NR);Bacteria;Proteobacteria;Alphaproteobacteria;Rhizobiales;A0839;";"96.4";"18.2";"112";"112";"108";"4";"0";"457071";"373786"
"V4mis1";"SILVA (only NR);Bacteria;Proteobacteria;Alphaproteobacteria;Rhizobiales;Amb-16S-1323;";"88.9";"18.2";"18";"18";"16";"2";"0";"457165";"373878"
"V4mis1";"SILVA (only NR);Bacteria;Proteobacteria;Alphaproteobacteria;Rhizobiales;Ancalomicrobiaceae;";"100.0";"18.2";"4";"4";"4";"0";"0";"457179";"373890"
"V4mis1";"SILVA (only NR);Bacteria;Proteobacteria;Alphaproteobacteria;Rhizobiales;Ancalomicrobiaceae;Ancalomicrobium;";"100.0";"18.2";"4";"4";"4";"0";"0";"457179";"373890"
"V4mis1";"SILVA (only NR);Bacteria;Proteobacteria;Alphaproteobacteria;Rhizobiales;Beijerinckiaceae;";"92.8";"18.3";"1477";"1477";"1371";"106";"0";"455706";"372523"
"V4mis1";"SILVA (only NR);Bacteria;Proteobacteria;Alphaproteobacteria;Rhizobiales;Beijerinckiaceae;1174-901-12;";"95.2";"18.2";"62";"62";"59";"3";"0";"457121";"373835"
"V4mis1";"SILVA (only NR);Bacteria;Proteobacteria;Alphaproteobacteria;Rhizobiales;Beijerinckiaceae;28-YEA-48;";"100.0";"18.2";"2";"2";"2";"0";"0";"457181";"373892"
"V4mis1";"SILVA (only NR);Bacteria;Proteobacteria;Alphaproteobacteria;Rhizobiales;Beijerinckiaceae;Beijerinckia;";"87.0";"18.2";"23";"23";"20";"3";"0";"457160";"373874"
"V4mis1";"SILVA (only NR);Bacteria;Proteobacteria;Alphaproteobacteria;Rhizobiales;Beijerinckiaceae;Bosea;";"96.0";"18.2";"124";"124";"119";"5";"0";"457059";"373775"
"V4mis1";"SILVA (only NR);Bacteria;Proteobacteria;Alphaproteobacteria;Rhizobiales;Beijerinckiaceae;Camelimonas;";"100.0";"18.2";"9";"9";"9";"0";"0";"457174";"373885"
"V4mis1";"SILVA (only NR);Bacteria;Proteobacteria;Alphaproteobacteria;Rhizobiales;Beijerinckiaceae;Chelatococcus;";"100.0";"18.2";"21";"21";"21";"0";"0";"457162";"373873"
"V4mis1";"SILVA (only NR);Bacteria;Proteobacteria;Alphaproteobacteria;Rhizobiales;Beijerinckiaceae;FFCH5858;";"83.3";"18.2";"6";"6";"5";"1";"0";"457177";"373889"
"V4mis1";"SILVA (only NR);Bacteria;Proteobacteria;Alphaproteobacteria;Rhizobiales;Beijerinckiaceae;FukuN57;";"93.3";"18.2";"15";"15";"14";"1";"0";"457168";"373880"
"V4mis1";"SILVA (only NR);Bacteria;Proteobacteria;Alphaproteobacteria;Rhizobiales;Beijerinckiaceae;Methylobacterium-Methylorubrum;";"88.9";"18.2";"551";"551";"490";"61";"0";"456632";"373404"
"V4mis1";"SILVA (only NR);Bacteria;Proteobacteria;Alphaproteobacteria;Rhizobiales;Beijerinckiaceae;Methylocapsa;";"100.0";"18.2";"10";"10";"10";"0";"0";"457173";"373884"
"V4mis1";"SILVA (only NR);Bacteria;Proteobacteria;Alphaproteobacteria;Rhizobiales;Beijerinckiaceae;Methylocella;";"100.0";"18.2";"20";"20";"20";"0";"0";"457163";"373874"
"V4mis1";"SILVA (only NR);Bacteria;Proteobacteria;Alphaproteobacteria;Rhizobiales;Beijerinckiaceae;Methylocystis;";"94.6";"18.2";"56";"56";"53";"3";"0";"457127";"373841"
"V4mis1";"SILVA (only NR);Bacteria;Proteobacteria;Alphaproteobacteria;Rhizobiales;Beijerinckiaceae;Methyloferula;";"100.0";"18.2";"5";"5";"5";"0";"0";"457178";"373889"
"V4mis1";"SILVA (only NR);Bacteria;Proteobacteria;Alphaproteobacteria;Rhizobiales;Beijerinckiaceae;Methylorosula;";"87.5";"18.2";"24";"24";"21";"3";"0";"457159";"373873"
"V4mis1";"SILVA (only NR);Bacteria;Proteobacteria;Alphaproteobacteria;Rhizobiales;Beijerinckiaceae;Methylosinus;";"100.0";"18.2";"18";"18";"18";"0";"0";"457165";"373876"
"V4mis1";"SILVA (only NR);Bacteria;Proteobacteria;Alphaproteobacteria;Rhizobiales;Beijerinckiaceae;Methylovirgula;";"100.0";"18.2";"15";"15";"15";"0";"0";"457168";"373879"
"V4mis1";"SILVA (only NR);Bacteria;Proteobacteria;Alphaproteobacteria;Rhizobiales;Beijerinckiaceae;Microvirga;";"92.4";"18.2";"170";"170";"157";"13";"0";"457013";"373737"
"V4mis1";"SILVA (only NR);Bacteria;Proteobacteria;Alphaproteobacteria;Rhizobiales;Beijerinckiaceae;Neo-b11;";"100.0";"18.2";"3";"3";"3";"0";"0";"457180";"373891"
"V4mis1";"SILVA (only NR);Bacteria;Proteobacteria;Alphaproteobacteria;Rhizobiales;Beijerinckiaceae;Pseudochelatococcus;";"92.9";"18.2";"14";"14";"13";"1";"0";"457169";"373881"
"V4mis1";"SILVA (only NR);Bacteria;Proteobacteria;Alphaproteobacteria;Rhizobiales;Beijerinckiaceae;Psychroglaciecola;";"100.0";"18.2";"16";"16";"16";"0";"0";"457167";"373878"
"V4mis1";"SILVA (only NR);Bacteria;Proteobacteria;Alphaproteobacteria;Rhizobiales;Beijerinckiaceae;Qingshengfania;";"100.0";"18.2";"2";"2";"2";"0";"0";"457181";"373892"
"V4mis1";"SILVA (only NR);Bacteria;Proteobacteria;Alphaproteobacteria;Rhizobiales;Beijerinckiaceae;Rhodoblastus;";"100.0";"18.2";"15";"15";"15";"0";"0";"457168";"373879"
"V4mis1";"SILVA (only NR);Bacteria;Proteobacteria;Alphaproteobacteria;Rhizobiales;Beijerinckiaceae;Roseiarcus;";"95.8";"18.2";"48";"48";"46";"2";"0";"457135";"373848"
"V4mis1";"SILVA (only NR);Bacteria;Proteobacteria;Alphaproteobacteria;Rhizobiales;Beijerinckiaceae;Salinarimonas;";"92.9";"18.2";"14";"14";"13";"1";"0";"457169";"373881"
"V4mis1";"SILVA (only NR);Bacteria;Proteobacteria;Alphaproteobacteria;Rhizobiales;Beijerinckiaceae;alphaI cluster;";"98.0";"18.2";"50";"50";"49";"1";"0";"457133";"373845"
"V4mis1";"SILVA (only NR);Bacteria;Proteobacteria;Alphaproteobacteria;Rhizobiales;Beijerinckiaceae;uncultured;";"95.3";"18.2";"172";"172";"164";"8";"0";"457011";"373730"
"V4mis1";"SILVA (only NR);Bacteria;Proteobacteria;Alphaproteobacteria;Rhizobiales;C2U;";"95.0";"18.2";"20";"20";"19";"1";"0";"457163";"373875"
"V4mis1";"SILVA (only NR);Bacteria;Proteobacteria;Alphaproteobacteria;Rhizobiales;D05-2;";"100.0";"18.2";"41";"41";"41";"0";"0";"457142";"373853"
"V4mis1";"SILVA (only NR);Bacteria;Proteobacteria;Alphaproteobacteria;Rhizobiales;Devosiaceae;";"95.3";"18.2";"536";"536";"511";"25";"0";"456647";"373383"
"V4mis1";"SILVA (only NR);Bacteria;Proteobacteria;Alphaproteobacteria;Rhizobiales;Devosiaceae;Arsenicitalea;";"100.0";"18.2";"17";"17";"17";"0";"0";"457166";"373877"
"V4mis1";"SILVA (only NR);Bacteria;Proteobacteria;Alphaproteobacteria;Rhizobiales;Devosiaceae;Cucumibacter;";"100.0";"18.2";"4";"4";"4";"0";"0";"457179";"373890"
"V4mis1";"SILVA (only NR);Bacteria;Proteobacteria;Alphaproteobacteria;Rhizobiales;Devosiaceae;Devosia;";"96.1";"18.2";"384";"384";"369";"15";"0";"456799";"373525"
"V4mis1";"SILVA (only NR);Bacteria;Proteobacteria;Alphaproteobacteria;Rhizobiales;Devosiaceae;Maritalea;";"100.0";"18.2";"13";"13";"13";"0";"0";"457170";"373881"
"V4mis1";"SILVA (only NR);Bacteria;Proteobacteria;Alphaproteobacteria;Rhizobiales;Devosiaceae;Methyloterrigena;";"100.0";"18.2";"2";"2";"2";"0";"0";"457181";"373892"
"V4mis1";"SILVA (only NR);Bacteria;Proteobacteria;Alphaproteobacteria;Rhizobiales;Devosiaceae;Paradevosia;";"50.0";"18.2";"2";"2";"1";"1";"0";"457181";"373893"
"V4mis1";"SILVA (only NR);Bacteria;Proteobacteria;Alphaproteobacteria;Rhizobiales;Devosiaceae;Pelagibacterium;";"90.7";"18.2";"43";"43";"39";"4";"0";"457140";"373855"
"V4mis1";"SILVA (only NR);Bacteria;Proteobacteria;Alphaproteobacteria;Rhizobiales;Devosiaceae;Youhaiella;";"100.0";"18.2";"2";"2";"2";"0";"0";"457181";"373892"
"V4mis1";"SILVA (only NR);Bacteria;Proteobacteria;Alphaproteobacteria;Rhizobiales;Devosiaceae;uncultured;";"93.8";"18.2";"65";"65";"61";"4";"0";"457118";"373833"
"V4mis1";"SILVA (only NR);Bacteria;Proteobacteria;Alphaproteobacteria;Rhizobiales;Hyphomicrobiaceae;";"95.9";"18.2";"583";"583";"559";"24";"0";"456600";"373335"
"V4mis1";"SILVA (only NR);Bacteria;Proteobacteria;Alphaproteobacteria;Rhizobiales;Hyphomicrobiaceae;Filomicrobium;";"93.0";"18.2";"71";"71";"66";"5";"0";"457112";"373828"
"V4mis1";"SILVA (only NR);Bacteria;Proteobacteria;Alphaproteobacteria;Rhizobiales;Hyphomicrobiaceae;Hyphomicrobium;";"96.7";"18.2";"300";"300";"290";"10";"0";"456883";"373604"
"V4mis1";"SILVA (only NR);Bacteria;Proteobacteria;Alphaproteobacteria;Rhizobiales;Hyphomicrobiaceae;Pedomicrobium;";"95.1";"18.2";"163";"163";"155";"8";"0";"457020";"373739"
"V4mis1";"SILVA (only NR);Bacteria;Proteobacteria;Alphaproteobacteria;Rhizobiales;Hyphomicrobiaceae;uncultured;";"97.9";"18.2";"48";"48";"47";"1";"0";"457135";"373847"
"V4mis1";"SILVA (only NR);Bacteria;Proteobacteria;Alphaproteobacteria;Rhizobiales;KF-JG30-B3;";"98.4";"18.2";"64";"64";"63";"1";"0";"457119";"373831"
"V4mis1";"SILVA (only NR);Bacteria;Proteobacteria;Alphaproteobacteria;Rhizobiales;Kaistiaceae;";"100.0";"18.2";"25";"25";"25";"0";"0";"457158";"373869"
"V4mis1";"SILVA (only NR);Bacteria;Proteobacteria;Alphaproteobacteria;Rhizobiales;Kaistiaceae;Kaistia;";"100.0";"18.2";"25";"25";"25";"0";"0";"457158";"373869"
"V4mis1";"SILVA (only NR);Bacteria;Proteobacteria;Alphaproteobacteria;Rhizobiales;Labraceae;";"94.3";"18.2";"53";"53";"50";"3";"0";"457130";"373844"
"V4mis1";"SILVA (only NR);Bacteria;Proteobacteria;Alphaproteobacteria;Rhizobiales;Labraceae;Labrys;";"94.3";"18.2";"53";"53";"50";"3";"0";"457130";"373844"
"V4mis1";"SILVA (only NR);Bacteria;Proteobacteria;Alphaproteobacteria;Rhizobiales;Lutibaculaceae;";"100.0";"18.2";"3";"3";"3";"0";"0";"457180";"373891"
"V4mis1";"SILVA (only NR);Bacteria;Proteobacteria;Alphaproteobacteria;Rhizobiales;Lutibaculaceae;Lutibaculum;";"100.0";"18.2";"3";"3";"3";"0";"0";"457180";"373891"
"V4mis1";"SILVA (only NR);Bacteria;Proteobacteria;Alphaproteobacteria;Rhizobiales;Methyloligellaceae;";"95.6";"18.2";"226";"226";"216";"10";"0";"456957";"373678"
"V4mis1";"SILVA (only NR);Bacteria;Proteobacteria;Alphaproteobacteria;Rhizobiales;Methyloligellaceae;Methyloceanibacter;";"100.0";"18.2";"33";"33";"33";"0";"0";"457150";"373861"
"V4mis1";"SILVA (only NR);Bacteria;Proteobacteria;Alphaproteobacteria;Rhizobiales;Methyloligellaceae;Methyloligella;";"100.0";"18.2";"2";"2";"2";"0";"0";"457181";"373892"
"V4mis1";"SILVA (only NR);Bacteria;Proteobacteria;Alphaproteobacteria;Rhizobiales;Methyloligellaceae;Rhodobium;";"100.0";"18.2";"4";"4";"4";"0";"0";"457179";"373890"
"V4mis1";"SILVA (only NR);Bacteria;Proteobacteria;Alphaproteobacteria;Rhizobiales;Methyloligellaceae;uncultured;";"94.4";"18.2";"180";"180";"170";"10";"0";"457003";"373724"
"V4mis1";"SILVA (only NR);Bacteria;Proteobacteria;Alphaproteobacteria;Rhizobiales;Methylopilaceae;";"100.0";"18.2";"27";"27";"27";"0";"0";"457156";"373867"
"V4mis1";"SILVA (only NR);Bacteria;Proteobacteria;Alphaproteobacteria;Rhizobiales;Methylopilaceae;Albibacter;";"100.0";"18.2";"4";"4";"4";"0";"0";"457179";"373890"
"V4mis1";"SILVA (only NR);Bacteria;Proteobacteria;Alphaproteobacteria;Rhizobiales;Methylopilaceae;Hansschlegelia;";"100.0";"18.2";"10";"10";"10";"0";"0";"457173";"373884"
"V4mis1";"SILVA (only NR);Bacteria;Proteobacteria;Alphaproteobacteria;Rhizobiales;Methylopilaceae;Methylopila;";"100.0";"18.2";"9";"9";"9";"0";"0";"457174";"373885"
"V4mis1";"SILVA (only NR);Bacteria;Proteobacteria;Alphaproteobacteria;Rhizobiales;Methylopilaceae;uncultured;";"100.0";"18.2";"2";"2";"2";"0";"0";"457181";"373892"
"V4mis1";"SILVA (only NR);Bacteria;Proteobacteria;Alphaproteobacteria;Rhizobiales;Pleomorphomonadaceae;";"98.3";"18.2";"60";"60";"59";"1";"0";"457123";"373835"
"V4mis1";"SILVA (only NR);Bacteria;Proteobacteria;Alphaproteobacteria;Rhizobiales;Pleomorphomonadaceae;Chthonobacter;";"100.0";"18.2";"16";"16";"16";"0";"0";"457167";"373878"
"V4mis1";"SILVA (only NR);Bacteria;Proteobacteria;Alphaproteobacteria;Rhizobiales;Pleomorphomonadaceae;Hartmannibacter;";"100.0";"18.2";"2";"2";"2";"0";"0";"457181";"373892"
"V4mis1";"SILVA (only NR);Bacteria;Proteobacteria;Alphaproteobacteria;Rhizobiales;Pleomorphomonadaceae;Methylobrevis;";"100.0";"18.2";"1";"1";"1";"0";"0";"457182";"373893"
"V4mis1";"SILVA (only NR);Bacteria;Proteobacteria;Alphaproteobacteria;Rhizobiales;Pleomorphomonadaceae;Pleomorphomonas;";"93.3";"18.2";"15";"15";"14";"1";"0";"457168";"373880"
"V4mis1";"SILVA (only NR);Bacteria;Proteobacteria;Alphaproteobacteria;Rhizobiales;Pleomorphomonadaceae;Prosthecomicrobium;";"100.0";"18.2";"10";"10";"10";"0";"0";"457173";"373884"
"V4mis1";"SILVA (only NR);Bacteria;Proteobacteria;Alphaproteobacteria;Rhizobiales;Pleomorphomonadaceae;uncultured;";"100.0";"18.2";"16";"16";"16";"0";"0";"457167";"373878"
"V4mis1";"SILVA (only NR);Bacteria;Proteobacteria;Alphaproteobacteria;Rhizobiales;Rhizobiaceae;";"95.4";"18.4";"4735";"4735";"4519";"216";"0";"452448";"369375"
"V4mis1";"SILVA (only NR);Bacteria;Proteobacteria;Alphaproteobacteria;Rhizobiales;Rhizobiaceae;Ahrensia;";"90.0";"18.2";"10";"10";"9";"1";"0";"457173";"373885"
"V4mis1";"SILVA (only NR);Bacteria;Proteobacteria;Alphaproteobacteria;Rhizobiales;Rhizobiaceae;Aliihoeflea;";"100.0";"18.2";"10";"10";"10";"0";"0";"457173";"373884"
"V4mis1";"SILVA (only NR);Bacteria;Proteobacteria;Alphaproteobacteria;Rhizobiales;Rhizobiaceae;Allorhizobium-Neorhizobium-Pararhizobium-Rhizobium;";"95.5";"18.3";"1660";"1660";"1585";"75";"0";"455523";"372309"
"V4mis1";"SILVA (only NR);Bacteria;Proteobacteria;Alphaproteobacteria;Rhizobiales;Rhizobiaceae;Aminobacter;";"96.6";"18.2";"89";"89";"86";"3";"0";"457094";"373808"
"V4mis1";"SILVA (only NR);Bacteria;Proteobacteria;Alphaproteobacteria;Rhizobiales;Rhizobiaceae;Aquamicrobium;";"95.5";"18.2";"44";"44";"42";"2";"0";"457139";"373852"
"V4mis1";"SILVA (only NR);Bacteria;Proteobacteria;Alphaproteobacteria;Rhizobiales;Rhizobiaceae;Aurantimonas;";"92.3";"18.2";"13";"13";"12";"1";"0";"457170";"373882"
"V4mis1";"SILVA (only NR);Bacteria;Proteobacteria;Alphaproteobacteria;Rhizobiales;Rhizobiaceae;Aureimonas;";"95.2";"18.2";"62";"62";"59";"3";"0";"457121";"373835"
"V4mis1";"SILVA (only NR);Bacteria;Proteobacteria;Alphaproteobacteria;Rhizobiales;Rhizobiaceae;Bartonella;";"99.3";"18.2";"135";"135";"134";"1";"0";"457048";"373760"
"V4mis1";"SILVA (only NR);Bacteria;Proteobacteria;Alphaproteobacteria;Rhizobiales;Rhizobiaceae;Brucella;";"100.0";"18.2";"383";"383";"383";"0";"0";"456800";"373511"
"V4mis1";"SILVA (only NR);Bacteria;Proteobacteria;Alphaproteobacteria;Rhizobiales;Rhizobiaceae;Candidatus Hodgkinia;";"96.0";"18.2";"173";"173";"166";"7";"0";"457010";"373728"
"V4mis1";"SILVA (only NR);Bacteria;Proteobacteria;Alphaproteobacteria;Rhizobiales;Rhizobiaceae;Candidatus Liberibacter;";"95.2";"18.2";"21";"21";"20";"1";"0";"457162";"373874"
"V4mis1";"SILVA (only NR);Bacteria;Proteobacteria;Alphaproteobacteria;Rhizobiales;Rhizobiaceae;Candidatus Tokpelaia;";"100.0";"18.2";"1";"1";"1";"0";"0";"457182";"373893"
"V4mis1";"SILVA (only NR);Bacteria;Proteobacteria;Alphaproteobacteria;Rhizobiales;Rhizobiaceae;Chelativorans;";"90.0";"18.2";"20";"20";"18";"2";"0";"457163";"373876"
"V4mis1";"SILVA (only NR);Bacteria;Proteobacteria;Alphaproteobacteria;Rhizobiales;Rhizobiaceae;Ciceribacter;";"100.0";"18.2";"14";"14";"14";"0";"0";"457169";"373880"
"V4mis1";"SILVA (only NR);Bacteria;Proteobacteria;Alphaproteobacteria;Rhizobiales;Rhizobiaceae;Cohaesibacter;";"89.8";"18.2";"49";"49";"44";"5";"0";"457134";"373850"
"V4mis1";"SILVA (only NR);Bacteria;Proteobacteria;Alphaproteobacteria;Rhizobiales;Rhizobiaceae;Corticibacterium;";"100.0";"18.2";"3";"3";"3";"0";"0";"457180";"373891"
"V4mis1";"SILVA (only NR);Bacteria;Proteobacteria;Alphaproteobacteria;Rhizobiales;Rhizobiaceae;Daeguia;";"100.0";"18.2";"1";"1";"1";"0";"0";"457182";"373893"
"V4mis1";"SILVA (only NR);Bacteria;Proteobacteria;Alphaproteobacteria;Rhizobiales;Rhizobiaceae;Ensifer;";"95.1";"18.2";"409";"409";"389";"20";"0";"456774";"373505"
"V4mis1";"SILVA (only NR);Bacteria;Proteobacteria;Alphaproteobacteria;Rhizobiales;Rhizobiaceae;Falsochrobactrum;";"82.6";"18.2";"23";"23";"19";"4";"0";"457160";"373875"
"V4mis1";"SILVA (only NR);Bacteria;Proteobacteria;Alphaproteobacteria;Rhizobiales;Rhizobiaceae;Fulvimarina;";"100.0";"18.2";"8";"8";"8";"0";"0";"457175";"373886"
"V4mis1";"SILVA (only NR);Bacteria;Proteobacteria;Alphaproteobacteria;Rhizobiales;Rhizobiaceae;Hoeflea;";"96.3";"18.2";"27";"27";"26";"1";"0";"457156";"373868"
"V4mis1";"SILVA (only NR);Bacteria;Proteobacteria;Alphaproteobacteria;Rhizobiales;Rhizobiaceae;Jiella;";"100.0";"18.2";"4";"4";"4";"0";"0";"457179";"373890"
"V4mis1";"SILVA (only NR);Bacteria;Proteobacteria;Alphaproteobacteria;Rhizobiales;Rhizobiaceae;Lentilitoribacter;";"100.0";"18.2";"8";"8";"8";"0";"0";"457175";"373886"
"V4mis1";"SILVA (only NR);Bacteria;Proteobacteria;Alphaproteobacteria;Rhizobiales;Rhizobiaceae;Martelella;";"96.6";"18.2";"29";"29";"28";"1";"0";"457154";"373866"
"V4mis1";"SILVA (only NR);Bacteria;Proteobacteria;Alphaproteobacteria;Rhizobiales;Rhizobiaceae;Mesorhizobium;";"95.4";"18.2";"548";"548";"523";"25";"0";"456635";"373371"
"V4mis1";"SILVA (only NR);Bacteria;Proteobacteria;Alphaproteobacteria;Rhizobiales;Rhizobiaceae;Mycoplana;";"100.0";"18.2";"8";"8";"8";"0";"0";"457175";"373886"
"V4mis1";"SILVA (only NR);Bacteria;Proteobacteria;Alphaproteobacteria;Rhizobiales;Rhizobiaceae;Neorhizobium;";"94.7";"18.2";"19";"19";"18";"1";"0";"457164";"373876"
"V4mis1";"SILVA (only NR);Bacteria;Proteobacteria;Alphaproteobacteria;Rhizobiales;Rhizobiaceae;Nitratireductor;";"84.6";"18.2";"104";"104";"88";"16";"0";"457079";"373806"
"V4mis1";"SILVA (only NR);Bacteria;Proteobacteria;Alphaproteobacteria;Rhizobiales;Rhizobiaceae;Ochrobactrum;";"93.2";"18.2";"308";"308";"287";"21";"0";"456875";"373607"
"V4mis1";"SILVA (only NR);Bacteria;Proteobacteria;Alphaproteobacteria;Rhizobiales;Rhizobiaceae;Oricola;";"100.0";"18.2";"4";"4";"4";"0";"0";"457179";"373890"
"V4mis1";"SILVA (only NR);Bacteria;Proteobacteria;Alphaproteobacteria;Rhizobiales;Rhizobiaceae;Paenochrobactrum;";"100.0";"18.2";"14";"14";"14";"0";"0";"457169";"373880"
"V4mis1";"SILVA (only NR);Bacteria;Proteobacteria;Alphaproteobacteria;Rhizobiales;Rhizobiaceae;Paramesorhizobium;";"100.0";"18.2";"5";"5";"5";"0";"0";"457178";"373889"
"V4mis1";"SILVA (only NR);Bacteria;Proteobacteria;Alphaproteobacteria;Rhizobiales;Rhizobiaceae;Phyllobacterium;";"98.1";"18.2";"106";"106";"104";"2";"0";"457077";"373790"
"V4mis1";"SILVA (only NR);Bacteria;Proteobacteria;Alphaproteobacteria;Rhizobiales;Rhizobiaceae;Pseudahrensia;";"96.0";"18.2";"50";"50";"48";"2";"0";"457133";"373846"
"V4mis1";"SILVA (only NR);Bacteria;Proteobacteria;Alphaproteobacteria;Rhizobiales;Rhizobiaceae;Pseudaminobacter;";"92.2";"18.2";"51";"51";"47";"4";"0";"457132";"373847"
"V4mis1";"SILVA (only NR);Bacteria;Proteobacteria;Alphaproteobacteria;Rhizobiales;Rhizobiaceae;Pseudochrobactrum;";"90.0";"18.2";"40";"40";"36";"4";"0";"457143";"373858"
"V4mis1";"SILVA (only NR);Bacteria;Proteobacteria;Alphaproteobacteria;Rhizobiales;Rhizobiaceae;Pseudohoeflea;";"100.0";"18.2";"3";"3";"3";"0";"0";"457180";"373891"
"V4mis1";"SILVA (only NR);Bacteria;Proteobacteria;Alphaproteobacteria;Rhizobiales;Rhizobiaceae;Pseudorhizobium;";"100.0";"18.2";"5";"5";"5";"0";"0";"457178";"373889"
"V4mis1";"SILVA (only NR);Bacteria;Proteobacteria;Alphaproteobacteria;Rhizobiales;Rhizobiaceae;Roseitalea;";"100.0";"18.2";"10";"10";"10";"0";"0";"457173";"373884"
"V4mis1";"SILVA (only NR);Bacteria;Proteobacteria;Alphaproteobacteria;Rhizobiales;Rhizobiaceae;Shinella;";"95.2";"18.2";"63";"63";"60";"3";"0";"457120";"373834"
"V4mis1";"SILVA (only NR);Bacteria;Proteobacteria;Alphaproteobacteria;Rhizobiales;Rhizobiaceae;Tianweitania;";"100.0";"18.2";"6";"6";"6";"0";"0";"457177";"373888"
"V4mis1";"SILVA (only NR);Bacteria;Proteobacteria;Alphaproteobacteria;Rhizobiales;Rhizobiaceae;[Rhizobium] sphaerophysae group;";"100.0";"18.2";"5";"5";"5";"0";"0";"457178";"373889"
"V4mis1";"SILVA (only NR);Bacteria;Proteobacteria;Alphaproteobacteria;Rhizobiales;Rhizobiaceae;uncultured;";"93.4";"18.2";"152";"152";"142";"10";"0";"457031";"373752"
"V4mis1";"SILVA (only NR);Bacteria;Proteobacteria;Alphaproteobacteria;Rhizobiales;Rhizobiales Incertae Sedis;";"94.7";"18.2";"433";"433";"410";"23";"0";"456750";"373484"
"V4mis1";"SILVA (only NR);Bacteria;Proteobacteria;Alphaproteobacteria;Rhizobiales;Rhizobiales Incertae Sedis;Alsobacter;";"100.0";"18.2";"5";"5";"5";"0";"0";"457178";"373889"
"V4mis1";"SILVA (only NR);Bacteria;Proteobacteria;Alphaproteobacteria;Rhizobiales;Rhizobiales Incertae Sedis;Anderseniella;";"95.5";"18.2";"22";"22";"21";"1";"0";"457161";"373873"
"V4mis1";"SILVA (only NR);Bacteria;Proteobacteria;Alphaproteobacteria;Rhizobiales;Rhizobiales Incertae Sedis;Bauldia;";"98.1";"18.2";"103";"103";"101";"2";"0";"457080";"373793"
"V4mis1";"SILVA (only NR);Bacteria;Proteobacteria;Alphaproteobacteria;Rhizobiales;Rhizobiales Incertae Sedis;Dichotomicrobium;";"80.7";"18.2";"57";"57";"46";"11";"0";"457126";"373848"
"V4mis1";"SILVA (only NR);Bacteria;Proteobacteria;Alphaproteobacteria;Rhizobiales;Rhizobiales Incertae Sedis;Nordella;";"94.6";"18.2";"56";"56";"53";"3";"0";"457127";"373841"
"V4mis1";"SILVA (only NR);Bacteria;Proteobacteria;Alphaproteobacteria;Rhizobiales;Rhizobiales Incertae Sedis;Phreatobacter;";"95.9";"18.2";"49";"49";"47";"2";"0";"457134";"373847"
"V4mis1";"SILVA (only NR);Bacteria;Proteobacteria;Alphaproteobacteria;Rhizobiales;Rhizobiales Incertae Sedis;uncultured;";"97.1";"18.2";"140";"140";"136";"4";"0";"457043";"373758"
"V4mis1";"SILVA (only NR);Bacteria;Proteobacteria;Alphaproteobacteria;Rhizobiales;Rhodobiaceae;";"81.8";"18.2";"33";"33";"27";"6";"0";"457150";"373867"
"V4mis1";"SILVA (only NR);Bacteria;Proteobacteria;Alphaproteobacteria;Rhizobiales;Rhodobiaceae;Afifella;";"81.3";"18.2";"16";"16";"13";"3";"0";"457167";"373881"
"V4mis1";"SILVA (only NR);Bacteria;Proteobacteria;Alphaproteobacteria;Rhizobiales;Rhodobiaceae;Amorphus;";"100.0";"18.2";"6";"6";"6";"0";"0";"457177";"373888"
"V4mis1";"SILVA (only NR);Bacteria;Proteobacteria;Alphaproteobacteria;Rhizobiales;Rhodobiaceae;Tepidamorphus;";"72.7";"18.2";"11";"11";"8";"3";"0";"457172";"373886"
"V4mis1";"SILVA (only NR);Bacteria;Proteobacteria;Alphaproteobacteria;Rhizobiales;Rhodomicrobiaceae;";"95.3";"18.2";"64";"64";"61";"3";"0";"457119";"373833"
"V4mis1";"SILVA (only NR);Bacteria;Proteobacteria;Alphaproteobacteria;Rhizobiales;Rhodomicrobiaceae;Rhodomicrobium;";"95.3";"18.2";"64";"64";"61";"3";"0";"457119";"373833"
"V4mis1";"SILVA (only NR);Bacteria;Proteobacteria;Alphaproteobacteria;Rhizobiales;Stappiaceae;";"92.7";"18.2";"219";"219";"203";"16";"0";"456964";"373691"
"V4mis1";"SILVA (only NR);Bacteria;Proteobacteria;Alphaproteobacteria;Rhizobiales;Stappiaceae;Agaricicola;";"100.0";"18.2";"3";"3";"3";"0";"0";"457180";"373891"
"V4mis1";"SILVA (only NR);Bacteria;Proteobacteria;Alphaproteobacteria;Rhizobiales;Stappiaceae;Breoghania;";"100.0";"18.2";"6";"6";"6";"0";"0";"457177";"373888"
"V4mis1";"SILVA (only NR);Bacteria;Proteobacteria;Alphaproteobacteria;Rhizobiales;Stappiaceae;Labrenzia;";"92.6";"18.2";"81";"81";"75";"6";"0";"457102";"373819"
"V4mis1";"SILVA (only NR);Bacteria;Proteobacteria;Alphaproteobacteria;Rhizobiales;Stappiaceae;Nesiotobacter;";"100.0";"18.2";"2";"2";"2";"0";"0";"457181";"373892"
"V4mis1";"SILVA (only NR);Bacteria;Proteobacteria;Alphaproteobacteria;Rhizobiales;Stappiaceae;Pannonibacter;";"93.5";"18.2";"31";"31";"29";"2";"0";"457152";"373865"
"V4mis1";"SILVA (only NR);Bacteria;Proteobacteria;Alphaproteobacteria;Rhizobiales;Stappiaceae;Polymorphum;";"100.0";"18.2";"1";"1";"1";"0";"0";"457182";"373893"
"V4mis1";"SILVA (only NR);Bacteria;Proteobacteria;Alphaproteobacteria;Rhizobiales;Stappiaceae;Pseudovibrio;";"88.7";"18.2";"62";"62";"55";"7";"0";"457121";"373839"
"V4mis1";"SILVA (only NR);Bacteria;Proteobacteria;Alphaproteobacteria;Rhizobiales;Stappiaceae;Rhodothalassium;";"100.0";"18.2";"6";"6";"6";"0";"0";"457177";"373888"
"V4mis1";"SILVA (only NR);Bacteria;Proteobacteria;Alphaproteobacteria;Rhizobiales;Stappiaceae;Roseibium;";"83.3";"18.2";"6";"6";"5";"1";"0";"457177";"373889"
"V4mis1";"SILVA (only NR);Bacteria;Proteobacteria;Alphaproteobacteria;Rhizobiales;Stappiaceae;Stappia;";"100.0";"18.2";"17";"17";"17";"0";"0";"457166";"373877"
"V4mis1";"SILVA (only NR);Bacteria;Proteobacteria;Alphaproteobacteria;Rhizobiales;Thermopetrobacteraceae;";"90.0";"18.2";"10";"10";"9";"1";"0";"457173";"373885"
"V4mis1";"SILVA (only NR);Bacteria;Proteobacteria;Alphaproteobacteria;Rhizobiales;Thermopetrobacteraceae;Thermopetrobacter;";"90.0";"18.2";"10";"10";"9";"1";"0";"457173";"373885"
"V4mis1";"SILVA (only NR);Bacteria;Proteobacteria;Alphaproteobacteria;Rhizobiales;WC3-116;";"100.0";"18.2";"2";"2";"2";"0";"0";"457181";"373892"
"V4mis1";"SILVA (only NR);Bacteria;Proteobacteria;Alphaproteobacteria;Rhizobiales;Xanthobacteraceae;";"94.8";"18.3";"2003";"2003";"1899";"104";"0";"455180";"371995"
"V4mis1";"SILVA (only NR);Bacteria;Proteobacteria;Alphaproteobacteria;Rhizobiales;Xanthobacteraceae;Afipia;";"93.9";"18.2";"82";"82";"77";"5";"0";"457101";"373817"
"V4mis1";"SILVA (only NR);Bacteria;Proteobacteria;Alphaproteobacteria;Rhizobiales;Xanthobacteraceae;Ancylobacter;";"100.0";"18.2";"31";"31";"31";"0";"0";"457152";"373863"
"V4mis1";"SILVA (only NR);Bacteria;Proteobacteria;Alphaproteobacteria;Rhizobiales;Xanthobacteraceae;Angulomicrobium;";"100.0";"18.2";"2";"2";"2";"0";"0";"457181";"373892"
"V4mis1";"SILVA (only NR);Bacteria;Proteobacteria;Alphaproteobacteria;Rhizobiales;Xanthobacteraceae;Aquabacter;";"100.0";"18.2";"1";"1";"1";"0";"0";"457182";"373893"
"V4mis1";"SILVA (only NR);Bacteria;Proteobacteria;Alphaproteobacteria;Rhizobiales;Xanthobacteraceae;Azorhizobium;";"95.0";"18.2";"20";"20";"19";"1";"0";"457163";"373875"
"V4mis1";"SILVA (only NR);Bacteria;Proteobacteria;Alphaproteobacteria;Rhizobiales;Xanthobacteraceae;Blastochloris;";"82.4";"18.2";"17";"17";"14";"3";"0";"457166";"373880"
"V4mis1";"SILVA (only NR);Bacteria;Proteobacteria;Alphaproteobacteria;Rhizobiales;Xanthobacteraceae;Bradyrhizobium;";"93.3";"18.2";"804";"804";"750";"54";"0";"456379";"373144"
"V4mis1";"SILVA (only NR);Bacteria;Proteobacteria;Alphaproteobacteria;Rhizobiales;Xanthobacteraceae;Methylorhabdus;";"100.0";"18.2";"2";"2";"2";"0";"0";"457181";"373892"
"V4mis1";"SILVA (only NR);Bacteria;Proteobacteria;Alphaproteobacteria;Rhizobiales;Xanthobacteraceae;Nitrobacter;";"90.9";"18.2";"22";"22";"20";"2";"0";"457161";"373874"
"V4mis1";"SILVA (only NR);Bacteria;Proteobacteria;Alphaproteobacteria;Rhizobiales;Xanthobacteraceae;Oligotropha;";"100.0";"18.2";"6";"6";"6";"0";"0";"457177";"373888"
"V4mis1";"SILVA (only NR);Bacteria;Proteobacteria;Alphaproteobacteria;Rhizobiales;Xanthobacteraceae;Pseudolabrys;";"95.3";"18.2";"150";"150";"143";"7";"0";"457033";"373751"
"V4mis1";"SILVA (only NR);Bacteria;Proteobacteria;Alphaproteobacteria;Rhizobiales;Xanthobacteraceae;Pseudorhodoplanes;";"94.4";"18.2";"36";"36";"34";"2";"0";"457147";"373860"
"V4mis1";"SILVA (only NR);Bacteria;Proteobacteria;Alphaproteobacteria;Rhizobiales;Xanthobacteraceae;Pseudoxanthobacter;";"83.3";"18.2";"6";"6";"5";"1";"0";"457177";"373889"
"V4mis1";"SILVA (only NR);Bacteria;Proteobacteria;Alphaproteobacteria;Rhizobiales;Xanthobacteraceae;Rhodoplanes;";"96.2";"18.2";"105";"105";"101";"4";"0";"457078";"373793"
"V4mis1";"SILVA (only NR);Bacteria;Proteobacteria;Alphaproteobacteria;Rhizobiales;Xanthobacteraceae;Rhodopseudomonas;";"96.5";"18.2";"114";"114";"110";"4";"0";"457069";"373784"
"V4mis1";"SILVA (only NR);Bacteria;Proteobacteria;Alphaproteobacteria;Rhizobiales;Xanthobacteraceae;Starkeya;";"92.3";"18.2";"13";"13";"12";"1";"0";"457170";"373882"
"V4mis1";"SILVA (only NR);Bacteria;Proteobacteria;Alphaproteobacteria;Rhizobiales;Xanthobacteraceae;Tardiphaga;";"94.1";"18.2";"17";"17";"16";"1";"0";"457166";"373878"
"V4mis1";"SILVA (only NR);Bacteria;Proteobacteria;Alphaproteobacteria;Rhizobiales;Xanthobacteraceae;Variibacter;";"100.0";"18.2";"4";"4";"4";"0";"0";"457179";"373890"
"V4mis1";"SILVA (only NR);Bacteria;Proteobacteria;Alphaproteobacteria;Rhizobiales;Xanthobacteraceae;Xanthobacter;";"97.7";"18.2";"43";"43";"42";"1";"0";"457140";"373852"
"V4mis1";"SILVA (only NR);Bacteria;Proteobacteria;Alphaproteobacteria;Rhizobiales;Xanthobacteraceae;uncultured;";"96.4";"18.2";"503";"503";"485";"18";"0";"456680";"373409"
"V4mis1";"SILVA (only NR);Bacteria;Proteobacteria;Alphaproteobacteria;Rhizobiales;uncultured;";"80.0";"18.2";"110";"110";"88";"22";"0";"457073";"373806"
"V4mis1";"SILVA (only NR);Bacteria;Proteobacteria;Alphaproteobacteria;Rhodobacterales;";"96.2";"18.4";"5419";"5419";"5215";"204";"0";"451764";"368679"
"V4mis1";"SILVA (only NR);Bacteria;Proteobacteria;Alphaproteobacteria;Rhodobacterales;Rhodobacteraceae;";"96.2";"18.4";"5419";"5419";"5215";"204";"0";"451764";"368679"
"V4mis1";"SILVA (only NR);Bacteria;Proteobacteria;Alphaproteobacteria;Rhodobacterales;Rhodobacteraceae;Actibacterium;";"100.0";"18.2";"25";"25";"25";"0";"0";"457158";"373869"
"V4mis1";"SILVA (only NR);Bacteria;Proteobacteria;Alphaproteobacteria;Rhodobacterales;Rhodobacteraceae;Aestuariibius;";"100.0";"18.2";"2";"2";"2";"0";"0";"457181";"373892"
"V4mis1";"SILVA (only NR);Bacteria;Proteobacteria;Alphaproteobacteria;Rhodobacterales;Rhodobacteraceae;Aestuariicoccus;";"100.0";"18.2";"21";"21";"21";"0";"0";"457162";"373873"
"V4mis1";"SILVA (only NR);Bacteria;Proteobacteria;Alphaproteobacteria;Rhodobacterales;Rhodobacteraceae;Aestuariihabitans;";"100.0";"18.2";"2";"2";"2";"0";"0";"457181";"373892"
"V4mis1";"SILVA (only NR);Bacteria;Proteobacteria;Alphaproteobacteria;Rhodobacterales;Rhodobacteraceae;Aestuariivita;";"100.0";"18.2";"1";"1";"1";"0";"0";"457182";"373893"
"V4mis1";"SILVA (only NR);Bacteria;Proteobacteria;Alphaproteobacteria;Rhodobacterales;Rhodobacteraceae;Albidovulum;";"90.5";"18.2";"21";"21";"19";"2";"0";"457162";"373875"
"V4mis1";"SILVA (only NR);Bacteria;Proteobacteria;Alphaproteobacteria;Rhodobacterales;Rhodobacteraceae;Albimonas;";"100.0";"18.2";"12";"12";"12";"0";"0";"457171";"373882"
"V4mis1";"SILVA (only NR);Bacteria;Proteobacteria;Alphaproteobacteria;Rhodobacterales;Rhodobacteraceae;Albirhodobacter;";"100.0";"18.2";"12";"12";"12";"0";"0";"457171";"373882"
"V4mis1";"SILVA (only NR);Bacteria;Proteobacteria;Alphaproteobacteria;Rhodobacterales;Rhodobacteraceae;Aliiroseovarius;";"97.1";"18.2";"34";"34";"33";"1";"0";"457149";"373861"
"V4mis1";"SILVA (only NR);Bacteria;Proteobacteria;Alphaproteobacteria;Rhodobacterales;Rhodobacteraceae;Amaricoccus;";"97.9";"18.2";"47";"47";"46";"1";"0";"457136";"373848"
"V4mis1";"SILVA (only NR);Bacteria;Proteobacteria;Alphaproteobacteria;Rhodobacterales;Rhodobacteraceae;Amylibacter;";"91.9";"18.2";"62";"62";"57";"5";"0";"457121";"373837"
"V4mis1";"SILVA (only NR);Bacteria;Proteobacteria;Alphaproteobacteria;Rhodobacterales;Rhodobacteraceae;Antarctobacter;";"100.0";"18.2";"8";"8";"8";"0";"0";"457175";"373886"
"V4mis1";"SILVA (only NR);Bacteria;Proteobacteria;Alphaproteobacteria;Rhodobacterales;Rhodobacteraceae;Aquimixticola;";"100.0";"18.2";"4";"4";"4";"0";"0";"457179";"373890"
"V4mis1";"SILVA (only NR);Bacteria;Proteobacteria;Alphaproteobacteria;Rhodobacterales;Rhodobacteraceae;Ascidiaceihabitans;";"97.9";"18.2";"48";"48";"47";"1";"0";"457135";"373847"
"V4mis1";"SILVA (only NR);Bacteria;Proteobacteria;Alphaproteobacteria;Rhodobacterales;Rhodobacteraceae;Boseongicola;";"85.7";"18.2";"7";"7";"6";"1";"0";"457176";"373888"
"V4mis1";"SILVA (only NR);Bacteria;Proteobacteria;Alphaproteobacteria;Rhodobacterales;Rhodobacteraceae;Brevirhabdus;";"100.0";"18.2";"4";"4";"4";"0";"0";"457179";"373890"
"V4mis1";"SILVA (only NR);Bacteria;Proteobacteria;Alphaproteobacteria;Rhodobacterales;Rhodobacteraceae;Celeribacter;";"100.0";"18.2";"35";"35";"35";"0";"0";"457148";"373859"
"V4mis1";"SILVA (only NR);Bacteria;Proteobacteria;Alphaproteobacteria;Rhodobacterales;Rhodobacteraceae;Cereibacter;";"100.0";"18.2";"11";"11";"11";"0";"0";"457172";"373883"
"V4mis1";"SILVA (only NR);Bacteria;Proteobacteria;Alphaproteobacteria;Rhodobacterales;Rhodobacteraceae;Citreicella;";"100.0";"18.2";"12";"12";"12";"0";"0";"457171";"373882"
"V4mis1";"SILVA (only NR);Bacteria;Proteobacteria;Alphaproteobacteria;Rhodobacterales;Rhodobacteraceae;Citreimonas;";"100.0";"18.2";"3";"3";"3";"0";"0";"457180";"373891"
"V4mis1";"SILVA (only NR);Bacteria;Proteobacteria;Alphaproteobacteria;Rhodobacterales;Rhodobacteraceae;Cognatishimia;";"100.0";"18.2";"26";"26";"26";"0";"0";"457157";"373868"
"V4mis1";"SILVA (only NR);Bacteria;Proteobacteria;Alphaproteobacteria;Rhodobacterales;Rhodobacteraceae;Cognatiyoonia;";"100.0";"18.2";"8";"8";"8";"0";"0";"457175";"373886"
"V4mis1";"SILVA (only NR);Bacteria;Proteobacteria;Alphaproteobacteria;Rhodobacterales;Rhodobacteraceae;Confluentimicrobium;";"100.0";"18.2";"5";"5";"5";"0";"0";"457178";"373889"
"V4mis1";"SILVA (only NR);Bacteria;Proteobacteria;Alphaproteobacteria;Rhodobacterales;Rhodobacteraceae;Cribrihabitans;";"100.0";"18.2";"9";"9";"9";"0";"0";"457174";"373885"
"V4mis1";"SILVA (only NR);Bacteria;Proteobacteria;Alphaproteobacteria;Rhodobacterales;Rhodobacteraceae;Defluviimonas;";"98.1";"18.2";"54";"54";"53";"1";"0";"457129";"373841"
"V4mis1";"SILVA (only NR);Bacteria;Proteobacteria;Alphaproteobacteria;Rhodobacterales;Rhodobacteraceae;Dinoroseobacter;";"83.3";"18.2";"18";"18";"15";"3";"0";"457165";"373879"
"V4mis1";"SILVA (only NR);Bacteria;Proteobacteria;Alphaproteobacteria;Rhodobacterales;Rhodobacteraceae;Donghicola;";"85.0";"18.2";"20";"20";"17";"3";"0";"457163";"373877"
"V4mis1";"SILVA (only NR);Bacteria;Proteobacteria;Alphaproteobacteria;Rhodobacterales;Rhodobacteraceae;Epibacterium;";"97.8";"18.2";"46";"46";"45";"1";"0";"457137";"373849"
"V4mis1";"SILVA (only NR);Bacteria;Proteobacteria;Alphaproteobacteria;Rhodobacterales;Rhodobacteraceae;Falsirhodobacter;";"96.4";"18.2";"28";"28";"27";"1";"0";"457155";"373867"
"V4mis1";"SILVA (only NR);Bacteria;Proteobacteria;Alphaproteobacteria;Rhodobacterales;Rhodobacteraceae;Flavimaricola;";"100.0";"18.2";"13";"13";"13";"0";"0";"457170";"373881"
"V4mis1";"SILVA (only NR);Bacteria;Proteobacteria;Alphaproteobacteria;Rhodobacterales;Rhodobacteraceae;Frigidibacter;";"100.0";"18.2";"3";"3";"3";"0";"0";"457180";"373891"
"V4mis1";"SILVA (only NR);Bacteria;Proteobacteria;Alphaproteobacteria;Rhodobacterales;Rhodobacteraceae;Gemmobacter;";"96.6";"18.2";"58";"58";"56";"2";"0";"457125";"373838"
"V4mis1";"SILVA (only NR);Bacteria;Proteobacteria;Alphaproteobacteria;Rhodobacterales;Rhodobacteraceae;HIMB11;";"100.0";"18.2";"42";"42";"42";"0";"0";"457141";"373852"
"V4mis1";"SILVA (only NR);Bacteria;Proteobacteria;Alphaproteobacteria;Rhodobacterales;Rhodobacteraceae;Haematobacter;";"81.3";"18.2";"16";"16";"13";"3";"0";"457167";"373881"
"V4mis1";"SILVA (only NR);Bacteria;Proteobacteria;Alphaproteobacteria;Rhodobacterales;Rhodobacteraceae;Halocynthiibacter;";"91.7";"18.2";"12";"12";"11";"1";"0";"457171";"373883"
"V4mis1";"SILVA (only NR);Bacteria;Proteobacteria;Alphaproteobacteria;Rhodobacterales;Rhodobacteraceae;Halodurantibacterium;";"91.3";"18.2";"23";"23";"21";"2";"0";"457160";"373873"
"V4mis1";"SILVA (only NR);Bacteria;Proteobacteria;Alphaproteobacteria;Rhodobacterales;Rhodobacteraceae;Halovulum;";"100.0";"18.2";"12";"12";"12";"0";"0";"457171";"373882"
"V4mis1";"SILVA (only NR);Bacteria;Proteobacteria;Alphaproteobacteria;Rhodobacterales;Rhodobacteraceae;Hasllibacter;";"100.0";"18.2";"2";"2";"2";"0";"0";"457181";"373892"
"V4mis1";"SILVA (only NR);Bacteria;Proteobacteria;Alphaproteobacteria;Rhodobacterales;Rhodobacteraceae;Hwanghaeicola;";"100.0";"18.2";"2";"2";"2";"0";"0";"457181";"373892"
"V4mis1";"SILVA (only NR);Bacteria;Proteobacteria;Alphaproteobacteria;Rhodobacterales;Rhodobacteraceae;Jannaschia;";"100.0";"18.2";"49";"49";"49";"0";"0";"457134";"373845"
"V4mis1";"SILVA (only NR);Bacteria;Proteobacteria;Alphaproteobacteria;Rhodobacterales;Rhodobacteraceae;Jhaorihella;";"91.7";"18.2";"12";"12";"11";"1";"0";"457171";"373883"
"V4mis1";"SILVA (only NR);Bacteria;Proteobacteria;Alphaproteobacteria;Rhodobacterales;Rhodobacteraceae;Ketogulonicigenium;";"100.0";"18.2";"14";"14";"14";"0";"0";"457169";"373880"
"V4mis1";"SILVA (only NR);Bacteria;Proteobacteria;Alphaproteobacteria;Rhodobacterales;Rhodobacteraceae;Lacimonas;";"100.0";"18.2";"8";"8";"8";"0";"0";"457175";"373886"
"V4mis1";"SILVA (only NR);Bacteria;Proteobacteria;Alphaproteobacteria;Rhodobacterales;Rhodobacteraceae;Leisingera;";"96.0";"18.2";"25";"25";"24";"1";"0";"457158";"373870"
"V4mis1";"SILVA (only NR);Bacteria;Proteobacteria;Alphaproteobacteria;Rhodobacterales;Rhodobacteraceae;Lentibacter;";"96.0";"18.2";"25";"25";"24";"1";"0";"457158";"373870"
"V4mis1";"SILVA (only NR);Bacteria;Proteobacteria;Alphaproteobacteria;Rhodobacterales;Rhodobacteraceae;Limibaculum;";"91.5";"18.2";"94";"94";"86";"8";"0";"457089";"373808"
"V4mis1";"SILVA (only NR);Bacteria;Proteobacteria;Alphaproteobacteria;Rhodobacterales;Rhodobacteraceae;Limimaricola;";"100.0";"18.2";"21";"21";"21";"0";"0";"457162";"373873"
"V4mis1";"SILVA (only NR);Bacteria;Proteobacteria;Alphaproteobacteria;Rhodobacterales;Rhodobacteraceae;Litoreibacter;";"100.0";"18.2";"15";"15";"15";"0";"0";"457168";"373879"
"V4mis1";"SILVA (only NR);Bacteria;Proteobacteria;Alphaproteobacteria;Rhodobacterales;Rhodobacteraceae;Litorimicrobium;";"92.9";"18.2";"14";"14";"13";"1";"0";"457169";"373881"
"V4mis1";"SILVA (only NR);Bacteria;Proteobacteria;Alphaproteobacteria;Rhodobacterales;Rhodobacteraceae;Litorisediminicola;";"100.0";"18.2";"1";"1";"1";"0";"0";"457182";"373893"
"V4mis1";"SILVA (only NR);Bacteria;Proteobacteria;Alphaproteobacteria;Rhodobacterales;Rhodobacteraceae;Litorisediminivivens;";"100.0";"18.2";"2";"2";"2";"0";"0";"457181";"373892"
"V4mis1";"SILVA (only NR);Bacteria;Proteobacteria;Alphaproteobacteria;Rhodobacterales;Rhodobacteraceae;Loktanella;";"100.0";"18.2";"7";"7";"7";"0";"0";"457176";"373887"
"V4mis1";"SILVA (only NR);Bacteria;Proteobacteria;Alphaproteobacteria;Rhodobacterales;Rhodobacteraceae;Lutimaribacter;";"92.3";"18.2";"13";"13";"12";"1";"0";"457170";"373882"
"V4mis1";"SILVA (only NR);Bacteria;Proteobacteria;Alphaproteobacteria;Rhodobacterales;Rhodobacteraceae;Maliponia;";"100.0";"18.2";"1";"1";"1";"0";"0";"457182";"373893"
"V4mis1";"SILVA (only NR);Bacteria;Proteobacteria;Alphaproteobacteria;Rhodobacterales;Rhodobacteraceae;Mameliella;";"100.0";"18.2";"17";"17";"17";"0";"0";"457166";"373877"
"V4mis1";"SILVA (only NR);Bacteria;Proteobacteria;Alphaproteobacteria;Rhodobacterales;Rhodobacteraceae;Maribius;";"100.0";"18.2";"8";"8";"8";"0";"0";"457175";"373886"
"V4mis1";"SILVA (only NR);Bacteria;Proteobacteria;Alphaproteobacteria;Rhodobacterales;Rhodobacteraceae;Marinibacterium;";"100.0";"18.2";"18";"18";"18";"0";"0";"457165";"373876"
"V4mis1";"SILVA (only NR);Bacteria;Proteobacteria;Alphaproteobacteria;Rhodobacterales;Rhodobacteraceae;Marinosulfonomonas;";"100.0";"18.2";"1";"1";"1";"0";"0";"457182";"373893"
"V4mis1";"SILVA (only NR);Bacteria;Proteobacteria;Alphaproteobacteria;Rhodobacterales;Rhodobacteraceae;Marinovum;";"100.0";"18.2";"24";"24";"24";"0";"0";"457159";"373870"
"V4mis1";"SILVA (only NR);Bacteria;Proteobacteria;Alphaproteobacteria;Rhodobacterales;Rhodobacteraceae;Maritimibacter;";"94.7";"18.2";"19";"19";"18";"1";"0";"457164";"373876"
"V4mis1";"SILVA (only NR);Bacteria;Proteobacteria;Alphaproteobacteria;Rhodobacterales;Rhodobacteraceae;Marivita;";"94.9";"18.2";"39";"39";"37";"2";"0";"457144";"373857"
"V4mis1";"SILVA (only NR);Bacteria;Proteobacteria;Alphaproteobacteria;Rhodobacterales;Rhodobacteraceae;Marivivens;";"84.6";"18.2";"13";"13";"11";"2";"0";"457170";"373883"
"V4mis1";"SILVA (only NR);Bacteria;Proteobacteria;Alphaproteobacteria;Rhodobacterales;Rhodobacteraceae;Methylarcula;";"100.0";"18.2";"2";"2";"2";"0";"0";"457181";"373892"
"V4mis1";"SILVA (only NR);Bacteria;Proteobacteria;Alphaproteobacteria;Rhodobacterales;Rhodobacteraceae;Natronohydrobacter;";"100.0";"18.2";"2";"2";"2";"0";"0";"457181";"373892"
"V4mis1";"SILVA (only NR);Bacteria;Proteobacteria;Alphaproteobacteria;Rhodobacterales;Rhodobacteraceae;Nautella;";"96.4";"18.2";"28";"28";"27";"1";"0";"457155";"373867"
"V4mis1";"SILVA (only NR);Bacteria;Proteobacteria;Alphaproteobacteria;Rhodobacterales;Rhodobacteraceae;Nereida;";"100.0";"18.2";"8";"8";"8";"0";"0";"457175";"373886"
"V4mis1";"SILVA (only NR);Bacteria;Proteobacteria;Alphaproteobacteria;Rhodobacterales;Rhodobacteraceae;Nioella;";"100.0";"18.2";"21";"21";"21";"0";"0";"457162";"373873"
"V4mis1";"SILVA (only NR);Bacteria;Proteobacteria;Alphaproteobacteria;Rhodobacterales;Rhodobacteraceae;Oceanibulbus;";"80.0";"18.2";"5";"5";"4";"1";"0";"457178";"373890"
"V4mis1";"SILVA (only NR);Bacteria;Proteobacteria;Alphaproteobacteria;Rhodobacterales;Rhodobacteraceae;Oceanicella;";"90.9";"18.2";"11";"11";"10";"1";"0";"457172";"373884"
"V4mis1";"SILVA (only NR);Bacteria;Proteobacteria;Alphaproteobacteria;Rhodobacterales;Rhodobacteraceae;Oceanicola;";"100.0";"18.2";"10";"10";"10";"0";"0";"457173";"373884"
"V4mis1";"SILVA (only NR);Bacteria;Proteobacteria;Alphaproteobacteria;Rhodobacterales;Rhodobacteraceae;Oceaniovalibus;";"100.0";"18.2";"4";"4";"4";"0";"0";"457179";"373890"
"V4mis1";"SILVA (only NR);Bacteria;Proteobacteria;Alphaproteobacteria;Rhodobacterales;Rhodobacteraceae;Oceanobacterium;";"100.0";"18.2";"5";"5";"5";"0";"0";"457178";"373889"
"V4mis1";"SILVA (only NR);Bacteria;Proteobacteria;Alphaproteobacteria;Rhodobacterales;Rhodobacteraceae;Octadecabacter;";"100.0";"18.2";"42";"42";"42";"0";"0";"457141";"373852"
"V4mis1";"SILVA (only NR);Bacteria;Proteobacteria;Alphaproteobacteria;Rhodobacterales;Rhodobacteraceae;Pacificibacter;";"100.0";"18.2";"4";"4";"4";"0";"0";"457179";"373890"
"V4mis1";"SILVA (only NR);Bacteria;Proteobacteria;Alphaproteobacteria;Rhodobacterales;Rhodobacteraceae;Paenirhodobacter;";"88.9";"18.2";"9";"9";"8";"1";"0";"457174";"373886"
"V4mis1";"SILVA (only NR);Bacteria;Proteobacteria;Alphaproteobacteria;Rhodobacterales;Rhodobacteraceae;Palleronia-Pseudomaribius;";"100.0";"18.2";"11";"11";"11";"0";"0";"457172";"373883"
"V4mis1";"SILVA (only NR);Bacteria;Proteobacteria;Alphaproteobacteria;Rhodobacterales;Rhodobacteraceae;Paracoccus;";"94.8";"18.2";"542";"542";"514";"28";"0";"456641";"373380"
"V4mis1";"SILVA (only NR);Bacteria;Proteobacteria;Alphaproteobacteria;Rhodobacterales;Rhodobacteraceae;Pelagibaca;";"88.9";"18.2";"9";"9";"8";"1";"0";"457174";"373886"
"V4mis1";"SILVA (only NR);Bacteria;Proteobacteria;Alphaproteobacteria;Rhodobacterales;Rhodobacteraceae;Pelagicola;";"85.7";"18.2";"7";"7";"6";"1";"0";"457176";"373888"
"V4mis1";"SILVA (only NR);Bacteria;Proteobacteria;Alphaproteobacteria;Rhodobacterales;Rhodobacteraceae;Pelagimonas;";"100.0";"18.2";"6";"6";"6";"0";"0";"457177";"373888"
"V4mis1";"SILVA (only NR);Bacteria;Proteobacteria;Alphaproteobacteria;Rhodobacterales;Rhodobacteraceae;Phaeobacter;";"100.0";"18.2";"45";"45";"45";"0";"0";"457138";"373849"
"V4mis1";"SILVA (only NR);Bacteria;Proteobacteria;Alphaproteobacteria;Rhodobacterales;Rhodobacteraceae;Planktomarina;";"94.5";"18.2";"110";"110";"104";"6";"0";"457073";"373790"
"V4mis1";"SILVA (only NR);Bacteria;Proteobacteria;Alphaproteobacteria;Rhodobacterales;Rhodobacteraceae;Planktotalea;";"96.0";"18.2";"25";"25";"24";"1";"0";"457158";"373870"
"V4mis1";"SILVA (only NR);Bacteria;Proteobacteria;Alphaproteobacteria;Rhodobacterales;Rhodobacteraceae;Plastorhodobacter;";"100.0";"18.2";"4";"4";"4";"0";"0";"457179";"373890"
"V4mis1";"SILVA (only NR);Bacteria;Proteobacteria;Alphaproteobacteria;Rhodobacterales;Rhodobacteraceae;Pontibaca;";"100.0";"18.2";"4";"4";"4";"0";"0";"457179";"373890"
"V4mis1";"SILVA (only NR);Bacteria;Proteobacteria;Alphaproteobacteria;Rhodobacterales;Rhodobacteraceae;Ponticoccus;";"95.7";"18.2";"23";"23";"22";"1";"0";"457160";"373872"
"V4mis1";"SILVA (only NR);Bacteria;Proteobacteria;Alphaproteobacteria;Rhodobacterales;Rhodobacteraceae;Pontivivens;";"100.0";"18.2";"13";"13";"13";"0";"0";"457170";"373881"
"V4mis1";"SILVA (only NR);Bacteria;Proteobacteria;Alphaproteobacteria;Rhodobacterales;Rhodobacteraceae;Poseidonocella;";"100.0";"18.2";"2";"2";"2";"0";"0";"457181";"373892"
"V4mis1";"SILVA (only NR);Bacteria;Proteobacteria;Alphaproteobacteria;Rhodobacterales;Rhodobacteraceae;Primorskyibacter;";"100.0";"18.2";"5";"5";"5";"0";"0";"457178";"373889"
"V4mis1";"SILVA (only NR);Bacteria;Proteobacteria;Alphaproteobacteria;Rhodobacterales;Rhodobacteraceae;Profundibacterium;";"100.0";"18.2";"3";"3";"3";"0";"0";"457180";"373891"
"V4mis1";"SILVA (only NR);Bacteria;Proteobacteria;Alphaproteobacteria;Rhodobacterales;Rhodobacteraceae;Pseudaestuariivita;";"100.0";"18.2";"2";"2";"2";"0";"0";"457181";"373892"
"V4mis1";"SILVA (only NR);Bacteria;Proteobacteria;Alphaproteobacteria;Rhodobacterales;Rhodobacteraceae;Pseudodonghicola;";"100.0";"18.2";"2";"2";"2";"0";"0";"457181";"373892"
"V4mis1";"SILVA (only NR);Bacteria;Proteobacteria;Alphaproteobacteria;Rhodobacterales;Rhodobacteraceae;Pseudohalocynthiibacter;";"100.0";"18.2";"1";"1";"1";"0";"0";"457182";"373893"
"V4mis1";"SILVA (only NR);Bacteria;Proteobacteria;Alphaproteobacteria;Rhodobacterales;Rhodobacteraceae;Pseudooceanicola;";"97.4";"18.2";"38";"38";"37";"1";"0";"457145";"373857"
"V4mis1";"SILVA (only NR);Bacteria;Proteobacteria;Alphaproteobacteria;Rhodobacterales;Rhodobacteraceae;Pseudooctadecabacter;";"100.0";"18.2";"2";"2";"2";"0";"0";"457181";"373892"
"V4mis1";"SILVA (only NR);Bacteria;Proteobacteria;Alphaproteobacteria;Rhodobacterales;Rhodobacteraceae;Pseudopelagicola;";"100.0";"18.2";"1";"1";"1";"0";"0";"457182";"373893"
"V4mis1";"SILVA (only NR);Bacteria;Proteobacteria;Alphaproteobacteria;Rhodobacterales;Rhodobacteraceae;Pseudophaeobacter;";"97.1";"18.2";"34";"34";"33";"1";"0";"457149";"373861"
"V4mis1";"SILVA (only NR);Bacteria;Proteobacteria;Alphaproteobacteria;Rhodobacterales;Rhodobacteraceae;Pseudorhodobacter;";"98.6";"18.2";"74";"74";"73";"1";"0";"457109";"373821"
"V4mis1";"SILVA (only NR);Bacteria;Proteobacteria;Alphaproteobacteria;Rhodobacterales;Rhodobacteraceae;Pseudoroseicyclus;";"100.0";"18.2";"2";"2";"2";"0";"0";"457181";"373892"
"V4mis1";"SILVA (only NR);Bacteria;Proteobacteria;Alphaproteobacteria;Rhodobacterales;Rhodobacteraceae;Pseudoruegeria;";"100.0";"18.2";"24";"24";"24";"0";"0";"457159";"373870"
"V4mis1";"SILVA (only NR);Bacteria;Proteobacteria;Alphaproteobacteria;Rhodobacterales;Rhodobacteraceae;Puniceibacterium;";"100.0";"18.2";"6";"6";"6";"0";"0";"457177";"373888"
"V4mis1";"SILVA (only NR);Bacteria;Proteobacteria;Alphaproteobacteria;Rhodobacterales;Rhodobacteraceae;Rhodobaca;";"100.0";"18.2";"5";"5";"5";"0";"0";"457178";"373889"
"V4mis1";"SILVA (only NR);Bacteria;Proteobacteria;Alphaproteobacteria;Rhodobacterales;Rhodobacteraceae;Rhodobacter;";"97.7";"18.2";"256";"256";"250";"6";"0";"456927";"373644"
"V4mis1";"SILVA (only NR);Bacteria;Proteobacteria;Alphaproteobacteria;Rhodobacterales;Rhodobacteraceae;Rhodobaculum;";"97.5";"18.2";"40";"40";"39";"1";"0";"457143";"373855"
"V4mis1";"SILVA (only NR);Bacteria;Proteobacteria;Alphaproteobacteria;Rhodobacterales;Rhodobacteraceae;Rhodovulum;";"100.0";"18.2";"60";"60";"60";"0";"0";"457123";"373834"
"V4mis1";"SILVA (only NR);Bacteria;Proteobacteria;Alphaproteobacteria;Rhodobacterales;Rhodobacteraceae;Roseibaca;";"100.0";"18.2";"13";"13";"13";"0";"0";"457170";"373881"
"V4mis1";"SILVA (only NR);Bacteria;Proteobacteria;Alphaproteobacteria;Rhodobacterales;Rhodobacteraceae;Roseibacterium;";"94.1";"18.2";"34";"34";"32";"2";"0";"457149";"373862"
"V4mis1";"SILVA (only NR);Bacteria;Proteobacteria;Alphaproteobacteria;Rhodobacterales;Rhodobacteraceae;Roseicitreum;";"100.0";"18.2";"1";"1";"1";"0";"0";"457182";"373893"
"V4mis1";"SILVA (only NR);Bacteria;Proteobacteria;Alphaproteobacteria;Rhodobacterales;Rhodobacteraceae;Roseicyclus;";"100.0";"18.2";"12";"12";"12";"0";"0";"457171";"373882"
"V4mis1";"SILVA (only NR);Bacteria;Proteobacteria;Alphaproteobacteria;Rhodobacterales;Rhodobacteraceae;Roseinatronobacter;";"90.0";"18.2";"10";"10";"9";"1";"0";"457173";"373885"
"V4mis1";"SILVA (only NR);Bacteria;Proteobacteria;Alphaproteobacteria;Rhodobacterales;Rhodobacteraceae;Roseisalinus;";"100.0";"18.2";"3";"3";"3";"0";"0";"457180";"373891"
"V4mis1";"SILVA (only NR);Bacteria;Proteobacteria;Alphaproteobacteria;Rhodobacterales;Rhodobacteraceae;Roseivivax;";"91.2";"18.2";"114";"114";"104";"10";"0";"457069";"373790"
"V4mis1";"SILVA (only NR);Bacteria;Proteobacteria;Alphaproteobacteria;Rhodobacterales;Rhodobacteraceae;Roseobacter clade CHAB-I-5 lineage;";"96.3";"18.2";"27";"27";"26";"1";"0";"457156";"373868"
"V4mis1";"SILVA (only NR);Bacteria;Proteobacteria;Alphaproteobacteria;Rhodobacterales;Rhodobacteraceae;Roseobacter clade Marinomonas lineage;";"100.0";"18.2";"3";"3";"3";"0";"0";"457180";"373891"
"V4mis1";"SILVA (only NR);Bacteria;Proteobacteria;Alphaproteobacteria;Rhodobacterales;Rhodobacteraceae;Roseobacter clade NAC11-7 lineage;";"97.8";"18.2";"91";"91";"89";"2";"0";"457092";"373805"
"V4mis1";"SILVA (only NR);Bacteria;Proteobacteria;Alphaproteobacteria;Rhodobacterales;Rhodobacteraceae;Roseobacter;";"93.2";"18.2";"44";"44";"41";"3";"0";"457139";"373853"
"V4mis1";"SILVA (only NR);Bacteria;Proteobacteria;Alphaproteobacteria;Rhodobacterales;Rhodobacteraceae;Roseovarius;";"95.5";"18.2";"221";"221";"211";"10";"0";"456962";"373683"
"V4mis1";"SILVA (only NR);Bacteria;Proteobacteria;Alphaproteobacteria;Rhodobacterales;Rhodobacteraceae;Rubellimicrobium;";"97.9";"18.2";"94";"94";"92";"2";"0";"457089";"373802"
"V4mis1";"SILVA (only NR);Bacteria;Proteobacteria;Alphaproteobacteria;Rhodobacterales;Rhodobacteraceae;Rubribacterium;";"100.0";"18.2";"19";"19";"19";"0";"0";"457164";"373875"
"V4mis1";"SILVA (only NR);Bacteria;Proteobacteria;Alphaproteobacteria;Rhodobacterales;Rhodobacteraceae;Rubrimonas;";"100.0";"18.2";"10";"10";"10";"0";"0";"457173";"373884"
"V4mis1";"SILVA (only NR);Bacteria;Proteobacteria;Alphaproteobacteria;Rhodobacterales;Rhodobacteraceae;Ruegeria;";"95.2";"18.2";"145";"145";"138";"7";"0";"457038";"373756"
"V4mis1";"SILVA (only NR);Bacteria;Proteobacteria;Alphaproteobacteria;Rhodobacterales;Rhodobacteraceae;Sagittula;";"100.0";"18.2";"18";"18";"18";"0";"0";"457165";"373876"
"V4mis1";"SILVA (only NR);Bacteria;Proteobacteria;Alphaproteobacteria;Rhodobacterales;Rhodobacteraceae;Salinihabitans;";"100.0";"18.2";"3";"3";"3";"0";"0";"457180";"373891"
"V4mis1";"SILVA (only NR);Bacteria;Proteobacteria;Alphaproteobacteria;Rhodobacterales;Rhodobacteraceae;Salipiger;";"100.0";"18.2";"3";"3";"3";"0";"0";"457180";"373891"
"V4mis1";"SILVA (only NR);Bacteria;Proteobacteria;Alphaproteobacteria;Rhodobacterales;Rhodobacteraceae;Sedimentitalea;";"97.8";"18.2";"45";"45";"44";"1";"0";"457138";"373850"
"V4mis1";"SILVA (only NR);Bacteria;Proteobacteria;Alphaproteobacteria;Rhodobacterales;Rhodobacteraceae;Sediminimonas;";"90.0";"18.2";"20";"20";"18";"2";"0";"457163";"373876"
"V4mis1";"SILVA (only NR);Bacteria;Proteobacteria;Alphaproteobacteria;Rhodobacterales;Rhodobacteraceae;Seohaeicola;";"83.3";"18.2";"6";"6";"5";"1";"0";"457177";"373889"
"V4mis1";"SILVA (only NR);Bacteria;Proteobacteria;Alphaproteobacteria;Rhodobacterales;Rhodobacteraceae;Shimia;";"95.5";"18.2";"22";"22";"21";"1";"0";"457161";"373873"
"V4mis1";"SILVA (only NR);Bacteria;Proteobacteria;Alphaproteobacteria;Rhodobacterales;Rhodobacteraceae;Silicimonas;";"88.9";"18.2";"27";"27";"24";"3";"0";"457156";"373870"
"V4mis1";"SILVA (only NR);Bacteria;Proteobacteria;Alphaproteobacteria;Rhodobacterales;Rhodobacteraceae;Sulfitobacter;";"93.8";"18.2";"273";"273";"256";"17";"0";"456910";"373638"
"V4mis1";"SILVA (only NR);Bacteria;Proteobacteria;Alphaproteobacteria;Rhodobacterales;Rhodobacteraceae;Tabrizicola;";"100.0";"18.2";"53";"53";"53";"0";"0";"457130";"373841"
"V4mis1";"SILVA (only NR);Bacteria;Proteobacteria;Alphaproteobacteria;Rhodobacterales;Rhodobacteraceae;Tateyamaria;";"100.0";"18.2";"39";"39";"39";"0";"0";"457144";"373855"
"V4mis1";"SILVA (only NR);Bacteria;Proteobacteria;Alphaproteobacteria;Rhodobacterales;Rhodobacteraceae;Thalassobius;";"97.2";"18.2";"36";"36";"35";"1";"0";"457147";"373859"
"V4mis1";"SILVA (only NR);Bacteria;Proteobacteria;Alphaproteobacteria;Rhodobacterales;Rhodobacteraceae;Thalassococcus;";"100.0";"18.2";"8";"8";"8";"0";"0";"457175";"373886"
"V4mis1";"SILVA (only NR);Bacteria;Proteobacteria;Alphaproteobacteria;Rhodobacterales;Rhodobacteraceae;Thiobacimonas;";"100.0";"18.2";"3";"3";"3";"0";"0";"457180";"373891"
"V4mis1";"SILVA (only NR);Bacteria;Proteobacteria;Alphaproteobacteria;Rhodobacterales;Rhodobacteraceae;Thioclava;";"100.0";"18.2";"20";"20";"20";"0";"0";"457163";"373874"
"V4mis1";"SILVA (only NR);Bacteria;Proteobacteria;Alphaproteobacteria;Rhodobacterales;Rhodobacteraceae;Tranquillimonas;";"100.0";"18.2";"2";"2";"2";"0";"0";"457181";"373892"
"V4mis1";"SILVA (only NR);Bacteria;Proteobacteria;Alphaproteobacteria;Rhodobacterales;Rhodobacteraceae;Tropicibacter;";"100.0";"18.2";"34";"34";"34";"0";"0";"457149";"373860"
"V4mis1";"SILVA (only NR);Bacteria;Proteobacteria;Alphaproteobacteria;Rhodobacterales;Rhodobacteraceae;Tropicimonas;";"96.3";"18.2";"54";"54";"52";"2";"0";"457129";"373842"
"V4mis1";"SILVA (only NR);Bacteria;Proteobacteria;Alphaproteobacteria;Rhodobacterales;Rhodobacteraceae;Vadicella;";"100.0";"18.2";"3";"3";"3";"0";"0";"457180";"373891"
"V4mis1";"SILVA (only NR);Bacteria;Proteobacteria;Alphaproteobacteria;Rhodobacterales;Rhodobacteraceae;WDS1C4;";"100.0";"18.2";"11";"11";"11";"0";"0";"457172";"373883"
"V4mis1";"SILVA (only NR);Bacteria;Proteobacteria;Alphaproteobacteria;Rhodobacterales;Rhodobacteraceae;Wenxinia;";"85.7";"18.2";"7";"7";"6";"1";"0";"457176";"373888"
"V4mis1";"SILVA (only NR);Bacteria;Proteobacteria;Alphaproteobacteria;Rhodobacterales;Rhodobacteraceae;Yangia;";"100.0";"18.2";"16";"16";"16";"0";"0";"457167";"373878"
"V4mis1";"SILVA (only NR);Bacteria;Proteobacteria;Alphaproteobacteria;Rhodobacterales;Rhodobacteraceae;Yoonia-Loktanella;";"95.8";"18.2";"120";"120";"115";"5";"0";"457063";"373779"
"V4mis1";"SILVA (only NR);Bacteria;Proteobacteria;Alphaproteobacteria;Rhodobacterales;Rhodobacteraceae;Youngimonas;";"100.0";"18.2";"4";"4";"4";"0";"0";"457179";"373890"
"V4mis1";"SILVA (only NR);Bacteria;Proteobacteria;Alphaproteobacteria;Rhodobacterales;Rhodobacteraceae;uncultured;";"96.3";"18.2";"899";"899";"866";"33";"0";"456284";"373028"
"V4mis1";"SILVA (only NR);Bacteria;Proteobacteria;Alphaproteobacteria;Rhodospirillales;";"94.9";"18.3";"1257";"1257";"1193";"64";"0";"455926";"372701"
"V4mis1";"SILVA (only NR);Bacteria;Proteobacteria;Alphaproteobacteria;Rhodospirillales;AEGEAN-169 marine group;";"99.1";"18.2";"108";"108";"107";"1";"0";"457075";"373787"
"V4mis1";"SILVA (only NR);Bacteria;Proteobacteria;Alphaproteobacteria;Rhodospirillales;Magnetospiraceae;";"94.4";"18.2";"339";"339";"320";"19";"0";"456844";"373574"
"V4mis1";"SILVA (only NR);Bacteria;Proteobacteria;Alphaproteobacteria;Rhodospirillales;Magnetospiraceae;Magnetospira;";"98.2";"18.2";"57";"57";"56";"1";"0";"457126";"373838"
"V4mis1";"SILVA (only NR);Bacteria;Proteobacteria;Alphaproteobacteria;Rhodospirillales;Magnetospiraceae;Magnetovibrio;";"80.4";"18.2";"46";"46";"37";"9";"0";"457137";"373857"
"V4mis1";"SILVA (only NR);Bacteria;Proteobacteria;Alphaproteobacteria;Rhodospirillales;Magnetospiraceae;Varunaivibrio;";"100.0";"18.2";"3";"3";"3";"0";"0";"457180";"373891"
"V4mis1";"SILVA (only NR);Bacteria;Proteobacteria;Alphaproteobacteria;Rhodospirillales;Magnetospiraceae;uncultured;";"96.1";"18.2";"230";"230";"221";"9";"0";"456953";"373673"
"V4mis1";"SILVA (only NR);Bacteria;Proteobacteria;Alphaproteobacteria;Rhodospirillales;Magnetospirillaceae;";"99.1";"18.2";"110";"110";"109";"1";"0";"457073";"373785"
"V4mis1";"SILVA (only NR);Bacteria;Proteobacteria;Alphaproteobacteria;Rhodospirillales;Magnetospirillaceae;Magnetospirillum;";"97.9";"18.2";"48";"48";"47";"1";"0";"457135";"373847"
"V4mis1";"SILVA (only NR);Bacteria;Proteobacteria;Alphaproteobacteria;Rhodospirillales;Magnetospirillaceae;Phaeospirillum;";"100.0";"18.2";"11";"11";"11";"0";"0";"457172";"373883"
"V4mis1";"SILVA (only NR);Bacteria;Proteobacteria;Alphaproteobacteria;Rhodospirillales;Magnetospirillaceae;Telmatospirillum;";"100.0";"18.2";"19";"19";"19";"0";"0";"457164";"373875"
"V4mis1";"SILVA (only NR);Bacteria;Proteobacteria;Alphaproteobacteria;Rhodospirillales;Magnetospirillaceae;[Aquaspirillum] polymorphum group;";"100.0";"18.2";"2";"2";"2";"0";"0";"457181";"373892"
"V4mis1";"SILVA (only NR);Bacteria;Proteobacteria;Alphaproteobacteria;Rhodospirillales;Magnetospirillaceae;uncultured;";"100.0";"18.2";"18";"18";"18";"0";"0";"457165";"373876"
"V4mis1";"SILVA (only NR);Bacteria;Proteobacteria;Alphaproteobacteria;Rhodospirillales;Rhodospirillaceae;";"94.3";"18.2";"194";"194";"183";"11";"0";"456989";"373711"
"V4mis1";"SILVA (only NR);Bacteria;Proteobacteria;Alphaproteobacteria;Rhodospirillales;Rhodospirillaceae;BRH-c57;";"100.0";"18.2";"3";"3";"3";"0";"0";"457180";"373891"
"V4mis1";"SILVA (only NR);Bacteria;Proteobacteria;Alphaproteobacteria;Rhodospirillales;Rhodospirillaceae;Caenispirillum;";"100.0";"18.2";"9";"9";"9";"0";"0";"457174";"373885"
"V4mis1";"SILVA (only NR);Bacteria;Proteobacteria;Alphaproteobacteria;Rhodospirillales;Rhodospirillaceae;Candidatus Riegeria;";"92.3";"18.2";"26";"26";"24";"2";"0";"457157";"373870"
"V4mis1";"SILVA (only NR);Bacteria;Proteobacteria;Alphaproteobacteria;Rhodospirillales;Rhodospirillaceae;Haematospirillum;";"100.0";"18.2";"5";"5";"5";"0";"0";"457178";"373889"
"V4mis1";"SILVA (only NR);Bacteria;Proteobacteria;Alphaproteobacteria;Rhodospirillales;Rhodospirillaceae;Insolitispirillum;";"75.0";"18.2";"8";"8";"6";"2";"0";"457175";"373888"
"V4mis1";"SILVA (only NR);Bacteria;Proteobacteria;Alphaproteobacteria;Rhodospirillales;Rhodospirillaceae;Marispirillum;";"100.0";"18.2";"6";"6";"6";"0";"0";"457177";"373888"
"V4mis1";"SILVA (only NR);Bacteria;Proteobacteria;Alphaproteobacteria;Rhodospirillales;Rhodospirillaceae;Novispirillum;";"100.0";"18.2";"7";"7";"7";"0";"0";"457176";"373887"
"V4mis1";"SILVA (only NR);Bacteria;Proteobacteria;Alphaproteobacteria;Rhodospirillales;Rhodospirillaceae;Pararhodospirillum;";"100.0";"18.2";"5";"5";"5";"0";"0";"457178";"373889"
"V4mis1";"SILVA (only NR);Bacteria;Proteobacteria;Alphaproteobacteria;Rhodospirillales;Rhodospirillaceae;Phaeovibrio;";"0.0";"0";"1";"1";"0";"1";"0";"457182";"373894"
"V4mis1";"SILVA (only NR);Bacteria;Proteobacteria;Alphaproteobacteria;Rhodospirillales;Rhodospirillaceae;Rhodospirillum;";"100.0";"18.2";"4";"4";"4";"0";"0";"457179";"373890"
"V4mis1";"SILVA (only NR);Bacteria;Proteobacteria;Alphaproteobacteria;Rhodospirillales;Rhodospirillaceae;Roseospira;";"92.9";"18.2";"14";"14";"13";"1";"0";"457169";"373881"
"V4mis1";"SILVA (only NR);Bacteria;Proteobacteria;Alphaproteobacteria;Rhodospirillales;Rhodospirillaceae;Roseospirillum;";"100.0";"18.2";"6";"6";"6";"0";"0";"457177";"373888"
"V4mis1";"SILVA (only NR);Bacteria;Proteobacteria;Alphaproteobacteria;Rhodospirillales;Rhodospirillaceae;uncultured;";"95.9";"18.2";"97";"97";"93";"4";"0";"457086";"373801"
"V4mis1";"SILVA (only NR);Bacteria;Proteobacteria;Alphaproteobacteria;Rhodospirillales;Terasakiellaceae;";"89.4";"18.2";"113";"113";"101";"12";"0";"457070";"373793"
"V4mis1";"SILVA (only NR);Bacteria;Proteobacteria;Alphaproteobacteria;Rhodospirillales;Terasakiellaceae;Aestuariispira;";"100.0";"18.2";"5";"5";"5";"0";"0";"457178";"373889"
"V4mis1";"SILVA (only NR);Bacteria;Proteobacteria;Alphaproteobacteria;Rhodospirillales;Terasakiellaceae;Terasakiella;";"93.3";"18.2";"15";"15";"14";"1";"0";"457168";"373880"
"V4mis1";"SILVA (only NR);Bacteria;Proteobacteria;Alphaproteobacteria;Rhodospirillales;Terasakiellaceae;uncultured;";"88.0";"18.2";"92";"92";"81";"11";"0";"457091";"373813"
"V4mis1";"SILVA (only NR);Bacteria;Proteobacteria;Alphaproteobacteria;Rhodospirillales;Thalassospiraceae;";"91.7";"18.2";"96";"96";"88";"8";"0";"457087";"373806"
"V4mis1";"SILVA (only NR);Bacteria;Proteobacteria;Alphaproteobacteria;Rhodospirillales;Thalassospiraceae;Thalassospira;";"91.7";"18.2";"96";"96";"88";"8";"0";"457087";"373806"
"V4mis1";"SILVA (only NR);Bacteria;Proteobacteria;Alphaproteobacteria;Rhodospirillales;uncultured;";"95.9";"18.2";"296";"296";"284";"12";"0";"456887";"373610"
"V4mis1";"SILVA (only NR);Bacteria;Proteobacteria;Alphaproteobacteria;Rickettsiales;";"88.7";"18.3";"2242";"2236";"1983";"253";"6";"454947";"371911"
"V4mis1";"SILVA (only NR);Bacteria;Proteobacteria;Alphaproteobacteria;Rickettsiales;AB1;";"100.0";"18.2";"47";"47";"47";"0";"0";"457136";"373847"
"V4mis1";"SILVA (only NR);Bacteria;Proteobacteria;Alphaproteobacteria;Rickettsiales;Anaplasmataceae;";"96.4";"18.2";"247";"247";"238";"9";"0";"456936";"373656"
"V4mis1";"SILVA (only NR);Bacteria;Proteobacteria;Alphaproteobacteria;Rickettsiales;Anaplasmataceae;Anaplasma;";"100.0";"18.2";"57";"57";"57";"0";"0";"457126";"373837"
"V4mis1";"SILVA (only NR);Bacteria;Proteobacteria;Alphaproteobacteria;Rickettsiales;Anaplasmataceae;Candidatus Cryptoplasma;";"100.0";"18.2";"2";"2";"2";"0";"0";"457181";"373892"
"V4mis1";"SILVA (only NR);Bacteria;Proteobacteria;Alphaproteobacteria;Rickettsiales;Anaplasmataceae;Candidatus Neoehrlichia;";"100.0";"18.2";"4";"4";"4";"0";"0";"457179";"373890"
"V4mis1";"SILVA (only NR);Bacteria;Proteobacteria;Alphaproteobacteria;Rickettsiales;Anaplasmataceae;Candidatus Xenohaliotis;";"100.0";"18.2";"5";"5";"5";"0";"0";"457178";"373889"
"V4mis1";"SILVA (only NR);Bacteria;Proteobacteria;Alphaproteobacteria;Rickettsiales;Anaplasmataceae;Candidatus Xenolissoclinum;";"100.0";"18.2";"1";"1";"1";"0";"0";"457182";"373893"
"V4mis1";"SILVA (only NR);Bacteria;Proteobacteria;Alphaproteobacteria;Rickettsiales;Anaplasmataceae;Ehrlichia;";"100.0";"18.2";"35";"35";"35";"0";"0";"457148";"373859"
"V4mis1";"SILVA (only NR);Bacteria;Proteobacteria;Alphaproteobacteria;Rickettsiales;Anaplasmataceae;Neorickettsia;";"100.0";"18.2";"25";"25";"25";"0";"0";"457158";"373869"
"V4mis1";"SILVA (only NR);Bacteria;Proteobacteria;Alphaproteobacteria;Rickettsiales;Anaplasmataceae;Wolbachia;";"91.8";"18.2";"110";"110";"101";"9";"0";"457073";"373793"
"V4mis1";"SILVA (only NR);Bacteria;Proteobacteria;Alphaproteobacteria;Rickettsiales;Anaplasmataceae;uncultured;";"100.0";"18.2";"5";"5";"5";"0";"0";"457178";"373889"
"V4mis1";"SILVA (only NR);Bacteria;Proteobacteria;Alphaproteobacteria;Rickettsiales;Candidatus Hepatincola;";"87.5";"18.2";"8";"8";"7";"1";"0";"457175";"373887"
"V4mis1";"SILVA (only NR);Bacteria;Proteobacteria;Alphaproteobacteria;Rickettsiales;Candidatus Jidaibacter;";"100.0";"18.2";"12";"12";"12";"0";"0";"457171";"373882"
"V4mis1";"SILVA (only NR);Bacteria;Proteobacteria;Alphaproteobacteria;Rickettsiales;Fokiniaceae;";"97.7";"18.2";"44";"44";"43";"1";"0";"457139";"373851"
"V4mis1";"SILVA (only NR);Bacteria;Proteobacteria;Alphaproteobacteria;Rickettsiales;Fokiniaceae;Candidatus Anadelfobacter;";"100.0";"18.2";"2";"2";"2";"0";"0";"457181";"373892"
"V4mis1";"SILVA (only NR);Bacteria;Proteobacteria;Alphaproteobacteria;Rickettsiales;Fokiniaceae;Candidatus Cyrtobacter;";"100.0";"18.2";"2";"2";"2";"0";"0";"457181";"373892"
"V4mis1";"SILVA (only NR);Bacteria;Proteobacteria;Alphaproteobacteria;Rickettsiales;Fokiniaceae;Candidatus Defluviella;";"100.0";"18.2";"1";"1";"1";"0";"0";"457182";"373893"
"V4mis1";"SILVA (only NR);Bacteria;Proteobacteria;Alphaproteobacteria;Rickettsiales;Fokiniaceae;Candidatus Fokinia;";"100.0";"18.2";"3";"3";"3";"0";"0";"457180";"373891"
"V4mis1";"SILVA (only NR);Bacteria;Proteobacteria;Alphaproteobacteria;Rickettsiales;Fokiniaceae;Candidatus Lariskella;";"83.3";"18.2";"6";"6";"5";"1";"0";"457177";"373889"
"V4mis1";"SILVA (only NR);Bacteria;Proteobacteria;Alphaproteobacteria;Rickettsiales;Fokiniaceae;Lyticum;";"100.0";"18.2";"1";"1";"1";"0";"0";"457182";"373893"
"V4mis1";"SILVA (only NR);Bacteria;Proteobacteria;Alphaproteobacteria;Rickettsiales;Fokiniaceae;MD3-55;";"100.0";"18.2";"20";"20";"20";"0";"0";"457163";"373874"
"V4mis1";"SILVA (only NR);Bacteria;Proteobacteria;Alphaproteobacteria;Rickettsiales;Fokiniaceae;uncultured;";"100.0";"18.2";"7";"7";"7";"0";"0";"457176";"373887"
"V4mis1";"SILVA (only NR);Bacteria;Proteobacteria;Alphaproteobacteria;Rickettsiales;Midichloriaceae;";"100.0";"18.2";"7";"7";"7";"0";"0";"457176";"373887"
"V4mis1";"SILVA (only NR);Bacteria;Proteobacteria;Alphaproteobacteria;Rickettsiales;Midichloriaceae;Candidatus Midichloria;";"100.0";"18.2";"7";"7";"7";"0";"0";"457176";"373887"
"V4mis1";"SILVA (only NR);Bacteria;Proteobacteria;Alphaproteobacteria;Rickettsiales;Mitochondria;";"81.7";"18.2";"1227";"1221";"997";"224";"6";"455962";"372897"
"V4mis1";"SILVA (only NR);Bacteria;Proteobacteria;Alphaproteobacteria;Rickettsiales;Rickettsiaceae;";"97.2";"18.2";"285";"285";"277";"8";"0";"456898";"373617"
"V4mis1";"SILVA (only NR);Bacteria;Proteobacteria;Alphaproteobacteria;Rickettsiales;Rickettsiaceae;Ac37b;";"100.0";"18.2";"2";"2";"2";"0";"0";"457181";"373892"
"V4mis1";"SILVA (only NR);Bacteria;Proteobacteria;Alphaproteobacteria;Rickettsiales;Rickettsiaceae;Candidatus Arcanobacter;";"100.0";"18.2";"1";"1";"1";"0";"0";"457182";"373893"
"V4mis1";"SILVA (only NR);Bacteria;Proteobacteria;Alphaproteobacteria;Rickettsiales;Rickettsiaceae;Candidatus Cryptoprodotis;";"100.0";"18.2";"5";"5";"5";"0";"0";"457178";"373889"
"V4mis1";"SILVA (only NR);Bacteria;Proteobacteria;Alphaproteobacteria;Rickettsiales;Rickettsiaceae;Candidatus Gigarickettsia;";"100.0";"18.2";"3";"3";"3";"0";"0";"457180";"373891"
"V4mis1";"SILVA (only NR);Bacteria;Proteobacteria;Alphaproteobacteria;Rickettsiales;Rickettsiaceae;Candidatus Hemipteriphilus;";"100.0";"18.2";"2";"2";"2";"0";"0";"457181";"373892"
"V4mis1";"SILVA (only NR);Bacteria;Proteobacteria;Alphaproteobacteria;Rickettsiales;Rickettsiaceae;Candidatus Megaira;";"100.0";"18.2";"26";"26";"26";"0";"0";"457157";"373868"
"V4mis1";"SILVA (only NR);Bacteria;Proteobacteria;Alphaproteobacteria;Rickettsiales;Rickettsiaceae;Candidatus Trichorickettsia;";"100.0";"18.2";"3";"3";"3";"0";"0";"457180";"373891"
"V4mis1";"SILVA (only NR);Bacteria;Proteobacteria;Alphaproteobacteria;Rickettsiales;Rickettsiaceae;Orientia;";"100.0";"18.2";"16";"16";"16";"0";"0";"457167";"373878"
"V4mis1";"SILVA (only NR);Bacteria;Proteobacteria;Alphaproteobacteria;Rickettsiales;Rickettsiaceae;Rickettsia;";"96.3";"18.2";"163";"163";"157";"6";"0";"457020";"373737"
"V4mis1";"SILVA (only NR);Bacteria;Proteobacteria;Alphaproteobacteria;Rickettsiales;Rickettsiaceae;uncultured;";"96.6";"18.2";"59";"59";"57";"2";"0";"457124";"373837"
"V4mis1";"SILVA (only NR);Bacteria;Proteobacteria;Alphaproteobacteria;Rickettsiales;S25-593;";"92.2";"18.2";"90";"90";"83";"7";"0";"457093";"373811"
"V4mis1";"SILVA (only NR);Bacteria;Proteobacteria;Alphaproteobacteria;Rickettsiales;SM1B06;";"100.0";"18.2";"4";"4";"4";"0";"0";"457179";"373890"
"V4mis1";"SILVA (only NR);Bacteria;Proteobacteria;Alphaproteobacteria;Rickettsiales;SM2D12;";"99.1";"18.2";"220";"220";"218";"2";"0";"456963";"373676"
"V4mis1";"SILVA (only NR);Bacteria;Proteobacteria;Alphaproteobacteria;Rickettsiales;bac2nit3;";"100.0";"18.2";"4";"4";"4";"0";"0";"457179";"373890"
"V4mis1";"SILVA (only NR);Bacteria;Proteobacteria;Alphaproteobacteria;Rickettsiales;uncultured;";"97.7";"18.2";"44";"44";"43";"1";"0";"457139";"373851"
"V4mis1";"SILVA (only NR);Bacteria;Proteobacteria;Alphaproteobacteria;SAR11 clade;";"97.4";"18.3";"2004";"2004";"1952";"52";"0";"455179";"371942"
"V4mis1";"SILVA (only NR);Bacteria;Proteobacteria;Alphaproteobacteria;SAR11 clade;Clade I;";"96.5";"18.3";"1091";"1091";"1053";"38";"0";"456092";"372841"
"V4mis1";"SILVA (only NR);Bacteria;Proteobacteria;Alphaproteobacteria;SAR11 clade;Clade I;Clade Ia;";"93.8";"18.2";"465";"465";"436";"29";"0";"456718";"373458"
"V4mis1";"SILVA (only NR);Bacteria;Proteobacteria;Alphaproteobacteria;SAR11 clade;Clade I;Clade Ib;";"97.9";"18.2";"238";"238";"233";"5";"0";"456945";"373661"
"V4mis1";"SILVA (only NR);Bacteria;Proteobacteria;Alphaproteobacteria;SAR11 clade;Clade I;uncultured;";"99.0";"18.2";"382";"382";"378";"4";"0";"456801";"373516"
"V4mis1";"SILVA (only NR);Bacteria;Proteobacteria;Alphaproteobacteria;SAR11 clade;Clade II;";"98.4";"18.2";"756";"756";"744";"12";"0";"456427";"373150"
"V4mis1";"SILVA (only NR);Bacteria;Proteobacteria;Alphaproteobacteria;SAR11 clade;Clade III;";"100.0";"18.2";"80";"80";"80";"0";"0";"457103";"373814"
"V4mis1";"SILVA (only NR);Bacteria;Proteobacteria;Alphaproteobacteria;SAR11 clade;Clade IV;";"96.8";"18.2";"31";"31";"30";"1";"0";"457152";"373864"
"V4mis1";"SILVA (only NR);Bacteria;Proteobacteria;Alphaproteobacteria;SAR11 clade;uncultured;";"97.6";"18.2";"42";"42";"41";"1";"0";"457141";"373853"
"V4mis1";"SILVA (only NR);Bacteria;Proteobacteria;Alphaproteobacteria;Sneathiellales;";"95.1";"18.2";"41";"41";"39";"2";"0";"457142";"373855"
"V4mis1";"SILVA (only NR);Bacteria;Proteobacteria;Alphaproteobacteria;Sneathiellales;Sneathiellaceae;";"95.1";"18.2";"41";"41";"39";"2";"0";"457142";"373855"
"V4mis1";"SILVA (only NR);Bacteria;Proteobacteria;Alphaproteobacteria;Sneathiellales;Sneathiellaceae;Oceanibacterium;";"100.0";"18.2";"1";"1";"1";"0";"0";"457182";"373893"
"V4mis1";"SILVA (only NR);Bacteria;Proteobacteria;Alphaproteobacteria;Sneathiellales;Sneathiellaceae;Sneathiella;";"93.5";"18.2";"31";"31";"29";"2";"0";"457152";"373865"
"V4mis1";"SILVA (only NR);Bacteria;Proteobacteria;Alphaproteobacteria;Sneathiellales;Sneathiellaceae;uncultured;";"100.0";"18.2";"9";"9";"9";"0";"0";"457174";"373885"
"V4mis1";"SILVA (only NR);Bacteria;Proteobacteria;Alphaproteobacteria;Sphingomonadales;";"94.4";"18.3";"4495";"4495";"4245";"250";"0";"452688";"369649"
"V4mis1";"SILVA (only NR);Bacteria;Proteobacteria;Alphaproteobacteria;Sphingomonadales;Sphingomonadaceae;";"94.4";"18.3";"4495";"4495";"4245";"250";"0";"452688";"369649"
"V4mis1";"SILVA (only NR);Bacteria;Proteobacteria;Alphaproteobacteria;Sphingomonadales;Sphingomonadaceae;Altererythrobacter;";"95.8";"18.2";"309";"309";"296";"13";"0";"456874";"373598"
"V4mis1";"SILVA (only NR);Bacteria;Proteobacteria;Alphaproteobacteria;Sphingomonadales;Sphingomonadaceae;Blastomonas;";"88.9";"18.2";"27";"27";"24";"3";"0";"457156";"373870"
"V4mis1";"SILVA (only NR);Bacteria;Proteobacteria;Alphaproteobacteria;Sphingomonadales;Sphingomonadaceae;Croceicoccus;";"90.9";"18.2";"11";"11";"10";"1";"0";"457172";"373884"
"V4mis1";"SILVA (only NR);Bacteria;Proteobacteria;Alphaproteobacteria;Sphingomonadales;Sphingomonadaceae;DSSF69;";"100.0";"18.2";"14";"14";"14";"0";"0";"457169";"373880"
"V4mis1";"SILVA (only NR);Bacteria;Proteobacteria;Alphaproteobacteria;Sphingomonadales;Sphingomonadaceae;Ellin6055;";"95.7";"18.2";"92";"92";"88";"4";"0";"457091";"373806"
"V4mis1";"SILVA (only NR);Bacteria;Proteobacteria;Alphaproteobacteria;Sphingomonadales;Sphingomonadaceae;Erythrobacter;";"95.0";"18.2";"259";"259";"246";"13";"0";"456924";"373648"
"V4mis1";"SILVA (only NR);Bacteria;Proteobacteria;Alphaproteobacteria;Sphingomonadales;Sphingomonadaceae;Hephaestia;";"85.7";"18.2";"7";"7";"6";"1";"0";"457176";"373888"
"V4mis1";"SILVA (only NR);Bacteria;Proteobacteria;Alphaproteobacteria;Sphingomonadales;Sphingomonadaceae;MN 122.2a;";"100.0";"18.2";"7";"7";"7";"0";"0";"457176";"373887"
"V4mis1";"SILVA (only NR);Bacteria;Proteobacteria;Alphaproteobacteria;Sphingomonadales;Sphingomonadaceae;Novosphingobium;";"94.0";"18.2";"552";"552";"519";"33";"0";"456631";"373375"
"V4mis1";"SILVA (only NR);Bacteria;Proteobacteria;Alphaproteobacteria;Sphingomonadales;Sphingomonadaceae;Parablastomonas;";"100.0";"18.2";"5";"5";"5";"0";"0";"457178";"373889"
"V4mis1";"SILVA (only NR);Bacteria;Proteobacteria;Alphaproteobacteria;Sphingomonadales;Sphingomonadaceae;Parasphingopyxis;";"100.0";"18.2";"8";"8";"8";"0";"0";"457175";"373886"
"V4mis1";"SILVA (only NR);Bacteria;Proteobacteria;Alphaproteobacteria;Sphingomonadales;Sphingomonadaceae;Plot4-2H12;";"100.0";"18.2";"3";"3";"3";"0";"0";"457180";"373891"
"V4mis1";"SILVA (only NR);Bacteria;Proteobacteria;Alphaproteobacteria;Sphingomonadales;Sphingomonadaceae;Polymorphobacter;";"100.0";"18.2";"30";"30";"30";"0";"0";"457153";"373864"
"V4mis1";"SILVA (only NR);Bacteria;Proteobacteria;Alphaproteobacteria;Sphingomonadales;Sphingomonadaceae;Porphyrobacter;";"94.8";"18.2";"96";"96";"91";"5";"0";"457087";"373803"
"V4mis1";"SILVA (only NR);Bacteria;Proteobacteria;Alphaproteobacteria;Sphingomonadales;Sphingomonadaceae;Qipengyuania;";"77.3";"18.2";"22";"22";"17";"5";"0";"457161";"373877"
"V4mis1";"SILVA (only NR);Bacteria;Proteobacteria;Alphaproteobacteria;Sphingomonadales;Sphingomonadaceae;Rhizorhapis;";"98.1";"18.2";"54";"54";"53";"1";"0";"457129";"373841"
"V4mis1";"SILVA (only NR);Bacteria;Proteobacteria;Alphaproteobacteria;Sphingomonadales;Sphingomonadaceae;SD04E11;";"91.7";"18.2";"12";"12";"11";"1";"0";"457171";"373883"
"V4mis1";"SILVA (only NR);Bacteria;Proteobacteria;Alphaproteobacteria;Sphingomonadales;Sphingomonadaceae;Sandaracinobacter;";"100.0";"18.2";"19";"19";"19";"0";"0";"457164";"373875"
"V4mis1";"SILVA (only NR);Bacteria;Proteobacteria;Alphaproteobacteria;Sphingomonadales;Sphingomonadaceae;Sandarakinorhabdus;";"100.0";"18.2";"9";"9";"9";"0";"0";"457174";"373885"
"V4mis1";"SILVA (only NR);Bacteria;Proteobacteria;Alphaproteobacteria;Sphingomonadales;Sphingomonadaceae;Sphingoaurantiacus;";"92.0";"18.2";"25";"25";"23";"2";"0";"457158";"373871"
"V4mis1";"SILVA (only NR);Bacteria;Proteobacteria;Alphaproteobacteria;Sphingomonadales;Sphingomonadaceae;Sphingobium;";"91.5";"18.2";"484";"484";"443";"41";"0";"456699";"373451"
"V4mis1";"SILVA (only NR);Bacteria;Proteobacteria;Alphaproteobacteria;Sphingomonadales;Sphingomonadaceae;Sphingomicrobium;";"88.9";"18.2";"9";"9";"8";"1";"0";"457174";"373886"
"V4mis1";"SILVA (only NR);Bacteria;Proteobacteria;Alphaproteobacteria;Sphingomonadales;Sphingomonadaceae;Sphingomonas;";"94.7";"18.3";"1787";"1787";"1692";"95";"0";"455396";"372202"
"V4mis1";"SILVA (only NR);Bacteria;Proteobacteria;Alphaproteobacteria;Sphingomonadales;Sphingomonadaceae;Sphingopyxis;";"96.3";"18.2";"214";"214";"206";"8";"0";"456969";"373688"
"V4mis1";"SILVA (only NR);Bacteria;Proteobacteria;Alphaproteobacteria;Sphingomonadales;Sphingomonadaceae;Sphingorhabdus;";"94.2";"18.2";"120";"120";"113";"7";"0";"457063";"373781"
"V4mis1";"SILVA (only NR);Bacteria;Proteobacteria;Alphaproteobacteria;Sphingomonadales;Sphingomonadaceae;Sphingosinicella;";"100.0";"18.2";"13";"13";"13";"0";"0";"457170";"373881"
"V4mis1";"SILVA (only NR);Bacteria;Proteobacteria;Alphaproteobacteria;Sphingomonadales;Sphingomonadaceae;Stakelama;";"100.0";"18.2";"6";"6";"6";"0";"0";"457177";"373888"
"V4mis1";"SILVA (only NR);Bacteria;Proteobacteria;Alphaproteobacteria;Sphingomonadales;Sphingomonadaceae;Zymomonas;";"93.9";"18.2";"33";"33";"31";"2";"0";"457150";"373863"
"V4mis1";"SILVA (only NR);Bacteria;Proteobacteria;Alphaproteobacteria;Sphingomonadales;Sphingomonadaceae;uncultured;";"94.5";"18.2";"256";"256";"242";"14";"0";"456927";"373652"
"V4mis1";"SILVA (only NR);Bacteria;Proteobacteria;Alphaproteobacteria;Thalassobaculales;";"96.7";"18.2";"152";"152";"147";"5";"0";"457031";"373747"
"V4mis1";"SILVA (only NR);Bacteria;Proteobacteria;Alphaproteobacteria;Thalassobaculales;Nisaeaceae;";"95.5";"18.2";"44";"44";"42";"2";"0";"457139";"373852"
"V4mis1";"SILVA (only NR);Bacteria;Proteobacteria;Alphaproteobacteria;Thalassobaculales;Nisaeaceae;Nisaea;";"100.0";"18.2";"12";"12";"12";"0";"0";"457171";"373882"
"V4mis1";"SILVA (only NR);Bacteria;Proteobacteria;Alphaproteobacteria;Thalassobaculales;Nisaeaceae;OM75 clade;";"93.8";"18.2";"32";"32";"30";"2";"0";"457151";"373864"
"V4mis1";"SILVA (only NR);Bacteria;Proteobacteria;Alphaproteobacteria;Thalassobaculales;Oceanibaculaceae;";"100.0";"18.2";"7";"7";"7";"0";"0";"457176";"373887"
"V4mis1";"SILVA (only NR);Bacteria;Proteobacteria;Alphaproteobacteria;Thalassobaculales;Oceanibaculaceae;Oceanibaculum;";"100.0";"18.2";"7";"7";"7";"0";"0";"457176";"373887"
"V4mis1";"SILVA (only NR);Bacteria;Proteobacteria;Alphaproteobacteria;Thalassobaculales;Thalassobaculaceae;";"93.3";"18.2";"15";"15";"14";"1";"0";"457168";"373880"
"V4mis1";"SILVA (only NR);Bacteria;Proteobacteria;Alphaproteobacteria;Thalassobaculales;Thalassobaculaceae;Candidatus Endolissoclinum;";"100.0";"18.2";"2";"2";"2";"0";"0";"457181";"373892"
"V4mis1";"SILVA (only NR);Bacteria;Proteobacteria;Alphaproteobacteria;Thalassobaculales;Thalassobaculaceae;Thalassobaculum;";"92.3";"18.2";"13";"13";"12";"1";"0";"457170";"373882"
"V4mis1";"SILVA (only NR);Bacteria;Proteobacteria;Alphaproteobacteria;Thalassobaculales;uncultured;";"97.7";"18.2";"86";"86";"84";"2";"0";"457097";"373810"
"V4mis1";"SILVA (only NR);Bacteria;Proteobacteria;Alphaproteobacteria;Tistrellales;";"93.7";"18.2";"126";"126";"118";"8";"0";"457057";"373776"
"V4mis1";"SILVA (only NR);Bacteria;Proteobacteria;Alphaproteobacteria;Tistrellales;Geminicoccaceae;";"95.1";"18.2";"103";"103";"98";"5";"0";"457080";"373796"
"V4mis1";"SILVA (only NR);Bacteria;Proteobacteria;Alphaproteobacteria;Tistrellales;Geminicoccaceae;Arboricoccus;";"100.0";"18.2";"4";"4";"4";"0";"0";"457179";"373890"
"V4mis1";"SILVA (only NR);Bacteria;Proteobacteria;Alphaproteobacteria;Tistrellales;Geminicoccaceae;Candidatus Alysiosphaera;";"96.3";"18.2";"54";"54";"52";"2";"0";"457129";"373842"
"V4mis1";"SILVA (only NR);Bacteria;Proteobacteria;Alphaproteobacteria;Tistrellales;Geminicoccaceae;Geminicoccus;";"100.0";"18.2";"9";"9";"9";"0";"0";"457174";"373885"
"V4mis1";"SILVA (only NR);Bacteria;Proteobacteria;Alphaproteobacteria;Tistrellales;Geminicoccaceae;uncultured;";"91.7";"18.2";"36";"36";"33";"3";"0";"457147";"373861"
"V4mis1";"SILVA (only NR);Bacteria;Proteobacteria;Alphaproteobacteria;Tistrellales;Tistrellaceae;";"87.0";"18.2";"23";"23";"20";"3";"0";"457160";"373874"
"V4mis1";"SILVA (only NR);Bacteria;Proteobacteria;Alphaproteobacteria;Tistrellales;Tistrellaceae;Tistrella;";"87.0";"18.2";"23";"23";"20";"3";"0";"457160";"373874"
"V4mis1";"SILVA (only NR);Bacteria;Proteobacteria;Alphaproteobacteria;Zavarziniales;";"95.8";"18.2";"24";"24";"23";"1";"0";"457159";"373871"
"V4mis1";"SILVA (only NR);Bacteria;Proteobacteria;Alphaproteobacteria;Zavarziniales;Zavarziniaceae;";"100.0";"18.2";"5";"5";"5";"0";"0";"457178";"373889"
"V4mis1";"SILVA (only NR);Bacteria;Proteobacteria;Alphaproteobacteria;Zavarziniales;Zavarziniaceae;Oleomonas;";"100.0";"18.2";"1";"1";"1";"0";"0";"457182";"373893"
"V4mis1";"SILVA (only NR);Bacteria;Proteobacteria;Alphaproteobacteria;Zavarziniales;Zavarziniaceae;Zavarzinia;";"100.0";"18.2";"2";"2";"2";"0";"0";"457181";"373892"
"V4mis1";"SILVA (only NR);Bacteria;Proteobacteria;Alphaproteobacteria;Zavarziniales;uncultured;";"94.7";"18.2";"19";"19";"18";"1";"0";"457164";"373876"
"V4mis1";"SILVA (only NR);Bacteria;Proteobacteria;Alphaproteobacteria;uncultured;";"95.8";"18.2";"481";"481";"461";"20";"0";"456702";"373433"
"V4mis1";"SILVA (only NR);Bacteria;Proteobacteria;Gammaproteobacteria;";"92.9";"20.4";"75026";"75026";"69680";"5346";"0";"382157";"304214"
"V4mis1";"SILVA (only NR);Bacteria;Proteobacteria;Gammaproteobacteria;1013-28-CG33;";"100.0";"18.2";"19";"19";"19";"0";"0";"457164";"373875"
"V4mis1";"SILVA (only NR);Bacteria;Proteobacteria;Gammaproteobacteria;AT-s16;";"100.0";"18.2";"6";"6";"6";"0";"0";"457177";"373888"
"V4mis1";"SILVA (only NR);Bacteria;Proteobacteria;Gammaproteobacteria;AT-s2-59;";"96.3";"18.2";"54";"54";"52";"2";"0";"457129";"373842"
"V4mis1";"SILVA (only NR);Bacteria;Proteobacteria;Gammaproteobacteria;Acidiferrobacterales;";"96.5";"18.2";"113";"113";"109";"4";"0";"457070";"373785"
"V4mis1";"SILVA (only NR);Bacteria;Proteobacteria;Gammaproteobacteria;Acidiferrobacterales;Acidiferrobacteraceae;";"96.5";"18.2";"113";"113";"109";"4";"0";"457070";"373785"
"V4mis1";"SILVA (only NR);Bacteria;Proteobacteria;Gammaproteobacteria;Acidiferrobacterales;Acidiferrobacteraceae;Acidiferrobacter;";"100.0";"18.2";"5";"5";"5";"0";"0";"457178";"373889"
"V4mis1";"SILVA (only NR);Bacteria;Proteobacteria;Gammaproteobacteria;Acidiferrobacterales;Acidiferrobacteraceae;Sulfurifustis;";"95.4";"18.2";"87";"87";"83";"4";"0";"457096";"373811"
"V4mis1";"SILVA (only NR);Bacteria;Proteobacteria;Gammaproteobacteria;Acidiferrobacterales;Acidiferrobacteraceae;uncultured;";"100.0";"18.2";"17";"17";"17";"0";"0";"457166";"373877"
"V4mis1";"SILVA (only NR);Bacteria;Proteobacteria;Gammaproteobacteria;Acidithiobacillales;";"94.5";"18.2";"344";"344";"325";"19";"0";"456839";"373569"
"V4mis1";"SILVA (only NR);Bacteria;Proteobacteria;Gammaproteobacteria;Acidithiobacillales;Acidithiobacillaceae;";"94.5";"18.2";"344";"344";"325";"19";"0";"456839";"373569"
"V4mis1";"SILVA (only NR);Bacteria;Proteobacteria;Gammaproteobacteria;Acidithiobacillales;Acidithiobacillaceae;9M32;";"100.0";"18.2";"25";"25";"25";"0";"0";"457158";"373869"
"V4mis1";"SILVA (only NR);Bacteria;Proteobacteria;Gammaproteobacteria;Acidithiobacillales;Acidithiobacillaceae;Acidithiobacillus;";"93.2";"18.2";"236";"236";"220";"16";"0";"456947";"373674"
"V4mis1";"SILVA (only NR);Bacteria;Proteobacteria;Gammaproteobacteria;Acidithiobacillales;Acidithiobacillaceae;KCM-B-112;";"94.7";"18.2";"57";"57";"54";"3";"0";"457126";"373840"
"V4mis1";"SILVA (only NR);Bacteria;Proteobacteria;Gammaproteobacteria;Acidithiobacillales;Acidithiobacillaceae;RCP1-48;";"100.0";"18.2";"14";"14";"14";"0";"0";"457169";"373880"
"V4mis1";"SILVA (only NR);Bacteria;Proteobacteria;Gammaproteobacteria;Acidithiobacillales;Acidithiobacillaceae;TX1A-55;";"100.0";"18.2";"5";"5";"5";"0";"0";"457178";"373889"
"V4mis1";"SILVA (only NR);Bacteria;Proteobacteria;Gammaproteobacteria;Acidithiobacillales;Acidithiobacillaceae;Thermithiobacillus;";"100.0";"18.2";"7";"7";"7";"0";"0";"457176";"373887"
"V4mis1";"SILVA (only NR);Bacteria;Proteobacteria;Gammaproteobacteria;Arenicellales;";"96.8";"18.2";"216";"216";"209";"7";"0";"456967";"373685"
"V4mis1";"SILVA (only NR);Bacteria;Proteobacteria;Gammaproteobacteria;Arenicellales;Arenicellaceae;";"96.8";"18.2";"216";"216";"209";"7";"0";"456967";"373685"
"V4mis1";"SILVA (only NR);Bacteria;Proteobacteria;Gammaproteobacteria;Arenicellales;Arenicellaceae;Arenicella;";"95.5";"18.2";"22";"22";"21";"1";"0";"457161";"373873"
"V4mis1";"SILVA (only NR);Bacteria;Proteobacteria;Gammaproteobacteria;Arenicellales;Arenicellaceae;Candidatus Thiosymbion;";"97.4";"18.2";"38";"38";"37";"1";"0";"457145";"373857"
"V4mis1";"SILVA (only NR);Bacteria;Proteobacteria;Gammaproteobacteria;Arenicellales;Arenicellaceae;HTCC5015;";"100.0";"18.2";"16";"16";"16";"0";"0";"457167";"373878"
"V4mis1";"SILVA (only NR);Bacteria;Proteobacteria;Gammaproteobacteria;Arenicellales;Arenicellaceae;Perspicuibacter;";"100.0";"18.2";"4";"4";"4";"0";"0";"457179";"373890"
"V4mis1";"SILVA (only NR);Bacteria;Proteobacteria;Gammaproteobacteria;Arenicellales;Arenicellaceae;Thiolapillus;";"100.0";"18.2";"8";"8";"8";"0";"0";"457175";"373886"
"V4mis1";"SILVA (only NR);Bacteria;Proteobacteria;Gammaproteobacteria;Arenicellales;Arenicellaceae;uncultured;";"96.0";"18.2";"125";"125";"120";"5";"0";"457058";"373774"
"V4mis1";"SILVA (only NR);Bacteria;Proteobacteria;Gammaproteobacteria;B108;";"100.0";"18.2";"2";"2";"2";"0";"0";"457181";"373892"
"V4mis1";"SILVA (only NR);Bacteria;Proteobacteria;Gammaproteobacteria;B2M28;";"93.3";"18.2";"165";"165";"154";"11";"0";"457018";"373740"
"V4mis1";"SILVA (only NR);Bacteria;Proteobacteria;Gammaproteobacteria;BD7-8;";"100.0";"18.2";"21";"21";"21";"0";"0";"457162";"373873"
"V4mis1";"SILVA (only NR);Bacteria;Proteobacteria;Gammaproteobacteria;BD72BR169;";"100.0";"18.2";"14";"14";"14";"0";"0";"457169";"373880"
"V4mis1";"SILVA (only NR);Bacteria;Proteobacteria;Gammaproteobacteria;Beggiatoales;";"96.4";"18.2";"137";"137";"132";"5";"0";"457046";"373762"
"V4mis1";"SILVA (only NR);Bacteria;Proteobacteria;Gammaproteobacteria;Beggiatoales;Beggiatoaceae;";"96.4";"18.2";"137";"137";"132";"5";"0";"457046";"373762"
"V4mis1";"SILVA (only NR);Bacteria;Proteobacteria;Gammaproteobacteria;Beggiatoales;Beggiatoaceae;Beggiatoa;";"96.4";"18.2";"28";"28";"27";"1";"0";"457155";"373867"
"V4mis1";"SILVA (only NR);Bacteria;Proteobacteria;Gammaproteobacteria;Beggiatoales;Beggiatoaceae;Candidatus Allobeggiatoa;";"100.0";"18.2";"1";"1";"1";"0";"0";"457182";"373893"
"V4mis1";"SILVA (only NR);Bacteria;Proteobacteria;Gammaproteobacteria;Beggiatoales;Beggiatoaceae;Candidatus Isobeggiatoa;";"100.0";"18.2";"7";"7";"7";"0";"0";"457176";"373887"
"V4mis1";"SILVA (only NR);Bacteria;Proteobacteria;Gammaproteobacteria;Beggiatoales;Beggiatoaceae;Candidatus Maribeggiatoa;";"100.0";"18.2";"2";"2";"2";"0";"0";"457181";"373892"
"V4mis1";"SILVA (only NR);Bacteria;Proteobacteria;Gammaproteobacteria;Beggiatoales;Beggiatoaceae;Candidatus Marithioploca;";"100.0";"18.2";"4";"4";"4";"0";"0";"457179";"373890"
"V4mis1";"SILVA (only NR);Bacteria;Proteobacteria;Gammaproteobacteria;Beggiatoales;Beggiatoaceae;Candidatus Marithrix;";"100.0";"18.2";"5";"5";"5";"0";"0";"457178";"373889"
"V4mis1";"SILVA (only NR);Bacteria;Proteobacteria;Gammaproteobacteria;Beggiatoales;Beggiatoaceae;Candidatus Parabeggiatoa;";"100.0";"18.2";"4";"4";"4";"0";"0";"457179";"373890"
"V4mis1";"SILVA (only NR);Bacteria;Proteobacteria;Gammaproteobacteria;Beggiatoales;Beggiatoaceae;Candidatus Thiophysa;";"100.0";"18.2";"1";"1";"1";"0";"0";"457182";"373893"
"V4mis1";"SILVA (only NR);Bacteria;Proteobacteria;Gammaproteobacteria;Beggiatoales;Beggiatoaceae;Candidatus Thiopilula;";"100.0";"18.2";"5";"5";"5";"0";"0";"457178";"373889"
"V4mis1";"SILVA (only NR);Bacteria;Proteobacteria;Gammaproteobacteria;Beggiatoales;Beggiatoaceae;Thioflexothrix;";"100.0";"18.2";"10";"10";"10";"0";"0";"457173";"373884"
"V4mis1";"SILVA (only NR);Bacteria;Proteobacteria;Gammaproteobacteria;Beggiatoales;Beggiatoaceae;Thiomargarita;";"100.0";"18.2";"10";"10";"10";"0";"0";"457173";"373884"
"V4mis1";"SILVA (only NR);Bacteria;Proteobacteria;Gammaproteobacteria;Beggiatoales;Beggiatoaceae;Thioploca;";"100.0";"18.2";"4";"4";"4";"0";"0";"457179";"373890"
"V4mis1";"SILVA (only NR);Bacteria;Proteobacteria;Gammaproteobacteria;Beggiatoales;Beggiatoaceae;uncultured;";"92.6";"18.2";"54";"54";"50";"4";"0";"457129";"373844"
"V4mis1";"SILVA (only NR);Bacteria;Proteobacteria;Gammaproteobacteria;Burkholderiales;";"93.4";"18.8";"20421";"20421";"19071";"1350";"0";"436762";"354823"
"V4mis1";"SILVA (only NR);Bacteria;Proteobacteria;Gammaproteobacteria;Burkholderiales;A21b;";"100.0";"18.2";"76";"76";"76";"0";"0";"457107";"373818"
"V4mis1";"SILVA (only NR);Bacteria;Proteobacteria;Gammaproteobacteria;Burkholderiales;Alcaligenaceae;";"93.9";"18.3";"1746";"1746";"1640";"106";"0";"455437";"372254"
"V4mis1";"SILVA (only NR);Bacteria;Proteobacteria;Gammaproteobacteria;Burkholderiales;Alcaligenaceae;Achromobacter;";"90.8";"18.2";"348";"348";"316";"32";"0";"456835";"373578"
"V4mis1";"SILVA (only NR);Bacteria;Proteobacteria;Gammaproteobacteria;Burkholderiales;Alcaligenaceae;Advenella;";"97.6";"18.2";"41";"41";"40";"1";"0";"457142";"373854"
"V4mis1";"SILVA (only NR);Bacteria;Proteobacteria;Gammaproteobacteria;Burkholderiales;Alcaligenaceae;Alcaligenes;";"86.2";"18.2";"269";"269";"232";"37";"0";"456914";"373662"
"V4mis1";"SILVA (only NR);Bacteria;Proteobacteria;Gammaproteobacteria;Burkholderiales;Alcaligenaceae;Ampullimonas;";"100.0";"18.2";"2";"2";"2";"0";"0";"457181";"373892"
"V4mis1";"SILVA (only NR);Bacteria;Proteobacteria;Gammaproteobacteria;Burkholderiales;Alcaligenaceae;Basilea;";"100.0";"18.2";"3";"3";"3";"0";"0";"457180";"373891"
"V4mis1";"SILVA (only NR);Bacteria;Proteobacteria;Gammaproteobacteria;Burkholderiales;Alcaligenaceae;Bordetella;";"98.3";"18.2";"532";"532";"523";"9";"0";"456651";"373371"
"V4mis1";"SILVA (only NR);Bacteria;Proteobacteria;Gammaproteobacteria;Burkholderiales;Alcaligenaceae;Brackiella;";"100.0";"18.2";"1";"1";"1";"0";"0";"457182";"373893"
"V4mis1";"SILVA (only NR);Bacteria;Proteobacteria;Gammaproteobacteria;Burkholderiales;Alcaligenaceae;Candidatus Kinetoplastibacterium;";"100.0";"18.2";"9";"9";"9";"0";"0";"457174";"373885"
"V4mis1";"SILVA (only NR);Bacteria;Proteobacteria;Gammaproteobacteria;Burkholderiales;Alcaligenaceae;Candidimonas;";"100.0";"18.2";"22";"22";"22";"0";"0";"457161";"373872"
"V4mis1";"SILVA (only NR);Bacteria;Proteobacteria;Gammaproteobacteria;Burkholderiales;Alcaligenaceae;Castellaniella;";"95.2";"18.2";"83";"83";"79";"4";"0";"457100";"373815"
"V4mis1";"SILVA (only NR);Bacteria;Proteobacteria;Gammaproteobacteria;Burkholderiales;Alcaligenaceae;Derxia;";"100.0";"18.2";"6";"6";"6";"0";"0";"457177";"373888"
"V4mis1";"SILVA (only NR);Bacteria;Proteobacteria;Gammaproteobacteria;Burkholderiales;Alcaligenaceae;Eoetvoesia;";"100.0";"18.2";"10";"10";"10";"0";"0";"457173";"373884"
"V4mis1";"SILVA (only NR);Bacteria;Proteobacteria;Gammaproteobacteria;Burkholderiales;Alcaligenaceae;GKS98 freshwater group;";"96.5";"18.2";"57";"57";"55";"2";"0";"457126";"373839"
"V4mis1";"SILVA (only NR);Bacteria;Proteobacteria;Gammaproteobacteria;Burkholderiales;Alcaligenaceae;Kerstersia;";"77.8";"18.2";"27";"27";"21";"6";"0";"457156";"373873"
"V4mis1";"SILVA (only NR);Bacteria;Proteobacteria;Gammaproteobacteria;Burkholderiales;Alcaligenaceae;Oligella;";"86.7";"18.2";"15";"15";"13";"2";"0";"457168";"373881"
"V4mis1";"SILVA (only NR);Bacteria;Proteobacteria;Gammaproteobacteria;Burkholderiales;Alcaligenaceae;Orrella;";"100.0";"18.2";"3";"3";"3";"0";"0";"457180";"373891"
"V4mis1";"SILVA (only NR);Bacteria;Proteobacteria;Gammaproteobacteria;Burkholderiales;Alcaligenaceae;Paenalcaligenes;";"95.0";"18.2";"20";"20";"19";"1";"0";"457163";"373875"
"V4mis1";"SILVA (only NR);Bacteria;Proteobacteria;Gammaproteobacteria;Burkholderiales;Alcaligenaceae;Paralcaligenes;";"100.0";"18.2";"4";"4";"4";"0";"0";"457179";"373890"
"V4mis1";"SILVA (only NR);Bacteria;Proteobacteria;Gammaproteobacteria;Burkholderiales;Alcaligenaceae;Parapusillimonas;";"96.3";"18.2";"54";"54";"52";"2";"0";"457129";"373842"
"V4mis1";"SILVA (only NR);Bacteria;Proteobacteria;Gammaproteobacteria;Burkholderiales;Alcaligenaceae;Parvibium;";"100.0";"18.2";"7";"7";"7";"0";"0";"457176";"373887"
"V4mis1";"SILVA (only NR);Bacteria;Proteobacteria;Gammaproteobacteria;Burkholderiales;Alcaligenaceae;Pelistega;";"100.0";"18.2";"10";"10";"10";"0";"0";"457173";"373884"
"V4mis1";"SILVA (only NR);Bacteria;Proteobacteria;Gammaproteobacteria;Burkholderiales;Alcaligenaceae;Pigmentiphaga;";"81.0";"18.2";"21";"21";"17";"4";"0";"457162";"373877"
"V4mis1";"SILVA (only NR);Bacteria;Proteobacteria;Gammaproteobacteria;Burkholderiales;Alcaligenaceae;Pusillimonas;";"95.2";"18.2";"63";"63";"60";"3";"0";"457120";"373834"
"V4mis1";"SILVA (only NR);Bacteria;Proteobacteria;Gammaproteobacteria;Burkholderiales;Alcaligenaceae;Taylorella;";"88.2";"18.2";"17";"17";"15";"2";"0";"457166";"373879"
"V4mis1";"SILVA (only NR);Bacteria;Proteobacteria;Gammaproteobacteria;Burkholderiales;Alcaligenaceae;Verticiella;";"97.4";"18.2";"39";"39";"38";"1";"0";"457144";"373856"
"V4mis1";"SILVA (only NR);Bacteria;Proteobacteria;Gammaproteobacteria;Burkholderiales;Alcaligenaceae;uncultured;";"100.0";"18.2";"54";"54";"54";"0";"0";"457129";"373840"
"V4mis1";"SILVA (only NR);Bacteria;Proteobacteria;Gammaproteobacteria;Burkholderiales;Aquaspirillaceae;";"93.8";"18.2";"48";"48";"45";"3";"0";"457135";"373849"
"V4mis1";"SILVA (only NR);Bacteria;Proteobacteria;Gammaproteobacteria;Burkholderiales;Aquaspirillaceae;Aquaspirillum;";"84.6";"18.2";"13";"13";"11";"2";"0";"457170";"373883"
"V4mis1";"SILVA (only NR);Bacteria;Proteobacteria;Gammaproteobacteria;Burkholderiales;Aquaspirillaceae;Laribacter;";"100.0";"18.2";"17";"17";"17";"0";"0";"457166";"373877"
"V4mis1";"SILVA (only NR);Bacteria;Proteobacteria;Gammaproteobacteria;Burkholderiales;Aquaspirillaceae;Microvirgula;";"100.0";"18.2";"11";"11";"11";"0";"0";"457172";"373883"
"V4mis1";"SILVA (only NR);Bacteria;Proteobacteria;Gammaproteobacteria;Burkholderiales;Aquaspirillaceae;Rivicola;";"83.3";"18.2";"6";"6";"5";"1";"0";"457177";"373889"
"V4mis1";"SILVA (only NR);Bacteria;Proteobacteria;Gammaproteobacteria;Burkholderiales;B1-7BS;";"93.8";"18.2";"81";"81";"76";"5";"0";"457102";"373818"
"V4mis1";"SILVA (only NR);Bacteria;Proteobacteria;Gammaproteobacteria;Burkholderiales;Burkholderiaceae;";"93.9";"18.3";"3609";"3609";"3389";"220";"0";"453574";"370505"
"V4mis1";"SILVA (only NR);Bacteria;Proteobacteria;Gammaproteobacteria;Burkholderiales;Burkholderiaceae;Burkholderia-Caballeronia-Paraburkholderia;";"94.8";"18.3";"2182";"2182";"2069";"113";"0";"455001";"371825"
"V4mis1";"SILVA (only NR);Bacteria;Proteobacteria;Gammaproteobacteria;Burkholderiales;Burkholderiaceae;Candidatus Glomeribacter;";"88.9";"18.2";"9";"9";"8";"1";"0";"457174";"373886"
"V4mis1";"SILVA (only NR);Bacteria;Proteobacteria;Gammaproteobacteria;Burkholderiales;Burkholderiaceae;Candidatus Tremblaya;";"100.0";"18.2";"37";"37";"37";"0";"0";"457146";"373857"
"V4mis1";"SILVA (only NR);Bacteria;Proteobacteria;Gammaproteobacteria;Burkholderiales;Burkholderiaceae;Cupriavidus;";"92.9";"18.2";"310";"310";"288";"22";"0";"456873";"373606"
"V4mis1";"SILVA (only NR);Bacteria;Proteobacteria;Gammaproteobacteria;Burkholderiales;Burkholderiaceae;Lautropia;";"93.3";"18.2";"194";"194";"181";"13";"0";"456989";"373713"
"V4mis1";"SILVA (only NR);Bacteria;Proteobacteria;Gammaproteobacteria;Burkholderiales;Burkholderiaceae;Limnobacter;";"86.1";"18.2";"202";"202";"174";"28";"0";"456981";"373720"
"V4mis1";"SILVA (only NR);Bacteria;Proteobacteria;Gammaproteobacteria;Burkholderiales;Burkholderiaceae;Mycoavidus;";"100.0";"18.2";"4";"4";"4";"0";"0";"457179";"373890"
"V4mis1";"SILVA (only NR);Bacteria;Proteobacteria;Gammaproteobacteria;Burkholderiales;Burkholderiaceae;Pandoraea;";"93.8";"18.2";"80";"80";"75";"5";"0";"457103";"373819"
"V4mis1";"SILVA (only NR);Bacteria;Proteobacteria;Gammaproteobacteria;Burkholderiales;Burkholderiaceae;Polynucleobacter;";"94.1";"18.2";"169";"169";"159";"10";"0";"457014";"373735"
"V4mis1";"SILVA (only NR);Bacteria;Proteobacteria;Gammaproteobacteria;Burkholderiales;Burkholderiaceae;Ralstonia;";"92.6";"18.2";"377";"377";"349";"28";"0";"456806";"373545"
"V4mis1";"SILVA (only NR);Bacteria;Proteobacteria;Gammaproteobacteria;Burkholderiales;Burkholderiaceae;Robbsia;";"100.0";"18.2";"15";"15";"15";"0";"0";"457168";"373879"
"V4mis1";"SILVA (only NR);Bacteria;Proteobacteria;Gammaproteobacteria;Burkholderiales;Burkholderiaceae;uncultured;";"100.0";"18.2";"29";"29";"29";"0";"0";"457154";"373865"
"V4mis1";"SILVA (only NR);Bacteria;Proteobacteria;Gammaproteobacteria;Burkholderiales;Burkholderiales Incertae Sedis;";"100.0";"18.2";"5";"5";"5";"0";"0";"457178";"373889"
"V4mis1";"SILVA (only NR);Bacteria;Proteobacteria;Gammaproteobacteria;Burkholderiales;Burkholderiales Incertae Sedis;2013Ark19i;";"100.0";"18.2";"3";"3";"3";"0";"0";"457180";"373891"
"V4mis1";"SILVA (only NR);Bacteria;Proteobacteria;Gammaproteobacteria;Burkholderiales;Burkholderiales Incertae Sedis;Candidatus Branchiomonas;";"100.0";"18.2";"2";"2";"2";"0";"0";"457181";"373892"
"V4mis1";"SILVA (only NR);Bacteria;Proteobacteria;Gammaproteobacteria;Burkholderiales;Candidatus Protistobacter;";"100.0";"18.2";"2";"2";"2";"0";"0";"457181";"373892"
"V4mis1";"SILVA (only NR);Bacteria;Proteobacteria;Gammaproteobacteria;Burkholderiales;Chitinibacteraceae;";"96.9";"18.2";"64";"64";"62";"2";"0";"457119";"373832"
"V4mis1";"SILVA (only NR);Bacteria;Proteobacteria;Gammaproteobacteria;Burkholderiales;Chitinibacteraceae;Amantichitinum;";"100.0";"18.2";"3";"3";"3";"0";"0";"457180";"373891"
"V4mis1";"SILVA (only NR);Bacteria;Proteobacteria;Gammaproteobacteria;Burkholderiales;Chitinibacteraceae;Andreprevotia;";"100.0";"18.2";"2";"2";"2";"0";"0";"457181";"373892"
"V4mis1";"SILVA (only NR);Bacteria;Proteobacteria;Gammaproteobacteria;Burkholderiales;Chitinibacteraceae;Chitinibacter;";"100.0";"18.2";"7";"7";"7";"0";"0";"457176";"373887"
"V4mis1";"SILVA (only NR);Bacteria;Proteobacteria;Gammaproteobacteria;Burkholderiales;Chitinibacteraceae;Chitinilyticum;";"100.0";"18.2";"2";"2";"2";"0";"0";"457181";"373892"
"V4mis1";"SILVA (only NR);Bacteria;Proteobacteria;Gammaproteobacteria;Burkholderiales;Chitinibacteraceae;Chitiniphilus;";"87.5";"18.2";"8";"8";"7";"1";"0";"457175";"373887"
"V4mis1";"SILVA (only NR);Bacteria;Proteobacteria;Gammaproteobacteria;Burkholderiales;Chitinibacteraceae;Deefgea;";"100.0";"18.2";"14";"14";"14";"0";"0";"457169";"373880"
"V4mis1";"SILVA (only NR);Bacteria;Proteobacteria;Gammaproteobacteria;Burkholderiales;Chitinibacteraceae;Formivibrio;";"100.0";"18.2";"4";"4";"4";"0";"0";"457179";"373890"
"V4mis1";"SILVA (only NR);Bacteria;Proteobacteria;Gammaproteobacteria;Burkholderiales;Chitinibacteraceae;Iodobacter;";"91.7";"18.2";"12";"12";"11";"1";"0";"457171";"373883"
"V4mis1";"SILVA (only NR);Bacteria;Proteobacteria;Gammaproteobacteria;Burkholderiales;Chitinibacteraceae;Jeongeupia;";"100.0";"18.2";"4";"4";"4";"0";"0";"457179";"373890"
"V4mis1";"SILVA (only NR);Bacteria;Proteobacteria;Gammaproteobacteria;Burkholderiales;Chitinibacteraceae;Silvimonas;";"100.0";"18.2";"6";"6";"6";"0";"0";"457177";"373888"
"V4mis1";"SILVA (only NR);Bacteria;Proteobacteria;Gammaproteobacteria;Burkholderiales;Chitinimonadaceae;";"100.0";"18.2";"34";"34";"34";"0";"0";"457149";"373860"
"V4mis1";"SILVA (only NR);Bacteria;Proteobacteria;Gammaproteobacteria;Burkholderiales;Chitinimonadaceae;Chitinimonas;";"100.0";"18.2";"25";"25";"25";"0";"0";"457158";"373869"
"V4mis1";"SILVA (only NR);Bacteria;Proteobacteria;Gammaproteobacteria;Burkholderiales;Chitinimonadaceae;Chitinivorax;";"100.0";"18.2";"9";"9";"9";"0";"0";"457174";"373885"
"V4mis1";"SILVA (only NR);Bacteria;Proteobacteria;Gammaproteobacteria;Burkholderiales;Chromobacteriaceae;";"90.3";"18.2";"185";"185";"167";"18";"0";"456998";"373727"
"V4mis1";"SILVA (only NR);Bacteria;Proteobacteria;Gammaproteobacteria;Burkholderiales;Chromobacteriaceae;Aquitalea;";"85.7";"18.2";"21";"21";"18";"3";"0";"457162";"373876"
"V4mis1";"SILVA (only NR);Bacteria;Proteobacteria;Gammaproteobacteria;Burkholderiales;Chromobacteriaceae;Chromobacterium;";"85.1";"18.2";"67";"67";"57";"10";"0";"457116";"373837"
"V4mis1";"SILVA (only NR);Bacteria;Proteobacteria;Gammaproteobacteria;Burkholderiales;Chromobacteriaceae;Crenobacter;";"100.0";"18.2";"11";"11";"11";"0";"0";"457172";"373883"
"V4mis1";"SILVA (only NR);Bacteria;Proteobacteria;Gammaproteobacteria;Burkholderiales;Chromobacteriaceae;Gulbenkiania;";"100.0";"18.2";"2";"2";"2";"0";"0";"457181";"373892"
"V4mis1";"SILVA (only NR);Bacteria;Proteobacteria;Gammaproteobacteria;Burkholderiales;Chromobacteriaceae;Paludibacterium;";"100.0";"18.2";"23";"23";"23";"0";"0";"457160";"373871"
"V4mis1";"SILVA (only NR);Bacteria;Proteobacteria;Gammaproteobacteria;Burkholderiales;Chromobacteriaceae;Pseudogulbenkiania;";"100.0";"18.2";"14";"14";"14";"0";"0";"457169";"373880"
"V4mis1";"SILVA (only NR);Bacteria;Proteobacteria;Gammaproteobacteria;Burkholderiales;Chromobacteriaceae;Vogesella;";"89.4";"18.2";"47";"47";"42";"5";"0";"457136";"373852"
"V4mis1";"SILVA (only NR);Bacteria;Proteobacteria;Gammaproteobacteria;Burkholderiales;Comamonadaceae;";"92.4";"18.3";"5187";"5187";"4793";"394";"0";"451996";"369101"
"V4mis1";"SILVA (only NR);Bacteria;Proteobacteria;Gammaproteobacteria;Burkholderiales;Comamonadaceae;Acidovorax;";"88.3";"18.2";"531";"531";"469";"62";"0";"456652";"373425"
"V4mis1";"SILVA (only NR);Bacteria;Proteobacteria;Gammaproteobacteria;Burkholderiales;Comamonadaceae;Alicycliphilus;";"100.0";"18.2";"43";"43";"43";"0";"0";"457140";"373851"
"V4mis1";"SILVA (only NR);Bacteria;Proteobacteria;Gammaproteobacteria;Burkholderiales;Comamonadaceae;Aquabacterium;";"78.0";"18.2";"287";"287";"224";"63";"0";"456896";"373670"
"V4mis1";"SILVA (only NR);Bacteria;Proteobacteria;Gammaproteobacteria;Burkholderiales;Comamonadaceae;Aquincola;";"100.0";"18.2";"1";"1";"1";"0";"0";"457182";"373893"
"V4mis1";"SILVA (only NR);Bacteria;Proteobacteria;Gammaproteobacteria;Burkholderiales;Comamonadaceae;Azohydromonas;";"100.0";"18.2";"20";"20";"20";"0";"0";"457163";"373874"
"V4mis1";"SILVA (only NR);Bacteria;Proteobacteria;Gammaproteobacteria;Burkholderiales;Comamonadaceae;Brachymonas;";"90.9";"18.2";"88";"88";"80";"8";"0";"457095";"373814"
"V4mis1";"SILVA (only NR);Bacteria;Proteobacteria;Gammaproteobacteria;Burkholderiales;Comamonadaceae;Caenimonas;";"100.0";"18.2";"63";"63";"63";"0";"0";"457120";"373831"
"V4mis1";"SILVA (only NR);Bacteria;Proteobacteria;Gammaproteobacteria;Burkholderiales;Comamonadaceae;Caldimonas;";"83.3";"18.2";"6";"6";"5";"1";"0";"457177";"373889"
"V4mis1";"SILVA (only NR);Bacteria;Proteobacteria;Gammaproteobacteria;Burkholderiales;Comamonadaceae;Candidatus Symbiobacter;";"93.6";"18.2";"47";"47";"44";"3";"0";"457136";"373850"
"V4mis1";"SILVA (only NR);Bacteria;Proteobacteria;Gammaproteobacteria;Burkholderiales;Comamonadaceae;Comamonas;";"92.3";"18.2";"483";"483";"446";"37";"0";"456700";"373448"
"V4mis1";"SILVA (only NR);Bacteria;Proteobacteria;Gammaproteobacteria;Burkholderiales;Comamonadaceae;Corticibacter;";"100.0";"18.2";"6";"6";"6";"0";"0";"457177";"373888"
"V4mis1";"SILVA (only NR);Bacteria;Proteobacteria;Gammaproteobacteria;Burkholderiales;Comamonadaceae;Curvibacter;";"94.3";"18.2";"88";"88";"83";"5";"0";"457095";"373811"
"V4mis1";"SILVA (only NR);Bacteria;Proteobacteria;Gammaproteobacteria;Burkholderiales;Comamonadaceae;Delftia;";"86.6";"18.2";"261";"261";"226";"35";"0";"456922";"373668"
"V4mis1";"SILVA (only NR);Bacteria;Proteobacteria;Gammaproteobacteria;Burkholderiales;Comamonadaceae;Diaphorobacter;";"85.5";"18.2";"186";"186";"159";"27";"0";"456997";"373735"
"V4mis1";"SILVA (only NR);Bacteria;Proteobacteria;Gammaproteobacteria;Burkholderiales;Comamonadaceae;Extensimonas;";"100.0";"18.2";"11";"11";"11";"0";"0";"457172";"373883"
"V4mis1";"SILVA (only NR);Bacteria;Proteobacteria;Gammaproteobacteria;Burkholderiales;Comamonadaceae;Giesbergeria;";"94.1";"18.2";"17";"17";"16";"1";"0";"457166";"373878"
"V4mis1";"SILVA (only NR);Bacteria;Proteobacteria;Gammaproteobacteria;Burkholderiales;Comamonadaceae;Hydrogenophaga;";"96.1";"18.2";"256";"256";"246";"10";"0";"456927";"373648"
"V4mis1";"SILVA (only NR);Bacteria;Proteobacteria;Gammaproteobacteria;Burkholderiales;Comamonadaceae;Hylemonella;";"100.0";"18.2";"12";"12";"12";"0";"0";"457171";"373882"
"V4mis1";"SILVA (only NR);Bacteria;Proteobacteria;Gammaproteobacteria;Burkholderiales;Comamonadaceae;Ideonella;";"91.1";"18.2";"56";"56";"51";"5";"0";"457127";"373843"
"V4mis1";"SILVA (only NR);Bacteria;Proteobacteria;Gammaproteobacteria;Burkholderiales;Comamonadaceae;Inhella;";"100.0";"18.2";"21";"21";"21";"0";"0";"457162";"373873"
"V4mis1";"SILVA (only NR);Bacteria;Proteobacteria;Gammaproteobacteria;Burkholderiales;Comamonadaceae;Kinneretia;";"100.0";"18.2";"6";"6";"6";"0";"0";"457177";"373888"
"V4mis1";"SILVA (only NR);Bacteria;Proteobacteria;Gammaproteobacteria;Burkholderiales;Comamonadaceae;Lampropedia;";"100.0";"18.2";"11";"11";"11";"0";"0";"457172";"373883"
"V4mis1";"SILVA (only NR);Bacteria;Proteobacteria;Gammaproteobacteria;Burkholderiales;Comamonadaceae;Leptothrix;";"97.8";"18.2";"90";"90";"88";"2";"0";"457093";"373806"
"V4mis1";"SILVA (only NR);Bacteria;Proteobacteria;Gammaproteobacteria;Burkholderiales;Comamonadaceae;Limnohabitans;";"97.4";"18.2";"234";"234";"228";"6";"0";"456949";"373666"
"V4mis1";"SILVA (only NR);Bacteria;Proteobacteria;Gammaproteobacteria;Burkholderiales;Comamonadaceae;Macromonas;";"75.0";"18.2";"4";"4";"3";"1";"0";"457179";"373891"
"V4mis1";"SILVA (only NR);Bacteria;Proteobacteria;Gammaproteobacteria;Burkholderiales;Comamonadaceae;Malikia;";"93.8";"18.2";"16";"16";"15";"1";"0";"457167";"373879"
"V4mis1";"SILVA (only NR);Bacteria;Proteobacteria;Gammaproteobacteria;Burkholderiales;Comamonadaceae;Methylibium;";"100.0";"18.2";"26";"26";"26";"0";"0";"457157";"373868"
"V4mis1";"SILVA (only NR);Bacteria;Proteobacteria;Gammaproteobacteria;Burkholderiales;Comamonadaceae;Mitsuaria;";"89.5";"18.2";"19";"19";"17";"2";"0";"457164";"373877"
"V4mis1";"SILVA (only NR);Bacteria;Proteobacteria;Gammaproteobacteria;Burkholderiales;Comamonadaceae;Ottowia;";"98.9";"18.2";"91";"91";"90";"1";"0";"457092";"373804"
"V4mis1";"SILVA (only NR);Bacteria;Proteobacteria;Gammaproteobacteria;Burkholderiales;Comamonadaceae;Paucibacter;";"100.0";"18.2";"49";"49";"49";"0";"0";"457134";"373845"
"V4mis1";"SILVA (only NR);Bacteria;Proteobacteria;Gammaproteobacteria;Burkholderiales;Comamonadaceae;Pelomonas;";"93.3";"18.2";"89";"89";"83";"6";"0";"457094";"373811"
"V4mis1";"SILVA (only NR);Bacteria;Proteobacteria;Gammaproteobacteria;Burkholderiales;Comamonadaceae;Piscinibacter;";"95.5";"18.2";"22";"22";"21";"1";"0";"457161";"373873"
"V4mis1";"SILVA (only NR);Bacteria;Proteobacteria;Gammaproteobacteria;Burkholderiales;Comamonadaceae;Polaromonas;";"93.2";"18.2";"191";"191";"178";"13";"0";"456992";"373716"
"V4mis1";"SILVA (only NR);Bacteria;Proteobacteria;Gammaproteobacteria;Burkholderiales;Comamonadaceae;Pseudacidovorax;";"100.0";"18.2";"3";"3";"3";"0";"0";"457180";"373891"
"V4mis1";"SILVA (only NR);Bacteria;Proteobacteria;Gammaproteobacteria;Burkholderiales;Comamonadaceae;Pseudorhodoferax;";"95.8";"18.2";"24";"24";"23";"1";"0";"457159";"373871"
"V4mis1";"SILVA (only NR);Bacteria;Proteobacteria;Gammaproteobacteria;Burkholderiales;Comamonadaceae;RS62 marine group;";"97.9";"18.2";"48";"48";"47";"1";"0";"457135";"373847"
"V4mis1";"SILVA (only NR);Bacteria;Proteobacteria;Gammaproteobacteria;Burkholderiales;Comamonadaceae;Ramlibacter;";"92.3";"18.2";"183";"183";"169";"14";"0";"457000";"373725"
"V4mis1";"SILVA (only NR);Bacteria;Proteobacteria;Gammaproteobacteria;Burkholderiales;Comamonadaceae;Rhizobacter;";"94.1";"18.2";"170";"170";"160";"10";"0";"457013";"373734"
"V4mis1";"SILVA (only NR);Bacteria;Proteobacteria;Gammaproteobacteria;Burkholderiales;Comamonadaceae;Rhodoferax;";"96.0";"18.2";"346";"346";"332";"14";"0";"456837";"373562"
"V4mis1";"SILVA (only NR);Bacteria;Proteobacteria;Gammaproteobacteria;Burkholderiales;Comamonadaceae;Rivibacter;";"100.0";"18.2";"13";"13";"13";"0";"0";"457170";"373881"
"V4mis1";"SILVA (only NR);Bacteria;Proteobacteria;Gammaproteobacteria;Burkholderiales;Comamonadaceae;Roseateles;";"91.3";"18.2";"23";"23";"21";"2";"0";"457160";"373873"
"V4mis1";"SILVA (only NR);Bacteria;Proteobacteria;Gammaproteobacteria;Burkholderiales;Comamonadaceae;Rubrivivax;";"96.3";"18.2";"27";"27";"26";"1";"0";"457156";"373868"
"V4mis1";"SILVA (only NR);Bacteria;Proteobacteria;Gammaproteobacteria;Burkholderiales;Comamonadaceae;Schlegelella;";"88.9";"18.2";"9";"9";"8";"1";"0";"457174";"373886"
"V4mis1";"SILVA (only NR);Bacteria;Proteobacteria;Gammaproteobacteria;Burkholderiales;Comamonadaceae;Simplicispira;";"96.7";"18.2";"60";"60";"58";"2";"0";"457123";"373836"
"V4mis1";"SILVA (only NR);Bacteria;Proteobacteria;Gammaproteobacteria;Burkholderiales;Comamonadaceae;Sphaerotilus;";"93.4";"18.2";"61";"61";"57";"4";"0";"457122";"373837"
"V4mis1";"SILVA (only NR);Bacteria;Proteobacteria;Gammaproteobacteria;Burkholderiales;Comamonadaceae;Tepidicella;";"66.7";"18.2";"3";"3";"2";"1";"0";"457180";"373892"
"V4mis1";"SILVA (only NR);Bacteria;Proteobacteria;Gammaproteobacteria;Burkholderiales;Comamonadaceae;Tepidimonas;";"100.0";"18.2";"29";"29";"29";"0";"0";"457154";"373865"
"V4mis1";"SILVA (only NR);Bacteria;Proteobacteria;Gammaproteobacteria;Burkholderiales;Comamonadaceae;Thiomonas;";"90.9";"18.2";"55";"55";"50";"5";"0";"457128";"373844"
"V4mis1";"SILVA (only NR);Bacteria;Proteobacteria;Gammaproteobacteria;Burkholderiales;Comamonadaceae;Tibeticola;";"100.0";"18.2";"5";"5";"5";"0";"0";"457178";"373889"
"V4mis1";"SILVA (only NR);Bacteria;Proteobacteria;Gammaproteobacteria;Burkholderiales;Comamonadaceae;Variovorax;";"93.7";"18.2";"222";"222";"208";"14";"0";"456961";"373686"
"V4mis1";"SILVA (only NR);Bacteria;Proteobacteria;Gammaproteobacteria;Burkholderiales;Comamonadaceae;Verminephrobacter;";"76.7";"18.2";"30";"30";"23";"7";"0";"457153";"373871"
"V4mis1";"SILVA (only NR);Bacteria;Proteobacteria;Gammaproteobacteria;Burkholderiales;Comamonadaceae;Xenophilus;";"77.8";"18.2";"9";"9";"7";"2";"0";"457174";"373887"
"V4mis1";"SILVA (only NR);Bacteria;Proteobacteria;Gammaproteobacteria;Burkholderiales;Comamonadaceae;Xylophilus;";"100.0";"18.2";"24";"24";"24";"0";"0";"457159";"373870"
"V4mis1";"SILVA (only NR);Bacteria;Proteobacteria;Gammaproteobacteria;Burkholderiales;Comamonadaceae;Zhizhongheella;";"100.0";"18.2";"4";"4";"4";"0";"0";"457179";"373890"
"V4mis1";"SILVA (only NR);Bacteria;Proteobacteria;Gammaproteobacteria;Burkholderiales;Comamonadaceae;[Polyangium] brachysporum group;";"100.0";"18.2";"9";"9";"9";"0";"0";"457174";"373885"
"V4mis1";"SILVA (only NR);Bacteria;Proteobacteria;Gammaproteobacteria;Burkholderiales;Comamonadaceae;uncultured;";"95.3";"18.2";"466";"466";"444";"22";"0";"456717";"373450"
"V4mis1";"SILVA (only NR);Bacteria;Proteobacteria;Gammaproteobacteria;Burkholderiales;EC94;";"55.0";"18.2";"20";"20";"11";"9";"0";"457163";"373883"
"V4mis1";"SILVA (only NR);Bacteria;Proteobacteria;Gammaproteobacteria;Burkholderiales;Ferrovaceae;";"77.4";"18.2";"31";"31";"24";"7";"0";"457152";"373870"
"V4mis1";"SILVA (only NR);Bacteria;Proteobacteria;Gammaproteobacteria;Burkholderiales;Ferrovaceae;Ferrovum;";"77.4";"18.2";"31";"31";"24";"7";"0";"457152";"373870"
"V4mis1";"SILVA (only NR);Bacteria;Proteobacteria;Gammaproteobacteria;Burkholderiales;Gallionellaceae;";"96.0";"18.2";"403";"403";"387";"16";"0";"456780";"373507"
"V4mis1";"SILVA (only NR);Bacteria;Proteobacteria;Gammaproteobacteria;Burkholderiales;Gallionellaceae;Candidatus Nitrotoga;";"95.7";"18.2";"47";"47";"45";"2";"0";"457136";"373849"
"V4mis1";"SILVA (only NR);Bacteria;Proteobacteria;Gammaproteobacteria;Burkholderiales;Gallionellaceae;Ferriphaselus;";"100.0";"18.2";"10";"10";"10";"0";"0";"457173";"373884"
"V4mis1";"SILVA (only NR);Bacteria;Proteobacteria;Gammaproteobacteria;Burkholderiales;Gallionellaceae;Gallionella;";"97.8";"18.2";"138";"138";"135";"3";"0";"457045";"373759"
"V4mis1";"SILVA (only NR);Bacteria;Proteobacteria;Gammaproteobacteria;Burkholderiales;Gallionellaceae;Sideroxydans;";"94.4";"18.2";"161";"161";"152";"9";"0";"457022";"373742"
"V4mis1";"SILVA (only NR);Bacteria;Proteobacteria;Gammaproteobacteria;Burkholderiales;Gallionellaceae;uncultured;";"95.5";"18.2";"44";"44";"42";"2";"0";"457139";"373852"
"V4mis1";"SILVA (only NR);Bacteria;Proteobacteria;Gammaproteobacteria;Burkholderiales;Hydrogenophilaceae;";"95.5";"18.2";"556";"556";"531";"25";"0";"456627";"373363"
"V4mis1";"SILVA (only NR);Bacteria;Proteobacteria;Gammaproteobacteria;Burkholderiales;Hydrogenophilaceae;Annwodia;";"100.0";"18.2";"4";"4";"4";"0";"0";"457179";"373890"
"V4mis1";"SILVA (only NR);Bacteria;Proteobacteria;Gammaproteobacteria;Burkholderiales;Hydrogenophilaceae;Hydrogenophilus;";"92.9";"18.2";"28";"28";"26";"2";"0";"457155";"373868"
"V4mis1";"SILVA (only NR);Bacteria;Proteobacteria;Gammaproteobacteria;Burkholderiales;Hydrogenophilaceae;Spirillum;";"100.0";"18.2";"4";"4";"4";"0";"0";"457179";"373890"
"V4mis1";"SILVA (only NR);Bacteria;Proteobacteria;Gammaproteobacteria;Burkholderiales;Hydrogenophilaceae;Sulfuritortus;";"100.0";"18.2";"5";"5";"5";"0";"0";"457178";"373889"
"V4mis1";"SILVA (only NR);Bacteria;Proteobacteria;Gammaproteobacteria;Burkholderiales;Hydrogenophilaceae;Tepidiphilus;";"82.6";"18.2";"23";"23";"19";"4";"0";"457160";"373875"
"V4mis1";"SILVA (only NR);Bacteria;Proteobacteria;Gammaproteobacteria;Burkholderiales;Hydrogenophilaceae;Thiobacillus;";"96.7";"18.2";"276";"276";"267";"9";"0";"456907";"373627"
"V4mis1";"SILVA (only NR);Bacteria;Proteobacteria;Gammaproteobacteria;Burkholderiales;Hydrogenophilaceae;Thiobacter;";"100.0";"18.2";"5";"5";"5";"0";"0";"457178";"373889"
"V4mis1";"SILVA (only NR);Bacteria;Proteobacteria;Gammaproteobacteria;Burkholderiales;Hydrogenophilaceae;uncultured;";"95.2";"18.2";"209";"209";"199";"10";"0";"456974";"373695"
"V4mis1";"SILVA (only NR);Bacteria;Proteobacteria;Gammaproteobacteria;Burkholderiales;Leeiaceae;";"93.3";"18.2";"15";"15";"14";"1";"0";"457168";"373880"
"V4mis1";"SILVA (only NR);Bacteria;Proteobacteria;Gammaproteobacteria;Burkholderiales;Leeiaceae;Leeia;";"93.3";"18.2";"15";"15";"14";"1";"0";"457168";"373880"
"V4mis1";"SILVA (only NR);Bacteria;Proteobacteria;Gammaproteobacteria;Burkholderiales;MWH-UniP1 aquatic group;";"94.3";"18.2";"70";"70";"66";"4";"0";"457113";"373828"
"V4mis1";"SILVA (only NR);Bacteria;Proteobacteria;Gammaproteobacteria;Burkholderiales;Methylophilaceae;";"93.5";"18.2";"553";"553";"517";"36";"0";"456630";"373377"
"V4mis1";"SILVA (only NR);Bacteria;Proteobacteria;Gammaproteobacteria;Burkholderiales;Methylophilaceae;Candidatus Methylopumilus;";"93.9";"18.2";"33";"33";"31";"2";"0";"457150";"373863"
"V4mis1";"SILVA (only NR);Bacteria;Proteobacteria;Gammaproteobacteria;Burkholderiales;Methylophilaceae;MM1;";"100.0";"18.2";"9";"9";"9";"0";"0";"457174";"373885"
"V4mis1";"SILVA (only NR);Bacteria;Proteobacteria;Gammaproteobacteria;Burkholderiales;Methylophilaceae;MM2;";"94.7";"18.2";"19";"19";"18";"1";"0";"457164";"373876"
"V4mis1";"SILVA (only NR);Bacteria;Proteobacteria;Gammaproteobacteria;Burkholderiales;Methylophilaceae;Methylobacillus;";"96.8";"18.2";"31";"31";"30";"1";"0";"457152";"373864"
"V4mis1";"SILVA (only NR);Bacteria;Proteobacteria;Gammaproteobacteria;Burkholderiales;Methylophilaceae;Methylophilus;";"84.8";"18.2";"112";"112";"95";"17";"0";"457071";"373799"
"V4mis1";"SILVA (only NR);Bacteria;Proteobacteria;Gammaproteobacteria;Burkholderiales;Methylophilaceae;Methylotenera;";"97.2";"18.2";"145";"145";"141";"4";"0";"457038";"373753"
"V4mis1";"SILVA (only NR);Bacteria;Proteobacteria;Gammaproteobacteria;Burkholderiales;Methylophilaceae;Methylovorus;";"100.0";"18.2";"7";"7";"7";"0";"0";"457176";"373887"
"V4mis1";"SILVA (only NR);Bacteria;Proteobacteria;Gammaproteobacteria;Burkholderiales;Methylophilaceae;OM43 clade;";"92.4";"18.2";"131";"131";"121";"10";"0";"457052";"373773"
"V4mis1";"SILVA (only NR);Bacteria;Proteobacteria;Gammaproteobacteria;Burkholderiales;Methylophilaceae;UBA6140;";"100.0";"18.2";"17";"17";"17";"0";"0";"457166";"373877"
"V4mis1";"SILVA (only NR);Bacteria;Proteobacteria;Gammaproteobacteria;Burkholderiales;Methylophilaceae;uncultured;";"97.9";"18.2";"47";"47";"46";"1";"0";"457136";"373848"
"V4mis1";"SILVA (only NR);Bacteria;Proteobacteria;Gammaproteobacteria;Burkholderiales;Neisseriaceae;";"90.2";"18.2";"1355";"1355";"1222";"133";"0";"455828";"372672"
"V4mis1";"SILVA (only NR);Bacteria;Proteobacteria;Gammaproteobacteria;Burkholderiales;Neisseriaceae;Alysiella;";"100.0";"18.2";"24";"24";"24";"0";"0";"457159";"373870"
"V4mis1";"SILVA (only NR);Bacteria;Proteobacteria;Gammaproteobacteria;Burkholderiales;Neisseriaceae;Bergeriella;";"50.0";"18.2";"4";"4";"2";"2";"0";"457179";"373892"
"V4mis1";"SILVA (only NR);Bacteria;Proteobacteria;Gammaproteobacteria;Burkholderiales;Neisseriaceae;Conchiformibius;";"95.2";"18.2";"42";"42";"40";"2";"0";"457141";"373854"
"V4mis1";"SILVA (only NR);Bacteria;Proteobacteria;Gammaproteobacteria;Burkholderiales;Neisseriaceae;Eikenella;";"100.0";"18.2";"20";"20";"20";"0";"0";"457163";"373874"
"V4mis1";"SILVA (only NR);Bacteria;Proteobacteria;Gammaproteobacteria;Burkholderiales;Neisseriaceae;Kingella;";"97.4";"18.2";"116";"116";"113";"3";"0";"457067";"373781"
"V4mis1";"SILVA (only NR);Bacteria;Proteobacteria;Gammaproteobacteria;Burkholderiales;Neisseriaceae;Neisseria;";"89.0";"18.2";"980";"980";"872";"108";"0";"456203";"373022"
"V4mis1";"SILVA (only NR);Bacteria;Proteobacteria;Gammaproteobacteria;Burkholderiales;Neisseriaceae;Simonsiella;";"91.7";"18.2";"12";"12";"11";"1";"0";"457171";"373883"
"V4mis1";"SILVA (only NR);Bacteria;Proteobacteria;Gammaproteobacteria;Burkholderiales;Neisseriaceae;Snodgrassella;";"100.0";"18.2";"22";"22";"22";"0";"0";"457161";"373872"
"V4mis1";"SILVA (only NR);Bacteria;Proteobacteria;Gammaproteobacteria;Burkholderiales;Neisseriaceae;Stenoxybacter;";"100.0";"18.2";"3";"3";"3";"0";"0";"457180";"373891"
"V4mis1";"SILVA (only NR);Bacteria;Proteobacteria;Gammaproteobacteria;Burkholderiales;Neisseriaceae;Uruburuella;";"100.0";"18.2";"4";"4";"4";"0";"0";"457179";"373890"
"V4mis1";"SILVA (only NR);Bacteria;Proteobacteria;Gammaproteobacteria;Burkholderiales;Neisseriaceae;Vitreoscilla;";"100.0";"18.2";"13";"13";"13";"0";"0";"457170";"373881"
"V4mis1";"SILVA (only NR);Bacteria;Proteobacteria;Gammaproteobacteria;Burkholderiales;Neisseriaceae;uncultured;";"85.0";"18.2";"113";"113";"96";"17";"0";"457070";"373798"
"V4mis1";"SILVA (only NR);Bacteria;Proteobacteria;Gammaproteobacteria;Burkholderiales;Nitrosomonadaceae;";"94.5";"18.2";"1071";"1071";"1012";"59";"0";"456112";"372882"
"V4mis1";"SILVA (only NR);Bacteria;Proteobacteria;Gammaproteobacteria;Burkholderiales;Nitrosomonadaceae;966-1;";"100.0";"18.2";"18";"18";"18";"0";"0";"457165";"373876"
"V4mis1";"SILVA (only NR);Bacteria;Proteobacteria;Gammaproteobacteria;Burkholderiales;Nitrosomonadaceae;DSSD61;";"100.0";"18.2";"9";"9";"9";"0";"0";"457174";"373885"
"V4mis1";"SILVA (only NR);Bacteria;Proteobacteria;Gammaproteobacteria;Burkholderiales;Nitrosomonadaceae;Ellin6067;";"94.8";"18.2";"250";"250";"237";"13";"0";"456933";"373657"
"V4mis1";"SILVA (only NR);Bacteria;Proteobacteria;Gammaproteobacteria;Burkholderiales;Nitrosomonadaceae;GOUTA6;";"100.0";"18.2";"40";"40";"40";"0";"0";"457143";"373854"
"V4mis1";"SILVA (only NR);Bacteria;Proteobacteria;Gammaproteobacteria;Burkholderiales;Nitrosomonadaceae;IS-44;";"98.7";"18.2";"77";"77";"76";"1";"0";"457106";"373818"
"V4mis1";"SILVA (only NR);Bacteria;Proteobacteria;Gammaproteobacteria;Burkholderiales;Nitrosomonadaceae;MND1;";"91.4";"18.2";"290";"290";"265";"25";"0";"456893";"373629"
"V4mis1";"SILVA (only NR);Bacteria;Proteobacteria;Gammaproteobacteria;Burkholderiales;Nitrosomonadaceae;Nitrosomonas;";"94.3";"18.2";"210";"210";"198";"12";"0";"456973";"373696"
"V4mis1";"SILVA (only NR);Bacteria;Proteobacteria;Gammaproteobacteria;Burkholderiales;Nitrosomonadaceae;Nitrosospira;";"91.8";"18.2";"49";"49";"45";"4";"0";"457134";"373849"
"V4mis1";"SILVA (only NR);Bacteria;Proteobacteria;Gammaproteobacteria;Burkholderiales;Nitrosomonadaceae;P3OB-51;";"100.0";"18.2";"3";"3";"3";"0";"0";"457180";"373891"
"V4mis1";"SILVA (only NR);Bacteria;Proteobacteria;Gammaproteobacteria;Burkholderiales;Nitrosomonadaceae;cr616;";"100.0";"18.2";"5";"5";"5";"0";"0";"457178";"373889"
"V4mis1";"SILVA (only NR);Bacteria;Proteobacteria;Gammaproteobacteria;Burkholderiales;Nitrosomonadaceae;mle1-7;";"95.7";"18.2";"69";"69";"66";"3";"0";"457114";"373828"
"V4mis1";"SILVA (only NR);Bacteria;Proteobacteria;Gammaproteobacteria;Burkholderiales;Nitrosomonadaceae;oc32;";"96.3";"18.2";"27";"27";"26";"1";"0";"457156";"373868"
"V4mis1";"SILVA (only NR);Bacteria;Proteobacteria;Gammaproteobacteria;Burkholderiales;Nitrosomonadaceae;uncultured;";"100.0";"18.2";"24";"24";"24";"0";"0";"457159";"373870"
"V4mis1";"SILVA (only NR);Bacteria;Proteobacteria;Gammaproteobacteria;Burkholderiales;Oxalobacteraceae;";"94.1";"18.3";"2275";"2275";"2140";"135";"0";"454908";"371754"
"V4mis1";"SILVA (only NR);Bacteria;Proteobacteria;Gammaproteobacteria;Burkholderiales;Oxalobacteraceae;Actimicrobium;";"100.0";"18.2";"12";"12";"12";"0";"0";"457171";"373882"
"V4mis1";"SILVA (only NR);Bacteria;Proteobacteria;Gammaproteobacteria;Burkholderiales;Oxalobacteraceae;CM1G08;";"100.0";"18.2";"7";"7";"7";"0";"0";"457176";"373887"
"V4mis1";"SILVA (only NR);Bacteria;Proteobacteria;Gammaproteobacteria;Burkholderiales;Oxalobacteraceae;Candidatus Nasuia;";"100.0";"18.2";"12";"12";"12";"0";"0";"457171";"373882"
"V4mis1";"SILVA (only NR);Bacteria;Proteobacteria;Gammaproteobacteria;Burkholderiales;Oxalobacteraceae;Candidatus Profftella;";"100.0";"18.2";"4";"4";"4";"0";"0";"457179";"373890"
"V4mis1";"SILVA (only NR);Bacteria;Proteobacteria;Gammaproteobacteria;Burkholderiales;Oxalobacteraceae;Candidatus Vidania;";"100.0";"18.2";"13";"13";"13";"0";"0";"457170";"373881"
"V4mis1";"SILVA (only NR);Bacteria;Proteobacteria;Gammaproteobacteria;Burkholderiales;Oxalobacteraceae;Candidatus Zinderia;";"100.0";"18.2";"21";"21";"21";"0";"0";"457162";"373873"
"V4mis1";"SILVA (only NR);Bacteria;Proteobacteria;Gammaproteobacteria;Burkholderiales;Oxalobacteraceae;Collimonas;";"100.0";"18.2";"31";"31";"31";"0";"0";"457152";"373863"
"V4mis1";"SILVA (only NR);Bacteria;Proteobacteria;Gammaproteobacteria;Burkholderiales;Oxalobacteraceae;Duganella;";"94.1";"18.2";"101";"101";"95";"6";"0";"457082";"373799"
"V4mis1";"SILVA (only NR);Bacteria;Proteobacteria;Gammaproteobacteria;Burkholderiales;Oxalobacteraceae;Glaciimonas;";"100.0";"18.2";"9";"9";"9";"0";"0";"457174";"373885"
"V4mis1";"SILVA (only NR);Bacteria;Proteobacteria;Gammaproteobacteria;Burkholderiales;Oxalobacteraceae;Herbaspirillum;";"95.1";"18.2";"144";"144";"137";"7";"0";"457039";"373757"
"V4mis1";"SILVA (only NR);Bacteria;Proteobacteria;Gammaproteobacteria;Burkholderiales;Oxalobacteraceae;Herminiimonas;";"92.5";"18.2";"93";"93";"86";"7";"0";"457090";"373808"
"V4mis1";"SILVA (only NR);Bacteria;Proteobacteria;Gammaproteobacteria;Burkholderiales;Oxalobacteraceae;Janthinobacterium;";"79.4";"18.2";"209";"209";"166";"43";"0";"456974";"373728"
"V4mis1";"SILVA (only NR);Bacteria;Proteobacteria;Gammaproteobacteria;Burkholderiales;Oxalobacteraceae;Massilia;";"95.9";"18.2";"1037";"1037";"994";"43";"0";"456146";"372900"
"V4mis1";"SILVA (only NR);Bacteria;Proteobacteria;Gammaproteobacteria;Burkholderiales;Oxalobacteraceae;Noviherbaspirillum;";"94.2";"18.2";"243";"243";"229";"14";"0";"456940";"373665"
"V4mis1";"SILVA (only NR);Bacteria;Proteobacteria;Gammaproteobacteria;Burkholderiales;Oxalobacteraceae;Oxalicibacterium;";"95.0";"18.2";"20";"20";"19";"1";"0";"457163";"373875"
"V4mis1";"SILVA (only NR);Bacteria;Proteobacteria;Gammaproteobacteria;Burkholderiales;Oxalobacteraceae;Oxalobacter;";"100.0";"18.2";"27";"27";"27";"0";"0";"457156";"373867"
"V4mis1";"SILVA (only NR);Bacteria;Proteobacteria;Gammaproteobacteria;Burkholderiales;Oxalobacteraceae;Paraherbaspirillum;";"100.0";"18.2";"2";"2";"2";"0";"0";"457181";"373892"
"V4mis1";"SILVA (only NR);Bacteria;Proteobacteria;Gammaproteobacteria;Burkholderiales;Oxalobacteraceae;Paucimonas;";"100.0";"18.2";"6";"6";"6";"0";"0";"457177";"373888"
"V4mis1";"SILVA (only NR);Bacteria;Proteobacteria;Gammaproteobacteria;Burkholderiales;Oxalobacteraceae;Pseudoduganella;";"87.5";"18.2";"8";"8";"7";"1";"0";"457175";"373887"
"V4mis1";"SILVA (only NR);Bacteria;Proteobacteria;Gammaproteobacteria;Burkholderiales;Oxalobacteraceae;Rugamonas;";"100.0";"18.2";"6";"6";"6";"0";"0";"457177";"373888"
"V4mis1";"SILVA (only NR);Bacteria;Proteobacteria;Gammaproteobacteria;Burkholderiales;Oxalobacteraceae;Telluria;";"100.0";"18.2";"2";"2";"2";"0";"0";"457181";"373892"
"V4mis1";"SILVA (only NR);Bacteria;Proteobacteria;Gammaproteobacteria;Burkholderiales;Oxalobacteraceae;Undibacterium;";"94.9";"18.2";"118";"118";"112";"6";"0";"457065";"373782"
"V4mis1";"SILVA (only NR);Bacteria;Proteobacteria;Gammaproteobacteria;Burkholderiales;Oxalobacteraceae;[Aquaspirillum] arcticum group;";"95.7";"18.2";"23";"23";"22";"1";"0";"457160";"373872"
"V4mis1";"SILVA (only NR);Bacteria;Proteobacteria;Gammaproteobacteria;Burkholderiales;Oxalobacteraceae;s3t2d-1089;";"75.0";"18.2";"4";"4";"3";"1";"0";"457179";"373891"
"V4mis1";"SILVA (only NR);Bacteria;Proteobacteria;Gammaproteobacteria;Burkholderiales;Oxalobacteraceae;uncultured;";"96.5";"18.2";"113";"113";"109";"4";"0";"457070";"373785"
"V4mis1";"SILVA (only NR);Bacteria;Proteobacteria;Gammaproteobacteria;Burkholderiales;Procabacteriaceae;";"90.0";"18.2";"10";"10";"9";"1";"0";"457173";"373885"
"V4mis1";"SILVA (only NR);Bacteria;Proteobacteria;Gammaproteobacteria;Burkholderiales;Procabacteriaceae;Procabacter;";"90.0";"18.2";"10";"10";"9";"1";"0";"457173";"373885"
"V4mis1";"SILVA (only NR);Bacteria;Proteobacteria;Gammaproteobacteria;Burkholderiales;Rhodocyclaceae;";"95.0";"18.3";"1708";"1708";"1622";"86";"0";"455475";"372272"
"V4mis1";"SILVA (only NR);Bacteria;Proteobacteria;Gammaproteobacteria;Burkholderiales;Rhodocyclaceae;Azoarcus;";"95.0";"18.2";"121";"121";"115";"6";"0";"457062";"373779"
"V4mis1";"SILVA (only NR);Bacteria;Proteobacteria;Gammaproteobacteria;Burkholderiales;Rhodocyclaceae;Azonexus;";"75.0";"18.2";"28";"28";"21";"7";"0";"457155";"373873"
"V4mis1";"SILVA (only NR);Bacteria;Proteobacteria;Gammaproteobacteria;Burkholderiales;Rhodocyclaceae;Azospira;";"100.0";"18.2";"52";"52";"52";"0";"0";"457131";"373842"
"V4mis1";"SILVA (only NR);Bacteria;Proteobacteria;Gammaproteobacteria;Burkholderiales;Rhodocyclaceae;Azovibrio;";"94.4";"18.2";"18";"18";"17";"1";"0";"457165";"373877"
"V4mis1";"SILVA (only NR);Bacteria;Proteobacteria;Gammaproteobacteria;Burkholderiales;Rhodocyclaceae;C39;";"96.8";"18.2";"31";"31";"30";"1";"0";"457152";"373864"
"V4mis1";"SILVA (only NR);Bacteria;Proteobacteria;Gammaproteobacteria;Burkholderiales;Rhodocyclaceae;Candidatus Accumulibacter;";"96.7";"18.2";"123";"123";"119";"4";"0";"457060";"373775"
"V4mis1";"SILVA (only NR);Bacteria;Proteobacteria;Gammaproteobacteria;Burkholderiales;Rhodocyclaceae;Dechlorobacter;";"100.0";"18.2";"27";"27";"27";"0";"0";"457156";"373867"
"V4mis1";"SILVA (only NR);Bacteria;Proteobacteria;Gammaproteobacteria;Burkholderiales;Rhodocyclaceae;Dechloromonas;";"92.3";"18.2";"181";"181";"167";"14";"0";"457002";"373727"
"V4mis1";"SILVA (only NR);Bacteria;Proteobacteria;Gammaproteobacteria;Burkholderiales;Rhodocyclaceae;Dechlorosoma;";"91.3";"18.2";"23";"23";"21";"2";"0";"457160";"373873"
"V4mis1";"SILVA (only NR);Bacteria;Proteobacteria;Gammaproteobacteria;Burkholderiales;Rhodocyclaceae;Denitratisoma;";"89.2";"18.2";"65";"65";"58";"7";"0";"457118";"373836"
"V4mis1";"SILVA (only NR);Bacteria;Proteobacteria;Gammaproteobacteria;Burkholderiales;Rhodocyclaceae;Denitromonas;";"100.0";"18.2";"16";"16";"16";"0";"0";"457167";"373878"
"V4mis1";"SILVA (only NR);Bacteria;Proteobacteria;Gammaproteobacteria;Burkholderiales;Rhodocyclaceae;Ferribacterium;";"97.0";"18.2";"33";"33";"32";"1";"0";"457150";"373862"
"V4mis1";"SILVA (only NR);Bacteria;Proteobacteria;Gammaproteobacteria;Burkholderiales;Rhodocyclaceae;Georgfuchsia;";"100.0";"18.2";"8";"8";"8";"0";"0";"457175";"373886"
"V4mis1";"SILVA (only NR);Bacteria;Proteobacteria;Gammaproteobacteria;Burkholderiales;Rhodocyclaceae;Methyloversatilis;";"92.9";"18.2";"42";"42";"39";"3";"0";"457141";"373855"
"V4mis1";"SILVA (only NR);Bacteria;Proteobacteria;Gammaproteobacteria;Burkholderiales;Rhodocyclaceae;Niveibacterium;";"100.0";"18.2";"4";"4";"4";"0";"0";"457179";"373890"
"V4mis1";"SILVA (only NR);Bacteria;Proteobacteria;Gammaproteobacteria;Burkholderiales;Rhodocyclaceae;Propionivibrio;";"92.1";"18.2";"76";"76";"70";"6";"0";"457107";"373824"
"V4mis1";"SILVA (only NR);Bacteria;Proteobacteria;Gammaproteobacteria;Burkholderiales;Rhodocyclaceae;Quatrionicoccus;";"100.0";"18.2";"3";"3";"3";"0";"0";"457180";"373891"
"V4mis1";"SILVA (only NR);Bacteria;Proteobacteria;Gammaproteobacteria;Burkholderiales;Rhodocyclaceae;Rhodocyclus;";"100.0";"18.2";"4";"4";"4";"0";"0";"457179";"373890"
"V4mis1";"SILVA (only NR);Bacteria;Proteobacteria;Gammaproteobacteria;Burkholderiales;Rhodocyclaceae;Sterolibacterium;";"100.0";"18.2";"28";"28";"28";"0";"0";"457155";"373866"
"V4mis1";"SILVA (only NR);Bacteria;Proteobacteria;Gammaproteobacteria;Burkholderiales;Rhodocyclaceae;Sulfurisoma;";"100.0";"18.2";"6";"6";"6";"0";"0";"457177";"373888"
"V4mis1";"SILVA (only NR);Bacteria;Proteobacteria;Gammaproteobacteria;Burkholderiales;Rhodocyclaceae;Sulfuritalea;";"94.3";"18.2";"159";"159";"150";"9";"0";"457024";"373744"
"V4mis1";"SILVA (only NR);Bacteria;Proteobacteria;Gammaproteobacteria;Burkholderiales;Rhodocyclaceae;Thauera;";"97.1";"18.2";"209";"209";"203";"6";"0";"456974";"373691"
"V4mis1";"SILVA (only NR);Bacteria;Proteobacteria;Gammaproteobacteria;Burkholderiales;Rhodocyclaceae;Uliginosibacterium;";"91.4";"18.2";"35";"35";"32";"3";"0";"457148";"373862"
"V4mis1";"SILVA (only NR);Bacteria;Proteobacteria;Gammaproteobacteria;Burkholderiales;Rhodocyclaceae;Z-35;";"100.0";"18.2";"20";"20";"20";"0";"0";"457163";"373874"
"V4mis1";"SILVA (only NR);Bacteria;Proteobacteria;Gammaproteobacteria;Burkholderiales;Rhodocyclaceae;Zoogloea;";"92.6";"18.2";"136";"136";"126";"10";"0";"457047";"373768"
"V4mis1";"SILVA (only NR);Bacteria;Proteobacteria;Gammaproteobacteria;Burkholderiales;Rhodocyclaceae;uncultured;";"98.0";"18.2";"245";"245";"240";"5";"0";"456938";"373654"
"V4mis1";"SILVA (only NR);Bacteria;Proteobacteria;Gammaproteobacteria;Burkholderiales;SC-I-84;";"95.1";"18.2";"367";"367";"349";"18";"0";"456816";"373545"
"V4mis1";"SILVA (only NR);Bacteria;Proteobacteria;Gammaproteobacteria;Burkholderiales;Sulfuricellaceae;";"91.1";"18.2";"157";"157";"143";"14";"0";"457026";"373751"
"V4mis1";"SILVA (only NR);Bacteria;Proteobacteria;Gammaproteobacteria;Burkholderiales;Sulfuricellaceae;Ferritrophicum;";"80.9";"18.2";"68";"68";"55";"13";"0";"457115";"373839"
"V4mis1";"SILVA (only NR);Bacteria;Proteobacteria;Gammaproteobacteria;Burkholderiales;Sulfuricellaceae;Sulfuricella;";"100.0";"18.2";"19";"19";"19";"0";"0";"457164";"373875"
"V4mis1";"SILVA (only NR);Bacteria;Proteobacteria;Gammaproteobacteria;Burkholderiales;Sulfuricellaceae;Sulfuriferula;";"98.1";"18.2";"52";"52";"51";"1";"0";"457131";"373843"
"V4mis1";"SILVA (only NR);Bacteria;Proteobacteria;Gammaproteobacteria;Burkholderiales;Sulfuricellaceae;Sulfurirhabdus;";"100.0";"18.2";"17";"17";"17";"0";"0";"457166";"373877"
"V4mis1";"SILVA (only NR);Bacteria;Proteobacteria;Gammaproteobacteria;Burkholderiales;Sutterellaceae;";"93.6";"18.2";"388";"388";"363";"25";"0";"456795";"373531"
"V4mis1";"SILVA (only NR);Bacteria;Proteobacteria;Gammaproteobacteria;Burkholderiales;Sutterellaceae;AAP99;";"96.9";"18.2";"32";"32";"31";"1";"0";"457151";"373863"
"V4mis1";"SILVA (only NR);Bacteria;Proteobacteria;Gammaproteobacteria;Burkholderiales;Sutterellaceae;Parasutterella;";"91.5";"18.2";"129";"129";"118";"11";"0";"457054";"373776"
"V4mis1";"SILVA (only NR);Bacteria;Proteobacteria;Gammaproteobacteria;Burkholderiales;Sutterellaceae;Sutterella;";"94.5";"18.2";"110";"110";"104";"6";"0";"457073";"373790"
"V4mis1";"SILVA (only NR);Bacteria;Proteobacteria;Gammaproteobacteria;Burkholderiales;Sutterellaceae;uncultured;";"94.0";"18.2";"116";"116";"109";"7";"0";"457067";"373785"
"V4mis1";"SILVA (only NR);Bacteria;Proteobacteria;Gammaproteobacteria;Burkholderiales;T34;";"91.3";"18.2";"23";"23";"21";"2";"0";"457160";"373873"
"V4mis1";"SILVA (only NR);Bacteria;Proteobacteria;Gammaproteobacteria;Burkholderiales;TRA3-20;";"91.8";"18.2";"355";"355";"326";"29";"0";"456828";"373568"
"V4mis1";"SILVA (only NR);Bacteria;Proteobacteria;Gammaproteobacteria;Burkholderiales;uncultured;";"95.5";"18.2";"22";"22";"21";"1";"0";"457161";"373873"
"V4mis1";"SILVA (only NR);Bacteria;Proteobacteria;Gammaproteobacteria;CCD24;";"91.3";"18.2";"69";"69";"63";"6";"0";"457114";"373831"
"V4mis1";"SILVA (only NR);Bacteria;Proteobacteria;Gammaproteobacteria;CCM19a;";"94.7";"18.2";"19";"19";"18";"1";"0";"457164";"373876"
"V4mis1";"SILVA (only NR);Bacteria;Proteobacteria;Gammaproteobacteria;CH2b56;";"85.7";"18.2";"7";"7";"6";"1";"0";"457176";"373888"
"V4mis1";"SILVA (only NR);Bacteria;Proteobacteria;Gammaproteobacteria;CHAB-XI-27;";"90.0";"18.2";"10";"10";"9";"1";"0";"457173";"373885"
"V4mis1";"SILVA (only NR);Bacteria;Proteobacteria;Gammaproteobacteria;Cardiobacteriales;";"96.3";"18.2";"438";"438";"422";"16";"0";"456745";"373472"
"V4mis1";"SILVA (only NR);Bacteria;Proteobacteria;Gammaproteobacteria;Cardiobacteriales;Cardiobacteriaceae;";"96.1";"18.2";"415";"415";"399";"16";"0";"456768";"373495"
"V4mis1";"SILVA (only NR);Bacteria;Proteobacteria;Gammaproteobacteria;Cardiobacteriales;Cardiobacteriaceae;Cardiobacterium;";"92.9";"18.2";"113";"113";"105";"8";"0";"457070";"373789"
"V4mis1";"SILVA (only NR);Bacteria;Proteobacteria;Gammaproteobacteria;Cardiobacteriales;Cardiobacteriaceae;Dichelobacter;";"100.0";"18.2";"4";"4";"4";"0";"0";"457179";"373890"
"V4mis1";"SILVA (only NR);Bacteria;Proteobacteria;Gammaproteobacteria;Cardiobacteriales;Cardiobacteriaceae;Suttonella;";"100.0";"18.2";"10";"10";"10";"0";"0";"457173";"373884"
"V4mis1";"SILVA (only NR);Bacteria;Proteobacteria;Gammaproteobacteria;Cardiobacteriales;Cardiobacteriaceae;uncultured;";"97.2";"18.2";"287";"287";"279";"8";"0";"456896";"373615"
"V4mis1";"SILVA (only NR);Bacteria;Proteobacteria;Gammaproteobacteria;Cardiobacteriales;Wohlfahrtiimonadaceae;";"100.0";"18.2";"22";"22";"22";"0";"0";"457161";"373872"
"V4mis1";"SILVA (only NR);Bacteria;Proteobacteria;Gammaproteobacteria;Cardiobacteriales;Wohlfahrtiimonadaceae;Ignatzschineria;";"100.0";"18.2";"13";"13";"13";"0";"0";"457170";"373881"
"V4mis1";"SILVA (only NR);Bacteria;Proteobacteria;Gammaproteobacteria;Cardiobacteriales;Wohlfahrtiimonadaceae;Koukoulia;";"100.0";"18.2";"2";"2";"2";"0";"0";"457181";"373892"
"V4mis1";"SILVA (only NR);Bacteria;Proteobacteria;Gammaproteobacteria;Cardiobacteriales;Wohlfahrtiimonadaceae;Wohlfahrtiimonas;";"100.0";"18.2";"6";"6";"6";"0";"0";"457177";"373888"
"V4mis1";"SILVA (only NR);Bacteria;Proteobacteria;Gammaproteobacteria;Chromatiales;";"93.5";"18.2";"494";"494";"462";"32";"0";"456689";"373432"
"V4mis1";"SILVA (only NR);Bacteria;Proteobacteria;Gammaproteobacteria;Chromatiales;Chromatiaceae;";"92.4";"18.2";"356";"356";"329";"27";"0";"456827";"373565"
"V4mis1";"SILVA (only NR);Bacteria;Proteobacteria;Gammaproteobacteria;Chromatiales;Chromatiaceae;Achromatium;";"100.0";"18.2";"16";"16";"16";"0";"0";"457167";"373878"
"V4mis1";"SILVA (only NR);Bacteria;Proteobacteria;Gammaproteobacteria;Chromatiales;Chromatiaceae;Allochromatium;";"95.2";"18.2";"21";"21";"20";"1";"0";"457162";"373874"
"V4mis1";"SILVA (only NR);Bacteria;Proteobacteria;Gammaproteobacteria;Chromatiales;Chromatiaceae;Candidatus Thiobios;";"97.0";"18.2";"33";"33";"32";"1";"0";"457150";"373862"
"V4mis1";"SILVA (only NR);Bacteria;Proteobacteria;Gammaproteobacteria;Chromatiales;Chromatiaceae;Chromatium;";"100.0";"18.2";"12";"12";"12";"0";"0";"457171";"373882"
"V4mis1";"SILVA (only NR);Bacteria;Proteobacteria;Gammaproteobacteria;Chromatiales;Chromatiaceae;Halochromatium;";"88.4";"18.2";"69";"69";"61";"8";"0";"457114";"373833"
"V4mis1";"SILVA (only NR);Bacteria;Proteobacteria;Gammaproteobacteria;Chromatiales;Chromatiaceae;Isochromatium;";"100.0";"18.2";"1";"1";"1";"0";"0";"457182";"373893"
"V4mis1";"SILVA (only NR);Bacteria;Proteobacteria;Gammaproteobacteria;Chromatiales;Chromatiaceae;Lamprocystis;";"100.0";"18.2";"13";"13";"13";"0";"0";"457170";"373881"
"V4mis1";"SILVA (only NR);Bacteria;Proteobacteria;Gammaproteobacteria;Chromatiales;Chromatiaceae;Marichromatium;";"81.3";"18.2";"16";"16";"13";"3";"0";"457167";"373881"
"V4mis1";"SILVA (only NR);Bacteria;Proteobacteria;Gammaproteobacteria;Chromatiales;Chromatiaceae;Phaeochromatium;";"50.0";"18.2";"2";"2";"1";"1";"0";"457181";"373893"
"V4mis1";"SILVA (only NR);Bacteria;Proteobacteria;Gammaproteobacteria;Chromatiales;Chromatiaceae;Rhabdochromatium;";"100.0";"18.2";"2";"2";"2";"0";"0";"457181";"373892"
"V4mis1";"SILVA (only NR);Bacteria;Proteobacteria;Gammaproteobacteria;Chromatiales;Chromatiaceae;Thioalkalicoccus;";"100.0";"18.2";"3";"3";"3";"0";"0";"457180";"373891"
"V4mis1";"SILVA (only NR);Bacteria;Proteobacteria;Gammaproteobacteria;Chromatiales;Chromatiaceae;Thiobaca;";"100.0";"18.2";"3";"3";"3";"0";"0";"457180";"373891"
"V4mis1";"SILVA (only NR);Bacteria;Proteobacteria;Gammaproteobacteria;Chromatiales;Chromatiaceae;Thiocapsa;";"100.0";"18.2";"24";"24";"24";"0";"0";"457159";"373870"
"V4mis1";"SILVA (only NR);Bacteria;Proteobacteria;Gammaproteobacteria;Chromatiales;Chromatiaceae;Thiococcus;";"100.0";"18.2";"3";"3";"3";"0";"0";"457180";"373891"
"V4mis1";"SILVA (only NR);Bacteria;Proteobacteria;Gammaproteobacteria;Chromatiales;Chromatiaceae;Thiocystis;";"94.1";"18.2";"17";"17";"16";"1";"0";"457166";"373878"
"V4mis1";"SILVA (only NR);Bacteria;Proteobacteria;Gammaproteobacteria;Chromatiales;Chromatiaceae;Thiodictyon;";"100.0";"18.2";"4";"4";"4";"0";"0";"457179";"373890"
"V4mis1";"SILVA (only NR);Bacteria;Proteobacteria;Gammaproteobacteria;Chromatiales;Chromatiaceae;Thioflavicoccus;";"100.0";"18.2";"4";"4";"4";"0";"0";"457179";"373890"
"V4mis1";"SILVA (only NR);Bacteria;Proteobacteria;Gammaproteobacteria;Chromatiales;Chromatiaceae;Thiohalobacter;";"100.0";"18.2";"3";"3";"3";"0";"0";"457180";"373891"
"V4mis1";"SILVA (only NR);Bacteria;Proteobacteria;Gammaproteobacteria;Chromatiales;Chromatiaceae;Thiohalocapsa;";"81.0";"18.2";"58";"58";"47";"11";"0";"457125";"373847"
"V4mis1";"SILVA (only NR);Bacteria;Proteobacteria;Gammaproteobacteria;Chromatiales;Chromatiaceae;Thiolamprovum;";"100.0";"18.2";"3";"3";"3";"0";"0";"457180";"373891"
"V4mis1";"SILVA (only NR);Bacteria;Proteobacteria;Gammaproteobacteria;Chromatiales;Chromatiaceae;Thiophaeococcus;";"100.0";"18.2";"6";"6";"6";"0";"0";"457177";"373888"
"V4mis1";"SILVA (only NR);Bacteria;Proteobacteria;Gammaproteobacteria;Chromatiales;Chromatiaceae;Thiorhodococcus;";"100.0";"18.2";"11";"11";"11";"0";"0";"457172";"373883"
"V4mis1";"SILVA (only NR);Bacteria;Proteobacteria;Gammaproteobacteria;Chromatiales;Chromatiaceae;Thiorhodovibrio;";"100.0";"18.2";"5";"5";"5";"0";"0";"457178";"373889"
"V4mis1";"SILVA (only NR);Bacteria;Proteobacteria;Gammaproteobacteria;Chromatiales;Chromatiaceae;uncultured;";"96.2";"18.2";"26";"26";"25";"1";"0";"457157";"373869"
"V4mis1";"SILVA (only NR);Bacteria;Proteobacteria;Gammaproteobacteria;Chromatiales;Sedimenticolaceae;";"96.4";"18.2";"138";"138";"133";"5";"0";"457045";"373761"
"V4mis1";"SILVA (only NR);Bacteria;Proteobacteria;Gammaproteobacteria;Chromatiales;Sedimenticolaceae;Candidatus Thiodiazotropha;";"94.4";"18.2";"18";"18";"17";"1";"0";"457165";"373877"
"V4mis1";"SILVA (only NR);Bacteria;Proteobacteria;Gammaproteobacteria;Chromatiales;Sedimenticolaceae;Sedimenticola;";"98.6";"18.2";"70";"70";"69";"1";"0";"457113";"373825"
"V4mis1";"SILVA (only NR);Bacteria;Proteobacteria;Gammaproteobacteria;Chromatiales;Sedimenticolaceae;uncultured;";"94.0";"18.2";"50";"50";"47";"3";"0";"457133";"373847"
"V4mis1";"SILVA (only NR);Bacteria;Proteobacteria;Gammaproteobacteria;Competibacterales;";"96.8";"18.2";"125";"125";"121";"4";"0";"457058";"373773"
"V4mis1";"SILVA (only NR);Bacteria;Proteobacteria;Gammaproteobacteria;Competibacterales;Competibacteraceae;";"96.8";"18.2";"125";"125";"121";"4";"0";"457058";"373773"
"V4mis1";"SILVA (only NR);Bacteria;Proteobacteria;Gammaproteobacteria;Competibacterales;Competibacteraceae;Candidatus Competibacter;";"96.8";"18.2";"95";"95";"92";"3";"0";"457088";"373802"
"V4mis1";"SILVA (only NR);Bacteria;Proteobacteria;Gammaproteobacteria;Competibacterales;Competibacteraceae;Candidatus Contendobacter;";"95.7";"18.2";"23";"23";"22";"1";"0";"457160";"373872"
"V4mis1";"SILVA (only NR);Bacteria;Proteobacteria;Gammaproteobacteria;Competibacterales;Competibacteraceae;Plasticicumulans;";"100.0";"18.2";"7";"7";"7";"0";"0";"457176";"373887"
"V4mis1";"SILVA (only NR);Bacteria;Proteobacteria;Gammaproteobacteria;Coxiellales;";"97.2";"18.2";"387";"387";"376";"11";"0";"456796";"373518"
"V4mis1";"SILVA (only NR);Bacteria;Proteobacteria;Gammaproteobacteria;Coxiellales;Coxiellaceae;";"97.2";"18.2";"387";"387";"376";"11";"0";"456796";"373518"
"V4mis1";"SILVA (only NR);Bacteria;Proteobacteria;Gammaproteobacteria;Coxiellales;Coxiellaceae;Coxiella;";"97.2";"18.2";"387";"387";"376";"11";"0";"456796";"373518"
"V4mis1";"SILVA (only NR);Bacteria;Proteobacteria;Gammaproteobacteria;D90;";"100.0";"18.2";"10";"10";"10";"0";"0";"457173";"373884"
"V4mis1";"SILVA (only NR);Bacteria;Proteobacteria;Gammaproteobacteria;Diplorickettsiales;";"96.0";"18.2";"446";"446";"428";"18";"0";"456737";"373466"
"V4mis1";"SILVA (only NR);Bacteria;Proteobacteria;Gammaproteobacteria;Diplorickettsiales;Diplorickettsiaceae;";"96.0";"18.2";"446";"446";"428";"18";"0";"456737";"373466"
"V4mis1";"SILVA (only NR);Bacteria;Proteobacteria;Gammaproteobacteria;Diplorickettsiales;Diplorickettsiaceae;Aquicella;";"95.2";"18.2";"167";"167";"159";"8";"0";"457016";"373735"
"V4mis1";"SILVA (only NR);Bacteria;Proteobacteria;Gammaproteobacteria;Diplorickettsiales;Diplorickettsiaceae;Diplorickettsia;";"85.7";"18.2";"7";"7";"6";"1";"0";"457176";"373888"
"V4mis1";"SILVA (only NR);Bacteria;Proteobacteria;Gammaproteobacteria;Diplorickettsiales;Diplorickettsiaceae;Rickettsiella;";"100.0";"18.2";"34";"34";"34";"0";"0";"457149";"373860"
"V4mis1";"SILVA (only NR);Bacteria;Proteobacteria;Gammaproteobacteria;Diplorickettsiales;Diplorickettsiaceae;uncultured;";"96.1";"18.2";"233";"233";"224";"9";"0";"456950";"373670"
"V4mis1";"SILVA (only NR);Bacteria;Proteobacteria;Gammaproteobacteria;EC3;";"98.2";"18.2";"55";"55";"54";"1";"0";"457128";"373840"
"V4mis1";"SILVA (only NR);Bacteria;Proteobacteria;Gammaproteobacteria;EPR3968-O8a-Bc78;";"87.5";"18.2";"56";"56";"49";"7";"0";"457127";"373845"
"V4mis1";"SILVA (only NR);Bacteria;Proteobacteria;Gammaproteobacteria;EV818SWSAP88;";"95.7";"18.2";"23";"23";"22";"1";"0";"457160";"373872"
"V4mis1";"SILVA (only NR);Bacteria;Proteobacteria;Gammaproteobacteria;Ectothiorhodospirales;";"94.3";"18.2";"473";"473";"446";"27";"0";"456710";"373448"
"V4mis1";"SILVA (only NR);Bacteria;Proteobacteria;Gammaproteobacteria;Ectothiorhodospirales;Acidihalobacteraceae;";"100.0";"18.2";"12";"12";"12";"0";"0";"457171";"373882"
"V4mis1";"SILVA (only NR);Bacteria;Proteobacteria;Gammaproteobacteria;Ectothiorhodospirales;Acidihalobacteraceae;Acidihalobacter;";"100.0";"18.2";"12";"12";"12";"0";"0";"457171";"373882"
"V4mis1";"SILVA (only NR);Bacteria;Proteobacteria;Gammaproteobacteria;Ectothiorhodospirales;Ectothiorhodospiraceae;";"92.9";"18.2";"311";"311";"289";"22";"0";"456872";"373605"
"V4mis1";"SILVA (only NR);Bacteria;Proteobacteria;Gammaproteobacteria;Ectothiorhodospirales;Ectothiorhodospiraceae;Ectothiorhodosinus;";"100.0";"18.2";"1";"1";"1";"0";"0";"457182";"373893"
"V4mis1";"SILVA (only NR);Bacteria;Proteobacteria;Gammaproteobacteria;Ectothiorhodospirales;Ectothiorhodospiraceae;Ectothiorhodospira;";"90.0";"18.2";"20";"20";"18";"2";"0";"457163";"373876"
"V4mis1";"SILVA (only NR);Bacteria;Proteobacteria;Gammaproteobacteria;Ectothiorhodospirales;Ectothiorhodospiraceae;Halofilum;";"90.9";"18.2";"22";"22";"20";"2";"0";"457161";"373874"
"V4mis1";"SILVA (only NR);Bacteria;Proteobacteria;Gammaproteobacteria;Ectothiorhodospirales;Ectothiorhodospiraceae;Thioalbus;";"100.0";"18.2";"5";"5";"5";"0";"0";"457178";"373889"
"V4mis1";"SILVA (only NR);Bacteria;Proteobacteria;Gammaproteobacteria;Ectothiorhodospirales;Ectothiorhodospiraceae;Thioalkalivibrio;";"95.1";"18.2";"41";"41";"39";"2";"0";"457142";"373855"
"V4mis1";"SILVA (only NR);Bacteria;Proteobacteria;Gammaproteobacteria;Ectothiorhodospirales;Ectothiorhodospiraceae;Thiogranum;";"84.8";"18.2";"66";"66";"56";"10";"0";"457117";"373838"
"V4mis1";"SILVA (only NR);Bacteria;Proteobacteria;Gammaproteobacteria;Ectothiorhodospirales;Ectothiorhodospiraceae;Thiohalomonas;";"100.0";"18.2";"10";"10";"10";"0";"0";"457173";"373884"
"V4mis1";"SILVA (only NR);Bacteria;Proteobacteria;Gammaproteobacteria;Ectothiorhodospirales;Ectothiorhodospiraceae;Thiohalospira;";"100.0";"18.2";"6";"6";"6";"0";"0";"457177";"373888"
"V4mis1";"SILVA (only NR);Bacteria;Proteobacteria;Gammaproteobacteria;Ectothiorhodospirales;Ectothiorhodospiraceae;Thiorhodospira;";"100.0";"18.2";"3";"3";"3";"0";"0";"457180";"373891"
"V4mis1";"SILVA (only NR);Bacteria;Proteobacteria;Gammaproteobacteria;Ectothiorhodospirales;Ectothiorhodospiraceae;uncultured;";"95.6";"18.2";"136";"136";"130";"6";"0";"457047";"373764"
"V4mis1";"SILVA (only NR);Bacteria;Proteobacteria;Gammaproteobacteria;Ectothiorhodospirales;Thioalkalispiraceae;";"96.7";"18.2";"150";"150";"145";"5";"0";"457033";"373749"
"V4mis1";"SILVA (only NR);Bacteria;Proteobacteria;Gammaproteobacteria;Ectothiorhodospirales;Thioalkalispiraceae;Thioalkalispira-Sulfurivermis;";"100.0";"18.2";"60";"60";"60";"0";"0";"457123";"373834"
"V4mis1";"SILVA (only NR);Bacteria;Proteobacteria;Gammaproteobacteria;Ectothiorhodospirales;Thioalkalispiraceae;Thiohalophilus;";"94.6";"18.2";"74";"74";"70";"4";"0";"457109";"373824"
"V4mis1";"SILVA (only NR);Bacteria;Proteobacteria;Gammaproteobacteria;Ectothiorhodospirales;Thioalkalispiraceae;uncultured;";"93.8";"18.2";"16";"16";"15";"1";"0";"457167";"373879"
"V4mis1";"SILVA (only NR);Bacteria;Proteobacteria;Gammaproteobacteria;Enterobacterales;";"92.3";"18.8";"23028";"23028";"21260";"1768";"0";"434155";"352634"
"V4mis1";"SILVA (only NR);Bacteria;Proteobacteria;Gammaproteobacteria;Enterobacterales;Aeromonadaceae;";"92.5";"18.2";"1135";"1135";"1050";"85";"0";"456048";"372844"
"V4mis1";"SILVA (only NR);Bacteria;Proteobacteria;Gammaproteobacteria;Enterobacterales;Aeromonadaceae;Aeromonas;";"92.3";"18.2";"1030";"1030";"951";"79";"0";"456153";"372943"
"V4mis1";"SILVA (only NR);Bacteria;Proteobacteria;Gammaproteobacteria;Enterobacterales;Aeromonadaceae;Oceanimonas;";"90.9";"18.2";"22";"22";"20";"2";"0";"457161";"373874"
"V4mis1";"SILVA (only NR);Bacteria;Proteobacteria;Gammaproteobacteria;Enterobacterales;Aeromonadaceae;Oceanisphaera;";"95.1";"18.2";"41";"41";"39";"2";"0";"457142";"373855"
"V4mis1";"SILVA (only NR);Bacteria;Proteobacteria;Gammaproteobacteria;Enterobacterales;Aeromonadaceae;Tolumonas;";"94.7";"18.2";"19";"19";"18";"1";"0";"457164";"373876"
"V4mis1";"SILVA (only NR);Bacteria;Proteobacteria;Gammaproteobacteria;Enterobacterales;Aeromonadaceae;Zobellella;";"93.8";"18.2";"16";"16";"15";"1";"0";"457167";"373879"
"V4mis1";"SILVA (only NR);Bacteria;Proteobacteria;Gammaproteobacteria;Enterobacterales;Alteromonadaceae;";"90.3";"18.2";"1053";"1053";"951";"102";"0";"456130";"372943"
"V4mis1";"SILVA (only NR);Bacteria;Proteobacteria;Gammaproteobacteria;Enterobacterales;Alteromonadaceae;Aestuariibacter;";"92.7";"18.2";"55";"55";"51";"4";"0";"457128";"373843"
"V4mis1";"SILVA (only NR);Bacteria;Proteobacteria;Gammaproteobacteria;Enterobacterales;Alteromonadaceae;Agaribacter;";"95.5";"18.2";"22";"22";"21";"1";"0";"457161";"373873"
"V4mis1";"SILVA (only NR);Bacteria;Proteobacteria;Gammaproteobacteria;Enterobacterales;Alteromonadaceae;Aliiglaciecola;";"100.0";"18.2";"14";"14";"14";"0";"0";"457169";"373880"
"V4mis1";"SILVA (only NR);Bacteria;Proteobacteria;Gammaproteobacteria;Enterobacterales;Alteromonadaceae;Alishewanella;";"86.5";"18.2";"37";"37";"32";"5";"0";"457146";"373862"
"V4mis1";"SILVA (only NR);Bacteria;Proteobacteria;Gammaproteobacteria;Enterobacterales;Alteromonadaceae;Alteromonas;";"84.0";"18.2";"456";"456";"383";"73";"0";"456727";"373511"
"V4mis1";"SILVA (only NR);Bacteria;Proteobacteria;Gammaproteobacteria;Enterobacterales;Alteromonadaceae;Bowmanella;";"100.0";"18.2";"4";"4";"4";"0";"0";"457179";"373890"
"V4mis1";"SILVA (only NR);Bacteria;Proteobacteria;Gammaproteobacteria;Enterobacterales;Alteromonadaceae;Catenovulum;";"100.0";"18.2";"12";"12";"12";"0";"0";"457171";"373882"
"V4mis1";"SILVA (only NR);Bacteria;Proteobacteria;Gammaproteobacteria;Enterobacterales;Alteromonadaceae;Gayadomonas;";"100.0";"18.2";"2";"2";"2";"0";"0";"457181";"373892"
"V4mis1";"SILVA (only NR);Bacteria;Proteobacteria;Gammaproteobacteria;Enterobacterales;Alteromonadaceae;Glaciecola;";"94.4";"18.2";"54";"54";"51";"3";"0";"457129";"373843"
"V4mis1";"SILVA (only NR);Bacteria;Proteobacteria;Gammaproteobacteria;Enterobacterales;Alteromonadaceae;Lacimicrobium;";"83.3";"18.2";"6";"6";"5";"1";"0";"457177";"373889"
"V4mis1";"SILVA (only NR);Bacteria;Proteobacteria;Gammaproteobacteria;Enterobacterales;Alteromonadaceae;Neiella;";"100.0";"18.2";"4";"4";"4";"0";"0";"457179";"373890"
"V4mis1";"SILVA (only NR);Bacteria;Proteobacteria;Gammaproteobacteria;Enterobacterales;Alteromonadaceae;Paraglaciecola;";"97.0";"18.2";"66";"66";"64";"2";"0";"457117";"373830"
"V4mis1";"SILVA (only NR);Bacteria;Proteobacteria;Gammaproteobacteria;Enterobacterales;Alteromonadaceae;Pseudobowmanella;";"100.0";"18.2";"3";"3";"3";"0";"0";"457180";"373891"
"V4mis1";"SILVA (only NR);Bacteria;Proteobacteria;Gammaproteobacteria;Enterobacterales;Alteromonadaceae;Rheinheimera;";"96.0";"18.2";"225";"225";"216";"9";"0";"456958";"373678"
"V4mis1";"SILVA (only NR);Bacteria;Proteobacteria;Gammaproteobacteria;Enterobacterales;Alteromonadaceae;Salinimonas;";"84.2";"18.2";"19";"19";"16";"3";"0";"457164";"373878"
"V4mis1";"SILVA (only NR);Bacteria;Proteobacteria;Gammaproteobacteria;Enterobacterales;Alteromonadaceae;XY-R5;";"100.0";"18.2";"2";"2";"2";"0";"0";"457181";"373892"
"V4mis1";"SILVA (only NR);Bacteria;Proteobacteria;Gammaproteobacteria;Enterobacterales;Alteromonadaceae;uncultured;";"98.4";"18.2";"61";"61";"60";"1";"0";"457122";"373834"
"V4mis1";"SILVA (only NR);Bacteria;Proteobacteria;Gammaproteobacteria;Enterobacterales;Budviciaceae;";"100.0";"18.2";"22";"22";"22";"0";"0";"457161";"373872"
"V4mis1";"SILVA (only NR);Bacteria;Proteobacteria;Gammaproteobacteria;Enterobacterales;Budviciaceae;Budvicia;";"100.0";"18.2";"6";"6";"6";"0";"0";"457177";"373888"
"V4mis1";"SILVA (only NR);Bacteria;Proteobacteria;Gammaproteobacteria;Enterobacterales;Budviciaceae;Leminorella;";"100.0";"18.2";"5";"5";"5";"0";"0";"457178";"373889"
"V4mis1";"SILVA (only NR);Bacteria;Proteobacteria;Gammaproteobacteria;Enterobacterales;Budviciaceae;Pragia;";"100.0";"18.2";"11";"11";"11";"0";"0";"457172";"373883"
"V4mis1";"SILVA (only NR);Bacteria;Proteobacteria;Gammaproteobacteria;Enterobacterales;Celerinatantimonadaceae;";"100.0";"18.2";"3";"3";"3";"0";"0";"457180";"373891"
"V4mis1";"SILVA (only NR);Bacteria;Proteobacteria;Gammaproteobacteria;Enterobacterales;Celerinatantimonadaceae;Celerinatantimonas;";"100.0";"18.2";"3";"3";"3";"0";"0";"457180";"373891"
"V4mis1";"SILVA (only NR);Bacteria;Proteobacteria;Gammaproteobacteria;Enterobacterales;Colwelliaceae;";"93.0";"18.2";"511";"511";"475";"36";"0";"456672";"373419"
"V4mis1";"SILVA (only NR);Bacteria;Proteobacteria;Gammaproteobacteria;Enterobacterales;Colwelliaceae;Colwellia;";"92.6";"18.2";"377";"377";"349";"28";"0";"456806";"373545"
"V4mis1";"SILVA (only NR);Bacteria;Proteobacteria;Gammaproteobacteria;Enterobacterales;Colwelliaceae;Litorilituus;";"100.0";"18.2";"1";"1";"1";"0";"0";"457182";"373893"
"V4mis1";"SILVA (only NR);Bacteria;Proteobacteria;Gammaproteobacteria;Enterobacterales;Colwelliaceae;Thalassomonas;";"100.0";"18.2";"6";"6";"6";"0";"0";"457177";"373888"
"V4mis1";"SILVA (only NR);Bacteria;Proteobacteria;Gammaproteobacteria;Enterobacterales;Colwelliaceae;Thalassotalea;";"93.1";"18.2";"101";"101";"94";"7";"0";"457082";"373800"
"V4mis1";"SILVA (only NR);Bacteria;Proteobacteria;Gammaproteobacteria;Enterobacterales;Colwelliaceae;uncultured;";"95.8";"18.2";"24";"24";"23";"1";"0";"457159";"373871"
"V4mis1";"SILVA (only NR);Bacteria;Proteobacteria;Gammaproteobacteria;Enterobacterales;Enterobacterales Incertae Sedis;";"100.0";"18.2";"14";"14";"14";"0";"0";"457169";"373880"
"V4mis1";"SILVA (only NR);Bacteria;Proteobacteria;Gammaproteobacteria;Enterobacterales;Enterobacterales Incertae Sedis;Alkalimonas;";"100.0";"18.2";"14";"14";"14";"0";"0";"457169";"373880"
"V4mis1";"SILVA (only NR);Bacteria;Proteobacteria;Gammaproteobacteria;Enterobacterales;Enterobacteriaceae;";"91.2";"18.4";"7969";"7969";"7268";"701";"0";"449214";"366626"
"V4mis1";"SILVA (only NR);Bacteria;Proteobacteria;Gammaproteobacteria;Enterobacterales;Enterobacteriaceae;Aquamonas;";"100.0";"18.2";"1";"1";"1";"0";"0";"457182";"373893"
"V4mis1";"SILVA (only NR);Bacteria;Proteobacteria;Gammaproteobacteria;Enterobacterales;Enterobacteriaceae;Atlantibacter;";"75.0";"18.2";"4";"4";"3";"1";"0";"457179";"373891"
"V4mis1";"SILVA (only NR);Bacteria;Proteobacteria;Gammaproteobacteria;Enterobacterales;Enterobacteriaceae;Buttiauxella;";"96.5";"18.2";"57";"57";"55";"2";"0";"457126";"373839"
"V4mis1";"SILVA (only NR);Bacteria;Proteobacteria;Gammaproteobacteria;Enterobacterales;Enterobacteriaceae;Cedecea;";"100.0";"18.2";"14";"14";"14";"0";"0";"457169";"373880"
"V4mis1";"SILVA (only NR);Bacteria;Proteobacteria;Gammaproteobacteria;Enterobacterales;Enterobacteriaceae;Citrobacter;";"91.5";"18.2";"516";"516";"472";"44";"0";"456667";"373422"
"V4mis1";"SILVA (only NR);Bacteria;Proteobacteria;Gammaproteobacteria;Enterobacterales;Enterobacteriaceae;Cronobacter;";"96.7";"18.2";"153";"153";"148";"5";"0";"457030";"373746"
"V4mis1";"SILVA (only NR);Bacteria;Proteobacteria;Gammaproteobacteria;Enterobacterales;Enterobacteriaceae;Enterobacillus;";"100.0";"18.2";"15";"15";"15";"0";"0";"457168";"373879"
"V4mis1";"SILVA (only NR);Bacteria;Proteobacteria;Gammaproteobacteria;Enterobacterales;Enterobacteriaceae;Enterobacter;";"89.3";"18.2";"1670";"1670";"1491";"179";"0";"455513";"372403"
"V4mis1";"SILVA (only NR);Bacteria;Proteobacteria;Gammaproteobacteria;Enterobacterales;Enterobacteriaceae;Escherichia-Shigella;";"89.5";"18.3";"2807";"2807";"2511";"296";"0";"454376";"371383"
"V4mis1";"SILVA (only NR);Bacteria;Proteobacteria;Gammaproteobacteria;Enterobacterales;Enterobacteriaceae;Franconibacter;";"91.7";"18.2";"12";"12";"11";"1";"0";"457171";"373883"
"V4mis1";"SILVA (only NR);Bacteria;Proteobacteria;Gammaproteobacteria;Enterobacterales;Enterobacteriaceae;Klebsiella;";"91.5";"18.2";"1177";"1177";"1077";"100";"0";"456006";"372817"
"V4mis1";"SILVA (only NR);Bacteria;Proteobacteria;Gammaproteobacteria;Enterobacterales;Enterobacteriaceae;Kluyvera;";"95.5";"18.2";"88";"88";"84";"4";"0";"457095";"373810"
"V4mis1";"SILVA (only NR);Bacteria;Proteobacteria;Gammaproteobacteria;Enterobacterales;Enterobacteriaceae;Kosakonia;";"89.2";"18.2";"157";"157";"140";"17";"0";"457026";"373754"
"V4mis1";"SILVA (only NR);Bacteria;Proteobacteria;Gammaproteobacteria;Enterobacterales;Enterobacteriaceae;Lelliottia;";"96.8";"18.2";"31";"31";"30";"1";"0";"457152";"373864"
"V4mis1";"SILVA (only NR);Bacteria;Proteobacteria;Gammaproteobacteria;Enterobacterales;Enterobacteriaceae;Mangrovibacter;";"100.0";"18.2";"11";"11";"11";"0";"0";"457172";"373883"
"V4mis1";"SILVA (only NR);Bacteria;Proteobacteria;Gammaproteobacteria;Enterobacterales;Enterobacteriaceae;Plesiomonas;";"87.9";"18.2";"107";"107";"94";"13";"0";"457076";"373800"
"V4mis1";"SILVA (only NR);Bacteria;Proteobacteria;Gammaproteobacteria;Enterobacterales;Enterobacteriaceae;Pluralibacter;";"87.5";"18.2";"8";"8";"7";"1";"0";"457175";"373887"
"V4mis1";"SILVA (only NR);Bacteria;Proteobacteria;Gammaproteobacteria;Enterobacterales;Enterobacteriaceae;Pseudocitrobacter;";"100.0";"18.2";"20";"20";"20";"0";"0";"457163";"373874"
"V4mis1";"SILVA (only NR);Bacteria;Proteobacteria;Gammaproteobacteria;Enterobacterales;Enterobacteriaceae;Raoultella;";"84.4";"18.2";"96";"96";"81";"15";"0";"457087";"373813"
"V4mis1";"SILVA (only NR);Bacteria;Proteobacteria;Gammaproteobacteria;Enterobacterales;Enterobacteriaceae;Salmonella;";"97.7";"18.3";"952";"952";"930";"22";"0";"456231";"372964"
"V4mis1";"SILVA (only NR);Bacteria;Proteobacteria;Gammaproteobacteria;Enterobacterales;Enterobacteriaceae;Shimwellia;";"100.0";"18.2";"25";"25";"25";"0";"0";"457158";"373869"
"V4mis1";"SILVA (only NR);Bacteria;Proteobacteria;Gammaproteobacteria;Enterobacterales;Enterobacteriaceae;Trabulsiella;";"100.0";"18.2";"23";"23";"23";"0";"0";"457160";"373871"
"V4mis1";"SILVA (only NR);Bacteria;Proteobacteria;Gammaproteobacteria;Enterobacterales;Enterobacteriaceae;Yokenella;";"100.0";"18.2";"11";"11";"11";"0";"0";"457172";"373883"
"V4mis1";"SILVA (only NR);Bacteria;Proteobacteria;Gammaproteobacteria;Enterobacterales;Erwiniaceae;";"90.7";"18.2";"1233";"1233";"1118";"115";"0";"455950";"372776"
"V4mis1";"SILVA (only NR);Bacteria;Proteobacteria;Gammaproteobacteria;Enterobacterales;Erwiniaceae;Candidatus Stammerula;";"100.0";"18.2";"8";"8";"8";"0";"0";"457175";"373886"
"V4mis1";"SILVA (only NR);Bacteria;Proteobacteria;Gammaproteobacteria;Enterobacterales;Erwiniaceae;Erwinia;";"94.5";"18.2";"200";"200";"189";"11";"0";"456983";"373705"
"V4mis1";"SILVA (only NR);Bacteria;Proteobacteria;Gammaproteobacteria;Enterobacterales;Erwiniaceae;Incertae Sedis;";"62.5";"18.2";"8";"8";"5";"3";"0";"457175";"373889"
"V4mis1";"SILVA (only NR);Bacteria;Proteobacteria;Gammaproteobacteria;Enterobacterales;Erwiniaceae;Izhakiella;";"96.0";"18.2";"25";"25";"24";"1";"0";"457158";"373870"
"V4mis1";"SILVA (only NR);Bacteria;Proteobacteria;Gammaproteobacteria;Enterobacterales;Erwiniaceae;Pantoea;";"90.5";"18.2";"861";"861";"779";"82";"0";"456322";"373115"
"V4mis1";"SILVA (only NR);Bacteria;Proteobacteria;Gammaproteobacteria;Enterobacterales;Erwiniaceae;Phaseolibacter;";"100.0";"18.2";"3";"3";"3";"0";"0";"457180";"373891"
"V4mis1";"SILVA (only NR);Bacteria;Proteobacteria;Gammaproteobacteria;Enterobacterales;Erwiniaceae;Rosenbergiella;";"76.3";"18.2";"38";"38";"29";"9";"0";"457145";"373865"
"V4mis1";"SILVA (only NR);Bacteria;Proteobacteria;Gammaproteobacteria;Enterobacterales;Erwiniaceae;Siccibacter;";"100.0";"18.2";"16";"16";"16";"0";"0";"457167";"373878"
"V4mis1";"SILVA (only NR);Bacteria;Proteobacteria;Gammaproteobacteria;Enterobacterales;Erwiniaceae;Tatumella;";"89.2";"18.2";"37";"37";"33";"4";"0";"457146";"373861"
"V4mis1";"SILVA (only NR);Bacteria;Proteobacteria;Gammaproteobacteria;Enterobacterales;Erwiniaceae;uncultured;";"82.6";"18.2";"23";"23";"19";"4";"0";"457160";"373875"
"V4mis1";"SILVA (only NR);Bacteria;Proteobacteria;Gammaproteobacteria;Enterobacterales;Gallaecimonadaceae;";"100.0";"18.2";"10";"10";"10";"0";"0";"457173";"373884"
"V4mis1";"SILVA (only NR);Bacteria;Proteobacteria;Gammaproteobacteria;Enterobacterales;Gallaecimonadaceae;Gallaecimonas;";"100.0";"18.2";"10";"10";"10";"0";"0";"457173";"373884"
"V4mis1";"SILVA (only NR);Bacteria;Proteobacteria;Gammaproteobacteria;Enterobacterales;Hafniaceae;";"95.8";"18.2";"142";"142";"136";"6";"0";"457041";"373758"
"V4mis1";"SILVA (only NR);Bacteria;Proteobacteria;Gammaproteobacteria;Enterobacterales;Hafniaceae;Edwardsiella;";"95.2";"18.2";"62";"62";"59";"3";"0";"457121";"373835"
"V4mis1";"SILVA (only NR);Bacteria;Proteobacteria;Gammaproteobacteria;Enterobacterales;Hafniaceae;Hafnia-Obesumbacterium;";"96.3";"18.2";"80";"80";"77";"3";"0";"457103";"373817"
"V4mis1";"SILVA (only NR);Bacteria;Proteobacteria;Gammaproteobacteria;Enterobacterales;Idiomarinaceae;";"95.0";"18.2";"240";"240";"228";"12";"0";"456943";"373666"
"V4mis1";"SILVA (only NR);Bacteria;Proteobacteria;Gammaproteobacteria;Enterobacterales;Idiomarinaceae;Aliidiomarina;";"94.3";"18.2";"53";"53";"50";"3";"0";"457130";"373844"
"V4mis1";"SILVA (only NR);Bacteria;Proteobacteria;Gammaproteobacteria;Enterobacterales;Idiomarinaceae;Idiomarina;";"95.2";"18.2";"186";"186";"177";"9";"0";"456997";"373717"
"V4mis1";"SILVA (only NR);Bacteria;Proteobacteria;Gammaproteobacteria;Enterobacterales;JI49D030;";"100.0";"18.2";"2";"2";"2";"0";"0";"457181";"373892"
"V4mis1";"SILVA (only NR);Bacteria;Proteobacteria;Gammaproteobacteria;Enterobacterales;Kangiellaceae;";"94.1";"18.2";"68";"68";"64";"4";"0";"457115";"373830"
"V4mis1";"SILVA (only NR);Bacteria;Proteobacteria;Gammaproteobacteria;Enterobacterales;Kangiellaceae;Aliikangiella;";"94.1";"18.2";"17";"17";"16";"1";"0";"457166";"373878"
"V4mis1";"SILVA (only NR);Bacteria;Proteobacteria;Gammaproteobacteria;Enterobacterales;Kangiellaceae;Kangiella;";"100.0";"18.2";"31";"31";"31";"0";"0";"457152";"373863"
"V4mis1";"SILVA (only NR);Bacteria;Proteobacteria;Gammaproteobacteria;Enterobacterales;Kangiellaceae;Pleionea;";"100.0";"18.2";"4";"4";"4";"0";"0";"457179";"373890"
"V4mis1";"SILVA (only NR);Bacteria;Proteobacteria;Gammaproteobacteria;Enterobacterales;Kangiellaceae;uncultured;";"81.3";"18.2";"16";"16";"13";"3";"0";"457167";"373881"
"V4mis1";"SILVA (only NR);Bacteria;Proteobacteria;Gammaproteobacteria;Enterobacterales;MB19;";"90.9";"18.2";"11";"11";"10";"1";"0";"457172";"373884"
"V4mis1";"SILVA (only NR);Bacteria;Proteobacteria;Gammaproteobacteria;Enterobacterales;Morganellaceae;";"94.7";"18.3";"1368";"1368";"1296";"72";"0";"455815";"372598"
"V4mis1";"SILVA (only NR);Bacteria;Proteobacteria;Gammaproteobacteria;Enterobacterales;Morganellaceae;Arsenophonus;";"99.0";"18.2";"98";"98";"97";"1";"0";"457085";"373797"
"V4mis1";"SILVA (only NR);Bacteria;Proteobacteria;Gammaproteobacteria;Enterobacterales;Morganellaceae;Buchnera;";"98.6";"18.2";"219";"219";"216";"3";"0";"456964";"373678"
"V4mis1";"SILVA (only NR);Bacteria;Proteobacteria;Gammaproteobacteria;Enterobacterales;Morganellaceae;Candidatus Annandia;";"100.0";"18.2";"2";"2";"2";"0";"0";"457181";"373892"
"V4mis1";"SILVA (only NR);Bacteria;Proteobacteria;Gammaproteobacteria;Enterobacterales;Morganellaceae;Candidatus Baumannia;";"95.2";"18.2";"21";"21";"20";"1";"0";"457162";"373874"
"V4mis1";"SILVA (only NR);Bacteria;Proteobacteria;Gammaproteobacteria;Enterobacterales;Morganellaceae;Candidatus Benitsuchiphilus;";"100.0";"18.2";"10";"10";"10";"0";"0";"457173";"373884"
"V4mis1";"SILVA (only NR);Bacteria;Proteobacteria;Gammaproteobacteria;Enterobacterales;Morganellaceae;Candidatus Blochmannia;";"100.0";"18.2";"36";"36";"36";"0";"0";"457147";"373858"
"V4mis1";"SILVA (only NR);Bacteria;Proteobacteria;Gammaproteobacteria;Enterobacterales;Morganellaceae;Candidatus Curculioniphilus;";"100.0";"18.2";"31";"31";"31";"0";"0";"457152";"373863"
"V4mis1";"SILVA (only NR);Bacteria;Proteobacteria;Gammaproteobacteria;Enterobacterales;Morganellaceae;Candidatus Ecksteinia;";"100.0";"18.2";"6";"6";"6";"0";"0";"457177";"373888"
"V4mis1";"SILVA (only NR);Bacteria;Proteobacteria;Gammaproteobacteria;Enterobacterales;Morganellaceae;Candidatus Hamiltonella;";"94.4";"18.2";"18";"18";"17";"1";"0";"457165";"373877"
"V4mis1";"SILVA (only NR);Bacteria;Proteobacteria;Gammaproteobacteria;Enterobacterales;Morganellaceae;Candidatus Hartigia;";"100.0";"18.2";"3";"3";"3";"0";"0";"457180";"373891"
"V4mis1";"SILVA (only NR);Bacteria;Proteobacteria;Gammaproteobacteria;Enterobacterales;Morganellaceae;Candidatus Ishikawaella;";"100.0";"18.2";"5";"5";"5";"0";"0";"457178";"373889"
"V4mis1";"SILVA (only NR);Bacteria;Proteobacteria;Gammaproteobacteria;Enterobacterales;Morganellaceae;Candidatus Kleidoceria;";"100.0";"18.2";"1";"1";"1";"0";"0";"457182";"373893"
"V4mis1";"SILVA (only NR);Bacteria;Proteobacteria;Gammaproteobacteria;Enterobacterales;Morganellaceae;Candidatus Moranella;";"100.0";"18.2";"4";"4";"4";"0";"0";"457179";"373890"
"V4mis1";"SILVA (only NR);Bacteria;Proteobacteria;Gammaproteobacteria;Enterobacterales;Morganellaceae;Candidatus Puchtella;";"100.0";"18.2";"4";"4";"4";"0";"0";"457179";"373890"
"V4mis1";"SILVA (only NR);Bacteria;Proteobacteria;Gammaproteobacteria;Enterobacterales;Morganellaceae;Candidatus Purcelliella;";"100.0";"18.2";"9";"9";"9";"0";"0";"457174";"373885"
"V4mis1";"SILVA (only NR);Bacteria;Proteobacteria;Gammaproteobacteria;Enterobacterales;Morganellaceae;Candidatus Regiella;";"100.0";"18.2";"11";"11";"11";"0";"0";"457172";"373883"
"V4mis1";"SILVA (only NR);Bacteria;Proteobacteria;Gammaproteobacteria;Enterobacterales;Morganellaceae;Candidatus Riesia;";"100.0";"18.2";"6";"6";"6";"0";"0";"457177";"373888"
"V4mis1";"SILVA (only NR);Bacteria;Proteobacteria;Gammaproteobacteria;Enterobacterales;Morganellaceae;Candidatus Rosenkranzia;";"100.0";"18.2";"8";"8";"8";"0";"0";"457175";"373886"
"V4mis1";"SILVA (only NR);Bacteria;Proteobacteria;Gammaproteobacteria;Enterobacterales;Morganellaceae;Candidatus Schneideria;";"100.0";"18.2";"5";"5";"5";"0";"0";"457178";"373889"
"V4mis1";"SILVA (only NR);Bacteria;Proteobacteria;Gammaproteobacteria;Enterobacterales;Morganellaceae;Candidatus Westeberhardia;";"100.0";"18.2";"1";"1";"1";"0";"0";"457182";"373893"
"V4mis1";"SILVA (only NR);Bacteria;Proteobacteria;Gammaproteobacteria;Enterobacterales;Morganellaceae;Cosenzaea;";"100.0";"18.2";"3";"3";"3";"0";"0";"457180";"373891"
"V4mis1";"SILVA (only NR);Bacteria;Proteobacteria;Gammaproteobacteria;Enterobacterales;Morganellaceae;Incertae Sedis;";"100.0";"18.2";"28";"28";"28";"0";"0";"457155";"373866"
"V4mis1";"SILVA (only NR);Bacteria;Proteobacteria;Gammaproteobacteria;Enterobacterales;Morganellaceae;Moellerella;";"100.0";"18.2";"3";"3";"3";"0";"0";"457180";"373891"
"V4mis1";"SILVA (only NR);Bacteria;Proteobacteria;Gammaproteobacteria;Enterobacterales;Morganellaceae;Morganella;";"91.1";"18.2";"123";"123";"112";"11";"0";"457060";"373782"
"V4mis1";"SILVA (only NR);Bacteria;Proteobacteria;Gammaproteobacteria;Enterobacterales;Morganellaceae;Photorhabdus;";"95.8";"18.2";"72";"72";"69";"3";"0";"457111";"373825"
"V4mis1";"SILVA (only NR);Bacteria;Proteobacteria;Gammaproteobacteria;Enterobacterales;Morganellaceae;Proteus;";"91.7";"18.2";"230";"230";"211";"19";"0";"456953";"373683"
"V4mis1";"SILVA (only NR);Bacteria;Proteobacteria;Gammaproteobacteria;Enterobacterales;Morganellaceae;Providencia;";"86.8";"18.2";"189";"189";"164";"25";"0";"456994";"373730"
"V4mis1";"SILVA (only NR);Bacteria;Proteobacteria;Gammaproteobacteria;Enterobacterales;Morganellaceae;Wigglesworthia;";"100.0";"18.2";"4";"4";"4";"0";"0";"457179";"373890"
"V4mis1";"SILVA (only NR);Bacteria;Proteobacteria;Gammaproteobacteria;Enterobacterales;Morganellaceae;Xenorhabdus;";"92.6";"18.2";"95";"95";"88";"7";"0";"457088";"373806"
"V4mis1";"SILVA (only NR);Bacteria;Proteobacteria;Gammaproteobacteria;Enterobacterales;Morganellaceae;endosymbionts;";"98.9";"18.2";"91";"91";"90";"1";"0";"457092";"373804"
"V4mis1";"SILVA (only NR);Bacteria;Proteobacteria;Gammaproteobacteria;Enterobacterales;Morganellaceae;uncultured;";"100.0";"18.2";"13";"13";"13";"0";"0";"457170";"373881"
"V4mis1";"SILVA (only NR);Bacteria;Proteobacteria;Gammaproteobacteria;Enterobacterales;Moritellaceae;";"94.8";"18.2";"58";"58";"55";"3";"0";"457125";"373839"
"V4mis1";"SILVA (only NR);Bacteria;Proteobacteria;Gammaproteobacteria;Enterobacterales;Moritellaceae;Moritella;";"95.5";"18.2";"44";"44";"42";"2";"0";"457139";"373852"
"V4mis1";"SILVA (only NR);Bacteria;Proteobacteria;Gammaproteobacteria;Enterobacterales;Moritellaceae;Paramoritella;";"85.7";"18.2";"7";"7";"6";"1";"0";"457176";"373888"
"V4mis1";"SILVA (only NR);Bacteria;Proteobacteria;Gammaproteobacteria;Enterobacterales;Moritellaceae;uncultured;";"100.0";"18.2";"7";"7";"7";"0";"0";"457176";"373887"
"V4mis1";"SILVA (only NR);Bacteria;Proteobacteria;Gammaproteobacteria;Enterobacterales;Orbaceae;";"90.1";"18.2";"91";"91";"82";"9";"0";"457092";"373812"
"V4mis1";"SILVA (only NR);Bacteria;Proteobacteria;Gammaproteobacteria;Enterobacterales;Orbaceae;Candidatus Schmidhempelia;";"100.0";"18.2";"4";"4";"4";"0";"0";"457179";"373890"
"V4mis1";"SILVA (only NR);Bacteria;Proteobacteria;Gammaproteobacteria;Enterobacterales;Orbaceae;Frischella;";"71.4";"18.2";"7";"7";"5";"2";"0";"457176";"373889"
"V4mis1";"SILVA (only NR);Bacteria;Proteobacteria;Gammaproteobacteria;Enterobacterales;Orbaceae;Gilliamella;";"90.9";"18.2";"66";"66";"60";"6";"0";"457117";"373834"
"V4mis1";"SILVA (only NR);Bacteria;Proteobacteria;Gammaproteobacteria;Enterobacterales;Orbaceae;Orbus;";"100.0";"18.2";"5";"5";"5";"0";"0";"457178";"373889"
"V4mis1";"SILVA (only NR);Bacteria;Proteobacteria;Gammaproteobacteria;Enterobacterales;Orbaceae;uncultured;";"100.0";"18.2";"5";"5";"5";"0";"0";"457178";"373889"
"V4mis1";"SILVA (only NR);Bacteria;Proteobacteria;Gammaproteobacteria;Enterobacterales;Pasteurellaceae;";"92.9";"18.3";"2549";"2549";"2367";"182";"0";"454634";"371527"
"V4mis1";"SILVA (only NR);Bacteria;Proteobacteria;Gammaproteobacteria;Enterobacterales;Pasteurellaceae;Actinobacillus;";"95.7";"18.2";"398";"398";"381";"17";"0";"456785";"373513"
"V4mis1";"SILVA (only NR);Bacteria;Proteobacteria;Gammaproteobacteria;Enterobacterales;Pasteurellaceae;Aggregatibacter;";"90.8";"18.2";"207";"207";"188";"19";"0";"456976";"373706"
"V4mis1";"SILVA (only NR);Bacteria;Proteobacteria;Gammaproteobacteria;Enterobacterales;Pasteurellaceae;Avibacterium;";"96.0";"18.2";"25";"25";"24";"1";"0";"457158";"373870"
"V4mis1";"SILVA (only NR);Bacteria;Proteobacteria;Gammaproteobacteria;Enterobacterales;Pasteurellaceae;Basfia;";"100.0";"18.2";"6";"6";"6";"0";"0";"457177";"373888"
"V4mis1";"SILVA (only NR);Bacteria;Proteobacteria;Gammaproteobacteria;Enterobacterales;Pasteurellaceae;Bibersteinia;";"100.0";"18.2";"21";"21";"21";"0";"0";"457162";"373873"
"V4mis1";"SILVA (only NR);Bacteria;Proteobacteria;Gammaproteobacteria;Enterobacterales;Pasteurellaceae;Bisgaardia;";"100.0";"18.2";"10";"10";"10";"0";"0";"457173";"373884"
"V4mis1";"SILVA (only NR);Bacteria;Proteobacteria;Gammaproteobacteria;Enterobacterales;Pasteurellaceae;Caviibacterium;";"100.0";"18.2";"4";"4";"4";"0";"0";"457179";"373890"
"V4mis1";"SILVA (only NR);Bacteria;Proteobacteria;Gammaproteobacteria;Enterobacterales;Pasteurellaceae;Chelonobacter;";"100.0";"18.2";"4";"4";"4";"0";"0";"457179";"373890"
"V4mis1";"SILVA (only NR);Bacteria;Proteobacteria;Gammaproteobacteria;Enterobacterales;Pasteurellaceae;Conservatibacter;";"100.0";"18.2";"2";"2";"2";"0";"0";"457181";"373892"
"V4mis1";"SILVA (only NR);Bacteria;Proteobacteria;Gammaproteobacteria;Enterobacterales;Pasteurellaceae;Cricetibacter;";"100.0";"18.2";"2";"2";"2";"0";"0";"457181";"373892"
"V4mis1";"SILVA (only NR);Bacteria;Proteobacteria;Gammaproteobacteria;Enterobacterales;Pasteurellaceae;Frederiksenia;";"100.0";"18.2";"11";"11";"11";"0";"0";"457172";"373883"
"V4mis1";"SILVA (only NR);Bacteria;Proteobacteria;Gammaproteobacteria;Enterobacterales;Pasteurellaceae;Gallibacterium;";"97.1";"18.2";"35";"35";"34";"1";"0";"457148";"373860"
"V4mis1";"SILVA (only NR);Bacteria;Proteobacteria;Gammaproteobacteria;Enterobacterales;Pasteurellaceae;Haemophilus;";"89.5";"18.2";"1110";"1110";"994";"116";"0";"456073";"372900"
"V4mis1";"SILVA (only NR);Bacteria;Proteobacteria;Gammaproteobacteria;Enterobacterales;Pasteurellaceae;Histophilus;";"96.9";"18.2";"32";"32";"31";"1";"0";"457151";"373863"
"V4mis1";"SILVA (only NR);Bacteria;Proteobacteria;Gammaproteobacteria;Enterobacterales;Pasteurellaceae;Lonepinella;";"100.0";"18.2";"3";"3";"3";"0";"0";"457180";"373891"
"V4mis1";"SILVA (only NR);Bacteria;Proteobacteria;Gammaproteobacteria;Enterobacterales;Pasteurellaceae;Mannheimia;";"96.9";"18.2";"65";"65";"63";"2";"0";"457118";"373831"
"V4mis1";"SILVA (only NR);Bacteria;Proteobacteria;Gammaproteobacteria;Enterobacterales;Pasteurellaceae;Mesocricetibacter;";"100.0";"18.2";"4";"4";"4";"0";"0";"457179";"373890"
"V4mis1";"SILVA (only NR);Bacteria;Proteobacteria;Gammaproteobacteria;Enterobacterales;Pasteurellaceae;Muribacter;";"92.6";"18.2";"27";"27";"25";"2";"0";"457156";"373869"
"V4mis1";"SILVA (only NR);Bacteria;Proteobacteria;Gammaproteobacteria;Enterobacterales;Pasteurellaceae;Necropsobacter;";"100.0";"18.2";"4";"4";"4";"0";"0";"457179";"373890"
"V4mis1";"SILVA (only NR);Bacteria;Proteobacteria;Gammaproteobacteria;Enterobacterales;Pasteurellaceae;Nicoletella;";"100.0";"18.2";"17";"17";"17";"0";"0";"457166";"373877"
"V4mis1";"SILVA (only NR);Bacteria;Proteobacteria;Gammaproteobacteria;Enterobacterales;Pasteurellaceae;Otariodibacter;";"95.9";"18.2";"98";"98";"94";"4";"0";"457085";"373800"
"V4mis1";"SILVA (only NR);Bacteria;Proteobacteria;Gammaproteobacteria;Enterobacterales;Pasteurellaceae;Pasteurella;";"97.4";"18.2";"114";"114";"111";"3";"0";"457069";"373783"
"V4mis1";"SILVA (only NR);Bacteria;Proteobacteria;Gammaproteobacteria;Enterobacterales;Pasteurellaceae;Phocoenobacter;";"99.3";"18.2";"141";"141";"140";"1";"0";"457042";"373754"
"V4mis1";"SILVA (only NR);Bacteria;Proteobacteria;Gammaproteobacteria;Enterobacterales;Pasteurellaceae;Rodentibacter;";"90.6";"18.2";"117";"117";"106";"11";"0";"457066";"373788"
"V4mis1";"SILVA (only NR);Bacteria;Proteobacteria;Gammaproteobacteria;Enterobacterales;Pasteurellaceae;Seminibacterium;";"100.0";"18.2";"1";"1";"1";"0";"0";"457182";"373893"
"V4mis1";"SILVA (only NR);Bacteria;Proteobacteria;Gammaproteobacteria;Enterobacterales;Pasteurellaceae;Testudinibacter;";"100.0";"18.2";"3";"3";"3";"0";"0";"457180";"373891"
"V4mis1";"SILVA (only NR);Bacteria;Proteobacteria;Gammaproteobacteria;Enterobacterales;Pasteurellaceae;Ursidibacter;";"100.0";"18.2";"6";"6";"6";"0";"0";"457177";"373888"
"V4mis1";"SILVA (only NR);Bacteria;Proteobacteria;Gammaproteobacteria;Enterobacterales;Pasteurellaceae;Vespertiliibacter;";"100.0";"18.2";"2";"2";"2";"0";"0";"457181";"373892"
"V4mis1";"SILVA (only NR);Bacteria;Proteobacteria;Gammaproteobacteria;Enterobacterales;Pasteurellaceae;Volucribacter;";"100.0";"18.2";"5";"5";"5";"0";"0";"457178";"373889"
"V4mis1";"SILVA (only NR);Bacteria;Proteobacteria;Gammaproteobacteria;Enterobacterales;Pasteurellaceae;uncultured;";"93.5";"18.2";"62";"62";"58";"4";"0";"457121";"373836"
"V4mis1";"SILVA (only NR);Bacteria;Proteobacteria;Gammaproteobacteria;Enterobacterales;Pectobacteriaceae;";"96.5";"18.2";"433";"433";"418";"15";"0";"456750";"373476"
"V4mis1";"SILVA (only NR);Bacteria;Proteobacteria;Gammaproteobacteria;Enterobacterales;Pectobacteriaceae;Biostraticola;";"100.0";"18.2";"1";"1";"1";"0";"0";"457182";"373893"
"V4mis1";"SILVA (only NR);Bacteria;Proteobacteria;Gammaproteobacteria;Enterobacterales;Pectobacteriaceae;Brenneria;";"100.0";"18.2";"25";"25";"25";"0";"0";"457158";"373869"
"V4mis1";"SILVA (only NR);Bacteria;Proteobacteria;Gammaproteobacteria;Enterobacterales;Pectobacteriaceae;Dickeya;";"94.3";"18.2";"122";"122";"115";"7";"0";"457061";"373779"
"V4mis1";"SILVA (only NR);Bacteria;Proteobacteria;Gammaproteobacteria;Enterobacterales;Pectobacteriaceae;Lonsdalea;";"100.0";"18.2";"16";"16";"16";"0";"0";"457167";"373878"
"V4mis1";"SILVA (only NR);Bacteria;Proteobacteria;Gammaproteobacteria;Enterobacterales;Pectobacteriaceae;Nissabacter;";"100.0";"18.2";"2";"2";"2";"0";"0";"457181";"373892"
"V4mis1";"SILVA (only NR);Bacteria;Proteobacteria;Gammaproteobacteria;Enterobacterales;Pectobacteriaceae;Pectobacterium;";"96.7";"18.2";"183";"183";"177";"6";"0";"457000";"373717"
"V4mis1";"SILVA (only NR);Bacteria;Proteobacteria;Gammaproteobacteria;Enterobacterales;Pectobacteriaceae;Sodalis;";"97.5";"18.2";"79";"79";"77";"2";"0";"457104";"373817"
"V4mis1";"SILVA (only NR);Bacteria;Proteobacteria;Gammaproteobacteria;Enterobacterales;Pectobacteriaceae;uncultured;";"100.0";"18.2";"5";"5";"5";"0";"0";"457178";"373889"
"V4mis1";"SILVA (only NR);Bacteria;Proteobacteria;Gammaproteobacteria;Enterobacterales;Pseudoalteromonadaceae;";"91.8";"18.2";"892";"892";"819";"73";"0";"456291";"373075"
"V4mis1";"SILVA (only NR);Bacteria;Proteobacteria;Gammaproteobacteria;Enterobacterales;Pseudoalteromonadaceae;Algicola;";"92.9";"18.2";"14";"14";"13";"1";"0";"457169";"373881"
"V4mis1";"SILVA (only NR);Bacteria;Proteobacteria;Gammaproteobacteria;Enterobacterales;Pseudoalteromonadaceae;Pseudoalteromonas;";"91.6";"18.2";"861";"861";"789";"72";"0";"456322";"373105"
"V4mis1";"SILVA (only NR);Bacteria;Proteobacteria;Gammaproteobacteria;Enterobacterales;Pseudoalteromonadaceae;Psychrosphaera;";"100.0";"18.2";"8";"8";"8";"0";"0";"457175";"373886"
"V4mis1";"SILVA (only NR);Bacteria;Proteobacteria;Gammaproteobacteria;Enterobacterales;Pseudoalteromonadaceae;uncultured;";"100.0";"18.2";"8";"8";"8";"0";"0";"457175";"373886"
"V4mis1";"SILVA (only NR);Bacteria;Proteobacteria;Gammaproteobacteria;Enterobacterales;Psychromonadaceae;";"94.0";"18.2";"116";"116";"109";"7";"0";"457067";"373785"
"V4mis1";"SILVA (only NR);Bacteria;Proteobacteria;Gammaproteobacteria;Enterobacterales;Psychromonadaceae;Agarivorans;";"94.1";"18.2";"34";"34";"32";"2";"0";"457149";"373862"
"V4mis1";"SILVA (only NR);Bacteria;Proteobacteria;Gammaproteobacteria;Enterobacterales;Psychromonadaceae;Aliagarivorans;";"100.0";"18.2";"2";"2";"2";"0";"0";"457181";"373892"
"V4mis1";"SILVA (only NR);Bacteria;Proteobacteria;Gammaproteobacteria;Enterobacterales;Psychromonadaceae;Motilimonas;";"100.0";"18.2";"4";"4";"4";"0";"0";"457179";"373890"
"V4mis1";"SILVA (only NR);Bacteria;Proteobacteria;Gammaproteobacteria;Enterobacterales;Psychromonadaceae;Psychromonas;";"93.2";"18.2";"74";"74";"69";"5";"0";"457109";"373825"
"V4mis1";"SILVA (only NR);Bacteria;Proteobacteria;Gammaproteobacteria;Enterobacterales;Shewanellaceae;";"94.6";"18.2";"702";"702";"664";"38";"0";"456481";"373230"
"V4mis1";"SILVA (only NR);Bacteria;Proteobacteria;Gammaproteobacteria;Enterobacterales;Shewanellaceae;Ferrimonas;";"94.7";"18.2";"38";"38";"36";"2";"0";"457145";"373858"
"V4mis1";"SILVA (only NR);Bacteria;Proteobacteria;Gammaproteobacteria;Enterobacterales;Shewanellaceae;Psychrobium;";"90.9";"18.2";"11";"11";"10";"1";"0";"457172";"373884"
"V4mis1";"SILVA (only NR);Bacteria;Proteobacteria;Gammaproteobacteria;Enterobacterales;Shewanellaceae;Shewanella;";"94.6";"18.2";"653";"653";"618";"35";"0";"456530";"373276"
"V4mis1";"SILVA (only NR);Bacteria;Proteobacteria;Gammaproteobacteria;Enterobacterales;Succinivibrionaceae;";"87.2";"18.2";"281";"281";"245";"36";"0";"456902";"373649"
"V4mis1";"SILVA (only NR);Bacteria;Proteobacteria;Gammaproteobacteria;Enterobacterales;Succinivibrionaceae;Anaerobiospirillum;";"94.7";"18.2";"19";"19";"18";"1";"0";"457164";"373876"
"V4mis1";"SILVA (only NR);Bacteria;Proteobacteria;Gammaproteobacteria;Enterobacterales;Succinivibrionaceae;Ruminobacter;";"83.0";"18.2";"47";"47";"39";"8";"0";"457136";"373855"
"V4mis1";"SILVA (only NR);Bacteria;Proteobacteria;Gammaproteobacteria;Enterobacterales;Succinivibrionaceae;Succinatimonas;";"100.0";"18.2";"9";"9";"9";"0";"0";"457174";"373885"
"V4mis1";"SILVA (only NR);Bacteria;Proteobacteria;Gammaproteobacteria;Enterobacterales;Succinivibrionaceae;Succinimonas;";"91.7";"18.2";"12";"12";"11";"1";"0";"457171";"373883"
"V4mis1";"SILVA (only NR);Bacteria;Proteobacteria;Gammaproteobacteria;Enterobacterales;Succinivibrionaceae;Succinivibrio;";"87.2";"18.2";"141";"141";"123";"18";"0";"457042";"373771"
"V4mis1";"SILVA (only NR);Bacteria;Proteobacteria;Gammaproteobacteria;Enterobacterales;Succinivibrionaceae;Succinivibrionaceae UCG-001;";"78.1";"18.2";"32";"32";"25";"7";"0";"457151";"373869"
"V4mis1";"SILVA (only NR);Bacteria;Proteobacteria;Gammaproteobacteria;Enterobacterales;Succinivibrionaceae;Succinivibrionaceae UCG-002;";"90.9";"18.2";"11";"11";"10";"1";"0";"457172";"373884"
"V4mis1";"SILVA (only NR);Bacteria;Proteobacteria;Gammaproteobacteria;Enterobacterales;Succinivibrionaceae;uncultured;";"100.0";"18.2";"10";"10";"10";"0";"0";"457173";"373884"
"V4mis1";"SILVA (only NR);Bacteria;Proteobacteria;Gammaproteobacteria;Enterobacterales;Thorselliaceae;";"100.0";"18.2";"4";"4";"4";"0";"0";"457179";"373890"
"V4mis1";"SILVA (only NR);Bacteria;Proteobacteria;Gammaproteobacteria;Enterobacterales;Thorselliaceae;Coetzeea;";"100.0";"18.2";"1";"1";"1";"0";"0";"457182";"373893"
"V4mis1";"SILVA (only NR);Bacteria;Proteobacteria;Gammaproteobacteria;Enterobacterales;Thorselliaceae;Thorsellia;";"100.0";"18.2";"3";"3";"3";"0";"0";"457180";"373891"
"V4mis1";"SILVA (only NR);Bacteria;Proteobacteria;Gammaproteobacteria;Enterobacterales;Vibrionaceae;";"94.2";"18.3";"2885";"2885";"2717";"168";"0";"454298";"371177"
"V4mis1";"SILVA (only NR);Bacteria;Proteobacteria;Gammaproteobacteria;Enterobacterales;Vibrionaceae;Aliivibrio;";"98.8";"18.2";"81";"81";"80";"1";"0";"457102";"373814"
"V4mis1";"SILVA (only NR);Bacteria;Proteobacteria;Gammaproteobacteria;Enterobacterales;Vibrionaceae;Candidatus Photodesmus;";"100.0";"18.2";"3";"3";"3";"0";"0";"457180";"373891"
"V4mis1";"SILVA (only NR);Bacteria;Proteobacteria;Gammaproteobacteria;Enterobacterales;Vibrionaceae;Catenococcus;";"100.0";"18.2";"12";"12";"12";"0";"0";"457171";"373882"
"V4mis1";"SILVA (only NR);Bacteria;Proteobacteria;Gammaproteobacteria;Enterobacterales;Vibrionaceae;Enterovibrio;";"100.0";"18.2";"26";"26";"26";"0";"0";"457157";"373868"
"V4mis1";"SILVA (only NR);Bacteria;Proteobacteria;Gammaproteobacteria;Enterobacterales;Vibrionaceae;Grimontia;";"100.0";"18.2";"24";"24";"24";"0";"0";"457159";"373870"
"V4mis1";"SILVA (only NR);Bacteria;Proteobacteria;Gammaproteobacteria;Enterobacterales;Vibrionaceae;Photobacterium;";"95.9";"18.2";"320";"320";"307";"13";"0";"456863";"373587"
"V4mis1";"SILVA (only NR);Bacteria;Proteobacteria;Gammaproteobacteria;Enterobacterales;Vibrionaceae;Salinivibrio;";"87.8";"18.2";"98";"98";"86";"12";"0";"457085";"373808"
"V4mis1";"SILVA (only NR);Bacteria;Proteobacteria;Gammaproteobacteria;Enterobacterales;Vibrionaceae;Thaumasiovibrio;";"100.0";"18.2";"16";"16";"16";"0";"0";"457167";"373878"
"V4mis1";"SILVA (only NR);Bacteria;Proteobacteria;Gammaproteobacteria;Enterobacterales;Vibrionaceae;Vibrio;";"93.9";"18.3";"2295";"2295";"2154";"141";"0";"454888";"371740"
"V4mis1";"SILVA (only NR);Bacteria;Proteobacteria;Gammaproteobacteria;Enterobacterales;Vibrionaceae;uncultured;";"100.0";"18.2";"7";"7";"7";"0";"0";"457176";"373887"
"V4mis1";"SILVA (only NR);Bacteria;Proteobacteria;Gammaproteobacteria;Enterobacterales;Yersiniaceae;";"91.7";"18.2";"1212";"1212";"1112";"100";"0";"455971";"372782"
"V4mis1";"SILVA (only NR);Bacteria;Proteobacteria;Gammaproteobacteria;Enterobacterales;Yersiniaceae;Chania;";"100.0";"18.2";"1";"1";"1";"0";"0";"457182";"373893"
"V4mis1";"SILVA (only NR);Bacteria;Proteobacteria;Gammaproteobacteria;Enterobacterales;Yersiniaceae;Gibbsiella;";"84.6";"18.2";"13";"13";"11";"2";"0";"457170";"373883"
"V4mis1";"SILVA (only NR);Bacteria;Proteobacteria;Gammaproteobacteria;Enterobacterales;Yersiniaceae;Rahnella1;";"83.6";"18.2";"61";"61";"51";"10";"0";"457122";"373843"
"V4mis1";"SILVA (only NR);Bacteria;Proteobacteria;Gammaproteobacteria;Enterobacterales;Yersiniaceae;Rahnella;";"100.0";"18.2";"1";"1";"1";"0";"0";"457182";"373893"
"V4mis1";"SILVA (only NR);Bacteria;Proteobacteria;Gammaproteobacteria;Enterobacterales;Yersiniaceae;Samsonia;";"100.0";"18.2";"1";"1";"1";"0";"0";"457182";"373893"
"V4mis1";"SILVA (only NR);Bacteria;Proteobacteria;Gammaproteobacteria;Enterobacterales;Yersiniaceae;Serratia;";"90.9";"18.2";"935";"935";"850";"85";"0";"456248";"373044"
"V4mis1";"SILVA (only NR);Bacteria;Proteobacteria;Gammaproteobacteria;Enterobacterales;Yersiniaceae;Yersinia;";"98.5";"18.2";"200";"200";"197";"3";"0";"456983";"373697"
"V4mis1";"SILVA (only NR);Bacteria;Proteobacteria;Gammaproteobacteria;Enterobacterales;uncultured;";"86.7";"18.2";"15";"15";"13";"2";"0";"457168";"373881"
"V4mis1";"SILVA (only NR);Bacteria;Proteobacteria;Gammaproteobacteria;F9P41300-M23;";"100.0";"18.2";"3";"3";"3";"0";"0";"457180";"373891"
"V4mis1";"SILVA (only NR);Bacteria;Proteobacteria;Gammaproteobacteria;FGL7S;";"100.0";"18.2";"5";"5";"5";"0";"0";"457178";"373889"
"V4mis1";"SILVA (only NR);Bacteria;Proteobacteria;Gammaproteobacteria;Francisellales;";"96.6";"18.2";"149";"149";"144";"5";"0";"457034";"373750"
"V4mis1";"SILVA (only NR);Bacteria;Proteobacteria;Gammaproteobacteria;Francisellales;Francisellaceae;";"96.6";"18.2";"149";"149";"144";"5";"0";"457034";"373750"
"V4mis1";"SILVA (only NR);Bacteria;Proteobacteria;Gammaproteobacteria;Francisellales;Francisellaceae;Allofrancisella;";"100.0";"18.2";"5";"5";"5";"0";"0";"457178";"373889"
"V4mis1";"SILVA (only NR);Bacteria;Proteobacteria;Gammaproteobacteria;Francisellales;Francisellaceae;Fangia;";"100.0";"18.2";"2";"2";"2";"0";"0";"457181";"373892"
"V4mis1";"SILVA (only NR);Bacteria;Proteobacteria;Gammaproteobacteria;Francisellales;Francisellaceae;Francisella;";"98.2";"18.2";"112";"112";"110";"2";"0";"457071";"373784"
"V4mis1";"SILVA (only NR);Bacteria;Proteobacteria;Gammaproteobacteria;Francisellales;Francisellaceae;[Caedibacter] taeniospiralis group;";"80.0";"18.2";"10";"10";"8";"2";"0";"457173";"373886"
"V4mis1";"SILVA (only NR);Bacteria;Proteobacteria;Gammaproteobacteria;Francisellales;Francisellaceae;uncultured;";"94.7";"18.2";"19";"19";"18";"1";"0";"457164";"373876"
"V4mis1";"SILVA (only NR);Bacteria;Proteobacteria;Gammaproteobacteria;GB102;";"100.0";"18.2";"2";"2";"2";"0";"0";"457181";"373892"
"V4mis1";"SILVA (only NR);Bacteria;Proteobacteria;Gammaproteobacteria;Ga0077536;";"96.3";"18.2";"80";"80";"77";"3";"0";"457103";"373817"
"V4mis1";"SILVA (only NR);Bacteria;Proteobacteria;Gammaproteobacteria;Gammaproteobacteria Incertae Sedis;";"94.3";"18.2";"805";"805";"759";"46";"0";"456378";"373135"
"V4mis1";"SILVA (only NR);Bacteria;Proteobacteria;Gammaproteobacteria;Gammaproteobacteria Incertae Sedis;Unknown Family;";"94.3";"18.2";"805";"805";"759";"46";"0";"456378";"373135"
"V4mis1";"SILVA (only NR);Bacteria;Proteobacteria;Gammaproteobacteria;Gammaproteobacteria Incertae Sedis;Unknown Family;Acidibacter;";"92.0";"18.2";"188";"188";"173";"15";"0";"456995";"373721"
"V4mis1";"SILVA (only NR);Bacteria;Proteobacteria;Gammaproteobacteria;Gammaproteobacteria Incertae Sedis;Unknown Family;Candidatus Berkiella;";"100.0";"18.2";"52";"52";"52";"0";"0";"457131";"373842"
"V4mis1";"SILVA (only NR);Bacteria;Proteobacteria;Gammaproteobacteria;Gammaproteobacteria Incertae Sedis;Unknown Family;Candidatus Carsonella;";"97.0";"18.2";"33";"33";"32";"1";"0";"457150";"373862"
"V4mis1";"SILVA (only NR);Bacteria;Proteobacteria;Gammaproteobacteria;Gammaproteobacteria Incertae Sedis;Unknown Family;Candidatus Endonucleariobacter;";"100.0";"18.2";"3";"3";"3";"0";"0";"457180";"373891"
"V4mis1";"SILVA (only NR);Bacteria;Proteobacteria;Gammaproteobacteria;Gammaproteobacteria Incertae Sedis;Unknown Family;Candidatus Ovatusbacter;";"97.3";"18.2";"37";"37";"36";"1";"0";"457146";"373858"
"V4mis1";"SILVA (only NR);Bacteria;Proteobacteria;Gammaproteobacteria;Gammaproteobacteria Incertae Sedis;Unknown Family;Endothiovibrio;";"100.0";"18.2";"3";"3";"3";"0";"0";"457180";"373891"
"V4mis1";"SILVA (only NR);Bacteria;Proteobacteria;Gammaproteobacteria;Gammaproteobacteria Incertae Sedis;Unknown Family;Marinicella;";"94.5";"18.2";"55";"55";"52";"3";"0";"457128";"373842"
"V4mis1";"SILVA (only NR);Bacteria;Proteobacteria;Gammaproteobacteria;Gammaproteobacteria Incertae Sedis;Unknown Family;Sulfuriflexus;";"100.0";"18.2";"2";"2";"2";"0";"0";"457181";"373892"
"V4mis1";"SILVA (only NR);Bacteria;Proteobacteria;Gammaproteobacteria;Gammaproteobacteria Incertae Sedis;Unknown Family;Wenzhouxiangella;";"91.7";"18.2";"24";"24";"22";"2";"0";"457159";"373872"
"V4mis1";"SILVA (only NR);Bacteria;Proteobacteria;Gammaproteobacteria;Gammaproteobacteria Incertae Sedis;Unknown Family;uncultured;";"93.9";"18.2";"347";"347";"326";"21";"0";"456836";"373568"
"V4mis1";"SILVA (only NR);Bacteria;Proteobacteria;Gammaproteobacteria;Granulosicoccales;";"100.0";"18.2";"61";"61";"61";"0";"0";"457122";"373833"
"V4mis1";"SILVA (only NR);Bacteria;Proteobacteria;Gammaproteobacteria;Granulosicoccales;Granulosicoccaceae;";"100.0";"18.2";"39";"39";"39";"0";"0";"457144";"373855"
"V4mis1";"SILVA (only NR);Bacteria;Proteobacteria;Gammaproteobacteria;Granulosicoccales;Granulosicoccaceae;Granulosicoccus;";"100.0";"18.2";"39";"39";"39";"0";"0";"457144";"373855"
"V4mis1";"SILVA (only NR);Bacteria;Proteobacteria;Gammaproteobacteria;Granulosicoccales;Methylohalomonas;";"100.0";"18.2";"6";"6";"6";"0";"0";"457177";"373888"
"V4mis1";"SILVA (only NR);Bacteria;Proteobacteria;Gammaproteobacteria;Granulosicoccales;uncultured;";"100.0";"18.2";"16";"16";"16";"0";"0";"457167";"373878"
"V4mis1";"SILVA (only NR);Bacteria;Proteobacteria;Gammaproteobacteria;HOC36;";"87.1";"18.2";"147";"147";"128";"19";"0";"457036";"373766"
"V4mis1";"SILVA (only NR);Bacteria;Proteobacteria;Gammaproteobacteria;Halothiobacillales;";"90.3";"18.2";"165";"165";"149";"16";"0";"457018";"373745"
"V4mis1";"SILVA (only NR);Bacteria;Proteobacteria;Gammaproteobacteria;Halothiobacillales;Halothiobacillaceae;";"89.4";"18.2";"142";"142";"127";"15";"0";"457041";"373767"
"V4mis1";"SILVA (only NR);Bacteria;Proteobacteria;Gammaproteobacteria;Halothiobacillales;Halothiobacillaceae;Halothiobacillus;";"90.9";"18.2";"33";"33";"30";"3";"0";"457150";"373864"
"V4mis1";"SILVA (only NR);Bacteria;Proteobacteria;Gammaproteobacteria;Halothiobacillales;Halothiobacillaceae;Thiofaba;";"95.5";"18.2";"22";"22";"21";"1";"0";"457161";"373873"
"V4mis1";"SILVA (only NR);Bacteria;Proteobacteria;Gammaproteobacteria;Halothiobacillales;Halothiobacillaceae;Thiovirga;";"76.6";"18.2";"47";"47";"36";"11";"0";"457136";"373858"
"V4mis1";"SILVA (only NR);Bacteria;Proteobacteria;Gammaproteobacteria;Halothiobacillales;Halothiobacillaceae;uncultured;";"100.0";"18.2";"40";"40";"40";"0";"0";"457143";"373854"
"V4mis1";"SILVA (only NR);Bacteria;Proteobacteria;Gammaproteobacteria;Halothiobacillales;Thioalkalibacteraceae;";"95.7";"18.2";"23";"23";"22";"1";"0";"457160";"373872"
"V4mis1";"SILVA (only NR);Bacteria;Proteobacteria;Gammaproteobacteria;Halothiobacillales;Thioalkalibacteraceae;Guyparkeria;";"95.0";"18.2";"20";"20";"19";"1";"0";"457163";"373875"
"V4mis1";"SILVA (only NR);Bacteria;Proteobacteria;Gammaproteobacteria;Halothiobacillales;Thioalkalibacteraceae;Thioalkalibacter;";"100.0";"18.2";"3";"3";"3";"0";"0";"457180";"373891"
"V4mis1";"SILVA (only NR);Bacteria;Proteobacteria;Gammaproteobacteria;HgCo23;";"100.0";"18.2";"6";"6";"6";"0";"0";"457177";"373888"
"V4mis1";"SILVA (only NR);Bacteria;Proteobacteria;Gammaproteobacteria;HglApr721;";"100.0";"18.2";"5";"5";"5";"0";"0";"457178";"373889"
"V4mis1";"SILVA (only NR);Bacteria;Proteobacteria;Gammaproteobacteria;I3A;";"100.0";"18.2";"8";"8";"8";"0";"0";"457175";"373886"
"V4mis1";"SILVA (only NR);Bacteria;Proteobacteria;Gammaproteobacteria;Immundisolibacterales;";"94.3";"18.2";"70";"70";"66";"4";"0";"457113";"373828"
"V4mis1";"SILVA (only NR);Bacteria;Proteobacteria;Gammaproteobacteria;Immundisolibacterales;Immundisolibacteraceae;";"94.3";"18.2";"70";"70";"66";"4";"0";"457113";"373828"
"V4mis1";"SILVA (only NR);Bacteria;Proteobacteria;Gammaproteobacteria;Immundisolibacterales;Immundisolibacteraceae;Immundisolibacter;";"95.1";"18.2";"41";"41";"39";"2";"0";"457142";"373855"
"V4mis1";"SILVA (only NR);Bacteria;Proteobacteria;Gammaproteobacteria;Immundisolibacterales;Immundisolibacteraceae;uncultured;";"96.3";"18.2";"27";"27";"26";"1";"0";"457156";"373868"
"V4mis1";"SILVA (only NR);Bacteria;Proteobacteria;Gammaproteobacteria;JG36-GS-52;";"100.0";"18.2";"13";"13";"13";"0";"0";"457170";"373881"
"V4mis1";"SILVA (only NR);Bacteria;Proteobacteria;Gammaproteobacteria;JG36-TzT-191;";"96.0";"18.2";"25";"25";"24";"1";"0";"457158";"373870"
"V4mis1";"SILVA (only NR);Bacteria;Proteobacteria;Gammaproteobacteria;JTB23;";"96.5";"18.2";"86";"86";"83";"3";"0";"457097";"373811"
"V4mis1";"SILVA (only NR);Bacteria;Proteobacteria;Gammaproteobacteria;KF-JG30-C25;";"100.0";"18.2";"41";"41";"41";"0";"0";"457142";"373853"
"V4mis1";"SILVA (only NR);Bacteria;Proteobacteria;Gammaproteobacteria;Legionellales;";"97.0";"18.2";"628";"628";"609";"19";"0";"456555";"373285"
"V4mis1";"SILVA (only NR);Bacteria;Proteobacteria;Gammaproteobacteria;Legionellales;Legionellaceae;";"97.0";"18.2";"628";"628";"609";"19";"0";"456555";"373285"
"V4mis1";"SILVA (only NR);Bacteria;Proteobacteria;Gammaproteobacteria;Legionellales;Legionellaceae;Legionella;";"97.3";"18.2";"566";"566";"551";"15";"0";"456617";"373343"
"V4mis1";"SILVA (only NR);Bacteria;Proteobacteria;Gammaproteobacteria;Legionellales;Legionellaceae;uncultured;";"93.4";"18.2";"61";"61";"57";"4";"0";"457122";"373837"
"V4mis1";"SILVA (only NR);Bacteria;Proteobacteria;Gammaproteobacteria;MBMPE27;";"95.6";"18.2";"45";"45";"43";"2";"0";"457138";"373851"
"V4mis1";"SILVA (only NR);Bacteria;Proteobacteria;Gammaproteobacteria;MD2904-B13;";"100.0";"18.2";"8";"8";"8";"0";"0";"457175";"373886"
"V4mis1";"SILVA (only NR);Bacteria;Proteobacteria;Gammaproteobacteria;Methylococcales;";"94.8";"18.2";"675";"675";"640";"35";"0";"456508";"373254"
"V4mis1";"SILVA (only NR);Bacteria;Proteobacteria;Gammaproteobacteria;Methylococcales;Cycloclasticaceae;";"96.4";"18.2";"28";"28";"27";"1";"0";"457155";"373867"
"V4mis1";"SILVA (only NR);Bacteria;Proteobacteria;Gammaproteobacteria;Methylococcales;Cycloclasticaceae;Cycloclasticus;";"96.4";"18.2";"28";"28";"27";"1";"0";"457155";"373867"
"V4mis1";"SILVA (only NR);Bacteria;Proteobacteria;Gammaproteobacteria;Methylococcales;Methylococcaceae;";"93.5";"18.2";"107";"107";"100";"7";"0";"457076";"373794"
"V4mis1";"SILVA (only NR);Bacteria;Proteobacteria;Gammaproteobacteria;Methylococcales;Methylococcaceae;Candidatus Methylospira;";"100.0";"18.2";"6";"6";"6";"0";"0";"457177";"373888"
"V4mis1";"SILVA (only NR);Bacteria;Proteobacteria;Gammaproteobacteria;Methylococcales;Methylococcaceae;Methylocaldum;";"90.0";"18.2";"20";"20";"18";"2";"0";"457163";"373876"
"V4mis1";"SILVA (only NR);Bacteria;Proteobacteria;Gammaproteobacteria;Methylococcales;Methylococcaceae;Methylococcus;";"94.4";"18.2";"18";"18";"17";"1";"0";"457165";"373877"
"V4mis1";"SILVA (only NR);Bacteria;Proteobacteria;Gammaproteobacteria;Methylococcales;Methylococcaceae;Methylogaea;";"100.0";"18.2";"1";"1";"1";"0";"0";"457182";"373893"
"V4mis1";"SILVA (only NR);Bacteria;Proteobacteria;Gammaproteobacteria;Methylococcales;Methylococcaceae;Methylomagnum;";"100.0";"18.2";"4";"4";"4";"0";"0";"457179";"373890"
"V4mis1";"SILVA (only NR);Bacteria;Proteobacteria;Gammaproteobacteria;Methylococcales;Methylococcaceae;Methyloparacoccus;";"85.7";"18.2";"14";"14";"12";"2";"0";"457169";"373882"
"V4mis1";"SILVA (only NR);Bacteria;Proteobacteria;Gammaproteobacteria;Methylococcales;Methylococcaceae;Methyloterricola;";"100.0";"18.2";"1";"1";"1";"0";"0";"457182";"373893"
"V4mis1";"SILVA (only NR);Bacteria;Proteobacteria;Gammaproteobacteria;Methylococcales;Methylococcaceae;uncultured;";"97.1";"18.2";"35";"35";"34";"1";"0";"457148";"373860"
"V4mis1";"SILVA (only NR);Bacteria;Proteobacteria;Gammaproteobacteria;Methylococcales;Methylohalobiaceae;";"91.7";"18.2";"12";"12";"11";"1";"0";"457171";"373883"
"V4mis1";"SILVA (only NR);Bacteria;Proteobacteria;Gammaproteobacteria;Methylococcales;Methylohalobiaceae;Methylohalobius;";"100.0";"18.2";"4";"4";"4";"0";"0";"457179";"373890"
"V4mis1";"SILVA (only NR);Bacteria;Proteobacteria;Gammaproteobacteria;Methylococcales;Methylohalobiaceae;Methylomarinovum;";"66.7";"18.2";"3";"3";"2";"1";"0";"457180";"373892"
"V4mis1";"SILVA (only NR);Bacteria;Proteobacteria;Gammaproteobacteria;Methylococcales;Methylohalobiaceae;Methylothermus;";"100.0";"18.2";"5";"5";"5";"0";"0";"457178";"373889"
"V4mis1";"SILVA (only NR);Bacteria;Proteobacteria;Gammaproteobacteria;Methylococcales;Methylomonadaceae;";"95.1";"18.2";"528";"528";"502";"26";"0";"456655";"373392"
"V4mis1";"SILVA (only NR);Bacteria;Proteobacteria;Gammaproteobacteria;Methylococcales;Methylomonadaceae;Crenothrix;";"96.9";"18.2";"64";"64";"62";"2";"0";"457119";"373832"
"V4mis1";"SILVA (only NR);Bacteria;Proteobacteria;Gammaproteobacteria;Methylococcales;Methylomonadaceae;ET-SHO;";"100.0";"18.2";"7";"7";"7";"0";"0";"457176";"373887"
"V4mis1";"SILVA (only NR);Bacteria;Proteobacteria;Gammaproteobacteria;Methylococcales;Methylomonadaceae;IheB2-23;";"84.2";"18.2";"19";"19";"16";"3";"0";"457164";"373878"
"V4mis1";"SILVA (only NR);Bacteria;Proteobacteria;Gammaproteobacteria;Methylococcales;Methylomonadaceae;Marine Methylotrophic Group 2;";"94.4";"18.2";"71";"71";"67";"4";"0";"457112";"373827"
"V4mis1";"SILVA (only NR);Bacteria;Proteobacteria;Gammaproteobacteria;Methylococcales;Methylomonadaceae;Methylobacter;";"94.5";"18.2";"55";"55";"52";"3";"0";"457128";"373842"
"V4mis1";"SILVA (only NR);Bacteria;Proteobacteria;Gammaproteobacteria;Methylococcales;Methylomonadaceae;Methyloglobulus;";"92.3";"18.2";"13";"13";"12";"1";"0";"457170";"373882"
"V4mis1";"SILVA (only NR);Bacteria;Proteobacteria;Gammaproteobacteria;Methylococcales;Methylomonadaceae;Methylomarinum;";"88.9";"18.2";"9";"9";"8";"1";"0";"457174";"373886"
"V4mis1";"SILVA (only NR);Bacteria;Proteobacteria;Gammaproteobacteria;Methylococcales;Methylomonadaceae;Methylomicrobium;";"96.8";"18.2";"31";"31";"30";"1";"0";"457152";"373864"
"V4mis1";"SILVA (only NR);Bacteria;Proteobacteria;Gammaproteobacteria;Methylococcales;Methylomonadaceae;Methylomonas;";"97.6";"18.2";"83";"83";"81";"2";"0";"457100";"373813"
"V4mis1";"SILVA (only NR);Bacteria;Proteobacteria;Gammaproteobacteria;Methylococcales;Methylomonadaceae;Methyloprofundus;";"92.7";"18.2";"55";"55";"51";"4";"0";"457128";"373843"
"V4mis1";"SILVA (only NR);Bacteria;Proteobacteria;Gammaproteobacteria;Methylococcales;Methylomonadaceae;Methylosarcina;";"100.0";"18.2";"9";"9";"9";"0";"0";"457174";"373885"
"V4mis1";"SILVA (only NR);Bacteria;Proteobacteria;Gammaproteobacteria;Methylococcales;Methylomonadaceae;Methylosoma;";"100.0";"18.2";"1";"1";"1";"0";"0";"457182";"373893"
"V4mis1";"SILVA (only NR);Bacteria;Proteobacteria;Gammaproteobacteria;Methylococcales;Methylomonadaceae;Methylosphaera;";"100.0";"18.2";"1";"1";"1";"0";"0";"457182";"373893"
"V4mis1";"SILVA (only NR);Bacteria;Proteobacteria;Gammaproteobacteria;Methylococcales;Methylomonadaceae;Methylovulum;";"100.0";"18.2";"19";"19";"19";"0";"0";"457164";"373875"
"V4mis1";"SILVA (only NR);Bacteria;Proteobacteria;Gammaproteobacteria;Methylococcales;Methylomonadaceae;Milano-WF1B-03;";"92.1";"18.2";"38";"38";"35";"3";"0";"457145";"373859"
"V4mis1";"SILVA (only NR);Bacteria;Proteobacteria;Gammaproteobacteria;Methylococcales;Methylomonadaceae;Milano-WF1B-42;";"100.0";"18.2";"3";"3";"3";"0";"0";"457180";"373891"
"V4mis1";"SILVA (only NR);Bacteria;Proteobacteria;Gammaproteobacteria;Methylococcales;Methylomonadaceae;pItb-vmat-59;";"100.0";"18.2";"10";"10";"10";"0";"0";"457173";"373884"
"V4mis1";"SILVA (only NR);Bacteria;Proteobacteria;Gammaproteobacteria;Methylococcales;Methylomonadaceae;pLW-20;";"90.5";"18.2";"21";"21";"19";"2";"0";"457162";"373875"
"V4mis1";"SILVA (only NR);Bacteria;Proteobacteria;Gammaproteobacteria;Methylococcales;Methylomonadaceae;uncultured;";"100.0";"18.2";"19";"19";"19";"0";"0";"457164";"373875"
"V4mis1";"SILVA (only NR);Bacteria;Proteobacteria;Gammaproteobacteria;Milano-WF1B-44;";"95.2";"18.2";"21";"21";"20";"1";"0";"457162";"373874"
"V4mis1";"SILVA (only NR);Bacteria;Proteobacteria;Gammaproteobacteria;NKB5;";"100.0";"18.2";"2";"2";"2";"0";"0";"457181";"373892"
"V4mis1";"SILVA (only NR);Bacteria;Proteobacteria;Gammaproteobacteria;Nitrococcales;";"97.1";"18.2";"138";"138";"134";"4";"0";"457045";"373760"
"V4mis1";"SILVA (only NR);Bacteria;Proteobacteria;Gammaproteobacteria;Nitrococcales;Halorhodospiraceae;";"96.7";"18.2";"61";"61";"59";"2";"0";"457122";"373835"
"V4mis1";"SILVA (only NR);Bacteria;Proteobacteria;Gammaproteobacteria;Nitrococcales;Halorhodospiraceae;Alkalilimnicola;";"100.0";"18.2";"3";"3";"3";"0";"0";"457180";"373891"
"V4mis1";"SILVA (only NR);Bacteria;Proteobacteria;Gammaproteobacteria;Nitrococcales;Halorhodospiraceae;Alkalispirillum;";"100.0";"18.2";"2";"2";"2";"0";"0";"457181";"373892"
"V4mis1";"SILVA (only NR);Bacteria;Proteobacteria;Gammaproteobacteria;Nitrococcales;Halorhodospiraceae;Halorhodospira;";"95.7";"18.2";"46";"46";"44";"2";"0";"457137";"373850"
"V4mis1";"SILVA (only NR);Bacteria;Proteobacteria;Gammaproteobacteria;Nitrococcales;Halorhodospiraceae;Sulfurivirga;";"100.0";"18.2";"6";"6";"6";"0";"0";"457177";"373888"
"V4mis1";"SILVA (only NR);Bacteria;Proteobacteria;Gammaproteobacteria;Nitrococcales;Halorhodospiraceae;uncultured;";"100.0";"18.2";"2";"2";"2";"0";"0";"457181";"373892"
"V4mis1";"SILVA (only NR);Bacteria;Proteobacteria;Gammaproteobacteria;Nitrococcales;Nitrococcaceae;";"97.0";"18.2";"66";"66";"64";"2";"0";"457117";"373830"
"V4mis1";"SILVA (only NR);Bacteria;Proteobacteria;Gammaproteobacteria;Nitrococcales;Nitrococcaceae;Aquisalimonas;";"100.0";"18.2";"10";"10";"10";"0";"0";"457173";"373884"
"V4mis1";"SILVA (only NR);Bacteria;Proteobacteria;Gammaproteobacteria;Nitrococcales;Nitrococcaceae;Arhodomonas;";"100.0";"18.2";"4";"4";"4";"0";"0";"457179";"373890"
"V4mis1";"SILVA (only NR);Bacteria;Proteobacteria;Gammaproteobacteria;Nitrococcales;Nitrococcaceae;Halopeptonella;";"94.4";"18.2";"18";"18";"17";"1";"0";"457165";"373877"
"V4mis1";"SILVA (only NR);Bacteria;Proteobacteria;Gammaproteobacteria;Nitrococcales;Nitrococcaceae;Nitrococcus;";"100.0";"18.2";"7";"7";"7";"0";"0";"457176";"373887"
"V4mis1";"SILVA (only NR);Bacteria;Proteobacteria;Gammaproteobacteria;Nitrococcales;Nitrococcaceae;Spiribacter;";"100.0";"18.2";"16";"16";"16";"0";"0";"457167";"373878"
"V4mis1";"SILVA (only NR);Bacteria;Proteobacteria;Gammaproteobacteria;Nitrococcales;Nitrococcaceae;uncultured;";"100.0";"18.2";"10";"10";"10";"0";"0";"457173";"373884"
"V4mis1";"SILVA (only NR);Bacteria;Proteobacteria;Gammaproteobacteria;Nitrococcales;Nitrococcales Incertae Sedis;";"100.0";"18.2";"11";"11";"11";"0";"0";"457172";"373883"
"V4mis1";"SILVA (only NR);Bacteria;Proteobacteria;Gammaproteobacteria;Nitrococcales;Nitrococcales Incertae Sedis;Methylonatrum;";"100.0";"18.2";"10";"10";"10";"0";"0";"457173";"373884"
"V4mis1";"SILVA (only NR);Bacteria;Proteobacteria;Gammaproteobacteria;Nitrococcales;Nitrococcales Incertae Sedis;Natronocella;";"100.0";"18.2";"1";"1";"1";"0";"0";"457182";"373893"
"V4mis1";"SILVA (only NR);Bacteria;Proteobacteria;Gammaproteobacteria;Nitrosococcales;";"94.8";"18.2";"424";"424";"402";"22";"0";"456759";"373492"
"V4mis1";"SILVA (only NR);Bacteria;Proteobacteria;Gammaproteobacteria;Nitrosococcales;Methylophagaceae;";"93.8";"18.2";"209";"209";"196";"13";"0";"456974";"373698"
"V4mis1";"SILVA (only NR);Bacteria;Proteobacteria;Gammaproteobacteria;Nitrosococcales;Methylophagaceae;Marine Methylotrophic Group 3;";"100.0";"18.2";"40";"40";"40";"0";"0";"457143";"373854"
"V4mis1";"SILVA (only NR);Bacteria;Proteobacteria;Gammaproteobacteria;Nitrosococcales;Methylophagaceae;Methylophaga;";"89.3";"18.2";"122";"122";"109";"13";"0";"457061";"373785"
"V4mis1";"SILVA (only NR);Bacteria;Proteobacteria;Gammaproteobacteria;Nitrosococcales;Methylophagaceae;uncultured;";"100.0";"18.2";"46";"46";"46";"0";"0";"457137";"373848"
"V4mis1";"SILVA (only NR);Bacteria;Proteobacteria;Gammaproteobacteria;Nitrosococcales;Nitrosococcaceae;";"95.8";"18.2";"215";"215";"206";"9";"0";"456968";"373688"
"V4mis1";"SILVA (only NR);Bacteria;Proteobacteria;Gammaproteobacteria;Nitrosococcales;Nitrosococcaceae;3PJM14;";"80.0";"18.2";"5";"5";"4";"1";"0";"457178";"373890"
"V4mis1";"SILVA (only NR);Bacteria;Proteobacteria;Gammaproteobacteria;Nitrosococcales;Nitrosococcaceae;AqS1;";"97.1";"18.2";"70";"70";"68";"2";"0";"457113";"373826"
"V4mis1";"SILVA (only NR);Bacteria;Proteobacteria;Gammaproteobacteria;Nitrosococcales;Nitrosococcaceae;CI75cm.2.12;";"83.3";"18.2";"12";"12";"10";"2";"0";"457171";"373884"
"V4mis1";"SILVA (only NR);Bacteria;Proteobacteria;Gammaproteobacteria;Nitrosococcales;Nitrosococcaceae;Candidatus Nitrosoglobus;";"100.0";"18.2";"3";"3";"3";"0";"0";"457180";"373891"
"V4mis1";"SILVA (only NR);Bacteria;Proteobacteria;Gammaproteobacteria;Nitrosococcales;Nitrosococcaceae;Cm1-21;";"100.0";"18.2";"19";"19";"19";"0";"0";"457164";"373875"
"V4mis1";"SILVA (only NR);Bacteria;Proteobacteria;Gammaproteobacteria;Nitrosococcales;Nitrosococcaceae;FS142-36B-02;";"100.0";"18.2";"14";"14";"14";"0";"0";"457169";"373880"
"V4mis1";"SILVA (only NR);Bacteria;Proteobacteria;Gammaproteobacteria;Nitrosococcales;Nitrosococcaceae;Inmirania;";"100.0";"18.2";"7";"7";"7";"0";"0";"457176";"373887"
"V4mis1";"SILVA (only NR);Bacteria;Proteobacteria;Gammaproteobacteria;Nitrosococcales;Nitrosococcaceae;MSB-1D1;";"100.0";"18.2";"6";"6";"6";"0";"0";"457177";"373888"
"V4mis1";"SILVA (only NR);Bacteria;Proteobacteria;Gammaproteobacteria;Nitrosococcales;Nitrosococcaceae;Nitrosococcus;";"100.0";"18.2";"12";"12";"12";"0";"0";"457171";"373882"
"V4mis1";"SILVA (only NR);Bacteria;Proteobacteria;Gammaproteobacteria;Nitrosococcales;Nitrosococcaceae;SZB85;";"92.3";"18.2";"13";"13";"12";"1";"0";"457170";"373882"
"V4mis1";"SILVA (only NR);Bacteria;Proteobacteria;Gammaproteobacteria;Nitrosococcales;Nitrosococcaceae;wb1-P19;";"94.4";"18.2";"54";"54";"51";"3";"0";"457129";"373843"
"V4mis1";"SILVA (only NR);Bacteria;Proteobacteria;Gammaproteobacteria;P0X4b2H11;";"100.0";"18.2";"2";"2";"2";"0";"0";"457181";"373892"
"V4mis1";"SILVA (only NR);Bacteria;Proteobacteria;Gammaproteobacteria;PLTA13;";"95.7";"18.2";"92";"92";"88";"4";"0";"457091";"373806"
"V4mis1";"SILVA (only NR);Bacteria;Proteobacteria;Gammaproteobacteria;Piscirickettsiales;";"98.2";"18.2";"57";"57";"56";"1";"0";"457126";"373838"
"V4mis1";"SILVA (only NR);Bacteria;Proteobacteria;Gammaproteobacteria;Piscirickettsiales;Piscirickettsiaceae;";"98.2";"18.2";"57";"57";"56";"1";"0";"457126";"373838"
"V4mis1";"SILVA (only NR);Bacteria;Proteobacteria;Gammaproteobacteria;Piscirickettsiales;Piscirickettsiaceae;Candidatus Endoecteinascidia;";"100.0";"18.2";"23";"23";"23";"0";"0";"457160";"373871"
"V4mis1";"SILVA (only NR);Bacteria;Proteobacteria;Gammaproteobacteria;Piscirickettsiales;Piscirickettsiaceae;Piscirickettsia;";"97.1";"18.2";"34";"34";"33";"1";"0";"457149";"373861"
"V4mis1";"SILVA (only NR);Bacteria;Proteobacteria;Gammaproteobacteria;Pseudomonadales;";"91.5";"18.6";"17709";"17709";"16208";"1501";"0";"439474";"357686"
"V4mis1";"SILVA (only NR);Bacteria;Proteobacteria;Gammaproteobacteria;Pseudomonadales;211ds20;";"100.0";"18.2";"13";"13";"13";"0";"0";"457170";"373881"
"V4mis1";"SILVA (only NR);Bacteria;Proteobacteria;Gammaproteobacteria;Pseudomonadales;Alcanivoracaceae1;";"91.6";"18.2";"323";"323";"296";"27";"0";"456860";"373598"
"V4mis1";"SILVA (only NR);Bacteria;Proteobacteria;Gammaproteobacteria;Pseudomonadales;Alcanivoracaceae1;Alcanivorax;";"91.6";"18.2";"323";"323";"296";"27";"0";"456860";"373598"
"V4mis1";"SILVA (only NR);Bacteria;Proteobacteria;Gammaproteobacteria;Pseudomonadales;Alcanivoracaceae;";"94.9";"18.2";"39";"39";"37";"2";"0";"457144";"373857"
"V4mis1";"SILVA (only NR);Bacteria;Proteobacteria;Gammaproteobacteria;Pseudomonadales;Alcanivoracaceae;Ketobacter;";"94.9";"18.2";"39";"39";"37";"2";"0";"457144";"373857"
"V4mis1";"SILVA (only NR);Bacteria;Proteobacteria;Gammaproteobacteria;Pseudomonadales;BD2-7;";"100.0";"18.2";"14";"14";"14";"0";"0";"457169";"373880"
"V4mis1";"SILVA (only NR);Bacteria;Proteobacteria;Gammaproteobacteria;Pseudomonadales;Cellvibrionaceae;";"94.2";"18.2";"326";"326";"307";"19";"0";"456857";"373587"
"V4mis1";"SILVA (only NR);Bacteria;Proteobacteria;Gammaproteobacteria;Pseudomonadales;Cellvibrionaceae;Aestuariicella;";"94.1";"18.2";"17";"17";"16";"1";"0";"457166";"373878"
"V4mis1";"SILVA (only NR);Bacteria;Proteobacteria;Gammaproteobacteria;Pseudomonadales;Cellvibrionaceae;Agaribacterium;";"100.0";"18.2";"7";"7";"7";"0";"0";"457176";"373887"
"V4mis1";"SILVA (only NR);Bacteria;Proteobacteria;Gammaproteobacteria;Pseudomonadales;Cellvibrionaceae;Agarilytica;";"100.0";"18.2";"6";"6";"6";"0";"0";"457177";"373888"
"V4mis1";"SILVA (only NR);Bacteria;Proteobacteria;Gammaproteobacteria;Pseudomonadales;Cellvibrionaceae;Candidatus Endobugula;";"83.3";"18.2";"6";"6";"5";"1";"0";"457177";"373889"
"V4mis1";"SILVA (only NR);Bacteria;Proteobacteria;Gammaproteobacteria;Pseudomonadales;Cellvibrionaceae;Cellvibrio;";"94.0";"18.2";"100";"100";"94";"6";"0";"457083";"373800"
"V4mis1";"SILVA (only NR);Bacteria;Proteobacteria;Gammaproteobacteria;Pseudomonadales;Cellvibrionaceae;Eionea;";"100.0";"18.2";"4";"4";"4";"0";"0";"457179";"373890"
"V4mis1";"SILVA (only NR);Bacteria;Proteobacteria;Gammaproteobacteria;Pseudomonadales;Cellvibrionaceae;Gilvimarinus;";"93.8";"18.2";"16";"16";"15";"1";"0";"457167";"373879"
"V4mis1";"SILVA (only NR);Bacteria;Proteobacteria;Gammaproteobacteria;Pseudomonadales;Cellvibrionaceae;Halioxenophilus;";"100.0";"18.2";"3";"3";"3";"0";"0";"457180";"373891"
"V4mis1";"SILVA (only NR);Bacteria;Proteobacteria;Gammaproteobacteria;Pseudomonadales;Cellvibrionaceae;Maricurvus;";"100.0";"18.2";"2";"2";"2";"0";"0";"457181";"373892"
"V4mis1";"SILVA (only NR);Bacteria;Proteobacteria;Gammaproteobacteria;Pseudomonadales;Cellvibrionaceae;Marinagarivorans;";"100.0";"18.2";"4";"4";"4";"0";"0";"457179";"373890"
"V4mis1";"SILVA (only NR);Bacteria;Proteobacteria;Gammaproteobacteria;Pseudomonadales;Cellvibrionaceae;Marinibactrum;";"100.0";"18.2";"1";"1";"1";"0";"0";"457182";"373893"
"V4mis1";"SILVA (only NR);Bacteria;Proteobacteria;Gammaproteobacteria;Pseudomonadales;Cellvibrionaceae;Marinimicrobium;";"90.0";"18.2";"40";"40";"36";"4";"0";"457143";"373858"
"V4mis1";"SILVA (only NR);Bacteria;Proteobacteria;Gammaproteobacteria;Pseudomonadales;Cellvibrionaceae;Pseudomaricurvus;";"50.0";"18.2";"2";"2";"1";"1";"0";"457181";"373893"
"V4mis1";"SILVA (only NR);Bacteria;Proteobacteria;Gammaproteobacteria;Pseudomonadales;Cellvibrionaceae;Pseudoteredinibacter;";"100.0";"18.2";"5";"5";"5";"0";"0";"457178";"373889"
"V4mis1";"SILVA (only NR);Bacteria;Proteobacteria;Gammaproteobacteria;Pseudomonadales;Cellvibrionaceae;Saccharophagus;";"100.0";"18.2";"3";"3";"3";"0";"0";"457180";"373891"
"V4mis1";"SILVA (only NR);Bacteria;Proteobacteria;Gammaproteobacteria;Pseudomonadales;Cellvibrionaceae;Simiduia;";"100.0";"18.2";"6";"6";"6";"0";"0";"457177";"373888"
"V4mis1";"SILVA (only NR);Bacteria;Proteobacteria;Gammaproteobacteria;Pseudomonadales;Cellvibrionaceae;Teredinibacter;";"100.0";"18.2";"4";"4";"4";"0";"0";"457179";"373890"
"V4mis1";"SILVA (only NR);Bacteria;Proteobacteria;Gammaproteobacteria;Pseudomonadales;Cellvibrionaceae;Umboniibacter;";"85.7";"18.2";"7";"7";"6";"1";"0";"457176";"373888"
"V4mis1";"SILVA (only NR);Bacteria;Proteobacteria;Gammaproteobacteria;Pseudomonadales;Cellvibrionaceae;uncultured;";"96.1";"18.2";"77";"77";"74";"3";"0";"457106";"373820"
"V4mis1";"SILVA (only NR);Bacteria;Proteobacteria;Gammaproteobacteria;Pseudomonadales;Endozoicomonadaceae;";"88.3";"18.2";"334";"334";"295";"39";"0";"456849";"373599"
"V4mis1";"SILVA (only NR);Bacteria;Proteobacteria;Gammaproteobacteria;Pseudomonadales;Endozoicomonadaceae;Endozoicomonas;";"87.8";"18.2";"320";"320";"281";"39";"0";"456863";"373613"
"V4mis1";"SILVA (only NR);Bacteria;Proteobacteria;Gammaproteobacteria;Pseudomonadales;Endozoicomonadaceae;Kistimonas;";"100.0";"18.2";"9";"9";"9";"0";"0";"457174";"373885"
"V4mis1";"SILVA (only NR);Bacteria;Proteobacteria;Gammaproteobacteria;Pseudomonadales;Endozoicomonadaceae;Zooshikella;";"100.0";"18.2";"5";"5";"5";"0";"0";"457178";"373889"
"V4mis1";"SILVA (only NR);Bacteria;Proteobacteria;Gammaproteobacteria;Pseudomonadales;Gven-F17;";"100.0";"18.2";"3";"3";"3";"0";"0";"457180";"373891"
"V4mis1";"SILVA (only NR);Bacteria;Proteobacteria;Gammaproteobacteria;Pseudomonadales;Hahellaceae;";"96.3";"18.2";"27";"27";"26";"1";"0";"457156";"373868"
"V4mis1";"SILVA (only NR);Bacteria;Proteobacteria;Gammaproteobacteria;Pseudomonadales;Hahellaceae;Hahella;";"96.3";"18.2";"27";"27";"26";"1";"0";"457156";"373868"
"V4mis1";"SILVA (only NR);Bacteria;Proteobacteria;Gammaproteobacteria;Pseudomonadales;Halieaceae;";"93.8";"18.2";"517";"517";"485";"32";"0";"456666";"373409"
"V4mis1";"SILVA (only NR);Bacteria;Proteobacteria;Gammaproteobacteria;Pseudomonadales;Halieaceae;Chromatocurvus;";"100.0";"18.2";"2";"2";"2";"0";"0";"457181";"373892"
"V4mis1";"SILVA (only NR);Bacteria;Proteobacteria;Gammaproteobacteria;Pseudomonadales;Halieaceae;Congregibacter;";"100.0";"18.2";"9";"9";"9";"0";"0";"457174";"373885"
"V4mis1";"SILVA (only NR);Bacteria;Proteobacteria;Gammaproteobacteria;Pseudomonadales;Halieaceae;Haliea;";"91.7";"18.2";"12";"12";"11";"1";"0";"457171";"373883"
"V4mis1";"SILVA (only NR);Bacteria;Proteobacteria;Gammaproteobacteria;Pseudomonadales;Halieaceae;Halioglobus;";"94.4";"18.2";"160";"160";"151";"9";"0";"457023";"373743"
"V4mis1";"SILVA (only NR);Bacteria;Proteobacteria;Gammaproteobacteria;Pseudomonadales;Halieaceae;Luminiphilus;";"93.1";"18.2";"29";"29";"27";"2";"0";"457154";"373867"
"V4mis1";"SILVA (only NR);Bacteria;Proteobacteria;Gammaproteobacteria;Pseudomonadales;Halieaceae;Marimicrobium;";"75.0";"18.2";"8";"8";"6";"2";"0";"457175";"373888"
"V4mis1";"SILVA (only NR);Bacteria;Proteobacteria;Gammaproteobacteria;Pseudomonadales;Halieaceae;OM60(NOR5) clade;";"95.3";"18.2";"211";"211";"201";"10";"0";"456972";"373693"
"V4mis1";"SILVA (only NR);Bacteria;Proteobacteria;Gammaproteobacteria;Pseudomonadales;Halieaceae;Parahaliea;";"96.0";"18.2";"25";"25";"24";"1";"0";"457158";"373870"
"V4mis1";"SILVA (only NR);Bacteria;Proteobacteria;Gammaproteobacteria;Pseudomonadales;Halieaceae;Pseudohaliea;";"87.5";"18.2";"56";"56";"49";"7";"0";"457127";"373845"
"V4mis1";"SILVA (only NR);Bacteria;Proteobacteria;Gammaproteobacteria;Pseudomonadales;Halomonadaceae;";"93.8";"18.3";"1697";"1697";"1591";"106";"0";"455486";"372303"
"V4mis1";"SILVA (only NR);Bacteria;Proteobacteria;Gammaproteobacteria;Pseudomonadales;Halomonadaceae;Aidingimonas;";"100.0";"18.2";"6";"6";"6";"0";"0";"457177";"373888"
"V4mis1";"SILVA (only NR);Bacteria;Proteobacteria;Gammaproteobacteria;Pseudomonadales;Halomonadaceae;Candidatus Evansia;";"100.0";"18.2";"9";"9";"9";"0";"0";"457174";"373885"
"V4mis1";"SILVA (only NR);Bacteria;Proteobacteria;Gammaproteobacteria;Pseudomonadales;Halomonadaceae;Candidatus Portiera;";"100.0";"18.2";"41";"41";"41";"0";"0";"457142";"373853"
"V4mis1";"SILVA (only NR);Bacteria;Proteobacteria;Gammaproteobacteria;Pseudomonadales;Halomonadaceae;Carnimonas;";"78.6";"18.2";"14";"14";"11";"3";"0";"457169";"373883"
"V4mis1";"SILVA (only NR);Bacteria;Proteobacteria;Gammaproteobacteria;Pseudomonadales;Halomonadaceae;Chromohalobacter;";"95.4";"18.2";"65";"65";"62";"3";"0";"457118";"373832"
"V4mis1";"SILVA (only NR);Bacteria;Proteobacteria;Gammaproteobacteria;Pseudomonadales;Halomonadaceae;Cobetia;";"89.0";"18.2";"73";"73";"65";"8";"0";"457110";"373829"
"V4mis1";"SILVA (only NR);Bacteria;Proteobacteria;Gammaproteobacteria;Pseudomonadales;Halomonadaceae;Halomonas;";"94.1";"18.3";"1246";"1246";"1172";"74";"0";"455937";"372722"
"V4mis1";"SILVA (only NR);Bacteria;Proteobacteria;Gammaproteobacteria;Pseudomonadales;Halomonadaceae;Halospina;";"100.0";"18.2";"6";"6";"6";"0";"0";"457177";"373888"
"V4mis1";"SILVA (only NR);Bacteria;Proteobacteria;Gammaproteobacteria;Pseudomonadales;Halomonadaceae;Halotalea;";"100.0";"18.2";"2";"2";"2";"0";"0";"457181";"373892"
"V4mis1";"SILVA (only NR);Bacteria;Proteobacteria;Gammaproteobacteria;Pseudomonadales;Halomonadaceae;Halovibrio;";"85.7";"18.2";"7";"7";"6";"1";"0";"457176";"373888"
"V4mis1";"SILVA (only NR);Bacteria;Proteobacteria;Gammaproteobacteria;Pseudomonadales;Halomonadaceae;HdN1;";"100.0";"18.2";"1";"1";"1";"0";"0";"457182";"373893"
"V4mis1";"SILVA (only NR);Bacteria;Proteobacteria;Gammaproteobacteria;Pseudomonadales;Halomonadaceae;Kushneria;";"95.5";"18.2";"22";"22";"21";"1";"0";"457161";"373873"
"V4mis1";"SILVA (only NR);Bacteria;Proteobacteria;Gammaproteobacteria;Pseudomonadales;Halomonadaceae;Larsenimonas;";"100.0";"18.2";"3";"3";"3";"0";"0";"457180";"373891"
"V4mis1";"SILVA (only NR);Bacteria;Proteobacteria;Gammaproteobacteria;Pseudomonadales;Halomonadaceae;Marinospirillum;";"96.0";"18.2";"25";"25";"24";"1";"0";"457158";"373870"
"V4mis1";"SILVA (only NR);Bacteria;Proteobacteria;Gammaproteobacteria;Pseudomonadales;Halomonadaceae;Modicisalibacter;";"50.0";"18.2";"4";"4";"2";"2";"0";"457179";"373892"
"V4mis1";"SILVA (only NR);Bacteria;Proteobacteria;Gammaproteobacteria;Pseudomonadales;Halomonadaceae;Salicola;";"93.8";"18.2";"16";"16";"15";"1";"0";"457167";"373879"
"V4mis1";"SILVA (only NR);Bacteria;Proteobacteria;Gammaproteobacteria;Pseudomonadales;Halomonadaceae;Salinicola;";"87.2";"18.2";"86";"86";"75";"11";"0";"457097";"373819"
"V4mis1";"SILVA (only NR);Bacteria;Proteobacteria;Gammaproteobacteria;Pseudomonadales;Halomonadaceae;Terasakiispira;";"100.0";"18.2";"7";"7";"7";"0";"0";"457176";"373887"
"V4mis1";"SILVA (only NR);Bacteria;Proteobacteria;Gammaproteobacteria;Pseudomonadales;Halomonadaceae;Zymobacter;";"100.0";"18.2";"4";"4";"4";"0";"0";"457179";"373890"
"V4mis1";"SILVA (only NR);Bacteria;Proteobacteria;Gammaproteobacteria;Pseudomonadales;Halomonadaceae;uncultured;";"97.7";"18.2";"44";"44";"43";"1";"0";"457139";"373851"
"V4mis1";"SILVA (only NR);Bacteria;Proteobacteria;Gammaproteobacteria;Pseudomonadales;KI89A clade;";"97.4";"18.2";"78";"78";"76";"2";"0";"457105";"373818"
"V4mis1";"SILVA (only NR);Bacteria;Proteobacteria;Gammaproteobacteria;Pseudomonadales;Litoricolaceae;";"92.6";"18.2";"27";"27";"25";"2";"0";"457156";"373869"
"V4mis1";"SILVA (only NR);Bacteria;Proteobacteria;Gammaproteobacteria;Pseudomonadales;Litoricolaceae;Litoricola;";"92.6";"18.2";"27";"27";"25";"2";"0";"457156";"373869"
"V4mis1";"SILVA (only NR);Bacteria;Proteobacteria;Gammaproteobacteria;Pseudomonadales;MBAE14;";"100.0";"18.2";"41";"41";"41";"0";"0";"457142";"373853"
"V4mis1";"SILVA (only NR);Bacteria;Proteobacteria;Gammaproteobacteria;Pseudomonadales;Marinobacteraceae;";"92.7";"18.2";"590";"590";"547";"43";"0";"456593";"373347"
"V4mis1";"SILVA (only NR);Bacteria;Proteobacteria;Gammaproteobacteria;Pseudomonadales;Marinobacteraceae;Marinobacter;";"92.7";"18.2";"590";"590";"547";"43";"0";"456593";"373347"
"V4mis1";"SILVA (only NR);Bacteria;Proteobacteria;Gammaproteobacteria;Pseudomonadales;Marinomonadaceae;";"95.4";"18.2";"152";"152";"145";"7";"0";"457031";"373749"
"V4mis1";"SILVA (only NR);Bacteria;Proteobacteria;Gammaproteobacteria;Pseudomonadales;Marinomonadaceae;Marinomonas;";"95.4";"18.2";"152";"152";"145";"7";"0";"457031";"373749"
"V4mis1";"SILVA (only NR);Bacteria;Proteobacteria;Gammaproteobacteria;Pseudomonadales;Microbulbiferaceae;";"100.0";"18.2";"90";"90";"90";"0";"0";"457093";"373804"
"V4mis1";"SILVA (only NR);Bacteria;Proteobacteria;Gammaproteobacteria;Pseudomonadales;Microbulbiferaceae;Microbulbifer;";"100.0";"18.2";"90";"90";"90";"0";"0";"457093";"373804"
"V4mis1";"SILVA (only NR);Bacteria;Proteobacteria;Gammaproteobacteria;Pseudomonadales;Moraxellaceae;";"91.4";"18.3";"3680";"3680";"3362";"318";"0";"453503";"370532"
"V4mis1";"SILVA (only NR);Bacteria;Proteobacteria;Gammaproteobacteria;Pseudomonadales;Moraxellaceae;Acinetobacter;";"91.4";"18.3";"2460";"2460";"2249";"211";"0";"454723";"371645"
"V4mis1";"SILVA (only NR);Bacteria;Proteobacteria;Gammaproteobacteria;Pseudomonadales;Moraxellaceae;Alkanindiges;";"96.5";"18.2";"57";"57";"55";"2";"0";"457126";"373839"
"V4mis1";"SILVA (only NR);Bacteria;Proteobacteria;Gammaproteobacteria;Pseudomonadales;Moraxellaceae;Cavicella;";"100.0";"18.2";"14";"14";"14";"0";"0";"457169";"373880"
"V4mis1";"SILVA (only NR);Bacteria;Proteobacteria;Gammaproteobacteria;Pseudomonadales;Moraxellaceae;Enhydrobacter;";"89.4";"18.2";"132";"132";"118";"14";"0";"457051";"373776"
"V4mis1";"SILVA (only NR);Bacteria;Proteobacteria;Gammaproteobacteria;Pseudomonadales;Moraxellaceae;Faucicola;";"100.0";"18.2";"1";"1";"1";"0";"0";"457182";"373893"
"V4mis1";"SILVA (only NR);Bacteria;Proteobacteria;Gammaproteobacteria;Pseudomonadales;Moraxellaceae;Fluviicoccus;";"100.0";"18.2";"6";"6";"6";"0";"0";"457177";"373888"
"V4mis1";"SILVA (only NR);Bacteria;Proteobacteria;Gammaproteobacteria;Pseudomonadales;Moraxellaceae;Moraxella;";"83.5";"18.2";"285";"285";"238";"47";"0";"456898";"373656"
"V4mis1";"SILVA (only NR);Bacteria;Proteobacteria;Gammaproteobacteria;Pseudomonadales;Moraxellaceae;Paraperlucidibaca;";"80.0";"18.2";"5";"5";"4";"1";"0";"457178";"373890"
"V4mis1";"SILVA (only NR);Bacteria;Proteobacteria;Gammaproteobacteria;Pseudomonadales;Moraxellaceae;Perlucidibaca;";"100.0";"18.2";"7";"7";"7";"0";"0";"457176";"373887"
"V4mis1";"SILVA (only NR);Bacteria;Proteobacteria;Gammaproteobacteria;Pseudomonadales;Moraxellaceae;Permianibacter;";"100.0";"18.2";"3";"3";"3";"0";"0";"457180";"373891"
"V4mis1";"SILVA (only NR);Bacteria;Proteobacteria;Gammaproteobacteria;Pseudomonadales;Moraxellaceae;Psychrobacter;";"93.1";"18.2";"580";"580";"540";"40";"0";"456603";"373354"
"V4mis1";"SILVA (only NR);Bacteria;Proteobacteria;Gammaproteobacteria;Pseudomonadales;Moraxellaceae;[Agitococcus] lubricus group;";"93.1";"18.2";"29";"29";"27";"2";"0";"457154";"373867"
"V4mis1";"SILVA (only NR);Bacteria;Proteobacteria;Gammaproteobacteria;Pseudomonadales;Moraxellaceae;uncultured;";"98.9";"18.2";"95";"95";"94";"1";"0";"457088";"373800"
"V4mis1";"SILVA (only NR);Bacteria;Proteobacteria;Gammaproteobacteria;Pseudomonadales;Nitrincolaceae;";"91.4";"18.2";"397";"397";"363";"34";"0";"456786";"373531"
"V4mis1";"SILVA (only NR);Bacteria;Proteobacteria;Gammaproteobacteria;Pseudomonadales;Nitrincolaceae;Amphritea;";"94.1";"18.2";"34";"34";"32";"2";"0";"457149";"373862"
"V4mis1";"SILVA (only NR);Bacteria;Proteobacteria;Gammaproteobacteria;Pseudomonadales;Nitrincolaceae;Balneatrix;";"66.7";"18.2";"3";"3";"2";"1";"0";"457180";"373892"
"V4mis1";"SILVA (only NR);Bacteria;Proteobacteria;Gammaproteobacteria;Pseudomonadales;Nitrincolaceae;Corallomonas;";"100.0";"18.2";"2";"2";"2";"0";"0";"457181";"373892"
"V4mis1";"SILVA (only NR);Bacteria;Proteobacteria;Gammaproteobacteria;Pseudomonadales;Nitrincolaceae;Marinobacterium;";"91.9";"18.2";"124";"124";"114";"10";"0";"457059";"373780"
"V4mis1";"SILVA (only NR);Bacteria;Proteobacteria;Gammaproteobacteria;Pseudomonadales;Nitrincolaceae;Motiliproteus;";"100.0";"18.2";"14";"14";"14";"0";"0";"457169";"373880"
"V4mis1";"SILVA (only NR);Bacteria;Proteobacteria;Gammaproteobacteria;Pseudomonadales;Nitrincolaceae;Neptuniibacter;";"78.1";"18.2";"32";"32";"25";"7";"0";"457151";"373869"
"V4mis1";"SILVA (only NR);Bacteria;Proteobacteria;Gammaproteobacteria;Pseudomonadales;Nitrincolaceae;Neptunomonas;";"94.4";"18.2";"18";"18";"17";"1";"0";"457165";"373877"
"V4mis1";"SILVA (only NR);Bacteria;Proteobacteria;Gammaproteobacteria;Pseudomonadales;Nitrincolaceae;Nitrincola;";"87.5";"18.2";"24";"24";"21";"3";"0";"457159";"373873"
"V4mis1";"SILVA (only NR);Bacteria;Proteobacteria;Gammaproteobacteria;Pseudomonadales;Nitrincolaceae;Pontibacterium;";"100.0";"18.2";"3";"3";"3";"0";"0";"457180";"373891"
"V4mis1";"SILVA (only NR);Bacteria;Proteobacteria;Gammaproteobacteria;Pseudomonadales;Nitrincolaceae;Profundimonas;";"90.9";"18.2";"22";"22";"20";"2";"0";"457161";"373874"
"V4mis1";"SILVA (only NR);Bacteria;Proteobacteria;Gammaproteobacteria;Pseudomonadales;Nitrincolaceae;uncultured;";"93.2";"18.2";"118";"118";"110";"8";"0";"457065";"373784"
"V4mis1";"SILVA (only NR);Bacteria;Proteobacteria;Gammaproteobacteria;Pseudomonadales;OM182 clade;";"93.7";"18.2";"63";"63";"59";"4";"0";"457120";"373835"
"V4mis1";"SILVA (only NR);Bacteria;Proteobacteria;Gammaproteobacteria;Pseudomonadales;Oceanospirillaceae;";"100.0";"18.2";"19";"19";"19";"0";"0";"457164";"373875"
"V4mis1";"SILVA (only NR);Bacteria;Proteobacteria;Gammaproteobacteria;Pseudomonadales;Oceanospirillaceae;Oceanospirillum;";"100.0";"18.2";"19";"19";"19";"0";"0";"457164";"373875"
"V4mis1";"SILVA (only NR);Bacteria;Proteobacteria;Gammaproteobacteria;Pseudomonadales;Oleiphilaceae;";"96.9";"18.2";"32";"32";"31";"1";"0";"457151";"373863"
"V4mis1";"SILVA (only NR);Bacteria;Proteobacteria;Gammaproteobacteria;Pseudomonadales;Oleiphilaceae;Oleiphilus;";"96.9";"18.2";"32";"32";"31";"1";"0";"457151";"373863"
"V4mis1";"SILVA (only NR);Bacteria;Proteobacteria;Gammaproteobacteria;Pseudomonadales;P13-46;";"83.3";"18.2";"6";"6";"5";"1";"0";"457177";"373889"
"V4mis1";"SILVA (only NR);Bacteria;Proteobacteria;Gammaproteobacteria;Pseudomonadales;Porticoccaceae;";"94.6";"18.2";"240";"240";"227";"13";"0";"456943";"373667"
"V4mis1";"SILVA (only NR);Bacteria;Proteobacteria;Gammaproteobacteria;Pseudomonadales;Porticoccaceae;C1-B045;";"96.0";"18.2";"100";"100";"96";"4";"0";"457083";"373798"
"V4mis1";"SILVA (only NR);Bacteria;Proteobacteria;Gammaproteobacteria;Pseudomonadales;Porticoccaceae;Porticoccus;";"95.3";"18.2";"43";"43";"41";"2";"0";"457140";"373853"
"V4mis1";"SILVA (only NR);Bacteria;Proteobacteria;Gammaproteobacteria;Pseudomonadales;Porticoccaceae;SAR92 clade;";"92.8";"18.2";"97";"97";"90";"7";"0";"457086";"373804"
"V4mis1";"SILVA (only NR);Bacteria;Proteobacteria;Gammaproteobacteria;Pseudomonadales;Pseudohongiellaceae;";"96.8";"18.2";"250";"250";"242";"8";"0";"456933";"373652"
"V4mis1";"SILVA (only NR);Bacteria;Proteobacteria;Gammaproteobacteria;Pseudomonadales;Pseudohongiellaceae;BIyi10;";"100.0";"18.2";"29";"29";"29";"0";"0";"457154";"373865"
"V4mis1";"SILVA (only NR);Bacteria;Proteobacteria;Gammaproteobacteria;Pseudomonadales;Pseudohongiellaceae;Pseudohongiella;";"96.3";"18.2";"217";"217";"209";"8";"0";"456966";"373685"
"V4mis1";"SILVA (only NR);Bacteria;Proteobacteria;Gammaproteobacteria;Pseudomonadales;Pseudohongiellaceae;Pseudospirillum;";"100.0";"18.2";"4";"4";"4";"0";"0";"457179";"373890"
"V4mis1";"SILVA (only NR);Bacteria;Proteobacteria;Gammaproteobacteria;Pseudomonadales;Pseudomonadaceae;";"89.7";"18.4";"7564";"7564";"6785";"779";"0";"449619";"367109"
"V4mis1";"SILVA (only NR);Bacteria;Proteobacteria;Gammaproteobacteria;Pseudomonadales;Pseudomonadaceae;Azomonas;";"100.0";"18.2";"4";"4";"4";"0";"0";"457179";"373890"
"V4mis1";"SILVA (only NR);Bacteria;Proteobacteria;Gammaproteobacteria;Pseudomonadales;Pseudomonadaceae;Azorhizophilus;";"100.0";"18.2";"4";"4";"4";"0";"0";"457179";"373890"
"V4mis1";"SILVA (only NR);Bacteria;Proteobacteria;Gammaproteobacteria;Pseudomonadales;Pseudomonadaceae;Azotobacter;";"82.7";"18.2";"75";"75";"62";"13";"0";"457108";"373832"
"V4mis1";"SILVA (only NR);Bacteria;Proteobacteria;Gammaproteobacteria;Pseudomonadales;Pseudomonadaceae;Oblitimonas;";"100.0";"18.2";"9";"9";"9";"0";"0";"457174";"373885"
"V4mis1";"SILVA (only NR);Bacteria;Proteobacteria;Gammaproteobacteria;Pseudomonadales;Pseudomonadaceae;Pseudomonas;";"89.7";"18.3";"7435";"7435";"6672";"763";"0";"449748";"367222"
"V4mis1";"SILVA (only NR);Bacteria;Proteobacteria;Gammaproteobacteria;Pseudomonadales;Pseudomonadaceae;Thiopseudomonas;";"91.4";"18.2";"35";"35";"32";"3";"0";"457148";"373862"
"V4mis1";"SILVA (only NR);Bacteria;Proteobacteria;Gammaproteobacteria;Pseudomonadales;Pseudomonadaceae;Ventosimonas;";"100.0";"18.2";"1";"1";"1";"0";"0";"457182";"373893"
"V4mis1";"SILVA (only NR);Bacteria;Proteobacteria;Gammaproteobacteria;Pseudomonadales;SAR86 clade;";"95.8";"18.2";"503";"503";"482";"21";"0";"456680";"373412"
"V4mis1";"SILVA (only NR);Bacteria;Proteobacteria;Gammaproteobacteria;Pseudomonadales;Saccharospirillaceae;";"95.3";"18.2";"211";"211";"201";"10";"0";"456972";"373693"
"V4mis1";"SILVA (only NR);Bacteria;Proteobacteria;Gammaproteobacteria;Pseudomonadales;Saccharospirillaceae;Bermanella;";"75.0";"18.2";"4";"4";"3";"1";"0";"457179";"373891"
"V4mis1";"SILVA (only NR);Bacteria;Proteobacteria;Gammaproteobacteria;Pseudomonadales;Saccharospirillaceae;Gynuella;";"100.0";"18.2";"3";"3";"3";"0";"0";"457180";"373891"
"V4mis1";"SILVA (only NR);Bacteria;Proteobacteria;Gammaproteobacteria;Pseudomonadales;Saccharospirillaceae;Litoribacillus;";"100.0";"18.2";"2";"2";"2";"0";"0";"457181";"373892"
"V4mis1";"SILVA (only NR);Bacteria;Proteobacteria;Gammaproteobacteria;Pseudomonadales;Saccharospirillaceae;Litoribrevibacter;";"100.0";"18.2";"2";"2";"2";"0";"0";"457181";"373892"
"V4mis1";"SILVA (only NR);Bacteria;Proteobacteria;Gammaproteobacteria;Pseudomonadales;Saccharospirillaceae;Oceaniserpentilla;";"100.0";"18.2";"5";"5";"5";"0";"0";"457178";"373889"
"V4mis1";"SILVA (only NR);Bacteria;Proteobacteria;Gammaproteobacteria;Pseudomonadales;Saccharospirillaceae;Oceanobacter;";"94.4";"18.2";"18";"18";"17";"1";"0";"457165";"373877"
"V4mis1";"SILVA (only NR);Bacteria;Proteobacteria;Gammaproteobacteria;Pseudomonadales;Saccharospirillaceae;Oleibacter;";"95.8";"18.2";"24";"24";"23";"1";"0";"457159";"373871"
"V4mis1";"SILVA (only NR);Bacteria;Proteobacteria;Gammaproteobacteria;Pseudomonadales;Saccharospirillaceae;Oleispira;";"92.3";"18.2";"26";"26";"24";"2";"0";"457157";"373870"
"V4mis1";"SILVA (only NR);Bacteria;Proteobacteria;Gammaproteobacteria;Pseudomonadales;Saccharospirillaceae;Reinekea;";"93.3";"18.2";"30";"30";"28";"2";"0";"457153";"373866"
"V4mis1";"SILVA (only NR);Bacteria;Proteobacteria;Gammaproteobacteria;Pseudomonadales;Saccharospirillaceae;Saccharospirillum;";"100.0";"18.2";"15";"15";"15";"0";"0";"457168";"373879"
"V4mis1";"SILVA (only NR);Bacteria;Proteobacteria;Gammaproteobacteria;Pseudomonadales;Saccharospirillaceae;Salinispirillum;";"100.0";"18.2";"2";"2";"2";"0";"0";"457181";"373892"
"V4mis1";"SILVA (only NR);Bacteria;Proteobacteria;Gammaproteobacteria;Pseudomonadales;Saccharospirillaceae;Spongiispira;";"100.0";"18.2";"1";"1";"1";"0";"0";"457182";"373893"
"V4mis1";"SILVA (only NR);Bacteria;Proteobacteria;Gammaproteobacteria;Pseudomonadales;Saccharospirillaceae;Thalassolituus;";"93.3";"18.2";"15";"15";"14";"1";"0";"457168";"373880"
"V4mis1";"SILVA (only NR);Bacteria;Proteobacteria;Gammaproteobacteria;Pseudomonadales;Saccharospirillaceae;uncultured;";"96.6";"18.2";"58";"58";"56";"2";"0";"457125";"373838"
"V4mis1";"SILVA (only NR);Bacteria;Proteobacteria;Gammaproteobacteria;Pseudomonadales;Spongiibacteraceae;";"96.1";"18.2";"203";"203";"195";"8";"0";"456980";"373699"
"V4mis1";"SILVA (only NR);Bacteria;Proteobacteria;Gammaproteobacteria;Pseudomonadales;Spongiibacteraceae;BD1-7 clade;";"97.7";"18.2";"130";"130";"127";"3";"0";"457053";"373767"
"V4mis1";"SILVA (only NR);Bacteria;Proteobacteria;Gammaproteobacteria;Pseudomonadales;Spongiibacteraceae;Dasania;";"85.7";"18.2";"7";"7";"6";"1";"0";"457176";"373888"
"V4mis1";"SILVA (only NR);Bacteria;Proteobacteria;Gammaproteobacteria;Pseudomonadales;Spongiibacteraceae;Litorivivens;";"100.0";"18.2";"7";"7";"7";"0";"0";"457176";"373887"
"V4mis1";"SILVA (only NR);Bacteria;Proteobacteria;Gammaproteobacteria;Pseudomonadales;Spongiibacteraceae;Oceanicoccus;";"100.0";"18.2";"2";"2";"2";"0";"0";"457181";"373892"
"V4mis1";"SILVA (only NR);Bacteria;Proteobacteria;Gammaproteobacteria;Pseudomonadales;Spongiibacteraceae;Sinobacterium;";"75.0";"18.2";"8";"8";"6";"2";"0";"457175";"373888"
"V4mis1";"SILVA (only NR);Bacteria;Proteobacteria;Gammaproteobacteria;Pseudomonadales;Spongiibacteraceae;Spongiibacter;";"100.0";"18.2";"16";"16";"16";"0";"0";"457167";"373878"
"V4mis1";"SILVA (only NR);Bacteria;Proteobacteria;Gammaproteobacteria;Pseudomonadales;Spongiibacteraceae;Zhongshania;";"92.9";"18.2";"14";"14";"13";"1";"0";"457169";"373881"
"V4mis1";"SILVA (only NR);Bacteria;Proteobacteria;Gammaproteobacteria;Pseudomonadales;Spongiibacteraceae;uncultured;";"93.3";"18.2";"15";"15";"14";"1";"0";"457168";"373880"
"V4mis1";"SILVA (only NR);Bacteria;Proteobacteria;Gammaproteobacteria;Pseudomonadales;Thioglobaceae;";"91.1";"18.2";"257";"257";"234";"23";"0";"456926";"373660"
"V4mis1";"SILVA (only NR);Bacteria;Proteobacteria;Gammaproteobacteria;Pseudomonadales;Thioglobaceae;Candidatus Ruthia;";"100.0";"18.2";"4";"4";"4";"0";"0";"457179";"373890"
"V4mis1";"SILVA (only NR);Bacteria;Proteobacteria;Gammaproteobacteria;Pseudomonadales;Thioglobaceae;Candidatus Thioglobus;";"100.0";"18.2";"3";"3";"3";"0";"0";"457180";"373891"
"V4mis1";"SILVA (only NR);Bacteria;Proteobacteria;Gammaproteobacteria;Pseudomonadales;Thioglobaceae;Candidatus Vesicomyosocius;";"100.0";"18.2";"7";"7";"7";"0";"0";"457176";"373887"
"V4mis1";"SILVA (only NR);Bacteria;Proteobacteria;Gammaproteobacteria;Pseudomonadales;Thioglobaceae;IheB2-31;";"100.0";"18.2";"3";"3";"3";"0";"0";"457180";"373891"
"V4mis1";"SILVA (only NR);Bacteria;Proteobacteria;Gammaproteobacteria;Pseudomonadales;Thioglobaceae;JL-ETNP-Z34;";"100.0";"18.2";"2";"2";"2";"0";"0";"457181";"373892"
"V4mis1";"SILVA (only NR);Bacteria;Proteobacteria;Gammaproteobacteria;Pseudomonadales;Thioglobaceae;SUP05 cluster;";"89.9";"18.2";"228";"228";"205";"23";"0";"456955";"373689"
"V4mis1";"SILVA (only NR);Bacteria;Proteobacteria;Gammaproteobacteria;Pseudomonadales;Thioglobaceae;V38;";"100.0";"18.2";"10";"10";"10";"0";"0";"457173";"373884"
"V4mis1";"SILVA (only NR);Bacteria;Proteobacteria;Gammaproteobacteria;Pseudomonadales;Unknown Family;";"100.0";"18.2";"5";"5";"5";"0";"0";"457178";"373889"
"V4mis1";"SILVA (only NR);Bacteria;Proteobacteria;Gammaproteobacteria;Pseudomonadales;Unknown Family;Alkalimarinus;";"100.0";"18.2";"5";"5";"5";"0";"0";"457178";"373889"
"V4mis1";"SILVA (only NR);Bacteria;Proteobacteria;Gammaproteobacteria;R7C24;";"98.8";"18.2";"80";"80";"79";"1";"0";"457103";"373815"
"V4mis1";"SILVA (only NR);Bacteria;Proteobacteria;Gammaproteobacteria;Run-SP154;";"100.0";"18.2";"27";"27";"27";"0";"0";"457156";"373867"
"V4mis1";"SILVA (only NR);Bacteria;Proteobacteria;Gammaproteobacteria;S1-3-65;";"100.0";"18.2";"2";"2";"2";"0";"0";"457181";"373892"
"V4mis1";"SILVA (only NR);Bacteria;Proteobacteria;Gammaproteobacteria;SBYH-1030;";"100.0";"18.2";"2";"2";"2";"0";"0";"457181";"373892"
"V4mis1";"SILVA (only NR);Bacteria;Proteobacteria;Gammaproteobacteria;SS1-B-04-55;";"100.0";"18.2";"6";"6";"6";"0";"0";"457177";"373888"
"V4mis1";"SILVA (only NR);Bacteria;Proteobacteria;Gammaproteobacteria;SS1-B-07-19;";"80.0";"18.2";"5";"5";"4";"1";"0";"457178";"373890"
"V4mis1";"SILVA (only NR);Bacteria;Proteobacteria;Gammaproteobacteria;SS1-B-09-64;";"88.9";"18.2";"9";"9";"8";"1";"0";"457174";"373886"
"V4mis1";"SILVA (only NR);Bacteria;Proteobacteria;Gammaproteobacteria;SZB30;";"100.0";"18.2";"10";"10";"10";"0";"0";"457173";"373884"
"V4mis1";"SILVA (only NR);Bacteria;Proteobacteria;Gammaproteobacteria;SZB50;";"92.3";"18.2";"13";"13";"12";"1";"0";"457170";"373882"
"V4mis1";"SILVA (only NR);Bacteria;Proteobacteria;Gammaproteobacteria;SZB7;";"100.0";"18.2";"3";"3";"3";"0";"0";"457180";"373891"
"V4mis1";"SILVA (only NR);Bacteria;Proteobacteria;Gammaproteobacteria;Salinisphaerales;";"95.9";"18.2";"245";"245";"235";"10";"0";"456938";"373659"
"V4mis1";"SILVA (only NR);Bacteria;Proteobacteria;Gammaproteobacteria;Salinisphaerales;Algiphilaceae;";"100.0";"18.2";"5";"5";"5";"0";"0";"457178";"373889"
"V4mis1";"SILVA (only NR);Bacteria;Proteobacteria;Gammaproteobacteria;Salinisphaerales;Algiphilaceae;Algiphilus;";"100.0";"18.2";"5";"5";"5";"0";"0";"457178";"373889"
"V4mis1";"SILVA (only NR);Bacteria;Proteobacteria;Gammaproteobacteria;Salinisphaerales;Salinisphaeraceae;";"97.6";"18.2";"42";"42";"41";"1";"0";"457141";"373853"
"V4mis1";"SILVA (only NR);Bacteria;Proteobacteria;Gammaproteobacteria;Salinisphaerales;Salinisphaeraceae;Salinisphaera;";"97.6";"18.2";"42";"42";"41";"1";"0";"457141";"373853"
"V4mis1";"SILVA (only NR);Bacteria;Proteobacteria;Gammaproteobacteria;Salinisphaerales;Solimonadaceae;";"95.5";"18.2";"198";"198";"189";"9";"0";"456985";"373705"
"V4mis1";"SILVA (only NR);Bacteria;Proteobacteria;Gammaproteobacteria;Salinisphaerales;Solimonadaceae;Alkanibacter;";"92.3";"18.2";"13";"13";"12";"1";"0";"457170";"373882"
"V4mis1";"SILVA (only NR);Bacteria;Proteobacteria;Gammaproteobacteria;Salinisphaerales;Solimonadaceae;Fontimonas;";"100.0";"18.2";"17";"17";"17";"0";"0";"457166";"373877"
"V4mis1";"SILVA (only NR);Bacteria;Proteobacteria;Gammaproteobacteria;Salinisphaerales;Solimonadaceae;Hydrocarboniphaga;";"94.7";"18.2";"19";"19";"18";"1";"0";"457164";"373876"
"V4mis1";"SILVA (only NR);Bacteria;Proteobacteria;Gammaproteobacteria;Salinisphaerales;Solimonadaceae;Nevskia;";"95.0";"18.2";"40";"40";"38";"2";"0";"457143";"373856"
"V4mis1";"SILVA (only NR);Bacteria;Proteobacteria;Gammaproteobacteria;Salinisphaerales;Solimonadaceae;Oceanococcus;";"100.0";"18.2";"4";"4";"4";"0";"0";"457179";"373890"
"V4mis1";"SILVA (only NR);Bacteria;Proteobacteria;Gammaproteobacteria;Salinisphaerales;Solimonadaceae;Panacagrimonas;";"92.9";"18.2";"14";"14";"13";"1";"0";"457169";"373881"
"V4mis1";"SILVA (only NR);Bacteria;Proteobacteria;Gammaproteobacteria;Salinisphaerales;Solimonadaceae;Polycyclovorans;";"89.7";"18.2";"39";"39";"35";"4";"0";"457144";"373859"
"V4mis1";"SILVA (only NR);Bacteria;Proteobacteria;Gammaproteobacteria;Salinisphaerales;Solimonadaceae;Solimonas;";"100.0";"18.2";"18";"18";"18";"0";"0";"457165";"373876"
"V4mis1";"SILVA (only NR);Bacteria;Proteobacteria;Gammaproteobacteria;Salinisphaerales;Solimonadaceae;uncultured;";"100.0";"18.2";"31";"31";"31";"0";"0";"457152";"373863"
"V4mis1";"SILVA (only NR);Bacteria;Proteobacteria;Gammaproteobacteria;Steroidobacterales;";"96.0";"18.2";"827";"827";"794";"33";"0";"456356";"373100"
"V4mis1";"SILVA (only NR);Bacteria;Proteobacteria;Gammaproteobacteria;Steroidobacterales;Steroidobacteraceae;";"96.2";"18.2";"317";"317";"305";"12";"0";"456866";"373589"
"V4mis1";"SILVA (only NR);Bacteria;Proteobacteria;Gammaproteobacteria;Steroidobacterales;Steroidobacteraceae;Povalibacter;";"66.7";"18.2";"3";"3";"2";"1";"0";"457180";"373892"
"V4mis1";"SILVA (only NR);Bacteria;Proteobacteria;Gammaproteobacteria;Steroidobacterales;Steroidobacteraceae;Steroidobacter;";"96.2";"18.2";"157";"157";"151";"6";"0";"457026";"373743"
"V4mis1";"SILVA (only NR);Bacteria;Proteobacteria;Gammaproteobacteria;Steroidobacterales;Steroidobacteraceae;uncultured;";"96.8";"18.2";"155";"155";"150";"5";"0";"457028";"373744"
"V4mis1";"SILVA (only NR);Bacteria;Proteobacteria;Gammaproteobacteria;Steroidobacterales;Woeseiaceae;";"95.9";"18.2";"510";"510";"489";"21";"0";"456673";"373405"
"V4mis1";"SILVA (only NR);Bacteria;Proteobacteria;Gammaproteobacteria;Steroidobacterales;Woeseiaceae;JTB255 marine benthic group;";"100.0";"18.2";"46";"46";"46";"0";"0";"457137";"373848"
"V4mis1";"SILVA (only NR);Bacteria;Proteobacteria;Gammaproteobacteria;Steroidobacterales;Woeseiaceae;Woeseia;";"95.5";"18.2";"464";"464";"443";"21";"0";"456719";"373451"
"V4mis1";"SILVA (only NR);Bacteria;Proteobacteria;Gammaproteobacteria;TDNP-Wbc97-11-7-16;";"100.0";"18.2";"2";"2";"2";"0";"0";"457181";"373892"
"V4mis1";"SILVA (only NR);Bacteria;Proteobacteria;Gammaproteobacteria;Tenderiales;";"90.9";"18.2";"33";"33";"30";"3";"0";"457150";"373864"
"V4mis1";"SILVA (only NR);Bacteria;Proteobacteria;Gammaproteobacteria;Tenderiales;Tenderiaceae;";"90.9";"18.2";"33";"33";"30";"3";"0";"457150";"373864"
"V4mis1";"SILVA (only NR);Bacteria;Proteobacteria;Gammaproteobacteria;Tenderiales;Tenderiaceae;Candidatus Tenderia;";"90.9";"18.2";"33";"33";"30";"3";"0";"457150";"373864"
"V4mis1";"SILVA (only NR);Bacteria;Proteobacteria;Gammaproteobacteria;Thiohalorhabdales;";"98.2";"18.2";"56";"56";"55";"1";"0";"457127";"373839"
"V4mis1";"SILVA (only NR);Bacteria;Proteobacteria;Gammaproteobacteria;Thiohalorhabdales;Thiohalorhabdaceae;";"98.2";"18.2";"56";"56";"55";"1";"0";"457127";"373839"
"V4mis1";"SILVA (only NR);Bacteria;Proteobacteria;Gammaproteobacteria;Thiohalorhabdales;Thiohalorhabdaceae;Thiohalorhabdus;";"100.0";"18.2";"34";"34";"34";"0";"0";"457149";"373860"
"V4mis1";"SILVA (only NR);Bacteria;Proteobacteria;Gammaproteobacteria;Thiohalorhabdales;Thiohalorhabdaceae;uncultured;";"95.5";"18.2";"22";"22";"21";"1";"0";"457161";"373873"
"V4mis1";"SILVA (only NR);Bacteria;Proteobacteria;Gammaproteobacteria;Thiomicrospirales;";"95.7";"18.2";"281";"281";"269";"12";"0";"456902";"373625"
"V4mis1";"SILVA (only NR);Bacteria;Proteobacteria;Gammaproteobacteria;Thiomicrospirales;Thiomicrospiraceae;";"95.7";"18.2";"281";"281";"269";"12";"0";"456902";"373625"
"V4mis1";"SILVA (only NR);Bacteria;Proteobacteria;Gammaproteobacteria;Thiomicrospirales;Thiomicrospiraceae;Galenea;";"100.0";"18.2";"2";"2";"2";"0";"0";"457181";"373892"
"V4mis1";"SILVA (only NR);Bacteria;Proteobacteria;Gammaproteobacteria;Thiomicrospirales;Thiomicrospiraceae;Hydrogenovibrio;";"100.0";"18.2";"4";"4";"4";"0";"0";"457179";"373890"
"V4mis1";"SILVA (only NR);Bacteria;Proteobacteria;Gammaproteobacteria;Thiomicrospirales;Thiomicrospiraceae;Thioalkalimicrobium;";"100.0";"18.2";"12";"12";"12";"0";"0";"457171";"373882"
"V4mis1";"SILVA (only NR);Bacteria;Proteobacteria;Gammaproteobacteria;Thiomicrospirales;Thiomicrospiraceae;Thiomicrorhabdus;";"96.4";"18.2";"111";"111";"107";"4";"0";"457072";"373787"
"V4mis1";"SILVA (only NR);Bacteria;Proteobacteria;Gammaproteobacteria;Thiomicrospirales;Thiomicrospiraceae;Thiomicrospira;";"100.0";"18.2";"29";"29";"29";"0";"0";"457154";"373865"
"V4mis1";"SILVA (only NR);Bacteria;Proteobacteria;Gammaproteobacteria;Thiomicrospirales;Thiomicrospiraceae;endosymbionts;";"92.6";"18.2";"108";"108";"100";"8";"0";"457075";"373794"
"V4mis1";"SILVA (only NR);Bacteria;Proteobacteria;Gammaproteobacteria;Thiomicrospirales;Thiomicrospiraceae;uncultured;";"100.0";"18.2";"13";"13";"13";"0";"0";"457170";"373881"
"V4mis1";"SILVA (only NR);Bacteria;Proteobacteria;Gammaproteobacteria;Thioprofundaceae;";"100.0";"18.2";"8";"8";"8";"0";"0";"457175";"373886"
"V4mis1";"SILVA (only NR);Bacteria;Proteobacteria;Gammaproteobacteria;Thioprofundaceae;Thioprofundum;";"100.0";"18.2";"8";"8";"8";"0";"0";"457175";"373886"
"V4mis1";"SILVA (only NR);Bacteria;Proteobacteria;Gammaproteobacteria;Thiotrichales;";"96.0";"18.2";"623";"623";"598";"25";"0";"456560";"373296"
"V4mis1";"SILVA (only NR);Bacteria;Proteobacteria;Gammaproteobacteria;Thiotrichales;Thiotrichaceae;";"96.0";"18.2";"623";"623";"598";"25";"0";"456560";"373296"
"V4mis1";"SILVA (only NR);Bacteria;Proteobacteria;Gammaproteobacteria;Thiotrichales;Thiotrichaceae;Candidatus Navis;";"100.0";"18.2";"3";"3";"3";"0";"0";"457180";"373891"
"V4mis1";"SILVA (only NR);Bacteria;Proteobacteria;Gammaproteobacteria;Thiotrichales;Thiotrichaceae;Cocleimonas;";"94.5";"18.2";"73";"73";"69";"4";"0";"457110";"373825"
"V4mis1";"SILVA (only NR);Bacteria;Proteobacteria;Gammaproteobacteria;Thiotrichales;Thiotrichaceae;Leucothrix;";"91.7";"18.2";"24";"24";"22";"2";"0";"457159";"373872"
"V4mis1";"SILVA (only NR);Bacteria;Proteobacteria;Gammaproteobacteria;Thiotrichales;Thiotrichaceae;Thiothrix;";"95.8";"18.2";"216";"216";"207";"9";"0";"456967";"373687"
"V4mis1";"SILVA (only NR);Bacteria;Proteobacteria;Gammaproteobacteria;Thiotrichales;Thiotrichaceae;uncultured;";"96.7";"18.2";"306";"306";"296";"10";"0";"456877";"373598"
"V4mis1";"SILVA (only NR);Bacteria;Proteobacteria;Gammaproteobacteria;UBA10353 marine group;";"91.8";"18.2";"194";"194";"178";"16";"0";"456989";"373716"
"V4mis1";"SILVA (only NR);Bacteria;Proteobacteria;Gammaproteobacteria;UBA4486;";"92.9";"18.2";"14";"14";"13";"1";"0";"457169";"373881"
"V4mis1";"SILVA (only NR);Bacteria;Proteobacteria;Gammaproteobacteria;WD260;";"97.9";"18.2";"47";"47";"46";"1";"0";"457136";"373848"
"V4mis1";"SILVA (only NR);Bacteria;Proteobacteria;Gammaproteobacteria;WN-HWB-116;";"87.5";"18.2";"16";"16";"14";"2";"0";"457167";"373880"
"V4mis1";"SILVA (only NR);Bacteria;Proteobacteria;Gammaproteobacteria;Xanthomonadales;";"93.2";"18.3";"3619";"3619";"3372";"247";"0";"453564";"370522"
"V4mis1";"SILVA (only NR);Bacteria;Proteobacteria;Gammaproteobacteria;Xanthomonadales;Coralloluteibacterium;";"100.0";"18.2";"1";"1";"1";"0";"0";"457182";"373893"
"V4mis1";"SILVA (only NR);Bacteria;Proteobacteria;Gammaproteobacteria;Xanthomonadales;Rhodanobacteraceae;";"94.9";"18.2";"828";"828";"786";"42";"0";"456355";"373108"
"V4mis1";"SILVA (only NR);Bacteria;Proteobacteria;Gammaproteobacteria;Xanthomonadales;Rhodanobacteraceae;Ahniella;";"98.3";"18.2";"59";"59";"58";"1";"0";"457124";"373836"
"V4mis1";"SILVA (only NR);Bacteria;Proteobacteria;Gammaproteobacteria;Xanthomonadales;Rhodanobacteraceae;Aquimonas;";"85.0";"18.2";"20";"20";"17";"3";"0";"457163";"373877"
"V4mis1";"SILVA (only NR);Bacteria;Proteobacteria;Gammaproteobacteria;Xanthomonadales;Rhodanobacteraceae;Chiayiivirga;";"100.0";"18.2";"6";"6";"6";"0";"0";"457177";"373888"
"V4mis1";"SILVA (only NR);Bacteria;Proteobacteria;Gammaproteobacteria;Xanthomonadales;Rhodanobacteraceae;Chujaibacter;";"92.5";"18.2";"40";"40";"37";"3";"0";"457143";"373857"
"V4mis1";"SILVA (only NR);Bacteria;Proteobacteria;Gammaproteobacteria;Xanthomonadales;Rhodanobacteraceae;Dokdonella;";"96.8";"18.2";"95";"95";"92";"3";"0";"457088";"373802"
"V4mis1";"SILVA (only NR);Bacteria;Proteobacteria;Gammaproteobacteria;Xanthomonadales;Rhodanobacteraceae;Dyella;";"92.2";"18.2";"102";"102";"94";"8";"0";"457081";"373800"
"V4mis1";"SILVA (only NR);Bacteria;Proteobacteria;Gammaproteobacteria;Xanthomonadales;Rhodanobacteraceae;Frateuria;";"96.7";"18.2";"30";"30";"29";"1";"0";"457153";"373865"
"V4mis1";"SILVA (only NR);Bacteria;Proteobacteria;Gammaproteobacteria;Xanthomonadales;Rhodanobacteraceae;Fulvimonas;";"100.0";"18.2";"8";"8";"8";"0";"0";"457175";"373886"
"V4mis1";"SILVA (only NR);Bacteria;Proteobacteria;Gammaproteobacteria;Xanthomonadales;Rhodanobacteraceae;Luteibacter;";"93.5";"18.2";"62";"62";"58";"4";"0";"457121";"373836"
"V4mis1";"SILVA (only NR);Bacteria;Proteobacteria;Gammaproteobacteria;Xanthomonadales;Rhodanobacteraceae;Metallibacterium;";"86.7";"18.2";"15";"15";"13";"2";"0";"457168";"373881"
"V4mis1";"SILVA (only NR);Bacteria;Proteobacteria;Gammaproteobacteria;Xanthomonadales;Rhodanobacteraceae;Mizugakiibacter;";"100.0";"18.2";"8";"8";"8";"0";"0";"457175";"373886"
"V4mis1";"SILVA (only NR);Bacteria;Proteobacteria;Gammaproteobacteria;Xanthomonadales;Rhodanobacteraceae;Oleiagrimonas;";"100.0";"18.2";"6";"6";"6";"0";"0";"457177";"373888"
"V4mis1";"SILVA (only NR);Bacteria;Proteobacteria;Gammaproteobacteria;Xanthomonadales;Rhodanobacteraceae;Pseudofulvimonas;";"77.8";"18.2";"27";"27";"21";"6";"0";"457156";"373873"
"V4mis1";"SILVA (only NR);Bacteria;Proteobacteria;Gammaproteobacteria;Xanthomonadales;Rhodanobacteraceae;Rhodanobacter;";"97.1";"18.2";"238";"238";"231";"7";"0";"456945";"373663"
"V4mis1";"SILVA (only NR);Bacteria;Proteobacteria;Gammaproteobacteria;Xanthomonadales;Rhodanobacteraceae;Rudaea;";"100.0";"18.2";"8";"8";"8";"0";"0";"457175";"373886"
"V4mis1";"SILVA (only NR);Bacteria;Proteobacteria;Gammaproteobacteria;Xanthomonadales;Rhodanobacteraceae;Tahibacter;";"95.8";"18.2";"24";"24";"23";"1";"0";"457159";"373871"
"V4mis1";"SILVA (only NR);Bacteria;Proteobacteria;Gammaproteobacteria;Xanthomonadales;Rhodanobacteraceae;uncultured;";"96.0";"18.2";"75";"75";"72";"3";"0";"457108";"373822"
"V4mis1";"SILVA (only NR);Bacteria;Proteobacteria;Gammaproteobacteria;Xanthomonadales;Xanthomonadaceae;";"92.6";"18.3";"2774";"2774";"2569";"205";"0";"454409";"371325"
"V4mis1";"SILVA (only NR);Bacteria;Proteobacteria;Gammaproteobacteria;Xanthomonadales;Xanthomonadaceae;Arenimonas;";"96.1";"18.2";"207";"207";"199";"8";"0";"456976";"373695"
"V4mis1";"SILVA (only NR);Bacteria;Proteobacteria;Gammaproteobacteria;Xanthomonadales;Xanthomonadaceae;Luteimonas;";"94.3";"18.2";"244";"244";"230";"14";"0";"456939";"373664"
"V4mis1";"SILVA (only NR);Bacteria;Proteobacteria;Gammaproteobacteria;Xanthomonadales;Xanthomonadaceae;Lysobacter;";"90.1";"18.2";"455";"455";"410";"45";"0";"456728";"373484"
"V4mis1";"SILVA (only NR);Bacteria;Proteobacteria;Gammaproteobacteria;Xanthomonadales;Xanthomonadaceae;Pseudoxanthomonas;";"94.2";"18.2";"173";"173";"163";"10";"0";"457010";"373731"
"V4mis1";"SILVA (only NR);Bacteria;Proteobacteria;Gammaproteobacteria;Xanthomonadales;Xanthomonadaceae;Rehaibacterium;";"100.0";"18.2";"10";"10";"10";"0";"0";"457173";"373884"
"V4mis1";"SILVA (only NR);Bacteria;Proteobacteria;Gammaproteobacteria;Xanthomonadales;Xanthomonadaceae;SN8;";"83.3";"18.2";"6";"6";"5";"1";"0";"457177";"373889"
"V4mis1";"SILVA (only NR);Bacteria;Proteobacteria;Gammaproteobacteria;Xanthomonadales;Xanthomonadaceae;Silanimonas;";"89.5";"18.2";"19";"19";"17";"2";"0";"457164";"373877"
"V4mis1";"SILVA (only NR);Bacteria;Proteobacteria;Gammaproteobacteria;Xanthomonadales;Xanthomonadaceae;Stenotrophomonas;";"89.0";"18.2";"1011";"1011";"900";"111";"0";"456172";"372994"
"V4mis1";"SILVA (only NR);Bacteria;Proteobacteria;Gammaproteobacteria;Xanthomonadales;Xanthomonadaceae;Thermomonas;";"98.5";"18.2";"130";"130";"128";"2";"0";"457053";"373766"
"V4mis1";"SILVA (only NR);Bacteria;Proteobacteria;Gammaproteobacteria;Xanthomonadales;Xanthomonadaceae;Vulcaniibacterium;";"90.9";"18.2";"22";"22";"20";"2";"0";"457161";"373874"
"V4mis1";"SILVA (only NR);Bacteria;Proteobacteria;Gammaproteobacteria;Xanthomonadales;Xanthomonadaceae;Xanthomonas;";"98.4";"18.2";"369";"369";"363";"6";"0";"456814";"373531"
"V4mis1";"SILVA (only NR);Bacteria;Proteobacteria;Gammaproteobacteria;Xanthomonadales;Xanthomonadaceae;Xylella;";"100.0";"18.2";"52";"52";"52";"0";"0";"457131";"373842"
"V4mis1";"SILVA (only NR);Bacteria;Proteobacteria;Gammaproteobacteria;Xanthomonadales;Xanthomonadaceae;uncultured;";"95.4";"18.2";"65";"65";"62";"3";"0";"457118";"373832"
"V4mis1";"SILVA (only NR);Bacteria;Proteobacteria;Gammaproteobacteria;Xanthomonadales;uncultured;";"100.0";"18.2";"16";"16";"16";"0";"0";"457167";"373878"
"V4mis1";"SILVA (only NR);Bacteria;Proteobacteria;Gammaproteobacteria;eub62A3;";"100.0";"18.2";"9";"9";"9";"0";"0";"457174";"373885"
"V4mis1";"SILVA (only NR);Bacteria;Proteobacteria;Gammaproteobacteria;pItb-vmat-80;";"100.0";"18.2";"23";"23";"23";"0";"0";"457160";"373871"
"V4mis1";"SILVA (only NR);Bacteria;Proteobacteria;Gammaproteobacteria;sediment-surface35;";"100.0";"18.2";"2";"2";"2";"0";"0";"457181";"373892"
"V4mis1";"SILVA (only NR);Bacteria;Proteobacteria;Gammaproteobacteria;uncultured;";"95.0";"18.2";"240";"240";"228";"12";"0";"456943";"373666"
"V4mis1";"SILVA (only NR);Bacteria;Proteobacteria;Magnetococcia;";"96.9";"18.2";"194";"194";"188";"6";"0";"456989";"373706"
"V4mis1";"SILVA (only NR);Bacteria;Proteobacteria;Magnetococcia;Magnetococcales;";"96.9";"18.2";"194";"194";"188";"6";"0";"456989";"373706"
"V4mis1";"SILVA (only NR);Bacteria;Proteobacteria;Magnetococcia;Magnetococcales;Magnetococcaceae;";"96.9";"18.2";"194";"194";"188";"6";"0";"456989";"373706"
"V4mis1";"SILVA (only NR);Bacteria;Proteobacteria;Magnetococcia;Magnetococcales;Magnetococcaceae;Magnetococcus;";"96.9";"18.2";"194";"194";"188";"6";"0";"456989";"373706"
"V4mis1";"SILVA (only NR);Bacteria;Proteobacteria;Zetaproteobacteria;";"99.3";"18.2";"136";"136";"135";"1";"0";"457047";"373759"
"V4mis1";"SILVA (only NR);Bacteria;Proteobacteria;Zetaproteobacteria;Mariprofundales;";"99.3";"18.2";"136";"136";"135";"1";"0";"457047";"373759"
"V4mis1";"SILVA (only NR);Bacteria;Proteobacteria;Zetaproteobacteria;Mariprofundales;Mariprofundaceae;";"99.3";"18.2";"136";"136";"135";"1";"0";"457047";"373759"
"V4mis1";"SILVA (only NR);Bacteria;Proteobacteria;Zetaproteobacteria;Mariprofundales;Mariprofundaceae;Mariprofundus;";"99.3";"18.2";"136";"136";"135";"1";"0";"457047";"373759"
"V4mis1";"SILVA (only NR);Bacteria;RCP2-54;";"90.5";"18.2";"137";"137";"124";"13";"0";"457046";"373770"
"V4mis1";"SILVA (only NR);Bacteria;Rs-K70 termite group;";"93.5";"18.2";"31";"31";"29";"2";"0";"457152";"373865"
"V4mis1";"SILVA (only NR);Bacteria;SAR324 clade(Marine group B);";"96.8";"18.2";"629";"629";"609";"20";"0";"456554";"373285"
"V4mis1";"SILVA (only NR);Bacteria;Schekmanbacteria;";"97.6";"18.2";"42";"42";"41";"1";"0";"457141";"373853"
"V4mis1";"SILVA (only NR);Bacteria;Spirochaetota;";"94.5";"18.3";"4069";"4069";"3845";"224";"0";"453114";"370049"
"V4mis1";"SILVA (only NR);Bacteria;Spirochaetota;Brachyspirae;";"92.8";"18.2";"111";"111";"103";"8";"0";"457072";"373791"
"V4mis1";"SILVA (only NR);Bacteria;Spirochaetota;Brachyspirae;Brachyspirales;";"92.8";"18.2";"111";"111";"103";"8";"0";"457072";"373791"
"V4mis1";"SILVA (only NR);Bacteria;Spirochaetota;Brachyspirae;Brachyspirales;Brachyspiraceae;";"93.7";"18.2";"63";"63";"59";"4";"0";"457120";"373835"
"V4mis1";"SILVA (only NR);Bacteria;Spirochaetota;Brachyspirae;Brachyspirales;Brachyspiraceae;Brachyspira;";"93.7";"18.2";"63";"63";"59";"4";"0";"457120";"373835"
"V4mis1";"SILVA (only NR);Bacteria;Spirochaetota;Brachyspirae;Brachyspirales;Brachyspirales Incertae Sedis;";"86.7";"18.2";"15";"15";"13";"2";"0";"457168";"373881"
"V4mis1";"SILVA (only NR);Bacteria;Spirochaetota;Brachyspirae;Brachyspirales;Brachyspirales Incertae Sedis;Exilispira;";"86.7";"18.2";"15";"15";"13";"2";"0";"457168";"373881"
"V4mis1";"SILVA (only NR);Bacteria;Spirochaetota;Brachyspirae;Brachyspirales;LH041;";"93.9";"18.2";"33";"33";"31";"2";"0";"457150";"373863"
"V4mis1";"SILVA (only NR);Bacteria;Spirochaetota;Brevinematia;";"100.0";"18.2";"17";"17";"17";"0";"0";"457166";"373877"
"V4mis1";"SILVA (only NR);Bacteria;Spirochaetota;Brevinematia;Brevinematales;";"100.0";"18.2";"17";"17";"17";"0";"0";"457166";"373877"
"V4mis1";"SILVA (only NR);Bacteria;Spirochaetota;Brevinematia;Brevinematales;Brevinemataceae;";"100.0";"18.2";"17";"17";"17";"0";"0";"457166";"373877"
"V4mis1";"SILVA (only NR);Bacteria;Spirochaetota;Brevinematia;Brevinematales;Brevinemataceae;Brevinema;";"100.0";"18.2";"17";"17";"17";"0";"0";"457166";"373877"
"V4mis1";"SILVA (only NR);Bacteria;Spirochaetota;Leptospirae;";"94.6";"18.2";"336";"336";"318";"18";"0";"456847";"373576"
"V4mis1";"SILVA (only NR);Bacteria;Spirochaetota;Leptospirae;Leptospirales;";"94.6";"18.2";"336";"336";"318";"18";"0";"456847";"373576"
"V4mis1";"SILVA (only NR);Bacteria;Spirochaetota;Leptospirae;Leptospirales;Leptospiraceae;";"94.6";"18.2";"336";"336";"318";"18";"0";"456847";"373576"
"V4mis1";"SILVA (only NR);Bacteria;Spirochaetota;Leptospirae;Leptospirales;Leptospiraceae;Leptonema;";"100.0";"18.2";"5";"5";"5";"0";"0";"457178";"373889"
"V4mis1";"SILVA (only NR);Bacteria;Spirochaetota;Leptospirae;Leptospirales;Leptospiraceae;Leptospira;";"96.6";"18.2";"178";"178";"172";"6";"0";"457005";"373722"
"V4mis1";"SILVA (only NR);Bacteria;Spirochaetota;Leptospirae;Leptospirales;Leptospiraceae;RBG-16-49-21;";"88.5";"18.2";"104";"104";"92";"12";"0";"457079";"373802"
"V4mis1";"SILVA (only NR);Bacteria;Spirochaetota;Leptospirae;Leptospirales;Leptospiraceae;Rs-H88 termite group;";"100.0";"18.2";"6";"6";"6";"0";"0";"457177";"373888"
"V4mis1";"SILVA (only NR);Bacteria;Spirochaetota;Leptospirae;Leptospirales;Leptospiraceae;Turneriella;";"100.0";"18.2";"16";"16";"16";"0";"0";"457167";"373878"
"V4mis1";"SILVA (only NR);Bacteria;Spirochaetota;Leptospirae;Leptospirales;Leptospiraceae;uncultured;";"100.0";"18.2";"25";"25";"25";"0";"0";"457158";"373869"
"V4mis1";"SILVA (only NR);Bacteria;Spirochaetota;MVP-15;";"93.9";"18.2";"66";"66";"62";"4";"0";"457117";"373832"
"V4mis1";"SILVA (only NR);Bacteria;Spirochaetota;Spirochaetia;";"94.5";"18.3";"3514";"3514";"3321";"193";"0";"453669";"370573"
"V4mis1";"SILVA (only NR);Bacteria;Spirochaetota;Spirochaetia;Spirochaetales;";"94.5";"18.3";"3514";"3514";"3321";"193";"0";"453669";"370573"
"V4mis1";"SILVA (only NR);Bacteria;Spirochaetota;Spirochaetia;Spirochaetales;Spirochaetaceae;";"94.5";"18.3";"3514";"3514";"3321";"193";"0";"453669";"370573"
"V4mis1";"SILVA (only NR);Bacteria;Spirochaetota;Spirochaetia;Spirochaetales;Spirochaetaceae;Alkalispirochaeta;";"97.7";"18.2";"44";"44";"43";"1";"0";"457139";"373851"
"V4mis1";"SILVA (only NR);Bacteria;Spirochaetota;Spirochaetia;Spirochaetales;Spirochaetaceae;Borrelia;";"94.8";"18.2";"58";"58";"55";"3";"0";"457125";"373839"
"V4mis1";"SILVA (only NR);Bacteria;Spirochaetota;Spirochaetia;Spirochaetales;Spirochaetaceae;Borreliella;";"94.9";"18.2";"59";"59";"56";"3";"0";"457124";"373838"
"V4mis1";"SILVA (only NR);Bacteria;Spirochaetota;Spirochaetia;Spirochaetales;Spirochaetaceae;Candidatus Marispirochaeta;";"97.1";"18.2";"35";"35";"34";"1";"0";"457148";"373860"
"V4mis1";"SILVA (only NR);Bacteria;Spirochaetota;Spirochaetia;Spirochaetales;Spirochaetaceae;GWE2-31-10;";"100.0";"18.2";"22";"22";"22";"0";"0";"457161";"373872"
"V4mis1";"SILVA (only NR);Bacteria;Spirochaetota;Spirochaetia;Spirochaetales;Spirochaetaceae;M2PT2-76 termite group;";"100.0";"18.2";"11";"11";"11";"0";"0";"457172";"373883"
"V4mis1";"SILVA (only NR);Bacteria;Spirochaetota;Spirochaetia;Spirochaetales;Spirochaetaceae;Salinispira;";"90.9";"18.2";"11";"11";"10";"1";"0";"457172";"373884"
"V4mis1";"SILVA (only NR);Bacteria;Spirochaetota;Spirochaetia;Spirochaetales;Spirochaetaceae;Sediminispirochaeta;";"94.5";"18.2";"182";"182";"172";"10";"0";"457001";"373722"
"V4mis1";"SILVA (only NR);Bacteria;Spirochaetota;Spirochaetia;Spirochaetales;Spirochaetaceae;Sphaerochaeta;";"92.9";"18.2";"198";"198";"184";"14";"0";"456985";"373710"
"V4mis1";"SILVA (only NR);Bacteria;Spirochaetota;Spirochaetia;Spirochaetales;Spirochaetaceae;Spirochaeta 2;";"88.9";"18.2";"404";"404";"359";"45";"0";"456779";"373535"
"V4mis1";"SILVA (only NR);Bacteria;Spirochaetota;Spirochaetia;Spirochaetales;Spirochaetaceae;Spirochaeta;";"92.7";"18.2";"412";"412";"382";"30";"0";"456771";"373512"
"V4mis1";"SILVA (only NR);Bacteria;Spirochaetota;Spirochaetia;Spirochaetales;Spirochaetaceae;Termite Treponema cluster;";"95.4";"18.2";"261";"261";"249";"12";"0";"456922";"373645"
"V4mis1";"SILVA (only NR);Bacteria;Spirochaetota;Spirochaetia;Spirochaetales;Spirochaetaceae;Treponema;";"96.8";"18.3";"1427";"1427";"1381";"46";"0";"455756";"372513"
"V4mis1";"SILVA (only NR);Bacteria;Spirochaetota;Spirochaetia;Spirochaetales;Spirochaetaceae;uncultured;";"93.1";"18.2";"390";"390";"363";"27";"0";"456793";"373531"
"V4mis1";"SILVA (only NR);Bacteria;Spirochaetota;V2072-189E03;";"93.8";"18.2";"16";"16";"15";"1";"0";"457167";"373879"
"V4mis1";"SILVA (only NR);Bacteria;Spirochaetota;uncultured;";"100.0";"18.2";"7";"7";"7";"0";"0";"457176";"373887"
"V4mis1";"SILVA (only NR);Bacteria;Sumerlaeota;";"93.6";"18.2";"392";"392";"367";"25";"0";"456791";"373527"
"V4mis1";"SILVA (only NR);Bacteria;Sumerlaeota;Sumerlaeia;";"93.6";"18.2";"392";"392";"367";"25";"0";"456791";"373527"
"V4mis1";"SILVA (only NR);Bacteria;Sumerlaeota;Sumerlaeia;Sumerlaeales;";"96.9";"18.2";"261";"261";"253";"8";"0";"456922";"373641"
"V4mis1";"SILVA (only NR);Bacteria;Sumerlaeota;Sumerlaeia;Sumerlaeales;Sumerlaeaceae;";"96.9";"18.2";"261";"261";"253";"8";"0";"456922";"373641"
"V4mis1";"SILVA (only NR);Bacteria;Sumerlaeota;Sumerlaeia;Sumerlaeales;Sumerlaeaceae;Sumerlaea;";"96.9";"18.2";"261";"261";"253";"8";"0";"456922";"373641"
"V4mis1";"SILVA (only NR);Bacteria;Sumerlaeota;Sumerlaeia;uncultured;";"87.0";"18.2";"131";"131";"114";"17";"0";"457052";"373780"
"V4mis1";"SILVA (only NR);Bacteria;Sva0485;";"97.7";"18.2";"387";"387";"378";"9";"0";"456796";"373516"
"V4mis1";"SILVA (only NR);Bacteria;Synergistota;";"94.9";"18.2";"925";"925";"878";"47";"0";"456258";"373016"
"V4mis1";"SILVA (only NR);Bacteria;Synergistota;Synergistia;";"94.9";"18.2";"925";"925";"878";"47";"0";"456258";"373016"
"V4mis1";"SILVA (only NR);Bacteria;Synergistota;Synergistia;Synergistales;";"94.9";"18.2";"925";"925";"878";"47";"0";"456258";"373016"
"V4mis1";"SILVA (only NR);Bacteria;Synergistota;Synergistia;Synergistales;Synergistaceae;";"94.9";"18.2";"925";"925";"878";"47";"0";"456258";"373016"
"V4mis1";"SILVA (only NR);Bacteria;Synergistota;Synergistia;Synergistales;Synergistaceae;Acetomicrobium;";"97.0";"18.2";"33";"33";"32";"1";"0";"457150";"373862"
"V4mis1";"SILVA (only NR);Bacteria;Synergistota;Synergistia;Synergistales;Synergistaceae;Aminiphilus;";"57.1";"18.2";"7";"7";"4";"3";"0";"457176";"373890"
"V4mis1";"SILVA (only NR);Bacteria;Synergistota;Synergistia;Synergistales;Synergistaceae;Aminivibrio;";"100.0";"18.2";"12";"12";"12";"0";"0";"457171";"373882"
"V4mis1";"SILVA (only NR);Bacteria;Synergistota;Synergistia;Synergistales;Synergistaceae;Aminobacterium;";"90.9";"18.2";"22";"22";"20";"2";"0";"457161";"373874"
"V4mis1";"SILVA (only NR);Bacteria;Synergistota;Synergistia;Synergistales;Synergistaceae;Aminomonas;";"66.7";"18.2";"3";"3";"2";"1";"0";"457180";"373892"
"V4mis1";"SILVA (only NR);Bacteria;Synergistota;Synergistia;Synergistales;Synergistaceae;Candidatus Tammella;";"100.0";"18.2";"25";"25";"25";"0";"0";"457158";"373869"
"V4mis1";"SILVA (only NR);Bacteria;Synergistota;Synergistia;Synergistales;Synergistaceae;Cloacibacillus;";"95.5";"18.2";"22";"22";"21";"1";"0";"457161";"373873"
"V4mis1";"SILVA (only NR);Bacteria;Synergistota;Synergistia;Synergistales;Synergistaceae;Dethiosulfovibrio;";"100.0";"18.2";"13";"13";"13";"0";"0";"457170";"373881"
"V4mis1";"SILVA (only NR);Bacteria;Synergistota;Synergistia;Synergistales;Synergistaceae;EBM-39;";"100.0";"18.2";"9";"9";"9";"0";"0";"457174";"373885"
"V4mis1";"SILVA (only NR);Bacteria;Synergistota;Synergistia;Synergistales;Synergistaceae;Fretibacterium;";"92.3";"18.2";"181";"181";"167";"14";"0";"457002";"373727"
"V4mis1";"SILVA (only NR);Bacteria;Synergistota;Synergistia;Synergistales;Synergistaceae;JGI-0000079-D21;";"94.0";"18.2";"50";"50";"47";"3";"0";"457133";"373847"
"V4mis1";"SILVA (only NR);Bacteria;Synergistota;Synergistia;Synergistales;Synergistaceae;Jonquetella;";"100.0";"18.2";"1";"1";"1";"0";"0";"457182";"373893"
"V4mis1";"SILVA (only NR);Bacteria;Synergistota;Synergistia;Synergistales;Synergistaceae;Lactivibrio;";"93.3";"18.2";"15";"15";"14";"1";"0";"457168";"373880"
"V4mis1";"SILVA (only NR);Bacteria;Synergistota;Synergistia;Synergistales;Synergistaceae;Pyramidobacter;";"86.2";"18.2";"29";"29";"25";"4";"0";"457154";"373869"
"V4mis1";"SILVA (only NR);Bacteria;Synergistota;Synergistia;Synergistales;Synergistaceae;Syner-01;";"100.0";"18.2";"48";"48";"48";"0";"0";"457135";"373846"
"V4mis1";"SILVA (only NR);Bacteria;Synergistota;Synergistia;Synergistales;Synergistaceae;Synergistes;";"100.0";"18.2";"4";"4";"4";"0";"0";"457179";"373890"
"V4mis1";"SILVA (only NR);Bacteria;Synergistota;Synergistia;Synergistales;Synergistaceae;Thermanaerovibrio;";"100.0";"18.2";"4";"4";"4";"0";"0";"457179";"373890"
"V4mis1";"SILVA (only NR);Bacteria;Synergistota;Synergistia;Synergistales;Synergistaceae;Thermovirga;";"94.3";"18.2";"88";"88";"83";"5";"0";"457095";"373811"
"V4mis1";"SILVA (only NR);Bacteria;Synergistota;Synergistia;Synergistales;Synergistaceae;uncultured;";"96.6";"18.2";"358";"358";"346";"12";"0";"456825";"373548"
"V4mis1";"SILVA (only NR);Bacteria;TA06;";"98.6";"18.2";"72";"72";"71";"1";"0";"457111";"373823"
"V4mis1";"SILVA (only NR);Bacteria;TX1A-33;";"100.0";"18.2";"4";"4";"4";"0";"0";"457179";"373890"
"V4mis1";"SILVA (only NR);Bacteria;Thermodesulfobiota;";"100.0";"18.2";"7";"7";"7";"0";"0";"457176";"373887"
"V4mis1";"SILVA (only NR);Bacteria;Thermodesulfobiota;Thermodesulfobiia;";"100.0";"18.2";"7";"7";"7";"0";"0";"457176";"373887"
"V4mis1";"SILVA (only NR);Bacteria;Thermodesulfobiota;Thermodesulfobiia;Thermodesulfobiales;";"100.0";"18.2";"7";"7";"7";"0";"0";"457176";"373887"
"V4mis1";"SILVA (only NR);Bacteria;Thermodesulfobiota;Thermodesulfobiia;Thermodesulfobiales;Thermodesulfobiaceae;";"100.0";"18.2";"7";"7";"7";"0";"0";"457176";"373887"
"V4mis1";"SILVA (only NR);Bacteria;Thermodesulfobiota;Thermodesulfobiia;Thermodesulfobiales;Thermodesulfobiaceae;Thermodesulfobium;";"100.0";"18.2";"7";"7";"7";"0";"0";"457176";"373887"
"V4mis1";"SILVA (only NR);Bacteria;Thermosulfidibacterota;";"100.0";"18.2";"3";"3";"3";"0";"0";"457180";"373891"
"V4mis1";"SILVA (only NR);Bacteria;Thermosulfidibacterota;Thermosulfidibacteria;";"100.0";"18.2";"3";"3";"3";"0";"0";"457180";"373891"
"V4mis1";"SILVA (only NR);Bacteria;Thermosulfidibacterota;Thermosulfidibacteria;Thermosulfidibacterales;";"100.0";"18.2";"3";"3";"3";"0";"0";"457180";"373891"
"V4mis1";"SILVA (only NR);Bacteria;Thermosulfidibacterota;Thermosulfidibacteria;Thermosulfidibacterales;Thermosulfidibacteraceae;";"100.0";"18.2";"3";"3";"3";"0";"0";"457180";"373891"
"V4mis1";"SILVA (only NR);Bacteria;Thermosulfidibacterota;Thermosulfidibacteria;Thermosulfidibacterales;Thermosulfidibacteraceae;Thermosulfidibacter;";"100.0";"18.2";"3";"3";"3";"0";"0";"457180";"373891"
"V4mis1";"SILVA (only NR);Bacteria;Thermotogota;";"94.1";"18.2";"288";"288";"271";"17";"0";"456895";"373623"
"V4mis1";"SILVA (only NR);Bacteria;Thermotogota;Thermotogae;";"94.1";"18.2";"288";"288";"271";"17";"0";"456895";"373623"
"V4mis1";"SILVA (only NR);Bacteria;Thermotogota;Thermotogae;Kosmotogales;";"95.7";"18.2";"46";"46";"44";"2";"0";"457137";"373850"
"V4mis1";"SILVA (only NR);Bacteria;Thermotogota;Thermotogae;Kosmotogales;Kosmotogaceae;";"95.7";"18.2";"46";"46";"44";"2";"0";"457137";"373850"
"V4mis1";"SILVA (only NR);Bacteria;Thermotogota;Thermotogae;Kosmotogales;Kosmotogaceae;Kosmotoga;";"100.0";"18.2";"7";"7";"7";"0";"0";"457176";"373887"
"V4mis1";"SILVA (only NR);Bacteria;Thermotogota;Thermotogae;Kosmotogales;Kosmotogaceae;Mesotoga;";"94.1";"18.2";"34";"34";"32";"2";"0";"457149";"373862"
"V4mis1";"SILVA (only NR);Bacteria;Thermotogota;Thermotogae;Kosmotogales;Kosmotogaceae;uncultured;";"100.0";"18.2";"5";"5";"5";"0";"0";"457178";"373889"
"V4mis1";"SILVA (only NR);Bacteria;Thermotogota;Thermotogae;Mesoaciditogales;";"100.0";"18.2";"15";"15";"15";"0";"0";"457168";"373879"
"V4mis1";"SILVA (only NR);Bacteria;Thermotogota;Thermotogae;Mesoaciditogales;Mesoaciditogaceae;";"100.0";"18.2";"15";"15";"15";"0";"0";"457168";"373879"
"V4mis1";"SILVA (only NR);Bacteria;Thermotogota;Thermotogae;Mesoaciditogales;Mesoaciditogaceae;Mesoaciditoga;";"100.0";"18.2";"13";"13";"13";"0";"0";"457170";"373881"
"V4mis1";"SILVA (only NR);Bacteria;Thermotogota;Thermotogae;Mesoaciditogales;Mesoaciditogaceae;uncultured;";"100.0";"18.2";"2";"2";"2";"0";"0";"457181";"373892"
"V4mis1";"SILVA (only NR);Bacteria;Thermotogota;Thermotogae;Petrotogales;";"91.6";"18.2";"95";"95";"87";"8";"0";"457088";"373807"
"V4mis1";"SILVA (only NR);Bacteria;Thermotogota;Thermotogae;Petrotogales;Petrotogaceae;";"91.6";"18.2";"95";"95";"87";"8";"0";"457088";"373807"
"V4mis1";"SILVA (only NR);Bacteria;Thermotogota;Thermotogae;Petrotogales;Petrotogaceae;AUTHM297;";"75.0";"18.2";"4";"4";"3";"1";"0";"457179";"373891"
"V4mis1";"SILVA (only NR);Bacteria;Thermotogota;Thermotogae;Petrotogales;Petrotogaceae;Defluviitoga;";"79.4";"18.2";"34";"34";"27";"7";"0";"457149";"373867"
"V4mis1";"SILVA (only NR);Bacteria;Thermotogota;Thermotogae;Petrotogales;Petrotogaceae;Geotoga;";"100.0";"18.2";"4";"4";"4";"0";"0";"457179";"373890"
"V4mis1";"SILVA (only NR);Bacteria;Thermotogota;Thermotogae;Petrotogales;Petrotogaceae;Marinitoga;";"100.0";"18.2";"10";"10";"10";"0";"0";"457173";"373884"
"V4mis1";"SILVA (only NR);Bacteria;Thermotogota;Thermotogae;Petrotogales;Petrotogaceae;Oceanotoga;";"100.0";"18.2";"2";"2";"2";"0";"0";"457181";"373892"
"V4mis1";"SILVA (only NR);Bacteria;Thermotogota;Thermotogae;Petrotogales;Petrotogaceae;Petrotoga;";"100.0";"18.2";"16";"16";"16";"0";"0";"457167";"373878"
"V4mis1";"SILVA (only NR);Bacteria;Thermotogota;Thermotogae;Petrotogales;Petrotogaceae;SC103;";"100.0";"18.2";"24";"24";"24";"0";"0";"457159";"373870"
"V4mis1";"SILVA (only NR);Bacteria;Thermotogota;Thermotogae;Thermotogales;";"94.6";"18.2";"129";"129";"122";"7";"0";"457054";"373772"
"V4mis1";"SILVA (only NR);Bacteria;Thermotogota;Thermotogae;Thermotogales;Fervidobacteriaceae;";"95.9";"18.2";"74";"74";"71";"3";"0";"457109";"373823"
"V4mis1";"SILVA (only NR);Bacteria;Thermotogota;Thermotogae;Thermotogales;Fervidobacteriaceae;Fervidobacterium;";"93.8";"18.2";"48";"48";"45";"3";"0";"457135";"373849"
"V4mis1";"SILVA (only NR);Bacteria;Thermotogota;Thermotogae;Thermotogales;Fervidobacteriaceae;Thermopallium;";"100.0";"18.2";"3";"3";"3";"0";"0";"457180";"373891"
"V4mis1";"SILVA (only NR);Bacteria;Thermotogota;Thermotogae;Thermotogales;Fervidobacteriaceae;Thermosipho;";"100.0";"18.2";"23";"23";"23";"0";"0";"457160";"373871"
"V4mis1";"SILVA (only NR);Bacteria;Thermotogota;Thermotogae;Thermotogales;Thermotogaceae;";"92.7";"18.2";"55";"55";"51";"4";"0";"457128";"373843"
"V4mis1";"SILVA (only NR);Bacteria;Thermotogota;Thermotogae;Thermotogales;Thermotogaceae;Pseudothermotoga;";"88.9";"18.2";"27";"27";"24";"3";"0";"457156";"373870"
"V4mis1";"SILVA (only NR);Bacteria;Thermotogota;Thermotogae;Thermotogales;Thermotogaceae;Thermotoga;";"96.4";"18.2";"28";"28";"27";"1";"0";"457155";"373867"
"V4mis1";"SILVA (only NR);Bacteria;Thermotogota;Thermotogae;uncultured;";"100.0";"18.2";"2";"2";"2";"0";"0";"457181";"373892"
"V4mis1";"SILVA (only NR);Bacteria;Verrucomicrobiota;";"94.4";"18.4";"6648";"6648";"6274";"374";"0";"450535";"367620"
"V4mis1";"SILVA (only NR);Bacteria;Verrucomicrobiota;Chlamydiae;";"95.6";"18.2";"519";"519";"496";"23";"0";"456664";"373398"
"V4mis1";"SILVA (only NR);Bacteria;Verrucomicrobiota;Chlamydiae;Chlamydiales;";"96.3";"18.2";"433";"433";"417";"16";"0";"456750";"373477"
"V4mis1";"SILVA (only NR);Bacteria;Verrucomicrobiota;Chlamydiae;Chlamydiales;Chlamydiaceae;";"99.6";"18.2";"251";"251";"250";"1";"0";"456932";"373644"
"V4mis1";"SILVA (only NR);Bacteria;Verrucomicrobiota;Chlamydiae;Chlamydiales;Chlamydiaceae;Candidatus Amphibiichlamydia;";"100.0";"18.2";"3";"3";"3";"0";"0";"457180";"373891"
"V4mis1";"SILVA (only NR);Bacteria;Verrucomicrobiota;Chlamydiae;Chlamydiales;Chlamydiaceae;Candidatus Clavichlamydia;";"100.0";"18.2";"2";"2";"2";"0";"0";"457181";"373892"
"V4mis1";"SILVA (only NR);Bacteria;Verrucomicrobiota;Chlamydiae;Chlamydiales;Chlamydiaceae;Chlamydia;";"100.0";"18.2";"233";"233";"233";"0";"0";"456950";"373661"
"V4mis1";"SILVA (only NR);Bacteria;Verrucomicrobiota;Chlamydiae;Chlamydiales;Chlamydiaceae;uncultured;";"90.0";"18.2";"10";"10";"9";"1";"0";"457173";"373885"
"V4mis1";"SILVA (only NR);Bacteria;Verrucomicrobiota;Chlamydiae;Chlamydiales;Chlamydiales Incertae Sedis;";"100.0";"18.2";"15";"15";"15";"0";"0";"457168";"373879"
"V4mis1";"SILVA (only NR);Bacteria;Verrucomicrobiota;Chlamydiae;Chlamydiales;Chlamydiales Incertae Sedis;Candidatus Piscichlamydia;";"100.0";"18.2";"3";"3";"3";"0";"0";"457180";"373891"
"V4mis1";"SILVA (only NR);Bacteria;Verrucomicrobiota;Chlamydiae;Chlamydiales;Chlamydiales Incertae Sedis;Candidatus Similichlamydia;";"100.0";"18.2";"11";"11";"11";"0";"0";"457172";"373883"
"V4mis1";"SILVA (only NR);Bacteria;Verrucomicrobiota;Chlamydiae;Chlamydiales;Criblamydiaceae;";"100.0";"18.2";"6";"6";"6";"0";"0";"457177";"373888"
"V4mis1";"SILVA (only NR);Bacteria;Verrucomicrobiota;Chlamydiae;Chlamydiales;Criblamydiaceae;Criblamydia;";"100.0";"18.2";"1";"1";"1";"0";"0";"457182";"373893"
"V4mis1";"SILVA (only NR);Bacteria;Verrucomicrobiota;Chlamydiae;Chlamydiales;Criblamydiaceae;Estrella;";"100.0";"18.2";"1";"1";"1";"0";"0";"457182";"373893"
"V4mis1";"SILVA (only NR);Bacteria;Verrucomicrobiota;Chlamydiae;Chlamydiales;Criblamydiaceae;uncultured;";"100.0";"18.2";"2";"2";"2";"0";"0";"457181";"373892"
"V4mis1";"SILVA (only NR);Bacteria;Verrucomicrobiota;Chlamydiae;Chlamydiales;Parachlamydiaceae;";"96.8";"18.2";"62";"62";"60";"2";"0";"457121";"373834"
"V4mis1";"SILVA (only NR);Bacteria;Verrucomicrobiota;Chlamydiae;Chlamydiales;Parachlamydiaceae;Candidatus Mesochlamydia;";"100.0";"18.2";"1";"1";"1";"0";"0";"457182";"373893"
"V4mis1";"SILVA (only NR);Bacteria;Verrucomicrobiota;Chlamydiae;Chlamydiales;Parachlamydiaceae;Candidatus Metachlamydia;";"100.0";"18.2";"1";"1";"1";"0";"0";"457182";"373893"
"V4mis1";"SILVA (only NR);Bacteria;Verrucomicrobiota;Chlamydiae;Chlamydiales;Parachlamydiaceae;Candidatus Protochlamydia;";"94.7";"18.2";"19";"19";"18";"1";"0";"457164";"373876"
"V4mis1";"SILVA (only NR);Bacteria;Verrucomicrobiota;Chlamydiae;Chlamydiales;Parachlamydiaceae;Candidatus Rubidus;";"100.0";"18.2";"1";"1";"1";"0";"0";"457182";"373893"
"V4mis1";"SILVA (only NR);Bacteria;Verrucomicrobiota;Chlamydiae;Chlamydiales;Parachlamydiaceae;Neochlamydia;";"96.0";"18.2";"25";"25";"24";"1";"0";"457158";"373870"
"V4mis1";"SILVA (only NR);Bacteria;Verrucomicrobiota;Chlamydiae;Chlamydiales;Parachlamydiaceae;Parachlamydia;";"100.0";"18.2";"6";"6";"6";"0";"0";"457177";"373888"
"V4mis1";"SILVA (only NR);Bacteria;Verrucomicrobiota;Chlamydiae;Chlamydiales;Parachlamydiaceae;uncultured;";"100.0";"18.2";"7";"7";"7";"0";"0";"457176";"373887"
"V4mis1";"SILVA (only NR);Bacteria;Verrucomicrobiota;Chlamydiae;Chlamydiales;Simkaniaceae;";"84.3";"18.2";"70";"70";"59";"11";"0";"457113";"373835"
"V4mis1";"SILVA (only NR);Bacteria;Verrucomicrobiota;Chlamydiae;Chlamydiales;Simkaniaceae;Candidatus Fritschea;";"100.0";"18.2";"5";"5";"5";"0";"0";"457178";"373889"
"V4mis1";"SILVA (only NR);Bacteria;Verrucomicrobiota;Chlamydiae;Chlamydiales;Simkaniaceae;Candidatus Renichlamydia;";"100.0";"18.2";"2";"2";"2";"0";"0";"457181";"373892"
"V4mis1";"SILVA (only NR);Bacteria;Verrucomicrobiota;Chlamydiae;Chlamydiales;Simkaniaceae;Candidatus Rhabdochlamydia;";"100.0";"18.2";"6";"6";"6";"0";"0";"457177";"373888"
"V4mis1";"SILVA (only NR);Bacteria;Verrucomicrobiota;Chlamydiae;Chlamydiales;Simkaniaceae;Ga0074140;";"100.0";"18.2";"3";"3";"3";"0";"0";"457180";"373891"
"V4mis1";"SILVA (only NR);Bacteria;Verrucomicrobiota;Chlamydiae;Chlamydiales;Simkaniaceae;Simkania;";"100.0";"18.2";"2";"2";"2";"0";"0";"457181";"373892"
"V4mis1";"SILVA (only NR);Bacteria;Verrucomicrobiota;Chlamydiae;Chlamydiales;Simkaniaceae;uncultured;";"78.4";"18.2";"51";"51";"40";"11";"0";"457132";"373854"
"V4mis1";"SILVA (only NR);Bacteria;Verrucomicrobiota;Chlamydiae;Chlamydiales;Waddliaceae;";"100.0";"18.2";"6";"6";"6";"0";"0";"457177";"373888"
"V4mis1";"SILVA (only NR);Bacteria;Verrucomicrobiota;Chlamydiae;Chlamydiales;Waddliaceae;Waddlia;";"100.0";"18.2";"6";"6";"6";"0";"0";"457177";"373888"
"V4mis1";"SILVA (only NR);Bacteria;Verrucomicrobiota;Chlamydiae;Chlamydiales;cvE6;";"90.9";"18.2";"22";"22";"20";"2";"0";"457161";"373874"
"V4mis1";"SILVA (only NR);Bacteria;Verrucomicrobiota;Chlamydiae;LD1-PA32;";"91.9";"18.2";"86";"86";"79";"7";"0";"457097";"373815"
"V4mis1";"SILVA (only NR);Bacteria;Verrucomicrobiota;Kiritimatiellae;";"93.4";"18.2";"971";"971";"907";"64";"0";"456212";"372987"
"V4mis1";"SILVA (only NR);Bacteria;Verrucomicrobiota;Kiritimatiellae;113B434;";"100.0";"18.2";"4";"4";"4";"0";"0";"457179";"373890"
"V4mis1";"SILVA (only NR);Bacteria;Verrucomicrobiota;Kiritimatiellae;Kiritimatiellales;";"95.3";"18.2";"106";"106";"101";"5";"0";"457077";"373793"
"V4mis1";"SILVA (only NR);Bacteria;Verrucomicrobiota;Kiritimatiellae;Kiritimatiellales;Kiritimatiellaceae;";"95.3";"18.2";"106";"106";"101";"5";"0";"457077";"373793"
"V4mis1";"SILVA (only NR);Bacteria;Verrucomicrobiota;Kiritimatiellae;Kiritimatiellales;Kiritimatiellaceae;Kiritimatiella;";"100.0";"18.2";"3";"3";"3";"0";"0";"457180";"373891"
"V4mis1";"SILVA (only NR);Bacteria;Verrucomicrobiota;Kiritimatiellae;Kiritimatiellales;Kiritimatiellaceae;MSBL3;";"97.2";"18.2";"36";"36";"35";"1";"0";"457147";"373859"
"V4mis1";"SILVA (only NR);Bacteria;Verrucomicrobiota;Kiritimatiellae;Kiritimatiellales;Kiritimatiellaceae;R76-B128;";"95.4";"18.2";"65";"65";"62";"3";"0";"457118";"373832"
"V4mis1";"SILVA (only NR);Bacteria;Verrucomicrobiota;Kiritimatiellae;Kiritimatiellales;Kiritimatiellaceae;uncultured;";"50.0";"18.2";"2";"2";"1";"1";"0";"457181";"373893"
"V4mis1";"SILVA (only NR);Bacteria;Verrucomicrobiota;Kiritimatiellae;WCHB1-41;";"93.1";"18.2";"861";"861";"802";"59";"0";"456322";"373092"
"V4mis1";"SILVA (only NR);Bacteria;Verrucomicrobiota;Lentisphaeria;";"96.4";"18.2";"472";"472";"455";"17";"0";"456711";"373439"
"V4mis1";"SILVA (only NR);Bacteria;Verrucomicrobiota;Lentisphaeria;Lentisphaerales;";"90.9";"18.2";"33";"33";"30";"3";"0";"457150";"373864"
"V4mis1";"SILVA (only NR);Bacteria;Verrucomicrobiota;Lentisphaeria;Lentisphaerales;Lentisphaeraceae;";"90.9";"18.2";"33";"33";"30";"3";"0";"457150";"373864"
"V4mis1";"SILVA (only NR);Bacteria;Verrucomicrobiota;Lentisphaeria;Lentisphaerales;Lentisphaeraceae;Lentisphaera;";"90.9";"18.2";"33";"33";"30";"3";"0";"457150";"373864"
"V4mis1";"SILVA (only NR);Bacteria;Verrucomicrobiota;Lentisphaeria;Oligosphaerales;";"94.9";"18.2";"198";"198";"188";"10";"0";"456985";"373706"
"V4mis1";"SILVA (only NR);Bacteria;Verrucomicrobiota;Lentisphaeria;Oligosphaerales;Lenti-02;";"92.9";"18.2";"112";"112";"104";"8";"0";"457071";"373790"
"V4mis1";"SILVA (only NR);Bacteria;Verrucomicrobiota;Lentisphaeria;Oligosphaerales;Oligosphaeraceae;";"97.6";"18.2";"84";"84";"82";"2";"0";"457099";"373812"
"V4mis1";"SILVA (only NR);Bacteria;Verrucomicrobiota;Lentisphaeria;Oligosphaerales;Oligosphaeraceae;ADurb.Bin063-2;";"87.5";"18.2";"16";"16";"14";"2";"0";"457167";"373880"
"V4mis1";"SILVA (only NR);Bacteria;Verrucomicrobiota;Lentisphaeria;Oligosphaerales;Oligosphaeraceae;Oligosphaera;";"100.0";"18.2";"4";"4";"4";"0";"0";"457179";"373890"
"V4mis1";"SILVA (only NR);Bacteria;Verrucomicrobiota;Lentisphaeria;Oligosphaerales;Oligosphaeraceae;SBZC-1223;";"100.0";"18.2";"6";"6";"6";"0";"0";"457177";"373888"
"V4mis1";"SILVA (only NR);Bacteria;Verrucomicrobiota;Lentisphaeria;Oligosphaerales;Oligosphaeraceae;Z20;";"100.0";"18.2";"37";"37";"37";"0";"0";"457146";"373857"
"V4mis1";"SILVA (only NR);Bacteria;Verrucomicrobiota;Lentisphaeria;Oligosphaerales;Oligosphaeraceae;horsej-a03;";"100.0";"18.2";"18";"18";"18";"0";"0";"457165";"373876"
"V4mis1";"SILVA (only NR);Bacteria;Verrucomicrobiota;Lentisphaeria;Oligosphaerales;uncultured;";"100.0";"18.2";"2";"2";"2";"0";"0";"457181";"373892"
"V4mis1";"SILVA (only NR);Bacteria;Verrucomicrobiota;Lentisphaeria;P.palmC41;";"100.0";"18.2";"25";"25";"25";"0";"0";"457158";"373869"
"V4mis1";"SILVA (only NR);Bacteria;Verrucomicrobiota;Lentisphaeria;SS1-B-02-17;";"94.2";"18.2";"52";"52";"49";"3";"0";"457131";"373845"
"V4mis1";"SILVA (only NR);Bacteria;Verrucomicrobiota;Lentisphaeria;Victivallales;";"99.4";"18.2";"164";"164";"163";"1";"0";"457019";"373731"
"V4mis1";"SILVA (only NR);Bacteria;Verrucomicrobiota;Lentisphaeria;Victivallales;Arctic95B-14;";"100.0";"18.2";"12";"12";"12";"0";"0";"457171";"373882"
"V4mis1";"SILVA (only NR);Bacteria;Verrucomicrobiota;Lentisphaeria;Victivallales;BD2-3;";"100.0";"18.2";"10";"10";"10";"0";"0";"457173";"373884"
"V4mis1";"SILVA (only NR);Bacteria;Verrucomicrobiota;Lentisphaeria;Victivallales;GWF2-44-16;";"100.0";"18.2";"17";"17";"17";"0";"0";"457166";"373877"
"V4mis1";"SILVA (only NR);Bacteria;Verrucomicrobiota;Lentisphaeria;Victivallales;PRD18C08;";"100.0";"18.2";"16";"16";"16";"0";"0";"457167";"373878"
"V4mis1";"SILVA (only NR);Bacteria;Verrucomicrobiota;Lentisphaeria;Victivallales;SBYX-4944;";"100.0";"18.2";"6";"6";"6";"0";"0";"457177";"373888"
"V4mis1";"SILVA (only NR);Bacteria;Verrucomicrobiota;Lentisphaeria;Victivallales;SBZC-4624;";"100.0";"18.2";"5";"5";"5";"0";"0";"457178";"373889"
"V4mis1";"SILVA (only NR);Bacteria;Verrucomicrobiota;Lentisphaeria;Victivallales;Victivallaceae;";"98.1";"18.2";"52";"52";"51";"1";"0";"457131";"373843"
"V4mis1";"SILVA (only NR);Bacteria;Verrucomicrobiota;Lentisphaeria;Victivallales;Victivallaceae;Victivallis;";"93.3";"18.2";"15";"15";"14";"1";"0";"457168";"373880"
"V4mis1";"SILVA (only NR);Bacteria;Verrucomicrobiota;Lentisphaeria;Victivallales;vadinBE97;";"100.0";"18.2";"42";"42";"42";"0";"0";"457141";"373852"
"V4mis1";"SILVA (only NR);Bacteria;Verrucomicrobiota;Omnitrophia;";"94.8";"18.2";"520";"520";"493";"27";"0";"456663";"373401"
"V4mis1";"SILVA (only NR);Bacteria;Verrucomicrobiota;Omnitrophia;Omnitrophales;";"94.8";"18.2";"519";"519";"492";"27";"0";"456664";"373402"
"V4mis1";"SILVA (only NR);Bacteria;Verrucomicrobiota;Omnitrophia;Omnitrophales;Omnitrophaceae;";"94.1";"18.2";"426";"426";"401";"25";"0";"456757";"373493"
"V4mis1";"SILVA (only NR);Bacteria;Verrucomicrobiota;Omnitrophia;Omnitrophales;Omnitrophaceae;Candidatus Omnitrophus;";"94.1";"18.2";"426";"426";"401";"25";"0";"456757";"373493"
"V4mis1";"SILVA (only NR);Bacteria;Verrucomicrobiota;Omnitrophia;Omnitrophales;koll11;";"93.8";"18.2";"16";"16";"15";"1";"0";"457167";"373879"
"V4mis1";"SILVA (only NR);Bacteria;Verrucomicrobiota;Verrucomicrobiae;";"94.2";"18.3";"4166";"4166";"3923";"243";"0";"453017";"369971"
"V4mis1";"SILVA (only NR);Bacteria;Verrucomicrobiota;Verrucomicrobiae;Arctic97B-4 marine group;";"97.5";"18.2";"80";"80";"78";"2";"0";"457103";"373816"
"V4mis1";"SILVA (only NR);Bacteria;Verrucomicrobiota;Verrucomicrobiae;B29;";"100.0";"18.2";"2";"2";"2";"0";"0";"457181";"373892"
"V4mis1";"SILVA (only NR);Bacteria;Verrucomicrobiota;Verrucomicrobiae;Chthoniobacterales;";"94.5";"18.2";"1004";"1004";"949";"55";"0";"456179";"372945"
"V4mis1";"SILVA (only NR);Bacteria;Verrucomicrobiota;Verrucomicrobiae;Chthoniobacterales;01D2Z36;";"88.6";"18.2";"132";"132";"117";"15";"0";"457051";"373777"
"V4mis1";"SILVA (only NR);Bacteria;Verrucomicrobiota;Verrucomicrobiae;Chthoniobacterales;Chthoniobacteraceae;";"95.2";"18.2";"724";"724";"689";"35";"0";"456459";"373205"
"V4mis1";"SILVA (only NR);Bacteria;Verrucomicrobiota;Verrucomicrobiae;Chthoniobacterales;Chthoniobacteraceae;Candidatus Udaeobacter;";"95.5";"18.2";"397";"397";"379";"18";"0";"456786";"373515"
"V4mis1";"SILVA (only NR);Bacteria;Verrucomicrobiota;Verrucomicrobiae;Chthoniobacterales;Chthoniobacteraceae;Chthoniobacter;";"96.0";"18.2";"274";"274";"263";"11";"0";"456909";"373631"
"V4mis1";"SILVA (only NR);Bacteria;Verrucomicrobiota;Verrucomicrobiae;Chthoniobacterales;Chthoniobacteraceae;LD29;";"88.2";"18.2";"51";"51";"45";"6";"0";"457132";"373849"
"V4mis1";"SILVA (only NR);Bacteria;Verrucomicrobiota;Verrucomicrobiae;Chthoniobacterales;Terrimicrobiaceae;";"97.1";"18.2";"70";"70";"68";"2";"0";"457113";"373826"
"V4mis1";"SILVA (only NR);Bacteria;Verrucomicrobiota;Verrucomicrobiae;Chthoniobacterales;Terrimicrobiaceae;FukuN18 freshwater group;";"100.0";"18.2";"20";"20";"20";"0";"0";"457163";"373874"
"V4mis1";"SILVA (only NR);Bacteria;Verrucomicrobiota;Verrucomicrobiae;Chthoniobacterales;Terrimicrobiaceae;Terrimicrobium;";"96.0";"18.2";"50";"50";"48";"2";"0";"457133";"373846"
"V4mis1";"SILVA (only NR);Bacteria;Verrucomicrobiota;Verrucomicrobiae;Chthoniobacterales;Xiphinematobacteraceae;";"95.5";"18.2";"66";"66";"63";"3";"0";"457117";"373831"
"V4mis1";"SILVA (only NR);Bacteria;Verrucomicrobiota;Verrucomicrobiae;Chthoniobacterales;Xiphinematobacteraceae;Candidatus Xiphinematobacter;";"95.5";"18.2";"66";"66";"63";"3";"0";"457117";"373831"
"V4mis1";"SILVA (only NR);Bacteria;Verrucomicrobiota;Verrucomicrobiae;Chthoniobacterales;uncultured;";"100.0";"18.2";"12";"12";"12";"0";"0";"457171";"373882"
"V4mis1";"SILVA (only NR);Bacteria;Verrucomicrobiota;Verrucomicrobiae;LD1-PB3;";"98.6";"18.2";"70";"70";"69";"1";"0";"457113";"373825"
"V4mis1";"SILVA (only NR);Bacteria;Verrucomicrobiota;Verrucomicrobiae;Methylacidiphilales;";"98.0";"18.2";"101";"101";"99";"2";"0";"457082";"373795"
"V4mis1";"SILVA (only NR);Bacteria;Verrucomicrobiota;Verrucomicrobiae;Methylacidiphilales;Methylacidiphilaceae;";"98.0";"18.2";"101";"101";"99";"2";"0";"457082";"373795"
"V4mis1";"SILVA (only NR);Bacteria;Verrucomicrobiota;Verrucomicrobiae;Methylacidiphilales;Methylacidiphilaceae;Candidatus Methylacidiphilum;";"100.0";"18.2";"14";"14";"14";"0";"0";"457169";"373880"
"V4mis1";"SILVA (only NR);Bacteria;Verrucomicrobiota;Verrucomicrobiae;Methylacidiphilales;Methylacidiphilaceae;uncultured;";"97.7";"18.2";"87";"87";"85";"2";"0";"457096";"373809"
"V4mis1";"SILVA (only NR);Bacteria;Verrucomicrobiota;Verrucomicrobiae;Opitutales;";"94.6";"18.2";"833";"833";"788";"45";"0";"456350";"373106"
"V4mis1";"SILVA (only NR);Bacteria;Verrucomicrobiota;Verrucomicrobiae;Opitutales;Opitutaceae;";"95.2";"18.2";"315";"315";"300";"15";"0";"456868";"373594"
"V4mis1";"SILVA (only NR);Bacteria;Verrucomicrobiota;Verrucomicrobiae;Opitutales;Opitutaceae;Alterococcus;";"92.9";"18.2";"14";"14";"13";"1";"0";"457169";"373881"
"V4mis1";"SILVA (only NR);Bacteria;Verrucomicrobiota;Verrucomicrobiae;Opitutales;Opitutaceae;Cephaloticoccus;";"90.6";"18.2";"32";"32";"29";"3";"0";"457151";"373865"
"V4mis1";"SILVA (only NR);Bacteria;Verrucomicrobiota;Verrucomicrobiae;Opitutales;Opitutaceae;Diplosphaera;";"100.0";"18.2";"14";"14";"14";"0";"0";"457169";"373880"
"V4mis1";"SILVA (only NR);Bacteria;Verrucomicrobiota;Verrucomicrobiae;Opitutales;Opitutaceae;Ereboglobus;";"80.0";"18.2";"10";"10";"8";"2";"0";"457173";"373886"
"V4mis1";"SILVA (only NR);Bacteria;Verrucomicrobiota;Verrucomicrobiae;Opitutales;Opitutaceae;IMCC26134;";"95.7";"18.2";"23";"23";"22";"1";"0";"457160";"373872"
"V4mis1";"SILVA (only NR);Bacteria;Verrucomicrobiota;Verrucomicrobiae;Opitutales;Opitutaceae;Lacunisphaera;";"97.9";"18.2";"95";"95";"93";"2";"0";"457088";"373801"
"V4mis1";"SILVA (only NR);Bacteria;Verrucomicrobiota;Verrucomicrobiae;Opitutales;Opitutaceae;Opitutus;";"96.2";"18.2";"106";"106";"102";"4";"0";"457077";"373792"
"V4mis1";"SILVA (only NR);Bacteria;Verrucomicrobiota;Verrucomicrobiae;Opitutales;Opitutaceae;uncultured;";"90.0";"18.2";"20";"20";"18";"2";"0";"457163";"373876"
"V4mis1";"SILVA (only NR);Bacteria;Verrucomicrobiota;Verrucomicrobiae;Opitutales;Puniceicoccaceae;";"94.4";"18.2";"515";"515";"486";"29";"0";"456668";"373408"
"V4mis1";"SILVA (only NR);Bacteria;Verrucomicrobiota;Verrucomicrobiae;Opitutales;Puniceicoccaceae;A714019;";"100.0";"18.2";"4";"4";"4";"0";"0";"457179";"373890"
"V4mis1";"SILVA (only NR);Bacteria;Verrucomicrobiota;Verrucomicrobiae;Opitutales;Puniceicoccaceae;Cerasicoccus;";"91.1";"18.2";"56";"56";"51";"5";"0";"457127";"373843"
"V4mis1";"SILVA (only NR);Bacteria;Verrucomicrobiota;Verrucomicrobiae;Opitutales;Puniceicoccaceae;Coraliomargarita;";"88.2";"18.2";"34";"34";"30";"4";"0";"457149";"373864"
"V4mis1";"SILVA (only NR);Bacteria;Verrucomicrobiota;Verrucomicrobiae;Opitutales;Puniceicoccaceae;Lentimonas;";"92.8";"18.2";"83";"83";"77";"6";"0";"457100";"373817"
"V4mis1";"SILVA (only NR);Bacteria;Verrucomicrobiota;Verrucomicrobiae;Opitutales;Puniceicoccaceae;MB11C04 marine group;";"97.5";"18.2";"79";"79";"77";"2";"0";"457104";"373817"
"V4mis1";"SILVA (only NR);Bacteria;Verrucomicrobiota;Verrucomicrobiae;Opitutales;Puniceicoccaceae;Pelagicoccus;";"100.0";"18.2";"19";"19";"19";"0";"0";"457164";"373875"
"V4mis1";"SILVA (only NR);Bacteria;Verrucomicrobiota;Verrucomicrobiae;Opitutales;Puniceicoccaceae;Puniceicoccus;";"96.3";"18.2";"134";"134";"129";"5";"0";"457049";"373765"
"V4mis1";"SILVA (only NR);Bacteria;Verrucomicrobiota;Verrucomicrobiae;Opitutales;Puniceicoccaceae;Verruc-01;";"94.4";"18.2";"89";"89";"84";"5";"0";"457094";"373810"
"V4mis1";"SILVA (only NR);Bacteria;Verrucomicrobiota;Verrucomicrobiae;Opitutales;Puniceicoccaceae;uncultured;";"87.5";"18.2";"16";"16";"14";"2";"0";"457167";"373880"
"V4mis1";"SILVA (only NR);Bacteria;Verrucomicrobiota;Verrucomicrobiae;Opitutales;uncultured;";"66.7";"18.2";"3";"3";"2";"1";"0";"457180";"373892"
"V4mis1";"SILVA (only NR);Bacteria;Verrucomicrobiota;Verrucomicrobiae;Pedosphaerales;";"95.1";"18.2";"770";"770";"732";"38";"0";"456413";"373162"
"V4mis1";"SILVA (only NR);Bacteria;Verrucomicrobiota;Verrucomicrobiae;Pedosphaerales;Pedosphaeraceae;";"95.1";"18.2";"770";"770";"732";"38";"0";"456413";"373162"
"V4mis1";"SILVA (only NR);Bacteria;Verrucomicrobiota;Verrucomicrobiae;Pedosphaerales;Pedosphaeraceae;ADurb.Bin063-1;";"98.7";"18.2";"77";"77";"76";"1";"0";"457106";"373818"
"V4mis1";"SILVA (only NR);Bacteria;Verrucomicrobiota;Verrucomicrobiae;Pedosphaerales;Pedosphaeraceae;ADurb.Bin118;";"100.0";"18.2";"9";"9";"9";"0";"0";"457174";"373885"
"V4mis1";"SILVA (only NR);Bacteria;Verrucomicrobiota;Verrucomicrobiae;Pedosphaerales;Pedosphaeraceae;DEV008;";"95.8";"18.2";"24";"24";"23";"1";"0";"457159";"373871"
"V4mis1";"SILVA (only NR);Bacteria;Verrucomicrobiota;Verrucomicrobiae;Pedosphaerales;Pedosphaeraceae;DEV114;";"93.1";"18.2";"29";"29";"27";"2";"0";"457154";"373867"
"V4mis1";"SILVA (only NR);Bacteria;Verrucomicrobiota;Verrucomicrobiae;Pedosphaerales;Pedosphaeraceae;Ellin516;";"91.7";"18.2";"24";"24";"22";"2";"0";"457159";"373872"
"V4mis1";"SILVA (only NR);Bacteria;Verrucomicrobiota;Verrucomicrobiae;Pedosphaerales;Pedosphaeraceae;Ellin517;";"97.1";"18.2";"34";"34";"33";"1";"0";"457149";"373861"
"V4mis1";"SILVA (only NR);Bacteria;Verrucomicrobiota;Verrucomicrobiae;Pedosphaerales;Pedosphaeraceae;Limisphaera;";"75.0";"18.2";"4";"4";"3";"1";"0";"457179";"373891"
"V4mis1";"SILVA (only NR);Bacteria;Verrucomicrobiota;Verrucomicrobiae;Pedosphaerales;Pedosphaeraceae;Oikopleura;";"90.0";"18.2";"20";"20";"18";"2";"0";"457163";"373876"
"V4mis1";"SILVA (only NR);Bacteria;Verrucomicrobiota;Verrucomicrobiae;Pedosphaerales;Pedosphaeraceae;Pedosphaera;";"91.7";"18.2";"12";"12";"11";"1";"0";"457171";"373883"
"V4mis1";"SILVA (only NR);Bacteria;Verrucomicrobiota;Verrucomicrobiae;Pedosphaerales;Pedosphaeraceae;RS25G;";"100.0";"18.2";"2";"2";"2";"0";"0";"457181";"373892"
"V4mis1";"SILVA (only NR);Bacteria;Verrucomicrobiota;Verrucomicrobiae;Pedosphaerales;Pedosphaeraceae;SCGC AAA164-E04;";"100.0";"18.2";"23";"23";"23";"0";"0";"457160";"373871"
"V4mis1";"SILVA (only NR);Bacteria;Verrucomicrobiota;Verrucomicrobiae;Pedosphaerales;Pedosphaeraceae;SH3-11;";"90.3";"18.2";"31";"31";"28";"3";"0";"457152";"373866"
"V4mis1";"SILVA (only NR);Bacteria;Verrucomicrobiota;Verrucomicrobiae;Pedosphaerales;Pedosphaeraceae;uncultured;";"96.8";"18.2";"125";"125";"121";"4";"0";"457058";"373773"
"V4mis1";"SILVA (only NR);Bacteria;Verrucomicrobiota;Verrucomicrobiae;S-BQ2-57 soil group;";"94.7";"18.2";"38";"38";"36";"2";"0";"457145";"373858"
"V4mis1";"SILVA (only NR);Bacteria;Verrucomicrobiota;Verrucomicrobiae;UA11;";"100.0";"18.2";"2";"2";"2";"0";"0";"457181";"373892"
"V4mis1";"SILVA (only NR);Bacteria;Verrucomicrobiota;Verrucomicrobiae;Verrucomicrobiales;";"92.1";"18.2";"1241";"1241";"1143";"98";"0";"455942";"372751"
"V4mis1";"SILVA (only NR);Bacteria;Verrucomicrobiota;Verrucomicrobiae;Verrucomicrobiales;Akkermansiaceae;";"85.7";"18.2";"470";"470";"403";"67";"0";"456713";"373491"
"V4mis1";"SILVA (only NR);Bacteria;Verrucomicrobiota;Verrucomicrobiae;Verrucomicrobiales;Akkermansiaceae;Akkermansia;";"85.7";"18.2";"470";"470";"403";"67";"0";"456713";"373491"
"V4mis1";"SILVA (only NR);Bacteria;Verrucomicrobiota;Verrucomicrobiae;Verrucomicrobiales;DEV007;";"96.5";"18.2";"141";"141";"136";"5";"0";"457042";"373758"
"V4mis1";"SILVA (only NR);Bacteria;Verrucomicrobiota;Verrucomicrobiae;Verrucomicrobiales;Rubritaleaceae;";"95.9";"18.2";"413";"413";"396";"17";"0";"456770";"373498"
"V4mis1";"SILVA (only NR);Bacteria;Verrucomicrobiota;Verrucomicrobiae;Verrucomicrobiales;Rubritaleaceae;DBS1;";"100.0";"18.2";"10";"10";"10";"0";"0";"457173";"373884"
"V4mis1";"SILVA (only NR);Bacteria;Verrucomicrobiota;Verrucomicrobiae;Verrucomicrobiales;Rubritaleaceae;Haloferula;";"93.1";"18.2";"29";"29";"27";"2";"0";"457154";"373867"
"V4mis1";"SILVA (only NR);Bacteria;Verrucomicrobiota;Verrucomicrobiae;Verrucomicrobiales;Rubritaleaceae;Luteolibacter;";"96.2";"18.2";"211";"211";"203";"8";"0";"456972";"373691"
"V4mis1";"SILVA (only NR);Bacteria;Verrucomicrobiota;Verrucomicrobiae;Verrucomicrobiales;Rubritaleaceae;Persicirhabdus;";"96.9";"18.2";"32";"32";"31";"1";"0";"457151";"373863"
"V4mis1";"SILVA (only NR);Bacteria;Verrucomicrobiota;Verrucomicrobiae;Verrucomicrobiales;Rubritaleaceae;Roseibacillus;";"93.7";"18.2";"63";"63";"59";"4";"0";"457120";"373835"
"V4mis1";"SILVA (only NR);Bacteria;Verrucomicrobiota;Verrucomicrobiae;Verrucomicrobiales;Rubritaleaceae;Rubritalea;";"96.9";"18.2";"64";"64";"62";"2";"0";"457119";"373832"
"V4mis1";"SILVA (only NR);Bacteria;Verrucomicrobiota;Verrucomicrobiae;Verrucomicrobiales;Rubritaleaceae;uncultured;";"100.0";"18.2";"3";"3";"3";"0";"0";"457180";"373891"
"V4mis1";"SILVA (only NR);Bacteria;Verrucomicrobiota;Verrucomicrobiae;Verrucomicrobiales;Verrucomicrobiaceae;";"95.8";"18.2";"216";"216";"207";"9";"0";"456967";"373687"
"V4mis1";"SILVA (only NR);Bacteria;Verrucomicrobiota;Verrucomicrobiae;Verrucomicrobiales;Verrucomicrobiaceae;Brevifollis;";"100.0";"18.2";"6";"6";"6";"0";"0";"457177";"373888"
"V4mis1";"SILVA (only NR);Bacteria;Verrucomicrobiota;Verrucomicrobiae;Verrucomicrobiales;Verrucomicrobiaceae;Prosthecobacter;";"96.7";"18.2";"61";"61";"59";"2";"0";"457122";"373835"
"V4mis1";"SILVA (only NR);Bacteria;Verrucomicrobiota;Verrucomicrobiae;Verrucomicrobiales;Verrucomicrobiaceae;Roseimicrobium;";"94.9";"18.2";"39";"39";"37";"2";"0";"457144";"373857"
"V4mis1";"SILVA (only NR);Bacteria;Verrucomicrobiota;Verrucomicrobiae;Verrucomicrobiales;Verrucomicrobiaceae;Verrucomicrobium;";"94.7";"18.2";"19";"19";"18";"1";"0";"457164";"373876"
"V4mis1";"SILVA (only NR);Bacteria;Verrucomicrobiota;Verrucomicrobiae;Verrucomicrobiales;Verrucomicrobiaceae;uncultured;";"95.6";"18.2";"91";"91";"87";"4";"0";"457092";"373807"
"V4mis1";"SILVA (only NR);Bacteria;Verrucomicrobiota;Verrucomicrobiae;uncultured;";"100.0";"18.2";"25";"25";"25";"0";"0";"457158";"373869"
"V4mis1";"SILVA (only NR);Bacteria;WOR-1;";"97.4";"18.2";"38";"38";"37";"1";"0";"457145";"373857"
"V4mis1";"SILVA (only NR);Bacteria;WPS-2;";"93.4";"18.2";"61";"61";"57";"4";"0";"457122";"373837"
"V4mis1";"SILVA (only NR);Bacteria;WS1;";"93.5";"18.2";"93";"93";"87";"6";"0";"457090";"373807"
"V4mis1";"SILVA (only NR);Bacteria;WS2;";"86.4";"18.2";"59";"59";"51";"8";"0";"457124";"373843"
"V4mis1";"SILVA (only NR);Bacteria;WS4;";"88.2";"18.2";"17";"17";"15";"2";"0";"457166";"373879"
"V4mis1";"SILVA (only NR);Bacteria;Zixibacteria;";"94.2";"18.2";"207";"207";"195";"12";"0";"456976";"373699"
"V4mis1";"SILVA (only NR);Bacteria;uncultured;";"100.0";"18.2";"5";"5";"5";"0";"0";"457178";"373889"
"V4mis1";"SILVA (only NR);Eukaryota;";"2.0";"7.1";"56829";"55751";"1103";"54648";"1078";"401432";"372791"
"V4mis1";"SILVA (only NR);Eukaryota;Amorphea;";"0.5";"12.2";"31959";"31611";"173";"31438";"348";"425572";"373721"
"V4mis1";"SILVA (only NR);Eukaryota;Amorphea;Amoebozoa;";"2.8";"18";"1148";"1060";"30";"1030";"88";"456123";"373864"
"V4mis1";"SILVA (only NR);Eukaryota;Amorphea;Amoebozoa;Archamoebae;";"13.3";"18.2";"15";"15";"2";"13";"0";"457168";"373892"
"V4mis1";"SILVA (only NR);Eukaryota;Amorphea;Amoebozoa;Archamoebae;Entamoebida;";"0.0";"0";"4";"4";"0";"4";"0";"457179";"373894"
"V4mis1";"SILVA (only NR);Eukaryota;Amorphea;Amoebozoa;Archamoebae;Entamoebida;Entamoeba;";"0.0";"0";"4";"4";"0";"4";"0";"457179";"373894"
"V4mis1";"SILVA (only NR);Eukaryota;Amorphea;Amoebozoa;Archamoebae;Incertae Sedis;";"18.2";"18.2";"11";"11";"2";"9";"0";"457172";"373892"
"V4mis1";"SILVA (only NR);Eukaryota;Amorphea;Amoebozoa;Archamoebae;Incertae Sedis;Rhizomastix;";"18.2";"18.2";"11";"11";"2";"9";"0";"457172";"373892"
"V4mis1";"SILVA (only NR);Eukaryota;Amorphea;Amoebozoa;Cavosteliida;";"0.0";"0";"13";"13";"0";"13";"0";"457170";"373894"
"V4mis1";"SILVA (only NR);Eukaryota;Amorphea;Amoebozoa;Cavosteliida;Cavostelium;";"0.0";"0";"1";"1";"0";"1";"0";"457182";"373894"
"V4mis1";"SILVA (only NR);Eukaryota;Amorphea;Amoebozoa;Cavosteliida;Schizoplasmodiopsis;";"0.0";"0";"5";"5";"0";"5";"0";"457178";"373894"
"V4mis1";"SILVA (only NR);Eukaryota;Amorphea;Amoebozoa;Cavosteliida;Tychosporium;";"0.0";"0";"2";"2";"0";"2";"0";"457181";"373894"
"V4mis1";"SILVA (only NR);Eukaryota;Amorphea;Amoebozoa;Centrohelida;";"0.0";"0";"77";"75";"0";"75";"2";"457108";"373894"
"V4mis1";"SILVA (only NR);Eukaryota;Amorphea;Amoebozoa;Centrohelida;Acanthocystidae;";"0.0";"0";"24";"23";"0";"23";"1";"457160";"373894"
"V4mis1";"SILVA (only NR);Eukaryota;Amorphea;Amoebozoa;Centrohelida;Acanthocystidae;Choanocystis;";"0.0";"0";"5";"5";"0";"5";"0";"457178";"373894"
"V4mis1";"SILVA (only NR);Eukaryota;Amorphea;Amoebozoa;Centrohelida;Acanthocystidae;Pterocystis;";"0.0";"0";"16";"15";"0";"15";"1";"457168";"373894"
"V4mis1";"SILVA (only NR);Eukaryota;Amorphea;Amoebozoa;Centrohelida;Acanthocystidae;Raineriophrys;";"0.0";"0";"1";"1";"0";"1";"0";"457182";"373894"
"V4mis1";"SILVA (only NR);Eukaryota;Amorphea;Amoebozoa;Centrohelida;CV1-B1-93;";"0.0";"0";"3";"3";"0";"3";"0";"457180";"373894"
"V4mis1";"SILVA (only NR);Eukaryota;Amorphea;Amoebozoa;Centrohelida;H1-10;";"0.0";"0";"7";"7";"0";"7";"0";"457176";"373894"
"V4mis1";"SILVA (only NR);Eukaryota;Amorphea;Amoebozoa;Centrohelida;H15-6;";"0.0";"0";"9";"9";"0";"9";"0";"457174";"373894"
"V4mis1";"SILVA (only NR);Eukaryota;Amorphea;Amoebozoa;Centrohelida;H26-1;";"0.0";"0";"3";"3";"0";"3";"0";"457180";"373894"
"V4mis1";"SILVA (only NR);Eukaryota;Amorphea;Amoebozoa;Centrohelida;Heterophryidae;";"0.0";"0";"11";"11";"0";"11";"0";"457172";"373894"
"V4mis1";"SILVA (only NR);Eukaryota;Amorphea;Amoebozoa;Centrohelida;Heterophryidae;Chlamydaster;";"0.0";"0";"2";"2";"0";"2";"0";"457181";"373894"
"V4mis1";"SILVA (only NR);Eukaryota;Amorphea;Amoebozoa;Centrohelida;Heterophryidae;Heterophrys;";"0.0";"0";"2";"2";"0";"2";"0";"457181";"373894"
"V4mis1";"SILVA (only NR);Eukaryota;Amorphea;Amoebozoa;Centrohelida;Heterophryidae;Oxnerella;";"0.0";"0";"1";"1";"0";"1";"0";"457182";"373894"
"V4mis1";"SILVA (only NR);Eukaryota;Amorphea;Amoebozoa;Centrohelida;Heterophryidae;Sphaerastrum;";"0.0";"0";"1";"1";"0";"1";"0";"457182";"373894"
"V4mis1";"SILVA (only NR);Eukaryota;Amorphea;Amoebozoa;Centrohelida;Incertae Sedis;";"0.0";"0";"1";"1";"0";"1";"0";"457182";"373894"
"V4mis1";"SILVA (only NR);Eukaryota;Amorphea;Amoebozoa;Centrohelida;Incertae Sedis;Spiculophrys;";"0.0";"0";"1";"1";"0";"1";"0";"457182";"373894"
"V4mis1";"SILVA (only NR);Eukaryota;Amorphea;Amoebozoa;Centrohelida;M1-18D08;";"0.0";"0";"3";"3";"0";"3";"0";"457180";"373894"
"V4mis1";"SILVA (only NR);Eukaryota;Amorphea;Amoebozoa;Centrohelida;Raphidiophryidae;";"0.0";"0";"1";"1";"0";"1";"0";"457182";"373894"
"V4mis1";"SILVA (only NR);Eukaryota;Amorphea;Amoebozoa;Centrohelida;Raphidiophryidae;Raphidiophrys;";"0.0";"0";"1";"1";"0";"1";"0";"457182";"373894"
"V4mis1";"SILVA (only NR);Eukaryota;Amorphea;Amoebozoa;Collodictyonidae;";"0.0";"0";"2";"2";"0";"2";"0";"457181";"373894"
"V4mis1";"SILVA (only NR);Eukaryota;Amorphea;Amoebozoa;Collodictyonidae;Diphylleia;";"0.0";"0";"2";"2";"0";"2";"0";"457181";"373894"
"V4mis1";"SILVA (only NR);Eukaryota;Amorphea;Amoebozoa;Dictyostelia;";"0.0";"0";"66";"66";"0";"66";"0";"457117";"373894"
"V4mis1";"SILVA (only NR);Eukaryota;Amorphea;Amoebozoa;Dictyostelia;Acytostelium;";"0.0";"0";"3";"3";"0";"3";"0";"457180";"373894"
"V4mis1";"SILVA (only NR);Eukaryota;Amorphea;Amoebozoa;Dictyostelia;Dictyostelium;";"0.0";"0";"45";"45";"0";"45";"0";"457138";"373894"
"V4mis1";"SILVA (only NR);Eukaryota;Amorphea;Amoebozoa;Dictyostelia;Polysphondylium;";"0.0";"0";"17";"17";"0";"17";"0";"457166";"373894"
"V4mis1";"SILVA (only NR);Eukaryota;Amorphea;Amoebozoa;Discosea;";"0.3";"18.1";"431";"393";"1";"392";"38";"456790";"373893"
"V4mis1";"SILVA (only NR);Eukaryota;Amorphea;Amoebozoa;Discosea;Flabellinia;";"0.5";"18.2";"233";"205";"1";"204";"28";"456978";"373893"
"V4mis1";"SILVA (only NR);Eukaryota;Amorphea;Amoebozoa;Discosea;Flabellinia;Dactylopodida;";"0.0";"0";"110";"104";"0";"104";"6";"457079";"373894"
"V4mis1";"SILVA (only NR);Eukaryota;Amorphea;Amoebozoa;Discosea;Flabellinia;Dactylopodida;Angulamoeba;";"0.0";"0";"10";"9";"0";"9";"1";"457174";"373894"
"V4mis1";"SILVA (only NR);Eukaryota;Amorphea;Amoebozoa;Discosea;Flabellinia;Dactylopodida;Korotnevella;";"0.0";"0";"22";"18";"0";"18";"4";"457165";"373894"
"V4mis1";"SILVA (only NR);Eukaryota;Amorphea;Amoebozoa;Discosea;Flabellinia;Dactylopodida;Neoparamoeba;";"0.0";"0";"9";"9";"0";"9";"0";"457174";"373894"
"V4mis1";"SILVA (only NR);Eukaryota;Amorphea;Amoebozoa;Discosea;Flabellinia;Dactylopodida;Paramoeba;";"0.0";"0";"55";"55";"0";"55";"0";"457128";"373894"
"V4mis1";"SILVA (only NR);Eukaryota;Amorphea;Amoebozoa;Discosea;Flabellinia;Dactylopodida;Parvamoeba;";"0.0";"0";"1";"1";"0";"1";"0";"457182";"373894"
"V4mis1";"SILVA (only NR);Eukaryota;Amorphea;Amoebozoa;Discosea;Flabellinia;Dactylopodida;Pseudoparamoeba;";"0.0";"0";"2";"2";"0";"2";"0";"457181";"373894"
"V4mis1";"SILVA (only NR);Eukaryota;Amorphea;Amoebozoa;Discosea;Flabellinia;Stygamoebida;";"0.0";"0";"7";"7";"0";"7";"0";"457176";"373894"
"V4mis1";"SILVA (only NR);Eukaryota;Amorphea;Amoebozoa;Discosea;Flabellinia;Stygamoebida;Stygamoeba;";"0.0";"0";"1";"1";"0";"1";"0";"457182";"373894"
"V4mis1";"SILVA (only NR);Eukaryota;Amorphea;Amoebozoa;Discosea;Flabellinia;Stygamoebida;Vermistella;";"0.0";"0";"5";"5";"0";"5";"0";"457178";"373894"
"V4mis1";"SILVA (only NR);Eukaryota;Amorphea;Amoebozoa;Discosea;Flabellinia;Vannellida;";"1.1";"18.2";"116";"94";"1";"93";"22";"457089";"373893"
"V4mis1";"SILVA (only NR);Eukaryota;Amorphea;Amoebozoa;Discosea;Flabellinia;Vannellida;BIO10-D10;";"0.0";"0";"4";"4";"0";"4";"0";"457179";"373894"
"V4mis1";"SILVA (only NR);Eukaryota;Amorphea;Amoebozoa;Discosea;Flabellinia;Vannellida;Platyamoeba;";"0.0";"0";"34";"34";"0";"34";"0";"457149";"373894"
"V4mis1";"SILVA (only NR);Eukaryota;Amorphea;Amoebozoa;Discosea;Flabellinia;Vannellida;Protosteliopsis;";"0.0";"0";"4";"4";"0";"4";"0";"457179";"373894"
"V4mis1";"SILVA (only NR);Eukaryota;Amorphea;Amoebozoa;Discosea;Flabellinia;Vannellida;Unda;";"0.0";"0";"1";"0";"0";"0";"1";"457183";"373894"
"V4mis1";"SILVA (only NR);Eukaryota;Amorphea;Amoebozoa;Discosea;Flabellinia;Vannellida;Vannella;";"2.9";"18.2";"36";"35";"1";"34";"1";"457148";"373893"
"V4mis1";"SILVA (only NR);Eukaryota;Amorphea;Amoebozoa;Discosea;Flabellinia;Vannellida;uncultured;";"0.0";"0";"14";"6";"0";"6";"8";"457177";"373894"
"V4mis1";"SILVA (only NR);Eukaryota;Amorphea;Amoebozoa;Discosea;Longamoebia;";"0.0";"0";"193";"183";"0";"183";"10";"457000";"373894"
"V4mis1";"SILVA (only NR);Eukaryota;Amorphea;Amoebozoa;Discosea;Longamoebia;Centramoebida;";"0.0";"0";"193";"183";"0";"183";"10";"457000";"373894"
"V4mis1";"SILVA (only NR);Eukaryota;Amorphea;Amoebozoa;Discosea;Longamoebia;Centramoebida;Acanthamoeba;";"0.0";"0";"169";"161";"0";"161";"8";"457022";"373894"
"V4mis1";"SILVA (only NR);Eukaryota;Amorphea;Amoebozoa;Discosea;Longamoebia;Centramoebida;Balamuthia;";"0.0";"0";"21";"19";"0";"19";"2";"457164";"373894"
"V4mis1";"SILVA (only NR);Eukaryota;Amorphea;Amoebozoa;Fractovitelliida;";"0.0";"0";"3";"3";"0";"3";"0";"457180";"373894"
"V4mis1";"SILVA (only NR);Eukaryota;Amorphea;Amoebozoa;Fractovitelliida;Soliformovum;";"0.0";"0";"3";"3";"0";"3";"0";"457180";"373894"
"V4mis1";"SILVA (only NR);Eukaryota;Amorphea;Amoebozoa;Gracilipodida;";"0.0";"0";"34";"33";"0";"33";"1";"457150";"373894"
"V4mis1";"SILVA (only NR);Eukaryota;Amorphea;Amoebozoa;Gracilipodida;Filamoeba;";"0.0";"0";"4";"4";"0";"4";"0";"457179";"373894"
"V4mis1";"SILVA (only NR);Eukaryota;Amorphea;Amoebozoa;Gracilipodida;Flamella;";"0.0";"0";"17";"17";"0";"17";"0";"457166";"373894"
"V4mis1";"SILVA (only NR);Eukaryota;Amorphea;Amoebozoa;Gracilipodida;Heliamoeba;";"0.0";"0";"1";"1";"0";"1";"0";"457182";"373894"
"V4mis1";"SILVA (only NR);Eukaryota;Amorphea;Amoebozoa;Gracilipodida;LEMD267;";"0.0";"0";"4";"4";"0";"4";"0";"457179";"373894"
"V4mis1";"SILVA (only NR);Eukaryota;Amorphea;Amoebozoa;Gracilipodida;Telaepolella;";"0.0";"0";"3";"2";"0";"2";"1";"457181";"373894"
"V4mis1";"SILVA (only NR);Eukaryota;Amorphea;Amoebozoa;Incertae Sedis;";"0.0";"0";"114";"103";"0";"103";"11";"457080";"373894"
"V4mis1";"SILVA (only NR);Eukaryota;Amorphea;Amoebozoa;Incertae Sedis;Apusomonadidae;";"0.0";"0";"63";"61";"0";"61";"2";"457122";"373894"
"V4mis1";"SILVA (only NR);Eukaryota;Amorphea;Amoebozoa;Incertae Sedis;Apusomonadidae;Amastigomonas;";"0.0";"0";"34";"34";"0";"34";"0";"457149";"373894"
"V4mis1";"SILVA (only NR);Eukaryota;Amorphea;Amoebozoa;Incertae Sedis;Apusomonadidae;Apusomonas;";"0.0";"0";"7";"7";"0";"7";"0";"457176";"373894"
"V4mis1";"SILVA (only NR);Eukaryota;Amorphea;Amoebozoa;Incertae Sedis;Apusomonadidae;Fabomonas;";"0.0";"0";"1";"1";"0";"1";"0";"457182";"373894"
"V4mis1";"SILVA (only NR);Eukaryota;Amorphea;Amoebozoa;Incertae Sedis;Apusomonadidae;Multimonas;";"0.0";"0";"3";"3";"0";"3";"0";"457180";"373894"
"V4mis1";"SILVA (only NR);Eukaryota;Amorphea;Amoebozoa;Incertae Sedis;Apusomonadidae;Planomonas;";"0.0";"0";"1";"1";"0";"1";"0";"457182";"373894"
"V4mis1";"SILVA (only NR);Eukaryota;Amorphea;Amoebozoa;Incertae Sedis;Arboramoeba;";"0.0";"0";"4";"3";"0";"3";"1";"457180";"373894"
"V4mis1";"SILVA (only NR);Eukaryota;Amorphea;Amoebozoa;Incertae Sedis;Breviatea;";"0.0";"0";"27";"24";"0";"24";"3";"457159";"373894"
"V4mis1";"SILVA (only NR);Eukaryota;Amorphea;Amoebozoa;Incertae Sedis;Breviatea;Breviata;";"0.0";"0";"2";"2";"0";"2";"0";"457181";"373894"
"V4mis1";"SILVA (only NR);Eukaryota;Amorphea;Amoebozoa;Incertae Sedis;Breviatea;NAMAKO-2;";"0.0";"0";"8";"8";"0";"8";"0";"457175";"373894"
"V4mis1";"SILVA (only NR);Eukaryota;Amorphea;Amoebozoa;Incertae Sedis;Breviatea;Pygsuia;";"0.0";"0";"1";"1";"0";"1";"0";"457182";"373894"
"V4mis1";"SILVA (only NR);Eukaryota;Amorphea;Amoebozoa;Incertae Sedis;Breviatea;Subulatomonas;";"0.0";"0";"13";"10";"0";"10";"3";"457173";"373894"
"V4mis1";"SILVA (only NR);Eukaryota;Amorphea;Amoebozoa;Incertae Sedis;Dictyamoeba;";"0.0";"0";"3";"3";"0";"3";"0";"457180";"373894"
"V4mis1";"SILVA (only NR);Eukaryota;Amorphea;Amoebozoa;Incertae Sedis;Ischnamoeba;";"0.0";"0";"4";"4";"0";"4";"0";"457179";"373894"
"V4mis1";"SILVA (only NR);Eukaryota;Amorphea;Amoebozoa;Incertae Sedis;Luapeleamoeba;";"0.0";"0";"1";"0";"0";"0";"1";"457183";"373894"
"V4mis1";"SILVA (only NR);Eukaryota;Amorphea;Amoebozoa;Incertae Sedis;Rigifilida;";"0.0";"0";"3";"3";"0";"3";"0";"457180";"373894"
"V4mis1";"SILVA (only NR);Eukaryota;Amorphea;Amoebozoa;Incertae Sedis;Rigifilida;Micronuclearia;";"0.0";"0";"1";"1";"0";"1";"0";"457182";"373894"
"V4mis1";"SILVA (only NR);Eukaryota;Amorphea;Amoebozoa;Incertae Sedis;Rigifilida;Rigifila;";"0.0";"0";"1";"1";"0";"1";"0";"457182";"373894"
"V4mis1";"SILVA (only NR);Eukaryota;Amorphea;Amoebozoa;Mycamoeba;";"0.0";"0";"5";"4";"0";"4";"1";"457179";"373894"
"V4mis1";"SILVA (only NR);Eukaryota;Amorphea;Amoebozoa;Myxogastria;";"0.0";"0";"111";"106";"0";"106";"5";"457077";"373894"
"V4mis1";"SILVA (only NR);Eukaryota;Amorphea;Amoebozoa;Myxogastria;Amaurochaete;";"0.0";"0";"1";"1";"0";"1";"0";"457182";"373894"
"V4mis1";"SILVA (only NR);Eukaryota;Amorphea;Amoebozoa;Myxogastria;Badhamia;";"0.0";"0";"16";"14";"0";"14";"2";"457169";"373894"
"V4mis1";"SILVA (only NR);Eukaryota;Amorphea;Amoebozoa;Myxogastria;Brefeldia;";"0.0";"0";"1";"1";"0";"1";"0";"457182";"373894"
"V4mis1";"SILVA (only NR);Eukaryota;Amorphea;Amoebozoa;Myxogastria;Comatricha;";"0.0";"0";"4";"4";"0";"4";"0";"457179";"373894"
"V4mis1";"SILVA (only NR);Eukaryota;Amorphea;Amoebozoa;Myxogastria;Diderma;";"0.0";"0";"1";"1";"0";"1";"0";"457182";"373894"
"V4mis1";"SILVA (only NR);Eukaryota;Amorphea;Amoebozoa;Myxogastria;Didymium;";"0.0";"0";"12";"12";"0";"12";"0";"457171";"373894"
"V4mis1";"SILVA (only NR);Eukaryota;Amorphea;Amoebozoa;Myxogastria;Fuligo;";"0.0";"0";"2";"2";"0";"2";"0";"457181";"373894"
"V4mis1";"SILVA (only NR);Eukaryota;Amorphea;Amoebozoa;Myxogastria;Lamproderma;";"0.0";"0";"25";"25";"0";"25";"0";"457158";"373894"
"V4mis1";"SILVA (only NR);Eukaryota;Amorphea;Amoebozoa;Myxogastria;Lepidoderma;";"0.0";"0";"3";"3";"0";"3";"0";"457180";"373894"
"V4mis1";"SILVA (only NR);Eukaryota;Amorphea;Amoebozoa;Myxogastria;Macbrideola;";"0.0";"0";"1";"1";"0";"1";"0";"457182";"373894"
"V4mis1";"SILVA (only NR);Eukaryota;Amorphea;Amoebozoa;Myxogastria;Meriderma;";"0.0";"0";"4";"4";"0";"4";"0";"457179";"373894"
"V4mis1";"SILVA (only NR);Eukaryota;Amorphea;Amoebozoa;Myxogastria;Mucilago;";"0.0";"0";"1";"1";"0";"1";"0";"457182";"373894"
"V4mis1";"SILVA (only NR);Eukaryota;Amorphea;Amoebozoa;Myxogastria;Physarella;";"0.0";"0";"2";"2";"0";"2";"0";"457181";"373894"
"V4mis1";"SILVA (only NR);Eukaryota;Amorphea;Amoebozoa;Myxogastria;Physarum;";"0.0";"0";"18";"17";"0";"17";"1";"457166";"373894"
"V4mis1";"SILVA (only NR);Eukaryota;Amorphea;Amoebozoa;Myxogastria;Protophysarum;";"0.0";"0";"11";"11";"0";"11";"0";"457172";"373894"
"V4mis1";"SILVA (only NR);Eukaryota;Amorphea;Amoebozoa;Myxogastria;Stemonitis;";"0.0";"0";"2";"2";"0";"2";"0";"457181";"373894"
"V4mis1";"SILVA (only NR);Eukaryota;Amorphea;Amoebozoa;Myxogastria;Symphytocarpus;";"0.0";"0";"1";"1";"0";"1";"0";"457182";"373894"
"V4mis1";"SILVA (only NR);Eukaryota;Amorphea;Amoebozoa;Protosporangiida;";"0.0";"0";"18";"17";"0";"17";"1";"457166";"373894"
"V4mis1";"SILVA (only NR);Eukaryota;Amorphea;Amoebozoa;Protosporangiida;Protosporangiidae;";"0.0";"0";"18";"17";"0";"17";"1";"457166";"373894"
"V4mis1";"SILVA (only NR);Eukaryota;Amorphea;Amoebozoa;Protosporangiida;Protosporangiidae;Protosporangium;";"0.0";"0";"18";"17";"0";"17";"1";"457166";"373894"
"V4mis1";"SILVA (only NR);Eukaryota;Amorphea;Amoebozoa;Protosteliida;";"0.0";"0";"32";"32";"0";"32";"0";"457151";"373894"
"V4mis1";"SILVA (only NR);Eukaryota;Amorphea;Amoebozoa;Protosteliida;Planoprotostelium;";"0.0";"0";"3";"3";"0";"3";"0";"457180";"373894"
"V4mis1";"SILVA (only NR);Eukaryota;Amorphea;Amoebozoa;Protosteliida;Protostelium;";"0.0";"0";"18";"18";"0";"18";"0";"457165";"373894"
"V4mis1";"SILVA (only NR);Eukaryota;Amorphea;Amoebozoa;Protosteliida;Schoutedamoeba;";"0.0";"0";"1";"1";"0";"1";"0";"457182";"373894"
"V4mis1";"SILVA (only NR);Eukaryota;Amorphea;Amoebozoa;SAR;";"55.1";"18.2";"60";"49";"27";"22";"11";"457134";"373867"
"V4mis1";"SILVA (only NR);Eukaryota;Amorphea;Amoebozoa;SAR;Stramenopiles;";"55.1";"18.2";"60";"49";"27";"22";"11";"457134";"373867"
"V4mis1";"SILVA (only NR);Eukaryota;Amorphea;Amoebozoa;SAR;Stramenopiles;Labyrinthulomycetes;";"55.1";"18.2";"60";"49";"27";"22";"11";"457134";"373867"
"V4mis1";"SILVA (only NR);Eukaryota;Amorphea;Amoebozoa;SAR;Stramenopiles;Labyrinthulomycetes;Sorodiplophrys;";"55.1";"18.2";"60";"49";"27";"22";"11";"457134";"373867"
"V4mis1";"SILVA (only NR);Eukaryota;Amorphea;Amoebozoa;Schizoplasmodiida;";"0.0";"0";"14";"11";"0";"11";"3";"457172";"373894"
"V4mis1";"SILVA (only NR);Eukaryota;Amorphea;Amoebozoa;Schizoplasmodiida;Ceratiomyxella;";"0.0";"0";"1";"1";"0";"1";"0";"457182";"373894"
"V4mis1";"SILVA (only NR);Eukaryota;Amorphea;Amoebozoa;Schizoplasmodiida;Nematostelium;";"0.0";"0";"1";"1";"0";"1";"0";"457182";"373894"
"V4mis1";"SILVA (only NR);Eukaryota;Amorphea;Amoebozoa;Schizoplasmodiida;Phalansterium;";"0.0";"0";"10";"7";"0";"7";"3";"457176";"373894"
"V4mis1";"SILVA (only NR);Eukaryota;Amorphea;Amoebozoa;Schizoplasmodiida;Schizoplasmodium;";"0.0";"0";"1";"1";"0";"1";"0";"457182";"373894"
"V4mis1";"SILVA (only NR);Eukaryota;Amorphea;Amoebozoa;Tubulinea;";"0.0";"0";"132";"118";"0";"118";"14";"457065";"373894"
"V4mis1";"SILVA (only NR);Eukaryota;Amorphea;Amoebozoa;Tubulinea;Arcellinida;";"0.0";"0";"35";"33";"0";"33";"2";"457150";"373894"
"V4mis1";"SILVA (only NR);Eukaryota;Amorphea;Amoebozoa;Tubulinea;Arcellinida;Arcellina;";"0.0";"0";"4";"2";"0";"2";"2";"457181";"373894"
"V4mis1";"SILVA (only NR);Eukaryota;Amorphea;Amoebozoa;Tubulinea;Arcellinida;Arcellina;Arcella;";"0.0";"0";"4";"2";"0";"2";"2";"457181";"373894"
"V4mis1";"SILVA (only NR);Eukaryota;Amorphea;Amoebozoa;Tubulinea;Arcellinida;Echinamoebida;";"0.0";"0";"21";"21";"0";"21";"0";"457162";"373894"
"V4mis1";"SILVA (only NR);Eukaryota;Amorphea;Amoebozoa;Tubulinea;Arcellinida;Echinamoebida;Echinamoeba;";"0.0";"0";"5";"5";"0";"5";"0";"457178";"373894"
"V4mis1";"SILVA (only NR);Eukaryota;Amorphea;Amoebozoa;Tubulinea;Arcellinida;Echinamoebida;Vermamoeba;";"0.0";"0";"8";"8";"0";"8";"0";"457175";"373894"
"V4mis1";"SILVA (only NR);Eukaryota;Amorphea;Amoebozoa;Tubulinea;Arcellinida;Phryganellina;";"0.0";"0";"5";"5";"0";"5";"0";"457178";"373894"
"V4mis1";"SILVA (only NR);Eukaryota;Amorphea;Amoebozoa;Tubulinea;Arcellinida;Phryganellina;Cryptodifflugia;";"0.0";"0";"5";"5";"0";"5";"0";"457178";"373894"
"V4mis1";"SILVA (only NR);Eukaryota;Amorphea;Amoebozoa;Tubulinea;Euamoebida;";"0.0";"0";"57";"48";"0";"48";"9";"457135";"373894"
"V4mis1";"SILVA (only NR);Eukaryota;Amorphea;Amoebozoa;Tubulinea;Euamoebida;Amoeba;";"0.0";"0";"2";"2";"0";"2";"0";"457181";"373894"
"V4mis1";"SILVA (only NR);Eukaryota;Amorphea;Amoebozoa;Tubulinea;Euamoebida;BOLA868;";"0.0";"0";"8";"8";"0";"8";"0";"457175";"373894"
"V4mis1";"SILVA (only NR);Eukaryota;Amorphea;Amoebozoa;Tubulinea;Euamoebida;Chaos;";"0.0";"0";"1";"1";"0";"1";"0";"457182";"373894"
"V4mis1";"SILVA (only NR);Eukaryota;Amorphea;Amoebozoa;Tubulinea;Euamoebida;Copromyxa;";"0.0";"0";"3";"3";"0";"3";"0";"457180";"373894"
"V4mis1";"SILVA (only NR);Eukaryota;Amorphea;Amoebozoa;Tubulinea;Euamoebida;Glaeseria;";"0.0";"0";"1";"1";"0";"1";"0";"457182";"373894"
"V4mis1";"SILVA (only NR);Eukaryota;Amorphea;Amoebozoa;Tubulinea;Euamoebida;Hartmannella;";"0.0";"0";"6";"6";"0";"6";"0";"457177";"373894"
"V4mis1";"SILVA (only NR);Eukaryota;Amorphea;Amoebozoa;Tubulinea;Euamoebida;Ptolemeba;";"0.0";"0";"2";"2";"0";"2";"0";"457181";"373894"
"V4mis1";"SILVA (only NR);Eukaryota;Amorphea;Amoebozoa;Tubulinea;Euamoebida;Saccamoeba;";"0.0";"0";"3";"3";"0";"3";"0";"457180";"373894"
"V4mis1";"SILVA (only NR);Eukaryota;Amorphea;Amoebozoa;Tubulinea;Euamoebida;Sacchamoeba;";"0.0";"0";"1";"1";"0";"1";"0";"457182";"373894"
"V4mis1";"SILVA (only NR);Eukaryota;Amorphea;Amoebozoa;Tubulinea;Incertae Sedis;";"0.0";"0";"1";"1";"0";"1";"0";"457182";"373894"
"V4mis1";"SILVA (only NR);Eukaryota;Amorphea;Amoebozoa;Tubulinea;Incertae Sedis;Pyxidicula;";"0.0";"0";"1";"1";"0";"1";"0";"457182";"373894"
"V4mis1";"SILVA (only NR);Eukaryota;Amorphea;Amoebozoa;Tubulinea;Leptomyxida;";"0.0";"0";"35";"33";"0";"33";"2";"457150";"373894"
"V4mis1";"SILVA (only NR);Eukaryota;Amorphea;Amoebozoa;Tubulinea;Leptomyxida;Flabellula;";"0.0";"0";"9";"9";"0";"9";"0";"457174";"373894"
"V4mis1";"SILVA (only NR);Eukaryota;Amorphea;Amoebozoa;Tubulinea;Leptomyxida;Leptomyxa;";"0.0";"0";"7";"7";"0";"7";"0";"457176";"373894"
"V4mis1";"SILVA (only NR);Eukaryota;Amorphea;Amoebozoa;Tubulinea;Leptomyxida;NETC3-I;";"0.0";"0";"2";"2";"0";"2";"0";"457181";"373894"
"V4mis1";"SILVA (only NR);Eukaryota;Amorphea;Amoebozoa;Tubulinea;Leptomyxida;Paraflabellula;";"0.0";"0";"2";"2";"0";"2";"0";"457181";"373894"
"V4mis1";"SILVA (only NR);Eukaryota;Amorphea;Amoebozoa;Tubulinea;Leptomyxida;Rhizamoeba;";"0.0";"0";"2";"2";"0";"2";"0";"457181";"373894"
"V4mis1";"SILVA (only NR);Eukaryota;Amorphea;Amoebozoa;uncultured;";"0.0";"0";"12";"11";"0";"11";"1";"457172";"373894"
"V4mis1";"SILVA (only NR);Eukaryota;Amorphea;Obazoa;";"0.5";"12.4";"30811";"30551";"143";"30408";"260";"426632";"373751"
"V4mis1";"SILVA (only NR);Eukaryota;Amorphea;Obazoa;Opisthokonta;";"0.5";"12.4";"30811";"30551";"143";"30408";"260";"426632";"373751"
"V4mis1";"SILVA (only NR);Eukaryota;Amorphea;Obazoa;Opisthokonta;Holozoa;";"0.2";"14.3";"21360";"21153";"50";"21103";"207";"436030";"373844"
"V4mis1";"SILVA (only NR);Eukaryota;Amorphea;Obazoa;Opisthokonta;Holozoa;Choanozoa;";"0.2";"14.3";"21360";"21153";"50";"21103";"207";"436030";"373844"
"V4mis1";"SILVA (only NR);Eukaryota;Amorphea;Obazoa;Opisthokonta;Holozoa;Choanozoa;Choanoflagellata;";"2.8";"18.2";"328";"318";"9";"309";"10";"456865";"373885"
"V4mis1";"SILVA (only NR);Eukaryota;Amorphea;Obazoa;Opisthokonta;Holozoa;Choanozoa;Choanoflagellata;Choanoflagellida;";"4.7";"18.2";"200";"190";"9";"181";"10";"456993";"373885"
"V4mis1";"SILVA (only NR);Eukaryota;Amorphea;Obazoa;Opisthokonta;Holozoa;Choanozoa;Choanoflagellata;Choanoflagellida;Acanthoecida;";"0.0";"0";"67";"67";"0";"67";"0";"457116";"373894"
"V4mis1";"SILVA (only NR);Eukaryota;Amorphea;Obazoa;Opisthokonta;Holozoa;Choanozoa;Choanoflagellata;Choanoflagellida;Acanthoecida;Acanthoecidae;";"0.0";"0";"18";"18";"0";"18";"0";"457165";"373894"
"V4mis1";"SILVA (only NR);Eukaryota;Amorphea;Obazoa;Opisthokonta;Holozoa;Choanozoa;Choanoflagellata;Choanoflagellida;Acanthoecida;Acanthoecidae;Acanthoeca;";"0.0";"0";"2";"2";"0";"2";"0";"457181";"373894"
"V4mis1";"SILVA (only NR);Eukaryota;Amorphea;Obazoa;Opisthokonta;Holozoa;Choanozoa;Choanoflagellata;Choanoflagellida;Acanthoecida;Acanthoecidae;FV23-1A4;";"0.0";"0";"6";"6";"0";"6";"0";"457177";"373894"
"V4mis1";"SILVA (only NR);Eukaryota;Amorphea;Obazoa;Opisthokonta;Holozoa;Choanozoa;Choanoflagellata;Choanoflagellida;Acanthoecida;Acanthoecidae;Pleurasiga;";"0.0";"0";"3";"3";"0";"3";"0";"457180";"373894"
"V4mis1";"SILVA (only NR);Eukaryota;Amorphea;Obazoa;Opisthokonta;Holozoa;Choanozoa;Choanoflagellata;Choanoflagellida;Acanthoecida;Acanthoecidae;Polyoeca;";"0.0";"0";"1";"1";"0";"1";"0";"457182";"373894"
"V4mis1";"SILVA (only NR);Eukaryota;Amorphea;Obazoa;Opisthokonta;Holozoa;Choanozoa;Choanoflagellata;Choanoflagellida;Acanthoecida;Acanthoecidae;Savillea;";"0.0";"0";"1";"1";"0";"1";"0";"457182";"373894"
"V4mis1";"SILVA (only NR);Eukaryota;Amorphea;Obazoa;Opisthokonta;Holozoa;Choanozoa;Choanoflagellata;Choanoflagellida;Acanthoecida;Stephanoecidae;";"0.0";"0";"48";"48";"0";"48";"0";"457135";"373894"
"V4mis1";"SILVA (only NR);Eukaryota;Amorphea;Obazoa;Opisthokonta;Holozoa;Choanozoa;Choanoflagellata;Choanoflagellida;Acanthoecida;Stephanoecidae;Bicosta;";"0.0";"0";"6";"6";"0";"6";"0";"457177";"373894"
"V4mis1";"SILVA (only NR);Eukaryota;Amorphea;Obazoa;Opisthokonta;Holozoa;Choanozoa;Choanoflagellata;Choanoflagellida;Acanthoecida;Stephanoecidae;Calliacantha;";"0.0";"0";"2";"2";"0";"2";"0";"457181";"373894"
"V4mis1";"SILVA (only NR);Eukaryota;Amorphea;Obazoa;Opisthokonta;Holozoa;Choanozoa;Choanoflagellata;Choanoflagellida;Acanthoecida;Stephanoecidae;Diaphanoeca;";"0.0";"0";"15";"15";"0";"15";"0";"457168";"373894"
"V4mis1";"SILVA (only NR);Eukaryota;Amorphea;Obazoa;Opisthokonta;Holozoa;Choanozoa;Choanoflagellata;Choanoflagellida;Acanthoecida;Stephanoecidae;Didymoeca;";"0.0";"0";"2";"2";"0";"2";"0";"457181";"373894"
"V4mis1";"SILVA (only NR);Eukaryota;Amorphea;Obazoa;Opisthokonta;Holozoa;Choanozoa;Choanoflagellata;Choanoflagellida;Acanthoecida;Stephanoecidae;Marine Choanoflagellates 1;";"0.0";"0";"6";"6";"0";"6";"0";"457177";"373894"
"V4mis1";"SILVA (only NR);Eukaryota;Amorphea;Obazoa;Opisthokonta;Holozoa;Choanozoa;Choanoflagellata;Choanoflagellida;Acanthoecida;Stephanoecidae;Marine Choanoflagellates 2;";"0.0";"0";"2";"2";"0";"2";"0";"457181";"373894"
"V4mis1";"SILVA (only NR);Eukaryota;Amorphea;Obazoa;Opisthokonta;Holozoa;Choanozoa;Choanoflagellata;Choanoflagellida;Acanthoecida;Stephanoecidae;Stephanoeca;";"0.0";"0";"10";"10";"0";"10";"0";"457173";"373894"
"V4mis1";"SILVA (only NR);Eukaryota;Amorphea;Obazoa;Opisthokonta;Holozoa;Choanozoa;Choanoflagellata;Choanoflagellida;Clade L;";"0.0";"0";"4";"4";"0";"4";"0";"457179";"373894"
"V4mis1";"SILVA (only NR);Eukaryota;Amorphea;Obazoa;Opisthokonta;Holozoa;Choanozoa;Choanoflagellata;Choanoflagellida;Craspedida;";"7.6";"18.2";"129";"119";"9";"110";"10";"457064";"373885"
"V4mis1";"SILVA (only NR);Eukaryota;Amorphea;Obazoa;Opisthokonta;Holozoa;Choanozoa;Choanoflagellata;Choanoflagellida;Craspedida;Codonosigidae;";"10.7";"18.2";"28";"28";"3";"25";"0";"457155";"373891"
"V4mis1";"SILVA (only NR);Eukaryota;Amorphea;Obazoa;Opisthokonta;Holozoa;Choanozoa;Choanoflagellata;Choanoflagellida;Craspedida;Codonosigidae;Codosiga;";"0.0";"0";"9";"9";"0";"9";"0";"457174";"373894"
"V4mis1";"SILVA (only NR);Eukaryota;Amorphea;Obazoa;Opisthokonta;Holozoa;Choanozoa;Choanoflagellata;Choanoflagellida;Craspedida;Codonosigidae;Desmarella;";"100.0";"18.2";"1";"1";"1";"0";"0";"457182";"373893"
"V4mis1";"SILVA (only NR);Eukaryota;Amorphea;Obazoa;Opisthokonta;Holozoa;Choanozoa;Choanoflagellata;Choanoflagellida;Craspedida;Codonosigidae;Monosiga;";"20.0";"18.2";"10";"10";"2";"8";"0";"457173";"373892"
"V4mis1";"SILVA (only NR);Eukaryota;Amorphea;Obazoa;Opisthokonta;Holozoa;Choanozoa;Choanoflagellata;Choanoflagellida;Craspedida;Codonosigidae;Proterospongia;";"0.0";"0";"1";"1";"0";"1";"0";"457182";"373894"
"V4mis1";"SILVA (only NR);Eukaryota;Amorphea;Obazoa;Opisthokonta;Holozoa;Choanozoa;Choanoflagellata;Choanoflagellida;Craspedida;Codonosigidae;Sphaeroeca;";"0.0";"0";"5";"5";"0";"5";"0";"457178";"373894"
"V4mis1";"SILVA (only NR);Eukaryota;Amorphea;Obazoa;Opisthokonta;Holozoa;Choanozoa;Choanoflagellata;Choanoflagellida;Craspedida;Codosigidae;";"0.0";"0";"19";"16";"0";"16";"3";"457167";"373894"
"V4mis1";"SILVA (only NR);Eukaryota;Amorphea;Obazoa;Opisthokonta;Holozoa;Choanozoa;Choanoflagellata;Choanoflagellida;Craspedida;Codosigidae;Freshwater Choanoflagellates 1;";"0.0";"0";"10";"9";"0";"9";"1";"457174";"373894"
"V4mis1";"SILVA (only NR);Eukaryota;Amorphea;Obazoa;Opisthokonta;Holozoa;Choanozoa;Choanoflagellata;Choanoflagellida;Craspedida;Codosigidae;Lagenoeca;";"0.0";"0";"9";"7";"0";"7";"2";"457176";"373894"
"V4mis1";"SILVA (only NR);Eukaryota;Amorphea;Obazoa;Opisthokonta;Holozoa;Choanozoa;Choanoflagellata;Choanoflagellida;Craspedida;Incertae Sedis;";"0.0";"0";"1";"1";"0";"1";"0";"457182";"373894"
"V4mis1";"SILVA (only NR);Eukaryota;Amorphea;Obazoa;Opisthokonta;Holozoa;Choanozoa;Choanoflagellata;Choanoflagellida;Craspedida;Incertae Sedis;Paramonosiga;";"0.0";"0";"1";"1";"0";"1";"0";"457182";"373894"
"V4mis1";"SILVA (only NR);Eukaryota;Amorphea;Obazoa;Opisthokonta;Holozoa;Choanozoa;Choanoflagellata;Choanoflagellida;Craspedida;Salpingoecidae;";"7.9";"18.2";"70";"63";"5";"58";"7";"457120";"373889"
"V4mis1";"SILVA (only NR);Eukaryota;Amorphea;Obazoa;Opisthokonta;Holozoa;Choanozoa;Choanoflagellata;Choanoflagellida;Craspedida;Salpingoecidae;Choanoeca;";"0.0";"0";"1";"1";"0";"1";"0";"457182";"373894"
"V4mis1";"SILVA (only NR);Eukaryota;Amorphea;Obazoa;Opisthokonta;Holozoa;Choanozoa;Choanoflagellata;Choanoflagellida;Craspedida;Salpingoecidae;Freshwater Choanoflagellates 2;";"0.0";"0";"6";"6";"0";"6";"0";"457177";"373894"
"V4mis1";"SILVA (only NR);Eukaryota;Amorphea;Obazoa;Opisthokonta;Holozoa;Choanozoa;Choanoflagellata;Choanoflagellida;Craspedida;Salpingoecidae;Hartaetosiga;";"0.0";"0";"9";"7";"0";"7";"2";"457176";"373894"
"V4mis1";"SILVA (only NR);Eukaryota;Amorphea;Obazoa;Opisthokonta;Holozoa;Choanozoa;Choanoflagellata;Choanoflagellida;Craspedida;Salpingoecidae;Salpingoeca;";"21.7";"18.2";"28";"23";"5";"18";"5";"457160";"373889"
"V4mis1";"SILVA (only NR);Eukaryota;Amorphea;Obazoa;Opisthokonta;Holozoa;Choanozoa;Choanoflagellata;Choanoflagellida;Craspedida;Salpingoecidae;Stagondoeca;";"0.0";"0";"1";"1";"0";"1";"0";"457182";"373894"
"V4mis1";"SILVA (only NR);Eukaryota;Amorphea;Obazoa;Opisthokonta;Holozoa;Choanozoa;Choanoflagellata;Choanoflagellida;Craspedida;uncultured;";"0.0";"0";"4";"4";"0";"4";"0";"457179";"373894"
"V4mis1";"SILVA (only NR);Eukaryota;Amorphea;Obazoa;Opisthokonta;Holozoa;Choanozoa;Choanoflagellata;Corallochytrea;";"0.0";"0";"1";"1";"0";"1";"0";"457182";"373894"
"V4mis1";"SILVA (only NR);Eukaryota;Amorphea;Obazoa;Opisthokonta;Holozoa;Choanozoa;Choanoflagellata;Corallochytrea;Corallochytrida;";"0.0";"0";"1";"1";"0";"1";"0";"457182";"373894"
"V4mis1";"SILVA (only NR);Eukaryota;Amorphea;Obazoa;Opisthokonta;Holozoa;Choanozoa;Choanoflagellata;Corallochytrea;Corallochytrida;Corallochytridae;";"0.0";"0";"1";"1";"0";"1";"0";"457182";"373894"
"V4mis1";"SILVA (only NR);Eukaryota;Amorphea;Obazoa;Opisthokonta;Holozoa;Choanozoa;Choanoflagellata;Corallochytrea;Corallochytrida;Corallochytridae;Corallochytrium;";"0.0";"0";"1";"1";"0";"1";"0";"457182";"373894"
"V4mis1";"SILVA (only NR);Eukaryota;Amorphea;Obazoa;Opisthokonta;Holozoa;Choanozoa;Choanoflagellata;Eccrinales;";"0.0";"0";"27";"27";"0";"27";"0";"457156";"373894"
"V4mis1";"SILVA (only NR);Eukaryota;Amorphea;Obazoa;Opisthokonta;Holozoa;Choanozoa;Choanoflagellata;Eccrinales;Alacrinella;";"0.0";"0";"1";"1";"0";"1";"0";"457182";"373894"
"V4mis1";"SILVA (only NR);Eukaryota;Amorphea;Obazoa;Opisthokonta;Holozoa;Choanozoa;Choanoflagellata;Eccrinales;Arundinula;";"0.0";"0";"2";"2";"0";"2";"0";"457181";"373894"
"V4mis1";"SILVA (only NR);Eukaryota;Amorphea;Obazoa;Opisthokonta;Holozoa;Choanozoa;Choanoflagellata;Eccrinales;Astreptonema;";"0.0";"0";"3";"3";"0";"3";"0";"457180";"373894"
"V4mis1";"SILVA (only NR);Eukaryota;Amorphea;Obazoa;Opisthokonta;Holozoa;Choanozoa;Choanoflagellata;Eccrinales;Eccrinidus;";"0.0";"0";"1";"1";"0";"1";"0";"457182";"373894"
"V4mis1";"SILVA (only NR);Eukaryota;Amorphea;Obazoa;Opisthokonta;Holozoa;Choanozoa;Choanoflagellata;Eccrinales;Enterobryus;";"0.0";"0";"7";"7";"0";"7";"0";"457176";"373894"
"V4mis1";"SILVA (only NR);Eukaryota;Amorphea;Obazoa;Opisthokonta;Holozoa;Choanozoa;Choanoflagellata;Eccrinales;Enteromyces;";"0.0";"0";"1";"1";"0";"1";"0";"457182";"373894"
"V4mis1";"SILVA (only NR);Eukaryota;Amorphea;Obazoa;Opisthokonta;Holozoa;Choanozoa;Choanoflagellata;Eccrinales;Enteropogon;";"0.0";"0";"1";"1";"0";"1";"0";"457182";"373894"
"V4mis1";"SILVA (only NR);Eukaryota;Amorphea;Obazoa;Opisthokonta;Holozoa;Choanozoa;Choanoflagellata;Eccrinales;Leidyomyces;";"0.0";"0";"2";"2";"0";"2";"0";"457181";"373894"
"V4mis1";"SILVA (only NR);Eukaryota;Amorphea;Obazoa;Opisthokonta;Holozoa;Choanozoa;Choanoflagellata;Eccrinales;Palavascia;";"0.0";"0";"2";"2";"0";"2";"0";"457181";"373894"
"V4mis1";"SILVA (only NR);Eukaryota;Amorphea;Obazoa;Opisthokonta;Holozoa;Choanozoa;Choanoflagellata;Eccrinales;Parataeniella;";"0.0";"0";"3";"3";"0";"3";"0";"457180";"373894"
"V4mis1";"SILVA (only NR);Eukaryota;Amorphea;Obazoa;Opisthokonta;Holozoa;Choanozoa;Choanoflagellata;Eccrinales;Taeniella;";"0.0";"0";"1";"1";"0";"1";"0";"457182";"373894"
"V4mis1";"SILVA (only NR);Eukaryota;Amorphea;Obazoa;Opisthokonta;Holozoa;Choanozoa;Choanoflagellata;Filasterea;";"0.0";"0";"18";"18";"0";"18";"0";"457165";"373894"
"V4mis1";"SILVA (only NR);Eukaryota;Amorphea;Obazoa;Opisthokonta;Holozoa;Choanozoa;Choanoflagellata;Filasterea;Ministeriida;";"0.0";"0";"18";"18";"0";"18";"0";"457165";"373894"
"V4mis1";"SILVA (only NR);Eukaryota;Amorphea;Obazoa;Opisthokonta;Holozoa;Choanozoa;Choanoflagellata;Filasterea;Ministeriida;Capsasporidae;";"0.0";"0";"16";"16";"0";"16";"0";"457167";"373894"
"V4mis1";"SILVA (only NR);Eukaryota;Amorphea;Obazoa;Opisthokonta;Holozoa;Choanozoa;Choanoflagellata;Filasterea;Ministeriida;Capsasporidae;AT4-11;";"0.0";"0";"6";"6";"0";"6";"0";"457177";"373894"
"V4mis1";"SILVA (only NR);Eukaryota;Amorphea;Obazoa;Opisthokonta;Holozoa;Choanozoa;Choanoflagellata;Filasterea;Ministeriida;Capsasporidae;Capsaspora;";"0.0";"0";"1";"1";"0";"1";"0";"457182";"373894"
"V4mis1";"SILVA (only NR);Eukaryota;Amorphea;Obazoa;Opisthokonta;Holozoa;Choanozoa;Choanoflagellata;Filasterea;Ministeriida;Capsasporidae;Marine Group;";"0.0";"0";"7";"7";"0";"7";"0";"457176";"373894"
"V4mis1";"SILVA (only NR);Eukaryota;Amorphea;Obazoa;Opisthokonta;Holozoa;Choanozoa;Choanoflagellata;Filasterea;Ministeriida;Ministeridae;";"0.0";"0";"1";"1";"0";"1";"0";"457182";"373894"
"V4mis1";"SILVA (only NR);Eukaryota;Amorphea;Obazoa;Opisthokonta;Holozoa;Choanozoa;Choanoflagellata;Filasterea;Ministeriida;Ministeridae;Ministeria;";"0.0";"0";"1";"1";"0";"1";"0";"457182";"373894"
"V4mis1";"SILVA (only NR);Eukaryota;Amorphea;Obazoa;Opisthokonta;Holozoa;Choanozoa;Choanoflagellata;Ichthyosporea;";"0.0";"0";"80";"80";"0";"80";"0";"457103";"373894"
"V4mis1";"SILVA (only NR);Eukaryota;Amorphea;Obazoa;Opisthokonta;Holozoa;Choanozoa;Choanoflagellata;Ichthyosporea;Dermocystida;";"0.0";"0";"13";"13";"0";"13";"0";"457170";"373894"
"V4mis1";"SILVA (only NR);Eukaryota;Amorphea;Obazoa;Opisthokonta;Holozoa;Choanozoa;Choanoflagellata;Ichthyosporea;Dermocystida;Rhinosporideacae;";"0.0";"0";"13";"13";"0";"13";"0";"457170";"373894"
"V4mis1";"SILVA (only NR);Eukaryota;Amorphea;Obazoa;Opisthokonta;Holozoa;Choanozoa;Choanoflagellata;Ichthyosporea;Dermocystida;Rhinosporideacae;Amphibiocystidium;";"0.0";"0";"2";"2";"0";"2";"0";"457181";"373894"
"V4mis1";"SILVA (only NR);Eukaryota;Amorphea;Obazoa;Opisthokonta;Holozoa;Choanozoa;Choanoflagellata;Ichthyosporea;Dermocystida;Rhinosporideacae;Amphibiothecum;";"0.0";"0";"1";"1";"0";"1";"0";"457182";"373894"
"V4mis1";"SILVA (only NR);Eukaryota;Amorphea;Obazoa;Opisthokonta;Holozoa;Choanozoa;Choanoflagellata;Ichthyosporea;Dermocystida;Rhinosporideacae;Dermocystidium;";"0.0";"0";"4";"4";"0";"4";"0";"457179";"373894"
"V4mis1";"SILVA (only NR);Eukaryota;Amorphea;Obazoa;Opisthokonta;Holozoa;Choanozoa;Choanoflagellata;Ichthyosporea;Dermocystida;Rhinosporideacae;Rhinosporidium;";"0.0";"0";"1";"1";"0";"1";"0";"457182";"373894"
"V4mis1";"SILVA (only NR);Eukaryota;Amorphea;Obazoa;Opisthokonta;Holozoa;Choanozoa;Choanoflagellata;Ichthyosporea;Ichthyophonae;";"0.0";"0";"67";"67";"0";"67";"0";"457116";"373894"
"V4mis1";"SILVA (only NR);Eukaryota;Amorphea;Obazoa;Opisthokonta;Holozoa;Choanozoa;Choanoflagellata;Ichthyosporea;Ichthyophonae;Abeoformidae;";"0.0";"0";"11";"11";"0";"11";"0";"457172";"373894"
"V4mis1";"SILVA (only NR);Eukaryota;Amorphea;Obazoa;Opisthokonta;Holozoa;Choanozoa;Choanoflagellata;Ichthyosporea;Ichthyophonae;Abeoformidae;Abeoforma;";"0.0";"0";"2";"2";"0";"2";"0";"457181";"373894"
"V4mis1";"SILVA (only NR);Eukaryota;Amorphea;Obazoa;Opisthokonta;Holozoa;Choanozoa;Choanoflagellata;Ichthyosporea;Ichthyophonae;Abeoformidae;Caullerya;";"0.0";"0";"1";"1";"0";"1";"0";"457182";"373894"
"V4mis1";"SILVA (only NR);Eukaryota;Amorphea;Obazoa;Opisthokonta;Holozoa;Choanozoa;Choanoflagellata;Ichthyosporea;Ichthyophonae;Abeoformidae;Marine Ichthyosporeans 1;";"0.0";"0";"2";"2";"0";"2";"0";"457181";"373894"
"V4mis1";"SILVA (only NR);Eukaryota;Amorphea;Obazoa;Opisthokonta;Holozoa;Choanozoa;Choanoflagellata;Ichthyosporea;Ichthyophonae;Abeoformidae;Pirum;";"0.0";"0";"3";"3";"0";"3";"0";"457180";"373894"
"V4mis1";"SILVA (only NR);Eukaryota;Amorphea;Obazoa;Opisthokonta;Holozoa;Choanozoa;Choanoflagellata;Ichthyosporea;Ichthyophonae;Ichthyophonidae;";"0.0";"0";"43";"43";"0";"43";"0";"457140";"373894"
"V4mis1";"SILVA (only NR);Eukaryota;Amorphea;Obazoa;Opisthokonta;Holozoa;Choanozoa;Choanoflagellata;Ichthyosporea;Ichthyophonae;Ichthyophonidae;Amoebidium;";"0.0";"0";"1";"1";"0";"1";"0";"457182";"373894"
"V4mis1";"SILVA (only NR);Eukaryota;Amorphea;Obazoa;Opisthokonta;Holozoa;Choanozoa;Choanoflagellata;Ichthyosporea;Ichthyophonae;Ichthyophonidae;Freshwater Ichthyosporeans 1;";"0.0";"0";"3";"3";"0";"3";"0";"457180";"373894"
"V4mis1";"SILVA (only NR);Eukaryota;Amorphea;Obazoa;Opisthokonta;Holozoa;Choanozoa;Choanoflagellata;Ichthyosporea;Ichthyophonae;Ichthyophonidae;Ichthyophonus;";"0.0";"0";"4";"4";"0";"4";"0";"457179";"373894"
"V4mis1";"SILVA (only NR);Eukaryota;Amorphea;Obazoa;Opisthokonta;Holozoa;Choanozoa;Choanoflagellata;Ichthyosporea;Ichthyophonae;Ichthyophonidae;Paramoebidium;";"0.0";"0";"32";"32";"0";"32";"0";"457151";"373894"
"V4mis1";"SILVA (only NR);Eukaryota;Amorphea;Obazoa;Opisthokonta;Holozoa;Choanozoa;Choanoflagellata;Ichthyosporea;Ichthyophonae;Ichthyophonidae;Psorospermium;";"0.0";"0";"1";"1";"0";"1";"0";"457182";"373894"
"V4mis1";"SILVA (only NR);Eukaryota;Amorphea;Obazoa;Opisthokonta;Holozoa;Choanozoa;Choanoflagellata;Ichthyosporea;Ichthyophonae;Pseudoperkinsidae;";"0.0";"0";"12";"12";"0";"12";"0";"457171";"373894"
"V4mis1";"SILVA (only NR);Eukaryota;Amorphea;Obazoa;Opisthokonta;Holozoa;Choanozoa;Choanoflagellata;Ichthyosporea;Ichthyophonae;Pseudoperkinsidae;Anurofeca;";"0.0";"0";"3";"3";"0";"3";"0";"457180";"373894"
"V4mis1";"SILVA (only NR);Eukaryota;Amorphea;Obazoa;Opisthokonta;Holozoa;Choanozoa;Choanoflagellata;Ichthyosporea;Ichthyophonae;Pseudoperkinsidae;Creolimax;";"0.0";"0";"1";"1";"0";"1";"0";"457182";"373894"
"V4mis1";"SILVA (only NR);Eukaryota;Amorphea;Obazoa;Opisthokonta;Holozoa;Choanozoa;Choanoflagellata;Ichthyosporea;Ichthyophonae;Pseudoperkinsidae;LKM51;";"0.0";"0";"2";"2";"0";"2";"0";"457181";"373894"
"V4mis1";"SILVA (only NR);Eukaryota;Amorphea;Obazoa;Opisthokonta;Holozoa;Choanozoa;Metazoa;";"0.2";"14.3";"21032";"20835";"41";"20794";"197";"436348";"373853"
"V4mis1";"SILVA (only NR);Eukaryota;Amorphea;Obazoa;Opisthokonta;Holozoa;Choanozoa;Metazoa;Animalia;";"0.2";"14.4";"20636";"20440";"40";"20400";"196";"436743";"373854"
"V4mis1";"SILVA (only NR);Eukaryota;Amorphea;Obazoa;Opisthokonta;Holozoa;Choanozoa;Metazoa;Animalia;BCP clade;";"0.2";"14.4";"20636";"20440";"40";"20400";"196";"436743";"373854"
"V4mis1";"SILVA (only NR);Eukaryota;Amorphea;Obazoa;Opisthokonta;Holozoa;Choanozoa;Metazoa;Animalia;BCP clade;Bilateria;";"0.2";"14.7";"19180";"18990";"40";"18950";"190";"438193";"373854"
"V4mis1";"SILVA (only NR);Eukaryota;Amorphea;Obazoa;Opisthokonta;Holozoa;Choanozoa;Metazoa;Animalia;BCP clade;Bilateria;Deuterostomia;";"0.0";"0";"1400";"1390";"0";"1390";"10";"455793";"373894"
"V4mis1";"SILVA (only NR);Eukaryota;Amorphea;Obazoa;Opisthokonta;Holozoa;Choanozoa;Metazoa;Animalia;BCP clade;Bilateria;Deuterostomia;Ambulacraria;";"0.0";"0";"178";"178";"0";"178";"0";"457005";"373894"
"V4mis1";"SILVA (only NR);Eukaryota;Amorphea;Obazoa;Opisthokonta;Holozoa;Choanozoa;Metazoa;Animalia;BCP clade;Bilateria;Deuterostomia;Ambulacraria;Echinodermata;";"0.0";"0";"146";"146";"0";"146";"0";"457037";"373894"
"V4mis1";"SILVA (only NR);Eukaryota;Amorphea;Obazoa;Opisthokonta;Holozoa;Choanozoa;Metazoa;Animalia;BCP clade;Bilateria;Deuterostomia;Ambulacraria;Echinodermata;Asteroidea;";"0.0";"0";"35";"35";"0";"35";"0";"457148";"373894"
"V4mis1";"SILVA (only NR);Eukaryota;Amorphea;Obazoa;Opisthokonta;Holozoa;Choanozoa;Metazoa;Animalia;BCP clade;Bilateria;Deuterostomia;Ambulacraria;Echinodermata;Crinoidea;";"0.0";"0";"13";"13";"0";"13";"0";"457170";"373894"
"V4mis1";"SILVA (only NR);Eukaryota;Amorphea;Obazoa;Opisthokonta;Holozoa;Choanozoa;Metazoa;Animalia;BCP clade;Bilateria;Deuterostomia;Ambulacraria;Echinodermata;Echinoidea;";"0.0";"0";"39";"39";"0";"39";"0";"457144";"373894"
"V4mis1";"SILVA (only NR);Eukaryota;Amorphea;Obazoa;Opisthokonta;Holozoa;Choanozoa;Metazoa;Animalia;BCP clade;Bilateria;Deuterostomia;Ambulacraria;Echinodermata;Holothuroidea;";"0.0";"0";"44";"44";"0";"44";"0";"457139";"373894"
"V4mis1";"SILVA (only NR);Eukaryota;Amorphea;Obazoa;Opisthokonta;Holozoa;Choanozoa;Metazoa;Animalia;BCP clade;Bilateria;Deuterostomia;Ambulacraria;Echinodermata;Ophiuroidea;";"0.0";"0";"14";"14";"0";"14";"0";"457169";"373894"
"V4mis1";"SILVA (only NR);Eukaryota;Amorphea;Obazoa;Opisthokonta;Holozoa;Choanozoa;Metazoa;Animalia;BCP clade;Bilateria;Deuterostomia;Ambulacraria;Hemichordata;";"0.0";"0";"32";"32";"0";"32";"0";"457151";"373894"
"V4mis1";"SILVA (only NR);Eukaryota;Amorphea;Obazoa;Opisthokonta;Holozoa;Choanozoa;Metazoa;Animalia;BCP clade;Bilateria;Deuterostomia;Ambulacraria;Hemichordata;Enteropneusta;";"0.0";"0";"29";"29";"0";"29";"0";"457154";"373894"
"V4mis1";"SILVA (only NR);Eukaryota;Amorphea;Obazoa;Opisthokonta;Holozoa;Choanozoa;Metazoa;Animalia;BCP clade;Bilateria;Deuterostomia;Ambulacraria;Hemichordata;Enteropneusta;Harrimaniidae;";"0.0";"0";"14";"14";"0";"14";"0";"457169";"373894"
"V4mis1";"SILVA (only NR);Eukaryota;Amorphea;Obazoa;Opisthokonta;Holozoa;Choanozoa;Metazoa;Animalia;BCP clade;Bilateria;Deuterostomia;Ambulacraria;Hemichordata;Enteropneusta;Ptychoderidae;";"0.0";"0";"11";"11";"0";"11";"0";"457172";"373894"
"V4mis1";"SILVA (only NR);Eukaryota;Amorphea;Obazoa;Opisthokonta;Holozoa;Choanozoa;Metazoa;Animalia;BCP clade;Bilateria;Deuterostomia;Ambulacraria;Hemichordata;Enteropneusta;Saxipendiidae;";"0.0";"0";"2";"2";"0";"2";"0";"457181";"373894"
"V4mis1";"SILVA (only NR);Eukaryota;Amorphea;Obazoa;Opisthokonta;Holozoa;Choanozoa;Metazoa;Animalia;BCP clade;Bilateria;Deuterostomia;Ambulacraria;Hemichordata;Enteropneusta;Spengelidae;";"0.0";"0";"2";"2";"0";"2";"0";"457181";"373894"
"V4mis1";"SILVA (only NR);Eukaryota;Amorphea;Obazoa;Opisthokonta;Holozoa;Choanozoa;Metazoa;Animalia;BCP clade;Bilateria;Deuterostomia;Ambulacraria;Hemichordata;Graptolithoidea;";"0.0";"0";"3";"3";"0";"3";"0";"457180";"373894"
"V4mis1";"SILVA (only NR);Eukaryota;Amorphea;Obazoa;Opisthokonta;Holozoa;Choanozoa;Metazoa;Animalia;BCP clade;Bilateria;Deuterostomia;Ambulacraria;Hemichordata;Graptolithoidea;Cephalodiscidae;";"0.0";"0";"3";"3";"0";"3";"0";"457180";"373894"
"V4mis1";"SILVA (only NR);Eukaryota;Amorphea;Obazoa;Opisthokonta;Holozoa;Choanozoa;Metazoa;Animalia;BCP clade;Bilateria;Deuterostomia;Chordata;";"0.0";"0";"1221";"1211";"0";"1211";"10";"455972";"373894"
"V4mis1";"SILVA (only NR);Eukaryota;Amorphea;Obazoa;Opisthokonta;Holozoa;Choanozoa;Metazoa;Animalia;BCP clade;Bilateria;Deuterostomia;Chordata;Cephalochordata;";"0.0";"0";"6";"6";"0";"6";"0";"457177";"373894"
"V4mis1";"SILVA (only NR);Eukaryota;Amorphea;Obazoa;Opisthokonta;Holozoa;Choanozoa;Metazoa;Animalia;BCP clade;Bilateria;Deuterostomia;Chordata;Cephalochordata;Leptocardii;";"0.0";"0";"6";"6";"0";"6";"0";"457177";"373894"
"V4mis1";"SILVA (only NR);Eukaryota;Amorphea;Obazoa;Opisthokonta;Holozoa;Choanozoa;Metazoa;Animalia;BCP clade;Bilateria;Deuterostomia;Chordata;Cephalochordata;Leptocardii;Amphioxiformes;";"0.0";"0";"6";"6";"0";"6";"0";"457177";"373894"
"V4mis1";"SILVA (only NR);Eukaryota;Amorphea;Obazoa;Opisthokonta;Holozoa;Choanozoa;Metazoa;Animalia;BCP clade;Bilateria;Deuterostomia;Chordata;Cephalochordata;Leptocardii;Amphioxiformes;Branchiostomidae;";"0.0";"0";"6";"6";"0";"6";"0";"457177";"373894"
"V4mis1";"SILVA (only NR);Eukaryota;Amorphea;Obazoa;Opisthokonta;Holozoa;Choanozoa;Metazoa;Animalia;BCP clade;Bilateria;Deuterostomia;Chordata;Tunicata;";"0.0";"0";"130";"129";"0";"129";"1";"457054";"373894"
"V4mis1";"SILVA (only NR);Eukaryota;Amorphea;Obazoa;Opisthokonta;Holozoa;Choanozoa;Metazoa;Animalia;BCP clade;Bilateria;Deuterostomia;Chordata;Tunicata;Appendicularia;";"0.0";"0";"29";"29";"0";"29";"0";"457154";"373894"
"V4mis1";"SILVA (only NR);Eukaryota;Amorphea;Obazoa;Opisthokonta;Holozoa;Choanozoa;Metazoa;Animalia;BCP clade;Bilateria;Deuterostomia;Chordata;Tunicata;Appendicularia;Copelata;";"0.0";"0";"29";"29";"0";"29";"0";"457154";"373894"
"V4mis1";"SILVA (only NR);Eukaryota;Amorphea;Obazoa;Opisthokonta;Holozoa;Choanozoa;Metazoa;Animalia;BCP clade;Bilateria;Deuterostomia;Chordata;Tunicata;Appendicularia;Copelata;Oikopleuridae;";"0.0";"0";"29";"29";"0";"29";"0";"457154";"373894"
"V4mis1";"SILVA (only NR);Eukaryota;Amorphea;Obazoa;Opisthokonta;Holozoa;Choanozoa;Metazoa;Animalia;BCP clade;Bilateria;Deuterostomia;Chordata;Tunicata;Ascidiacea;";"0.0";"0";"78";"77";"0";"77";"1";"457106";"373894"
"V4mis1";"SILVA (only NR);Eukaryota;Amorphea;Obazoa;Opisthokonta;Holozoa;Choanozoa;Metazoa;Animalia;BCP clade;Bilateria;Deuterostomia;Chordata;Tunicata;Ascidiacea;Enterogona;";"0.0";"0";"39";"38";"0";"38";"1";"457145";"373894"
"V4mis1";"SILVA (only NR);Eukaryota;Amorphea;Obazoa;Opisthokonta;Holozoa;Choanozoa;Metazoa;Animalia;BCP clade;Bilateria;Deuterostomia;Chordata;Tunicata;Ascidiacea;Stolidobranchia;";"0.0";"0";"39";"39";"0";"39";"0";"457144";"373894"
"V4mis1";"SILVA (only NR);Eukaryota;Amorphea;Obazoa;Opisthokonta;Holozoa;Choanozoa;Metazoa;Animalia;BCP clade;Bilateria;Deuterostomia;Chordata;Tunicata;Thaliacea;";"0.0";"0";"23";"23";"0";"23";"0";"457160";"373894"
"V4mis1";"SILVA (only NR);Eukaryota;Amorphea;Obazoa;Opisthokonta;Holozoa;Choanozoa;Metazoa;Animalia;BCP clade;Bilateria;Deuterostomia;Chordata;Tunicata;Thaliacea;Doliolida;";"0.0";"0";"2";"2";"0";"2";"0";"457181";"373894"
"V4mis1";"SILVA (only NR);Eukaryota;Amorphea;Obazoa;Opisthokonta;Holozoa;Choanozoa;Metazoa;Animalia;BCP clade;Bilateria;Deuterostomia;Chordata;Tunicata;Thaliacea;Pyrosomata;";"0.0";"0";"3";"3";"0";"3";"0";"457180";"373894"
"V4mis1";"SILVA (only NR);Eukaryota;Amorphea;Obazoa;Opisthokonta;Holozoa;Choanozoa;Metazoa;Animalia;BCP clade;Bilateria;Deuterostomia;Chordata;Tunicata;Thaliacea;Salpida;";"0.0";"0";"18";"18";"0";"18";"0";"457165";"373894"
"V4mis1";"SILVA (only NR);Eukaryota;Amorphea;Obazoa;Opisthokonta;Holozoa;Choanozoa;Metazoa;Animalia;BCP clade;Bilateria;Deuterostomia;Chordata;Vertebrata;";"0.0";"0";"1085";"1076";"0";"1076";"9";"456107";"373894"
"V4mis1";"SILVA (only NR);Eukaryota;Amorphea;Obazoa;Opisthokonta;Holozoa;Choanozoa;Metazoa;Animalia;BCP clade;Bilateria;Deuterostomia;Chordata;Vertebrata;Agnatha;";"0.0";"0";"9";"9";"0";"9";"0";"457174";"373894"
"V4mis1";"SILVA (only NR);Eukaryota;Amorphea;Obazoa;Opisthokonta;Holozoa;Choanozoa;Metazoa;Animalia;BCP clade;Bilateria;Deuterostomia;Chordata;Vertebrata;Agnatha;Cephalaspidomorphi;";"0.0";"0";"7";"7";"0";"7";"0";"457176";"373894"
"V4mis1";"SILVA (only NR);Eukaryota;Amorphea;Obazoa;Opisthokonta;Holozoa;Choanozoa;Metazoa;Animalia;BCP clade;Bilateria;Deuterostomia;Chordata;Vertebrata;Agnatha;Cephalaspidomorphi;Petromyzontiformes;";"0.0";"0";"7";"7";"0";"7";"0";"457176";"373894"
"V4mis1";"SILVA (only NR);Eukaryota;Amorphea;Obazoa;Opisthokonta;Holozoa;Choanozoa;Metazoa;Animalia;BCP clade;Bilateria;Deuterostomia;Chordata;Vertebrata;Agnatha;Myxini;";"0.0";"0";"2";"2";"0";"2";"0";"457181";"373894"
"V4mis1";"SILVA (only NR);Eukaryota;Amorphea;Obazoa;Opisthokonta;Holozoa;Choanozoa;Metazoa;Animalia;BCP clade;Bilateria;Deuterostomia;Chordata;Vertebrata;Agnatha;Myxini;Myxiniformes;";"0.0";"0";"2";"2";"0";"2";"0";"457181";"373894"
"V4mis1";"SILVA (only NR);Eukaryota;Amorphea;Obazoa;Opisthokonta;Holozoa;Choanozoa;Metazoa;Animalia;BCP clade;Bilateria;Deuterostomia;Chordata;Vertebrata;Gnathostomata;";"0.0";"0";"1076";"1067";"0";"1067";"9";"456116";"373894"
"V4mis1";"SILVA (only NR);Eukaryota;Amorphea;Obazoa;Opisthokonta;Holozoa;Choanozoa;Metazoa;Animalia;BCP clade;Bilateria;Deuterostomia;Chordata;Vertebrata;Gnathostomata;Chimaeriformes;";"0.0";"0";"2";"2";"0";"2";"0";"457181";"373894"
"V4mis1";"SILVA (only NR);Eukaryota;Amorphea;Obazoa;Opisthokonta;Holozoa;Choanozoa;Metazoa;Animalia;BCP clade;Bilateria;Deuterostomia;Chordata;Vertebrata;Gnathostomata;Chimaeriformes;Callorhinchus;";"0.0";"0";"2";"2";"0";"2";"0";"457181";"373894"
"V4mis1";"SILVA (only NR);Eukaryota;Amorphea;Obazoa;Opisthokonta;Holozoa;Choanozoa;Metazoa;Animalia;BCP clade;Bilateria;Deuterostomia;Chordata;Vertebrata;Gnathostomata;Chondrichthyes;";"0.0";"0";"14";"14";"0";"14";"0";"457169";"373894"
"V4mis1";"SILVA (only NR);Eukaryota;Amorphea;Obazoa;Opisthokonta;Holozoa;Choanozoa;Metazoa;Animalia;BCP clade;Bilateria;Deuterostomia;Chordata;Vertebrata;Gnathostomata;Chondrichthyes;Elasmobranchii;";"0.0";"0";"14";"14";"0";"14";"0";"457169";"373894"
"V4mis1";"SILVA (only NR);Eukaryota;Amorphea;Obazoa;Opisthokonta;Holozoa;Choanozoa;Metazoa;Animalia;BCP clade;Bilateria;Deuterostomia;Chordata;Vertebrata;Gnathostomata;Chondrichthyes;Elasmobranchii;Batoidea;";"0.0";"0";"3";"3";"0";"3";"0";"457180";"373894"
"V4mis1";"SILVA (only NR);Eukaryota;Amorphea;Obazoa;Opisthokonta;Holozoa;Choanozoa;Metazoa;Animalia;BCP clade;Bilateria;Deuterostomia;Chordata;Vertebrata;Gnathostomata;Chondrichthyes;Elasmobranchii;Galeomorphii;";"0.0";"0";"8";"8";"0";"8";"0";"457175";"373894"
"V4mis1";"SILVA (only NR);Eukaryota;Amorphea;Obazoa;Opisthokonta;Holozoa;Choanozoa;Metazoa;Animalia;BCP clade;Bilateria;Deuterostomia;Chordata;Vertebrata;Gnathostomata;Chondrichthyes;Elasmobranchii;Squalimorphii;";"0.0";"0";"3";"3";"0";"3";"0";"457180";"373894"
"V4mis1";"SILVA (only NR);Eukaryota;Amorphea;Obazoa;Opisthokonta;Holozoa;Choanozoa;Metazoa;Animalia;BCP clade;Bilateria;Deuterostomia;Chordata;Vertebrata;Gnathostomata;Euteleostomi;";"0.0";"0";"1060";"1051";"0";"1051";"9";"456132";"373894"
"V4mis1";"SILVA (only NR);Eukaryota;Amorphea;Obazoa;Opisthokonta;Holozoa;Choanozoa;Metazoa;Animalia;BCP clade;Bilateria;Deuterostomia;Chordata;Vertebrata;Gnathostomata;Euteleostomi;Actinopterygii;";"0.0";"0";"426";"419";"0";"419";"7";"456764";"373894"
"V4mis1";"SILVA (only NR);Eukaryota;Amorphea;Obazoa;Opisthokonta;Holozoa;Choanozoa;Metazoa;Animalia;BCP clade;Bilateria;Deuterostomia;Chordata;Vertebrata;Gnathostomata;Euteleostomi;Actinopterygii;Chondrostei;";"0.0";"0";"13";"13";"0";"13";"0";"457170";"373894"
"V4mis1";"SILVA (only NR);Eukaryota;Amorphea;Obazoa;Opisthokonta;Holozoa;Choanozoa;Metazoa;Animalia;BCP clade;Bilateria;Deuterostomia;Chordata;Vertebrata;Gnathostomata;Euteleostomi;Actinopterygii;Chondrostei;Acipenseriformes;";"0.0";"0";"13";"13";"0";"13";"0";"457170";"373894"
"V4mis1";"SILVA (only NR);Eukaryota;Amorphea;Obazoa;Opisthokonta;Holozoa;Choanozoa;Metazoa;Animalia;BCP clade;Bilateria;Deuterostomia;Chordata;Vertebrata;Gnathostomata;Euteleostomi;Actinopterygii;Neopterygii;";"0.0";"0";"412";"405";"0";"405";"7";"456778";"373894"
"V4mis1";"SILVA (only NR);Eukaryota;Amorphea;Obazoa;Opisthokonta;Holozoa;Choanozoa;Metazoa;Animalia;BCP clade;Bilateria;Deuterostomia;Chordata;Vertebrata;Gnathostomata;Euteleostomi;Actinopterygii;Neopterygii;Amiiformes;";"0.0";"0";"10";"9";"0";"9";"1";"457174";"373894"
"V4mis1";"SILVA (only NR);Eukaryota;Amorphea;Obazoa;Opisthokonta;Holozoa;Choanozoa;Metazoa;Animalia;BCP clade;Bilateria;Deuterostomia;Chordata;Vertebrata;Gnathostomata;Euteleostomi;Actinopterygii;Neopterygii;Semionotiformes;";"0.0";"0";"4";"4";"0";"4";"0";"457179";"373894"
"V4mis1";"SILVA (only NR);Eukaryota;Amorphea;Obazoa;Opisthokonta;Holozoa;Choanozoa;Metazoa;Animalia;BCP clade;Bilateria;Deuterostomia;Chordata;Vertebrata;Gnathostomata;Euteleostomi;Actinopterygii;Neopterygii;Teleostei;";"0.0";"0";"397";"391";"0";"391";"6";"456792";"373894"
"V4mis1";"SILVA (only NR);Eukaryota;Amorphea;Obazoa;Opisthokonta;Holozoa;Choanozoa;Metazoa;Animalia;BCP clade;Bilateria;Deuterostomia;Chordata;Vertebrata;Gnathostomata;Euteleostomi;Sarcopterygii;";"0.0";"0";"6";"6";"0";"6";"0";"457177";"373894"
"V4mis1";"SILVA (only NR);Eukaryota;Amorphea;Obazoa;Opisthokonta;Holozoa;Choanozoa;Metazoa;Animalia;BCP clade;Bilateria;Deuterostomia;Chordata;Vertebrata;Gnathostomata;Euteleostomi;Sarcopterygii;Coelacanthiformes;";"0.0";"0";"3";"3";"0";"3";"0";"457180";"373894"
"V4mis1";"SILVA (only NR);Eukaryota;Amorphea;Obazoa;Opisthokonta;Holozoa;Choanozoa;Metazoa;Animalia;BCP clade;Bilateria;Deuterostomia;Chordata;Vertebrata;Gnathostomata;Euteleostomi;Sarcopterygii;Dipnoi;";"0.0";"0";"3";"3";"0";"3";"0";"457180";"373894"
"V4mis1";"SILVA (only NR);Eukaryota;Amorphea;Obazoa;Opisthokonta;Holozoa;Choanozoa;Metazoa;Animalia;BCP clade;Bilateria;Deuterostomia;Chordata;Vertebrata;Gnathostomata;Euteleostomi;Tetrapoda;";"0.0";"0";"627";"625";"0";"625";"2";"456558";"373894"
"V4mis1";"SILVA (only NR);Eukaryota;Amorphea;Obazoa;Opisthokonta;Holozoa;Choanozoa;Metazoa;Animalia;BCP clade;Bilateria;Deuterostomia;Chordata;Vertebrata;Gnathostomata;Euteleostomi;Tetrapoda;Amphibia;";"0.0";"0";"24";"24";"0";"24";"0";"457159";"373894"
"V4mis1";"SILVA (only NR);Eukaryota;Amorphea;Obazoa;Opisthokonta;Holozoa;Choanozoa;Metazoa;Animalia;BCP clade;Bilateria;Deuterostomia;Chordata;Vertebrata;Gnathostomata;Euteleostomi;Tetrapoda;Aves;";"0.0";"0";"10";"10";"0";"10";"0";"457173";"373894"
"V4mis1";"SILVA (only NR);Eukaryota;Amorphea;Obazoa;Opisthokonta;Holozoa;Choanozoa;Metazoa;Animalia;BCP clade;Bilateria;Deuterostomia;Chordata;Vertebrata;Gnathostomata;Euteleostomi;Tetrapoda;Crocodylia;";"0.0";"0";"23";"23";"0";"23";"0";"457160";"373894"
"V4mis1";"SILVA (only NR);Eukaryota;Amorphea;Obazoa;Opisthokonta;Holozoa;Choanozoa;Metazoa;Animalia;BCP clade;Bilateria;Deuterostomia;Chordata;Vertebrata;Gnathostomata;Euteleostomi;Tetrapoda;Lepidosauria;";"0.0";"0";"7";"7";"0";"7";"0";"457176";"373894"
"V4mis1";"SILVA (only NR);Eukaryota;Amorphea;Obazoa;Opisthokonta;Holozoa;Choanozoa;Metazoa;Animalia;BCP clade;Bilateria;Deuterostomia;Chordata;Vertebrata;Gnathostomata;Euteleostomi;Tetrapoda;Mammalia;";"0.0";"0";"550";"548";"0";"548";"2";"456635";"373894"
"V4mis1";"SILVA (only NR);Eukaryota;Amorphea;Obazoa;Opisthokonta;Holozoa;Choanozoa;Metazoa;Animalia;BCP clade;Bilateria;Deuterostomia;Chordata;Vertebrata;Gnathostomata;Euteleostomi;Tetrapoda;Testudines;";"0.0";"0";"13";"13";"0";"13";"0";"457170";"373894"
"V4mis1";"SILVA (only NR);Eukaryota;Amorphea;Obazoa;Opisthokonta;Holozoa;Choanozoa;Metazoa;Animalia;BCP clade;Bilateria;Protostomia;";"0.2";"15";"17780";"17600";"40";"17560";"180";"439583";"373854"
"V4mis1";"SILVA (only NR);Eukaryota;Amorphea;Obazoa;Opisthokonta;Holozoa;Choanozoa;Metazoa;Animalia;BCP clade;Bilateria;Protostomia;Chaetognatha;";"58.7";"18.2";"46";"46";"27";"19";"0";"457137";"373867"
"V4mis1";"SILVA (only NR);Eukaryota;Amorphea;Obazoa;Opisthokonta;Holozoa;Choanozoa;Metazoa;Animalia;BCP clade;Bilateria;Protostomia;Chaetognatha;Sagittoidea;";"58.7";"18.2";"46";"46";"27";"19";"0";"457137";"373867"
"V4mis1";"SILVA (only NR);Eukaryota;Amorphea;Obazoa;Opisthokonta;Holozoa;Choanozoa;Metazoa;Animalia;BCP clade;Bilateria;Protostomia;Chaetognatha;Sagittoidea;Aphragmophora;";"77.1";"18.2";"35";"35";"27";"8";"0";"457148";"373867"
"V4mis1";"SILVA (only NR);Eukaryota;Amorphea;Obazoa;Opisthokonta;Holozoa;Choanozoa;Metazoa;Animalia;BCP clade;Bilateria;Protostomia;Chaetognatha;Sagittoidea;Monophragmophora;";"0.0";"0";"4";"4";"0";"4";"0";"457179";"373894"
"V4mis1";"SILVA (only NR);Eukaryota;Amorphea;Obazoa;Opisthokonta;Holozoa;Choanozoa;Metazoa;Animalia;BCP clade;Bilateria;Protostomia;Chaetognatha;Sagittoidea;Phragmophora;";"0.0";"0";"7";"7";"0";"7";"0";"457176";"373894"
"V4mis1";"SILVA (only NR);Eukaryota;Amorphea;Obazoa;Opisthokonta;Holozoa;Choanozoa;Metazoa;Animalia;BCP clade;Bilateria;Protostomia;Ecdysozoa;";"0.1";"15.9";"12526";"12378";"7";"12371";"148";"444805";"373887"
"V4mis1";"SILVA (only NR);Eukaryota;Amorphea;Obazoa;Opisthokonta;Holozoa;Choanozoa;Metazoa;Animalia;BCP clade;Bilateria;Protostomia;Ecdysozoa;Arthropoda;";"0.0";"16.4";"10152";"10016";"2";"10014";"136";"447167";"373892"
"V4mis1";"SILVA (only NR);Eukaryota;Amorphea;Obazoa;Opisthokonta;Holozoa;Choanozoa;Metazoa;Animalia;BCP clade;Bilateria;Protostomia;Ecdysozoa;Arthropoda;Chelicerata;";"0.0";"17.8";"2232";"2230";"1";"2229";"2";"454953";"373893"
"V4mis1";"SILVA (only NR);Eukaryota;Amorphea;Obazoa;Opisthokonta;Holozoa;Choanozoa;Metazoa;Animalia;BCP clade;Bilateria;Protostomia;Ecdysozoa;Arthropoda;Chelicerata;Arachnida;";"0.0";"17.8";"2150";"2148";"1";"2147";"2";"455035";"373893"
"V4mis1";"SILVA (only NR);Eukaryota;Amorphea;Obazoa;Opisthokonta;Holozoa;Choanozoa;Metazoa;Animalia;BCP clade;Bilateria;Protostomia;Ecdysozoa;Arthropoda;Chelicerata;Arachnida;Acari;";"0.0";"0";"855";"853";"0";"853";"2";"456330";"373894"
"V4mis1";"SILVA (only NR);Eukaryota;Amorphea;Obazoa;Opisthokonta;Holozoa;Choanozoa;Metazoa;Animalia;BCP clade;Bilateria;Protostomia;Ecdysozoa;Arthropoda;Chelicerata;Arachnida;Amblypygi;";"0.0";"0";"15";"15";"0";"15";"0";"457168";"373894"
"V4mis1";"SILVA (only NR);Eukaryota;Amorphea;Obazoa;Opisthokonta;Holozoa;Choanozoa;Metazoa;Animalia;BCP clade;Bilateria;Protostomia;Ecdysozoa;Arthropoda;Chelicerata;Arachnida;Araneae;";"0.0";"0";"864";"864";"0";"864";"0";"456319";"373894"
"V4mis1";"SILVA (only NR);Eukaryota;Amorphea;Obazoa;Opisthokonta;Holozoa;Choanozoa;Metazoa;Animalia;BCP clade;Bilateria;Protostomia;Ecdysozoa;Arthropoda;Chelicerata;Arachnida;Opiliones;";"0.3";"18.2";"294";"294";"1";"293";"0";"456889";"373893"
"V4mis1";"SILVA (only NR);Eukaryota;Amorphea;Obazoa;Opisthokonta;Holozoa;Choanozoa;Metazoa;Animalia;BCP clade;Bilateria;Protostomia;Ecdysozoa;Arthropoda;Chelicerata;Arachnida;Palpigradi;";"0.0";"0";"10";"10";"0";"10";"0";"457173";"373894"
"V4mis1";"SILVA (only NR);Eukaryota;Amorphea;Obazoa;Opisthokonta;Holozoa;Choanozoa;Metazoa;Animalia;BCP clade;Bilateria;Protostomia;Ecdysozoa;Arthropoda;Chelicerata;Arachnida;Pseudoscorpiones;";"0.0";"0";"88";"88";"0";"88";"0";"457095";"373894"
"V4mis1";"SILVA (only NR);Eukaryota;Amorphea;Obazoa;Opisthokonta;Holozoa;Choanozoa;Metazoa;Animalia;BCP clade;Bilateria;Protostomia;Ecdysozoa;Arthropoda;Chelicerata;Arachnida;Ricinulei;";"0.0";"0";"3";"3";"0";"3";"0";"457180";"373894"
"V4mis1";"SILVA (only NR);Eukaryota;Amorphea;Obazoa;Opisthokonta;Holozoa;Choanozoa;Metazoa;Animalia;BCP clade;Bilateria;Protostomia;Ecdysozoa;Arthropoda;Chelicerata;Arachnida;Scorpiones;";"0.0";"0";"12";"12";"0";"12";"0";"457171";"373894"
"V4mis1";"SILVA (only NR);Eukaryota;Amorphea;Obazoa;Opisthokonta;Holozoa;Choanozoa;Metazoa;Animalia;BCP clade;Bilateria;Protostomia;Ecdysozoa;Arthropoda;Chelicerata;Arachnida;Solifugae;";"0.0";"0";"7";"7";"0";"7";"0";"457176";"373894"
"V4mis1";"SILVA (only NR);Eukaryota;Amorphea;Obazoa;Opisthokonta;Holozoa;Choanozoa;Metazoa;Animalia;BCP clade;Bilateria;Protostomia;Ecdysozoa;Arthropoda;Chelicerata;Arachnida;Uropygi;";"0.0";"0";"2";"2";"0";"2";"0";"457181";"373894"
"V4mis1";"SILVA (only NR);Eukaryota;Amorphea;Obazoa;Opisthokonta;Holozoa;Choanozoa;Metazoa;Animalia;BCP clade;Bilateria;Protostomia;Ecdysozoa;Arthropoda;Chelicerata;Merostomata;";"0.0";"0";"9";"9";"0";"9";"0";"457174";"373894"
"V4mis1";"SILVA (only NR);Eukaryota;Amorphea;Obazoa;Opisthokonta;Holozoa;Choanozoa;Metazoa;Animalia;BCP clade;Bilateria;Protostomia;Ecdysozoa;Arthropoda;Chelicerata;Merostomata;Xiphosura;";"0.0";"0";"9";"9";"0";"9";"0";"457174";"373894"
"V4mis1";"SILVA (only NR);Eukaryota;Amorphea;Obazoa;Opisthokonta;Holozoa;Choanozoa;Metazoa;Animalia;BCP clade;Bilateria;Protostomia;Ecdysozoa;Arthropoda;Chelicerata;Pycnogonida;";"0.0";"0";"72";"72";"0";"72";"0";"457111";"373894"
"V4mis1";"SILVA (only NR);Eukaryota;Amorphea;Obazoa;Opisthokonta;Holozoa;Choanozoa;Metazoa;Animalia;BCP clade;Bilateria;Protostomia;Ecdysozoa;Arthropoda;Chelicerata;Pycnogonida;Pantopoda;";"0.0";"0";"72";"72";"0";"72";"0";"457111";"373894"
"V4mis1";"SILVA (only NR);Eukaryota;Amorphea;Obazoa;Opisthokonta;Holozoa;Choanozoa;Metazoa;Animalia;BCP clade;Bilateria;Protostomia;Ecdysozoa;Arthropoda;Crustacea;";"0.0";"0";"1909";"1901";"0";"1901";"8";"455282";"373894"
"V4mis1";"SILVA (only NR);Eukaryota;Amorphea;Obazoa;Opisthokonta;Holozoa;Choanozoa;Metazoa;Animalia;BCP clade;Bilateria;Protostomia;Ecdysozoa;Arthropoda;Crustacea;Branchiopoda;";"0.0";"0";"82";"80";"0";"80";"2";"457103";"373894"
"V4mis1";"SILVA (only NR);Eukaryota;Amorphea;Obazoa;Opisthokonta;Holozoa;Choanozoa;Metazoa;Animalia;BCP clade;Bilateria;Protostomia;Ecdysozoa;Arthropoda;Crustacea;Branchiopoda;Phyllopoda;";"0.0";"0";"75";"73";"0";"73";"2";"457110";"373894"
"V4mis1";"SILVA (only NR);Eukaryota;Amorphea;Obazoa;Opisthokonta;Holozoa;Choanozoa;Metazoa;Animalia;BCP clade;Bilateria;Protostomia;Ecdysozoa;Arthropoda;Crustacea;Branchiopoda;Phyllopoda;Diplostraca;";"0.0";"0";"73";"71";"0";"71";"2";"457112";"373894"
"V4mis1";"SILVA (only NR);Eukaryota;Amorphea;Obazoa;Opisthokonta;Holozoa;Choanozoa;Metazoa;Animalia;BCP clade;Bilateria;Protostomia;Ecdysozoa;Arthropoda;Crustacea;Branchiopoda;Phyllopoda;Notostraca;";"0.0";"0";"2";"2";"0";"2";"0";"457181";"373894"
"V4mis1";"SILVA (only NR);Eukaryota;Amorphea;Obazoa;Opisthokonta;Holozoa;Choanozoa;Metazoa;Animalia;BCP clade;Bilateria;Protostomia;Ecdysozoa;Arthropoda;Crustacea;Branchiopoda;Sarsostraca;";"0.0";"0";"7";"7";"0";"7";"0";"457176";"373894"
"V4mis1";"SILVA (only NR);Eukaryota;Amorphea;Obazoa;Opisthokonta;Holozoa;Choanozoa;Metazoa;Animalia;BCP clade;Bilateria;Protostomia;Ecdysozoa;Arthropoda;Crustacea;Branchiopoda;Sarsostraca;Anostraca;";"0.0";"0";"7";"7";"0";"7";"0";"457176";"373894"
"V4mis1";"SILVA (only NR);Eukaryota;Amorphea;Obazoa;Opisthokonta;Holozoa;Choanozoa;Metazoa;Animalia;BCP clade;Bilateria;Protostomia;Ecdysozoa;Arthropoda;Crustacea;Malacostraca;";"0.0";"0";"839";"834";"0";"834";"5";"456349";"373894"
"V4mis1";"SILVA (only NR);Eukaryota;Amorphea;Obazoa;Opisthokonta;Holozoa;Choanozoa;Metazoa;Animalia;BCP clade;Bilateria;Protostomia;Ecdysozoa;Arthropoda;Crustacea;Malacostraca;Eumalacostraca;";"0.0";"0";"834";"829";"0";"829";"5";"456354";"373894"
"V4mis1";"SILVA (only NR);Eukaryota;Amorphea;Obazoa;Opisthokonta;Holozoa;Choanozoa;Metazoa;Animalia;BCP clade;Bilateria;Protostomia;Ecdysozoa;Arthropoda;Crustacea;Malacostraca;Eumalacostraca;Eucarida;";"0.0";"0";"477";"472";"0";"472";"5";"456711";"373894"
"V4mis1";"SILVA (only NR);Eukaryota;Amorphea;Obazoa;Opisthokonta;Holozoa;Choanozoa;Metazoa;Animalia;BCP clade;Bilateria;Protostomia;Ecdysozoa;Arthropoda;Crustacea;Malacostraca;Eumalacostraca;Hoplocarida;";"0.0";"0";"10";"10";"0";"10";"0";"457173";"373894"
"V4mis1";"SILVA (only NR);Eukaryota;Amorphea;Obazoa;Opisthokonta;Holozoa;Choanozoa;Metazoa;Animalia;BCP clade;Bilateria;Protostomia;Ecdysozoa;Arthropoda;Crustacea;Malacostraca;Eumalacostraca;Peracarida;";"0.0";"0";"312";"312";"0";"312";"0";"456871";"373894"
"V4mis1";"SILVA (only NR);Eukaryota;Amorphea;Obazoa;Opisthokonta;Holozoa;Choanozoa;Metazoa;Animalia;BCP clade;Bilateria;Protostomia;Ecdysozoa;Arthropoda;Crustacea;Malacostraca;Eumalacostraca;Syncarida;";"0.0";"0";"32";"32";"0";"32";"0";"457151";"373894"
"V4mis1";"SILVA (only NR);Eukaryota;Amorphea;Obazoa;Opisthokonta;Holozoa;Choanozoa;Metazoa;Animalia;BCP clade;Bilateria;Protostomia;Ecdysozoa;Arthropoda;Crustacea;Malacostraca;Phyllocarida;";"0.0";"0";"4";"4";"0";"4";"0";"457179";"373894"
"V4mis1";"SILVA (only NR);Eukaryota;Amorphea;Obazoa;Opisthokonta;Holozoa;Choanozoa;Metazoa;Animalia;BCP clade;Bilateria;Protostomia;Ecdysozoa;Arthropoda;Crustacea;Malacostraca;Phyllocarida;Leptostraca;";"0.0";"0";"4";"4";"0";"4";"0";"457179";"373894"
"V4mis1";"SILVA (only NR);Eukaryota;Amorphea;Obazoa;Opisthokonta;Holozoa;Choanozoa;Metazoa;Animalia;BCP clade;Bilateria;Protostomia;Ecdysozoa;Arthropoda;Crustacea;Maxillopoda;";"0.0";"0";"841";"841";"0";"841";"0";"456342";"373894"
"V4mis1";"SILVA (only NR);Eukaryota;Amorphea;Obazoa;Opisthokonta;Holozoa;Choanozoa;Metazoa;Animalia;BCP clade;Bilateria;Protostomia;Ecdysozoa;Arthropoda;Crustacea;Maxillopoda;Branchiura;";"0.0";"0";"12";"12";"0";"12";"0";"457171";"373894"
"V4mis1";"SILVA (only NR);Eukaryota;Amorphea;Obazoa;Opisthokonta;Holozoa;Choanozoa;Metazoa;Animalia;BCP clade;Bilateria;Protostomia;Ecdysozoa;Arthropoda;Crustacea;Maxillopoda;Branchiura;Arguloida;";"0.0";"0";"12";"12";"0";"12";"0";"457171";"373894"
"V4mis1";"SILVA (only NR);Eukaryota;Amorphea;Obazoa;Opisthokonta;Holozoa;Choanozoa;Metazoa;Animalia;BCP clade;Bilateria;Protostomia;Ecdysozoa;Arthropoda;Crustacea;Maxillopoda;Copepoda;";"0.0";"0";"673";"673";"0";"673";"0";"456510";"373894"
"V4mis1";"SILVA (only NR);Eukaryota;Amorphea;Obazoa;Opisthokonta;Holozoa;Choanozoa;Metazoa;Animalia;BCP clade;Bilateria;Protostomia;Ecdysozoa;Arthropoda;Crustacea;Maxillopoda;Copepoda;Calanoida;";"0.0";"0";"263";"263";"0";"263";"0";"456920";"373894"
"V4mis1";"SILVA (only NR);Eukaryota;Amorphea;Obazoa;Opisthokonta;Holozoa;Choanozoa;Metazoa;Animalia;BCP clade;Bilateria;Protostomia;Ecdysozoa;Arthropoda;Crustacea;Maxillopoda;Copepoda;Cyclopoida;";"0.0";"0";"159";"159";"0";"159";"0";"457024";"373894"
"V4mis1";"SILVA (only NR);Eukaryota;Amorphea;Obazoa;Opisthokonta;Holozoa;Choanozoa;Metazoa;Animalia;BCP clade;Bilateria;Protostomia;Ecdysozoa;Arthropoda;Crustacea;Maxillopoda;Copepoda;Harpacticoida;";"0.0";"0";"95";"95";"0";"95";"0";"457088";"373894"
"V4mis1";"SILVA (only NR);Eukaryota;Amorphea;Obazoa;Opisthokonta;Holozoa;Choanozoa;Metazoa;Animalia;BCP clade;Bilateria;Protostomia;Ecdysozoa;Arthropoda;Crustacea;Maxillopoda;Copepoda;Misophrioida;";"0.0";"0";"6";"6";"0";"6";"0";"457177";"373894"
"V4mis1";"SILVA (only NR);Eukaryota;Amorphea;Obazoa;Opisthokonta;Holozoa;Choanozoa;Metazoa;Animalia;BCP clade;Bilateria;Protostomia;Ecdysozoa;Arthropoda;Crustacea;Maxillopoda;Copepoda;Monstrilloida;";"0.0";"0";"18";"18";"0";"18";"0";"457165";"373894"
"V4mis1";"SILVA (only NR);Eukaryota;Amorphea;Obazoa;Opisthokonta;Holozoa;Choanozoa;Metazoa;Animalia;BCP clade;Bilateria;Protostomia;Ecdysozoa;Arthropoda;Crustacea;Maxillopoda;Copepoda;Poecilostomatoida;";"0.0";"0";"46";"46";"0";"46";"0";"457137";"373894"
"V4mis1";"SILVA (only NR);Eukaryota;Amorphea;Obazoa;Opisthokonta;Holozoa;Choanozoa;Metazoa;Animalia;BCP clade;Bilateria;Protostomia;Ecdysozoa;Arthropoda;Crustacea;Maxillopoda;Copepoda;Siphonostomatoida;";"0.0";"0";"58";"58";"0";"58";"0";"457125";"373894"
"V4mis1";"SILVA (only NR);Eukaryota;Amorphea;Obazoa;Opisthokonta;Holozoa;Choanozoa;Metazoa;Animalia;BCP clade;Bilateria;Protostomia;Ecdysozoa;Arthropoda;Crustacea;Maxillopoda;Pentastomida;";"0.0";"0";"13";"13";"0";"13";"0";"457170";"373894"
"V4mis1";"SILVA (only NR);Eukaryota;Amorphea;Obazoa;Opisthokonta;Holozoa;Choanozoa;Metazoa;Animalia;BCP clade;Bilateria;Protostomia;Ecdysozoa;Arthropoda;Crustacea;Maxillopoda;Pentastomida;Cephalobaenida;";"0.0";"0";"4";"4";"0";"4";"0";"457179";"373894"
"V4mis1";"SILVA (only NR);Eukaryota;Amorphea;Obazoa;Opisthokonta;Holozoa;Choanozoa;Metazoa;Animalia;BCP clade;Bilateria;Protostomia;Ecdysozoa;Arthropoda;Crustacea;Maxillopoda;Pentastomida;Porocephalida;";"0.0";"0";"8";"8";"0";"8";"0";"457175";"373894"
"V4mis1";"SILVA (only NR);Eukaryota;Amorphea;Obazoa;Opisthokonta;Holozoa;Choanozoa;Metazoa;Animalia;BCP clade;Bilateria;Protostomia;Ecdysozoa;Arthropoda;Crustacea;Maxillopoda;Tantulocarida;";"0.0";"0";"2";"2";"0";"2";"0";"457181";"373894"
"V4mis1";"SILVA (only NR);Eukaryota;Amorphea;Obazoa;Opisthokonta;Holozoa;Choanozoa;Metazoa;Animalia;BCP clade;Bilateria;Protostomia;Ecdysozoa;Arthropoda;Crustacea;Maxillopoda;Thecostraca;";"0.0";"0";"140";"140";"0";"140";"0";"457043";"373894"
"V4mis1";"SILVA (only NR);Eukaryota;Amorphea;Obazoa;Opisthokonta;Holozoa;Choanozoa;Metazoa;Animalia;BCP clade;Bilateria;Protostomia;Ecdysozoa;Arthropoda;Crustacea;Maxillopoda;Thecostraca;Akentrogonida;";"0.0";"0";"7";"7";"0";"7";"0";"457176";"373894"
"V4mis1";"SILVA (only NR);Eukaryota;Amorphea;Obazoa;Opisthokonta;Holozoa;Choanozoa;Metazoa;Animalia;BCP clade;Bilateria;Protostomia;Ecdysozoa;Arthropoda;Crustacea;Maxillopoda;Thecostraca;Apygophora;";"0.0";"0";"2";"2";"0";"2";"0";"457181";"373894"
"V4mis1";"SILVA (only NR);Eukaryota;Amorphea;Obazoa;Opisthokonta;Holozoa;Choanozoa;Metazoa;Animalia;BCP clade;Bilateria;Protostomia;Ecdysozoa;Arthropoda;Crustacea;Maxillopoda;Thecostraca;Dendrogastrida;";"0.0";"0";"4";"4";"0";"4";"0";"457179";"373894"
"V4mis1";"SILVA (only NR);Eukaryota;Amorphea;Obazoa;Opisthokonta;Holozoa;Choanozoa;Metazoa;Animalia;BCP clade;Bilateria;Protostomia;Ecdysozoa;Arthropoda;Crustacea;Maxillopoda;Thecostraca;Facetotecta;";"0.0";"0";"5";"5";"0";"5";"0";"457178";"373894"
"V4mis1";"SILVA (only NR);Eukaryota;Amorphea;Obazoa;Opisthokonta;Holozoa;Choanozoa;Metazoa;Animalia;BCP clade;Bilateria;Protostomia;Ecdysozoa;Arthropoda;Crustacea;Maxillopoda;Thecostraca;Kentrogonida;";"0.0";"0";"22";"22";"0";"22";"0";"457161";"373894"
"V4mis1";"SILVA (only NR);Eukaryota;Amorphea;Obazoa;Opisthokonta;Holozoa;Choanozoa;Metazoa;Animalia;BCP clade;Bilateria;Protostomia;Ecdysozoa;Arthropoda;Crustacea;Maxillopoda;Thecostraca;Laurida;";"0.0";"0";"2";"2";"0";"2";"0";"457181";"373894"
"V4mis1";"SILVA (only NR);Eukaryota;Amorphea;Obazoa;Opisthokonta;Holozoa;Choanozoa;Metazoa;Animalia;BCP clade;Bilateria;Protostomia;Ecdysozoa;Arthropoda;Crustacea;Maxillopoda;Thecostraca;Pedunculata;";"0.0";"0";"41";"41";"0";"41";"0";"457142";"373894"
"V4mis1";"SILVA (only NR);Eukaryota;Amorphea;Obazoa;Opisthokonta;Holozoa;Choanozoa;Metazoa;Animalia;BCP clade;Bilateria;Protostomia;Ecdysozoa;Arthropoda;Crustacea;Maxillopoda;Thecostraca;Pygophora;";"0.0";"0";"4";"4";"0";"4";"0";"457179";"373894"
"V4mis1";"SILVA (only NR);Eukaryota;Amorphea;Obazoa;Opisthokonta;Holozoa;Choanozoa;Metazoa;Animalia;BCP clade;Bilateria;Protostomia;Ecdysozoa;Arthropoda;Crustacea;Maxillopoda;Thecostraca;Sessilia;";"0.0";"0";"50";"50";"0";"50";"0";"457133";"373894"
"V4mis1";"SILVA (only NR);Eukaryota;Amorphea;Obazoa;Opisthokonta;Holozoa;Choanozoa;Metazoa;Animalia;BCP clade;Bilateria;Protostomia;Ecdysozoa;Arthropoda;Crustacea;Ostracoda;";"0.0";"0";"141";"141";"0";"141";"0";"457042";"373894"
"V4mis1";"SILVA (only NR);Eukaryota;Amorphea;Obazoa;Opisthokonta;Holozoa;Choanozoa;Metazoa;Animalia;BCP clade;Bilateria;Protostomia;Ecdysozoa;Arthropoda;Crustacea;Ostracoda;Myodocopa;";"0.0";"0";"35";"35";"0";"35";"0";"457148";"373894"
"V4mis1";"SILVA (only NR);Eukaryota;Amorphea;Obazoa;Opisthokonta;Holozoa;Choanozoa;Metazoa;Animalia;BCP clade;Bilateria;Protostomia;Ecdysozoa;Arthropoda;Crustacea;Ostracoda;Myodocopa;Halocyprida;";"0.0";"0";"14";"14";"0";"14";"0";"457169";"373894"
"V4mis1";"SILVA (only NR);Eukaryota;Amorphea;Obazoa;Opisthokonta;Holozoa;Choanozoa;Metazoa;Animalia;BCP clade;Bilateria;Protostomia;Ecdysozoa;Arthropoda;Crustacea;Ostracoda;Myodocopa;Myodocopida;";"0.0";"0";"21";"21";"0";"21";"0";"457162";"373894"
"V4mis1";"SILVA (only NR);Eukaryota;Amorphea;Obazoa;Opisthokonta;Holozoa;Choanozoa;Metazoa;Animalia;BCP clade;Bilateria;Protostomia;Ecdysozoa;Arthropoda;Crustacea;Ostracoda;Podocopa;";"0.0";"0";"106";"106";"0";"106";"0";"457077";"373894"
"V4mis1";"SILVA (only NR);Eukaryota;Amorphea;Obazoa;Opisthokonta;Holozoa;Choanozoa;Metazoa;Animalia;BCP clade;Bilateria;Protostomia;Ecdysozoa;Arthropoda;Crustacea;Ostracoda;Podocopa;Podocopida;";"0.0";"0";"105";"105";"0";"105";"0";"457078";"373894"
"V4mis1";"SILVA (only NR);Eukaryota;Amorphea;Obazoa;Opisthokonta;Holozoa;Choanozoa;Metazoa;Animalia;BCP clade;Bilateria;Protostomia;Ecdysozoa;Arthropoda;Hexapoda;";"0.0";"17.2";"5800";"5674";"1";"5673";"126";"451509";"373893"
"V4mis1";"SILVA (only NR);Eukaryota;Amorphea;Obazoa;Opisthokonta;Holozoa;Choanozoa;Metazoa;Animalia;BCP clade;Bilateria;Protostomia;Ecdysozoa;Arthropoda;Hexapoda;Diplura;";"0.0";"0";"13";"13";"0";"13";"0";"457170";"373894"
"V4mis1";"SILVA (only NR);Eukaryota;Amorphea;Obazoa;Opisthokonta;Holozoa;Choanozoa;Metazoa;Animalia;BCP clade;Bilateria;Protostomia;Ecdysozoa;Arthropoda;Hexapoda;Diplura;Campodeoidea;";"0.0";"0";"7";"7";"0";"7";"0";"457176";"373894"
"V4mis1";"SILVA (only NR);Eukaryota;Amorphea;Obazoa;Opisthokonta;Holozoa;Choanozoa;Metazoa;Animalia;BCP clade;Bilateria;Protostomia;Ecdysozoa;Arthropoda;Hexapoda;Diplura;Japygoidea;";"0.0";"0";"4";"4";"0";"4";"0";"457179";"373894"
"V4mis1";"SILVA (only NR);Eukaryota;Amorphea;Obazoa;Opisthokonta;Holozoa;Choanozoa;Metazoa;Animalia;BCP clade;Bilateria;Protostomia;Ecdysozoa;Arthropoda;Hexapoda;Ellipura;";"0.0";"0";"156";"155";"0";"155";"1";"457028";"373894"
"V4mis1";"SILVA (only NR);Eukaryota;Amorphea;Obazoa;Opisthokonta;Holozoa;Choanozoa;Metazoa;Animalia;BCP clade;Bilateria;Protostomia;Ecdysozoa;Arthropoda;Hexapoda;Ellipura;Collembola;";"0.0";"0";"129";"128";"0";"128";"1";"457055";"373894"
"V4mis1";"SILVA (only NR);Eukaryota;Amorphea;Obazoa;Opisthokonta;Holozoa;Choanozoa;Metazoa;Animalia;BCP clade;Bilateria;Protostomia;Ecdysozoa;Arthropoda;Hexapoda;Ellipura;Protura;";"0.0";"0";"27";"27";"0";"27";"0";"457156";"373894"
"V4mis1";"SILVA (only NR);Eukaryota;Amorphea;Obazoa;Opisthokonta;Holozoa;Choanozoa;Metazoa;Animalia;BCP clade;Bilateria;Protostomia;Ecdysozoa;Arthropoda;Hexapoda;Insecta;";"0.0";"17.2";"5631";"5506";"1";"5505";"125";"451677";"373893"
"V4mis1";"SILVA (only NR);Eukaryota;Amorphea;Obazoa;Opisthokonta;Holozoa;Choanozoa;Metazoa;Animalia;BCP clade;Bilateria;Protostomia;Ecdysozoa;Arthropoda;Hexapoda;Insecta;Monocondylia;";"0.0";"0";"11";"11";"0";"11";"0";"457172";"373894"
"V4mis1";"SILVA (only NR);Eukaryota;Amorphea;Obazoa;Opisthokonta;Holozoa;Choanozoa;Metazoa;Animalia;BCP clade;Bilateria;Protostomia;Ecdysozoa;Arthropoda;Hexapoda;Insecta;Monocondylia;Archaeognatha;";"0.0";"0";"11";"11";"0";"11";"0";"457172";"373894"
"V4mis1";"SILVA (only NR);Eukaryota;Amorphea;Obazoa;Opisthokonta;Holozoa;Choanozoa;Metazoa;Animalia;BCP clade;Bilateria;Protostomia;Ecdysozoa;Arthropoda;Hexapoda;Insecta;Pterygota;";"0.0";"17.2";"5605";"5480";"1";"5479";"125";"451703";"373893"
"V4mis1";"SILVA (only NR);Eukaryota;Amorphea;Obazoa;Opisthokonta;Holozoa;Choanozoa;Metazoa;Animalia;BCP clade;Bilateria;Protostomia;Ecdysozoa;Arthropoda;Hexapoda;Insecta;Pterygota;Neoptera;";"0.0";"17.3";"5443";"5319";"1";"5318";"124";"451864";"373893"
"V4mis1";"SILVA (only NR);Eukaryota;Amorphea;Obazoa;Opisthokonta;Holozoa;Choanozoa;Metazoa;Animalia;BCP clade;Bilateria;Protostomia;Ecdysozoa;Arthropoda;Hexapoda;Insecta;Pterygota;Neoptera;Amphiesmenoptera;";"0.0";"0";"84";"80";"0";"80";"4";"457103";"373894"
"V4mis1";"SILVA (only NR);Eukaryota;Amorphea;Obazoa;Opisthokonta;Holozoa;Choanozoa;Metazoa;Animalia;BCP clade;Bilateria;Protostomia;Ecdysozoa;Arthropoda;Hexapoda;Insecta;Pterygota;Neoptera;Amphiesmenoptera;Lepidoptera;";"0.0";"0";"69";"65";"0";"65";"4";"457118";"373894"
"V4mis1";"SILVA (only NR);Eukaryota;Amorphea;Obazoa;Opisthokonta;Holozoa;Choanozoa;Metazoa;Animalia;BCP clade;Bilateria;Protostomia;Ecdysozoa;Arthropoda;Hexapoda;Insecta;Pterygota;Neoptera;Amphiesmenoptera;Trichoptera;";"0.0";"0";"13";"13";"0";"13";"0";"457170";"373894"
"V4mis1";"SILVA (only NR);Eukaryota;Amorphea;Obazoa;Opisthokonta;Holozoa;Choanozoa;Metazoa;Animalia;BCP clade;Bilateria;Protostomia;Ecdysozoa;Arthropoda;Hexapoda;Insecta;Pterygota;Neoptera;Coleoptera;";"0.0";"0";"2365";"2348";"0";"2348";"17";"454835";"373894"
"V4mis1";"SILVA (only NR);Eukaryota;Amorphea;Obazoa;Opisthokonta;Holozoa;Choanozoa;Metazoa;Animalia;BCP clade;Bilateria;Protostomia;Ecdysozoa;Arthropoda;Hexapoda;Insecta;Pterygota;Neoptera;Dermaptera;";"0.0";"0";"19";"19";"0";"19";"0";"457164";"373894"
"V4mis1";"SILVA (only NR);Eukaryota;Amorphea;Obazoa;Opisthokonta;Holozoa;Choanozoa;Metazoa;Animalia;BCP clade;Bilateria;Protostomia;Ecdysozoa;Arthropoda;Hexapoda;Insecta;Pterygota;Neoptera;Dictyoptera;";"0.0";"0";"132";"130";"0";"130";"2";"457053";"373894"
"V4mis1";"SILVA (only NR);Eukaryota;Amorphea;Obazoa;Opisthokonta;Holozoa;Choanozoa;Metazoa;Animalia;BCP clade;Bilateria;Protostomia;Ecdysozoa;Arthropoda;Hexapoda;Insecta;Pterygota;Neoptera;Dictyoptera;Blattodea;";"0.0";"0";"84";"82";"0";"82";"2";"457101";"373894"
"V4mis1";"SILVA (only NR);Eukaryota;Amorphea;Obazoa;Opisthokonta;Holozoa;Choanozoa;Metazoa;Animalia;BCP clade;Bilateria;Protostomia;Ecdysozoa;Arthropoda;Hexapoda;Insecta;Pterygota;Neoptera;Dictyoptera;Isoptera;";"0.0";"0";"14";"14";"0";"14";"0";"457169";"373894"
"V4mis1";"SILVA (only NR);Eukaryota;Amorphea;Obazoa;Opisthokonta;Holozoa;Choanozoa;Metazoa;Animalia;BCP clade;Bilateria;Protostomia;Ecdysozoa;Arthropoda;Hexapoda;Insecta;Pterygota;Neoptera;Dictyoptera;Mantodea;";"0.0";"0";"32";"32";"0";"32";"0";"457151";"373894"
"V4mis1";"SILVA (only NR);Eukaryota;Amorphea;Obazoa;Opisthokonta;Holozoa;Choanozoa;Metazoa;Animalia;BCP clade;Bilateria;Protostomia;Ecdysozoa;Arthropoda;Hexapoda;Insecta;Pterygota;Neoptera;Diptera;";"0.0";"0";"810";"792";"0";"792";"18";"456391";"373894"
"V4mis1";"SILVA (only NR);Eukaryota;Amorphea;Obazoa;Opisthokonta;Holozoa;Choanozoa;Metazoa;Animalia;BCP clade;Bilateria;Protostomia;Ecdysozoa;Arthropoda;Hexapoda;Insecta;Pterygota;Neoptera;Embioptera;";"0.0";"0";"28";"28";"0";"28";"0";"457155";"373894"
"V4mis1";"SILVA (only NR);Eukaryota;Amorphea;Obazoa;Opisthokonta;Holozoa;Choanozoa;Metazoa;Animalia;BCP clade;Bilateria;Protostomia;Ecdysozoa;Arthropoda;Hexapoda;Insecta;Pterygota;Neoptera;Grylloblattodea;";"0.0";"0";"14";"14";"0";"14";"0";"457169";"373894"
"V4mis1";"SILVA (only NR);Eukaryota;Amorphea;Obazoa;Opisthokonta;Holozoa;Choanozoa;Metazoa;Animalia;BCP clade;Bilateria;Protostomia;Ecdysozoa;Arthropoda;Hexapoda;Insecta;Pterygota;Neoptera;Hemiptera;";"0.0";"0";"757";"699";"0";"699";"58";"456484";"373894"
"V4mis1";"SILVA (only NR);Eukaryota;Amorphea;Obazoa;Opisthokonta;Holozoa;Choanozoa;Metazoa;Animalia;BCP clade;Bilateria;Protostomia;Ecdysozoa;Arthropoda;Hexapoda;Insecta;Pterygota;Neoptera;Hymenoptera;";"0.0";"0";"418";"412";"0";"412";"6";"456771";"373894"
"V4mis1";"SILVA (only NR);Eukaryota;Amorphea;Obazoa;Opisthokonta;Holozoa;Choanozoa;Metazoa;Animalia;BCP clade;Bilateria;Protostomia;Ecdysozoa;Arthropoda;Hexapoda;Insecta;Pterygota;Neoptera;Mantophasmatodea;";"0.0";"0";"3";"2";"0";"2";"1";"457181";"373894"
"V4mis1";"SILVA (only NR);Eukaryota;Amorphea;Obazoa;Opisthokonta;Holozoa;Choanozoa;Metazoa;Animalia;BCP clade;Bilateria;Protostomia;Ecdysozoa;Arthropoda;Hexapoda;Insecta;Pterygota;Neoptera;Mecoptera;";"0.0";"0";"27";"27";"0";"27";"0";"457156";"373894"
"V4mis1";"SILVA (only NR);Eukaryota;Amorphea;Obazoa;Opisthokonta;Holozoa;Choanozoa;Metazoa;Animalia;BCP clade;Bilateria;Protostomia;Ecdysozoa;Arthropoda;Hexapoda;Insecta;Pterygota;Neoptera;Megaloptera;";"0.0";"0";"4";"4";"0";"4";"0";"457179";"373894"
"V4mis1";"SILVA (only NR);Eukaryota;Amorphea;Obazoa;Opisthokonta;Holozoa;Choanozoa;Metazoa;Animalia;BCP clade;Bilateria;Protostomia;Ecdysozoa;Arthropoda;Hexapoda;Insecta;Pterygota;Neoptera;Neuroptera;";"0.0";"0";"71";"66";"0";"66";"5";"457117";"373894"
"V4mis1";"SILVA (only NR);Eukaryota;Amorphea;Obazoa;Opisthokonta;Holozoa;Choanozoa;Metazoa;Animalia;BCP clade;Bilateria;Protostomia;Ecdysozoa;Arthropoda;Hexapoda;Insecta;Pterygota;Neoptera;Orthoptera;";"0.0";"0";"133";"131";"0";"131";"2";"457052";"373894"
"V4mis1";"SILVA (only NR);Eukaryota;Amorphea;Obazoa;Opisthokonta;Holozoa;Choanozoa;Metazoa;Animalia;BCP clade;Bilateria;Protostomia;Ecdysozoa;Arthropoda;Hexapoda;Insecta;Pterygota;Neoptera;Phasmatodea;";"0.0";"0";"32";"32";"0";"32";"0";"457151";"373894"
"V4mis1";"SILVA (only NR);Eukaryota;Amorphea;Obazoa;Opisthokonta;Holozoa;Choanozoa;Metazoa;Animalia;BCP clade;Bilateria;Protostomia;Ecdysozoa;Arthropoda;Hexapoda;Insecta;Pterygota;Neoptera;Phthiraptera;";"0.0";"0";"40";"34";"0";"34";"6";"457149";"373894"
"V4mis1";"SILVA (only NR);Eukaryota;Amorphea;Obazoa;Opisthokonta;Holozoa;Choanozoa;Metazoa;Animalia;BCP clade;Bilateria;Protostomia;Ecdysozoa;Arthropoda;Hexapoda;Insecta;Pterygota;Neoptera;Plecoptera;";"0.0";"0";"132";"130";"0";"130";"2";"457053";"373894"
"V4mis1";"SILVA (only NR);Eukaryota;Amorphea;Obazoa;Opisthokonta;Holozoa;Choanozoa;Metazoa;Animalia;BCP clade;Bilateria;Protostomia;Ecdysozoa;Arthropoda;Hexapoda;Insecta;Pterygota;Neoptera;Psocoptera;";"0.0";"0";"151";"150";"0";"150";"1";"457033";"373894"
"V4mis1";"SILVA (only NR);Eukaryota;Amorphea;Obazoa;Opisthokonta;Holozoa;Choanozoa;Metazoa;Animalia;BCP clade;Bilateria;Protostomia;Ecdysozoa;Arthropoda;Hexapoda;Insecta;Pterygota;Neoptera;Raphidioptera;";"0.0";"0";"5";"5";"0";"5";"0";"457178";"373894"
"V4mis1";"SILVA (only NR);Eukaryota;Amorphea;Obazoa;Opisthokonta;Holozoa;Choanozoa;Metazoa;Animalia;BCP clade;Bilateria;Protostomia;Ecdysozoa;Arthropoda;Hexapoda;Insecta;Pterygota;Neoptera;Siphonaptera;";"0.0";"0";"52";"52";"0";"52";"0";"457131";"373894"
"V4mis1";"SILVA (only NR);Eukaryota;Amorphea;Obazoa;Opisthokonta;Holozoa;Choanozoa;Metazoa;Animalia;BCP clade;Bilateria;Protostomia;Ecdysozoa;Arthropoda;Hexapoda;Insecta;Pterygota;Neoptera;Strepsiptera;";"0.0";"0";"7";"6";"0";"6";"1";"457177";"373894"
"V4mis1";"SILVA (only NR);Eukaryota;Amorphea;Obazoa;Opisthokonta;Holozoa;Choanozoa;Metazoa;Animalia;BCP clade;Bilateria;Protostomia;Ecdysozoa;Arthropoda;Hexapoda;Insecta;Pterygota;Neoptera;Thysanoptera;";"1.0";"18.2";"102";"102";"1";"101";"0";"457081";"373893"
"V4mis1";"SILVA (only NR);Eukaryota;Amorphea;Obazoa;Opisthokonta;Holozoa;Choanozoa;Metazoa;Animalia;BCP clade;Bilateria;Protostomia;Ecdysozoa;Arthropoda;Hexapoda;Insecta;Pterygota;Neoptera;Zoraptera;";"0.0";"0";"10";"10";"0";"10";"0";"457173";"373894"
"V4mis1";"SILVA (only NR);Eukaryota;Amorphea;Obazoa;Opisthokonta;Holozoa;Choanozoa;Metazoa;Animalia;BCP clade;Bilateria;Protostomia;Ecdysozoa;Arthropoda;Hexapoda;Insecta;Pterygota;Palaeoptera;";"0.0";"0";"162";"161";"0";"161";"1";"457022";"373894"
"V4mis1";"SILVA (only NR);Eukaryota;Amorphea;Obazoa;Opisthokonta;Holozoa;Choanozoa;Metazoa;Animalia;BCP clade;Bilateria;Protostomia;Ecdysozoa;Arthropoda;Hexapoda;Insecta;Pterygota;Palaeoptera;Ephemeroptera;";"0.0";"0";"115";"114";"0";"114";"1";"457069";"373894"
"V4mis1";"SILVA (only NR);Eukaryota;Amorphea;Obazoa;Opisthokonta;Holozoa;Choanozoa;Metazoa;Animalia;BCP clade;Bilateria;Protostomia;Ecdysozoa;Arthropoda;Hexapoda;Insecta;Pterygota;Palaeoptera;Odonata;";"0.0";"0";"47";"47";"0";"47";"0";"457136";"373894"
"V4mis1";"SILVA (only NR);Eukaryota;Amorphea;Obazoa;Opisthokonta;Holozoa;Choanozoa;Metazoa;Animalia;BCP clade;Bilateria;Protostomia;Ecdysozoa;Arthropoda;Hexapoda;Insecta;Thysanura;";"0.0";"0";"5";"5";"0";"5";"0";"457178";"373894"
"V4mis1";"SILVA (only NR);Eukaryota;Amorphea;Obazoa;Opisthokonta;Holozoa;Choanozoa;Metazoa;Animalia;BCP clade;Bilateria;Protostomia;Ecdysozoa;Arthropoda;Hexapoda;Insecta;Thysanura;Nicoletiidae;";"0.0";"0";"5";"5";"0";"5";"0";"457178";"373894"
"V4mis1";"SILVA (only NR);Eukaryota;Amorphea;Obazoa;Opisthokonta;Holozoa;Choanozoa;Metazoa;Animalia;BCP clade;Bilateria;Protostomia;Ecdysozoa;Arthropoda;Hexapoda;Insecta;Zygentoma;";"0.0";"0";"8";"8";"0";"8";"0";"457175";"373894"
"V4mis1";"SILVA (only NR);Eukaryota;Amorphea;Obazoa;Opisthokonta;Holozoa;Choanozoa;Metazoa;Animalia;BCP clade;Bilateria;Protostomia;Ecdysozoa;Arthropoda;Hexapoda;Insecta;Zygentoma;Lepismatidae;";"0.0";"0";"8";"8";"0";"8";"0";"457175";"373894"
"V4mis1";"SILVA (only NR);Eukaryota;Amorphea;Obazoa;Opisthokonta;Holozoa;Choanozoa;Metazoa;Animalia;BCP clade;Bilateria;Protostomia;Ecdysozoa;Arthropoda;Hexapoda;Insecta;Zygentoma;Lepismatidae;Lepisma;";"0.0";"0";"2";"2";"0";"2";"0";"457181";"373894"
"V4mis1";"SILVA (only NR);Eukaryota;Amorphea;Obazoa;Opisthokonta;Holozoa;Choanozoa;Metazoa;Animalia;BCP clade;Bilateria;Protostomia;Ecdysozoa;Arthropoda;Myriapoda;";"0.0";"0";"211";"211";"0";"211";"0";"456972";"373894"
"V4mis1";"SILVA (only NR);Eukaryota;Amorphea;Obazoa;Opisthokonta;Holozoa;Choanozoa;Metazoa;Animalia;BCP clade;Bilateria;Protostomia;Ecdysozoa;Arthropoda;Myriapoda;Chilopoda;";"0.0";"0";"126";"126";"0";"126";"0";"457057";"373894"
"V4mis1";"SILVA (only NR);Eukaryota;Amorphea;Obazoa;Opisthokonta;Holozoa;Choanozoa;Metazoa;Animalia;BCP clade;Bilateria;Protostomia;Ecdysozoa;Arthropoda;Myriapoda;Chilopoda;Notostigmophora;";"0.0";"0";"5";"5";"0";"5";"0";"457178";"373894"
"V4mis1";"SILVA (only NR);Eukaryota;Amorphea;Obazoa;Opisthokonta;Holozoa;Choanozoa;Metazoa;Animalia;BCP clade;Bilateria;Protostomia;Ecdysozoa;Arthropoda;Myriapoda;Chilopoda;Pleurostigmophora;";"0.0";"0";"120";"120";"0";"120";"0";"457063";"373894"
"V4mis1";"SILVA (only NR);Eukaryota;Amorphea;Obazoa;Opisthokonta;Holozoa;Choanozoa;Metazoa;Animalia;BCP clade;Bilateria;Protostomia;Ecdysozoa;Arthropoda;Myriapoda;Diplopoda;";"0.0";"0";"85";"85";"0";"85";"0";"457098";"373894"
"V4mis1";"SILVA (only NR);Eukaryota;Amorphea;Obazoa;Opisthokonta;Holozoa;Choanozoa;Metazoa;Animalia;BCP clade;Bilateria;Protostomia;Ecdysozoa;Arthropoda;Myriapoda;Diplopoda;Helminthomorpha;";"0.0";"0";"75";"75";"0";"75";"0";"457108";"373894"
"V4mis1";"SILVA (only NR);Eukaryota;Amorphea;Obazoa;Opisthokonta;Holozoa;Choanozoa;Metazoa;Animalia;BCP clade;Bilateria;Protostomia;Ecdysozoa;Arthropoda;Myriapoda;Diplopoda;Penicillata;";"0.0";"0";"8";"8";"0";"8";"0";"457175";"373894"
"V4mis1";"SILVA (only NR);Eukaryota;Amorphea;Obazoa;Opisthokonta;Holozoa;Choanozoa;Metazoa;Animalia;BCP clade;Bilateria;Protostomia;Ecdysozoa;Incertae Sedis;";"0.0";"0";"3";"3";"0";"3";"0";"457180";"373894"
"V4mis1";"SILVA (only NR);Eukaryota;Amorphea;Obazoa;Opisthokonta;Holozoa;Choanozoa;Metazoa;Animalia;BCP clade;Bilateria;Protostomia;Ecdysozoa;Nematozoa;";"0.2";"17.8";"2184";"2176";"5";"2171";"8";"455007";"373889"
"V4mis1";"SILVA (only NR);Eukaryota;Amorphea;Obazoa;Opisthokonta;Holozoa;Choanozoa;Metazoa;Animalia;BCP clade;Bilateria;Protostomia;Ecdysozoa;Nematozoa;Nematoda;";"0.2";"17.8";"2170";"2162";"5";"2157";"8";"455021";"373889"
"V4mis1";"SILVA (only NR);Eukaryota;Amorphea;Obazoa;Opisthokonta;Holozoa;Choanozoa;Metazoa;Animalia;BCP clade;Bilateria;Protostomia;Ecdysozoa;Nematozoa;Nematoda;Chromadorea;";"0.3";"18";"1443";"1442";"5";"1437";"1";"455741";"373889"
"V4mis1";"SILVA (only NR);Eukaryota;Amorphea;Obazoa;Opisthokonta;Holozoa;Choanozoa;Metazoa;Animalia;BCP clade;Bilateria;Protostomia;Ecdysozoa;Nematozoa;Nematoda;Chromadorea;Araeolaimida;";"0.0";"0";"55";"55";"0";"55";"0";"457128";"373894"
"V4mis1";"SILVA (only NR);Eukaryota;Amorphea;Obazoa;Opisthokonta;Holozoa;Choanozoa;Metazoa;Animalia;BCP clade;Bilateria;Protostomia;Ecdysozoa;Nematozoa;Nematoda;Chromadorea;Ascaridida;";"0.0";"0";"47";"47";"0";"47";"0";"457136";"373894"
"V4mis1";"SILVA (only NR);Eukaryota;Amorphea;Obazoa;Opisthokonta;Holozoa;Choanozoa;Metazoa;Animalia;BCP clade;Bilateria;Protostomia;Ecdysozoa;Nematozoa;Nematoda;Chromadorea;Chromadorida;";"0.0";"0";"39";"39";"0";"39";"0";"457144";"373894"
"V4mis1";"SILVA (only NR);Eukaryota;Amorphea;Obazoa;Opisthokonta;Holozoa;Choanozoa;Metazoa;Animalia;BCP clade;Bilateria;Protostomia;Ecdysozoa;Nematozoa;Nematoda;Chromadorea;Desmodorida;";"0.0";"0";"74";"74";"0";"74";"0";"457109";"373894"
"V4mis1";"SILVA (only NR);Eukaryota;Amorphea;Obazoa;Opisthokonta;Holozoa;Choanozoa;Metazoa;Animalia;BCP clade;Bilateria;Protostomia;Ecdysozoa;Nematozoa;Nematoda;Chromadorea;Desmoscolecida;";"0.0";"0";"2";"2";"0";"2";"0";"457181";"373894"
"V4mis1";"SILVA (only NR);Eukaryota;Amorphea;Obazoa;Opisthokonta;Holozoa;Choanozoa;Metazoa;Animalia;BCP clade;Bilateria;Protostomia;Ecdysozoa;Nematozoa;Nematoda;Chromadorea;Diplogasterida;";"0.0";"0";"107";"107";"0";"107";"0";"457076";"373894"
"V4mis1";"SILVA (only NR);Eukaryota;Amorphea;Obazoa;Opisthokonta;Holozoa;Choanozoa;Metazoa;Animalia;BCP clade;Bilateria;Protostomia;Ecdysozoa;Nematozoa;Nematoda;Chromadorea;Monhysterida;";"0.0";"0";"89";"89";"0";"89";"0";"457094";"373894"
"V4mis1";"SILVA (only NR);Eukaryota;Amorphea;Obazoa;Opisthokonta;Holozoa;Choanozoa;Metazoa;Animalia;BCP clade;Bilateria;Protostomia;Ecdysozoa;Nematozoa;Nematoda;Chromadorea;Oxyurida;";"0.0";"0";"30";"30";"0";"30";"0";"457153";"373894"
"V4mis1";"SILVA (only NR);Eukaryota;Amorphea;Obazoa;Opisthokonta;Holozoa;Choanozoa;Metazoa;Animalia;BCP clade;Bilateria;Protostomia;Ecdysozoa;Nematozoa;Nematoda;Chromadorea;Rhabditida;";"0.0";"0";"297";"297";"0";"297";"0";"456886";"373894"
"V4mis1";"SILVA (only NR);Eukaryota;Amorphea;Obazoa;Opisthokonta;Holozoa;Choanozoa;Metazoa;Animalia;BCP clade;Bilateria;Protostomia;Ecdysozoa;Nematozoa;Nematoda;Chromadorea;Rhigonematida;";"0.0";"0";"10";"10";"0";"10";"0";"457173";"373894"
"V4mis1";"SILVA (only NR);Eukaryota;Amorphea;Obazoa;Opisthokonta;Holozoa;Choanozoa;Metazoa;Animalia;BCP clade;Bilateria;Protostomia;Ecdysozoa;Nematozoa;Nematoda;Chromadorea;Spirurida;";"0.0";"0";"116";"115";"0";"115";"1";"457068";"373894"
"V4mis1";"SILVA (only NR);Eukaryota;Amorphea;Obazoa;Opisthokonta;Holozoa;Choanozoa;Metazoa;Animalia;BCP clade;Bilateria;Protostomia;Ecdysozoa;Nematozoa;Nematoda;Chromadorea;Tylenchida;";"0.9";"18.1";"565";"565";"5";"560";"0";"456618";"373889"
"V4mis1";"SILVA (only NR);Eukaryota;Amorphea;Obazoa;Opisthokonta;Holozoa;Choanozoa;Metazoa;Animalia;BCP clade;Bilateria;Protostomia;Ecdysozoa;Nematozoa;Nematoda;Chromadorea;Tylenchida;Anomyctus;";"0.0";"0";"1";"1";"0";"1";"0";"457182";"373894"
"V4mis1";"SILVA (only NR);Eukaryota;Amorphea;Obazoa;Opisthokonta;Holozoa;Choanozoa;Metazoa;Animalia;BCP clade;Bilateria;Protostomia;Ecdysozoa;Nematozoa;Nematoda;Chromadorea;Tylenchida;Aphelenchoides;";"0.0";"0";"40";"40";"0";"40";"0";"457143";"373894"
"V4mis1";"SILVA (only NR);Eukaryota;Amorphea;Obazoa;Opisthokonta;Holozoa;Choanozoa;Metazoa;Animalia;BCP clade;Bilateria;Protostomia;Ecdysozoa;Nematozoa;Nematoda;Chromadorea;Tylenchida;Basilaphelenchus;";"0.0";"0";"1";"1";"0";"1";"0";"457182";"373894"
"V4mis1";"SILVA (only NR);Eukaryota;Amorphea;Obazoa;Opisthokonta;Holozoa;Choanozoa;Metazoa;Animalia;BCP clade;Bilateria;Protostomia;Ecdysozoa;Nematozoa;Nematoda;Chromadorea;Tylenchida;Bursaphelenchus;";"0.0";"0";"59";"59";"0";"59";"0";"457124";"373894"
"V4mis1";"SILVA (only NR);Eukaryota;Amorphea;Obazoa;Opisthokonta;Holozoa;Choanozoa;Metazoa;Animalia;BCP clade;Bilateria;Protostomia;Ecdysozoa;Nematozoa;Nematoda;Chromadorea;Tylenchida;Cryptaphelenchus;";"0.0";"0";"2";"2";"0";"2";"0";"457181";"373894"
"V4mis1";"SILVA (only NR);Eukaryota;Amorphea;Obazoa;Opisthokonta;Holozoa;Choanozoa;Metazoa;Animalia;BCP clade;Bilateria;Protostomia;Ecdysozoa;Nematozoa;Nematoda;Chromadorea;Tylenchida;Ektaphelenchoides;";"0.0";"0";"1";"1";"0";"1";"0";"457182";"373894"
"V4mis1";"SILVA (only NR);Eukaryota;Amorphea;Obazoa;Opisthokonta;Holozoa;Choanozoa;Metazoa;Animalia;BCP clade;Bilateria;Protostomia;Ecdysozoa;Nematozoa;Nematoda;Chromadorea;Tylenchida;Ektaphelenchus;";"0.0";"0";"2";"2";"0";"2";"0";"457181";"373894"
"V4mis1";"SILVA (only NR);Eukaryota;Amorphea;Obazoa;Opisthokonta;Holozoa;Choanozoa;Metazoa;Animalia;BCP clade;Bilateria;Protostomia;Ecdysozoa;Nematozoa;Nematoda;Chromadorea;Tylenchida;Laimaphelenchus;";"0.0";"0";"15";"15";"0";"15";"0";"457168";"373894"
"V4mis1";"SILVA (only NR);Eukaryota;Amorphea;Obazoa;Opisthokonta;Holozoa;Choanozoa;Metazoa;Animalia;BCP clade;Bilateria;Protostomia;Ecdysozoa;Nematozoa;Nematoda;Chromadorea;Tylenchida;Noctuidonema;";"0.0";"0";"1";"1";"0";"1";"0";"457182";"373894"
"V4mis1";"SILVA (only NR);Eukaryota;Amorphea;Obazoa;Opisthokonta;Holozoa;Choanozoa;Metazoa;Animalia;BCP clade;Bilateria;Protostomia;Ecdysozoa;Nematozoa;Nematoda;Chromadorea;Tylenchida;Peraphelenchus;";"0.0";"0";"1";"1";"0";"1";"0";"457182";"373894"
"V4mis1";"SILVA (only NR);Eukaryota;Amorphea;Obazoa;Opisthokonta;Holozoa;Choanozoa;Metazoa;Animalia;BCP clade;Bilateria;Protostomia;Ecdysozoa;Nematozoa;Nematoda;Chromadorea;Tylenchida;Pseudaphelenchus;";"0.0";"0";"4";"4";"0";"4";"0";"457179";"373894"
"V4mis1";"SILVA (only NR);Eukaryota;Amorphea;Obazoa;Opisthokonta;Holozoa;Choanozoa;Metazoa;Animalia;BCP clade;Bilateria;Protostomia;Ecdysozoa;Nematozoa;Nematoda;Chromadorea;Tylenchida;Robustodorus;";"0.0";"0";"3";"3";"0";"3";"0";"457180";"373894"
"V4mis1";"SILVA (only NR);Eukaryota;Amorphea;Obazoa;Opisthokonta;Holozoa;Choanozoa;Metazoa;Animalia;BCP clade;Bilateria;Protostomia;Ecdysozoa;Nematozoa;Nematoda;Chromadorea;Tylenchida;Ruehmaphelenchus;";"0.0";"0";"4";"4";"0";"4";"0";"457179";"373894"
"V4mis1";"SILVA (only NR);Eukaryota;Amorphea;Obazoa;Opisthokonta;Holozoa;Choanozoa;Metazoa;Animalia;BCP clade;Bilateria;Protostomia;Ecdysozoa;Nematozoa;Nematoda;Chromadorea;Tylenchida;Schistonchus;";"0.0";"0";"22";"22";"0";"22";"0";"457161";"373894"
"V4mis1";"SILVA (only NR);Eukaryota;Amorphea;Obazoa;Opisthokonta;Holozoa;Choanozoa;Metazoa;Animalia;BCP clade;Bilateria;Protostomia;Ecdysozoa;Nematozoa;Nematoda;Chromadorea;Tylenchida;Tylaphelenchus;";"0.0";"0";"1";"1";"0";"1";"0";"457182";"373894"
"V4mis1";"SILVA (only NR);Eukaryota;Amorphea;Obazoa;Opisthokonta;Holozoa;Choanozoa;Metazoa;Animalia;BCP clade;Bilateria;Protostomia;Ecdysozoa;Nematozoa;Nematoda;Enoplea;";"0.0";"0";"727";"720";"0";"720";"7";"456463";"373894"
"V4mis1";"SILVA (only NR);Eukaryota;Amorphea;Obazoa;Opisthokonta;Holozoa;Choanozoa;Metazoa;Animalia;BCP clade;Bilateria;Protostomia;Ecdysozoa;Nematozoa;Nematoda;Enoplea;Dorylaimia;";"0.0";"0";"445";"439";"0";"439";"6";"456744";"373894"
"V4mis1";"SILVA (only NR);Eukaryota;Amorphea;Obazoa;Opisthokonta;Holozoa;Choanozoa;Metazoa;Animalia;BCP clade;Bilateria;Protostomia;Ecdysozoa;Nematozoa;Nematoda;Enoplea;Dorylaimia;Dioctophymatoidea;";"0.0";"0";"2";"2";"0";"2";"0";"457181";"373894"
"V4mis1";"SILVA (only NR);Eukaryota;Amorphea;Obazoa;Opisthokonta;Holozoa;Choanozoa;Metazoa;Animalia;BCP clade;Bilateria;Protostomia;Ecdysozoa;Nematozoa;Nematoda;Enoplea;Dorylaimia;Dorylaimida;";"0.0";"0";"147";"147";"0";"147";"0";"457036";"373894"
"V4mis1";"SILVA (only NR);Eukaryota;Amorphea;Obazoa;Opisthokonta;Holozoa;Choanozoa;Metazoa;Animalia;BCP clade;Bilateria;Protostomia;Ecdysozoa;Nematozoa;Nematoda;Enoplea;Dorylaimia;Mermithida;";"0.0";"0";"19";"19";"0";"19";"0";"457164";"373894"
"V4mis1";"SILVA (only NR);Eukaryota;Amorphea;Obazoa;Opisthokonta;Holozoa;Choanozoa;Metazoa;Animalia;BCP clade;Bilateria;Protostomia;Ecdysozoa;Nematozoa;Nematoda;Enoplea;Dorylaimia;Mononchida;";"0.0";"0";"30";"30";"0";"30";"0";"457153";"373894"
"V4mis1";"SILVA (only NR);Eukaryota;Amorphea;Obazoa;Opisthokonta;Holozoa;Choanozoa;Metazoa;Animalia;BCP clade;Bilateria;Protostomia;Ecdysozoa;Nematozoa;Nematoda;Enoplea;Dorylaimia;Trichocephalida;";"0.0";"0";"242";"236";"0";"236";"6";"456947";"373894"
"V4mis1";"SILVA (only NR);Eukaryota;Amorphea;Obazoa;Opisthokonta;Holozoa;Choanozoa;Metazoa;Animalia;BCP clade;Bilateria;Protostomia;Ecdysozoa;Nematozoa;Nematoda;Enoplea;Enoplia;";"0.0";"0";"282";"281";"0";"281";"1";"456902";"373894"
"V4mis1";"SILVA (only NR);Eukaryota;Amorphea;Obazoa;Opisthokonta;Holozoa;Choanozoa;Metazoa;Animalia;BCP clade;Bilateria;Protostomia;Ecdysozoa;Nematozoa;Nematoda;Enoplea;Enoplia;Enoplida;";"0.0";"0";"182";"182";"0";"182";"0";"457001";"373894"
"V4mis1";"SILVA (only NR);Eukaryota;Amorphea;Obazoa;Opisthokonta;Holozoa;Choanozoa;Metazoa;Animalia;BCP clade;Bilateria;Protostomia;Ecdysozoa;Nematozoa;Nematoda;Enoplea;Enoplia;Triplonchida;";"0.0";"0";"98";"97";"0";"97";"1";"457086";"373894"
"V4mis1";"SILVA (only NR);Eukaryota;Amorphea;Obazoa;Opisthokonta;Holozoa;Choanozoa;Metazoa;Animalia;BCP clade;Bilateria;Protostomia;Ecdysozoa;Nematozoa;Nematomorpha;";"0.0";"0";"14";"14";"0";"14";"0";"457169";"373894"
"V4mis1";"SILVA (only NR);Eukaryota;Amorphea;Obazoa;Opisthokonta;Holozoa;Choanozoa;Metazoa;Animalia;BCP clade;Bilateria;Protostomia;Ecdysozoa;Nematozoa;Nematomorpha;Gordioida;";"0.0";"0";"13";"13";"0";"13";"0";"457170";"373894"
"V4mis1";"SILVA (only NR);Eukaryota;Amorphea;Obazoa;Opisthokonta;Holozoa;Choanozoa;Metazoa;Animalia;BCP clade;Bilateria;Protostomia;Ecdysozoa;Nematozoa;Nematomorpha;Gordioida;Chordodea;";"0.0";"0";"6";"6";"0";"6";"0";"457177";"373894"
"V4mis1";"SILVA (only NR);Eukaryota;Amorphea;Obazoa;Opisthokonta;Holozoa;Choanozoa;Metazoa;Animalia;BCP clade;Bilateria;Protostomia;Ecdysozoa;Nematozoa;Nematomorpha;Gordioida;Gordea;";"0.0";"0";"7";"7";"0";"7";"0";"457176";"373894"
"V4mis1";"SILVA (only NR);Eukaryota;Amorphea;Obazoa;Opisthokonta;Holozoa;Choanozoa;Metazoa;Animalia;BCP clade;Bilateria;Protostomia;Ecdysozoa;Onychophora;";"0.0";"0";"23";"23";"0";"23";"0";"457160";"373894"
"V4mis1";"SILVA (only NR);Eukaryota;Amorphea;Obazoa;Opisthokonta;Holozoa;Choanozoa;Metazoa;Animalia;BCP clade;Bilateria;Protostomia;Ecdysozoa;Onychophora;Udeonycophora;";"0.0";"0";"23";"23";"0";"23";"0";"457160";"373894"
"V4mis1";"SILVA (only NR);Eukaryota;Amorphea;Obazoa;Opisthokonta;Holozoa;Choanozoa;Metazoa;Animalia;BCP clade;Bilateria;Protostomia;Ecdysozoa;Onychophora;Udeonycophora;Euonycophora;";"0.0";"0";"23";"23";"0";"23";"0";"457160";"373894"
"V4mis1";"SILVA (only NR);Eukaryota;Amorphea;Obazoa;Opisthokonta;Holozoa;Choanozoa;Metazoa;Animalia;BCP clade;Bilateria;Protostomia;Ecdysozoa;Onychophora;Udeonycophora;Euonycophora;Peripatopsidae;";"0.0";"0";"23";"23";"0";"23";"0";"457160";"373894"
"V4mis1";"SILVA (only NR);Eukaryota;Amorphea;Obazoa;Opisthokonta;Holozoa;Choanozoa;Metazoa;Animalia;BCP clade;Bilateria;Protostomia;Ecdysozoa;Scalidophora;";"0.0";"0";"52";"52";"0";"52";"0";"457131";"373894"
"V4mis1";"SILVA (only NR);Eukaryota;Amorphea;Obazoa;Opisthokonta;Holozoa;Choanozoa;Metazoa;Animalia;BCP clade;Bilateria;Protostomia;Ecdysozoa;Scalidophora;Kinorhyncha;";"0.0";"0";"42";"42";"0";"42";"0";"457141";"373894"
"V4mis1";"SILVA (only NR);Eukaryota;Amorphea;Obazoa;Opisthokonta;Holozoa;Choanozoa;Metazoa;Animalia;BCP clade;Bilateria;Protostomia;Ecdysozoa;Scalidophora;Kinorhyncha;Cyclorhagida;";"0.0";"0";"26";"26";"0";"26";"0";"457157";"373894"
"V4mis1";"SILVA (only NR);Eukaryota;Amorphea;Obazoa;Opisthokonta;Holozoa;Choanozoa;Metazoa;Animalia;BCP clade;Bilateria;Protostomia;Ecdysozoa;Scalidophora;Kinorhyncha;Homalorhagida;";"0.0";"0";"14";"14";"0";"14";"0";"457169";"373894"
"V4mis1";"SILVA (only NR);Eukaryota;Amorphea;Obazoa;Opisthokonta;Holozoa;Choanozoa;Metazoa;Animalia;BCP clade;Bilateria;Protostomia;Ecdysozoa;Scalidophora;Kinorhyncha;Kinorhyncha Incertae Sedis;";"0.0";"0";"2";"2";"0";"2";"0";"457181";"373894"
"V4mis1";"SILVA (only NR);Eukaryota;Amorphea;Obazoa;Opisthokonta;Holozoa;Choanozoa;Metazoa;Animalia;BCP clade;Bilateria;Protostomia;Ecdysozoa;Scalidophora;Loricifera;";"0.0";"0";"2";"2";"0";"2";"0";"457181";"373894"
"V4mis1";"SILVA (only NR);Eukaryota;Amorphea;Obazoa;Opisthokonta;Holozoa;Choanozoa;Metazoa;Animalia;BCP clade;Bilateria;Protostomia;Ecdysozoa;Scalidophora;Priapulida;";"0.0";"0";"8";"8";"0";"8";"0";"457175";"373894"
"V4mis1";"SILVA (only NR);Eukaryota;Amorphea;Obazoa;Opisthokonta;Holozoa;Choanozoa;Metazoa;Animalia;BCP clade;Bilateria;Protostomia;Ecdysozoa;Scalidophora;Priapulida;Priapulidae;";"0.0";"0";"4";"4";"0";"4";"0";"457179";"373894"
"V4mis1";"SILVA (only NR);Eukaryota;Amorphea;Obazoa;Opisthokonta;Holozoa;Choanozoa;Metazoa;Animalia;BCP clade;Bilateria;Protostomia;Ecdysozoa;Scalidophora;Priapulida;Tubiluchidae;";"0.0";"0";"4";"4";"0";"4";"0";"457179";"373894"
"V4mis1";"SILVA (only NR);Eukaryota;Amorphea;Obazoa;Opisthokonta;Holozoa;Choanozoa;Metazoa;Animalia;BCP clade;Bilateria;Protostomia;Ecdysozoa;Tardigrada;";"0.0";"0";"108";"104";"0";"104";"4";"457079";"373894"
"V4mis1";"SILVA (only NR);Eukaryota;Amorphea;Obazoa;Opisthokonta;Holozoa;Choanozoa;Metazoa;Animalia;BCP clade;Bilateria;Protostomia;Ecdysozoa;Tardigrada;Eutardigrada;";"0.0";"0";"78";"77";"0";"77";"1";"457106";"373894"
"V4mis1";"SILVA (only NR);Eukaryota;Amorphea;Obazoa;Opisthokonta;Holozoa;Choanozoa;Metazoa;Animalia;BCP clade;Bilateria;Protostomia;Ecdysozoa;Tardigrada;Eutardigrada;Apochela;";"0.0";"0";"7";"7";"0";"7";"0";"457176";"373894"
"V4mis1";"SILVA (only NR);Eukaryota;Amorphea;Obazoa;Opisthokonta;Holozoa;Choanozoa;Metazoa;Animalia;BCP clade;Bilateria;Protostomia;Ecdysozoa;Tardigrada;Eutardigrada;Parachaela;";"0.0";"0";"71";"70";"0";"70";"1";"457113";"373894"
"V4mis1";"SILVA (only NR);Eukaryota;Amorphea;Obazoa;Opisthokonta;Holozoa;Choanozoa;Metazoa;Animalia;BCP clade;Bilateria;Protostomia;Ecdysozoa;Tardigrada;Heterotardigrada;";"0.0";"0";"30";"27";"0";"27";"3";"457156";"373894"
"V4mis1";"SILVA (only NR);Eukaryota;Amorphea;Obazoa;Opisthokonta;Holozoa;Choanozoa;Metazoa;Animalia;BCP clade;Bilateria;Protostomia;Ecdysozoa;Tardigrada;Heterotardigrada;Echiniscoidea;";"0.0";"0";"29";"27";"0";"27";"2";"457156";"373894"
"V4mis1";"SILVA (only NR);Eukaryota;Amorphea;Obazoa;Opisthokonta;Holozoa;Choanozoa;Metazoa;Animalia;BCP clade;Bilateria;Protostomia;Lophotrochozoa;";"0.1";"17.3";"5194";"5162";"6";"5156";"32";"452021";"373888"
"V4mis1";"SILVA (only NR);Eukaryota;Amorphea;Obazoa;Opisthokonta;Holozoa;Choanozoa;Metazoa;Animalia;BCP clade;Bilateria;Protostomia;Lophotrochozoa;Acanthocephala;";"0.0";"0";"66";"66";"0";"66";"0";"457117";"373894"
"V4mis1";"SILVA (only NR);Eukaryota;Amorphea;Obazoa;Opisthokonta;Holozoa;Choanozoa;Metazoa;Animalia;BCP clade;Bilateria;Protostomia;Lophotrochozoa;Acanthocephala;Archiacanthocephala;";"0.0";"0";"7";"7";"0";"7";"0";"457176";"373894"
"V4mis1";"SILVA (only NR);Eukaryota;Amorphea;Obazoa;Opisthokonta;Holozoa;Choanozoa;Metazoa;Animalia;BCP clade;Bilateria;Protostomia;Lophotrochozoa;Acanthocephala;Archiacanthocephala;Gigantorhynchida;";"0.0";"0";"2";"2";"0";"2";"0";"457181";"373894"
"V4mis1";"SILVA (only NR);Eukaryota;Amorphea;Obazoa;Opisthokonta;Holozoa;Choanozoa;Metazoa;Animalia;BCP clade;Bilateria;Protostomia;Lophotrochozoa;Acanthocephala;Archiacanthocephala;Oligacanthorhynchida;";"0.0";"0";"4";"4";"0";"4";"0";"457179";"373894"
"V4mis1";"SILVA (only NR);Eukaryota;Amorphea;Obazoa;Opisthokonta;Holozoa;Choanozoa;Metazoa;Animalia;BCP clade;Bilateria;Protostomia;Lophotrochozoa;Acanthocephala;Eoacanthocephala;";"0.0";"0";"10";"10";"0";"10";"0";"457173";"373894"
"V4mis1";"SILVA (only NR);Eukaryota;Amorphea;Obazoa;Opisthokonta;Holozoa;Choanozoa;Metazoa;Animalia;BCP clade;Bilateria;Protostomia;Lophotrochozoa;Acanthocephala;Eoacanthocephala;Neoechinorhynchida;";"0.0";"0";"10";"10";"0";"10";"0";"457173";"373894"
"V4mis1";"SILVA (only NR);Eukaryota;Amorphea;Obazoa;Opisthokonta;Holozoa;Choanozoa;Metazoa;Animalia;BCP clade;Bilateria;Protostomia;Lophotrochozoa;Acanthocephala;Palaeacanthocephala;";"0.0";"0";"49";"49";"0";"49";"0";"457134";"373894"
"V4mis1";"SILVA (only NR);Eukaryota;Amorphea;Obazoa;Opisthokonta;Holozoa;Choanozoa;Metazoa;Animalia;BCP clade;Bilateria;Protostomia;Lophotrochozoa;Acanthocephala;Palaeacanthocephala;Echinorhynchida;";"0.0";"0";"24";"24";"0";"24";"0";"457159";"373894"
"V4mis1";"SILVA (only NR);Eukaryota;Amorphea;Obazoa;Opisthokonta;Holozoa;Choanozoa;Metazoa;Animalia;BCP clade;Bilateria;Protostomia;Lophotrochozoa;Acanthocephala;Palaeacanthocephala;Polymorphida;";"0.0";"0";"25";"25";"0";"25";"0";"457158";"373894"
"V4mis1";"SILVA (only NR);Eukaryota;Amorphea;Obazoa;Opisthokonta;Holozoa;Choanozoa;Metazoa;Animalia;BCP clade;Bilateria;Protostomia;Lophotrochozoa;Annelida;";"0.0";"0";"1328";"1321";"0";"1321";"7";"455862";"373894"
"V4mis1";"SILVA (only NR);Eukaryota;Amorphea;Obazoa;Opisthokonta;Holozoa;Choanozoa;Metazoa;Animalia;BCP clade;Bilateria;Protostomia;Lophotrochozoa;Annelida;Annelida Incertae Sedis;";"0.0";"0";"2";"2";"0";"2";"0";"457181";"373894"
"V4mis1";"SILVA (only NR);Eukaryota;Amorphea;Obazoa;Opisthokonta;Holozoa;Choanozoa;Metazoa;Animalia;BCP clade;Bilateria;Protostomia;Lophotrochozoa;Annelida;Annelida Incertae Sedis;Fauvelopsis;";"0.0";"0";"1";"1";"0";"1";"0";"457182";"373894"
"V4mis1";"SILVA (only NR);Eukaryota;Amorphea;Obazoa;Opisthokonta;Holozoa;Choanozoa;Metazoa;Animalia;BCP clade;Bilateria;Protostomia;Lophotrochozoa;Annelida;Annelida Incertae Sedis;Hrabeiella;";"0.0";"0";"1";"1";"0";"1";"0";"457182";"373894"
"V4mis1";"SILVA (only NR);Eukaryota;Amorphea;Obazoa;Opisthokonta;Holozoa;Choanozoa;Metazoa;Animalia;BCP clade;Bilateria;Protostomia;Lophotrochozoa;Annelida;Clitellata;";"0.0";"0";"290";"290";"0";"290";"0";"456893";"373894"
"V4mis1";"SILVA (only NR);Eukaryota;Amorphea;Obazoa;Opisthokonta;Holozoa;Choanozoa;Metazoa;Animalia;BCP clade;Bilateria;Protostomia;Lophotrochozoa;Annelida;Clitellata;Branchiobdellae;";"0.0";"0";"11";"11";"0";"11";"0";"457172";"373894"
"V4mis1";"SILVA (only NR);Eukaryota;Amorphea;Obazoa;Opisthokonta;Holozoa;Choanozoa;Metazoa;Animalia;BCP clade;Bilateria;Protostomia;Lophotrochozoa;Annelida;Clitellata;Branchiobdellae;Branchiobdellida;";"0.0";"0";"11";"11";"0";"11";"0";"457172";"373894"
"V4mis1";"SILVA (only NR);Eukaryota;Amorphea;Obazoa;Opisthokonta;Holozoa;Choanozoa;Metazoa;Animalia;BCP clade;Bilateria;Protostomia;Lophotrochozoa;Annelida;Clitellata;Hirudinida;";"0.0";"0";"106";"106";"0";"106";"0";"457077";"373894"
"V4mis1";"SILVA (only NR);Eukaryota;Amorphea;Obazoa;Opisthokonta;Holozoa;Choanozoa;Metazoa;Animalia;BCP clade;Bilateria;Protostomia;Lophotrochozoa;Annelida;Clitellata;Hirudinida;Arhynchobdellida;";"0.0";"0";"77";"77";"0";"77";"0";"457106";"373894"
"V4mis1";"SILVA (only NR);Eukaryota;Amorphea;Obazoa;Opisthokonta;Holozoa;Choanozoa;Metazoa;Animalia;BCP clade;Bilateria;Protostomia;Lophotrochozoa;Annelida;Clitellata;Hirudinida;Rhynchobdellida;";"0.0";"0";"28";"28";"0";"28";"0";"457155";"373894"
"V4mis1";"SILVA (only NR);Eukaryota;Amorphea;Obazoa;Opisthokonta;Holozoa;Choanozoa;Metazoa;Animalia;BCP clade;Bilateria;Protostomia;Lophotrochozoa;Annelida;Clitellata;Oligochaeta;";"0.0";"0";"173";"173";"0";"173";"0";"457010";"373894"
"V4mis1";"SILVA (only NR);Eukaryota;Amorphea;Obazoa;Opisthokonta;Holozoa;Choanozoa;Metazoa;Animalia;BCP clade;Bilateria;Protostomia;Lophotrochozoa;Annelida;Clitellata;Oligochaeta;Haplotaxida;";"0.0";"0";"165";"165";"0";"165";"0";"457018";"373894"
"V4mis1";"SILVA (only NR);Eukaryota;Amorphea;Obazoa;Opisthokonta;Holozoa;Choanozoa;Metazoa;Animalia;BCP clade;Bilateria;Protostomia;Lophotrochozoa;Annelida;Clitellata;Oligochaeta;Lumbriculida;";"0.0";"0";"3";"3";"0";"3";"0";"457180";"373894"
"V4mis1";"SILVA (only NR);Eukaryota;Amorphea;Obazoa;Opisthokonta;Holozoa;Choanozoa;Metazoa;Animalia;BCP clade;Bilateria;Protostomia;Lophotrochozoa;Annelida;Clitellata;Oligochaeta;Moniligastrida;";"0.0";"0";"4";"4";"0";"4";"0";"457179";"373894"
"V4mis1";"SILVA (only NR);Eukaryota;Amorphea;Obazoa;Opisthokonta;Holozoa;Choanozoa;Metazoa;Animalia;BCP clade;Bilateria;Protostomia;Lophotrochozoa;Annelida;Myzostomida;";"0.0";"0";"54";"54";"0";"54";"0";"457129";"373894"
"V4mis1";"SILVA (only NR);Eukaryota;Amorphea;Obazoa;Opisthokonta;Holozoa;Choanozoa;Metazoa;Animalia;BCP clade;Bilateria;Protostomia;Lophotrochozoa;Annelida;Myzostomida;Endomyzostomatidae;";"0.0";"0";"6";"6";"0";"6";"0";"457177";"373894"
"V4mis1";"SILVA (only NR);Eukaryota;Amorphea;Obazoa;Opisthokonta;Holozoa;Choanozoa;Metazoa;Animalia;BCP clade;Bilateria;Protostomia;Lophotrochozoa;Annelida;Myzostomida;Myzostomida Incertae Sedis;";"0.0";"0";"3";"3";"0";"3";"0";"457180";"373894"
"V4mis1";"SILVA (only NR);Eukaryota;Amorphea;Obazoa;Opisthokonta;Holozoa;Choanozoa;Metazoa;Animalia;BCP clade;Bilateria;Protostomia;Lophotrochozoa;Annelida;Myzostomida;Myzostomidae;";"0.0";"0";"43";"43";"0";"43";"0";"457140";"373894"
"V4mis1";"SILVA (only NR);Eukaryota;Amorphea;Obazoa;Opisthokonta;Holozoa;Choanozoa;Metazoa;Animalia;BCP clade;Bilateria;Protostomia;Lophotrochozoa;Annelida;Polychaeta;";"0.0";"0";"975";"968";"0";"968";"7";"456215";"373894"
"V4mis1";"SILVA (only NR);Eukaryota;Amorphea;Obazoa;Opisthokonta;Holozoa;Choanozoa;Metazoa;Animalia;BCP clade;Bilateria;Protostomia;Lophotrochozoa;Annelida;Polychaeta;Echiura;";"0.0";"0";"17";"17";"0";"17";"0";"457166";"373894"
"V4mis1";"SILVA (only NR);Eukaryota;Amorphea;Obazoa;Opisthokonta;Holozoa;Choanozoa;Metazoa;Animalia;BCP clade;Bilateria;Protostomia;Lophotrochozoa;Annelida;Polychaeta;Echiura;Echiuroinea;";"0.0";"0";"15";"15";"0";"15";"0";"457168";"373894"
"V4mis1";"SILVA (only NR);Eukaryota;Amorphea;Obazoa;Opisthokonta;Holozoa;Choanozoa;Metazoa;Animalia;BCP clade;Bilateria;Protostomia;Lophotrochozoa;Annelida;Polychaeta;Echiura;Xenopneusta;";"0.0";"0";"2";"2";"0";"2";"0";"457181";"373894"
"V4mis1";"SILVA (only NR);Eukaryota;Amorphea;Obazoa;Opisthokonta;Holozoa;Choanozoa;Metazoa;Animalia;BCP clade;Bilateria;Protostomia;Lophotrochozoa;Annelida;Polychaeta;Palpata;";"0.0";"0";"593";"586";"0";"586";"7";"456597";"373894"
"V4mis1";"SILVA (only NR);Eukaryota;Amorphea;Obazoa;Opisthokonta;Holozoa;Choanozoa;Metazoa;Animalia;BCP clade;Bilateria;Protostomia;Lophotrochozoa;Annelida;Polychaeta;Palpata;Eunicida;";"0.0";"0";"54";"54";"0";"54";"0";"457129";"373894"
"V4mis1";"SILVA (only NR);Eukaryota;Amorphea;Obazoa;Opisthokonta;Holozoa;Choanozoa;Metazoa;Animalia;BCP clade;Bilateria;Protostomia;Lophotrochozoa;Annelida;Polychaeta;Palpata;Flabelligerida;";"0.0";"0";"14";"14";"0";"14";"0";"457169";"373894"
"V4mis1";"SILVA (only NR);Eukaryota;Amorphea;Obazoa;Opisthokonta;Holozoa;Choanozoa;Metazoa;Animalia;BCP clade;Bilateria;Protostomia;Lophotrochozoa;Annelida;Polychaeta;Palpata;Palpata Incertae Sedis;";"0.0";"0";"27";"27";"0";"27";"0";"457156";"373894"
"V4mis1";"SILVA (only NR);Eukaryota;Amorphea;Obazoa;Opisthokonta;Holozoa;Choanozoa;Metazoa;Animalia;BCP clade;Bilateria;Protostomia;Lophotrochozoa;Annelida;Polychaeta;Palpata;Phyllodocida;";"0.0";"0";"353";"346";"0";"346";"7";"456837";"373894"
"V4mis1";"SILVA (only NR);Eukaryota;Amorphea;Obazoa;Opisthokonta;Holozoa;Choanozoa;Metazoa;Animalia;BCP clade;Bilateria;Protostomia;Lophotrochozoa;Annelida;Polychaeta;Palpata;Sabellida;";"0.0";"0";"144";"144";"0";"144";"0";"457039";"373894"
"V4mis1";"SILVA (only NR);Eukaryota;Amorphea;Obazoa;Opisthokonta;Holozoa;Choanozoa;Metazoa;Animalia;BCP clade;Bilateria;Protostomia;Lophotrochozoa;Annelida;Polychaeta;Protodrilidae;";"0.0";"0";"39";"39";"0";"39";"0";"457144";"373894"
"V4mis1";"SILVA (only NR);Eukaryota;Amorphea;Obazoa;Opisthokonta;Holozoa;Choanozoa;Metazoa;Animalia;BCP clade;Bilateria;Protostomia;Lophotrochozoa;Annelida;Polychaeta;Protodrilidae;Protodrilus;";"0.0";"0";"39";"39";"0";"39";"0";"457144";"373894"
"V4mis1";"SILVA (only NR);Eukaryota;Amorphea;Obazoa;Opisthokonta;Holozoa;Choanozoa;Metazoa;Animalia;BCP clade;Bilateria;Protostomia;Lophotrochozoa;Annelida;Polychaeta;Scolecida;";"0.0";"0";"290";"290";"0";"290";"0";"456893";"373894"
"V4mis1";"SILVA (only NR);Eukaryota;Amorphea;Obazoa;Opisthokonta;Holozoa;Choanozoa;Metazoa;Animalia;BCP clade;Bilateria;Protostomia;Lophotrochozoa;Annelida;Polychaeta;Scolecida;Capitellida;";"0.0";"0";"56";"56";"0";"56";"0";"457127";"373894"
"V4mis1";"SILVA (only NR);Eukaryota;Amorphea;Obazoa;Opisthokonta;Holozoa;Choanozoa;Metazoa;Animalia;BCP clade;Bilateria;Protostomia;Lophotrochozoa;Annelida;Polychaeta;Scolecida;Cossuridae;";"0.0";"0";"4";"4";"0";"4";"0";"457179";"373894"
"V4mis1";"SILVA (only NR);Eukaryota;Amorphea;Obazoa;Opisthokonta;Holozoa;Choanozoa;Metazoa;Animalia;BCP clade;Bilateria;Protostomia;Lophotrochozoa;Annelida;Polychaeta;Scolecida;Dinophilida;";"0.0";"0";"6";"6";"0";"6";"0";"457177";"373894"
"V4mis1";"SILVA (only NR);Eukaryota;Amorphea;Obazoa;Opisthokonta;Holozoa;Choanozoa;Metazoa;Animalia;BCP clade;Bilateria;Protostomia;Lophotrochozoa;Annelida;Polychaeta;Scolecida;Opheliidae;";"0.0";"0";"9";"9";"0";"9";"0";"457174";"373894"
"V4mis1";"SILVA (only NR);Eukaryota;Amorphea;Obazoa;Opisthokonta;Holozoa;Choanozoa;Metazoa;Animalia;BCP clade;Bilateria;Protostomia;Lophotrochozoa;Annelida;Polychaeta;Scolecida;Orbiniidae;";"0.0";"0";"25";"25";"0";"25";"0";"457158";"373894"
"V4mis1";"SILVA (only NR);Eukaryota;Amorphea;Obazoa;Opisthokonta;Holozoa;Choanozoa;Metazoa;Animalia;BCP clade;Bilateria;Protostomia;Lophotrochozoa;Annelida;Polychaeta;Scolecida;Paraonidae;";"0.0";"0";"6";"6";"0";"6";"0";"457177";"373894"
"V4mis1";"SILVA (only NR);Eukaryota;Amorphea;Obazoa;Opisthokonta;Holozoa;Choanozoa;Metazoa;Animalia;BCP clade;Bilateria;Protostomia;Lophotrochozoa;Annelida;Polychaeta;Scolecida;Parergodrilidae;";"0.0";"0";"4";"4";"0";"4";"0";"457179";"373894"
"V4mis1";"SILVA (only NR);Eukaryota;Amorphea;Obazoa;Opisthokonta;Holozoa;Choanozoa;Metazoa;Animalia;BCP clade;Bilateria;Protostomia;Lophotrochozoa;Annelida;Polychaeta;Scolecida;Questidae;";"0.0";"0";"2";"2";"0";"2";"0";"457181";"373894"
"V4mis1";"SILVA (only NR);Eukaryota;Amorphea;Obazoa;Opisthokonta;Holozoa;Choanozoa;Metazoa;Animalia;BCP clade;Bilateria;Protostomia;Lophotrochozoa;Annelida;Polychaeta;Scolecida;Spionida;";"0.0";"0";"93";"93";"0";"93";"0";"457090";"373894"
"V4mis1";"SILVA (only NR);Eukaryota;Amorphea;Obazoa;Opisthokonta;Holozoa;Choanozoa;Metazoa;Animalia;BCP clade;Bilateria;Protostomia;Lophotrochozoa;Annelida;Polychaeta;Scolecida;Terebellida;";"0.0";"0";"81";"81";"0";"81";"0";"457102";"373894"
"V4mis1";"SILVA (only NR);Eukaryota;Amorphea;Obazoa;Opisthokonta;Holozoa;Choanozoa;Metazoa;Animalia;BCP clade;Bilateria;Protostomia;Lophotrochozoa;Annelida;Polychaeta;Sipuncula;";"0.0";"0";"34";"34";"0";"34";"0";"457149";"373894"
"V4mis1";"SILVA (only NR);Eukaryota;Amorphea;Obazoa;Opisthokonta;Holozoa;Choanozoa;Metazoa;Animalia;BCP clade;Bilateria;Protostomia;Lophotrochozoa;Annelida;Polychaeta;Sipuncula;Aspidosiphonidormes;";"0.0";"0";"5";"5";"0";"5";"0";"457178";"373894"
"V4mis1";"SILVA (only NR);Eukaryota;Amorphea;Obazoa;Opisthokonta;Holozoa;Choanozoa;Metazoa;Animalia;BCP clade;Bilateria;Protostomia;Lophotrochozoa;Annelida;Polychaeta;Sipuncula;Golfingiida;";"0.0";"0";"20";"20";"0";"20";"0";"457163";"373894"
"V4mis1";"SILVA (only NR);Eukaryota;Amorphea;Obazoa;Opisthokonta;Holozoa;Choanozoa;Metazoa;Animalia;BCP clade;Bilateria;Protostomia;Lophotrochozoa;Annelida;Polychaeta;Sipuncula;Phascolosomatiformes;";"0.0";"0";"9";"9";"0";"9";"0";"457174";"373894"
"V4mis1";"SILVA (only NR);Eukaryota;Amorphea;Obazoa;Opisthokonta;Holozoa;Choanozoa;Metazoa;Animalia;BCP clade;Bilateria;Protostomia;Lophotrochozoa;Bryozoa;";"0.0";"0";"111";"111";"0";"111";"0";"457072";"373894"
"V4mis1";"SILVA (only NR);Eukaryota;Amorphea;Obazoa;Opisthokonta;Holozoa;Choanozoa;Metazoa;Animalia;BCP clade;Bilateria;Protostomia;Lophotrochozoa;Bryozoa;Gymnolaemata;";"0.0";"0";"71";"71";"0";"71";"0";"457112";"373894"
"V4mis1";"SILVA (only NR);Eukaryota;Amorphea;Obazoa;Opisthokonta;Holozoa;Choanozoa;Metazoa;Animalia;BCP clade;Bilateria;Protostomia;Lophotrochozoa;Bryozoa;Gymnolaemata;Cheilostomatida;";"0.0";"0";"54";"54";"0";"54";"0";"457129";"373894"
"V4mis1";"SILVA (only NR);Eukaryota;Amorphea;Obazoa;Opisthokonta;Holozoa;Choanozoa;Metazoa;Animalia;BCP clade;Bilateria;Protostomia;Lophotrochozoa;Bryozoa;Gymnolaemata;Ctenostomatida;";"0.0";"0";"17";"17";"0";"17";"0";"457166";"373894"
"V4mis1";"SILVA (only NR);Eukaryota;Amorphea;Obazoa;Opisthokonta;Holozoa;Choanozoa;Metazoa;Animalia;BCP clade;Bilateria;Protostomia;Lophotrochozoa;Bryozoa;Phylactolaemata;";"0.0";"0";"7";"7";"0";"7";"0";"457176";"373894"
"V4mis1";"SILVA (only NR);Eukaryota;Amorphea;Obazoa;Opisthokonta;Holozoa;Choanozoa;Metazoa;Animalia;BCP clade;Bilateria;Protostomia;Lophotrochozoa;Bryozoa;Phylactolaemata;Plumatellida;";"0.0";"0";"7";"7";"0";"7";"0";"457176";"373894"
"V4mis1";"SILVA (only NR);Eukaryota;Amorphea;Obazoa;Opisthokonta;Holozoa;Choanozoa;Metazoa;Animalia;BCP clade;Bilateria;Protostomia;Lophotrochozoa;Bryozoa;Phylactolaemata;Plumatellida;Plumatellidae;";"0.0";"0";"2";"2";"0";"2";"0";"457181";"373894"
"V4mis1";"SILVA (only NR);Eukaryota;Amorphea;Obazoa;Opisthokonta;Holozoa;Choanozoa;Metazoa;Animalia;BCP clade;Bilateria;Protostomia;Lophotrochozoa;Bryozoa;Stenolaemata;";"0.0";"0";"33";"33";"0";"33";"0";"457150";"373894"
"V4mis1";"SILVA (only NR);Eukaryota;Amorphea;Obazoa;Opisthokonta;Holozoa;Choanozoa;Metazoa;Animalia;BCP clade;Bilateria;Protostomia;Lophotrochozoa;Bryozoa;Stenolaemata;Cyclostomatida;";"0.0";"0";"28";"28";"0";"28";"0";"457155";"373894"
"V4mis1";"SILVA (only NR);Eukaryota;Amorphea;Obazoa;Opisthokonta;Holozoa;Choanozoa;Metazoa;Animalia;BCP clade;Bilateria;Protostomia;Lophotrochozoa;Bryozoa;Stenolaemata;Tubuliporida;";"0.0";"0";"4";"4";"0";"4";"0";"457179";"373894"
"V4mis1";"SILVA (only NR);Eukaryota;Amorphea;Obazoa;Opisthokonta;Holozoa;Choanozoa;Metazoa;Animalia;BCP clade;Bilateria;Protostomia;Lophotrochozoa;Entoprocta;";"0.0";"0";"19";"19";"0";"19";"0";"457164";"373894"
"V4mis1";"SILVA (only NR);Eukaryota;Amorphea;Obazoa;Opisthokonta;Holozoa;Choanozoa;Metazoa;Animalia;BCP clade;Bilateria;Protostomia;Lophotrochozoa;Entoprocta;Coloniales;";"0.0";"0";"4";"4";"0";"4";"0";"457179";"373894"
"V4mis1";"SILVA (only NR);Eukaryota;Amorphea;Obazoa;Opisthokonta;Holozoa;Choanozoa;Metazoa;Animalia;BCP clade;Bilateria;Protostomia;Lophotrochozoa;Entoprocta;Coloniales;Barentsiidae;";"0.0";"0";"4";"4";"0";"4";"0";"457179";"373894"
"V4mis1";"SILVA (only NR);Eukaryota;Amorphea;Obazoa;Opisthokonta;Holozoa;Choanozoa;Metazoa;Animalia;BCP clade;Bilateria;Protostomia;Lophotrochozoa;Entoprocta;Solitaria;";"0.0";"0";"13";"13";"0";"13";"0";"457170";"373894"
"V4mis1";"SILVA (only NR);Eukaryota;Amorphea;Obazoa;Opisthokonta;Holozoa;Choanozoa;Metazoa;Animalia;BCP clade;Bilateria;Protostomia;Lophotrochozoa;Entoprocta;Solitaria;Loxosomatidae;";"0.0";"0";"13";"13";"0";"13";"0";"457170";"373894"
"V4mis1";"SILVA (only NR);Eukaryota;Amorphea;Obazoa;Opisthokonta;Holozoa;Choanozoa;Metazoa;Animalia;BCP clade;Bilateria;Protostomia;Lophotrochozoa;Gastrotricha;";"0.0";"0";"149";"149";"0";"149";"0";"457034";"373894"
"V4mis1";"SILVA (only NR);Eukaryota;Amorphea;Obazoa;Opisthokonta;Holozoa;Choanozoa;Metazoa;Animalia;BCP clade;Bilateria;Protostomia;Lophotrochozoa;Gastrotricha;Chaetonotida;";"0.0";"0";"88";"88";"0";"88";"0";"457095";"373894"
"V4mis1";"SILVA (only NR);Eukaryota;Amorphea;Obazoa;Opisthokonta;Holozoa;Choanozoa;Metazoa;Animalia;BCP clade;Bilateria;Protostomia;Lophotrochozoa;Gastrotricha;Macrodasyida;";"0.0";"0";"61";"61";"0";"61";"0";"457122";"373894"
"V4mis1";"SILVA (only NR);Eukaryota;Amorphea;Obazoa;Opisthokonta;Holozoa;Choanozoa;Metazoa;Animalia;BCP clade;Bilateria;Protostomia;Lophotrochozoa;Gastrotricha;Macrodasyida;Dactylopodolidae;";"0.0";"0";"5";"5";"0";"5";"0";"457178";"373894"
"V4mis1";"SILVA (only NR);Eukaryota;Amorphea;Obazoa;Opisthokonta;Holozoa;Choanozoa;Metazoa;Animalia;BCP clade;Bilateria;Protostomia;Lophotrochozoa;Gnathostomulida;";"0.0";"0";"24";"24";"0";"24";"0";"457159";"373894"
"V4mis1";"SILVA (only NR);Eukaryota;Amorphea;Obazoa;Opisthokonta;Holozoa;Choanozoa;Metazoa;Animalia;BCP clade;Bilateria;Protostomia;Lophotrochozoa;Gnathostomulida;Bursovaginoidea;";"0.0";"0";"18";"18";"0";"18";"0";"457165";"373894"
"V4mis1";"SILVA (only NR);Eukaryota;Amorphea;Obazoa;Opisthokonta;Holozoa;Choanozoa;Metazoa;Animalia;BCP clade;Bilateria;Protostomia;Lophotrochozoa;Gnathostomulida;Filospermoidea;";"0.0";"0";"6";"6";"0";"6";"0";"457177";"373894"
"V4mis1";"SILVA (only NR);Eukaryota;Amorphea;Obazoa;Opisthokonta;Holozoa;Choanozoa;Metazoa;Animalia;BCP clade;Bilateria;Protostomia;Lophotrochozoa;Lophophorata;";"0.0";"0";"57";"57";"0";"57";"0";"457126";"373894"
"V4mis1";"SILVA (only NR);Eukaryota;Amorphea;Obazoa;Opisthokonta;Holozoa;Choanozoa;Metazoa;Animalia;BCP clade;Bilateria;Protostomia;Lophotrochozoa;Lophophorata;Brachiopoda;";"0.0";"0";"57";"57";"0";"57";"0";"457126";"373894"
"V4mis1";"SILVA (only NR);Eukaryota;Amorphea;Obazoa;Opisthokonta;Holozoa;Choanozoa;Metazoa;Animalia;BCP clade;Bilateria;Protostomia;Lophotrochozoa;Lophophorata;Brachiopoda;Linguliformea;";"0.0";"0";"6";"6";"0";"6";"0";"457177";"373894"
"V4mis1";"SILVA (only NR);Eukaryota;Amorphea;Obazoa;Opisthokonta;Holozoa;Choanozoa;Metazoa;Animalia;BCP clade;Bilateria;Protostomia;Lophotrochozoa;Lophophorata;Brachiopoda;Linguliformea;Lingulata;";"0.0";"0";"6";"6";"0";"6";"0";"457177";"373894"
"V4mis1";"SILVA (only NR);Eukaryota;Amorphea;Obazoa;Opisthokonta;Holozoa;Choanozoa;Metazoa;Animalia;BCP clade;Bilateria;Protostomia;Lophotrochozoa;Lophophorata;Brachiopoda;Linguliformea;Lingulata;Lingulida;";"0.0";"0";"6";"6";"0";"6";"0";"457177";"373894"
"V4mis1";"SILVA (only NR);Eukaryota;Amorphea;Obazoa;Opisthokonta;Holozoa;Choanozoa;Metazoa;Animalia;BCP clade;Bilateria;Protostomia;Lophotrochozoa;Lophophorata;Brachiopoda;Phoroniformea;";"0.0";"0";"12";"12";"0";"12";"0";"457171";"373894"
"V4mis1";"SILVA (only NR);Eukaryota;Amorphea;Obazoa;Opisthokonta;Holozoa;Choanozoa;Metazoa;Animalia;BCP clade;Bilateria;Protostomia;Lophotrochozoa;Lophophorata;Brachiopoda;Rhynchonelliformea;";"0.0";"0";"37";"37";"0";"37";"0";"457146";"373894"
"V4mis1";"SILVA (only NR);Eukaryota;Amorphea;Obazoa;Opisthokonta;Holozoa;Choanozoa;Metazoa;Animalia;BCP clade;Bilateria;Protostomia;Lophotrochozoa;Lophophorata;Brachiopoda;Rhynchonelliformea;Rhynchonellata;";"0.0";"0";"37";"37";"0";"37";"0";"457146";"373894"
"V4mis1";"SILVA (only NR);Eukaryota;Amorphea;Obazoa;Opisthokonta;Holozoa;Choanozoa;Metazoa;Animalia;BCP clade;Bilateria;Protostomia;Lophotrochozoa;Lophophorata;Brachiopoda;Rhynchonelliformea;Rhynchonellata;Rhynchonellida;";"0.0";"0";"9";"9";"0";"9";"0";"457174";"373894"
"V4mis1";"SILVA (only NR);Eukaryota;Amorphea;Obazoa;Opisthokonta;Holozoa;Choanozoa;Metazoa;Animalia;BCP clade;Bilateria;Protostomia;Lophotrochozoa;Lophophorata;Brachiopoda;Rhynchonelliformea;Rhynchonellata;Terebratulida;";"0.0";"0";"20";"20";"0";"20";"0";"457163";"373894"
"V4mis1";"SILVA (only NR);Eukaryota;Amorphea;Obazoa;Opisthokonta;Holozoa;Choanozoa;Metazoa;Animalia;BCP clade;Bilateria;Protostomia;Lophotrochozoa;Lophophorata;Brachiopoda;Rhynchonelliformea;Rhynchonellata;Thecideida;";"0.0";"0";"8";"8";"0";"8";"0";"457175";"373894"
"V4mis1";"SILVA (only NR);Eukaryota;Amorphea;Obazoa;Opisthokonta;Holozoa;Choanozoa;Metazoa;Animalia;BCP clade;Bilateria;Protostomia;Lophotrochozoa;Micrognathozoa;";"0.0";"0";"2";"2";"0";"2";"0";"457181";"373894"
"V4mis1";"SILVA (only NR);Eukaryota;Amorphea;Obazoa;Opisthokonta;Holozoa;Choanozoa;Metazoa;Animalia;BCP clade;Bilateria;Protostomia;Lophotrochozoa;Micrognathozoa;Limnognathia;";"0.0";"0";"2";"2";"0";"2";"0";"457181";"373894"
"V4mis1";"SILVA (only NR);Eukaryota;Amorphea;Obazoa;Opisthokonta;Holozoa;Choanozoa;Metazoa;Animalia;BCP clade;Bilateria;Protostomia;Lophotrochozoa;Mollusca;";"0.3";"18";"986";"983";"3";"980";"3";"456200";"373891"
"V4mis1";"SILVA (only NR);Eukaryota;Amorphea;Obazoa;Opisthokonta;Holozoa;Choanozoa;Metazoa;Animalia;BCP clade;Bilateria;Protostomia;Lophotrochozoa;Mollusca;Bivalvia;";"0.8";"18.2";"368";"368";"3";"365";"0";"456815";"373891"
"V4mis1";"SILVA (only NR);Eukaryota;Amorphea;Obazoa;Opisthokonta;Holozoa;Choanozoa;Metazoa;Animalia;BCP clade;Bilateria;Protostomia;Lophotrochozoa;Mollusca;Bivalvia;Anomalodesmata;";"0.0";"0";"43";"43";"0";"43";"0";"457140";"373894"
"V4mis1";"SILVA (only NR);Eukaryota;Amorphea;Obazoa;Opisthokonta;Holozoa;Choanozoa;Metazoa;Animalia;BCP clade;Bilateria;Protostomia;Lophotrochozoa;Mollusca;Bivalvia;Anomalodesmata;Pholadomyoida;";"0.0";"0";"43";"43";"0";"43";"0";"457140";"373894"
"V4mis1";"SILVA (only NR);Eukaryota;Amorphea;Obazoa;Opisthokonta;Holozoa;Choanozoa;Metazoa;Animalia;BCP clade;Bilateria;Protostomia;Lophotrochozoa;Mollusca;Bivalvia;Heteroconchia;";"1.7";"18.2";"176";"176";"3";"173";"0";"457007";"373891"
"V4mis1";"SILVA (only NR);Eukaryota;Amorphea;Obazoa;Opisthokonta;Holozoa;Choanozoa;Metazoa;Animalia;BCP clade;Bilateria;Protostomia;Lophotrochozoa;Mollusca;Bivalvia;Heteroconchia;Myoida;";"0.0";"0";"36";"36";"0";"36";"0";"457147";"373894"
"V4mis1";"SILVA (only NR);Eukaryota;Amorphea;Obazoa;Opisthokonta;Holozoa;Choanozoa;Metazoa;Animalia;BCP clade;Bilateria;Protostomia;Lophotrochozoa;Mollusca;Bivalvia;Heteroconchia;Veneroida;";"2.2";"18.2";"134";"134";"3";"131";"0";"457049";"373891"
"V4mis1";"SILVA (only NR);Eukaryota;Amorphea;Obazoa;Opisthokonta;Holozoa;Choanozoa;Metazoa;Animalia;BCP clade;Bilateria;Protostomia;Lophotrochozoa;Mollusca;Bivalvia;Palaeoheterodonta;";"0.0";"0";"15";"15";"0";"15";"0";"457168";"373894"
"V4mis1";"SILVA (only NR);Eukaryota;Amorphea;Obazoa;Opisthokonta;Holozoa;Choanozoa;Metazoa;Animalia;BCP clade;Bilateria;Protostomia;Lophotrochozoa;Mollusca;Bivalvia;Palaeoheterodonta;Unionoida;";"0.0";"0";"14";"14";"0";"14";"0";"457169";"373894"
"V4mis1";"SILVA (only NR);Eukaryota;Amorphea;Obazoa;Opisthokonta;Holozoa;Choanozoa;Metazoa;Animalia;BCP clade;Bilateria;Protostomia;Lophotrochozoa;Mollusca;Bivalvia;Protobranchia;";"0.0";"0";"26";"26";"0";"26";"0";"457157";"373894"
"V4mis1";"SILVA (only NR);Eukaryota;Amorphea;Obazoa;Opisthokonta;Holozoa;Choanozoa;Metazoa;Animalia;BCP clade;Bilateria;Protostomia;Lophotrochozoa;Mollusca;Bivalvia;Protobranchia;Nuculanoida;";"0.0";"0";"6";"6";"0";"6";"0";"457177";"373894"
"V4mis1";"SILVA (only NR);Eukaryota;Amorphea;Obazoa;Opisthokonta;Holozoa;Choanozoa;Metazoa;Animalia;BCP clade;Bilateria;Protostomia;Lophotrochozoa;Mollusca;Bivalvia;Protobranchia;Nuculoida;";"0.0";"0";"4";"4";"0";"4";"0";"457179";"373894"
"V4mis1";"SILVA (only NR);Eukaryota;Amorphea;Obazoa;Opisthokonta;Holozoa;Choanozoa;Metazoa;Animalia;BCP clade;Bilateria;Protostomia;Lophotrochozoa;Mollusca;Bivalvia;Protobranchia;Solemyoida;";"0.0";"0";"16";"16";"0";"16";"0";"457167";"373894"
"V4mis1";"SILVA (only NR);Eukaryota;Amorphea;Obazoa;Opisthokonta;Holozoa;Choanozoa;Metazoa;Animalia;BCP clade;Bilateria;Protostomia;Lophotrochozoa;Mollusca;Bivalvia;Pteriomorphia;";"0.0";"0";"108";"108";"0";"108";"0";"457075";"373894"
"V4mis1";"SILVA (only NR);Eukaryota;Amorphea;Obazoa;Opisthokonta;Holozoa;Choanozoa;Metazoa;Animalia;BCP clade;Bilateria;Protostomia;Lophotrochozoa;Mollusca;Bivalvia;Pteriomorphia;Arcoida;";"0.0";"0";"12";"12";"0";"12";"0";"457171";"373894"
"V4mis1";"SILVA (only NR);Eukaryota;Amorphea;Obazoa;Opisthokonta;Holozoa;Choanozoa;Metazoa;Animalia;BCP clade;Bilateria;Protostomia;Lophotrochozoa;Mollusca;Bivalvia;Pteriomorphia;Limoida;";"0.0";"0";"8";"8";"0";"8";"0";"457175";"373894"
"V4mis1";"SILVA (only NR);Eukaryota;Amorphea;Obazoa;Opisthokonta;Holozoa;Choanozoa;Metazoa;Animalia;BCP clade;Bilateria;Protostomia;Lophotrochozoa;Mollusca;Bivalvia;Pteriomorphia;Mytiloida;";"0.0";"0";"37";"37";"0";"37";"0";"457146";"373894"
"V4mis1";"SILVA (only NR);Eukaryota;Amorphea;Obazoa;Opisthokonta;Holozoa;Choanozoa;Metazoa;Animalia;BCP clade;Bilateria;Protostomia;Lophotrochozoa;Mollusca;Bivalvia;Pteriomorphia;Ostreoida;";"0.0";"0";"16";"16";"0";"16";"0";"457167";"373894"
"V4mis1";"SILVA (only NR);Eukaryota;Amorphea;Obazoa;Opisthokonta;Holozoa;Choanozoa;Metazoa;Animalia;BCP clade;Bilateria;Protostomia;Lophotrochozoa;Mollusca;Bivalvia;Pteriomorphia;Pectinoida;";"0.0";"0";"13";"13";"0";"13";"0";"457170";"373894"
"V4mis1";"SILVA (only NR);Eukaryota;Amorphea;Obazoa;Opisthokonta;Holozoa;Choanozoa;Metazoa;Animalia;BCP clade;Bilateria;Protostomia;Lophotrochozoa;Mollusca;Bivalvia;Pteriomorphia;Pterioida;";"0.0";"0";"22";"22";"0";"22";"0";"457161";"373894"
"V4mis1";"SILVA (only NR);Eukaryota;Amorphea;Obazoa;Opisthokonta;Holozoa;Choanozoa;Metazoa;Animalia;BCP clade;Bilateria;Protostomia;Lophotrochozoa;Mollusca;Caudofoveata;";"0.0";"0";"4";"4";"0";"4";"0";"457179";"373894"
"V4mis1";"SILVA (only NR);Eukaryota;Amorphea;Obazoa;Opisthokonta;Holozoa;Choanozoa;Metazoa;Animalia;BCP clade;Bilateria;Protostomia;Lophotrochozoa;Mollusca;Cephalopoda;";"0.0";"0";"53";"51";"0";"51";"2";"457132";"373894"
"V4mis1";"SILVA (only NR);Eukaryota;Amorphea;Obazoa;Opisthokonta;Holozoa;Choanozoa;Metazoa;Animalia;BCP clade;Bilateria;Protostomia;Lophotrochozoa;Mollusca;Cephalopoda;Coleoidea;";"0.0";"0";"53";"51";"0";"51";"2";"457132";"373894"
"V4mis1";"SILVA (only NR);Eukaryota;Amorphea;Obazoa;Opisthokonta;Holozoa;Choanozoa;Metazoa;Animalia;BCP clade;Bilateria;Protostomia;Lophotrochozoa;Mollusca;Cephalopoda;Coleoidea;Decapodiformes;";"0.0";"0";"50";"48";"0";"48";"2";"457135";"373894"
"V4mis1";"SILVA (only NR);Eukaryota;Amorphea;Obazoa;Opisthokonta;Holozoa;Choanozoa;Metazoa;Animalia;BCP clade;Bilateria;Protostomia;Lophotrochozoa;Mollusca;Cephalopoda;Coleoidea;Decapodiformes;Teuthida;";"0.0";"0";"46";"46";"0";"46";"0";"457137";"373894"
"V4mis1";"SILVA (only NR);Eukaryota;Amorphea;Obazoa;Opisthokonta;Holozoa;Choanozoa;Metazoa;Animalia;BCP clade;Bilateria;Protostomia;Lophotrochozoa;Mollusca;Gastropoda;";"0.0";"0";"496";"495";"0";"495";"1";"456688";"373894"
"V4mis1";"SILVA (only NR);Eukaryota;Amorphea;Obazoa;Opisthokonta;Holozoa;Choanozoa;Metazoa;Animalia;BCP clade;Bilateria;Protostomia;Lophotrochozoa;Mollusca;Gastropoda;Caenogastropoda;";"0.0";"0";"97";"96";"0";"96";"1";"457087";"373894"
"V4mis1";"SILVA (only NR);Eukaryota;Amorphea;Obazoa;Opisthokonta;Holozoa;Choanozoa;Metazoa;Animalia;BCP clade;Bilateria;Protostomia;Lophotrochozoa;Mollusca;Gastropoda;Cucculiniformia;";"0.0";"0";"6";"6";"0";"6";"0";"457177";"373894"
"V4mis1";"SILVA (only NR);Eukaryota;Amorphea;Obazoa;Opisthokonta;Holozoa;Choanozoa;Metazoa;Animalia;BCP clade;Bilateria;Protostomia;Lophotrochozoa;Mollusca;Gastropoda;Heterobranchia;";"0.0";"0";"314";"314";"0";"314";"0";"456869";"373894"
"V4mis1";"SILVA (only NR);Eukaryota;Amorphea;Obazoa;Opisthokonta;Holozoa;Choanozoa;Metazoa;Animalia;BCP clade;Bilateria;Protostomia;Lophotrochozoa;Mollusca;Gastropoda;Neritimorpha;";"0.0";"0";"6";"6";"0";"6";"0";"457177";"373894"
"V4mis1";"SILVA (only NR);Eukaryota;Amorphea;Obazoa;Opisthokonta;Holozoa;Choanozoa;Metazoa;Animalia;BCP clade;Bilateria;Protostomia;Lophotrochozoa;Mollusca;Gastropoda;Vetigastropoda;";"0.0";"0";"72";"72";"0";"72";"0";"457111";"373894"
"V4mis1";"SILVA (only NR);Eukaryota;Amorphea;Obazoa;Opisthokonta;Holozoa;Choanozoa;Metazoa;Animalia;BCP clade;Bilateria;Protostomia;Lophotrochozoa;Mollusca;Polyplacophora;";"0.0";"0";"45";"45";"0";"45";"0";"457138";"373894"
"V4mis1";"SILVA (only NR);Eukaryota;Amorphea;Obazoa;Opisthokonta;Holozoa;Choanozoa;Metazoa;Animalia;BCP clade;Bilateria;Protostomia;Lophotrochozoa;Mollusca;Polyplacophora;Neoloricata;";"0.0";"0";"45";"45";"0";"45";"0";"457138";"373894"
"V4mis1";"SILVA (only NR);Eukaryota;Amorphea;Obazoa;Opisthokonta;Holozoa;Choanozoa;Metazoa;Animalia;BCP clade;Bilateria;Protostomia;Lophotrochozoa;Mollusca;Scaphopoda;";"0.0";"0";"16";"16";"0";"16";"0";"457167";"373894"
"V4mis1";"SILVA (only NR);Eukaryota;Amorphea;Obazoa;Opisthokonta;Holozoa;Choanozoa;Metazoa;Animalia;BCP clade;Bilateria;Protostomia;Lophotrochozoa;Mollusca;Scaphopoda;Dentaliida;";"0.0";"0";"7";"7";"0";"7";"0";"457176";"373894"
"V4mis1";"SILVA (only NR);Eukaryota;Amorphea;Obazoa;Opisthokonta;Holozoa;Choanozoa;Metazoa;Animalia;BCP clade;Bilateria;Protostomia;Lophotrochozoa;Mollusca;Scaphopoda;Gadilida;";"0.0";"0";"9";"9";"0";"9";"0";"457174";"373894"
"V4mis1";"SILVA (only NR);Eukaryota;Amorphea;Obazoa;Opisthokonta;Holozoa;Choanozoa;Metazoa;Animalia;BCP clade;Bilateria;Protostomia;Lophotrochozoa;Nemertea;";"0.0";"0";"160";"160";"0";"160";"0";"457023";"373894"
"V4mis1";"SILVA (only NR);Eukaryota;Amorphea;Obazoa;Opisthokonta;Holozoa;Choanozoa;Metazoa;Animalia;BCP clade;Bilateria;Protostomia;Lophotrochozoa;Nemertea;Anopla;";"0.0";"0";"74";"74";"0";"74";"0";"457109";"373894"
"V4mis1";"SILVA (only NR);Eukaryota;Amorphea;Obazoa;Opisthokonta;Holozoa;Choanozoa;Metazoa;Animalia;BCP clade;Bilateria;Protostomia;Lophotrochozoa;Nemertea;Anopla;Heteronemertea;";"0.0";"0";"38";"38";"0";"38";"0";"457145";"373894"
"V4mis1";"SILVA (only NR);Eukaryota;Amorphea;Obazoa;Opisthokonta;Holozoa;Choanozoa;Metazoa;Animalia;BCP clade;Bilateria;Protostomia;Lophotrochozoa;Nemertea;Anopla;Palaeonemertea;";"0.0";"0";"34";"34";"0";"34";"0";"457149";"373894"
"V4mis1";"SILVA (only NR);Eukaryota;Amorphea;Obazoa;Opisthokonta;Holozoa;Choanozoa;Metazoa;Animalia;BCP clade;Bilateria;Protostomia;Lophotrochozoa;Nemertea;Enopla;";"0.0";"0";"86";"86";"0";"86";"0";"457097";"373894"
"V4mis1";"SILVA (only NR);Eukaryota;Amorphea;Obazoa;Opisthokonta;Holozoa;Choanozoa;Metazoa;Animalia;BCP clade;Bilateria;Protostomia;Lophotrochozoa;Nemertea;Enopla;Bdellonemertea;";"0.0";"0";"2";"2";"0";"2";"0";"457181";"373894"
"V4mis1";"SILVA (only NR);Eukaryota;Amorphea;Obazoa;Opisthokonta;Holozoa;Choanozoa;Metazoa;Animalia;BCP clade;Bilateria;Protostomia;Lophotrochozoa;Nemertea;Enopla;Monostilifera;";"0.0";"0";"79";"79";"0";"79";"0";"457104";"373894"
"V4mis1";"SILVA (only NR);Eukaryota;Amorphea;Obazoa;Opisthokonta;Holozoa;Choanozoa;Metazoa;Animalia;BCP clade;Bilateria;Protostomia;Lophotrochozoa;Nemertea;Enopla;Polystilifera;";"0.0";"0";"4";"4";"0";"4";"0";"457179";"373894"
"V4mis1";"SILVA (only NR);Eukaryota;Amorphea;Obazoa;Opisthokonta;Holozoa;Choanozoa;Metazoa;Animalia;BCP clade;Bilateria;Protostomia;Lophotrochozoa;Pauropoda;";"0.0";"0";"5";"5";"0";"5";"0";"457178";"373894"
"V4mis1";"SILVA (only NR);Eukaryota;Amorphea;Obazoa;Opisthokonta;Holozoa;Choanozoa;Metazoa;Animalia;BCP clade;Bilateria;Protostomia;Lophotrochozoa;Platyhelminthes;";"0.0";"0";"1993";"1971";"0";"1971";"22";"455212";"373894"
"V4mis1";"SILVA (only NR);Eukaryota;Amorphea;Obazoa;Opisthokonta;Holozoa;Choanozoa;Metazoa;Animalia;BCP clade;Bilateria;Protostomia;Lophotrochozoa;Platyhelminthes;Catenulida;";"0.0";"0";"43";"42";"0";"42";"1";"457141";"373894"
"V4mis1";"SILVA (only NR);Eukaryota;Amorphea;Obazoa;Opisthokonta;Holozoa;Choanozoa;Metazoa;Animalia;BCP clade;Bilateria;Protostomia;Lophotrochozoa;Platyhelminthes;Catenulida;Catenulidae;";"0.0";"0";"22";"22";"0";"22";"0";"457161";"373894"
"V4mis1";"SILVA (only NR);Eukaryota;Amorphea;Obazoa;Opisthokonta;Holozoa;Choanozoa;Metazoa;Animalia;BCP clade;Bilateria;Protostomia;Lophotrochozoa;Platyhelminthes;Catenulida;Stenostomidae;";"0.0";"0";"20";"19";"0";"19";"1";"457164";"373894"
"V4mis1";"SILVA (only NR);Eukaryota;Amorphea;Obazoa;Opisthokonta;Holozoa;Choanozoa;Metazoa;Animalia;BCP clade;Bilateria;Protostomia;Lophotrochozoa;Platyhelminthes;Cestoda;";"0.0";"0";"508";"495";"0";"495";"13";"456688";"373894"
"V4mis1";"SILVA (only NR);Eukaryota;Amorphea;Obazoa;Opisthokonta;Holozoa;Choanozoa;Metazoa;Animalia;BCP clade;Bilateria;Protostomia;Lophotrochozoa;Platyhelminthes;Cestoda;Cestodaria;";"0.0";"0";"4";"4";"0";"4";"0";"457179";"373894"
"V4mis1";"SILVA (only NR);Eukaryota;Amorphea;Obazoa;Opisthokonta;Holozoa;Choanozoa;Metazoa;Animalia;BCP clade;Bilateria;Protostomia;Lophotrochozoa;Platyhelminthes;Cestoda;Cestodaria;Amphilinidea;";"0.0";"0";"2";"2";"0";"2";"0";"457181";"373894"
"V4mis1";"SILVA (only NR);Eukaryota;Amorphea;Obazoa;Opisthokonta;Holozoa;Choanozoa;Metazoa;Animalia;BCP clade;Bilateria;Protostomia;Lophotrochozoa;Platyhelminthes;Cestoda;Cestodaria;Gyrocotylidea;";"0.0";"0";"2";"2";"0";"2";"0";"457181";"373894"
"V4mis1";"SILVA (only NR);Eukaryota;Amorphea;Obazoa;Opisthokonta;Holozoa;Choanozoa;Metazoa;Animalia;BCP clade;Bilateria;Protostomia;Lophotrochozoa;Platyhelminthes;Cestoda;Eucestoda;";"0.0";"0";"503";"490";"0";"490";"13";"456693";"373894"
"V4mis1";"SILVA (only NR);Eukaryota;Amorphea;Obazoa;Opisthokonta;Holozoa;Choanozoa;Metazoa;Animalia;BCP clade;Bilateria;Protostomia;Lophotrochozoa;Platyhelminthes;Cestoda;Eucestoda;Bothriocephalidea;";"0.0";"0";"43";"43";"0";"43";"0";"457140";"373894"
"V4mis1";"SILVA (only NR);Eukaryota;Amorphea;Obazoa;Opisthokonta;Holozoa;Choanozoa;Metazoa;Animalia;BCP clade;Bilateria;Protostomia;Lophotrochozoa;Platyhelminthes;Cestoda;Eucestoda;Caryophyllidea;";"0.0";"0";"31";"31";"0";"31";"0";"457152";"373894"
"V4mis1";"SILVA (only NR);Eukaryota;Amorphea;Obazoa;Opisthokonta;Holozoa;Choanozoa;Metazoa;Animalia;BCP clade;Bilateria;Protostomia;Lophotrochozoa;Platyhelminthes;Cestoda;Eucestoda;Cathetocephalidea;";"0.0";"0";"2";"2";"0";"2";"0";"457181";"373894"
"V4mis1";"SILVA (only NR);Eukaryota;Amorphea;Obazoa;Opisthokonta;Holozoa;Choanozoa;Metazoa;Animalia;BCP clade;Bilateria;Protostomia;Lophotrochozoa;Platyhelminthes;Cestoda;Eucestoda;Cyclophyllidea;";"0.0";"0";"90";"80";"0";"80";"10";"457103";"373894"
"V4mis1";"SILVA (only NR);Eukaryota;Amorphea;Obazoa;Opisthokonta;Holozoa;Choanozoa;Metazoa;Animalia;BCP clade;Bilateria;Protostomia;Lophotrochozoa;Platyhelminthes;Cestoda;Eucestoda;Diphyllidea;";"0.0";"0";"21";"21";"0";"21";"0";"457162";"373894"
"V4mis1";"SILVA (only NR);Eukaryota;Amorphea;Obazoa;Opisthokonta;Holozoa;Choanozoa;Metazoa;Animalia;BCP clade;Bilateria;Protostomia;Lophotrochozoa;Platyhelminthes;Cestoda;Eucestoda;Diphyllobothriidea;";"0.0";"0";"12";"12";"0";"12";"0";"457171";"373894"
"V4mis1";"SILVA (only NR);Eukaryota;Amorphea;Obazoa;Opisthokonta;Holozoa;Choanozoa;Metazoa;Animalia;BCP clade;Bilateria;Protostomia;Lophotrochozoa;Platyhelminthes;Cestoda;Eucestoda;Eucestoda Incertae Sedis;";"0.0";"0";"4";"4";"0";"4";"0";"457179";"373894"
"V4mis1";"SILVA (only NR);Eukaryota;Amorphea;Obazoa;Opisthokonta;Holozoa;Choanozoa;Metazoa;Animalia;BCP clade;Bilateria;Protostomia;Lophotrochozoa;Platyhelminthes;Cestoda;Eucestoda;Lecanicephalidea;";"0.0";"0";"36";"36";"0";"36";"0";"457147";"373894"
"V4mis1";"SILVA (only NR);Eukaryota;Amorphea;Obazoa;Opisthokonta;Holozoa;Choanozoa;Metazoa;Animalia;BCP clade;Bilateria;Protostomia;Lophotrochozoa;Platyhelminthes;Cestoda;Eucestoda;Litobothriidea;";"0.0";"0";"3";"3";"0";"3";"0";"457180";"373894"
"V4mis1";"SILVA (only NR);Eukaryota;Amorphea;Obazoa;Opisthokonta;Holozoa;Choanozoa;Metazoa;Animalia;BCP clade;Bilateria;Protostomia;Lophotrochozoa;Platyhelminthes;Cestoda;Eucestoda;Nippotaeniidea;";"0.0";"0";"4";"4";"0";"4";"0";"457179";"373894"
"V4mis1";"SILVA (only NR);Eukaryota;Amorphea;Obazoa;Opisthokonta;Holozoa;Choanozoa;Metazoa;Animalia;BCP clade;Bilateria;Protostomia;Lophotrochozoa;Platyhelminthes;Cestoda;Eucestoda;Proteocephalidea;";"0.0";"0";"28";"28";"0";"28";"0";"457155";"373894"
"V4mis1";"SILVA (only NR);Eukaryota;Amorphea;Obazoa;Opisthokonta;Holozoa;Choanozoa;Metazoa;Animalia;BCP clade;Bilateria;Protostomia;Lophotrochozoa;Platyhelminthes;Cestoda;Eucestoda;Pseudophyllidea;";"0.0";"0";"7";"7";"0";"7";"0";"457176";"373894"
"V4mis1";"SILVA (only NR);Eukaryota;Amorphea;Obazoa;Opisthokonta;Holozoa;Choanozoa;Metazoa;Animalia;BCP clade;Bilateria;Protostomia;Lophotrochozoa;Platyhelminthes;Cestoda;Eucestoda;Rhinebothriidea;";"0.0";"0";"50";"50";"0";"50";"0";"457133";"373894"
"V4mis1";"SILVA (only NR);Eukaryota;Amorphea;Obazoa;Opisthokonta;Holozoa;Choanozoa;Metazoa;Animalia;BCP clade;Bilateria;Protostomia;Lophotrochozoa;Platyhelminthes;Cestoda;Eucestoda;Spathebothriidea;";"0.0";"0";"4";"4";"0";"4";"0";"457179";"373894"
"V4mis1";"SILVA (only NR);Eukaryota;Amorphea;Obazoa;Opisthokonta;Holozoa;Choanozoa;Metazoa;Animalia;BCP clade;Bilateria;Protostomia;Lophotrochozoa;Platyhelminthes;Cestoda;Eucestoda;Tetrabothriidea;";"0.0";"0";"3";"3";"0";"3";"0";"457180";"373894"
"V4mis1";"SILVA (only NR);Eukaryota;Amorphea;Obazoa;Opisthokonta;Holozoa;Choanozoa;Metazoa;Animalia;BCP clade;Bilateria;Protostomia;Lophotrochozoa;Platyhelminthes;Cestoda;Eucestoda;Tetraphyllidea;";"0.0";"0";"52";"49";"0";"49";"3";"457134";"373894"
"V4mis1";"SILVA (only NR);Eukaryota;Amorphea;Obazoa;Opisthokonta;Holozoa;Choanozoa;Metazoa;Animalia;BCP clade;Bilateria;Protostomia;Lophotrochozoa;Platyhelminthes;Cestoda;Eucestoda;Trypanorhyncha;";"0.0";"0";"78";"78";"0";"78";"0";"457105";"373894"
"V4mis1";"SILVA (only NR);Eukaryota;Amorphea;Obazoa;Opisthokonta;Holozoa;Choanozoa;Metazoa;Animalia;BCP clade;Bilateria;Protostomia;Lophotrochozoa;Platyhelminthes;Monogenea;";"0.0";"0";"195";"194";"0";"194";"1";"456989";"373894"
"V4mis1";"SILVA (only NR);Eukaryota;Amorphea;Obazoa;Opisthokonta;Holozoa;Choanozoa;Metazoa;Animalia;BCP clade;Bilateria;Protostomia;Lophotrochozoa;Platyhelminthes;Monogenea;Monopisthocotylea;";"0.0";"0";"121";"120";"0";"120";"1";"457063";"373894"
"V4mis1";"SILVA (only NR);Eukaryota;Amorphea;Obazoa;Opisthokonta;Holozoa;Choanozoa;Metazoa;Animalia;BCP clade;Bilateria;Protostomia;Lophotrochozoa;Platyhelminthes;Monogenea;Monopisthocotylea;Ancylodiscoididae;";"0.0";"0";"17";"16";"0";"16";"1";"457167";"373894"
"V4mis1";"SILVA (only NR);Eukaryota;Amorphea;Obazoa;Opisthokonta;Holozoa;Choanozoa;Metazoa;Animalia;BCP clade;Bilateria;Protostomia;Lophotrochozoa;Platyhelminthes;Monogenea;Monopisthocotylea;Ancyrocephalidae;";"0.0";"0";"32";"32";"0";"32";"0";"457151";"373894"
"V4mis1";"SILVA (only NR);Eukaryota;Amorphea;Obazoa;Opisthokonta;Holozoa;Choanozoa;Metazoa;Animalia;BCP clade;Bilateria;Protostomia;Lophotrochozoa;Platyhelminthes;Monogenea;Monopisthocotylea;Capsalidae;";"0.0";"0";"5";"5";"0";"5";"0";"457178";"373894"
"V4mis1";"SILVA (only NR);Eukaryota;Amorphea;Obazoa;Opisthokonta;Holozoa;Choanozoa;Metazoa;Animalia;BCP clade;Bilateria;Protostomia;Lophotrochozoa;Platyhelminthes;Monogenea;Monopisthocotylea;Dactylogyridae;";"0.0";"0";"4";"4";"0";"4";"0";"457179";"373894"
"V4mis1";"SILVA (only NR);Eukaryota;Amorphea;Obazoa;Opisthokonta;Holozoa;Choanozoa;Metazoa;Animalia;BCP clade;Bilateria;Protostomia;Lophotrochozoa;Platyhelminthes;Monogenea;Monopisthocotylea;Diplectanidae;";"0.0";"0";"9";"9";"0";"9";"0";"457174";"373894"
"V4mis1";"SILVA (only NR);Eukaryota;Amorphea;Obazoa;Opisthokonta;Holozoa;Choanozoa;Metazoa;Animalia;BCP clade;Bilateria;Protostomia;Lophotrochozoa;Platyhelminthes;Monogenea;Monopisthocotylea;Gyrodactylidae;";"0.0";"0";"30";"30";"0";"30";"0";"457153";"373894"
"V4mis1";"SILVA (only NR);Eukaryota;Amorphea;Obazoa;Opisthokonta;Holozoa;Choanozoa;Metazoa;Animalia;BCP clade;Bilateria;Protostomia;Lophotrochozoa;Platyhelminthes;Monogenea;Monopisthocotylea;Monocotylidae;";"0.0";"0";"4";"4";"0";"4";"0";"457179";"373894"
"V4mis1";"SILVA (only NR);Eukaryota;Amorphea;Obazoa;Opisthokonta;Holozoa;Choanozoa;Metazoa;Animalia;BCP clade;Bilateria;Protostomia;Lophotrochozoa;Platyhelminthes;Monogenea;Monopisthocotylea;Ooegyrodactylidae;";"0.0";"0";"2";"2";"0";"2";"0";"457181";"373894"
"V4mis1";"SILVA (only NR);Eukaryota;Amorphea;Obazoa;Opisthokonta;Holozoa;Choanozoa;Metazoa;Animalia;BCP clade;Bilateria;Protostomia;Lophotrochozoa;Platyhelminthes;Monogenea;Monopisthocotylea;Pseudodactylogyridae;";"0.0";"0";"3";"3";"0";"3";"0";"457180";"373894"
"V4mis1";"SILVA (only NR);Eukaryota;Amorphea;Obazoa;Opisthokonta;Holozoa;Choanozoa;Metazoa;Animalia;BCP clade;Bilateria;Protostomia;Lophotrochozoa;Platyhelminthes;Monogenea;Monopisthocotylea;Udonellidae;";"0.0";"0";"4";"4";"0";"4";"0";"457179";"373894"
"V4mis1";"SILVA (only NR);Eukaryota;Amorphea;Obazoa;Opisthokonta;Holozoa;Choanozoa;Metazoa;Animalia;BCP clade;Bilateria;Protostomia;Lophotrochozoa;Platyhelminthes;Monogenea;Polyopisthocotylea;";"0.0";"0";"74";"74";"0";"74";"0";"457109";"373894"
"V4mis1";"SILVA (only NR);Eukaryota;Amorphea;Obazoa;Opisthokonta;Holozoa;Choanozoa;Metazoa;Animalia;BCP clade;Bilateria;Protostomia;Lophotrochozoa;Platyhelminthes;Monogenea;Polyopisthocotylea;Diclidophoridae;";"0.0";"0";"6";"6";"0";"6";"0";"457177";"373894"
"V4mis1";"SILVA (only NR);Eukaryota;Amorphea;Obazoa;Opisthokonta;Holozoa;Choanozoa;Metazoa;Animalia;BCP clade;Bilateria;Protostomia;Lophotrochozoa;Platyhelminthes;Monogenea;Polyopisthocotylea;Diclybothriidae;";"0.0";"0";"2";"2";"0";"2";"0";"457181";"373894"
"V4mis1";"SILVA (only NR);Eukaryota;Amorphea;Obazoa;Opisthokonta;Holozoa;Choanozoa;Metazoa;Animalia;BCP clade;Bilateria;Protostomia;Lophotrochozoa;Platyhelminthes;Monogenea;Polyopisthocotylea;Gotocotylidae;";"0.0";"0";"3";"3";"0";"3";"0";"457180";"373894"
"V4mis1";"SILVA (only NR);Eukaryota;Amorphea;Obazoa;Opisthokonta;Holozoa;Choanozoa;Metazoa;Animalia;BCP clade;Bilateria;Protostomia;Lophotrochozoa;Platyhelminthes;Monogenea;Polyopisthocotylea;Mazocraeidae;";"0.0";"0";"6";"6";"0";"6";"0";"457177";"373894"
"V4mis1";"SILVA (only NR);Eukaryota;Amorphea;Obazoa;Opisthokonta;Holozoa;Choanozoa;Metazoa;Animalia;BCP clade;Bilateria;Protostomia;Lophotrochozoa;Platyhelminthes;Monogenea;Polyopisthocotylea;Microcotylidae;";"0.0";"0";"5";"5";"0";"5";"0";"457178";"373894"
"V4mis1";"SILVA (only NR);Eukaryota;Amorphea;Obazoa;Opisthokonta;Holozoa;Choanozoa;Metazoa;Animalia;BCP clade;Bilateria;Protostomia;Lophotrochozoa;Platyhelminthes;Monogenea;Polyopisthocotylea;Neothoracocotylidae;";"0.0";"0";"2";"2";"0";"2";"0";"457181";"373894"
"V4mis1";"SILVA (only NR);Eukaryota;Amorphea;Obazoa;Opisthokonta;Holozoa;Choanozoa;Metazoa;Animalia;BCP clade;Bilateria;Protostomia;Lophotrochozoa;Platyhelminthes;Monogenea;Polyopisthocotylea;Polystomatidae;";"0.0";"0";"37";"37";"0";"37";"0";"457146";"373894"
"V4mis1";"SILVA (only NR);Eukaryota;Amorphea;Obazoa;Opisthokonta;Holozoa;Choanozoa;Metazoa;Animalia;BCP clade;Bilateria;Protostomia;Lophotrochozoa;Platyhelminthes;Rhabditophora;";"0.0";"0";"886";"883";"0";"883";"3";"456300";"373894"
"V4mis1";"SILVA (only NR);Eukaryota;Amorphea;Obazoa;Opisthokonta;Holozoa;Choanozoa;Metazoa;Animalia;BCP clade;Bilateria;Protostomia;Lophotrochozoa;Platyhelminthes;Rhabditophora;Haplopharyngida;";"0.0";"0";"3";"3";"0";"3";"0";"457180";"373894"
"V4mis1";"SILVA (only NR);Eukaryota;Amorphea;Obazoa;Opisthokonta;Holozoa;Choanozoa;Metazoa;Animalia;BCP clade;Bilateria;Protostomia;Lophotrochozoa;Platyhelminthes;Rhabditophora;Lecithoepitheliata;";"0.0";"0";"21";"21";"0";"21";"0";"457162";"373894"
"V4mis1";"SILVA (only NR);Eukaryota;Amorphea;Obazoa;Opisthokonta;Holozoa;Choanozoa;Metazoa;Animalia;BCP clade;Bilateria;Protostomia;Lophotrochozoa;Platyhelminthes;Rhabditophora;Macrostomida;";"0.0";"0";"198";"198";"0";"198";"0";"456985";"373894"
"V4mis1";"SILVA (only NR);Eukaryota;Amorphea;Obazoa;Opisthokonta;Holozoa;Choanozoa;Metazoa;Animalia;BCP clade;Bilateria;Protostomia;Lophotrochozoa;Platyhelminthes;Rhabditophora;Mediofusata;";"0.0";"0";"3";"3";"0";"3";"0";"457180";"373894"
"V4mis1";"SILVA (only NR);Eukaryota;Amorphea;Obazoa;Opisthokonta;Holozoa;Choanozoa;Metazoa;Animalia;BCP clade;Bilateria;Protostomia;Lophotrochozoa;Platyhelminthes;Rhabditophora;Mediofusata;Urastomidae;";"0.0";"0";"3";"3";"0";"3";"0";"457180";"373894"
"V4mis1";"SILVA (only NR);Eukaryota;Amorphea;Obazoa;Opisthokonta;Holozoa;Choanozoa;Metazoa;Animalia;BCP clade;Bilateria;Protostomia;Lophotrochozoa;Platyhelminthes;Rhabditophora;Polycladida;";"0.0";"0";"15";"15";"0";"15";"0";"457168";"373894"
"V4mis1";"SILVA (only NR);Eukaryota;Amorphea;Obazoa;Opisthokonta;Holozoa;Choanozoa;Metazoa;Animalia;BCP clade;Bilateria;Protostomia;Lophotrochozoa;Platyhelminthes;Rhabditophora;Prolecithophora;";"0.0";"0";"28";"28";"0";"28";"0";"457155";"373894"
"V4mis1";"SILVA (only NR);Eukaryota;Amorphea;Obazoa;Opisthokonta;Holozoa;Choanozoa;Metazoa;Animalia;BCP clade;Bilateria;Protostomia;Lophotrochozoa;Platyhelminthes;Rhabditophora;Rhabdocoela;";"0.0";"0";"287";"287";"0";"287";"0";"456896";"373894"
"V4mis1";"SILVA (only NR);Eukaryota;Amorphea;Obazoa;Opisthokonta;Holozoa;Choanozoa;Metazoa;Animalia;BCP clade;Bilateria;Protostomia;Lophotrochozoa;Platyhelminthes;Rhabditophora;Rhabdocoela;Dalyellioida;";"0.0";"0";"38";"38";"0";"38";"0";"457145";"373894"
"V4mis1";"SILVA (only NR);Eukaryota;Amorphea;Obazoa;Opisthokonta;Holozoa;Choanozoa;Metazoa;Animalia;BCP clade;Bilateria;Protostomia;Lophotrochozoa;Platyhelminthes;Rhabditophora;Rhabdocoela;Kalyptorhynchia;";"0.0";"0";"130";"130";"0";"130";"0";"457053";"373894"
"V4mis1";"SILVA (only NR);Eukaryota;Amorphea;Obazoa;Opisthokonta;Holozoa;Choanozoa;Metazoa;Animalia;BCP clade;Bilateria;Protostomia;Lophotrochozoa;Platyhelminthes;Rhabditophora;Rhabdocoela;Neodalyellida;";"0.0";"0";"114";"114";"0";"114";"0";"457069";"373894"
"V4mis1";"SILVA (only NR);Eukaryota;Amorphea;Obazoa;Opisthokonta;Holozoa;Choanozoa;Metazoa;Animalia;BCP clade;Bilateria;Protostomia;Lophotrochozoa;Platyhelminthes;Rhabditophora;Rhabdocoela;Typhloplanoida;";"0.0";"0";"5";"5";"0";"5";"0";"457178";"373894"
"V4mis1";"SILVA (only NR);Eukaryota;Amorphea;Obazoa;Opisthokonta;Holozoa;Choanozoa;Metazoa;Animalia;BCP clade;Bilateria;Protostomia;Lophotrochozoa;Platyhelminthes;Rhabditophora;Seriata;";"0.0";"0";"330";"327";"0";"327";"3";"456856";"373894"
"V4mis1";"SILVA (only NR);Eukaryota;Amorphea;Obazoa;Opisthokonta;Holozoa;Choanozoa;Metazoa;Animalia;BCP clade;Bilateria;Protostomia;Lophotrochozoa;Platyhelminthes;Rhabditophora;Seriata;Proseriata;";"0.0";"0";"99";"99";"0";"99";"0";"457084";"373894"
"V4mis1";"SILVA (only NR);Eukaryota;Amorphea;Obazoa;Opisthokonta;Holozoa;Choanozoa;Metazoa;Animalia;BCP clade;Bilateria;Protostomia;Lophotrochozoa;Platyhelminthes;Rhabditophora;Seriata;Tricladida;";"0.0";"0";"230";"227";"0";"227";"3";"456956";"373894"
"V4mis1";"SILVA (only NR);Eukaryota;Amorphea;Obazoa;Opisthokonta;Holozoa;Choanozoa;Metazoa;Animalia;BCP clade;Bilateria;Protostomia;Lophotrochozoa;Platyhelminthes;Rhabditophora;Seriata;Tricladida;Continenticola;";"0.0";"0";"213";"210";"0";"210";"3";"456973";"373894"
"V4mis1";"SILVA (only NR);Eukaryota;Amorphea;Obazoa;Opisthokonta;Holozoa;Choanozoa;Metazoa;Animalia;BCP clade;Bilateria;Protostomia;Lophotrochozoa;Platyhelminthes;Rhabditophora;Seriata;Tricladida;Maricola;";"0.0";"0";"15";"15";"0";"15";"0";"457168";"373894"
"V4mis1";"SILVA (only NR);Eukaryota;Amorphea;Obazoa;Opisthokonta;Holozoa;Choanozoa;Metazoa;Animalia;BCP clade;Bilateria;Protostomia;Lophotrochozoa;Platyhelminthes;Trematoda;";"0.0";"0";"360";"356";"0";"356";"4";"456827";"373894"
"V4mis1";"SILVA (only NR);Eukaryota;Amorphea;Obazoa;Opisthokonta;Holozoa;Choanozoa;Metazoa;Animalia;BCP clade;Bilateria;Protostomia;Lophotrochozoa;Platyhelminthes;Trematoda;Aspidogastrea;";"0.0";"0";"9";"9";"0";"9";"0";"457174";"373894"
"V4mis1";"SILVA (only NR);Eukaryota;Amorphea;Obazoa;Opisthokonta;Holozoa;Choanozoa;Metazoa;Animalia;BCP clade;Bilateria;Protostomia;Lophotrochozoa;Platyhelminthes;Trematoda;Aspidogastrea;Aspidogastridae;";"0.0";"0";"7";"7";"0";"7";"0";"457176";"373894"
"V4mis1";"SILVA (only NR);Eukaryota;Amorphea;Obazoa;Opisthokonta;Holozoa;Choanozoa;Metazoa;Animalia;BCP clade;Bilateria;Protostomia;Lophotrochozoa;Platyhelminthes;Trematoda;Digenea;";"0.0";"0";"351";"347";"0";"347";"4";"456836";"373894"
"V4mis1";"SILVA (only NR);Eukaryota;Amorphea;Obazoa;Opisthokonta;Holozoa;Choanozoa;Metazoa;Animalia;BCP clade;Bilateria;Protostomia;Lophotrochozoa;Platyhelminthes;Trematoda;Digenea;Azygiida;";"0.0";"0";"39";"39";"0";"39";"0";"457144";"373894"
"V4mis1";"SILVA (only NR);Eukaryota;Amorphea;Obazoa;Opisthokonta;Holozoa;Choanozoa;Metazoa;Animalia;BCP clade;Bilateria;Protostomia;Lophotrochozoa;Platyhelminthes;Trematoda;Digenea;Diplostomida;";"0.0";"0";"2";"2";"0";"2";"0";"457181";"373894"
"V4mis1";"SILVA (only NR);Eukaryota;Amorphea;Obazoa;Opisthokonta;Holozoa;Choanozoa;Metazoa;Animalia;BCP clade;Bilateria;Protostomia;Lophotrochozoa;Platyhelminthes;Trematoda;Digenea;Diplostomida;Brachylaimoidea;";"0.0";"0";"2";"2";"0";"2";"0";"457181";"373894"
"V4mis1";"SILVA (only NR);Eukaryota;Amorphea;Obazoa;Opisthokonta;Holozoa;Choanozoa;Metazoa;Animalia;BCP clade;Bilateria;Protostomia;Lophotrochozoa;Platyhelminthes;Trematoda;Digenea;Echinostomida;";"0.0";"0";"53";"52";"0";"52";"1";"457131";"373894"
"V4mis1";"SILVA (only NR);Eukaryota;Amorphea;Obazoa;Opisthokonta;Holozoa;Choanozoa;Metazoa;Animalia;BCP clade;Bilateria;Protostomia;Lophotrochozoa;Platyhelminthes;Trematoda;Digenea;Incertae Sedis;";"0.0";"0";"1";"1";"0";"1";"0";"457182";"373894"
"V4mis1";"SILVA (only NR);Eukaryota;Amorphea;Obazoa;Opisthokonta;Holozoa;Choanozoa;Metazoa;Animalia;BCP clade;Bilateria;Protostomia;Lophotrochozoa;Platyhelminthes;Trematoda;Digenea;Incertae Sedis;Prosorhynchoides;";"0.0";"0";"1";"1";"0";"1";"0";"457182";"373894"
"V4mis1";"SILVA (only NR);Eukaryota;Amorphea;Obazoa;Opisthokonta;Holozoa;Choanozoa;Metazoa;Animalia;BCP clade;Bilateria;Protostomia;Lophotrochozoa;Platyhelminthes;Trematoda;Digenea;Opisthorchiida;";"0.0";"0";"36";"35";"0";"35";"1";"457148";"373894"
"V4mis1";"SILVA (only NR);Eukaryota;Amorphea;Obazoa;Opisthokonta;Holozoa;Choanozoa;Metazoa;Animalia;BCP clade;Bilateria;Protostomia;Lophotrochozoa;Platyhelminthes;Trematoda;Digenea;Plagiorchiida;";"0.0";"0";"119";"118";"0";"118";"1";"457065";"373894"
"V4mis1";"SILVA (only NR);Eukaryota;Amorphea;Obazoa;Opisthokonta;Holozoa;Choanozoa;Metazoa;Animalia;BCP clade;Bilateria;Protostomia;Lophotrochozoa;Platyhelminthes;Trematoda;Digenea;Strigeidida;";"0.0";"0";"93";"92";"0";"92";"1";"457091";"373894"
"V4mis1";"SILVA (only NR);Eukaryota;Amorphea;Obazoa;Opisthokonta;Holozoa;Choanozoa;Metazoa;Animalia;BCP clade;Bilateria;Protostomia;Lophotrochozoa;Rotifera;";"0.0";"0";"122";"122";"0";"122";"0";"457061";"373894"
"V4mis1";"SILVA (only NR);Eukaryota;Amorphea;Obazoa;Opisthokonta;Holozoa;Choanozoa;Metazoa;Animalia;BCP clade;Bilateria;Protostomia;Lophotrochozoa;Rotifera;Bdelloidea;";"0.0";"0";"57";"57";"0";"57";"0";"457126";"373894"
"V4mis1";"SILVA (only NR);Eukaryota;Amorphea;Obazoa;Opisthokonta;Holozoa;Choanozoa;Metazoa;Animalia;BCP clade;Bilateria;Protostomia;Lophotrochozoa;Rotifera;Bdelloidea;Adinetida;";"0.0";"0";"28";"28";"0";"28";"0";"457155";"373894"
"V4mis1";"SILVA (only NR);Eukaryota;Amorphea;Obazoa;Opisthokonta;Holozoa;Choanozoa;Metazoa;Animalia;BCP clade;Bilateria;Protostomia;Lophotrochozoa;Rotifera;Bdelloidea;Philodinida;";"0.0";"0";"19";"19";"0";"19";"0";"457164";"373894"
"V4mis1";"SILVA (only NR);Eukaryota;Amorphea;Obazoa;Opisthokonta;Holozoa;Choanozoa;Metazoa;Animalia;BCP clade;Bilateria;Protostomia;Lophotrochozoa;Rotifera;Bdelloidea;Rotaria;";"0.0";"0";"9";"9";"0";"9";"0";"457174";"373894"
"V4mis1";"SILVA (only NR);Eukaryota;Amorphea;Obazoa;Opisthokonta;Holozoa;Choanozoa;Metazoa;Animalia;BCP clade;Bilateria;Protostomia;Lophotrochozoa;Rotifera;Monogononta;";"0.0";"0";"64";"64";"0";"64";"0";"457119";"373894"
"V4mis1";"SILVA (only NR);Eukaryota;Amorphea;Obazoa;Opisthokonta;Holozoa;Choanozoa;Metazoa;Animalia;BCP clade;Bilateria;Protostomia;Lophotrochozoa;Rotifera;Monogononta;Flosculariacea;";"0.0";"0";"16";"16";"0";"16";"0";"457167";"373894"
"V4mis1";"SILVA (only NR);Eukaryota;Amorphea;Obazoa;Opisthokonta;Holozoa;Choanozoa;Metazoa;Animalia;BCP clade;Bilateria;Protostomia;Lophotrochozoa;Rotifera;Monogononta;Ploimida;";"0.0";"0";"48";"48";"0";"48";"0";"457135";"373894"
"V4mis1";"SILVA (only NR);Eukaryota;Amorphea;Obazoa;Opisthokonta;Holozoa;Choanozoa;Metazoa;Animalia;BCP clade;Bilateria;Protostomia;Lophotrochozoa;Xenacoelomorpha;";"1.8";"18.2";"163";"163";"3";"160";"0";"457020";"373891"
"V4mis1";"SILVA (only NR);Eukaryota;Amorphea;Obazoa;Opisthokonta;Holozoa;Choanozoa;Metazoa;Animalia;BCP clade;Bilateria;Protostomia;Lophotrochozoa;Xenacoelomorpha;Acoelomorpha;";"1.8";"18.2";"163";"163";"3";"160";"0";"457020";"373891"
"V4mis1";"SILVA (only NR);Eukaryota;Amorphea;Obazoa;Opisthokonta;Holozoa;Choanozoa;Metazoa;Animalia;BCP clade;Bilateria;Protostomia;Lophotrochozoa;Xenacoelomorpha;Acoelomorpha;Acoela;";"2.2";"18.2";"135";"135";"3";"132";"0";"457048";"373891"
"V4mis1";"SILVA (only NR);Eukaryota;Amorphea;Obazoa;Opisthokonta;Holozoa;Choanozoa;Metazoa;Animalia;BCP clade;Bilateria;Protostomia;Lophotrochozoa;Xenacoelomorpha;Acoelomorpha;Nemertodermatida;";"0.0";"0";"28";"28";"0";"28";"0";"457155";"373894"
"V4mis1";"SILVA (only NR);Eukaryota;Amorphea;Obazoa;Opisthokonta;Holozoa;Choanozoa;Metazoa;Animalia;BCP clade;Bilateria;Protostomia;Lophotrochozoa;Xenacoelomorpha;Acoelomorpha;Nemertodermatida;Nemertodermatidae;";"0.0";"0";"28";"28";"0";"28";"0";"457155";"373894"
"V4mis1";"SILVA (only NR);Eukaryota;Amorphea;Obazoa;Opisthokonta;Holozoa;Choanozoa;Metazoa;Animalia;BCP clade;Bilateria;Protostomia;uncultured;";"0.0";"0";"12";"12";"0";"12";"0";"457171";"373894"
"V4mis1";"SILVA (only NR);Eukaryota;Amorphea;Obazoa;Opisthokonta;Holozoa;Choanozoa;Metazoa;Animalia;BCP clade;Cnidaria;";"0.0";"0";"1397";"1393";"0";"1393";"4";"455790";"373894"
"V4mis1";"SILVA (only NR);Eukaryota;Amorphea;Obazoa;Opisthokonta;Holozoa;Choanozoa;Metazoa;Animalia;BCP clade;Cnidaria;Anthozoa;";"0.0";"0";"313";"313";"0";"313";"0";"456870";"373894"
"V4mis1";"SILVA (only NR);Eukaryota;Amorphea;Obazoa;Opisthokonta;Holozoa;Choanozoa;Metazoa;Animalia;BCP clade;Cnidaria;Anthozoa;Hexacorallia;";"0.0";"0";"209";"209";"0";"209";"0";"456974";"373894"
"V4mis1";"SILVA (only NR);Eukaryota;Amorphea;Obazoa;Opisthokonta;Holozoa;Choanozoa;Metazoa;Animalia;BCP clade;Cnidaria;Anthozoa;Hexacorallia;Actiniaria;";"0.0";"0";"100";"100";"0";"100";"0";"457083";"373894"
"V4mis1";"SILVA (only NR);Eukaryota;Amorphea;Obazoa;Opisthokonta;Holozoa;Choanozoa;Metazoa;Animalia;BCP clade;Cnidaria;Anthozoa;Hexacorallia;Ceriantharia;";"0.0";"0";"6";"6";"0";"6";"0";"457177";"373894"
"V4mis1";"SILVA (only NR);Eukaryota;Amorphea;Obazoa;Opisthokonta;Holozoa;Choanozoa;Metazoa;Animalia;BCP clade;Cnidaria;Anthozoa;Hexacorallia;Corallimorpharia;";"0.0";"0";"9";"9";"0";"9";"0";"457174";"373894"
"V4mis1";"SILVA (only NR);Eukaryota;Amorphea;Obazoa;Opisthokonta;Holozoa;Choanozoa;Metazoa;Animalia;BCP clade;Cnidaria;Anthozoa;Hexacorallia;Scleractinia;";"0.0";"0";"61";"61";"0";"61";"0";"457122";"373894"
"V4mis1";"SILVA (only NR);Eukaryota;Amorphea;Obazoa;Opisthokonta;Holozoa;Choanozoa;Metazoa;Animalia;BCP clade;Cnidaria;Anthozoa;Hexacorallia;Zoantharia;";"0.0";"0";"7";"7";"0";"7";"0";"457176";"373894"
"V4mis1";"SILVA (only NR);Eukaryota;Amorphea;Obazoa;Opisthokonta;Holozoa;Choanozoa;Metazoa;Animalia;BCP clade;Cnidaria;Anthozoa;Octocorallia;";"0.0";"0";"104";"104";"0";"104";"0";"457079";"373894"
"V4mis1";"SILVA (only NR);Eukaryota;Amorphea;Obazoa;Opisthokonta;Holozoa;Choanozoa;Metazoa;Animalia;BCP clade;Cnidaria;Anthozoa;Octocorallia;Alcyonacea;";"0.0";"0";"88";"88";"0";"88";"0";"457095";"373894"
"V4mis1";"SILVA (only NR);Eukaryota;Amorphea;Obazoa;Opisthokonta;Holozoa;Choanozoa;Metazoa;Animalia;BCP clade;Cnidaria;Anthozoa;Octocorallia;Pennatulacea;";"0.0";"0";"8";"8";"0";"8";"0";"457175";"373894"
"V4mis1";"SILVA (only NR);Eukaryota;Amorphea;Obazoa;Opisthokonta;Holozoa;Choanozoa;Metazoa;Animalia;BCP clade;Cnidaria;Cubozoa;";"0.0";"0";"13";"13";"0";"13";"0";"457170";"373894"
"V4mis1";"SILVA (only NR);Eukaryota;Amorphea;Obazoa;Opisthokonta;Holozoa;Choanozoa;Metazoa;Animalia;BCP clade;Cnidaria;Cubozoa;Carybdeida;";"0.0";"0";"10";"10";"0";"10";"0";"457173";"373894"
"V4mis1";"SILVA (only NR);Eukaryota;Amorphea;Obazoa;Opisthokonta;Holozoa;Choanozoa;Metazoa;Animalia;BCP clade;Cnidaria;Cubozoa;Chirodropida;";"0.0";"0";"3";"3";"0";"3";"0";"457180";"373894"
"V4mis1";"SILVA (only NR);Eukaryota;Amorphea;Obazoa;Opisthokonta;Holozoa;Choanozoa;Metazoa;Animalia;BCP clade;Cnidaria;Hydrozoa;";"0.0";"0";"352";"349";"0";"349";"3";"456834";"373894"
"V4mis1";"SILVA (only NR);Eukaryota;Amorphea;Obazoa;Opisthokonta;Holozoa;Choanozoa;Metazoa;Animalia;BCP clade;Cnidaria;Hydrozoa;Hydroidolina;";"0.0";"0";"319";"317";"0";"317";"2";"456866";"373894"
"V4mis1";"SILVA (only NR);Eukaryota;Amorphea;Obazoa;Opisthokonta;Holozoa;Choanozoa;Metazoa;Animalia;BCP clade;Cnidaria;Hydrozoa;Hydroidolina;Anthoathecata;";"0.0";"0";"98";"96";"0";"96";"2";"457087";"373894"
"V4mis1";"SILVA (only NR);Eukaryota;Amorphea;Obazoa;Opisthokonta;Holozoa;Choanozoa;Metazoa;Animalia;BCP clade;Cnidaria;Hydrozoa;Hydroidolina;Leptothecata;";"0.0";"0";"158";"158";"0";"158";"0";"457025";"373894"
"V4mis1";"SILVA (only NR);Eukaryota;Amorphea;Obazoa;Opisthokonta;Holozoa;Choanozoa;Metazoa;Animalia;BCP clade;Cnidaria;Hydrozoa;Hydroidolina;Siphonophorae;";"0.0";"0";"58";"58";"0";"58";"0";"457125";"373894"
"V4mis1";"SILVA (only NR);Eukaryota;Amorphea;Obazoa;Opisthokonta;Holozoa;Choanozoa;Metazoa;Animalia;BCP clade;Cnidaria;Hydrozoa;Trachylinae;";"0.0";"0";"32";"31";"0";"31";"1";"457152";"373894"
"V4mis1";"SILVA (only NR);Eukaryota;Amorphea;Obazoa;Opisthokonta;Holozoa;Choanozoa;Metazoa;Animalia;BCP clade;Cnidaria;Hydrozoa;Trachylinae;Limnomedusae;";"0.0";"0";"9";"9";"0";"9";"0";"457174";"373894"
"V4mis1";"SILVA (only NR);Eukaryota;Amorphea;Obazoa;Opisthokonta;Holozoa;Choanozoa;Metazoa;Animalia;BCP clade;Cnidaria;Hydrozoa;Trachylinae;Narcomedusae;";"0.0";"0";"9";"9";"0";"9";"0";"457174";"373894"
"V4mis1";"SILVA (only NR);Eukaryota;Amorphea;Obazoa;Opisthokonta;Holozoa;Choanozoa;Metazoa;Animalia;BCP clade;Cnidaria;Hydrozoa;Trachylinae;Trachymedusae;";"0.0";"0";"9";"8";"0";"8";"1";"457175";"373894"
"V4mis1";"SILVA (only NR);Eukaryota;Amorphea;Obazoa;Opisthokonta;Holozoa;Choanozoa;Metazoa;Animalia;BCP clade;Cnidaria;Myxozoa;";"0.0";"0";"673";"672";"0";"672";"1";"456511";"373894"
"V4mis1";"SILVA (only NR);Eukaryota;Amorphea;Obazoa;Opisthokonta;Holozoa;Choanozoa;Metazoa;Animalia;BCP clade;Cnidaria;Myxozoa;Malacosporea;";"0.0";"0";"20";"20";"0";"20";"0";"457163";"373894"
"V4mis1";"SILVA (only NR);Eukaryota;Amorphea;Obazoa;Opisthokonta;Holozoa;Choanozoa;Metazoa;Animalia;BCP clade;Cnidaria;Myxozoa;Malacosporea;Malacovalvulida;";"0.0";"0";"20";"20";"0";"20";"0";"457163";"373894"
"V4mis1";"SILVA (only NR);Eukaryota;Amorphea;Obazoa;Opisthokonta;Holozoa;Choanozoa;Metazoa;Animalia;BCP clade;Cnidaria;Myxozoa;Myxosporea;";"0.0";"0";"653";"652";"0";"652";"1";"456531";"373894"
"V4mis1";"SILVA (only NR);Eukaryota;Amorphea;Obazoa;Opisthokonta;Holozoa;Choanozoa;Metazoa;Animalia;BCP clade;Cnidaria;Myxozoa;Myxosporea;Bivalvulida;";"0.0";"0";"587";"586";"0";"586";"1";"456597";"373894"
"V4mis1";"SILVA (only NR);Eukaryota;Amorphea;Obazoa;Opisthokonta;Holozoa;Choanozoa;Metazoa;Animalia;BCP clade;Cnidaria;Myxozoa;Myxosporea;Multivalvulida;";"0.0";"0";"65";"65";"0";"65";"0";"457118";"373894"
"V4mis1";"SILVA (only NR);Eukaryota;Amorphea;Obazoa;Opisthokonta;Holozoa;Choanozoa;Metazoa;Animalia;BCP clade;Cnidaria;Scyphozoa;";"0.0";"0";"46";"46";"0";"46";"0";"457137";"373894"
"V4mis1";"SILVA (only NR);Eukaryota;Amorphea;Obazoa;Opisthokonta;Holozoa;Choanozoa;Metazoa;Animalia;BCP clade;Cnidaria;Scyphozoa;Coronatae;";"0.0";"0";"2";"2";"0";"2";"0";"457181";"373894"
"V4mis1";"SILVA (only NR);Eukaryota;Amorphea;Obazoa;Opisthokonta;Holozoa;Choanozoa;Metazoa;Animalia;BCP clade;Cnidaria;Scyphozoa;Rhizostomeae;";"0.0";"0";"12";"12";"0";"12";"0";"457171";"373894"
"V4mis1";"SILVA (only NR);Eukaryota;Amorphea;Obazoa;Opisthokonta;Holozoa;Choanozoa;Metazoa;Animalia;BCP clade;Cnidaria;Scyphozoa;Semaeostomeae;";"0.0";"0";"19";"19";"0";"19";"0";"457164";"373894"
"V4mis1";"SILVA (only NR);Eukaryota;Amorphea;Obazoa;Opisthokonta;Holozoa;Choanozoa;Metazoa;Animalia;BCP clade;Cnidaria;Scyphozoa;Stauromedusae;";"0.0";"0";"10";"10";"0";"10";"0";"457173";"373894"
"V4mis1";"SILVA (only NR);Eukaryota;Amorphea;Obazoa;Opisthokonta;Holozoa;Choanozoa;Metazoa;Animalia;BCP clade;Ctenophora;";"0.0";"0";"27";"26";"0";"26";"1";"457157";"373894"
"V4mis1";"SILVA (only NR);Eukaryota;Amorphea;Obazoa;Opisthokonta;Holozoa;Choanozoa;Metazoa;Animalia;BCP clade;Ctenophora;Nuda;";"0.0";"0";"2";"2";"0";"2";"0";"457181";"373894"
"V4mis1";"SILVA (only NR);Eukaryota;Amorphea;Obazoa;Opisthokonta;Holozoa;Choanozoa;Metazoa;Animalia;BCP clade;Ctenophora;Nuda;Beroida;";"0.0";"0";"2";"2";"0";"2";"0";"457181";"373894"
"V4mis1";"SILVA (only NR);Eukaryota;Amorphea;Obazoa;Opisthokonta;Holozoa;Choanozoa;Metazoa;Animalia;BCP clade;Ctenophora;Tentaculata;";"0.0";"0";"18";"17";"0";"17";"1";"457166";"373894"
"V4mis1";"SILVA (only NR);Eukaryota;Amorphea;Obazoa;Opisthokonta;Holozoa;Choanozoa;Metazoa;Animalia;BCP clade;Ctenophora;Tentaculata;Cydippida;";"0.0";"0";"12";"11";"0";"11";"1";"457172";"373894"
"V4mis1";"SILVA (only NR);Eukaryota;Amorphea;Obazoa;Opisthokonta;Holozoa;Choanozoa;Metazoa;Animalia;BCP clade;Ctenophora;Tentaculata;Lobata;";"0.0";"0";"2";"2";"0";"2";"0";"457181";"373894"
"V4mis1";"SILVA (only NR);Eukaryota;Amorphea;Obazoa;Opisthokonta;Holozoa;Choanozoa;Metazoa;Animalia;BCP clade;Ctenophora;Tentaculata;Platyctenida;";"0.0";"0";"2";"2";"0";"2";"0";"457181";"373894"
"V4mis1";"SILVA (only NR);Eukaryota;Amorphea;Obazoa;Opisthokonta;Holozoa;Choanozoa;Metazoa;Animalia;BCP clade;Mesozoa;";"0.0";"0";"26";"26";"0";"26";"0";"457157";"373894"
"V4mis1";"SILVA (only NR);Eukaryota;Amorphea;Obazoa;Opisthokonta;Holozoa;Choanozoa;Metazoa;Animalia;BCP clade;Mesozoa;Orthonectida;";"0.0";"0";"3";"3";"0";"3";"0";"457180";"373894"
"V4mis1";"SILVA (only NR);Eukaryota;Amorphea;Obazoa;Opisthokonta;Holozoa;Choanozoa;Metazoa;Animalia;BCP clade;Mesozoa;Orthonectida;Rhopaluridae;";"0.0";"0";"3";"3";"0";"3";"0";"457180";"373894"
"V4mis1";"SILVA (only NR);Eukaryota;Amorphea;Obazoa;Opisthokonta;Holozoa;Choanozoa;Metazoa;Animalia;BCP clade;Mesozoa;Rhombozoa;";"0.0";"0";"20";"20";"0";"20";"0";"457163";"373894"
"V4mis1";"SILVA (only NR);Eukaryota;Amorphea;Obazoa;Opisthokonta;Holozoa;Choanozoa;Metazoa;Animalia;BCP clade;Mesozoa;Rhombozoa;Dicyemida;";"0.0";"0";"20";"20";"0";"20";"0";"457163";"373894"
"V4mis1";"SILVA (only NR);Eukaryota;Amorphea;Obazoa;Opisthokonta;Holozoa;Choanozoa;Metazoa;Animalia;BCP clade;Mesozoa;Rhombozoa;Dicyemida;Dicyema;";"0.0";"0";"8";"8";"0";"8";"0";"457175";"373894"
"V4mis1";"SILVA (only NR);Eukaryota;Amorphea;Obazoa;Opisthokonta;Holozoa;Choanozoa;Metazoa;Animalia;BCP clade;Mesozoa;Rhombozoa;Dicyemida;Dicyemennea;";"0.0";"0";"5";"5";"0";"5";"0";"457178";"373894"
"V4mis1";"SILVA (only NR);Eukaryota;Amorphea;Obazoa;Opisthokonta;Holozoa;Choanozoa;Metazoa;Animalia;BCP clade;Placozoa;";"0.0";"0";"4";"3";"0";"3";"1";"457180";"373894"
"V4mis1";"SILVA (only NR);Eukaryota;Amorphea;Obazoa;Opisthokonta;Holozoa;Choanozoa;Metazoa;Animalia;BCP clade;Placozoa;Trichoplax;";"0.0";"0";"4";"3";"0";"3";"1";"457180";"373894"
"V4mis1";"SILVA (only NR);Eukaryota;Amorphea;Obazoa;Opisthokonta;Holozoa;Choanozoa;Metazoa;Porifera;";"0.3";"18.1";"396";"395";"1";"394";"1";"456788";"373893"
"V4mis1";"SILVA (only NR);Eukaryota;Amorphea;Obazoa;Opisthokonta;Holozoa;Choanozoa;Metazoa;Porifera;Calcarea;";"0.0";"0";"34";"34";"0";"34";"0";"457149";"373894"
"V4mis1";"SILVA (only NR);Eukaryota;Amorphea;Obazoa;Opisthokonta;Holozoa;Choanozoa;Metazoa;Porifera;Calcarea;Calcaronea;";"0.0";"0";"14";"14";"0";"14";"0";"457169";"373894"
"V4mis1";"SILVA (only NR);Eukaryota;Amorphea;Obazoa;Opisthokonta;Holozoa;Choanozoa;Metazoa;Porifera;Calcarea;Calcaronea;Leucosolenida;";"0.0";"0";"9";"9";"0";"9";"0";"457174";"373894"
"V4mis1";"SILVA (only NR);Eukaryota;Amorphea;Obazoa;Opisthokonta;Holozoa;Choanozoa;Metazoa;Porifera;Calcarea;Calcinea;";"0.0";"0";"20";"20";"0";"20";"0";"457163";"373894"
"V4mis1";"SILVA (only NR);Eukaryota;Amorphea;Obazoa;Opisthokonta;Holozoa;Choanozoa;Metazoa;Porifera;Calcarea;Calcinea;Clathrinida;";"0.0";"0";"18";"18";"0";"18";"0";"457165";"373894"
"V4mis1";"SILVA (only NR);Eukaryota;Amorphea;Obazoa;Opisthokonta;Holozoa;Choanozoa;Metazoa;Porifera;Calcarea;Calcinea;Murrayonida;";"0.0";"0";"2";"2";"0";"2";"0";"457181";"373894"
"V4mis1";"SILVA (only NR);Eukaryota;Amorphea;Obazoa;Opisthokonta;Holozoa;Choanozoa;Metazoa;Porifera;DemHex clade;";"0.0";"0";"26";"26";"0";"26";"0";"457157";"373894"
"V4mis1";"SILVA (only NR);Eukaryota;Amorphea;Obazoa;Opisthokonta;Holozoa;Choanozoa;Metazoa;Porifera;DemHex clade;Hexactinellida;";"0.0";"0";"26";"26";"0";"26";"0";"457157";"373894"
"V4mis1";"SILVA (only NR);Eukaryota;Amorphea;Obazoa;Opisthokonta;Holozoa;Choanozoa;Metazoa;Porifera;DemHex clade;Hexactinellida;Amphidiscophora;";"0.0";"0";"3";"3";"0";"3";"0";"457180";"373894"
"V4mis1";"SILVA (only NR);Eukaryota;Amorphea;Obazoa;Opisthokonta;Holozoa;Choanozoa;Metazoa;Porifera;DemHex clade;Hexactinellida;Amphidiscophora;Amphidiscosida;";"0.0";"0";"3";"3";"0";"3";"0";"457180";"373894"
"V4mis1";"SILVA (only NR);Eukaryota;Amorphea;Obazoa;Opisthokonta;Holozoa;Choanozoa;Metazoa;Porifera;DemHex clade;Hexactinellida;Hexasterophora;";"0.0";"0";"23";"23";"0";"23";"0";"457160";"373894"
"V4mis1";"SILVA (only NR);Eukaryota;Amorphea;Obazoa;Opisthokonta;Holozoa;Choanozoa;Metazoa;Porifera;DemHex clade;Hexactinellida;Hexasterophora;Hexactinosida;";"0.0";"0";"14";"14";"0";"14";"0";"457169";"373894"
"V4mis1";"SILVA (only NR);Eukaryota;Amorphea;Obazoa;Opisthokonta;Holozoa;Choanozoa;Metazoa;Porifera;DemHex clade;Hexactinellida;Hexasterophora;Lyssacinosida;";"0.0";"0";"9";"9";"0";"9";"0";"457174";"373894"
"V4mis1";"SILVA (only NR);Eukaryota;Amorphea;Obazoa;Opisthokonta;Holozoa;Choanozoa;Metazoa;Porifera;Demospongiae;";"0.0";"0";"315";"315";"0";"315";"0";"456868";"373894"
"V4mis1";"SILVA (only NR);Eukaryota;Amorphea;Obazoa;Opisthokonta;Holozoa;Choanozoa;Metazoa;Porifera;Demospongiae;Axinellida;";"0.0";"0";"15";"15";"0";"15";"0";"457168";"373894"
"V4mis1";"SILVA (only NR);Eukaryota;Amorphea;Obazoa;Opisthokonta;Holozoa;Choanozoa;Metazoa;Porifera;Demospongiae;Biemnida;";"0.0";"0";"3";"3";"0";"3";"0";"457180";"373894"
"V4mis1";"SILVA (only NR);Eukaryota;Amorphea;Obazoa;Opisthokonta;Holozoa;Choanozoa;Metazoa;Porifera;Demospongiae;Bubarida;";"0.0";"0";"8";"8";"0";"8";"0";"457175";"373894"
"V4mis1";"SILVA (only NR);Eukaryota;Amorphea;Obazoa;Opisthokonta;Holozoa;Choanozoa;Metazoa;Porifera;Demospongiae;Clionaida;";"0.0";"0";"4";"4";"0";"4";"0";"457179";"373894"
"V4mis1";"SILVA (only NR);Eukaryota;Amorphea;Obazoa;Opisthokonta;Holozoa;Choanozoa;Metazoa;Porifera;Demospongiae;Dendroceratida;";"0.0";"0";"3";"3";"0";"3";"0";"457180";"373894"
"V4mis1";"SILVA (only NR);Eukaryota;Amorphea;Obazoa;Opisthokonta;Holozoa;Choanozoa;Metazoa;Porifera;Demospongiae;Dictyoceratida;";"0.0";"0";"27";"27";"0";"27";"0";"457156";"373894"
"V4mis1";"SILVA (only NR);Eukaryota;Amorphea;Obazoa;Opisthokonta;Holozoa;Choanozoa;Metazoa;Porifera;Demospongiae;Hadromerida;";"0.0";"0";"5";"5";"0";"5";"0";"457178";"373894"
"V4mis1";"SILVA (only NR);Eukaryota;Amorphea;Obazoa;Opisthokonta;Holozoa;Choanozoa;Metazoa;Porifera;Demospongiae;Halichondrida;";"0.0";"0";"3";"3";"0";"3";"0";"457180";"373894"
"V4mis1";"SILVA (only NR);Eukaryota;Amorphea;Obazoa;Opisthokonta;Holozoa;Choanozoa;Metazoa;Porifera;Demospongiae;Haplosclerida;";"0.0";"0";"69";"69";"0";"69";"0";"457114";"373894"
"V4mis1";"SILVA (only NR);Eukaryota;Amorphea;Obazoa;Opisthokonta;Holozoa;Choanozoa;Metazoa;Porifera;Demospongiae;Lithistida;";"0.0";"0";"2";"2";"0";"2";"0";"457181";"373894"
"V4mis1";"SILVA (only NR);Eukaryota;Amorphea;Obazoa;Opisthokonta;Holozoa;Choanozoa;Metazoa;Porifera;Demospongiae;Poecilosclerida;";"0.0";"0";"83";"83";"0";"83";"0";"457100";"373894"
"V4mis1";"SILVA (only NR);Eukaryota;Amorphea;Obazoa;Opisthokonta;Holozoa;Choanozoa;Metazoa;Porifera;Demospongiae;Polymastiida;";"0.0";"0";"4";"4";"0";"4";"0";"457179";"373894"
"V4mis1";"SILVA (only NR);Eukaryota;Amorphea;Obazoa;Opisthokonta;Holozoa;Choanozoa;Metazoa;Porifera;Demospongiae;Spongillida;";"0.0";"0";"5";"5";"0";"5";"0";"457178";"373894"
"V4mis1";"SILVA (only NR);Eukaryota;Amorphea;Obazoa;Opisthokonta;Holozoa;Choanozoa;Metazoa;Porifera;Demospongiae;Suberitida;";"0.0";"0";"19";"19";"0";"19";"0";"457164";"373894"
"V4mis1";"SILVA (only NR);Eukaryota;Amorphea;Obazoa;Opisthokonta;Holozoa;Choanozoa;Metazoa;Porifera;Demospongiae;Tetractinellida;";"0.0";"0";"23";"23";"0";"23";"0";"457160";"373894"
"V4mis1";"SILVA (only NR);Eukaryota;Amorphea;Obazoa;Opisthokonta;Holozoa;Choanozoa;Metazoa;Porifera;Demospongiae;Verongiida;";"0.0";"0";"12";"12";"0";"12";"0";"457171";"373894"
"V4mis1";"SILVA (only NR);Eukaryota;Amorphea;Obazoa;Opisthokonta;Holozoa;Choanozoa;Metazoa;Porifera;Homoscleromorpha;";"5.0";"18.2";"20";"20";"1";"19";"0";"457163";"373893"
"V4mis1";"SILVA (only NR);Eukaryota;Amorphea;Obazoa;Opisthokonta;Holozoa;Choanozoa;Metazoa;Porifera;Homoscleromorpha;Homosclerophorida;";"5.0";"18.2";"20";"20";"1";"19";"0";"457163";"373893"
"V4mis1";"SILVA (only NR);Eukaryota;Amorphea;Obazoa;Opisthokonta;Nucletmycea;";"1.0";"16.5";"9451";"9398";"93";"9305";"53";"447785";"373801"
"V4mis1";"SILVA (only NR);Eukaryota;Amorphea;Obazoa;Opisthokonta;Nucletmycea;Aphelidea;";"0.0";"0";"49";"49";"0";"49";"0";"457134";"373894"
"V4mis1";"SILVA (only NR);Eukaryota;Amorphea;Obazoa;Opisthokonta;Nucletmycea;Aphelidea;Aphelidium;";"0.0";"0";"9";"9";"0";"9";"0";"457174";"373894"
"V4mis1";"SILVA (only NR);Eukaryota;Amorphea;Obazoa;Opisthokonta;Nucletmycea;Aphelidea;Paraphelidium;";"0.0";"0";"11";"11";"0";"11";"0";"457172";"373894"
"V4mis1";"SILVA (only NR);Eukaryota;Amorphea;Obazoa;Opisthokonta;Nucletmycea;Aphelidea;uncultured;";"0.0";"0";"25";"25";"0";"25";"0";"457158";"373894"
"V4mis1";"SILVA (only NR);Eukaryota;Amorphea;Obazoa;Opisthokonta;Nucletmycea;Fungi;";"1.0";"16.5";"9373";"9321";"93";"9228";"52";"447862";"373801"
"V4mis1";"SILVA (only NR);Eukaryota;Amorphea;Obazoa;Opisthokonta;Nucletmycea;Fungi;Blastocladiomycota;";"18.2";"18.2";"33";"33";"6";"27";"0";"457150";"373888"
"V4mis1";"SILVA (only NR);Eukaryota;Amorphea;Obazoa;Opisthokonta;Nucletmycea;Fungi;Blastocladiomycota;Incertae Sedis;";"18.2";"18.2";"33";"33";"6";"27";"0";"457150";"373888"
"V4mis1";"SILVA (only NR);Eukaryota;Amorphea;Obazoa;Opisthokonta;Nucletmycea;Fungi;Blastocladiomycota;Incertae Sedis;Blastocladiomycetes;";"18.2";"18.2";"33";"33";"6";"27";"0";"457150";"373888"
"V4mis1";"SILVA (only NR);Eukaryota;Amorphea;Obazoa;Opisthokonta;Nucletmycea;Fungi;Blastocladiomycota;Incertae Sedis;Blastocladiomycetes;Blastocladiales;";"18.2";"18.2";"33";"33";"6";"27";"0";"457150";"373888"
"V4mis1";"SILVA (only NR);Eukaryota;Amorphea;Obazoa;Opisthokonta;Nucletmycea;Fungi;Blastocladiomycota;Incertae Sedis;Blastocladiomycetes;Blastocladiales;Blastocladiaceae;";"0.0";"0";"19";"19";"0";"19";"0";"457164";"373894"
"V4mis1";"SILVA (only NR);Eukaryota;Amorphea;Obazoa;Opisthokonta;Nucletmycea;Fungi;Blastocladiomycota;Incertae Sedis;Blastocladiomycetes;Blastocladiales;Blastocladiaceae;Allomyces;";"0.0";"0";"10";"10";"0";"10";"0";"457173";"373894"
"V4mis1";"SILVA (only NR);Eukaryota;Amorphea;Obazoa;Opisthokonta;Nucletmycea;Fungi;Blastocladiomycota;Incertae Sedis;Blastocladiomycetes;Blastocladiales;Blastocladiaceae;Blastocladia;";"0.0";"0";"4";"4";"0";"4";"0";"457179";"373894"
"V4mis1";"SILVA (only NR);Eukaryota;Amorphea;Obazoa;Opisthokonta;Nucletmycea;Fungi;Blastocladiomycota;Incertae Sedis;Blastocladiomycetes;Blastocladiales;Blastocladiaceae;Blastocladiella;";"0.0";"0";"4";"4";"0";"4";"0";"457179";"373894"
"V4mis1";"SILVA (only NR);Eukaryota;Amorphea;Obazoa;Opisthokonta;Nucletmycea;Fungi;Blastocladiomycota;Incertae Sedis;Blastocladiomycetes;Blastocladiales;Blastocladiaceae;Microallomyces;";"0.0";"0";"1";"1";"0";"1";"0";"457182";"373894"
"V4mis1";"SILVA (only NR);Eukaryota;Amorphea;Obazoa;Opisthokonta;Nucletmycea;Fungi;Blastocladiomycota;Incertae Sedis;Blastocladiomycetes;Blastocladiales;Catenaria;";"100.0";"18.2";"6";"6";"6";"0";"0";"457177";"373888"
"V4mis1";"SILVA (only NR);Eukaryota;Amorphea;Obazoa;Opisthokonta;Nucletmycea;Fungi;Blastocladiomycota;Incertae Sedis;Blastocladiomycetes;Blastocladiales;Coelomomyces;";"0.0";"0";"1";"1";"0";"1";"0";"457182";"373894"
"V4mis1";"SILVA (only NR);Eukaryota;Amorphea;Obazoa;Opisthokonta;Nucletmycea;Fungi;Blastocladiomycota;Incertae Sedis;Blastocladiomycetes;Blastocladiales;Physodermataceae;";"0.0";"0";"6";"6";"0";"6";"0";"457177";"373894"
"V4mis1";"SILVA (only NR);Eukaryota;Amorphea;Obazoa;Opisthokonta;Nucletmycea;Fungi;Blastocladiomycota;Incertae Sedis;Blastocladiomycetes;Blastocladiales;Physodermataceae;Paraphysoderma;";"0.0";"0";"1";"1";"0";"1";"0";"457182";"373894"
"V4mis1";"SILVA (only NR);Eukaryota;Amorphea;Obazoa;Opisthokonta;Nucletmycea;Fungi;Blastocladiomycota;Incertae Sedis;Blastocladiomycetes;Blastocladiales;Physodermataceae;Physoderma;";"0.0";"0";"3";"3";"0";"3";"0";"457180";"373894"
"V4mis1";"SILVA (only NR);Eukaryota;Amorphea;Obazoa;Opisthokonta;Nucletmycea;Fungi;Blastocladiomycota;Incertae Sedis;Blastocladiomycetes;Blastocladiales;Physodermataceae;Urophlyctis;";"0.0";"0";"1";"1";"0";"1";"0";"457182";"373894"
"V4mis1";"SILVA (only NR);Eukaryota;Amorphea;Obazoa;Opisthokonta;Nucletmycea;Fungi;Chytridiomycota;";"0.3";"18.2";"319";"315";"1";"314";"4";"456868";"373893"
"V4mis1";"SILVA (only NR);Eukaryota;Amorphea;Obazoa;Opisthokonta;Nucletmycea;Fungi;Chytridiomycota;Incertae Sedis;";"0.3";"18.2";"319";"315";"1";"314";"4";"456868";"373893"
"V4mis1";"SILVA (only NR);Eukaryota;Amorphea;Obazoa;Opisthokonta;Nucletmycea;Fungi;Chytridiomycota;Incertae Sedis;Chytridiomycetes;";"0.3";"18.2";"306";"302";"1";"301";"4";"456881";"373893"
"V4mis1";"SILVA (only NR);Eukaryota;Amorphea;Obazoa;Opisthokonta;Nucletmycea;Fungi;Chytridiomycota;Incertae Sedis;Chytridiomycetes;Chytridiales;";"3.4";"18.2";"30";"29";"1";"28";"1";"457154";"373893"
"V4mis1";"SILVA (only NR);Eukaryota;Amorphea;Obazoa;Opisthokonta;Nucletmycea;Fungi;Chytridiomycota;Incertae Sedis;Chytridiomycetes;Chytridiales;Chytridiaceae;";"0.0";"0";"10";"10";"0";"10";"0";"457173";"373894"
"V4mis1";"SILVA (only NR);Eukaryota;Amorphea;Obazoa;Opisthokonta;Nucletmycea;Fungi;Chytridiomycota;Incertae Sedis;Chytridiomycetes;Chytridiales;Chytridiaceae;Chytridium;";"0.0";"0";"1";"1";"0";"1";"0";"457182";"373894"
"V4mis1";"SILVA (only NR);Eukaryota;Amorphea;Obazoa;Opisthokonta;Nucletmycea;Fungi;Chytridiomycota;Incertae Sedis;Chytridiomycetes;Chytridiales;Chytridiaceae;Dendrochytridium;";"0.0";"0";"2";"2";"0";"2";"0";"457181";"373894"
"V4mis1";"SILVA (only NR);Eukaryota;Amorphea;Obazoa;Opisthokonta;Nucletmycea;Fungi;Chytridiomycota;Incertae Sedis;Chytridiomycetes;Chytridiales;Chytridiaceae;uncultured;";"0.0";"0";"7";"7";"0";"7";"0";"457176";"373894"
"V4mis1";"SILVA (only NR);Eukaryota;Amorphea;Obazoa;Opisthokonta;Nucletmycea;Fungi;Chytridiomycota;Incertae Sedis;Chytridiomycetes;Chytridiales;Chytriomycetaceae;";"9.1";"18.2";"12";"11";"1";"10";"1";"457172";"373893"
"V4mis1";"SILVA (only NR);Eukaryota;Amorphea;Obazoa;Opisthokonta;Nucletmycea;Fungi;Chytridiomycota;Incertae Sedis;Chytridiomycetes;Chytridiales;Chytriomycetaceae;Chytriomyces;";"0.0";"0";"2";"2";"0";"2";"0";"457181";"373894"
"V4mis1";"SILVA (only NR);Eukaryota;Amorphea;Obazoa;Opisthokonta;Nucletmycea;Fungi;Chytridiomycota;Incertae Sedis;Chytridiomycetes;Chytridiales;Chytriomycetaceae;Entophlyctis;";"0.0";"0";"1";"1";"0";"1";"0";"457182";"373894"
"V4mis1";"SILVA (only NR);Eukaryota;Amorphea;Obazoa;Opisthokonta;Nucletmycea;Fungi;Chytridiomycota;Incertae Sedis;Chytridiomycetes;Chytridiales;Chytriomycetaceae;Rhizoclosmatium;";"0.0";"0";"3";"2";"0";"2";"1";"457181";"373894"
"V4mis1";"SILVA (only NR);Eukaryota;Amorphea;Obazoa;Opisthokonta;Nucletmycea;Fungi;Chytridiomycota;Incertae Sedis;Chytridiomycetes;Chytridiales;Incertae Sedis;";"0.0";"0";"8";"8";"0";"8";"0";"457175";"373894"
"V4mis1";"SILVA (only NR);Eukaryota;Amorphea;Obazoa;Opisthokonta;Nucletmycea;Fungi;Chytridiomycota;Incertae Sedis;Chytridiomycetes;Chytridiales;Incertae Sedis;Pseudorhizidium;";"0.0";"0";"1";"1";"0";"1";"0";"457182";"373894"
"V4mis1";"SILVA (only NR);Eukaryota;Amorphea;Obazoa;Opisthokonta;Nucletmycea;Fungi;Chytridiomycota;Incertae Sedis;Chytridiomycetes;Chytridiales;Incertae Sedis;Zygorhizidium;";"0.0";"0";"2";"2";"0";"2";"0";"457181";"373894"
"V4mis1";"SILVA (only NR);Eukaryota;Amorphea;Obazoa;Opisthokonta;Nucletmycea;Fungi;Chytridiomycota;Incertae Sedis;Chytridiomycetes;Cladochytriales;";"0.0";"0";"10";"10";"0";"10";"0";"457173";"373894"
"V4mis1";"SILVA (only NR);Eukaryota;Amorphea;Obazoa;Opisthokonta;Nucletmycea;Fungi;Chytridiomycota;Incertae Sedis;Chytridiomycetes;Cladochytriales;Cladochytriaceae;";"0.0";"0";"3";"3";"0";"3";"0";"457180";"373894"
"V4mis1";"SILVA (only NR);Eukaryota;Amorphea;Obazoa;Opisthokonta;Nucletmycea;Fungi;Chytridiomycota;Incertae Sedis;Chytridiomycetes;Cladochytriales;Cladochytriaceae;Cladochytrium;";"0.0";"0";"3";"3";"0";"3";"0";"457180";"373894"
"V4mis1";"SILVA (only NR);Eukaryota;Amorphea;Obazoa;Opisthokonta;Nucletmycea;Fungi;Chytridiomycota;Incertae Sedis;Chytridiomycetes;Cladochytriales;Nowakowskiellaceae;";"0.0";"0";"7";"7";"0";"7";"0";"457176";"373894"
"V4mis1";"SILVA (only NR);Eukaryota;Amorphea;Obazoa;Opisthokonta;Nucletmycea;Fungi;Chytridiomycota;Incertae Sedis;Chytridiomycetes;Cladochytriales;Nowakowskiellaceae;Nowakowskiella;";"0.0";"0";"7";"7";"0";"7";"0";"457176";"373894"
"V4mis1";"SILVA (only NR);Eukaryota;Amorphea;Obazoa;Opisthokonta;Nucletmycea;Fungi;Chytridiomycota;Incertae Sedis;Chytridiomycetes;Gromochytriales;";"0.0";"0";"22";"22";"0";"22";"0";"457161";"373894"
"V4mis1";"SILVA (only NR);Eukaryota;Amorphea;Obazoa;Opisthokonta;Nucletmycea;Fungi;Chytridiomycota;Incertae Sedis;Chytridiomycetes;Gromochytriales;Gromochytriaceae;";"0.0";"0";"22";"22";"0";"22";"0";"457161";"373894"
"V4mis1";"SILVA (only NR);Eukaryota;Amorphea;Obazoa;Opisthokonta;Nucletmycea;Fungi;Chytridiomycota;Incertae Sedis;Chytridiomycetes;Gromochytriales;Gromochytriaceae;Gromochytrium;";"0.0";"0";"1";"1";"0";"1";"0";"457182";"373894"
"V4mis1";"SILVA (only NR);Eukaryota;Amorphea;Obazoa;Opisthokonta;Nucletmycea;Fungi;Chytridiomycota;Incertae Sedis;Chytridiomycetes;Gromochytriales;Gromochytriaceae;uncultured;";"0.0";"0";"19";"19";"0";"19";"0";"457164";"373894"
"V4mis1";"SILVA (only NR);Eukaryota;Amorphea;Obazoa;Opisthokonta;Nucletmycea;Fungi;Chytridiomycota;Incertae Sedis;Chytridiomycetes;Incertae Sedis;";"0.0";"0";"19";"18";"0";"18";"1";"457165";"373894"
"V4mis1";"SILVA (only NR);Eukaryota;Amorphea;Obazoa;Opisthokonta;Nucletmycea;Fungi;Chytridiomycota;Incertae Sedis;Chytridiomycetes;Incertae Sedis;Incertae Sedis;";"0.0";"0";"5";"5";"0";"5";"0";"457178";"373894"
"V4mis1";"SILVA (only NR);Eukaryota;Amorphea;Obazoa;Opisthokonta;Nucletmycea;Fungi;Chytridiomycota;Incertae Sedis;Chytridiomycetes;Incertae Sedis;Incertae Sedis;Blyttiomyces;";"0.0";"0";"1";"1";"0";"1";"0";"457182";"373894"
"V4mis1";"SILVA (only NR);Eukaryota;Amorphea;Obazoa;Opisthokonta;Nucletmycea;Fungi;Chytridiomycota;Incertae Sedis;Chytridiomycetes;Incertae Sedis;Incertae Sedis;Catenomyces;";"0.0";"0";"2";"2";"0";"2";"0";"457181";"373894"
"V4mis1";"SILVA (only NR);Eukaryota;Amorphea;Obazoa;Opisthokonta;Nucletmycea;Fungi;Chytridiomycota;Incertae Sedis;Chytridiomycetes;Incertae Sedis;Synchytriaceae;";"0.0";"0";"14";"13";"0";"13";"1";"457170";"373894"
"V4mis1";"SILVA (only NR);Eukaryota;Amorphea;Obazoa;Opisthokonta;Nucletmycea;Fungi;Chytridiomycota;Incertae Sedis;Chytridiomycetes;Incertae Sedis;Synchytriaceae;Synchytrium;";"0.0";"0";"14";"13";"0";"13";"1";"457170";"373894"
"V4mis1";"SILVA (only NR);Eukaryota;Amorphea;Obazoa;Opisthokonta;Nucletmycea;Fungi;Chytridiomycota;Incertae Sedis;Chytridiomycetes;Lobulomycetales;";"0.0";"0";"33";"32";"0";"32";"1";"457151";"373894"
"V4mis1";"SILVA (only NR);Eukaryota;Amorphea;Obazoa;Opisthokonta;Nucletmycea;Fungi;Chytridiomycota;Incertae Sedis;Chytridiomycetes;Lobulomycetales;Lobulomycetaceae;";"0.0";"0";"33";"32";"0";"32";"1";"457151";"373894"
"V4mis1";"SILVA (only NR);Eukaryota;Amorphea;Obazoa;Opisthokonta;Nucletmycea;Fungi;Chytridiomycota;Incertae Sedis;Chytridiomycetes;Lobulomycetales;Lobulomycetaceae;Clydaea;";"0.0";"0";"1";"1";"0";"1";"0";"457182";"373894"
"V4mis1";"SILVA (only NR);Eukaryota;Amorphea;Obazoa;Opisthokonta;Nucletmycea;Fungi;Chytridiomycota;Incertae Sedis;Chytridiomycetes;Lobulomycetales;Lobulomycetaceae;Lobulomyces;";"0.0";"0";"3";"3";"0";"3";"0";"457180";"373894"
"V4mis1";"SILVA (only NR);Eukaryota;Amorphea;Obazoa;Opisthokonta;Nucletmycea;Fungi;Chytridiomycota;Incertae Sedis;Chytridiomycetes;Lobulomycetales;Lobulomycetaceae;uncultured;";"0.0";"0";"24";"23";"0";"23";"1";"457160";"373894"
"V4mis1";"SILVA (only NR);Eukaryota;Amorphea;Obazoa;Opisthokonta;Nucletmycea;Fungi;Chytridiomycota;Incertae Sedis;Chytridiomycetes;Polychytriales;";"0.0";"0";"12";"12";"0";"12";"0";"457171";"373894"
"V4mis1";"SILVA (only NR);Eukaryota;Amorphea;Obazoa;Opisthokonta;Nucletmycea;Fungi;Chytridiomycota;Incertae Sedis;Chytridiomycetes;Polychytriales;Incertae Sedis;";"0.0";"0";"12";"12";"0";"12";"0";"457171";"373894"
"V4mis1";"SILVA (only NR);Eukaryota;Amorphea;Obazoa;Opisthokonta;Nucletmycea;Fungi;Chytridiomycota;Incertae Sedis;Chytridiomycetes;Polychytriales;Incertae Sedis;Arkaya;";"0.0";"0";"3";"3";"0";"3";"0";"457180";"373894"
"V4mis1";"SILVA (only NR);Eukaryota;Amorphea;Obazoa;Opisthokonta;Nucletmycea;Fungi;Chytridiomycota;Incertae Sedis;Chytridiomycetes;Polychytriales;Incertae Sedis;Karlingiomyces;";"0.0";"0";"2";"2";"0";"2";"0";"457181";"373894"
"V4mis1";"SILVA (only NR);Eukaryota;Amorphea;Obazoa;Opisthokonta;Nucletmycea;Fungi;Chytridiomycota;Incertae Sedis;Chytridiomycetes;Polychytriales;Incertae Sedis;Neokarlingia;";"0.0";"0";"1";"1";"0";"1";"0";"457182";"373894"
"V4mis1";"SILVA (only NR);Eukaryota;Amorphea;Obazoa;Opisthokonta;Nucletmycea;Fungi;Chytridiomycota;Incertae Sedis;Chytridiomycetes;Polychytriales;Incertae Sedis;Polychytrium;";"0.0";"0";"1";"1";"0";"1";"0";"457182";"373894"
"V4mis1";"SILVA (only NR);Eukaryota;Amorphea;Obazoa;Opisthokonta;Nucletmycea;Fungi;Chytridiomycota;Incertae Sedis;Chytridiomycetes;Polychytriales;Incertae Sedis;Polytrychium;";"0.0";"0";"2";"2";"0";"2";"0";"457181";"373894"
"V4mis1";"SILVA (only NR);Eukaryota;Amorphea;Obazoa;Opisthokonta;Nucletmycea;Fungi;Chytridiomycota;Incertae Sedis;Chytridiomycetes;Rhizophlyctidales;";"0.0";"0";"3";"3";"0";"3";"0";"457180";"373894"
"V4mis1";"SILVA (only NR);Eukaryota;Amorphea;Obazoa;Opisthokonta;Nucletmycea;Fungi;Chytridiomycota;Incertae Sedis;Chytridiomycetes;Rhizophlyctidales;Rhizophlyctidaceae;";"0.0";"0";"3";"3";"0";"3";"0";"457180";"373894"
"V4mis1";"SILVA (only NR);Eukaryota;Amorphea;Obazoa;Opisthokonta;Nucletmycea;Fungi;Chytridiomycota;Incertae Sedis;Chytridiomycetes;Rhizophlyctidales;Rhizophlyctidaceae;Rhizophlyctis;";"0.0";"0";"3";"3";"0";"3";"0";"457180";"373894"
"V4mis1";"SILVA (only NR);Eukaryota;Amorphea;Obazoa;Opisthokonta;Nucletmycea;Fungi;Chytridiomycota;Incertae Sedis;Chytridiomycetes;Rhizophydiales;";"0.0";"0";"95";"94";"0";"94";"1";"457089";"373894"
"V4mis1";"SILVA (only NR);Eukaryota;Amorphea;Obazoa;Opisthokonta;Nucletmycea;Fungi;Chytridiomycota;Incertae Sedis;Chytridiomycetes;Rhizophydiales;Boothiomyces;";"0.0";"0";"1";"1";"0";"1";"0";"457182";"373894"
"V4mis1";"SILVA (only NR);Eukaryota;Amorphea;Obazoa;Opisthokonta;Nucletmycea;Fungi;Chytridiomycota;Incertae Sedis;Chytridiomycetes;Rhizophydiales;Incertae Sedis;";"0.0";"0";"21";"21";"0";"21";"0";"457162";"373894"
"V4mis1";"SILVA (only NR);Eukaryota;Amorphea;Obazoa;Opisthokonta;Nucletmycea;Fungi;Chytridiomycota;Incertae Sedis;Chytridiomycetes;Rhizophydiales;Incertae Sedis;Batrachochytrium;";"0.0";"0";"20";"20";"0";"20";"0";"457163";"373894"
"V4mis1";"SILVA (only NR);Eukaryota;Amorphea;Obazoa;Opisthokonta;Nucletmycea;Fungi;Chytridiomycota;Incertae Sedis;Chytridiomycetes;Rhizophydiales;Kappamycetaceae;";"0.0";"0";"16";"16";"0";"16";"0";"457167";"373894"
"V4mis1";"SILVA (only NR);Eukaryota;Amorphea;Obazoa;Opisthokonta;Nucletmycea;Fungi;Chytridiomycota;Incertae Sedis;Chytridiomycetes;Rhizophydiales;Kappamycetaceae;Kappamyces;";"0.0";"0";"1";"1";"0";"1";"0";"457182";"373894"
"V4mis1";"SILVA (only NR);Eukaryota;Amorphea;Obazoa;Opisthokonta;Nucletmycea;Fungi;Chytridiomycota;Incertae Sedis;Chytridiomycetes;Rhizophydiales;Rhizophydiaceae;";"0.0";"0";"22";"21";"0";"21";"1";"457162";"373894"
"V4mis1";"SILVA (only NR);Eukaryota;Amorphea;Obazoa;Opisthokonta;Nucletmycea;Fungi;Chytridiomycota;Incertae Sedis;Chytridiomycetes;Rhizophydiales;Rhizophydiaceae;Rhizophydium;";"0.0";"0";"13";"12";"0";"12";"1";"457171";"373894"
"V4mis1";"SILVA (only NR);Eukaryota;Amorphea;Obazoa;Opisthokonta;Nucletmycea;Fungi;Chytridiomycota;Incertae Sedis;Chytridiomycetes;Rhizophydiales;uncultured;";"0.0";"0";"30";"30";"0";"30";"0";"457153";"373894"
"V4mis1";"SILVA (only NR);Eukaryota;Amorphea;Obazoa;Opisthokonta;Nucletmycea;Fungi;Chytridiomycota;Incertae Sedis;Chytridiomycetes;Spizellomycetales;";"0.0";"0";"41";"41";"0";"41";"0";"457142";"373894"
"V4mis1";"SILVA (only NR);Eukaryota;Amorphea;Obazoa;Opisthokonta;Nucletmycea;Fungi;Chytridiomycota;Incertae Sedis;Chytridiomycetes;Spizellomycetales;Olpidiaceae;";"0.0";"0";"6";"6";"0";"6";"0";"457177";"373894"
"V4mis1";"SILVA (only NR);Eukaryota;Amorphea;Obazoa;Opisthokonta;Nucletmycea;Fungi;Chytridiomycota;Incertae Sedis;Chytridiomycetes;Spizellomycetales;Olpidiaceae;Olpidium;";"0.0";"0";"6";"6";"0";"6";"0";"457177";"373894"
"V4mis1";"SILVA (only NR);Eukaryota;Amorphea;Obazoa;Opisthokonta;Nucletmycea;Fungi;Chytridiomycota;Incertae Sedis;Chytridiomycetes;Spizellomycetales;Powellomycetaceae;";"0.0";"0";"24";"24";"0";"24";"0";"457159";"373894"
"V4mis1";"SILVA (only NR);Eukaryota;Amorphea;Obazoa;Opisthokonta;Nucletmycea;Fungi;Chytridiomycota;Incertae Sedis;Chytridiomycetes;Spizellomycetales;Powellomycetaceae;Geranomyces;";"0.0";"0";"17";"17";"0";"17";"0";"457166";"373894"
"V4mis1";"SILVA (only NR);Eukaryota;Amorphea;Obazoa;Opisthokonta;Nucletmycea;Fungi;Chytridiomycota;Incertae Sedis;Chytridiomycetes;Spizellomycetales;Spizellomycetaceae;";"0.0";"0";"7";"7";"0";"7";"0";"457176";"373894"
"V4mis1";"SILVA (only NR);Eukaryota;Amorphea;Obazoa;Opisthokonta;Nucletmycea;Fungi;Chytridiomycota;Incertae Sedis;Chytridiomycetes;Spizellomycetales;Spizellomycetaceae;Gaertneriomyces;";"0.0";"0";"1";"1";"0";"1";"0";"457182";"373894"
"V4mis1";"SILVA (only NR);Eukaryota;Amorphea;Obazoa;Opisthokonta;Nucletmycea;Fungi;Chytridiomycota;Incertae Sedis;Chytridiomycetes;Spizellomycetales;Spizellomycetaceae;Phlyctochytrium;";"0.0";"0";"2";"2";"0";"2";"0";"457181";"373894"
"V4mis1";"SILVA (only NR);Eukaryota;Amorphea;Obazoa;Opisthokonta;Nucletmycea;Fungi;Chytridiomycota;Incertae Sedis;Chytridiomycetes;Spizellomycetales;Spizellomycetaceae;Spizellomyces;";"0.0";"0";"3";"3";"0";"3";"0";"457180";"373894"
"V4mis1";"SILVA (only NR);Eukaryota;Amorphea;Obazoa;Opisthokonta;Nucletmycea;Fungi;Chytridiomycota;Incertae Sedis;Chytridiomycetes;Spizellomycetales;uncultured;";"0.0";"0";"4";"4";"0";"4";"0";"457179";"373894"
"V4mis1";"SILVA (only NR);Eukaryota;Amorphea;Obazoa;Opisthokonta;Nucletmycea;Fungi;Chytridiomycota;Incertae Sedis;Chytridiomycetes;uncultured;";"0.0";"0";"27";"27";"0";"27";"0";"457156";"373894"
"V4mis1";"SILVA (only NR);Eukaryota;Amorphea;Obazoa;Opisthokonta;Nucletmycea;Fungi;Chytridiomycota;Incertae Sedis;Monoblepharidomycetes;";"0.0";"0";"13";"13";"0";"13";"0";"457170";"373894"
"V4mis1";"SILVA (only NR);Eukaryota;Amorphea;Obazoa;Opisthokonta;Nucletmycea;Fungi;Chytridiomycota;Incertae Sedis;Monoblepharidomycetes;Monoblepharidales;";"0.0";"0";"13";"13";"0";"13";"0";"457170";"373894"
"V4mis1";"SILVA (only NR);Eukaryota;Amorphea;Obazoa;Opisthokonta;Nucletmycea;Fungi;Chytridiomycota;Incertae Sedis;Monoblepharidomycetes;Monoblepharidales;Gonapodyaceae;";"0.0";"0";"4";"4";"0";"4";"0";"457179";"373894"
"V4mis1";"SILVA (only NR);Eukaryota;Amorphea;Obazoa;Opisthokonta;Nucletmycea;Fungi;Chytridiomycota;Incertae Sedis;Monoblepharidomycetes;Monoblepharidales;Gonapodyaceae;Gonapodya;";"0.0";"0";"4";"4";"0";"4";"0";"457179";"373894"
"V4mis1";"SILVA (only NR);Eukaryota;Amorphea;Obazoa;Opisthokonta;Nucletmycea;Fungi;Chytridiomycota;Incertae Sedis;Monoblepharidomycetes;Monoblepharidales;Harpochytriaceae;";"0.0";"0";"2";"2";"0";"2";"0";"457181";"373894"
"V4mis1";"SILVA (only NR);Eukaryota;Amorphea;Obazoa;Opisthokonta;Nucletmycea;Fungi;Chytridiomycota;Incertae Sedis;Monoblepharidomycetes;Monoblepharidales;Harpochytriaceae;Harpochytrium;";"0.0";"0";"2";"2";"0";"2";"0";"457181";"373894"
"V4mis1";"SILVA (only NR);Eukaryota;Amorphea;Obazoa;Opisthokonta;Nucletmycea;Fungi;Chytridiomycota;Incertae Sedis;Monoblepharidomycetes;Monoblepharidales;Hyaloraphidium;";"0.0";"0";"1";"1";"0";"1";"0";"457182";"373894"
"V4mis1";"SILVA (only NR);Eukaryota;Amorphea;Obazoa;Opisthokonta;Nucletmycea;Fungi;Chytridiomycota;Incertae Sedis;Monoblepharidomycetes;Monoblepharidales;Monoblepharidaceae;";"0.0";"0";"2";"2";"0";"2";"0";"457181";"373894"
"V4mis1";"SILVA (only NR);Eukaryota;Amorphea;Obazoa;Opisthokonta;Nucletmycea;Fungi;Chytridiomycota;Incertae Sedis;Monoblepharidomycetes;Monoblepharidales;Monoblepharidaceae;Monoblepharella;";"0.0";"0";"2";"2";"0";"2";"0";"457181";"373894"
"V4mis1";"SILVA (only NR);Eukaryota;Amorphea;Obazoa;Opisthokonta;Nucletmycea;Fungi;Cryptomycota;";"0.0";"0";"213";"213";"0";"213";"0";"456970";"373894"
"V4mis1";"SILVA (only NR);Eukaryota;Amorphea;Obazoa;Opisthokonta;Nucletmycea;Fungi;Cryptomycota;Incertae Sedis;";"0.0";"0";"49";"49";"0";"49";"0";"457134";"373894"
"V4mis1";"SILVA (only NR);Eukaryota;Amorphea;Obazoa;Opisthokonta;Nucletmycea;Fungi;Cryptomycota;Incertae Sedis;Incertae Sedis;";"0.0";"0";"49";"49";"0";"49";"0";"457134";"373894"
"V4mis1";"SILVA (only NR);Eukaryota;Amorphea;Obazoa;Opisthokonta;Nucletmycea;Fungi;Cryptomycota;Incertae Sedis;Incertae Sedis;Incertae Sedis;";"0.0";"0";"49";"49";"0";"49";"0";"457134";"373894"
"V4mis1";"SILVA (only NR);Eukaryota;Amorphea;Obazoa;Opisthokonta;Nucletmycea;Fungi;Cryptomycota;Incertae Sedis;Incertae Sedis;Incertae Sedis;Incertae Sedis;";"0.0";"0";"49";"49";"0";"49";"0";"457134";"373894"
"V4mis1";"SILVA (only NR);Eukaryota;Amorphea;Obazoa;Opisthokonta;Nucletmycea;Fungi;Cryptomycota;Incertae Sedis;Incertae Sedis;Incertae Sedis;Incertae Sedis;Nucleophaga;";"0.0";"0";"2";"2";"0";"2";"0";"457181";"373894"
"V4mis1";"SILVA (only NR);Eukaryota;Amorphea;Obazoa;Opisthokonta;Nucletmycea;Fungi;Cryptomycota;Incertae Sedis;Incertae Sedis;Incertae Sedis;Incertae Sedis;Paramicrosporidium;";"0.0";"0";"32";"32";"0";"32";"0";"457151";"373894"
"V4mis1";"SILVA (only NR);Eukaryota;Amorphea;Obazoa;Opisthokonta;Nucletmycea;Fungi;Cryptomycota;Incertae Sedis;Incertae Sedis;Incertae Sedis;Incertae Sedis;Rozella;";"0.0";"0";"15";"15";"0";"15";"0";"457168";"373894"
"V4mis1";"SILVA (only NR);Eukaryota;Amorphea;Obazoa;Opisthokonta;Nucletmycea;Fungi;Cryptomycota;LKM11;";"0.0";"0";"123";"123";"0";"123";"0";"457060";"373894"
"V4mis1";"SILVA (only NR);Eukaryota;Amorphea;Obazoa;Opisthokonta;Nucletmycea;Fungi;Cryptomycota;uncultured;";"0.0";"0";"39";"39";"0";"39";"0";"457144";"373894"
"V4mis1";"SILVA (only NR);Eukaryota;Amorphea;Obazoa;Opisthokonta;Nucletmycea;Fungi;Dikarya;";"1.0";"16.8";"7696";"7659";"79";"7580";"37";"449524";"373815"
"V4mis1";"SILVA (only NR);Eukaryota;Amorphea;Obazoa;Opisthokonta;Nucletmycea;Fungi;Dikarya;Ascomycota;";"0.0";"0";"5156";"5136";"0";"5136";"20";"452047";"373894"
"V4mis1";"SILVA (only NR);Eukaryota;Amorphea;Obazoa;Opisthokonta;Nucletmycea;Fungi;Dikarya;Ascomycota;Incertae Sedis;";"0.0";"0";"3";"3";"0";"3";"0";"457180";"373894"
"V4mis1";"SILVA (only NR);Eukaryota;Amorphea;Obazoa;Opisthokonta;Nucletmycea;Fungi;Dikarya;Ascomycota;Incertae Sedis;Incertae Sedis;";"0.0";"0";"3";"3";"0";"3";"0";"457180";"373894"
"V4mis1";"SILVA (only NR);Eukaryota;Amorphea;Obazoa;Opisthokonta;Nucletmycea;Fungi;Dikarya;Ascomycota;Incertae Sedis;Incertae Sedis;Incertae Sedis;";"0.0";"0";"3";"3";"0";"3";"0";"457180";"373894"
"V4mis1";"SILVA (only NR);Eukaryota;Amorphea;Obazoa;Opisthokonta;Nucletmycea;Fungi;Dikarya;Ascomycota;Incertae Sedis;Incertae Sedis;Incertae Sedis;Incertae Sedis;";"0.0";"0";"3";"3";"0";"3";"0";"457180";"373894"
"V4mis1";"SILVA (only NR);Eukaryota;Amorphea;Obazoa;Opisthokonta;Nucletmycea;Fungi;Dikarya;Ascomycota;Incertae Sedis;Incertae Sedis;Incertae Sedis;Incertae Sedis;Calcarisporiella;";"0.0";"0";"3";"3";"0";"3";"0";"457180";"373894"
"V4mis1";"SILVA (only NR);Eukaryota;Amorphea;Obazoa;Opisthokonta;Nucletmycea;Fungi;Dikarya;Ascomycota;Pezizomycotina;";"0.0";"0";"3667";"3650";"0";"3650";"17";"453533";"373894"
"V4mis1";"SILVA (only NR);Eukaryota;Amorphea;Obazoa;Opisthokonta;Nucletmycea;Fungi;Dikarya;Ascomycota;Pezizomycotina;Arthoniomycetes;";"0.0";"0";"13";"13";"0";"13";"0";"457170";"373894"
"V4mis1";"SILVA (only NR);Eukaryota;Amorphea;Obazoa;Opisthokonta;Nucletmycea;Fungi;Dikarya;Ascomycota;Pezizomycotina;Arthoniomycetes;Arthoniales;";"0.0";"0";"8";"8";"0";"8";"0";"457175";"373894"
"V4mis1";"SILVA (only NR);Eukaryota;Amorphea;Obazoa;Opisthokonta;Nucletmycea;Fungi;Dikarya;Ascomycota;Pezizomycotina;Arthoniomycetes;Arthoniales;Opegrapha;";"0.0";"0";"1";"1";"0";"1";"0";"457182";"373894"
"V4mis1";"SILVA (only NR);Eukaryota;Amorphea;Obazoa;Opisthokonta;Nucletmycea;Fungi;Dikarya;Ascomycota;Pezizomycotina;Arthoniomycetes;Arthoniales;Roccellaceae;";"0.0";"0";"4";"4";"0";"4";"0";"457179";"373894"
"V4mis1";"SILVA (only NR);Eukaryota;Amorphea;Obazoa;Opisthokonta;Nucletmycea;Fungi;Dikarya;Ascomycota;Pezizomycotina;Arthoniomycetes;Arthoniales;Roccellaceae;Combea;";"0.0";"0";"1";"1";"0";"1";"0";"457182";"373894"
"V4mis1";"SILVA (only NR);Eukaryota;Amorphea;Obazoa;Opisthokonta;Nucletmycea;Fungi;Dikarya;Ascomycota;Pezizomycotina;Arthoniomycetes;Arthoniales;Roccellaceae;Dendrographa;";"0.0";"0";"1";"1";"0";"1";"0";"457182";"373894"
"V4mis1";"SILVA (only NR);Eukaryota;Amorphea;Obazoa;Opisthokonta;Nucletmycea;Fungi;Dikarya;Ascomycota;Pezizomycotina;Arthoniomycetes;Arthoniales;Roccellaceae;Lecanactis;";"0.0";"0";"1";"1";"0";"1";"0";"457182";"373894"
"V4mis1";"SILVA (only NR);Eukaryota;Amorphea;Obazoa;Opisthokonta;Nucletmycea;Fungi;Dikarya;Ascomycota;Pezizomycotina;Arthoniomycetes;Arthoniales;Roccellaceae;Roccella;";"0.0";"0";"1";"1";"0";"1";"0";"457182";"373894"
"V4mis1";"SILVA (only NR);Eukaryota;Amorphea;Obazoa;Opisthokonta;Nucletmycea;Fungi;Dikarya;Ascomycota;Pezizomycotina;Arthoniomycetes;Arthoniales;Roccellographa;";"0.0";"0";"1";"1";"0";"1";"0";"457182";"373894"
"V4mis1";"SILVA (only NR);Eukaryota;Amorphea;Obazoa;Opisthokonta;Nucletmycea;Fungi;Dikarya;Ascomycota;Pezizomycotina;Arthoniomycetes;Arthoniales;Simonyella;";"0.0";"0";"1";"1";"0";"1";"0";"457182";"373894"
"V4mis1";"SILVA (only NR);Eukaryota;Amorphea;Obazoa;Opisthokonta;Nucletmycea;Fungi;Dikarya;Ascomycota;Pezizomycotina;Arthoniomycetes;uncultured;";"0.0";"0";"5";"5";"0";"5";"0";"457178";"373894"
"V4mis1";"SILVA (only NR);Eukaryota;Amorphea;Obazoa;Opisthokonta;Nucletmycea;Fungi;Dikarya;Ascomycota;Pezizomycotina;Dothideomycetes;";"0.0";"0";"1025";"1017";"0";"1017";"8";"456166";"373894"
"V4mis1";"SILVA (only NR);Eukaryota;Amorphea;Obazoa;Opisthokonta;Nucletmycea;Fungi;Dikarya;Ascomycota;Pezizomycotina;Dothideomycetes;Botryosphaeriales;";"0.0";"0";"21";"21";"0";"21";"0";"457162";"373894"
"V4mis1";"SILVA (only NR);Eukaryota;Amorphea;Obazoa;Opisthokonta;Nucletmycea;Fungi;Dikarya;Ascomycota;Pezizomycotina;Dothideomycetes;Botryosphaeriales;Bagnisiella;";"0.0";"0";"1";"1";"0";"1";"0";"457182";"373894"
"V4mis1";"SILVA (only NR);Eukaryota;Amorphea;Obazoa;Opisthokonta;Nucletmycea;Fungi;Dikarya;Ascomycota;Pezizomycotina;Dothideomycetes;Botryosphaeriales;Botryosphaeriaceae;";"0.0";"0";"6";"6";"0";"6";"0";"457177";"373894"
"V4mis1";"SILVA (only NR);Eukaryota;Amorphea;Obazoa;Opisthokonta;Nucletmycea;Fungi;Dikarya;Ascomycota;Pezizomycotina;Dothideomycetes;Botryosphaeriales;Botryosphaeriaceae;Botryosphaeria;";"0.0";"0";"1";"1";"0";"1";"0";"457182";"373894"
"V4mis1";"SILVA (only NR);Eukaryota;Amorphea;Obazoa;Opisthokonta;Nucletmycea;Fungi;Dikarya;Ascomycota;Pezizomycotina;Dothideomycetes;Botryosphaeriales;Botryosphaeriaceae;Diplodia;";"0.0";"0";"1";"1";"0";"1";"0";"457182";"373894"
"V4mis1";"SILVA (only NR);Eukaryota;Amorphea;Obazoa;Opisthokonta;Nucletmycea;Fungi;Dikarya;Ascomycota;Pezizomycotina;Dothideomycetes;Botryosphaeriales;Botryosphaeriaceae;Lasiodiplodia;";"0.0";"0";"1";"1";"0";"1";"0";"457182";"373894"
"V4mis1";"SILVA (only NR);Eukaryota;Amorphea;Obazoa;Opisthokonta;Nucletmycea;Fungi;Dikarya;Ascomycota;Pezizomycotina;Dothideomycetes;Botryosphaeriales;Botryosphaeriaceae;Macrophomina;";"0.0";"0";"1";"1";"0";"1";"0";"457182";"373894"
"V4mis1";"SILVA (only NR);Eukaryota;Amorphea;Obazoa;Opisthokonta;Nucletmycea;Fungi;Dikarya;Ascomycota;Pezizomycotina;Dothideomycetes;Botryosphaeriales;Botryosphaeriaceae;Neofusicoccum;";"0.0";"0";"1";"1";"0";"1";"0";"457182";"373894"
"V4mis1";"SILVA (only NR);Eukaryota;Amorphea;Obazoa;Opisthokonta;Nucletmycea;Fungi;Dikarya;Ascomycota;Pezizomycotina;Dothideomycetes;Botryosphaeriales;Botryosphaeriaceae;Neoscytalidium;";"0.0";"0";"1";"1";"0";"1";"0";"457182";"373894"
"V4mis1";"SILVA (only NR);Eukaryota;Amorphea;Obazoa;Opisthokonta;Nucletmycea;Fungi;Dikarya;Ascomycota;Pezizomycotina;Dothideomycetes;Botryosphaeriales;Phyllostictaceae;";"0.0";"0";"14";"14";"0";"14";"0";"457169";"373894"
"V4mis1";"SILVA (only NR);Eukaryota;Amorphea;Obazoa;Opisthokonta;Nucletmycea;Fungi;Dikarya;Ascomycota;Pezizomycotina;Dothideomycetes;Botryosphaeriales;Phyllostictaceae;Phyllosticta;";"0.0";"0";"14";"14";"0";"14";"0";"457169";"373894"
"V4mis1";"SILVA (only NR);Eukaryota;Amorphea;Obazoa;Opisthokonta;Nucletmycea;Fungi;Dikarya;Ascomycota;Pezizomycotina;Dothideomycetes;Capnodiales;";"0.0";"0";"351";"350";"0";"350";"1";"456833";"373894"
"V4mis1";"SILVA (only NR);Eukaryota;Amorphea;Obazoa;Opisthokonta;Nucletmycea;Fungi;Dikarya;Ascomycota;Pezizomycotina;Dothideomycetes;Capnodiales;Acrodontium;";"0.0";"0";"1";"1";"0";"1";"0";"457182";"373894"
"V4mis1";"SILVA (only NR);Eukaryota;Amorphea;Obazoa;Opisthokonta;Nucletmycea;Fungi;Dikarya;Ascomycota;Pezizomycotina;Dothideomycetes;Capnodiales;Capnodiaceae;";"0.0";"0";"5";"5";"0";"5";"0";"457178";"373894"
"V4mis1";"SILVA (only NR);Eukaryota;Amorphea;Obazoa;Opisthokonta;Nucletmycea;Fungi;Dikarya;Ascomycota;Pezizomycotina;Dothideomycetes;Capnodiales;Capnodiaceae;Conidiocarpus;";"0.0";"0";"1";"1";"0";"1";"0";"457182";"373894"
"V4mis1";"SILVA (only NR);Eukaryota;Amorphea;Obazoa;Opisthokonta;Nucletmycea;Fungi;Dikarya;Ascomycota;Pezizomycotina;Dothideomycetes;Capnodiales;Capnodiaceae;Leptoxyphium;";"0.0";"0";"2";"2";"0";"2";"0";"457181";"373894"
"V4mis1";"SILVA (only NR);Eukaryota;Amorphea;Obazoa;Opisthokonta;Nucletmycea;Fungi;Dikarya;Ascomycota;Pezizomycotina;Dothideomycetes;Capnodiales;Capnodiaceae;Scorias;";"0.0";"0";"2";"2";"0";"2";"0";"457181";"373894"
"V4mis1";"SILVA (only NR);Eukaryota;Amorphea;Obazoa;Opisthokonta;Nucletmycea;Fungi;Dikarya;Ascomycota;Pezizomycotina;Dothideomycetes;Capnodiales;Cladosporiaceae;";"0.0";"0";"91";"90";"0";"90";"1";"457093";"373894"
"V4mis1";"SILVA (only NR);Eukaryota;Amorphea;Obazoa;Opisthokonta;Nucletmycea;Fungi;Dikarya;Ascomycota;Pezizomycotina;Dothideomycetes;Capnodiales;Cladosporiaceae;Cladosporium;";"0.0";"0";"86";"85";"0";"85";"1";"457098";"373894"
"V4mis1";"SILVA (only NR);Eukaryota;Amorphea;Obazoa;Opisthokonta;Nucletmycea;Fungi;Dikarya;Ascomycota;Pezizomycotina;Dothideomycetes;Capnodiales;Cladosporiaceae;Rachicladosporium;";"0.0";"0";"2";"2";"0";"2";"0";"457181";"373894"
"V4mis1";"SILVA (only NR);Eukaryota;Amorphea;Obazoa;Opisthokonta;Nucletmycea;Fungi;Dikarya;Ascomycota;Pezizomycotina;Dothideomycetes;Capnodiales;Cladosporiaceae;Toxicocladosporium;";"0.0";"0";"3";"3";"0";"3";"0";"457180";"373894"
"V4mis1";"SILVA (only NR);Eukaryota;Amorphea;Obazoa;Opisthokonta;Nucletmycea;Fungi;Dikarya;Ascomycota;Pezizomycotina;Dothideomycetes;Capnodiales;Dissoconiaceae;";"0.0";"0";"8";"8";"0";"8";"0";"457175";"373894"
"V4mis1";"SILVA (only NR);Eukaryota;Amorphea;Obazoa;Opisthokonta;Nucletmycea;Fungi;Dikarya;Ascomycota;Pezizomycotina;Dothideomycetes;Capnodiales;Dissoconiaceae;Dissoconium;";"0.0";"0";"3";"3";"0";"3";"0";"457180";"373894"
"V4mis1";"SILVA (only NR);Eukaryota;Amorphea;Obazoa;Opisthokonta;Nucletmycea;Fungi;Dikarya;Ascomycota;Pezizomycotina;Dothideomycetes;Capnodiales;Dissoconiaceae;Ramichloridium;";"0.0";"0";"1";"1";"0";"1";"0";"457182";"373894"
"V4mis1";"SILVA (only NR);Eukaryota;Amorphea;Obazoa;Opisthokonta;Nucletmycea;Fungi;Dikarya;Ascomycota;Pezizomycotina;Dothideomycetes;Capnodiales;Dissoconiaceae;Uwebraunia;";"0.0";"0";"3";"3";"0";"3";"0";"457180";"373894"
"V4mis1";"SILVA (only NR);Eukaryota;Amorphea;Obazoa;Opisthokonta;Nucletmycea;Fungi;Dikarya;Ascomycota;Pezizomycotina;Dothideomycetes;Capnodiales;Extremaceae;";"0.0";"0";"9";"9";"0";"9";"0";"457174";"373894"
"V4mis1";"SILVA (only NR);Eukaryota;Amorphea;Obazoa;Opisthokonta;Nucletmycea;Fungi;Dikarya;Ascomycota;Pezizomycotina;Dothideomycetes;Capnodiales;Extremaceae;Vermiconia;";"0.0";"0";"3";"3";"0";"3";"0";"457180";"373894"
"V4mis1";"SILVA (only NR);Eukaryota;Amorphea;Obazoa;Opisthokonta;Nucletmycea;Fungi;Dikarya;Ascomycota;Pezizomycotina;Dothideomycetes;Capnodiales;Incertae Sedis;";"0.0";"0";"4";"4";"0";"4";"0";"457179";"373894"
"V4mis1";"SILVA (only NR);Eukaryota;Amorphea;Obazoa;Opisthokonta;Nucletmycea;Fungi;Dikarya;Ascomycota;Pezizomycotina;Dothideomycetes;Capnodiales;Incertae Sedis;Peltaster;";"0.0";"0";"4";"4";"0";"4";"0";"457179";"373894"
"V4mis1";"SILVA (only NR);Eukaryota;Amorphea;Obazoa;Opisthokonta;Nucletmycea;Fungi;Dikarya;Ascomycota;Pezizomycotina;Dothideomycetes;Capnodiales;Microcyclospora;";"0.0";"0";"1";"1";"0";"1";"0";"457182";"373894"
"V4mis1";"SILVA (only NR);Eukaryota;Amorphea;Obazoa;Opisthokonta;Nucletmycea;Fungi;Dikarya;Ascomycota;Pezizomycotina;Dothideomycetes;Capnodiales;Mucomycosphaerella;";"0.0";"0";"1";"1";"0";"1";"0";"457182";"373894"
"V4mis1";"SILVA (only NR);Eukaryota;Amorphea;Obazoa;Opisthokonta;Nucletmycea;Fungi;Dikarya;Ascomycota;Pezizomycotina;Dothideomycetes;Capnodiales;Mycosphaerellaceae;";"0.0";"0";"122";"122";"0";"122";"0";"457061";"373894"
"V4mis1";"SILVA (only NR);Eukaryota;Amorphea;Obazoa;Opisthokonta;Nucletmycea;Fungi;Dikarya;Ascomycota;Pezizomycotina;Dothideomycetes;Capnodiales;Mycosphaerellaceae;Cercospora;";"0.0";"0";"1";"1";"0";"1";"0";"457182";"373894"
"V4mis1";"SILVA (only NR);Eukaryota;Amorphea;Obazoa;Opisthokonta;Nucletmycea;Fungi;Dikarya;Ascomycota;Pezizomycotina;Dothideomycetes;Capnodiales;Mycosphaerellaceae;Cercosporella;";"0.0";"0";"1";"1";"0";"1";"0";"457182";"373894"
"V4mis1";"SILVA (only NR);Eukaryota;Amorphea;Obazoa;Opisthokonta;Nucletmycea;Fungi;Dikarya;Ascomycota;Pezizomycotina;Dothideomycetes;Capnodiales;Mycosphaerellaceae;Exopassalora;";"0.0";"0";"1";"1";"0";"1";"0";"457182";"373894"
"V4mis1";"SILVA (only NR);Eukaryota;Amorphea;Obazoa;Opisthokonta;Nucletmycea;Fungi;Dikarya;Ascomycota;Pezizomycotina;Dothideomycetes;Capnodiales;Mycosphaerellaceae;Exutisphaerella;";"0.0";"0";"1";"1";"0";"1";"0";"457182";"373894"
"V4mis1";"SILVA (only NR);Eukaryota;Amorphea;Obazoa;Opisthokonta;Nucletmycea;Fungi;Dikarya;Ascomycota;Pezizomycotina;Dothideomycetes;Capnodiales;Mycosphaerellaceae;Graminopassalora;";"0.0";"0";"1";"1";"0";"1";"0";"457182";"373894"
"V4mis1";"SILVA (only NR);Eukaryota;Amorphea;Obazoa;Opisthokonta;Nucletmycea;Fungi;Dikarya;Ascomycota;Pezizomycotina;Dothideomycetes;Capnodiales;Mycosphaerellaceae;Lecanosticta;";"0.0";"0";"1";"1";"0";"1";"0";"457182";"373894"
"V4mis1";"SILVA (only NR);Eukaryota;Amorphea;Obazoa;Opisthokonta;Nucletmycea;Fungi;Dikarya;Ascomycota;Pezizomycotina;Dothideomycetes;Capnodiales;Mycosphaerellaceae;Mycosphaerella;";"0.0";"0";"15";"15";"0";"15";"0";"457168";"373894"
"V4mis1";"SILVA (only NR);Eukaryota;Amorphea;Obazoa;Opisthokonta;Nucletmycea;Fungi;Dikarya;Ascomycota;Pezizomycotina;Dothideomycetes;Capnodiales;Mycosphaerellaceae;Neophloeospora;";"0.0";"0";"1";"1";"0";"1";"0";"457182";"373894"
"V4mis1";"SILVA (only NR);Eukaryota;Amorphea;Obazoa;Opisthokonta;Nucletmycea;Fungi;Dikarya;Ascomycota;Pezizomycotina;Dothideomycetes;Capnodiales;Mycosphaerellaceae;Neopseudocercosporella;";"0.0";"0";"1";"1";"0";"1";"0";"457182";"373894"
"V4mis1";"SILVA (only NR);Eukaryota;Amorphea;Obazoa;Opisthokonta;Nucletmycea;Fungi;Dikarya;Ascomycota;Pezizomycotina;Dothideomycetes;Capnodiales;Mycosphaerellaceae;Pallidocercospora;";"0.0";"0";"1";"1";"0";"1";"0";"457182";"373894"
"V4mis1";"SILVA (only NR);Eukaryota;Amorphea;Obazoa;Opisthokonta;Nucletmycea;Fungi;Dikarya;Ascomycota;Pezizomycotina;Dothideomycetes;Capnodiales;Mycosphaerellaceae;Paramycosphaerella;";"0.0";"0";"1";"1";"0";"1";"0";"457182";"373894"
"V4mis1";"SILVA (only NR);Eukaryota;Amorphea;Obazoa;Opisthokonta;Nucletmycea;Fungi;Dikarya;Ascomycota;Pezizomycotina;Dothideomycetes;Capnodiales;Mycosphaerellaceae;Passalora;";"0.0";"0";"3";"3";"0";"3";"0";"457180";"373894"
"V4mis1";"SILVA (only NR);Eukaryota;Amorphea;Obazoa;Opisthokonta;Nucletmycea;Fungi;Dikarya;Ascomycota;Pezizomycotina;Dothideomycetes;Capnodiales;Mycosphaerellaceae;Phaeoisariopsis;";"0.0";"0";"2";"2";"0";"2";"0";"457181";"373894"
"V4mis1";"SILVA (only NR);Eukaryota;Amorphea;Obazoa;Opisthokonta;Nucletmycea;Fungi;Dikarya;Ascomycota;Pezizomycotina;Dothideomycetes;Capnodiales;Mycosphaerellaceae;Phaeophleospora;";"0.0";"0";"1";"1";"0";"1";"0";"457182";"373894"
"V4mis1";"SILVA (only NR);Eukaryota;Amorphea;Obazoa;Opisthokonta;Nucletmycea;Fungi;Dikarya;Ascomycota;Pezizomycotina;Dothideomycetes;Capnodiales;Mycosphaerellaceae;Pseudocercospora;";"0.0";"0";"5";"5";"0";"5";"0";"457178";"373894"
"V4mis1";"SILVA (only NR);Eukaryota;Amorphea;Obazoa;Opisthokonta;Nucletmycea;Fungi;Dikarya;Ascomycota;Pezizomycotina;Dothideomycetes;Capnodiales;Mycosphaerellaceae;Ramularia;";"0.0";"0";"66";"66";"0";"66";"0";"457117";"373894"
"V4mis1";"SILVA (only NR);Eukaryota;Amorphea;Obazoa;Opisthokonta;Nucletmycea;Fungi;Dikarya;Ascomycota;Pezizomycotina;Dothideomycetes;Capnodiales;Mycosphaerellaceae;Septoria;";"0.0";"0";"3";"3";"0";"3";"0";"457180";"373894"
"V4mis1";"SILVA (only NR);Eukaryota;Amorphea;Obazoa;Opisthokonta;Nucletmycea;Fungi;Dikarya;Ascomycota;Pezizomycotina;Dothideomycetes;Capnodiales;Mycosphaerellaceae;Sphaerulina;";"0.0";"0";"4";"4";"0";"4";"0";"457179";"373894"
"V4mis1";"SILVA (only NR);Eukaryota;Amorphea;Obazoa;Opisthokonta;Nucletmycea;Fungi;Dikarya;Ascomycota;Pezizomycotina;Dothideomycetes;Capnodiales;Mycosphaerellaceae;Stigmina;";"0.0";"0";"1";"1";"0";"1";"0";"457182";"373894"
"V4mis1";"SILVA (only NR);Eukaryota;Amorphea;Obazoa;Opisthokonta;Nucletmycea;Fungi;Dikarya;Ascomycota;Pezizomycotina;Dothideomycetes;Capnodiales;Mycosphaerellaceae;Zasmidium;";"0.0";"0";"1";"1";"0";"1";"0";"457182";"373894"
"V4mis1";"SILVA (only NR);Eukaryota;Amorphea;Obazoa;Opisthokonta;Nucletmycea;Fungi;Dikarya;Ascomycota;Pezizomycotina;Dothideomycetes;Capnodiales;Mycosphaerellaceae;Zymoseptoria;";"0.0";"0";"7";"7";"0";"7";"0";"457176";"373894"
"V4mis1";"SILVA (only NR);Eukaryota;Amorphea;Obazoa;Opisthokonta;Nucletmycea;Fungi;Dikarya;Ascomycota;Pezizomycotina;Dothideomycetes;Capnodiales;Piedraia;";"0.0";"0";"1";"1";"0";"1";"0";"457182";"373894"
"V4mis1";"SILVA (only NR);Eukaryota;Amorphea;Obazoa;Opisthokonta;Nucletmycea;Fungi;Dikarya;Ascomycota;Pezizomycotina;Dothideomycetes;Capnodiales;Readeriella;";"0.0";"0";"1";"1";"0";"1";"0";"457182";"373894"
"V4mis1";"SILVA (only NR);Eukaryota;Amorphea;Obazoa;Opisthokonta;Nucletmycea;Fungi;Dikarya;Ascomycota;Pezizomycotina;Dothideomycetes;Capnodiales;Schizothyriaceae;";"0.0";"0";"3";"3";"0";"3";"0";"457180";"373894"
"V4mis1";"SILVA (only NR);Eukaryota;Amorphea;Obazoa;Opisthokonta;Nucletmycea;Fungi;Dikarya;Ascomycota;Pezizomycotina;Dothideomycetes;Capnodiales;Schizothyriaceae;Schizothyrium;";"0.0";"0";"3";"3";"0";"3";"0";"457180";"373894"
"V4mis1";"SILVA (only NR);Eukaryota;Amorphea;Obazoa;Opisthokonta;Nucletmycea;Fungi;Dikarya;Ascomycota;Pezizomycotina;Dothideomycetes;Capnodiales;Teratoramularia;";"0.0";"0";"1";"1";"0";"1";"0";"457182";"373894"
"V4mis1";"SILVA (only NR);Eukaryota;Amorphea;Obazoa;Opisthokonta;Nucletmycea;Fungi;Dikarya;Ascomycota;Pezizomycotina;Dothideomycetes;Capnodiales;Teratosphaeriaceae;";"0.0";"0";"99";"99";"0";"99";"0";"457084";"373894"
"V4mis1";"SILVA (only NR);Eukaryota;Amorphea;Obazoa;Opisthokonta;Nucletmycea;Fungi;Dikarya;Ascomycota;Pezizomycotina;Dothideomycetes;Capnodiales;Teratosphaeriaceae;Acidomyces;";"0.0";"0";"2";"2";"0";"2";"0";"457181";"373894"
"V4mis1";"SILVA (only NR);Eukaryota;Amorphea;Obazoa;Opisthokonta;Nucletmycea;Fungi;Dikarya;Ascomycota;Pezizomycotina;Dothideomycetes;Capnodiales;Teratosphaeriaceae;Baudoinia;";"0.0";"0";"2";"2";"0";"2";"0";"457181";"373894"
"V4mis1";"SILVA (only NR);Eukaryota;Amorphea;Obazoa;Opisthokonta;Nucletmycea;Fungi;Dikarya;Ascomycota;Pezizomycotina;Dothideomycetes;Capnodiales;Teratosphaeriaceae;Bryochiton;";"0.0";"0";"1";"1";"0";"1";"0";"457182";"373894"
"V4mis1";"SILVA (only NR);Eukaryota;Amorphea;Obazoa;Opisthokonta;Nucletmycea;Fungi;Dikarya;Ascomycota;Pezizomycotina;Dothideomycetes;Capnodiales;Teratosphaeriaceae;Capnobotryella;";"0.0";"0";"8";"8";"0";"8";"0";"457175";"373894"
"V4mis1";"SILVA (only NR);Eukaryota;Amorphea;Obazoa;Opisthokonta;Nucletmycea;Fungi;Dikarya;Ascomycota;Pezizomycotina;Dothideomycetes;Capnodiales;Teratosphaeriaceae;Catenulostroma;";"0.0";"0";"1";"1";"0";"1";"0";"457182";"373894"
"V4mis1";"SILVA (only NR);Eukaryota;Amorphea;Obazoa;Opisthokonta;Nucletmycea;Fungi;Dikarya;Ascomycota;Pezizomycotina;Dothideomycetes;Capnodiales;Teratosphaeriaceae;Devriesia;";"0.0";"0";"1";"1";"0";"1";"0";"457182";"373894"
"V4mis1";"SILVA (only NR);Eukaryota;Amorphea;Obazoa;Opisthokonta;Nucletmycea;Fungi;Dikarya;Ascomycota;Pezizomycotina;Dothideomycetes;Capnodiales;Teratosphaeriaceae;Elasticomyces;";"0.0";"0";"1";"1";"0";"1";"0";"457182";"373894"
"V4mis1";"SILVA (only NR);Eukaryota;Amorphea;Obazoa;Opisthokonta;Nucletmycea;Fungi;Dikarya;Ascomycota;Pezizomycotina;Dothideomycetes;Capnodiales;Teratosphaeriaceae;Friedmanniomyces;";"0.0";"0";"1";"1";"0";"1";"0";"457182";"373894"
"V4mis1";"SILVA (only NR);Eukaryota;Amorphea;Obazoa;Opisthokonta;Nucletmycea;Fungi;Dikarya;Ascomycota;Pezizomycotina;Dothideomycetes;Capnodiales;Teratosphaeriaceae;Hortaea;";"0.0";"0";"4";"4";"0";"4";"0";"457179";"373894"
"V4mis1";"SILVA (only NR);Eukaryota;Amorphea;Obazoa;Opisthokonta;Nucletmycea;Fungi;Dikarya;Ascomycota;Pezizomycotina;Dothideomycetes;Capnodiales;Teratosphaeriaceae;Monticola;";"0.0";"0";"1";"1";"0";"1";"0";"457182";"373894"
"V4mis1";"SILVA (only NR);Eukaryota;Amorphea;Obazoa;Opisthokonta;Nucletmycea;Fungi;Dikarya;Ascomycota;Pezizomycotina;Dothideomycetes;Capnodiales;Teratosphaeriaceae;Neocatenulostroma;";"0.0";"0";"62";"62";"0";"62";"0";"457121";"373894"
"V4mis1";"SILVA (only NR);Eukaryota;Amorphea;Obazoa;Opisthokonta;Nucletmycea;Fungi;Dikarya;Ascomycota;Pezizomycotina;Dothideomycetes;Capnodiales;Teratosphaeriaceae;Penidiella;";"0.0";"0";"1";"1";"0";"1";"0";"457182";"373894"
"V4mis1";"SILVA (only NR);Eukaryota;Amorphea;Obazoa;Opisthokonta;Nucletmycea;Fungi;Dikarya;Ascomycota;Pezizomycotina;Dothideomycetes;Capnodiales;Teratosphaeriaceae;Pseudotaeniolina;";"0.0";"0";"1";"1";"0";"1";"0";"457182";"373894"
"V4mis1";"SILVA (only NR);Eukaryota;Amorphea;Obazoa;Opisthokonta;Nucletmycea;Fungi;Dikarya;Ascomycota;Pezizomycotina;Dothideomycetes;Capnodiales;Teratosphaeriaceae;Recurvomyces;";"0.0";"0";"2";"2";"0";"2";"0";"457181";"373894"
"V4mis1";"SILVA (only NR);Eukaryota;Amorphea;Obazoa;Opisthokonta;Nucletmycea;Fungi;Dikarya;Ascomycota;Pezizomycotina;Dothideomycetes;Capnodiales;Teratosphaeriaceae;Suberoteratosphaeria;";"0.0";"0";"2";"2";"0";"2";"0";"457181";"373894"
"V4mis1";"SILVA (only NR);Eukaryota;Amorphea;Obazoa;Opisthokonta;Nucletmycea;Fungi;Dikarya;Ascomycota;Pezizomycotina;Dothideomycetes;Capnodiales;Teratosphaeriaceae;Teratosphaeria;";"0.0";"0";"6";"6";"0";"6";"0";"457177";"373894"
"V4mis1";"SILVA (only NR);Eukaryota;Amorphea;Obazoa;Opisthokonta;Nucletmycea;Fungi;Dikarya;Ascomycota;Pezizomycotina;Dothideomycetes;Cenococcum;";"0.0";"0";"2";"2";"0";"2";"0";"457181";"373894"
"V4mis1";"SILVA (only NR);Eukaryota;Amorphea;Obazoa;Opisthokonta;Nucletmycea;Fungi;Dikarya;Ascomycota;Pezizomycotina;Dothideomycetes;Dothideales;";"0.0";"0";"35";"35";"0";"35";"0";"457148";"373894"
"V4mis1";"SILVA (only NR);Eukaryota;Amorphea;Obazoa;Opisthokonta;Nucletmycea;Fungi;Dikarya;Ascomycota;Pezizomycotina;Dothideomycetes;Dothideales;Aureobasidiaceae;";"0.0";"0";"22";"22";"0";"22";"0";"457161";"373894"
"V4mis1";"SILVA (only NR);Eukaryota;Amorphea;Obazoa;Opisthokonta;Nucletmycea;Fungi;Dikarya;Ascomycota;Pezizomycotina;Dothideomycetes;Dothideales;Aureobasidiaceae;Aureobasidium;";"0.0";"0";"18";"18";"0";"18";"0";"457165";"373894"
"V4mis1";"SILVA (only NR);Eukaryota;Amorphea;Obazoa;Opisthokonta;Nucletmycea;Fungi;Dikarya;Ascomycota;Pezizomycotina;Dothideomycetes;Dothideales;Aureobasidiaceae;Columnosphaeria;";"0.0";"0";"1";"1";"0";"1";"0";"457182";"373894"
"V4mis1";"SILVA (only NR);Eukaryota;Amorphea;Obazoa;Opisthokonta;Nucletmycea;Fungi;Dikarya;Ascomycota;Pezizomycotina;Dothideomycetes;Dothideales;Aureobasidiaceae;Kabatiella;";"0.0";"0";"1";"1";"0";"1";"0";"457182";"373894"
"V4mis1";"SILVA (only NR);Eukaryota;Amorphea;Obazoa;Opisthokonta;Nucletmycea;Fungi;Dikarya;Ascomycota;Pezizomycotina;Dothideomycetes;Dothideales;Dothideaceae;";"0.0";"0";"6";"6";"0";"6";"0";"457177";"373894"
"V4mis1";"SILVA (only NR);Eukaryota;Amorphea;Obazoa;Opisthokonta;Nucletmycea;Fungi;Dikarya;Ascomycota;Pezizomycotina;Dothideomycetes;Dothideales;Dothideaceae;Dothidea;";"0.0";"0";"4";"4";"0";"4";"0";"457179";"373894"
"V4mis1";"SILVA (only NR);Eukaryota;Amorphea;Obazoa;Opisthokonta;Nucletmycea;Fungi;Dikarya;Ascomycota;Pezizomycotina;Dothideomycetes;Dothideales;Dothideaceae;Endoconidioma;";"0.0";"0";"1";"1";"0";"1";"0";"457182";"373894"
"V4mis1";"SILVA (only NR);Eukaryota;Amorphea;Obazoa;Opisthokonta;Nucletmycea;Fungi;Dikarya;Ascomycota;Pezizomycotina;Dothideomycetes;Dothideales;Dothideaceae;Stylodothis;";"0.0";"0";"1";"1";"0";"1";"0";"457182";"373894"
"V4mis1";"SILVA (only NR);Eukaryota;Amorphea;Obazoa;Opisthokonta;Nucletmycea;Fungi;Dikarya;Ascomycota;Pezizomycotina;Dothideomycetes;Dothideales;Dothioraceae;";"0.0";"0";"6";"6";"0";"6";"0";"457177";"373894"
"V4mis1";"SILVA (only NR);Eukaryota;Amorphea;Obazoa;Opisthokonta;Nucletmycea;Fungi;Dikarya;Ascomycota;Pezizomycotina;Dothideomycetes;Dothideales;Dothioraceae;Delphinella;";"0.0";"0";"2";"2";"0";"2";"0";"457181";"373894"
"V4mis1";"SILVA (only NR);Eukaryota;Amorphea;Obazoa;Opisthokonta;Nucletmycea;Fungi;Dikarya;Ascomycota;Pezizomycotina;Dothideomycetes;Dothideales;Dothioraceae;Dothiora;";"0.0";"0";"2";"2";"0";"2";"0";"457181";"373894"
"V4mis1";"SILVA (only NR);Eukaryota;Amorphea;Obazoa;Opisthokonta;Nucletmycea;Fungi;Dikarya;Ascomycota;Pezizomycotina;Dothideomycetes;Dothideales;Dothioraceae;Sydowia;";"0.0";"0";"1";"1";"0";"1";"0";"457182";"373894"
"V4mis1";"SILVA (only NR);Eukaryota;Amorphea;Obazoa;Opisthokonta;Nucletmycea;Fungi;Dikarya;Ascomycota;Pezizomycotina;Dothideomycetes;Dothideales;Scleroconidioma;";"0.0";"0";"1";"1";"0";"1";"0";"457182";"373894"
"V4mis1";"SILVA (only NR);Eukaryota;Amorphea;Obazoa;Opisthokonta;Nucletmycea;Fungi;Dikarya;Ascomycota;Pezizomycotina;Dothideomycetes;Hysteriales;";"0.0";"0";"2";"2";"0";"2";"0";"457181";"373894"
"V4mis1";"SILVA (only NR);Eukaryota;Amorphea;Obazoa;Opisthokonta;Nucletmycea;Fungi;Dikarya;Ascomycota;Pezizomycotina;Dothideomycetes;Hysteriales;Hysterographium;";"0.0";"0";"1";"1";"0";"1";"0";"457182";"373894"
"V4mis1";"SILVA (only NR);Eukaryota;Amorphea;Obazoa;Opisthokonta;Nucletmycea;Fungi;Dikarya;Ascomycota;Pezizomycotina;Dothideomycetes;Hysteriales;Rhytidhysteron;";"0.0";"0";"1";"1";"0";"1";"0";"457182";"373894"
"V4mis1";"SILVA (only NR);Eukaryota;Amorphea;Obazoa;Opisthokonta;Nucletmycea;Fungi;Dikarya;Ascomycota;Pezizomycotina;Dothideomycetes;Incertae Sedis;";"0.0";"0";"31";"31";"0";"31";"0";"457152";"373894"
"V4mis1";"SILVA (only NR);Eukaryota;Amorphea;Obazoa;Opisthokonta;Nucletmycea;Fungi;Dikarya;Ascomycota;Pezizomycotina;Dothideomycetes;Incertae Sedis;Eremomycetaceae;";"0.0";"0";"1";"1";"0";"1";"0";"457182";"373894"
"V4mis1";"SILVA (only NR);Eukaryota;Amorphea;Obazoa;Opisthokonta;Nucletmycea;Fungi;Dikarya;Ascomycota;Pezizomycotina;Dothideomycetes;Incertae Sedis;Eremomycetaceae;Arthrographis;";"0.0";"0";"1";"1";"0";"1";"0";"457182";"373894"
"V4mis1";"SILVA (only NR);Eukaryota;Amorphea;Obazoa;Opisthokonta;Nucletmycea;Fungi;Dikarya;Ascomycota;Pezizomycotina;Dothideomycetes;Incertae Sedis;Incertae Sedis;";"0.0";"0";"26";"26";"0";"26";"0";"457157";"373894"
"V4mis1";"SILVA (only NR);Eukaryota;Amorphea;Obazoa;Opisthokonta;Nucletmycea;Fungi;Dikarya;Ascomycota;Pezizomycotina;Dothideomycetes;Incertae Sedis;Incertae Sedis;Brachyconidiella;";"0.0";"0";"1";"1";"0";"1";"0";"457182";"373894"
"V4mis1";"SILVA (only NR);Eukaryota;Amorphea;Obazoa;Opisthokonta;Nucletmycea;Fungi;Dikarya;Ascomycota;Pezizomycotina;Dothideomycetes;Incertae Sedis;Incertae Sedis;Catinella;";"0.0";"0";"1";"1";"0";"1";"0";"457182";"373894"
"V4mis1";"SILVA (only NR);Eukaryota;Amorphea;Obazoa;Opisthokonta;Nucletmycea;Fungi;Dikarya;Ascomycota;Pezizomycotina;Dothideomycetes;Incertae Sedis;Incertae Sedis;Cryomyces;";"0.0";"0";"2";"2";"0";"2";"0";"457181";"373894"
"V4mis1";"SILVA (only NR);Eukaryota;Amorphea;Obazoa;Opisthokonta;Nucletmycea;Fungi;Dikarya;Ascomycota;Pezizomycotina;Dothideomycetes;Incertae Sedis;Incertae Sedis;Endosporium;";"0.0";"0";"1";"1";"0";"1";"0";"457182";"373894"
"V4mis1";"SILVA (only NR);Eukaryota;Amorphea;Obazoa;Opisthokonta;Nucletmycea;Fungi;Dikarya;Ascomycota;Pezizomycotina;Dothideomycetes;Incertae Sedis;Incertae Sedis;Heliocephala;";"0.0";"0";"3";"3";"0";"3";"0";"457180";"373894"
"V4mis1";"SILVA (only NR);Eukaryota;Amorphea;Obazoa;Opisthokonta;Nucletmycea;Fungi;Dikarya;Ascomycota;Pezizomycotina;Dothideomycetes;Incertae Sedis;Incertae Sedis;Phaeosclera;";"0.0";"0";"1";"1";"0";"1";"0";"457182";"373894"
"V4mis1";"SILVA (only NR);Eukaryota;Amorphea;Obazoa;Opisthokonta;Nucletmycea;Fungi;Dikarya;Ascomycota;Pezizomycotina;Dothideomycetes;Incertae Sedis;Incertae Sedis;Phaeotheca;";"0.0";"0";"1";"1";"0";"1";"0";"457182";"373894"
"V4mis1";"SILVA (only NR);Eukaryota;Amorphea;Obazoa;Opisthokonta;Nucletmycea;Fungi;Dikarya;Ascomycota;Pezizomycotina;Dothideomycetes;Incertae Sedis;Incertae Sedis;Pseudosigmoidea;";"0.0";"0";"1";"1";"0";"1";"0";"457182";"373894"
"V4mis1";"SILVA (only NR);Eukaryota;Amorphea;Obazoa;Opisthokonta;Nucletmycea;Fungi;Dikarya;Ascomycota;Pezizomycotina;Dothideomycetes;Incertae Sedis;Incertae Sedis;Rupestriomyces;";"0.0";"0";"1";"1";"0";"1";"0";"457182";"373894"
"V4mis1";"SILVA (only NR);Eukaryota;Amorphea;Obazoa;Opisthokonta;Nucletmycea;Fungi;Dikarya;Ascomycota;Pezizomycotina;Dothideomycetes;Incertae Sedis;Incertae Sedis;Saxomyces;";"0.0";"0";"2";"2";"0";"2";"0";"457181";"373894"
"V4mis1";"SILVA (only NR);Eukaryota;Amorphea;Obazoa;Opisthokonta;Nucletmycea;Fungi;Dikarya;Ascomycota;Pezizomycotina;Dothideomycetes;Incertae Sedis;Incertae Sedis;Scolecobasidium;";"0.0";"0";"1";"1";"0";"1";"0";"457182";"373894"
"V4mis1";"SILVA (only NR);Eukaryota;Amorphea;Obazoa;Opisthokonta;Nucletmycea;Fungi;Dikarya;Ascomycota;Pezizomycotina;Dothideomycetes;Incertae Sedis;Incertae Sedis;Spissiomyces;";"0.0";"0";"1";"1";"0";"1";"0";"457182";"373894"
"V4mis1";"SILVA (only NR);Eukaryota;Amorphea;Obazoa;Opisthokonta;Nucletmycea;Fungi;Dikarya;Ascomycota;Pezizomycotina;Dothideomycetes;Incertae Sedis;Incertae Sedis;Tyrannosorus;";"0.0";"0";"1";"1";"0";"1";"0";"457182";"373894"
"V4mis1";"SILVA (only NR);Eukaryota;Amorphea;Obazoa;Opisthokonta;Nucletmycea;Fungi;Dikarya;Ascomycota;Pezizomycotina;Dothideomycetes;Incertae Sedis;Kirschsteiniotheliaceae;";"0.0";"0";"2";"2";"0";"2";"0";"457181";"373894"
"V4mis1";"SILVA (only NR);Eukaryota;Amorphea;Obazoa;Opisthokonta;Nucletmycea;Fungi;Dikarya;Ascomycota;Pezizomycotina;Dothideomycetes;Incertae Sedis;Kirschsteiniotheliaceae;Kirschsteiniothelia;";"0.0";"0";"2";"2";"0";"2";"0";"457181";"373894"
"V4mis1";"SILVA (only NR);Eukaryota;Amorphea;Obazoa;Opisthokonta;Nucletmycea;Fungi;Dikarya;Ascomycota;Pezizomycotina;Dothideomycetes;Incertae Sedis;Micropeltidaceae;";"0.0";"0";"1";"1";"0";"1";"0";"457182";"373894"
"V4mis1";"SILVA (only NR);Eukaryota;Amorphea;Obazoa;Opisthokonta;Nucletmycea;Fungi;Dikarya;Ascomycota;Pezizomycotina;Dothideomycetes;Incertae Sedis;Micropeltidaceae;Stomiopeltis;";"0.0";"0";"1";"1";"0";"1";"0";"457182";"373894"
"V4mis1";"SILVA (only NR);Eukaryota;Amorphea;Obazoa;Opisthokonta;Nucletmycea;Fungi;Dikarya;Ascomycota;Pezizomycotina;Dothideomycetes;Jahnulales;";"0.0";"0";"7";"7";"0";"7";"0";"457176";"373894"
"V4mis1";"SILVA (only NR);Eukaryota;Amorphea;Obazoa;Opisthokonta;Nucletmycea;Fungi;Dikarya;Ascomycota;Pezizomycotina;Dothideomycetes;Jahnulales;Aliquandostipitaceae;";"0.0";"0";"6";"6";"0";"6";"0";"457177";"373894"
"V4mis1";"SILVA (only NR);Eukaryota;Amorphea;Obazoa;Opisthokonta;Nucletmycea;Fungi;Dikarya;Ascomycota;Pezizomycotina;Dothideomycetes;Jahnulales;Aliquandostipitaceae;Aliquandostipite;";"0.0";"0";"2";"2";"0";"2";"0";"457181";"373894"
"V4mis1";"SILVA (only NR);Eukaryota;Amorphea;Obazoa;Opisthokonta;Nucletmycea;Fungi;Dikarya;Ascomycota;Pezizomycotina;Dothideomycetes;Jahnulales;Aliquandostipitaceae;Jahnula;";"0.0";"0";"4";"4";"0";"4";"0";"457179";"373894"
"V4mis1";"SILVA (only NR);Eukaryota;Amorphea;Obazoa;Opisthokonta;Nucletmycea;Fungi;Dikarya;Ascomycota;Pezizomycotina;Dothideomycetes;Jahnulales;Manglicola;";"0.0";"0";"1";"1";"0";"1";"0";"457182";"373894"
"V4mis1";"SILVA (only NR);Eukaryota;Amorphea;Obazoa;Opisthokonta;Nucletmycea;Fungi;Dikarya;Ascomycota;Pezizomycotina;Dothideomycetes;Myriangiales;";"0.0";"0";"5";"5";"0";"5";"0";"457178";"373894"
"V4mis1";"SILVA (only NR);Eukaryota;Amorphea;Obazoa;Opisthokonta;Nucletmycea;Fungi;Dikarya;Ascomycota;Pezizomycotina;Dothideomycetes;Myriangiales;Elsinoaceae;";"0.0";"0";"3";"3";"0";"3";"0";"457180";"373894"
"V4mis1";"SILVA (only NR);Eukaryota;Amorphea;Obazoa;Opisthokonta;Nucletmycea;Fungi;Dikarya;Ascomycota;Pezizomycotina;Dothideomycetes;Myriangiales;Elsinoaceae;Elsinoe;";"0.0";"0";"3";"3";"0";"3";"0";"457180";"373894"
"V4mis1";"SILVA (only NR);Eukaryota;Amorphea;Obazoa;Opisthokonta;Nucletmycea;Fungi;Dikarya;Ascomycota;Pezizomycotina;Dothideomycetes;Myriangiales;Myriangiaceae;";"0.0";"0";"2";"2";"0";"2";"0";"457181";"373894"
"V4mis1";"SILVA (only NR);Eukaryota;Amorphea;Obazoa;Opisthokonta;Nucletmycea;Fungi;Dikarya;Ascomycota;Pezizomycotina;Dothideomycetes;Myriangiales;Myriangiaceae;Myriangium;";"0.0";"0";"2";"2";"0";"2";"0";"457181";"373894"
"V4mis1";"SILVA (only NR);Eukaryota;Amorphea;Obazoa;Opisthokonta;Nucletmycea;Fungi;Dikarya;Ascomycota;Pezizomycotina;Dothideomycetes;Mytilinidiales;";"0.0";"0";"3";"3";"0";"3";"0";"457180";"373894"
"V4mis1";"SILVA (only NR);Eukaryota;Amorphea;Obazoa;Opisthokonta;Nucletmycea;Fungi;Dikarya;Ascomycota;Pezizomycotina;Dothideomycetes;Mytilinidiales;Mytilinidiaceae;";"0.0";"0";"3";"3";"0";"3";"0";"457180";"373894"
"V4mis1";"SILVA (only NR);Eukaryota;Amorphea;Obazoa;Opisthokonta;Nucletmycea;Fungi;Dikarya;Ascomycota;Pezizomycotina;Dothideomycetes;Mytilinidiales;Mytilinidiaceae;Lophium;";"0.0";"0";"1";"1";"0";"1";"0";"457182";"373894"
"V4mis1";"SILVA (only NR);Eukaryota;Amorphea;Obazoa;Opisthokonta;Nucletmycea;Fungi;Dikarya;Ascomycota;Pezizomycotina;Dothideomycetes;Mytilinidiales;Mytilinidiaceae;Mytilinidion;";"0.0";"0";"1";"1";"0";"1";"0";"457182";"373894"
"V4mis1";"SILVA (only NR);Eukaryota;Amorphea;Obazoa;Opisthokonta;Nucletmycea;Fungi;Dikarya;Ascomycota;Pezizomycotina;Dothideomycetes;Mytilinidiales;Mytilinidiaceae;Slimacomyces;";"0.0";"0";"1";"1";"0";"1";"0";"457182";"373894"
"V4mis1";"SILVA (only NR);Eukaryota;Amorphea;Obazoa;Opisthokonta;Nucletmycea;Fungi;Dikarya;Ascomycota;Pezizomycotina;Dothideomycetes;Pleosporales;";"0.0";"0";"477";"470";"0";"470";"7";"456713";"373894"
"V4mis1";"SILVA (only NR);Eukaryota;Amorphea;Obazoa;Opisthokonta;Nucletmycea;Fungi;Dikarya;Ascomycota;Pezizomycotina;Dothideomycetes;Pleosporales;Acrocordiopsis;";"0.0";"0";"1";"1";"0";"1";"0";"457182";"373894"
"V4mis1";"SILVA (only NR);Eukaryota;Amorphea;Obazoa;Opisthokonta;Nucletmycea;Fungi;Dikarya;Ascomycota;Pezizomycotina;Dothideomycetes;Pleosporales;Aigialaceae;";"0.0";"0";"3";"3";"0";"3";"0";"457180";"373894"
"V4mis1";"SILVA (only NR);Eukaryota;Amorphea;Obazoa;Opisthokonta;Nucletmycea;Fungi;Dikarya;Ascomycota;Pezizomycotina;Dothideomycetes;Pleosporales;Aigialaceae;Aigialus;";"0.0";"0";"3";"3";"0";"3";"0";"457180";"373894"
"V4mis1";"SILVA (only NR);Eukaryota;Amorphea;Obazoa;Opisthokonta;Nucletmycea;Fungi;Dikarya;Ascomycota;Pezizomycotina;Dothideomycetes;Pleosporales;Amia;";"0.0";"0";"1";"1";"0";"1";"0";"457182";"373894"
"V4mis1";"SILVA (only NR);Eukaryota;Amorphea;Obazoa;Opisthokonta;Nucletmycea;Fungi;Dikarya;Ascomycota;Pezizomycotina;Dothideomycetes;Pleosporales;Amorosiaceae;";"0.0";"0";"3";"3";"0";"3";"0";"457180";"373894"
"V4mis1";"SILVA (only NR);Eukaryota;Amorphea;Obazoa;Opisthokonta;Nucletmycea;Fungi;Dikarya;Ascomycota;Pezizomycotina;Dothideomycetes;Pleosporales;Amorosiaceae;Amorosia;";"0.0";"0";"1";"1";"0";"1";"0";"457182";"373894"
"V4mis1";"SILVA (only NR);Eukaryota;Amorphea;Obazoa;Opisthokonta;Nucletmycea;Fungi;Dikarya;Ascomycota;Pezizomycotina;Dothideomycetes;Pleosporales;Anguillospora;";"0.0";"0";"1";"1";"0";"1";"0";"457182";"373894"
"V4mis1";"SILVA (only NR);Eukaryota;Amorphea;Obazoa;Opisthokonta;Nucletmycea;Fungi;Dikarya;Ascomycota;Pezizomycotina;Dothideomycetes;Pleosporales;Arthopyrenia;";"0.0";"0";"1";"1";"0";"1";"0";"457182";"373894"
"V4mis1";"SILVA (only NR);Eukaryota;Amorphea;Obazoa;Opisthokonta;Nucletmycea;Fungi;Dikarya;Ascomycota;Pezizomycotina;Dothideomycetes;Pleosporales;Biatriosporaceae;";"0.0";"0";"2";"2";"0";"2";"0";"457181";"373894"
"V4mis1";"SILVA (only NR);Eukaryota;Amorphea;Obazoa;Opisthokonta;Nucletmycea;Fungi;Dikarya;Ascomycota;Pezizomycotina;Dothideomycetes;Pleosporales;Biatriosporaceae;Biatriospora;";"0.0";"0";"2";"2";"0";"2";"0";"457181";"373894"
"V4mis1";"SILVA (only NR);Eukaryota;Amorphea;Obazoa;Opisthokonta;Nucletmycea;Fungi;Dikarya;Ascomycota;Pezizomycotina;Dothideomycetes;Pleosporales;Byssothecium;";"0.0";"0";"1";"1";"0";"1";"0";"457182";"373894"
"V4mis1";"SILVA (only NR);Eukaryota;Amorphea;Obazoa;Opisthokonta;Nucletmycea;Fungi;Dikarya;Ascomycota;Pezizomycotina;Dothideomycetes;Pleosporales;Coniothyriaceae;";"0.0";"0";"3";"3";"0";"3";"0";"457180";"373894"
"V4mis1";"SILVA (only NR);Eukaryota;Amorphea;Obazoa;Opisthokonta;Nucletmycea;Fungi;Dikarya;Ascomycota;Pezizomycotina;Dothideomycetes;Pleosporales;Coniothyriaceae;Coniothyrium;";"0.0";"0";"3";"3";"0";"3";"0";"457180";"373894"
"V4mis1";"SILVA (only NR);Eukaryota;Amorphea;Obazoa;Opisthokonta;Nucletmycea;Fungi;Dikarya;Ascomycota;Pezizomycotina;Dothideomycetes;Pleosporales;Corynespora;";"0.0";"0";"2";"2";"0";"2";"0";"457181";"373894"
"V4mis1";"SILVA (only NR);Eukaryota;Amorphea;Obazoa;Opisthokonta;Nucletmycea;Fungi;Dikarya;Ascomycota;Pezizomycotina;Dothideomycetes;Pleosporales;Cucurbitariaceae;";"0.0";"0";"10";"10";"0";"10";"0";"457173";"373894"
"V4mis1";"SILVA (only NR);Eukaryota;Amorphea;Obazoa;Opisthokonta;Nucletmycea;Fungi;Dikarya;Ascomycota;Pezizomycotina;Dothideomycetes;Pleosporales;Cucurbitariaceae;Cucurbitaria;";"0.0";"0";"1";"1";"0";"1";"0";"457182";"373894"
"V4mis1";"SILVA (only NR);Eukaryota;Amorphea;Obazoa;Opisthokonta;Nucletmycea;Fungi;Dikarya;Ascomycota;Pezizomycotina;Dothideomycetes;Pleosporales;Cucurbitariaceae;Pyrenochaeta;";"0.0";"0";"7";"7";"0";"7";"0";"457176";"373894"
"V4mis1";"SILVA (only NR);Eukaryota;Amorphea;Obazoa;Opisthokonta;Nucletmycea;Fungi;Dikarya;Ascomycota;Pezizomycotina;Dothideomycetes;Pleosporales;Cucurbitariaceae;uncultured;";"0.0";"0";"2";"2";"0";"2";"0";"457181";"373894"
"V4mis1";"SILVA (only NR);Eukaryota;Amorphea;Obazoa;Opisthokonta;Nucletmycea;Fungi;Dikarya;Ascomycota;Pezizomycotina;Dothideomycetes;Pleosporales;Curreya;";"0.0";"0";"1";"1";"0";"1";"0";"457182";"373894"
"V4mis1";"SILVA (only NR);Eukaryota;Amorphea;Obazoa;Opisthokonta;Nucletmycea;Fungi;Dikarya;Ascomycota;Pezizomycotina;Dothideomycetes;Pleosporales;Cyclothyriella;";"0.0";"0";"1";"1";"0";"1";"0";"457182";"373894"
"V4mis1";"SILVA (only NR);Eukaryota;Amorphea;Obazoa;Opisthokonta;Nucletmycea;Fungi;Dikarya;Ascomycota;Pezizomycotina;Dothideomycetes;Pleosporales;Decaisnella;";"0.0";"0";"1";"1";"0";"1";"0";"457182";"373894"
"V4mis1";"SILVA (only NR);Eukaryota;Amorphea;Obazoa;Opisthokonta;Nucletmycea;Fungi;Dikarya;Ascomycota;Pezizomycotina;Dothideomycetes;Pleosporales;Delitschia;";"0.0";"0";"2";"2";"0";"2";"0";"457181";"373894"
"V4mis1";"SILVA (only NR);Eukaryota;Amorphea;Obazoa;Opisthokonta;Nucletmycea;Fungi;Dikarya;Ascomycota;Pezizomycotina;Dothideomycetes;Pleosporales;Didymellaceae;";"0.0";"0";"86";"82";"0";"82";"4";"457101";"373894"
"V4mis1";"SILVA (only NR);Eukaryota;Amorphea;Obazoa;Opisthokonta;Nucletmycea;Fungi;Dikarya;Ascomycota;Pezizomycotina;Dothideomycetes;Pleosporales;Didymellaceae;Ascochyta;";"0.0";"0";"9";"9";"0";"9";"0";"457174";"373894"
"V4mis1";"SILVA (only NR);Eukaryota;Amorphea;Obazoa;Opisthokonta;Nucletmycea;Fungi;Dikarya;Ascomycota;Pezizomycotina;Dothideomycetes;Pleosporales;Didymellaceae;Boeremia;";"0.0";"0";"63";"63";"0";"63";"0";"457120";"373894"
"V4mis1";"SILVA (only NR);Eukaryota;Amorphea;Obazoa;Opisthokonta;Nucletmycea;Fungi;Dikarya;Ascomycota;Pezizomycotina;Dothideomycetes;Pleosporales;Didymellaceae;Didymella;";"0.0";"0";"6";"2";"0";"2";"4";"457181";"373894"
"V4mis1";"SILVA (only NR);Eukaryota;Amorphea;Obazoa;Opisthokonta;Nucletmycea;Fungi;Dikarya;Ascomycota;Pezizomycotina;Dothideomycetes;Pleosporales;Didymellaceae;Neoascochyta;";"0.0";"0";"1";"1";"0";"1";"0";"457182";"373894"
"V4mis1";"SILVA (only NR);Eukaryota;Amorphea;Obazoa;Opisthokonta;Nucletmycea;Fungi;Dikarya;Ascomycota;Pezizomycotina;Dothideomycetes;Pleosporales;Didymellaceae;Phoma;";"0.0";"0";"5";"5";"0";"5";"0";"457178";"373894"
"V4mis1";"SILVA (only NR);Eukaryota;Amorphea;Obazoa;Opisthokonta;Nucletmycea;Fungi;Dikarya;Ascomycota;Pezizomycotina;Dothideomycetes;Pleosporales;Didymellaceae;Stagonosporopsis;";"0.0";"0";"1";"1";"0";"1";"0";"457182";"373894"
"V4mis1";"SILVA (only NR);Eukaryota;Amorphea;Obazoa;Opisthokonta;Nucletmycea;Fungi;Dikarya;Ascomycota;Pezizomycotina;Dothideomycetes;Pleosporales;Didymocrea;";"0.0";"0";"2";"2";"0";"2";"0";"457181";"373894"
"V4mis1";"SILVA (only NR);Eukaryota;Amorphea;Obazoa;Opisthokonta;Nucletmycea;Fungi;Dikarya;Ascomycota;Pezizomycotina;Dothideomycetes;Pleosporales;Didymosphaeriaceae;";"0.0";"0";"15";"15";"0";"15";"0";"457168";"373894"
"V4mis1";"SILVA (only NR);Eukaryota;Amorphea;Obazoa;Opisthokonta;Nucletmycea;Fungi;Dikarya;Ascomycota;Pezizomycotina;Dothideomycetes;Pleosporales;Didymosphaeriaceae;Bimuria;";"0.0";"0";"3";"3";"0";"3";"0";"457180";"373894"
"V4mis1";"SILVA (only NR);Eukaryota;Amorphea;Obazoa;Opisthokonta;Nucletmycea;Fungi;Dikarya;Ascomycota;Pezizomycotina;Dothideomycetes;Pleosporales;Didymosphaeriaceae;Didymosphaeria;";"0.0";"0";"1";"1";"0";"1";"0";"457182";"373894"
"V4mis1";"SILVA (only NR);Eukaryota;Amorphea;Obazoa;Opisthokonta;Nucletmycea;Fungi;Dikarya;Ascomycota;Pezizomycotina;Dothideomycetes;Pleosporales;Didymosphaeriaceae;Letendraea;";"0.0";"0";"1";"1";"0";"1";"0";"457182";"373894"
"V4mis1";"SILVA (only NR);Eukaryota;Amorphea;Obazoa;Opisthokonta;Nucletmycea;Fungi;Dikarya;Ascomycota;Pezizomycotina;Dothideomycetes;Pleosporales;Didymosphaeriaceae;Paraconiothyrium;";"0.0";"0";"1";"1";"0";"1";"0";"457182";"373894"
"V4mis1";"SILVA (only NR);Eukaryota;Amorphea;Obazoa;Opisthokonta;Nucletmycea;Fungi;Dikarya;Ascomycota;Pezizomycotina;Dothideomycetes;Pleosporales;Didymosphaeriaceae;Paraphaeosphaeria;";"0.0";"0";"3";"3";"0";"3";"0";"457180";"373894"
"V4mis1";"SILVA (only NR);Eukaryota;Amorphea;Obazoa;Opisthokonta;Nucletmycea;Fungi;Dikarya;Ascomycota;Pezizomycotina;Dothideomycetes;Pleosporales;Didymosphaeriaceae;Pseudocamarosporium;";"0.0";"0";"2";"2";"0";"2";"0";"457181";"373894"
"V4mis1";"SILVA (only NR);Eukaryota;Amorphea;Obazoa;Opisthokonta;Nucletmycea;Fungi;Dikarya;Ascomycota;Pezizomycotina;Dothideomycetes;Pleosporales;Halojulellaceae;";"0.0";"0";"2";"2";"0";"2";"0";"457181";"373894"
"V4mis1";"SILVA (only NR);Eukaryota;Amorphea;Obazoa;Opisthokonta;Nucletmycea;Fungi;Dikarya;Ascomycota;Pezizomycotina;Dothideomycetes;Pleosporales;Halojulellaceae;Halojulella;";"0.0";"0";"1";"1";"0";"1";"0";"457182";"373894"
"V4mis1";"SILVA (only NR);Eukaryota;Amorphea;Obazoa;Opisthokonta;Nucletmycea;Fungi;Dikarya;Ascomycota;Pezizomycotina;Dothideomycetes;Pleosporales;Halokirschsteiniothelia;";"0.0";"0";"1";"1";"0";"1";"0";"457182";"373894"
"V4mis1";"SILVA (only NR);Eukaryota;Amorphea;Obazoa;Opisthokonta;Nucletmycea;Fungi;Dikarya;Ascomycota;Pezizomycotina;Dothideomycetes;Pleosporales;Herpotrichia;";"0.0";"0";"3";"3";"0";"3";"0";"457180";"373894"
"V4mis1";"SILVA (only NR);Eukaryota;Amorphea;Obazoa;Opisthokonta;Nucletmycea;Fungi;Dikarya;Ascomycota;Pezizomycotina;Dothideomycetes;Pleosporales;Hypoderma;";"0.0";"0";"1";"1";"0";"1";"0";"457182";"373894"
"V4mis1";"SILVA (only NR);Eukaryota;Amorphea;Obazoa;Opisthokonta;Nucletmycea;Fungi;Dikarya;Ascomycota;Pezizomycotina;Dothideomycetes;Pleosporales;Incertae Sedis;";"0.0";"0";"24";"24";"0";"24";"0";"457159";"373894"
"V4mis1";"SILVA (only NR);Eukaryota;Amorphea;Obazoa;Opisthokonta;Nucletmycea;Fungi;Dikarya;Ascomycota;Pezizomycotina;Dothideomycetes;Pleosporales;Incertae Sedis;Astrosphaeriella;";"0.0";"0";"1";"1";"0";"1";"0";"457182";"373894"
"V4mis1";"SILVA (only NR);Eukaryota;Amorphea;Obazoa;Opisthokonta;Nucletmycea;Fungi;Dikarya;Ascomycota;Pezizomycotina;Dothideomycetes;Pleosporales;Incertae Sedis;Camarosporium;";"0.0";"0";"2";"2";"0";"2";"0";"457181";"373894"
"V4mis1";"SILVA (only NR);Eukaryota;Amorphea;Obazoa;Opisthokonta;Nucletmycea;Fungi;Dikarya;Ascomycota;Pezizomycotina;Dothideomycetes;Pleosporales;Incertae Sedis;Dictyosporium;";"0.0";"0";"3";"3";"0";"3";"0";"457180";"373894"
"V4mis1";"SILVA (only NR);Eukaryota;Amorphea;Obazoa;Opisthokonta;Nucletmycea;Fungi;Dikarya;Ascomycota;Pezizomycotina;Dothideomycetes;Pleosporales;Incertae Sedis;Heleiosa;";"0.0";"0";"1";"1";"0";"1";"0";"457182";"373894"
"V4mis1";"SILVA (only NR);Eukaryota;Amorphea;Obazoa;Opisthokonta;Nucletmycea;Fungi;Dikarya;Ascomycota;Pezizomycotina;Dothideomycetes;Pleosporales;Incertae Sedis;Microsphaeropsis;";"0.0";"0";"3";"3";"0";"3";"0";"457180";"373894"
"V4mis1";"SILVA (only NR);Eukaryota;Amorphea;Obazoa;Opisthokonta;Nucletmycea;Fungi;Dikarya;Ascomycota;Pezizomycotina;Dothideomycetes;Pleosporales;Incertae Sedis;Pleiochaeta;";"0.0";"0";"2";"2";"0";"2";"0";"457181";"373894"
"V4mis1";"SILVA (only NR);Eukaryota;Amorphea;Obazoa;Opisthokonta;Nucletmycea;Fungi;Dikarya;Ascomycota;Pezizomycotina;Dothideomycetes;Pleosporales;Incertae Sedis;Pseudodictyosporium;";"0.0";"0";"2";"2";"0";"2";"0";"457181";"373894"
"V4mis1";"SILVA (only NR);Eukaryota;Amorphea;Obazoa;Opisthokonta;Nucletmycea;Fungi;Dikarya;Ascomycota;Pezizomycotina;Dothideomycetes;Pleosporales;Incertae Sedis;Pseudorobillarda;";"0.0";"0";"1";"1";"0";"1";"0";"457182";"373894"
"V4mis1";"SILVA (only NR);Eukaryota;Amorphea;Obazoa;Opisthokonta;Nucletmycea;Fungi;Dikarya;Ascomycota;Pezizomycotina;Dothideomycetes;Pleosporales;Incertae Sedis;Shiraia;";"0.0";"0";"4";"4";"0";"4";"0";"457179";"373894"
"V4mis1";"SILVA (only NR);Eukaryota;Amorphea;Obazoa;Opisthokonta;Nucletmycea;Fungi;Dikarya;Ascomycota;Pezizomycotina;Dothideomycetes;Pleosporales;Incertae Sedis;uncultured;";"0.0";"0";"3";"3";"0";"3";"0";"457180";"373894"
"V4mis1";"SILVA (only NR);Eukaryota;Amorphea;Obazoa;Opisthokonta;Nucletmycea;Fungi;Dikarya;Ascomycota;Pezizomycotina;Dothideomycetes;Pleosporales;Lentithecium;";"0.0";"0";"1";"1";"0";"1";"0";"457182";"373894"
"V4mis1";"SILVA (only NR);Eukaryota;Amorphea;Obazoa;Opisthokonta;Nucletmycea;Fungi;Dikarya;Ascomycota;Pezizomycotina;Dothideomycetes;Pleosporales;Leptosphaeriaceae;";"0.0";"0";"63";"63";"0";"63";"0";"457120";"373894"
"V4mis1";"SILVA (only NR);Eukaryota;Amorphea;Obazoa;Opisthokonta;Nucletmycea;Fungi;Dikarya;Ascomycota;Pezizomycotina;Dothideomycetes;Pleosporales;Leptosphaeriaceae;Leptosphaeria;";"0.0";"0";"36";"36";"0";"36";"0";"457147";"373894"
"V4mis1";"SILVA (only NR);Eukaryota;Amorphea;Obazoa;Opisthokonta;Nucletmycea;Fungi;Dikarya;Ascomycota;Pezizomycotina;Dothideomycetes;Pleosporales;Leptosphaeriaceae;Neophaeosphaeria;";"0.0";"0";"27";"27";"0";"27";"0";"457156";"373894"
"V4mis1";"SILVA (only NR);Eukaryota;Amorphea;Obazoa;Opisthokonta;Nucletmycea;Fungi;Dikarya;Ascomycota;Pezizomycotina;Dothideomycetes;Pleosporales;Lophiostomataceae;";"0.0";"0";"3";"3";"0";"3";"0";"457180";"373894"
"V4mis1";"SILVA (only NR);Eukaryota;Amorphea;Obazoa;Opisthokonta;Nucletmycea;Fungi;Dikarya;Ascomycota;Pezizomycotina;Dothideomycetes;Pleosporales;Lophiostomataceae;Lophiostoma;";"0.0";"0";"2";"2";"0";"2";"0";"457181";"373894"
"V4mis1";"SILVA (only NR);Eukaryota;Amorphea;Obazoa;Opisthokonta;Nucletmycea;Fungi;Dikarya;Ascomycota;Pezizomycotina;Dothideomycetes;Pleosporales;Lophiostomataceae;Sigarispora;";"0.0";"0";"1";"1";"0";"1";"0";"457182";"373894"
"V4mis1";"SILVA (only NR);Eukaryota;Amorphea;Obazoa;Opisthokonta;Nucletmycea;Fungi;Dikarya;Ascomycota;Pezizomycotina;Dothideomycetes;Pleosporales;Massariaceae;";"0.0";"0";"4";"4";"0";"4";"0";"457179";"373894"
"V4mis1";"SILVA (only NR);Eukaryota;Amorphea;Obazoa;Opisthokonta;Nucletmycea;Fungi;Dikarya;Ascomycota;Pezizomycotina;Dothideomycetes;Pleosporales;Massariaceae;Massaria;";"0.0";"0";"4";"4";"0";"4";"0";"457179";"373894"
"V4mis1";"SILVA (only NR);Eukaryota;Amorphea;Obazoa;Opisthokonta;Nucletmycea;Fungi;Dikarya;Ascomycota;Pezizomycotina;Dothideomycetes;Pleosporales;Massarinaceae;";"0.0";"0";"4";"4";"0";"4";"0";"457179";"373894"
"V4mis1";"SILVA (only NR);Eukaryota;Amorphea;Obazoa;Opisthokonta;Nucletmycea;Fungi;Dikarya;Ascomycota;Pezizomycotina;Dothideomycetes;Pleosporales;Massarinaceae;Helminthosporium;";"0.0";"0";"3";"3";"0";"3";"0";"457180";"373894"
"V4mis1";"SILVA (only NR);Eukaryota;Amorphea;Obazoa;Opisthokonta;Nucletmycea;Fungi;Dikarya;Ascomycota;Pezizomycotina;Dothideomycetes;Pleosporales;Massarinaceae;Stagonospora;";"0.0";"0";"1";"1";"0";"1";"0";"457182";"373894"
"V4mis1";"SILVA (only NR);Eukaryota;Amorphea;Obazoa;Opisthokonta;Nucletmycea;Fungi;Dikarya;Ascomycota;Pezizomycotina;Dothideomycetes;Pleosporales;Morosphaeriaceae;";"0.0";"0";"9";"9";"0";"9";"0";"457174";"373894"
"V4mis1";"SILVA (only NR);Eukaryota;Amorphea;Obazoa;Opisthokonta;Nucletmycea;Fungi;Dikarya;Ascomycota;Pezizomycotina;Dothideomycetes;Pleosporales;Morosphaeriaceae;Helicascus;";"0.0";"0";"4";"4";"0";"4";"0";"457179";"373894"
"V4mis1";"SILVA (only NR);Eukaryota;Amorphea;Obazoa;Opisthokonta;Nucletmycea;Fungi;Dikarya;Ascomycota;Pezizomycotina;Dothideomycetes;Pleosporales;Morosphaeriaceae;Helicoon;";"0.0";"0";"1";"1";"0";"1";"0";"457182";"373894"
"V4mis1";"SILVA (only NR);Eukaryota;Amorphea;Obazoa;Opisthokonta;Nucletmycea;Fungi;Dikarya;Ascomycota;Pezizomycotina;Dothideomycetes;Pleosporales;Morosphaeriaceae;Morosphaeria;";"0.0";"0";"1";"1";"0";"1";"0";"457182";"373894"
"V4mis1";"SILVA (only NR);Eukaryota;Amorphea;Obazoa;Opisthokonta;Nucletmycea;Fungi;Dikarya;Ascomycota;Pezizomycotina;Dothideomycetes;Pleosporales;Periconia;";"0.0";"0";"1";"1";"0";"1";"0";"457182";"373894"
"V4mis1";"SILVA (only NR);Eukaryota;Amorphea;Obazoa;Opisthokonta;Nucletmycea;Fungi;Dikarya;Ascomycota;Pezizomycotina;Dothideomycetes;Pleosporales;Phaeosphaeriaceae;";"0.0";"0";"34";"33";"0";"33";"1";"457150";"373894"
"V4mis1";"SILVA (only NR);Eukaryota;Amorphea;Obazoa;Opisthokonta;Nucletmycea;Fungi;Dikarya;Ascomycota;Pezizomycotina;Dothideomycetes;Pleosporales;Phaeosphaeriaceae;Ophiosphaerella;";"0.0";"0";"8";"7";"0";"7";"1";"457176";"373894"
"V4mis1";"SILVA (only NR);Eukaryota;Amorphea;Obazoa;Opisthokonta;Nucletmycea;Fungi;Dikarya;Ascomycota;Pezizomycotina;Dothideomycetes;Pleosporales;Phaeosphaeriaceae;Parastagonospora;";"0.0";"0";"13";"13";"0";"13";"0";"457170";"373894"
"V4mis1";"SILVA (only NR);Eukaryota;Amorphea;Obazoa;Opisthokonta;Nucletmycea;Fungi;Dikarya;Ascomycota;Pezizomycotina;Dothideomycetes;Pleosporales;Phaeosphaeriaceae;Phaeodothis;";"0.0";"0";"4";"4";"0";"4";"0";"457179";"373894"
"V4mis1";"SILVA (only NR);Eukaryota;Amorphea;Obazoa;Opisthokonta;Nucletmycea;Fungi;Dikarya;Ascomycota;Pezizomycotina;Dothideomycetes;Pleosporales;Phaeosphaeriaceae;Phaeosphaeria;";"0.0";"0";"4";"4";"0";"4";"0";"457179";"373894"
"V4mis1";"SILVA (only NR);Eukaryota;Amorphea;Obazoa;Opisthokonta;Nucletmycea;Fungi;Dikarya;Ascomycota;Pezizomycotina;Dothideomycetes;Pleosporales;Phaeosphaeriaceae;Phaeosphaeriopsis;";"0.0";"0";"1";"1";"0";"1";"0";"457182";"373894"
"V4mis1";"SILVA (only NR);Eukaryota;Amorphea;Obazoa;Opisthokonta;Nucletmycea;Fungi;Dikarya;Ascomycota;Pezizomycotina;Dothideomycetes;Pleosporales;Phaeosphaeriaceae;Setomelanomma;";"0.0";"0";"2";"2";"0";"2";"0";"457181";"373894"
"V4mis1";"SILVA (only NR);Eukaryota;Amorphea;Obazoa;Opisthokonta;Nucletmycea;Fungi;Dikarya;Ascomycota;Pezizomycotina;Dothideomycetes;Pleosporales;Phaeosphaeriaceae;uncultured;";"0.0";"0";"2";"2";"0";"2";"0";"457181";"373894"
"V4mis1";"SILVA (only NR);Eukaryota;Amorphea;Obazoa;Opisthokonta;Nucletmycea;Fungi;Dikarya;Ascomycota;Pezizomycotina;Dothideomycetes;Pleosporales;Pleomassaria;";"0.0";"0";"1";"1";"0";"1";"0";"457182";"373894"
"V4mis1";"SILVA (only NR);Eukaryota;Amorphea;Obazoa;Opisthokonta;Nucletmycea;Fungi;Dikarya;Ascomycota;Pezizomycotina;Dothideomycetes;Pleosporales;Pleosporaceae;";"0.0";"0";"110";"109";"0";"109";"1";"457074";"373894"
"V4mis1";"SILVA (only NR);Eukaryota;Amorphea;Obazoa;Opisthokonta;Nucletmycea;Fungi;Dikarya;Ascomycota;Pezizomycotina;Dothideomycetes;Pleosporales;Pleosporaceae;Alternaria;";"0.0";"0";"27";"27";"0";"27";"0";"457156";"373894"
"V4mis1";"SILVA (only NR);Eukaryota;Amorphea;Obazoa;Opisthokonta;Nucletmycea;Fungi;Dikarya;Ascomycota;Pezizomycotina;Dothideomycetes;Pleosporales;Pleosporaceae;Bipolaris;";"0.0";"0";"34";"33";"0";"33";"1";"457150";"373894"
"V4mis1";"SILVA (only NR);Eukaryota;Amorphea;Obazoa;Opisthokonta;Nucletmycea;Fungi;Dikarya;Ascomycota;Pezizomycotina;Dothideomycetes;Pleosporales;Pleosporaceae;Curvularia;";"0.0";"0";"30";"30";"0";"30";"0";"457153";"373894"
"V4mis1";"SILVA (only NR);Eukaryota;Amorphea;Obazoa;Opisthokonta;Nucletmycea;Fungi;Dikarya;Ascomycota;Pezizomycotina;Dothideomycetes;Pleosporales;Pleosporaceae;Decorospora;";"0.0";"0";"1";"1";"0";"1";"0";"457182";"373894"
"V4mis1";"SILVA (only NR);Eukaryota;Amorphea;Obazoa;Opisthokonta;Nucletmycea;Fungi;Dikarya;Ascomycota;Pezizomycotina;Dothideomycetes;Pleosporales;Pleosporaceae;Drechslera;";"0.0";"0";"1";"1";"0";"1";"0";"457182";"373894"
"V4mis1";"SILVA (only NR);Eukaryota;Amorphea;Obazoa;Opisthokonta;Nucletmycea;Fungi;Dikarya;Ascomycota;Pezizomycotina;Dothideomycetes;Pleosporales;Pleosporaceae;Pleospora;";"0.0";"0";"5";"5";"0";"5";"0";"457178";"373894"
"V4mis1";"SILVA (only NR);Eukaryota;Amorphea;Obazoa;Opisthokonta;Nucletmycea;Fungi;Dikarya;Ascomycota;Pezizomycotina;Dothideomycetes;Pleosporales;Pleosporaceae;Pyrenophora;";"0.0";"0";"6";"6";"0";"6";"0";"457177";"373894"
"V4mis1";"SILVA (only NR);Eukaryota;Amorphea;Obazoa;Opisthokonta;Nucletmycea;Fungi;Dikarya;Ascomycota;Pezizomycotina;Dothideomycetes;Pleosporales;Pleosporaceae;Setosphaeria;";"0.0";"0";"4";"4";"0";"4";"0";"457179";"373894"
"V4mis1";"SILVA (only NR);Eukaryota;Amorphea;Obazoa;Opisthokonta;Nucletmycea;Fungi;Dikarya;Ascomycota;Pezizomycotina;Dothideomycetes;Pleosporales;Pseudochaetosphaeronema;";"0.0";"0";"1";"1";"0";"1";"0";"457182";"373894"
"V4mis1";"SILVA (only NR);Eukaryota;Amorphea;Obazoa;Opisthokonta;Nucletmycea;Fungi;Dikarya;Ascomycota;Pezizomycotina;Dothideomycetes;Pleosporales;Roussoellaceae;";"0.0";"0";"6";"6";"0";"6";"0";"457177";"373894"
"V4mis1";"SILVA (only NR);Eukaryota;Amorphea;Obazoa;Opisthokonta;Nucletmycea;Fungi;Dikarya;Ascomycota;Pezizomycotina;Dothideomycetes;Pleosporales;Roussoellaceae;Roussoella;";"0.0";"0";"6";"6";"0";"6";"0";"457177";"373894"
"V4mis1";"SILVA (only NR);Eukaryota;Amorphea;Obazoa;Opisthokonta;Nucletmycea;Fungi;Dikarya;Ascomycota;Pezizomycotina;Dothideomycetes;Pleosporales;Sporormiaceae;";"0.0";"0";"10";"10";"0";"10";"0";"457173";"373894"
"V4mis1";"SILVA (only NR);Eukaryota;Amorphea;Obazoa;Opisthokonta;Nucletmycea;Fungi;Dikarya;Ascomycota;Pezizomycotina;Dothideomycetes;Pleosporales;Sporormiaceae;Preussia;";"0.0";"0";"7";"7";"0";"7";"0";"457176";"373894"
"V4mis1";"SILVA (only NR);Eukaryota;Amorphea;Obazoa;Opisthokonta;Nucletmycea;Fungi;Dikarya;Ascomycota;Pezizomycotina;Dothideomycetes;Pleosporales;Sporormiaceae;Westerdykella;";"0.0";"0";"3";"3";"0";"3";"0";"457180";"373894"
"V4mis1";"SILVA (only NR);Eukaryota;Amorphea;Obazoa;Opisthokonta;Nucletmycea;Fungi;Dikarya;Ascomycota;Pezizomycotina;Dothideomycetes;Pleosporales;Teichospora;";"0.0";"0";"1";"1";"0";"1";"0";"457182";"373894"
"V4mis1";"SILVA (only NR);Eukaryota;Amorphea;Obazoa;Opisthokonta;Nucletmycea;Fungi;Dikarya;Ascomycota;Pezizomycotina;Dothideomycetes;Pleosporales;Testudinaceae;";"0.0";"0";"5";"5";"0";"5";"0";"457178";"373894"
"V4mis1";"SILVA (only NR);Eukaryota;Amorphea;Obazoa;Opisthokonta;Nucletmycea;Fungi;Dikarya;Ascomycota;Pezizomycotina;Dothideomycetes;Pleosporales;Testudinaceae;Lepidosphaeria;";"0.0";"0";"1";"1";"0";"1";"0";"457182";"373894"
"V4mis1";"SILVA (only NR);Eukaryota;Amorphea;Obazoa;Opisthokonta;Nucletmycea;Fungi;Dikarya;Ascomycota;Pezizomycotina;Dothideomycetes;Pleosporales;Testudinaceae;Neotestudina;";"0.0";"0";"2";"2";"0";"2";"0";"457181";"373894"
"V4mis1";"SILVA (only NR);Eukaryota;Amorphea;Obazoa;Opisthokonta;Nucletmycea;Fungi;Dikarya;Ascomycota;Pezizomycotina;Dothideomycetes;Pleosporales;Testudinaceae;Ulospora;";"0.0";"0";"2";"2";"0";"2";"0";"457181";"373894"
"V4mis1";"SILVA (only NR);Eukaryota;Amorphea;Obazoa;Opisthokonta;Nucletmycea;Fungi;Dikarya;Ascomycota;Pezizomycotina;Dothideomycetes;Pleosporales;Torula;";"0.0";"0";"1";"1";"0";"1";"0";"457182";"373894"
"V4mis1";"SILVA (only NR);Eukaryota;Amorphea;Obazoa;Opisthokonta;Nucletmycea;Fungi;Dikarya;Ascomycota;Pezizomycotina;Dothideomycetes;Pleosporales;Trematosphaeria;";"0.0";"0";"2";"2";"0";"2";"0";"457181";"373894"
"V4mis1";"SILVA (only NR);Eukaryota;Amorphea;Obazoa;Opisthokonta;Nucletmycea;Fungi;Dikarya;Ascomycota;Pezizomycotina;Dothideomycetes;Pleosporales;Trematosphaeriaceae;";"0.0";"0";"2";"2";"0";"2";"0";"457181";"373894"
"V4mis1";"SILVA (only NR);Eukaryota;Amorphea;Obazoa;Opisthokonta;Nucletmycea;Fungi;Dikarya;Ascomycota;Pezizomycotina;Dothideomycetes;Pleosporales;Trematosphaeriaceae;Falciformispora;";"0.0";"0";"1";"1";"0";"1";"0";"457182";"373894"
"V4mis1";"SILVA (only NR);Eukaryota;Amorphea;Obazoa;Opisthokonta;Nucletmycea;Fungi;Dikarya;Ascomycota;Pezizomycotina;Dothideomycetes;Pleosporales;Zopfia;";"0.0";"0";"1";"1";"0";"1";"0";"457182";"373894"
"V4mis1";"SILVA (only NR);Eukaryota;Amorphea;Obazoa;Opisthokonta;Nucletmycea;Fungi;Dikarya;Ascomycota;Pezizomycotina;Dothideomycetes;Pleosporales;uncultured;";"0.0";"0";"31";"31";"0";"31";"0";"457152";"373894"
"V4mis1";"SILVA (only NR);Eukaryota;Amorphea;Obazoa;Opisthokonta;Nucletmycea;Fungi;Dikarya;Ascomycota;Pezizomycotina;Dothideomycetes;Stigmatodiscales;";"0.0";"0";"5";"5";"0";"5";"0";"457178";"373894"
"V4mis1";"SILVA (only NR);Eukaryota;Amorphea;Obazoa;Opisthokonta;Nucletmycea;Fungi;Dikarya;Ascomycota;Pezizomycotina;Dothideomycetes;Stigmatodiscales;Stigmatodiscaceae;";"0.0";"0";"5";"5";"0";"5";"0";"457178";"373894"
"V4mis1";"SILVA (only NR);Eukaryota;Amorphea;Obazoa;Opisthokonta;Nucletmycea;Fungi;Dikarya;Ascomycota;Pezizomycotina;Dothideomycetes;Stigmatodiscales;Stigmatodiscaceae;Asterodiscus;";"0.0";"0";"1";"1";"0";"1";"0";"457182";"373894"
"V4mis1";"SILVA (only NR);Eukaryota;Amorphea;Obazoa;Opisthokonta;Nucletmycea;Fungi;Dikarya;Ascomycota;Pezizomycotina;Dothideomycetes;Stigmatodiscales;Stigmatodiscaceae;Stigmatodiscus;";"0.0";"0";"2";"2";"0";"2";"0";"457181";"373894"
"V4mis1";"SILVA (only NR);Eukaryota;Amorphea;Obazoa;Opisthokonta;Nucletmycea;Fungi;Dikarya;Ascomycota;Pezizomycotina;Dothideomycetes;Stigmatodiscales;Stigmatodiscaceae;uncultured;";"0.0";"0";"2";"2";"0";"2";"0";"457181";"373894"
"V4mis1";"SILVA (only NR);Eukaryota;Amorphea;Obazoa;Opisthokonta;Nucletmycea;Fungi;Dikarya;Ascomycota;Pezizomycotina;Dothideomycetes;Tubeufiales;";"0.0";"0";"32";"32";"0";"32";"0";"457151";"373894"
"V4mis1";"SILVA (only NR);Eukaryota;Amorphea;Obazoa;Opisthokonta;Nucletmycea;Fungi;Dikarya;Ascomycota;Pezizomycotina;Dothideomycetes;Tubeufiales;Tubeufiaceae;";"0.0";"0";"31";"31";"0";"31";"0";"457152";"373894"
"V4mis1";"SILVA (only NR);Eukaryota;Amorphea;Obazoa;Opisthokonta;Nucletmycea;Fungi;Dikarya;Ascomycota;Pezizomycotina;Dothideomycetes;Tubeufiales;Tubeufiaceae;Acanthostigma;";"0.0";"0";"1";"1";"0";"1";"0";"457182";"373894"
"V4mis1";"SILVA (only NR);Eukaryota;Amorphea;Obazoa;Opisthokonta;Nucletmycea;Fungi;Dikarya;Ascomycota;Pezizomycotina;Dothideomycetes;Tubeufiales;Tubeufiaceae;Aquaphila;";"0.0";"0";"1";"1";"0";"1";"0";"457182";"373894"
"V4mis1";"SILVA (only NR);Eukaryota;Amorphea;Obazoa;Opisthokonta;Nucletmycea;Fungi;Dikarya;Ascomycota;Pezizomycotina;Dothideomycetes;Tubeufiales;Tubeufiaceae;Helicoma;";"0.0";"0";"11";"11";"0";"11";"0";"457172";"373894"
"V4mis1";"SILVA (only NR);Eukaryota;Amorphea;Obazoa;Opisthokonta;Nucletmycea;Fungi;Dikarya;Ascomycota;Pezizomycotina;Dothideomycetes;Tubeufiales;Tubeufiaceae;Helicomyces;";"0.0";"0";"4";"4";"0";"4";"0";"457179";"373894"
"V4mis1";"SILVA (only NR);Eukaryota;Amorphea;Obazoa;Opisthokonta;Nucletmycea;Fungi;Dikarya;Ascomycota;Pezizomycotina;Dothideomycetes;Tubeufiales;Tubeufiaceae;Helicosporium;";"0.0";"0";"7";"7";"0";"7";"0";"457176";"373894"
"V4mis1";"SILVA (only NR);Eukaryota;Amorphea;Obazoa;Opisthokonta;Nucletmycea;Fungi;Dikarya;Ascomycota;Pezizomycotina;Dothideomycetes;Tubeufiales;Tubeufiaceae;Tubeufia;";"0.0";"0";"7";"7";"0";"7";"0";"457176";"373894"
"V4mis1";"SILVA (only NR);Eukaryota;Amorphea;Obazoa;Opisthokonta;Nucletmycea;Fungi;Dikarya;Ascomycota;Pezizomycotina;Dothideomycetes;Tubeufiales;Wiesneriomyces;";"0.0";"0";"1";"1";"0";"1";"0";"457182";"373894"
"V4mis1";"SILVA (only NR);Eukaryota;Amorphea;Obazoa;Opisthokonta;Nucletmycea;Fungi;Dikarya;Ascomycota;Pezizomycotina;Dothideomycetes;Valsariales;";"0.0";"0";"4";"4";"0";"4";"0";"457179";"373894"
"V4mis1";"SILVA (only NR);Eukaryota;Amorphea;Obazoa;Opisthokonta;Nucletmycea;Fungi;Dikarya;Ascomycota;Pezizomycotina;Dothideomycetes;Valsariales;Valsariaceae;";"0.0";"0";"4";"4";"0";"4";"0";"457179";"373894"
"V4mis1";"SILVA (only NR);Eukaryota;Amorphea;Obazoa;Opisthokonta;Nucletmycea;Fungi;Dikarya;Ascomycota;Pezizomycotina;Dothideomycetes;Valsariales;Valsariaceae;Myrmaecium;";"0.0";"0";"1";"1";"0";"1";"0";"457182";"373894"
"V4mis1";"SILVA (only NR);Eukaryota;Amorphea;Obazoa;Opisthokonta;Nucletmycea;Fungi;Dikarya;Ascomycota;Pezizomycotina;Dothideomycetes;Valsariales;Valsariaceae;Valsaria;";"0.0";"0";"3";"3";"0";"3";"0";"457180";"373894"
"V4mis1";"SILVA (only NR);Eukaryota;Amorphea;Obazoa;Opisthokonta;Nucletmycea;Fungi;Dikarya;Ascomycota;Pezizomycotina;Dothideomycetes;Venturiales;";"0.0";"0";"33";"33";"0";"33";"0";"457150";"373894"
"V4mis1";"SILVA (only NR);Eukaryota;Amorphea;Obazoa;Opisthokonta;Nucletmycea;Fungi;Dikarya;Ascomycota;Pezizomycotina;Dothideomycetes;Venturiales;Sympoventuriaceae;";"0.0";"0";"28";"28";"0";"28";"0";"457155";"373894"
"V4mis1";"SILVA (only NR);Eukaryota;Amorphea;Obazoa;Opisthokonta;Nucletmycea;Fungi;Dikarya;Ascomycota;Pezizomycotina;Dothideomycetes;Venturiales;Sympoventuriaceae;Fusicladium;";"0.0";"0";"1";"1";"0";"1";"0";"457182";"373894"
"V4mis1";"SILVA (only NR);Eukaryota;Amorphea;Obazoa;Opisthokonta;Nucletmycea;Fungi;Dikarya;Ascomycota;Pezizomycotina;Dothideomycetes;Venturiales;Sympoventuriaceae;Mycosisymbrium;";"0.0";"0";"1";"1";"0";"1";"0";"457182";"373894"
"V4mis1";"SILVA (only NR);Eukaryota;Amorphea;Obazoa;Opisthokonta;Nucletmycea;Fungi;Dikarya;Ascomycota;Pezizomycotina;Dothideomycetes;Venturiales;Sympoventuriaceae;Ochroconis;";"0.0";"0";"20";"20";"0";"20";"0";"457163";"373894"
"V4mis1";"SILVA (only NR);Eukaryota;Amorphea;Obazoa;Opisthokonta;Nucletmycea;Fungi;Dikarya;Ascomycota;Pezizomycotina;Dothideomycetes;Venturiales;Sympoventuriaceae;Veronaeopsis;";"0.0";"0";"1";"1";"0";"1";"0";"457182";"373894"
"V4mis1";"SILVA (only NR);Eukaryota;Amorphea;Obazoa;Opisthokonta;Nucletmycea;Fungi;Dikarya;Ascomycota;Pezizomycotina;Dothideomycetes;Venturiales;Sympoventuriaceae;Verruconis;";"0.0";"0";"2";"2";"0";"2";"0";"457181";"373894"
"V4mis1";"SILVA (only NR);Eukaryota;Amorphea;Obazoa;Opisthokonta;Nucletmycea;Fungi;Dikarya;Ascomycota;Pezizomycotina;Dothideomycetes;Venturiales;Sympoventuriaceae;uncultured;";"0.0";"0";"2";"2";"0";"2";"0";"457181";"373894"
"V4mis1";"SILVA (only NR);Eukaryota;Amorphea;Obazoa;Opisthokonta;Nucletmycea;Fungi;Dikarya;Ascomycota;Pezizomycotina;Dothideomycetes;Venturiales;Venturiaceae;";"0.0";"0";"5";"5";"0";"5";"0";"457178";"373894"
"V4mis1";"SILVA (only NR);Eukaryota;Amorphea;Obazoa;Opisthokonta;Nucletmycea;Fungi;Dikarya;Ascomycota;Pezizomycotina;Dothideomycetes;Venturiales;Venturiaceae;Venturia;";"0.0";"0";"5";"5";"0";"5";"0";"457178";"373894"
"V4mis1";"SILVA (only NR);Eukaryota;Amorphea;Obazoa;Opisthokonta;Nucletmycea;Fungi;Dikarya;Ascomycota;Pezizomycotina;Dothideomycetes;uncultured;";"0.0";"0";"8";"8";"0";"8";"0";"457175";"373894"
"V4mis1";"SILVA (only NR);Eukaryota;Amorphea;Obazoa;Opisthokonta;Nucletmycea;Fungi;Dikarya;Ascomycota;Pezizomycotina;Eurotiomycetes;";"0.0";"0";"833";"827";"0";"827";"6";"456356";"373894"
"V4mis1";"SILVA (only NR);Eukaryota;Amorphea;Obazoa;Opisthokonta;Nucletmycea;Fungi;Dikarya;Ascomycota;Pezizomycotina;Eurotiomycetes;Chaetothyriales;";"0.0";"0";"176";"176";"0";"176";"0";"457007";"373894"
"V4mis1";"SILVA (only NR);Eukaryota;Amorphea;Obazoa;Opisthokonta;Nucletmycea;Fungi;Dikarya;Ascomycota;Pezizomycotina;Eurotiomycetes;Chaetothyriales;Chaetothyriaceae;";"0.0";"0";"4";"4";"0";"4";"0";"457179";"373894"
"V4mis1";"SILVA (only NR);Eukaryota;Amorphea;Obazoa;Opisthokonta;Nucletmycea;Fungi;Dikarya;Ascomycota;Pezizomycotina;Eurotiomycetes;Chaetothyriales;Chaetothyriaceae;Camptophora;";"0.0";"0";"2";"2";"0";"2";"0";"457181";"373894"
"V4mis1";"SILVA (only NR);Eukaryota;Amorphea;Obazoa;Opisthokonta;Nucletmycea;Fungi;Dikarya;Ascomycota;Pezizomycotina;Eurotiomycetes;Chaetothyriales;Chaetothyriaceae;Ceramothyrium;";"0.0";"0";"2";"2";"0";"2";"0";"457181";"373894"
"V4mis1";"SILVA (only NR);Eukaryota;Amorphea;Obazoa;Opisthokonta;Nucletmycea;Fungi;Dikarya;Ascomycota;Pezizomycotina;Eurotiomycetes;Chaetothyriales;Cyphellophoraceae;";"0.0";"0";"17";"17";"0";"17";"0";"457166";"373894"
"V4mis1";"SILVA (only NR);Eukaryota;Amorphea;Obazoa;Opisthokonta;Nucletmycea;Fungi;Dikarya;Ascomycota;Pezizomycotina;Eurotiomycetes;Chaetothyriales;Cyphellophoraceae;Cyphellophora;";"0.0";"0";"17";"17";"0";"17";"0";"457166";"373894"
"V4mis1";"SILVA (only NR);Eukaryota;Amorphea;Obazoa;Opisthokonta;Nucletmycea;Fungi;Dikarya;Ascomycota;Pezizomycotina;Eurotiomycetes;Chaetothyriales;Herpotrichiellaceae;";"0.0";"0";"109";"109";"0";"109";"0";"457074";"373894"
"V4mis1";"SILVA (only NR);Eukaryota;Amorphea;Obazoa;Opisthokonta;Nucletmycea;Fungi;Dikarya;Ascomycota;Pezizomycotina;Eurotiomycetes;Chaetothyriales;Herpotrichiellaceae;Berlesiella;";"0.0";"0";"1";"1";"0";"1";"0";"457182";"373894"
"V4mis1";"SILVA (only NR);Eukaryota;Amorphea;Obazoa;Opisthokonta;Nucletmycea;Fungi;Dikarya;Ascomycota;Pezizomycotina;Eurotiomycetes;Chaetothyriales;Herpotrichiellaceae;Capronia;";"0.0";"0";"15";"15";"0";"15";"0";"457168";"373894"
"V4mis1";"SILVA (only NR);Eukaryota;Amorphea;Obazoa;Opisthokonta;Nucletmycea;Fungi;Dikarya;Ascomycota;Pezizomycotina;Eurotiomycetes;Chaetothyriales;Herpotrichiellaceae;Cladophialophora;";"0.0";"0";"25";"25";"0";"25";"0";"457158";"373894"
"V4mis1";"SILVA (only NR);Eukaryota;Amorphea;Obazoa;Opisthokonta;Nucletmycea;Fungi;Dikarya;Ascomycota;Pezizomycotina;Eurotiomycetes;Chaetothyriales;Herpotrichiellaceae;Exophiala;";"0.0";"0";"44";"44";"0";"44";"0";"457139";"373894"
"V4mis1";"SILVA (only NR);Eukaryota;Amorphea;Obazoa;Opisthokonta;Nucletmycea;Fungi;Dikarya;Ascomycota;Pezizomycotina;Eurotiomycetes;Chaetothyriales;Herpotrichiellaceae;Fonsecaea;";"0.0";"0";"9";"9";"0";"9";"0";"457174";"373894"
"V4mis1";"SILVA (only NR);Eukaryota;Amorphea;Obazoa;Opisthokonta;Nucletmycea;Fungi;Dikarya;Ascomycota;Pezizomycotina;Eurotiomycetes;Chaetothyriales;Herpotrichiellaceae;Phialophora;";"0.0";"0";"5";"5";"0";"5";"0";"457178";"373894"
"V4mis1";"SILVA (only NR);Eukaryota;Amorphea;Obazoa;Opisthokonta;Nucletmycea;Fungi;Dikarya;Ascomycota;Pezizomycotina;Eurotiomycetes;Chaetothyriales;Herpotrichiellaceae;Rhinocladiella;";"0.0";"0";"5";"5";"0";"5";"0";"457178";"373894"
"V4mis1";"SILVA (only NR);Eukaryota;Amorphea;Obazoa;Opisthokonta;Nucletmycea;Fungi;Dikarya;Ascomycota;Pezizomycotina;Eurotiomycetes;Chaetothyriales;Herpotrichiellaceae;Veronaea;";"0.0";"0";"1";"1";"0";"1";"0";"457182";"373894"
"V4mis1";"SILVA (only NR);Eukaryota;Amorphea;Obazoa;Opisthokonta;Nucletmycea;Fungi;Dikarya;Ascomycota;Pezizomycotina;Eurotiomycetes;Chaetothyriales;Herpotrichiellaceae;uncultured;";"0.0";"0";"2";"2";"0";"2";"0";"457181";"373894"
"V4mis1";"SILVA (only NR);Eukaryota;Amorphea;Obazoa;Opisthokonta;Nucletmycea;Fungi;Dikarya;Ascomycota;Pezizomycotina;Eurotiomycetes;Chaetothyriales;Trichomeriaceae;";"0.0";"0";"34";"34";"0";"34";"0";"457149";"373894"
"V4mis1";"SILVA (only NR);Eukaryota;Amorphea;Obazoa;Opisthokonta;Nucletmycea;Fungi;Dikarya;Ascomycota;Pezizomycotina;Eurotiomycetes;Chaetothyriales;Trichomeriaceae;Bacillicladium;";"0.0";"0";"1";"1";"0";"1";"0";"457182";"373894"
"V4mis1";"SILVA (only NR);Eukaryota;Amorphea;Obazoa;Opisthokonta;Nucletmycea;Fungi;Dikarya;Ascomycota;Pezizomycotina;Eurotiomycetes;Chaetothyriales;Trichomeriaceae;Bradymyces;";"0.0";"0";"10";"10";"0";"10";"0";"457173";"373894"
"V4mis1";"SILVA (only NR);Eukaryota;Amorphea;Obazoa;Opisthokonta;Nucletmycea;Fungi;Dikarya;Ascomycota;Pezizomycotina;Eurotiomycetes;Chaetothyriales;Trichomeriaceae;Knufia;";"0.0";"0";"18";"18";"0";"18";"0";"457165";"373894"
"V4mis1";"SILVA (only NR);Eukaryota;Amorphea;Obazoa;Opisthokonta;Nucletmycea;Fungi;Dikarya;Ascomycota;Pezizomycotina;Eurotiomycetes;Chaetothyriales;Trichomeriaceae;Neophaeococcomyces;";"0.0";"0";"1";"1";"0";"1";"0";"457182";"373894"
"V4mis1";"SILVA (only NR);Eukaryota;Amorphea;Obazoa;Opisthokonta;Nucletmycea;Fungi;Dikarya;Ascomycota;Pezizomycotina;Eurotiomycetes;Chaetothyriales;Trichomeriaceae;uncultured;";"0.0";"0";"2";"2";"0";"2";"0";"457181";"373894"
"V4mis1";"SILVA (only NR);Eukaryota;Amorphea;Obazoa;Opisthokonta;Nucletmycea;Fungi;Dikarya;Ascomycota;Pezizomycotina;Eurotiomycetes;Chaetothyriales;uncultured;";"0.0";"0";"8";"8";"0";"8";"0";"457175";"373894"
"V4mis1";"SILVA (only NR);Eukaryota;Amorphea;Obazoa;Opisthokonta;Nucletmycea;Fungi;Dikarya;Ascomycota;Pezizomycotina;Eurotiomycetes;Coryneliales;";"0.0";"0";"5";"5";"0";"5";"0";"457178";"373894"
"V4mis1";"SILVA (only NR);Eukaryota;Amorphea;Obazoa;Opisthokonta;Nucletmycea;Fungi;Dikarya;Ascomycota;Pezizomycotina;Eurotiomycetes;Coryneliales;Coryneliaceae;";"0.0";"0";"5";"5";"0";"5";"0";"457178";"373894"
"V4mis1";"SILVA (only NR);Eukaryota;Amorphea;Obazoa;Opisthokonta;Nucletmycea;Fungi;Dikarya;Ascomycota;Pezizomycotina;Eurotiomycetes;Coryneliales;Coryneliaceae;Caliciopsis;";"0.0";"0";"2";"2";"0";"2";"0";"457181";"373894"
"V4mis1";"SILVA (only NR);Eukaryota;Amorphea;Obazoa;Opisthokonta;Nucletmycea;Fungi;Dikarya;Ascomycota;Pezizomycotina;Eurotiomycetes;Coryneliales;Coryneliaceae;Corynelia;";"0.0";"0";"2";"2";"0";"2";"0";"457181";"373894"
"V4mis1";"SILVA (only NR);Eukaryota;Amorphea;Obazoa;Opisthokonta;Nucletmycea;Fungi;Dikarya;Ascomycota;Pezizomycotina;Eurotiomycetes;Coryneliales;Coryneliaceae;Lagenulopsis;";"0.0";"0";"1";"1";"0";"1";"0";"457182";"373894"
"V4mis1";"SILVA (only NR);Eukaryota;Amorphea;Obazoa;Opisthokonta;Nucletmycea;Fungi;Dikarya;Ascomycota;Pezizomycotina;Eurotiomycetes;Eurotiales;";"0.0";"0";"440";"435";"0";"435";"5";"456748";"373894"
"V4mis1";"SILVA (only NR);Eukaryota;Amorphea;Obazoa;Opisthokonta;Nucletmycea;Fungi;Dikarya;Ascomycota;Pezizomycotina;Eurotiomycetes;Eurotiales;Aspergillaceae;";"0.0";"0";"304";"299";"0";"299";"5";"456884";"373894"
"V4mis1";"SILVA (only NR);Eukaryota;Amorphea;Obazoa;Opisthokonta;Nucletmycea;Fungi;Dikarya;Ascomycota;Pezizomycotina;Eurotiomycetes;Eurotiales;Aspergillaceae;Aspergillus;";"0.0";"0";"201";"196";"0";"196";"5";"456987";"373894"
"V4mis1";"SILVA (only NR);Eukaryota;Amorphea;Obazoa;Opisthokonta;Nucletmycea;Fungi;Dikarya;Ascomycota;Pezizomycotina;Eurotiomycetes;Eurotiales;Aspergillaceae;Chromocleista;";"0.0";"0";"2";"2";"0";"2";"0";"457181";"373894"
"V4mis1";"SILVA (only NR);Eukaryota;Amorphea;Obazoa;Opisthokonta;Nucletmycea;Fungi;Dikarya;Ascomycota;Pezizomycotina;Eurotiomycetes;Eurotiales;Aspergillaceae;Eurotium;";"0.0";"0";"1";"1";"0";"1";"0";"457182";"373894"
"V4mis1";"SILVA (only NR);Eukaryota;Amorphea;Obazoa;Opisthokonta;Nucletmycea;Fungi;Dikarya;Ascomycota;Pezizomycotina;Eurotiomycetes;Eurotiales;Aspergillaceae;Hamigera;";"0.0";"0";"3";"3";"0";"3";"0";"457180";"373894"
"V4mis1";"SILVA (only NR);Eukaryota;Amorphea;Obazoa;Opisthokonta;Nucletmycea;Fungi;Dikarya;Ascomycota;Pezizomycotina;Eurotiomycetes;Eurotiales;Aspergillaceae;Leiothecium;";"0.0";"0";"2";"2";"0";"2";"0";"457181";"373894"
"V4mis1";"SILVA (only NR);Eukaryota;Amorphea;Obazoa;Opisthokonta;Nucletmycea;Fungi;Dikarya;Ascomycota;Pezizomycotina;Eurotiomycetes;Eurotiales;Aspergillaceae;Merimbla;";"0.0";"0";"1";"1";"0";"1";"0";"457182";"373894"
"V4mis1";"SILVA (only NR);Eukaryota;Amorphea;Obazoa;Opisthokonta;Nucletmycea;Fungi;Dikarya;Ascomycota;Pezizomycotina;Eurotiomycetes;Eurotiales;Aspergillaceae;Monascus;";"0.0";"0";"8";"8";"0";"8";"0";"457175";"373894"
"V4mis1";"SILVA (only NR);Eukaryota;Amorphea;Obazoa;Opisthokonta;Nucletmycea;Fungi;Dikarya;Ascomycota;Pezizomycotina;Eurotiomycetes;Eurotiales;Aspergillaceae;Penicilliopsis;";"0.0";"0";"5";"5";"0";"5";"0";"457178";"373894"
"V4mis1";"SILVA (only NR);Eukaryota;Amorphea;Obazoa;Opisthokonta;Nucletmycea;Fungi;Dikarya;Ascomycota;Pezizomycotina;Eurotiomycetes;Eurotiales;Aspergillaceae;Penicillium;";"0.0";"0";"60";"60";"0";"60";"0";"457123";"373894"
"V4mis1";"SILVA (only NR);Eukaryota;Amorphea;Obazoa;Opisthokonta;Nucletmycea;Fungi;Dikarya;Ascomycota;Pezizomycotina;Eurotiomycetes;Eurotiales;Aspergillaceae;Sclerocleista;";"0.0";"0";"3";"3";"0";"3";"0";"457180";"373894"
"V4mis1";"SILVA (only NR);Eukaryota;Amorphea;Obazoa;Opisthokonta;Nucletmycea;Fungi;Dikarya;Ascomycota;Pezizomycotina;Eurotiomycetes;Eurotiales;Aspergillaceae;Thysanophora;";"0.0";"0";"10";"10";"0";"10";"0";"457173";"373894"
"V4mis1";"SILVA (only NR);Eukaryota;Amorphea;Obazoa;Opisthokonta;Nucletmycea;Fungi;Dikarya;Ascomycota;Pezizomycotina;Eurotiomycetes;Eurotiales;Aspergillaceae;Warcupiella;";"0.0";"0";"2";"2";"0";"2";"0";"457181";"373894"
"V4mis1";"SILVA (only NR);Eukaryota;Amorphea;Obazoa;Opisthokonta;Nucletmycea;Fungi;Dikarya;Ascomycota;Pezizomycotina;Eurotiomycetes;Eurotiales;Aspergillaceae;Xerochrysium;";"0.0";"0";"1";"1";"0";"1";"0";"457182";"373894"
"V4mis1";"SILVA (only NR);Eukaryota;Amorphea;Obazoa;Opisthokonta;Nucletmycea;Fungi;Dikarya;Ascomycota;Pezizomycotina;Eurotiomycetes;Eurotiales;Aspergillaceae;Xeromyces;";"0.0";"0";"3";"3";"0";"3";"0";"457180";"373894"
"V4mis1";"SILVA (only NR);Eukaryota;Amorphea;Obazoa;Opisthokonta;Nucletmycea;Fungi;Dikarya;Ascomycota;Pezizomycotina;Eurotiomycetes;Eurotiales;Elaphomycetaceae;";"0.0";"0";"4";"4";"0";"4";"0";"457179";"373894"
"V4mis1";"SILVA (only NR);Eukaryota;Amorphea;Obazoa;Opisthokonta;Nucletmycea;Fungi;Dikarya;Ascomycota;Pezizomycotina;Eurotiomycetes;Eurotiales;Elaphomycetaceae;Elaphomyces;";"0.0";"0";"2";"2";"0";"2";"0";"457181";"373894"
"V4mis1";"SILVA (only NR);Eukaryota;Amorphea;Obazoa;Opisthokonta;Nucletmycea;Fungi;Dikarya;Ascomycota;Pezizomycotina;Eurotiomycetes;Eurotiales;Elaphomycetaceae;Pseudotulostoma;";"0.0";"0";"2";"2";"0";"2";"0";"457181";"373894"
"V4mis1";"SILVA (only NR);Eukaryota;Amorphea;Obazoa;Opisthokonta;Nucletmycea;Fungi;Dikarya;Ascomycota;Pezizomycotina;Eurotiomycetes;Eurotiales;Incertae Sedis;";"0.0";"0";"2";"2";"0";"2";"0";"457181";"373894"
"V4mis1";"SILVA (only NR);Eukaryota;Amorphea;Obazoa;Opisthokonta;Nucletmycea;Fungi;Dikarya;Ascomycota;Pezizomycotina;Eurotiomycetes;Eurotiales;Incertae Sedis;Eladia;";"0.0";"0";"2";"2";"0";"2";"0";"457181";"373894"
"V4mis1";"SILVA (only NR);Eukaryota;Amorphea;Obazoa;Opisthokonta;Nucletmycea;Fungi;Dikarya;Ascomycota;Pezizomycotina;Eurotiomycetes;Eurotiales;Thermoascaceae;";"0.0";"0";"17";"17";"0";"17";"0";"457166";"373894"
"V4mis1";"SILVA (only NR);Eukaryota;Amorphea;Obazoa;Opisthokonta;Nucletmycea;Fungi;Dikarya;Ascomycota;Pezizomycotina;Eurotiomycetes;Eurotiales;Thermoascaceae;Byssochlamys;";"0.0";"0";"13";"13";"0";"13";"0";"457170";"373894"
"V4mis1";"SILVA (only NR);Eukaryota;Amorphea;Obazoa;Opisthokonta;Nucletmycea;Fungi;Dikarya;Ascomycota;Pezizomycotina;Eurotiomycetes;Eurotiales;Thermoascaceae;Thermoascus;";"0.0";"0";"4";"4";"0";"4";"0";"457179";"373894"
"V4mis1";"SILVA (only NR);Eukaryota;Amorphea;Obazoa;Opisthokonta;Nucletmycea;Fungi;Dikarya;Ascomycota;Pezizomycotina;Eurotiomycetes;Eurotiales;Trichocomaceae;";"0.0";"0";"110";"110";"0";"110";"0";"457073";"373894"
"V4mis1";"SILVA (only NR);Eukaryota;Amorphea;Obazoa;Opisthokonta;Nucletmycea;Fungi;Dikarya;Ascomycota;Pezizomycotina;Eurotiomycetes;Eurotiales;Trichocomaceae;Rasamsonia;";"0.0";"0";"6";"6";"0";"6";"0";"457177";"373894"
"V4mis1";"SILVA (only NR);Eukaryota;Amorphea;Obazoa;Opisthokonta;Nucletmycea;Fungi;Dikarya;Ascomycota;Pezizomycotina;Eurotiomycetes;Eurotiales;Trichocomaceae;Sagenomella;";"0.0";"0";"6";"6";"0";"6";"0";"457177";"373894"
"V4mis1";"SILVA (only NR);Eukaryota;Amorphea;Obazoa;Opisthokonta;Nucletmycea;Fungi;Dikarya;Ascomycota;Pezizomycotina;Eurotiomycetes;Eurotiales;Trichocomaceae;Talaromyces;";"0.0";"0";"91";"91";"0";"91";"0";"457092";"373894"
"V4mis1";"SILVA (only NR);Eukaryota;Amorphea;Obazoa;Opisthokonta;Nucletmycea;Fungi;Dikarya;Ascomycota;Pezizomycotina;Eurotiomycetes;Eurotiales;Trichocomaceae;Thermomyces;";"0.0";"0";"3";"3";"0";"3";"0";"457180";"373894"
"V4mis1";"SILVA (only NR);Eukaryota;Amorphea;Obazoa;Opisthokonta;Nucletmycea;Fungi;Dikarya;Ascomycota;Pezizomycotina;Eurotiomycetes;Eurotiales;Trichocomaceae;Trichocoma;";"0.0";"0";"3";"3";"0";"3";"0";"457180";"373894"
"V4mis1";"SILVA (only NR);Eukaryota;Amorphea;Obazoa;Opisthokonta;Nucletmycea;Fungi;Dikarya;Ascomycota;Pezizomycotina;Eurotiomycetes;Incertae Sedis;";"0.0";"0";"3";"3";"0";"3";"0";"457180";"373894"
"V4mis1";"SILVA (only NR);Eukaryota;Amorphea;Obazoa;Opisthokonta;Nucletmycea;Fungi;Dikarya;Ascomycota;Pezizomycotina;Eurotiomycetes;Incertae Sedis;Incertae Sedis;";"0.0";"0";"1";"1";"0";"1";"0";"457182";"373894"
"V4mis1";"SILVA (only NR);Eukaryota;Amorphea;Obazoa;Opisthokonta;Nucletmycea;Fungi;Dikarya;Ascomycota;Pezizomycotina;Eurotiomycetes;Incertae Sedis;Incertae Sedis;Pseudospiromastix;";"0.0";"0";"1";"1";"0";"1";"0";"457182";"373894"
"V4mis1";"SILVA (only NR);Eukaryota;Amorphea;Obazoa;Opisthokonta;Nucletmycea;Fungi;Dikarya;Ascomycota;Pezizomycotina;Eurotiomycetes;Incertae Sedis;Rhynchostomataceae;";"0.0";"0";"2";"2";"0";"2";"0";"457181";"373894"
"V4mis1";"SILVA (only NR);Eukaryota;Amorphea;Obazoa;Opisthokonta;Nucletmycea;Fungi;Dikarya;Ascomycota;Pezizomycotina;Eurotiomycetes;Incertae Sedis;Rhynchostomataceae;Rhynchostoma;";"0.0";"0";"2";"2";"0";"2";"0";"457181";"373894"
"V4mis1";"SILVA (only NR);Eukaryota;Amorphea;Obazoa;Opisthokonta;Nucletmycea;Fungi;Dikarya;Ascomycota;Pezizomycotina;Eurotiomycetes;Mycocaliciales;";"0.0";"0";"4";"4";"0";"4";"0";"457179";"373894"
"V4mis1";"SILVA (only NR);Eukaryota;Amorphea;Obazoa;Opisthokonta;Nucletmycea;Fungi;Dikarya;Ascomycota;Pezizomycotina;Eurotiomycetes;Mycocaliciales;Mycocaliciaceae;";"0.0";"0";"3";"3";"0";"3";"0";"457180";"373894"
"V4mis1";"SILVA (only NR);Eukaryota;Amorphea;Obazoa;Opisthokonta;Nucletmycea;Fungi;Dikarya;Ascomycota;Pezizomycotina;Eurotiomycetes;Mycocaliciales;Mycocaliciaceae;Chaenothecopsis;";"0.0";"0";"1";"1";"0";"1";"0";"457182";"373894"
"V4mis1";"SILVA (only NR);Eukaryota;Amorphea;Obazoa;Opisthokonta;Nucletmycea;Fungi;Dikarya;Ascomycota;Pezizomycotina;Eurotiomycetes;Mycocaliciales;Mycocaliciaceae;Mycocalicium;";"0.0";"0";"1";"1";"0";"1";"0";"457182";"373894"
"V4mis1";"SILVA (only NR);Eukaryota;Amorphea;Obazoa;Opisthokonta;Nucletmycea;Fungi;Dikarya;Ascomycota;Pezizomycotina;Eurotiomycetes;Mycocaliciales;Mycocaliciaceae;Stenocybe;";"0.0";"0";"1";"1";"0";"1";"0";"457182";"373894"
"V4mis1";"SILVA (only NR);Eukaryota;Amorphea;Obazoa;Opisthokonta;Nucletmycea;Fungi;Dikarya;Ascomycota;Pezizomycotina;Eurotiomycetes;Mycocaliciales;Sphinctrina;";"0.0";"0";"1";"1";"0";"1";"0";"457182";"373894"
"V4mis1";"SILVA (only NR);Eukaryota;Amorphea;Obazoa;Opisthokonta;Nucletmycea;Fungi;Dikarya;Ascomycota;Pezizomycotina;Eurotiomycetes;Onygenales;";"0.0";"0";"150";"150";"0";"150";"0";"457033";"373894"
"V4mis1";"SILVA (only NR);Eukaryota;Amorphea;Obazoa;Opisthokonta;Nucletmycea;Fungi;Dikarya;Ascomycota;Pezizomycotina;Eurotiomycetes;Onygenales;Ajellomycetaceae;";"0.0";"0";"19";"19";"0";"19";"0";"457164";"373894"
"V4mis1";"SILVA (only NR);Eukaryota;Amorphea;Obazoa;Opisthokonta;Nucletmycea;Fungi;Dikarya;Ascomycota;Pezizomycotina;Eurotiomycetes;Onygenales;Ajellomycetaceae;Blastomyces;";"0.0";"0";"6";"6";"0";"6";"0";"457177";"373894"
"V4mis1";"SILVA (only NR);Eukaryota;Amorphea;Obazoa;Opisthokonta;Nucletmycea;Fungi;Dikarya;Ascomycota;Pezizomycotina;Eurotiomycetes;Onygenales;Ajellomycetaceae;Helicocarpus;";"0.0";"0";"1";"1";"0";"1";"0";"457182";"373894"
"V4mis1";"SILVA (only NR);Eukaryota;Amorphea;Obazoa;Opisthokonta;Nucletmycea;Fungi;Dikarya;Ascomycota;Pezizomycotina;Eurotiomycetes;Onygenales;Ajellomycetaceae;Histoplasma;";"0.0";"0";"8";"8";"0";"8";"0";"457175";"373894"
"V4mis1";"SILVA (only NR);Eukaryota;Amorphea;Obazoa;Opisthokonta;Nucletmycea;Fungi;Dikarya;Ascomycota;Pezizomycotina;Eurotiomycetes;Onygenales;Ajellomycetaceae;Lacazia;";"0.0";"0";"2";"2";"0";"2";"0";"457181";"373894"
"V4mis1";"SILVA (only NR);Eukaryota;Amorphea;Obazoa;Opisthokonta;Nucletmycea;Fungi;Dikarya;Ascomycota;Pezizomycotina;Eurotiomycetes;Onygenales;Ajellomycetaceae;Paracoccidioides;";"0.0";"0";"2";"2";"0";"2";"0";"457181";"373894"
"V4mis1";"SILVA (only NR);Eukaryota;Amorphea;Obazoa;Opisthokonta;Nucletmycea;Fungi;Dikarya;Ascomycota;Pezizomycotina;Eurotiomycetes;Onygenales;Amaurascopsis;";"0.0";"0";"1";"1";"0";"1";"0";"457182";"373894"
"V4mis1";"SILVA (only NR);Eukaryota;Amorphea;Obazoa;Opisthokonta;Nucletmycea;Fungi;Dikarya;Ascomycota;Pezizomycotina;Eurotiomycetes;Onygenales;Arachnomycetaceae;";"0.0";"0";"8";"8";"0";"8";"0";"457175";"373894"
"V4mis1";"SILVA (only NR);Eukaryota;Amorphea;Obazoa;Opisthokonta;Nucletmycea;Fungi;Dikarya;Ascomycota;Pezizomycotina;Eurotiomycetes;Onygenales;Arachnomycetaceae;Arachnomyces;";"0.0";"0";"8";"8";"0";"8";"0";"457175";"373894"
"V4mis1";"SILVA (only NR);Eukaryota;Amorphea;Obazoa;Opisthokonta;Nucletmycea;Fungi;Dikarya;Ascomycota;Pezizomycotina;Eurotiomycetes;Onygenales;Arthrodermataceae;";"0.0";"0";"29";"29";"0";"29";"0";"457154";"373894"
"V4mis1";"SILVA (only NR);Eukaryota;Amorphea;Obazoa;Opisthokonta;Nucletmycea;Fungi;Dikarya;Ascomycota;Pezizomycotina;Eurotiomycetes;Onygenales;Arthrodermataceae;Arthroderma;";"0.0";"0";"10";"10";"0";"10";"0";"457173";"373894"
"V4mis1";"SILVA (only NR);Eukaryota;Amorphea;Obazoa;Opisthokonta;Nucletmycea;Fungi;Dikarya;Ascomycota;Pezizomycotina;Eurotiomycetes;Onygenales;Arthrodermataceae;Ctenomyces;";"0.0";"0";"3";"3";"0";"3";"0";"457180";"373894"
"V4mis1";"SILVA (only NR);Eukaryota;Amorphea;Obazoa;Opisthokonta;Nucletmycea;Fungi;Dikarya;Ascomycota;Pezizomycotina;Eurotiomycetes;Onygenales;Arthrodermataceae;Epidermophyton;";"0.0";"0";"1";"1";"0";"1";"0";"457182";"373894"
"V4mis1";"SILVA (only NR);Eukaryota;Amorphea;Obazoa;Opisthokonta;Nucletmycea;Fungi;Dikarya;Ascomycota;Pezizomycotina;Eurotiomycetes;Onygenales;Arthrodermataceae;Microsporum;";"0.0";"0";"4";"4";"0";"4";"0";"457179";"373894"
"V4mis1";"SILVA (only NR);Eukaryota;Amorphea;Obazoa;Opisthokonta;Nucletmycea;Fungi;Dikarya;Ascomycota;Pezizomycotina;Eurotiomycetes;Onygenales;Arthrodermataceae;Nannizzia;";"0.0";"0";"1";"1";"0";"1";"0";"457182";"373894"
"V4mis1";"SILVA (only NR);Eukaryota;Amorphea;Obazoa;Opisthokonta;Nucletmycea;Fungi;Dikarya;Ascomycota;Pezizomycotina;Eurotiomycetes;Onygenales;Arthrodermataceae;Trichophyton;";"0.0";"0";"10";"10";"0";"10";"0";"457173";"373894"
"V4mis1";"SILVA (only NR);Eukaryota;Amorphea;Obazoa;Opisthokonta;Nucletmycea;Fungi;Dikarya;Ascomycota;Pezizomycotina;Eurotiomycetes;Onygenales;Ascosphaeraceae;";"0.0";"0";"6";"6";"0";"6";"0";"457177";"373894"
"V4mis1";"SILVA (only NR);Eukaryota;Amorphea;Obazoa;Opisthokonta;Nucletmycea;Fungi;Dikarya;Ascomycota;Pezizomycotina;Eurotiomycetes;Onygenales;Ascosphaeraceae;Ascosphaera;";"0.0";"0";"6";"6";"0";"6";"0";"457177";"373894"
"V4mis1";"SILVA (only NR);Eukaryota;Amorphea;Obazoa;Opisthokonta;Nucletmycea;Fungi;Dikarya;Ascomycota;Pezizomycotina;Eurotiomycetes;Onygenales;Auxarthronopsis;";"0.0";"0";"1";"1";"0";"1";"0";"457182";"373894"
"V4mis1";"SILVA (only NR);Eukaryota;Amorphea;Obazoa;Opisthokonta;Nucletmycea;Fungi;Dikarya;Ascomycota;Pezizomycotina;Eurotiomycetes;Onygenales;Eremascaceae;";"0.0";"0";"2";"2";"0";"2";"0";"457181";"373894"
"V4mis1";"SILVA (only NR);Eukaryota;Amorphea;Obazoa;Opisthokonta;Nucletmycea;Fungi;Dikarya;Ascomycota;Pezizomycotina;Eurotiomycetes;Onygenales;Eremascaceae;Eremascus;";"0.0";"0";"2";"2";"0";"2";"0";"457181";"373894"
"V4mis1";"SILVA (only NR);Eukaryota;Amorphea;Obazoa;Opisthokonta;Nucletmycea;Fungi;Dikarya;Ascomycota;Pezizomycotina;Eurotiomycetes;Onygenales;Gymnoascaceae;";"0.0";"0";"12";"12";"0";"12";"0";"457171";"373894"
"V4mis1";"SILVA (only NR);Eukaryota;Amorphea;Obazoa;Opisthokonta;Nucletmycea;Fungi;Dikarya;Ascomycota;Pezizomycotina;Eurotiomycetes;Onygenales;Gymnoascaceae;Arachniotus;";"0.0";"0";"2";"2";"0";"2";"0";"457181";"373894"
"V4mis1";"SILVA (only NR);Eukaryota;Amorphea;Obazoa;Opisthokonta;Nucletmycea;Fungi;Dikarya;Ascomycota;Pezizomycotina;Eurotiomycetes;Onygenales;Gymnoascaceae;Gymnascella;";"0.0";"0";"3";"3";"0";"3";"0";"457180";"373894"
"V4mis1";"SILVA (only NR);Eukaryota;Amorphea;Obazoa;Opisthokonta;Nucletmycea;Fungi;Dikarya;Ascomycota;Pezizomycotina;Eurotiomycetes;Onygenales;Gymnoascaceae;Gymnoascus;";"0.0";"0";"6";"6";"0";"6";"0";"457177";"373894"
"V4mis1";"SILVA (only NR);Eukaryota;Amorphea;Obazoa;Opisthokonta;Nucletmycea;Fungi;Dikarya;Ascomycota;Pezizomycotina;Eurotiomycetes;Onygenales;Gymnoascaceae;Kraurogymnocarpa;";"0.0";"0";"1";"1";"0";"1";"0";"457182";"373894"
"V4mis1";"SILVA (only NR);Eukaryota;Amorphea;Obazoa;Opisthokonta;Nucletmycea;Fungi;Dikarya;Ascomycota;Pezizomycotina;Eurotiomycetes;Onygenales;Incertae Sedis;";"0.0";"0";"16";"16";"0";"16";"0";"457167";"373894"
"V4mis1";"SILVA (only NR);Eukaryota;Amorphea;Obazoa;Opisthokonta;Nucletmycea;Fungi;Dikarya;Ascomycota;Pezizomycotina;Eurotiomycetes;Onygenales;Incertae Sedis;Coccidioides;";"0.0";"0";"14";"14";"0";"14";"0";"457169";"373894"
"V4mis1";"SILVA (only NR);Eukaryota;Amorphea;Obazoa;Opisthokonta;Nucletmycea;Fungi;Dikarya;Ascomycota;Pezizomycotina;Eurotiomycetes;Onygenales;Incertae Sedis;Spiromastix;";"0.0";"0";"2";"2";"0";"2";"0";"457181";"373894"
"V4mis1";"SILVA (only NR);Eukaryota;Amorphea;Obazoa;Opisthokonta;Nucletmycea;Fungi;Dikarya;Ascomycota;Pezizomycotina;Eurotiomycetes;Onygenales;Leucothecium;";"0.0";"0";"1";"1";"0";"1";"0";"457182";"373894"
"V4mis1";"SILVA (only NR);Eukaryota;Amorphea;Obazoa;Opisthokonta;Nucletmycea;Fungi;Dikarya;Ascomycota;Pezizomycotina;Eurotiomycetes;Onygenales;Nannizziopsiaceae;";"0.0";"0";"4";"4";"0";"4";"0";"457179";"373894"
"V4mis1";"SILVA (only NR);Eukaryota;Amorphea;Obazoa;Opisthokonta;Nucletmycea;Fungi;Dikarya;Ascomycota;Pezizomycotina;Eurotiomycetes;Onygenales;Nannizziopsiaceae;Nannizziopsis;";"0.0";"0";"2";"2";"0";"2";"0";"457181";"373894"
"V4mis1";"SILVA (only NR);Eukaryota;Amorphea;Obazoa;Opisthokonta;Nucletmycea;Fungi;Dikarya;Ascomycota;Pezizomycotina;Eurotiomycetes;Onygenales;Nannizziopsiaceae;Paranannizziopsis;";"0.0";"0";"2";"2";"0";"2";"0";"457181";"373894"
"V4mis1";"SILVA (only NR);Eukaryota;Amorphea;Obazoa;Opisthokonta;Nucletmycea;Fungi;Dikarya;Ascomycota;Pezizomycotina;Eurotiomycetes;Onygenales;Onygenaceae;";"0.0";"0";"50";"50";"0";"50";"0";"457133";"373894"
"V4mis1";"SILVA (only NR);Eukaryota;Amorphea;Obazoa;Opisthokonta;Nucletmycea;Fungi;Dikarya;Ascomycota;Pezizomycotina;Eurotiomycetes;Onygenales;Onygenaceae;Aphanoascus;";"0.0";"0";"13";"13";"0";"13";"0";"457170";"373894"
"V4mis1";"SILVA (only NR);Eukaryota;Amorphea;Obazoa;Opisthokonta;Nucletmycea;Fungi;Dikarya;Ascomycota;Pezizomycotina;Eurotiomycetes;Onygenales;Onygenaceae;Apinisia;";"0.0";"0";"1";"1";"0";"1";"0";"457182";"373894"
"V4mis1";"SILVA (only NR);Eukaryota;Amorphea;Obazoa;Opisthokonta;Nucletmycea;Fungi;Dikarya;Ascomycota;Pezizomycotina;Eurotiomycetes;Onygenales;Onygenaceae;Ascocalvatia;";"0.0";"0";"1";"1";"0";"1";"0";"457182";"373894"
"V4mis1";"SILVA (only NR);Eukaryota;Amorphea;Obazoa;Opisthokonta;Nucletmycea;Fungi;Dikarya;Ascomycota;Pezizomycotina;Eurotiomycetes;Onygenales;Onygenaceae;Auxarthron;";"0.0";"0";"15";"15";"0";"15";"0";"457168";"373894"
"V4mis1";"SILVA (only NR);Eukaryota;Amorphea;Obazoa;Opisthokonta;Nucletmycea;Fungi;Dikarya;Ascomycota;Pezizomycotina;Eurotiomycetes;Onygenales;Onygenaceae;Chlamydosauromyces;";"0.0";"0";"1";"1";"0";"1";"0";"457182";"373894"
"V4mis1";"SILVA (only NR);Eukaryota;Amorphea;Obazoa;Opisthokonta;Nucletmycea;Fungi;Dikarya;Ascomycota;Pezizomycotina;Eurotiomycetes;Onygenales;Onygenaceae;Chrysosporium;";"0.0";"0";"3";"3";"0";"3";"0";"457180";"373894"
"V4mis1";"SILVA (only NR);Eukaryota;Amorphea;Obazoa;Opisthokonta;Nucletmycea;Fungi;Dikarya;Ascomycota;Pezizomycotina;Eurotiomycetes;Onygenales;Onygenaceae;Onygena;";"0.0";"0";"2";"2";"0";"2";"0";"457181";"373894"
"V4mis1";"SILVA (only NR);Eukaryota;Amorphea;Obazoa;Opisthokonta;Nucletmycea;Fungi;Dikarya;Ascomycota;Pezizomycotina;Eurotiomycetes;Onygenales;Onygenaceae;Ophidiomyces;";"0.0";"0";"1";"1";"0";"1";"0";"457182";"373894"
"V4mis1";"SILVA (only NR);Eukaryota;Amorphea;Obazoa;Opisthokonta;Nucletmycea;Fungi;Dikarya;Ascomycota;Pezizomycotina;Eurotiomycetes;Onygenales;Onygenaceae;Pectinotrichum;";"0.0";"0";"2";"2";"0";"2";"0";"457181";"373894"
"V4mis1";"SILVA (only NR);Eukaryota;Amorphea;Obazoa;Opisthokonta;Nucletmycea;Fungi;Dikarya;Ascomycota;Pezizomycotina;Eurotiomycetes;Onygenales;Onygenaceae;Pseudoamauroascus;";"0.0";"0";"1";"1";"0";"1";"0";"457182";"373894"
"V4mis1";"SILVA (only NR);Eukaryota;Amorphea;Obazoa;Opisthokonta;Nucletmycea;Fungi;Dikarya;Ascomycota;Pezizomycotina;Eurotiomycetes;Onygenales;Onygenaceae;Renispora;";"0.0";"0";"2";"2";"0";"2";"0";"457181";"373894"
"V4mis1";"SILVA (only NR);Eukaryota;Amorphea;Obazoa;Opisthokonta;Nucletmycea;Fungi;Dikarya;Ascomycota;Pezizomycotina;Eurotiomycetes;Onygenales;Onygenaceae;Shanorella;";"0.0";"0";"1";"1";"0";"1";"0";"457182";"373894"
"V4mis1";"SILVA (only NR);Eukaryota;Amorphea;Obazoa;Opisthokonta;Nucletmycea;Fungi;Dikarya;Ascomycota;Pezizomycotina;Eurotiomycetes;Onygenales;Onygenaceae;Uncinocarpus;";"0.0";"0";"7";"7";"0";"7";"0";"457176";"373894"
"V4mis1";"SILVA (only NR);Eukaryota;Amorphea;Obazoa;Opisthokonta;Nucletmycea;Fungi;Dikarya;Ascomycota;Pezizomycotina;Eurotiomycetes;Phaeomoniellales;";"0.0";"0";"3";"3";"0";"3";"0";"457180";"373894"
"V4mis1";"SILVA (only NR);Eukaryota;Amorphea;Obazoa;Opisthokonta;Nucletmycea;Fungi;Dikarya;Ascomycota;Pezizomycotina;Eurotiomycetes;Phaeomoniellales;Incertae Sedis;";"0.0";"0";"3";"3";"0";"3";"0";"457180";"373894"
"V4mis1";"SILVA (only NR);Eukaryota;Amorphea;Obazoa;Opisthokonta;Nucletmycea;Fungi;Dikarya;Ascomycota;Pezizomycotina;Eurotiomycetes;Phaeomoniellales;Incertae Sedis;Aequabiliella;";"0.0";"0";"1";"1";"0";"1";"0";"457182";"373894"
"V4mis1";"SILVA (only NR);Eukaryota;Amorphea;Obazoa;Opisthokonta;Nucletmycea;Fungi;Dikarya;Ascomycota;Pezizomycotina;Eurotiomycetes;Phaeomoniellales;Incertae Sedis;Neophaeomoniella;";"0.0";"0";"1";"1";"0";"1";"0";"457182";"373894"
"V4mis1";"SILVA (only NR);Eukaryota;Amorphea;Obazoa;Opisthokonta;Nucletmycea;Fungi;Dikarya;Ascomycota;Pezizomycotina;Eurotiomycetes;Phaeomoniellales;Incertae Sedis;Phaeomoniella;";"0.0";"0";"1";"1";"0";"1";"0";"457182";"373894"
"V4mis1";"SILVA (only NR);Eukaryota;Amorphea;Obazoa;Opisthokonta;Nucletmycea;Fungi;Dikarya;Ascomycota;Pezizomycotina;Eurotiomycetes;Pyrenulales;";"0.0";"0";"1";"1";"0";"1";"0";"457182";"373894"
"V4mis1";"SILVA (only NR);Eukaryota;Amorphea;Obazoa;Opisthokonta;Nucletmycea;Fungi;Dikarya;Ascomycota;Pezizomycotina;Eurotiomycetes;Pyrenulales;Pyrenulaceae;";"0.0";"0";"1";"1";"0";"1";"0";"457182";"373894"
"V4mis1";"SILVA (only NR);Eukaryota;Amorphea;Obazoa;Opisthokonta;Nucletmycea;Fungi;Dikarya;Ascomycota;Pezizomycotina;Eurotiomycetes;Pyrenulales;Pyrenulaceae;Pyrgillus;";"0.0";"0";"1";"1";"0";"1";"0";"457182";"373894"
"V4mis1";"SILVA (only NR);Eukaryota;Amorphea;Obazoa;Opisthokonta;Nucletmycea;Fungi;Dikarya;Ascomycota;Pezizomycotina;Eurotiomycetes;Verrucariales;";"0.0";"0";"47";"47";"0";"47";"0";"457136";"373894"
"V4mis1";"SILVA (only NR);Eukaryota;Amorphea;Obazoa;Opisthokonta;Nucletmycea;Fungi;Dikarya;Ascomycota;Pezizomycotina;Eurotiomycetes;Verrucariales;Verrucariaceae;";"0.0";"0";"47";"47";"0";"47";"0";"457136";"373894"
"V4mis1";"SILVA (only NR);Eukaryota;Amorphea;Obazoa;Opisthokonta;Nucletmycea;Fungi;Dikarya;Ascomycota;Pezizomycotina;Eurotiomycetes;Verrucariales;Verrucariaceae;Bagliettoa;";"0.0";"0";"2";"2";"0";"2";"0";"457181";"373894"
"V4mis1";"SILVA (only NR);Eukaryota;Amorphea;Obazoa;Opisthokonta;Nucletmycea;Fungi;Dikarya;Ascomycota;Pezizomycotina;Eurotiomycetes;Verrucariales;Verrucariaceae;Catapyrenium;";"0.0";"0";"2";"2";"0";"2";"0";"457181";"373894"
"V4mis1";"SILVA (only NR);Eukaryota;Amorphea;Obazoa;Opisthokonta;Nucletmycea;Fungi;Dikarya;Ascomycota;Pezizomycotina;Eurotiomycetes;Verrucariales;Verrucariaceae;Dermatocarpon;";"0.0";"0";"2";"2";"0";"2";"0";"457181";"373894"
"V4mis1";"SILVA (only NR);Eukaryota;Amorphea;Obazoa;Opisthokonta;Nucletmycea;Fungi;Dikarya;Ascomycota;Pezizomycotina;Eurotiomycetes;Verrucariales;Verrucariaceae;Endocarpon;";"0.0";"0";"1";"1";"0";"1";"0";"457182";"373894"
"V4mis1";"SILVA (only NR);Eukaryota;Amorphea;Obazoa;Opisthokonta;Nucletmycea;Fungi;Dikarya;Ascomycota;Pezizomycotina;Eurotiomycetes;Verrucariales;Verrucariaceae;Flakea;";"0.0";"0";"1";"1";"0";"1";"0";"457182";"373894"
"V4mis1";"SILVA (only NR);Eukaryota;Amorphea;Obazoa;Opisthokonta;Nucletmycea;Fungi;Dikarya;Ascomycota;Pezizomycotina;Eurotiomycetes;Verrucariales;Verrucariaceae;Heteroplacidium;";"0.0";"0";"3";"3";"0";"3";"0";"457180";"373894"
"V4mis1";"SILVA (only NR);Eukaryota;Amorphea;Obazoa;Opisthokonta;Nucletmycea;Fungi;Dikarya;Ascomycota;Pezizomycotina;Eurotiomycetes;Verrucariales;Verrucariaceae;Hydropunctaria;";"0.0";"0";"2";"2";"0";"2";"0";"457181";"373894"
"V4mis1";"SILVA (only NR);Eukaryota;Amorphea;Obazoa;Opisthokonta;Nucletmycea;Fungi;Dikarya;Ascomycota;Pezizomycotina;Eurotiomycetes;Verrucariales;Verrucariaceae;Normandina;";"0.0";"0";"2";"2";"0";"2";"0";"457181";"373894"
"V4mis1";"SILVA (only NR);Eukaryota;Amorphea;Obazoa;Opisthokonta;Nucletmycea;Fungi;Dikarya;Ascomycota;Pezizomycotina;Eurotiomycetes;Verrucariales;Verrucariaceae;Norrlinia;";"0.0";"0";"1";"1";"0";"1";"0";"457182";"373894"
"V4mis1";"SILVA (only NR);Eukaryota;Amorphea;Obazoa;Opisthokonta;Nucletmycea;Fungi;Dikarya;Ascomycota;Pezizomycotina;Eurotiomycetes;Verrucariales;Verrucariaceae;Parabagliettoa;";"0.0";"0";"2";"2";"0";"2";"0";"457181";"373894"
"V4mis1";"SILVA (only NR);Eukaryota;Amorphea;Obazoa;Opisthokonta;Nucletmycea;Fungi;Dikarya;Ascomycota;Pezizomycotina;Eurotiomycetes;Verrucariales;Verrucariaceae;Placidiopsis;";"0.0";"0";"2";"2";"0";"2";"0";"457181";"373894"
"V4mis1";"SILVA (only NR);Eukaryota;Amorphea;Obazoa;Opisthokonta;Nucletmycea;Fungi;Dikarya;Ascomycota;Pezizomycotina;Eurotiomycetes;Verrucariales;Verrucariaceae;Placidium;";"0.0";"0";"4";"4";"0";"4";"0";"457179";"373894"
"V4mis1";"SILVA (only NR);Eukaryota;Amorphea;Obazoa;Opisthokonta;Nucletmycea;Fungi;Dikarya;Ascomycota;Pezizomycotina;Eurotiomycetes;Verrucariales;Verrucariaceae;Placocarpus;";"0.0";"0";"1";"1";"0";"1";"0";"457182";"373894"
"V4mis1";"SILVA (only NR);Eukaryota;Amorphea;Obazoa;Opisthokonta;Nucletmycea;Fungi;Dikarya;Ascomycota;Pezizomycotina;Eurotiomycetes;Verrucariales;Verrucariaceae;Placopyrenium;";"0.0";"0";"2";"2";"0";"2";"0";"457181";"373894"
"V4mis1";"SILVA (only NR);Eukaryota;Amorphea;Obazoa;Opisthokonta;Nucletmycea;Fungi;Dikarya;Ascomycota;Pezizomycotina;Eurotiomycetes;Verrucariales;Verrucariaceae;Staurothele;";"0.0";"0";"2";"2";"0";"2";"0";"457181";"373894"
"V4mis1";"SILVA (only NR);Eukaryota;Amorphea;Obazoa;Opisthokonta;Nucletmycea;Fungi;Dikarya;Ascomycota;Pezizomycotina;Eurotiomycetes;Verrucariales;Verrucariaceae;Thelidium;";"0.0";"0";"2";"2";"0";"2";"0";"457181";"373894"
"V4mis1";"SILVA (only NR);Eukaryota;Amorphea;Obazoa;Opisthokonta;Nucletmycea;Fungi;Dikarya;Ascomycota;Pezizomycotina;Eurotiomycetes;Verrucariales;Verrucariaceae;Verrucaria;";"0.0";"0";"8";"8";"0";"8";"0";"457175";"373894"
"V4mis1";"SILVA (only NR);Eukaryota;Amorphea;Obazoa;Opisthokonta;Nucletmycea;Fungi;Dikarya;Ascomycota;Pezizomycotina;Eurotiomycetes;Verrucariales;Verrucariaceae;Verrucula;";"0.0";"0";"2";"2";"0";"2";"0";"457181";"373894"
"V4mis1";"SILVA (only NR);Eukaryota;Amorphea;Obazoa;Opisthokonta;Nucletmycea;Fungi;Dikarya;Ascomycota;Pezizomycotina;Eurotiomycetes;Verrucariales;Verrucariaceae;Verruculopsis;";"0.0";"0";"1";"1";"0";"1";"0";"457182";"373894"
"V4mis1";"SILVA (only NR);Eukaryota;Amorphea;Obazoa;Opisthokonta;Nucletmycea;Fungi;Dikarya;Ascomycota;Pezizomycotina;Eurotiomycetes;Verrucariales;Verrucariaceae;Wahlenbergiella;";"0.0";"0";"2";"2";"0";"2";"0";"457181";"373894"
"V4mis1";"SILVA (only NR);Eukaryota;Amorphea;Obazoa;Opisthokonta;Nucletmycea;Fungi;Dikarya;Ascomycota;Pezizomycotina;Eurotiomycetes;Verrucariales;Verrucariaceae;uncultured;";"0.0";"0";"2";"2";"0";"2";"0";"457181";"373894"
"V4mis1";"SILVA (only NR);Eukaryota;Amorphea;Obazoa;Opisthokonta;Nucletmycea;Fungi;Dikarya;Ascomycota;Pezizomycotina;Geoglossomycetes;";"0.0";"0";"2";"2";"0";"2";"0";"457181";"373894"
"V4mis1";"SILVA (only NR);Eukaryota;Amorphea;Obazoa;Opisthokonta;Nucletmycea;Fungi;Dikarya;Ascomycota;Pezizomycotina;Geoglossomycetes;Geoglossales;";"0.0";"0";"2";"2";"0";"2";"0";"457181";"373894"
"V4mis1";"SILVA (only NR);Eukaryota;Amorphea;Obazoa;Opisthokonta;Nucletmycea;Fungi;Dikarya;Ascomycota;Pezizomycotina;Geoglossomycetes;Geoglossales;Geoglossaceae;";"0.0";"0";"2";"2";"0";"2";"0";"457181";"373894"
"V4mis1";"SILVA (only NR);Eukaryota;Amorphea;Obazoa;Opisthokonta;Nucletmycea;Fungi;Dikarya;Ascomycota;Pezizomycotina;Geoglossomycetes;Geoglossales;Geoglossaceae;Geoglossum;";"0.0";"0";"1";"1";"0";"1";"0";"457182";"373894"
"V4mis1";"SILVA (only NR);Eukaryota;Amorphea;Obazoa;Opisthokonta;Nucletmycea;Fungi;Dikarya;Ascomycota;Pezizomycotina;Geoglossomycetes;Geoglossales;Geoglossaceae;Trichoglossum;";"0.0";"0";"1";"1";"0";"1";"0";"457182";"373894"
"V4mis1";"SILVA (only NR);Eukaryota;Amorphea;Obazoa;Opisthokonta;Nucletmycea;Fungi;Dikarya;Ascomycota;Pezizomycotina;Incertae Sedis;";"0.0";"0";"9";"9";"0";"9";"0";"457174";"373894"
"V4mis1";"SILVA (only NR);Eukaryota;Amorphea;Obazoa;Opisthokonta;Nucletmycea;Fungi;Dikarya;Ascomycota;Pezizomycotina;Incertae Sedis;Incertae Sedis;";"0.0";"0";"8";"8";"0";"8";"0";"457175";"373894"
"V4mis1";"SILVA (only NR);Eukaryota;Amorphea;Obazoa;Opisthokonta;Nucletmycea;Fungi;Dikarya;Ascomycota;Pezizomycotina;Incertae Sedis;Incertae Sedis;Incertae Sedis;";"0.0";"0";"8";"8";"0";"8";"0";"457175";"373894"
"V4mis1";"SILVA (only NR);Eukaryota;Amorphea;Obazoa;Opisthokonta;Nucletmycea;Fungi;Dikarya;Ascomycota;Pezizomycotina;Incertae Sedis;Incertae Sedis;Incertae Sedis;Dictyocatenulata;";"0.0";"0";"5";"5";"0";"5";"0";"457178";"373894"
"V4mis1";"SILVA (only NR);Eukaryota;Amorphea;Obazoa;Opisthokonta;Nucletmycea;Fungi;Dikarya;Ascomycota;Pezizomycotina;Incertae Sedis;Incertae Sedis;Incertae Sedis;Kendrickiella;";"0.0";"0";"1";"1";"0";"1";"0";"457182";"373894"
"V4mis1";"SILVA (only NR);Eukaryota;Amorphea;Obazoa;Opisthokonta;Nucletmycea;Fungi;Dikarya;Ascomycota;Pezizomycotina;Incertae Sedis;Incertae Sedis;Incertae Sedis;Lecophagus;";"0.0";"0";"2";"2";"0";"2";"0";"457181";"373894"
"V4mis1";"SILVA (only NR);Eukaryota;Amorphea;Obazoa;Opisthokonta;Nucletmycea;Fungi;Dikarya;Ascomycota;Pezizomycotina;Incertae Sedis;Medeolariales;";"0.0";"0";"1";"1";"0";"1";"0";"457182";"373894"
"V4mis1";"SILVA (only NR);Eukaryota;Amorphea;Obazoa;Opisthokonta;Nucletmycea;Fungi;Dikarya;Ascomycota;Pezizomycotina;Incertae Sedis;Medeolariales;Medeolariaceae;";"0.0";"0";"1";"1";"0";"1";"0";"457182";"373894"
"V4mis1";"SILVA (only NR);Eukaryota;Amorphea;Obazoa;Opisthokonta;Nucletmycea;Fungi;Dikarya;Ascomycota;Pezizomycotina;Incertae Sedis;Medeolariales;Medeolariaceae;Medeolaria;";"0.0";"0";"1";"1";"0";"1";"0";"457182";"373894"
"V4mis1";"SILVA (only NR);Eukaryota;Amorphea;Obazoa;Opisthokonta;Nucletmycea;Fungi;Dikarya;Ascomycota;Pezizomycotina;Laboulbeniomycetes;";"0.0";"0";"11";"11";"0";"11";"0";"457172";"373894"
"V4mis1";"SILVA (only NR);Eukaryota;Amorphea;Obazoa;Opisthokonta;Nucletmycea;Fungi;Dikarya;Ascomycota;Pezizomycotina;Laboulbeniomycetes;Laboulbeniales;";"0.0";"0";"6";"6";"0";"6";"0";"457177";"373894"
"V4mis1";"SILVA (only NR);Eukaryota;Amorphea;Obazoa;Opisthokonta;Nucletmycea;Fungi;Dikarya;Ascomycota;Pezizomycotina;Laboulbeniomycetes;Laboulbeniales;Laboulbeniaceae;";"0.0";"0";"6";"6";"0";"6";"0";"457177";"373894"
"V4mis1";"SILVA (only NR);Eukaryota;Amorphea;Obazoa;Opisthokonta;Nucletmycea;Fungi;Dikarya;Ascomycota;Pezizomycotina;Laboulbeniomycetes;Laboulbeniales;Laboulbeniaceae;Gloeandromyces;";"0.0";"0";"1";"1";"0";"1";"0";"457182";"373894"
"V4mis1";"SILVA (only NR);Eukaryota;Amorphea;Obazoa;Opisthokonta;Nucletmycea;Fungi;Dikarya;Ascomycota;Pezizomycotina;Laboulbeniomycetes;Laboulbeniales;Laboulbeniaceae;Hesperomyces;";"0.0";"0";"2";"2";"0";"2";"0";"457181";"373894"
"V4mis1";"SILVA (only NR);Eukaryota;Amorphea;Obazoa;Opisthokonta;Nucletmycea;Fungi;Dikarya;Ascomycota;Pezizomycotina;Laboulbeniomycetes;Laboulbeniales;Laboulbeniaceae;Laboulbenia;";"0.0";"0";"1";"1";"0";"1";"0";"457182";"373894"
"V4mis1";"SILVA (only NR);Eukaryota;Amorphea;Obazoa;Opisthokonta;Nucletmycea;Fungi;Dikarya;Ascomycota;Pezizomycotina;Laboulbeniomycetes;Laboulbeniales;Laboulbeniaceae;Monoicomyces;";"0.0";"0";"1";"1";"0";"1";"0";"457182";"373894"
"V4mis1";"SILVA (only NR);Eukaryota;Amorphea;Obazoa;Opisthokonta;Nucletmycea;Fungi;Dikarya;Ascomycota;Pezizomycotina;Laboulbeniomycetes;Laboulbeniales;Laboulbeniaceae;Stigmatomyces;";"0.0";"0";"1";"1";"0";"1";"0";"457182";"373894"
"V4mis1";"SILVA (only NR);Eukaryota;Amorphea;Obazoa;Opisthokonta;Nucletmycea;Fungi;Dikarya;Ascomycota;Pezizomycotina;Laboulbeniomycetes;Pyxidiophorales;";"0.0";"0";"1";"1";"0";"1";"0";"457182";"373894"
"V4mis1";"SILVA (only NR);Eukaryota;Amorphea;Obazoa;Opisthokonta;Nucletmycea;Fungi;Dikarya;Ascomycota;Pezizomycotina;Laboulbeniomycetes;Pyxidiophorales;Pyxidiophoraceae;";"0.0";"0";"1";"1";"0";"1";"0";"457182";"373894"
"V4mis1";"SILVA (only NR);Eukaryota;Amorphea;Obazoa;Opisthokonta;Nucletmycea;Fungi;Dikarya;Ascomycota;Pezizomycotina;Laboulbeniomycetes;Pyxidiophorales;Pyxidiophoraceae;Pyxidiophora;";"0.0";"0";"1";"1";"0";"1";"0";"457182";"373894"
"V4mis1";"SILVA (only NR);Eukaryota;Amorphea;Obazoa;Opisthokonta;Nucletmycea;Fungi;Dikarya;Ascomycota;Pezizomycotina;Lecanoromycetes;";"0.0";"0";"282";"282";"0";"282";"0";"456901";"373894"
"V4mis1";"SILVA (only NR);Eukaryota;Amorphea;Obazoa;Opisthokonta;Nucletmycea;Fungi;Dikarya;Ascomycota;Pezizomycotina;Lecanoromycetes;Acarosporales;";"0.0";"0";"7";"7";"0";"7";"0";"457176";"373894"
"V4mis1";"SILVA (only NR);Eukaryota;Amorphea;Obazoa;Opisthokonta;Nucletmycea;Fungi;Dikarya;Ascomycota;Pezizomycotina;Lecanoromycetes;Acarosporales;Acarosporaceae;";"0.0";"0";"7";"7";"0";"7";"0";"457176";"373894"
"V4mis1";"SILVA (only NR);Eukaryota;Amorphea;Obazoa;Opisthokonta;Nucletmycea;Fungi;Dikarya;Ascomycota;Pezizomycotina;Lecanoromycetes;Acarosporales;Acarosporaceae;Acarospora;";"0.0";"0";"4";"4";"0";"4";"0";"457179";"373894"
"V4mis1";"SILVA (only NR);Eukaryota;Amorphea;Obazoa;Opisthokonta;Nucletmycea;Fungi;Dikarya;Ascomycota;Pezizomycotina;Lecanoromycetes;Acarosporales;Acarosporaceae;Myriospora;";"0.0";"0";"1";"1";"0";"1";"0";"457182";"373894"
"V4mis1";"SILVA (only NR);Eukaryota;Amorphea;Obazoa;Opisthokonta;Nucletmycea;Fungi;Dikarya;Ascomycota;Pezizomycotina;Lecanoromycetes;Acarosporales;Acarosporaceae;Phacopsis;";"0.0";"0";"2";"2";"0";"2";"0";"457181";"373894"
"V4mis1";"SILVA (only NR);Eukaryota;Amorphea;Obazoa;Opisthokonta;Nucletmycea;Fungi;Dikarya;Ascomycota;Pezizomycotina;Lecanoromycetes;Arctomiales;";"0.0";"0";"1";"1";"0";"1";"0";"457182";"373894"
"V4mis1";"SILVA (only NR);Eukaryota;Amorphea;Obazoa;Opisthokonta;Nucletmycea;Fungi;Dikarya;Ascomycota;Pezizomycotina;Lecanoromycetes;Arctomiales;Arctomiaceae;";"0.0";"0";"1";"1";"0";"1";"0";"457182";"373894"
"V4mis1";"SILVA (only NR);Eukaryota;Amorphea;Obazoa;Opisthokonta;Nucletmycea;Fungi;Dikarya;Ascomycota;Pezizomycotina;Lecanoromycetes;Arctomiales;Arctomiaceae;Gregorella;";"0.0";"0";"1";"1";"0";"1";"0";"457182";"373894"
"V4mis1";"SILVA (only NR);Eukaryota;Amorphea;Obazoa;Opisthokonta;Nucletmycea;Fungi;Dikarya;Ascomycota;Pezizomycotina;Lecanoromycetes;Baeomycetales;";"0.0";"0";"4";"4";"0";"4";"0";"457179";"373894"
"V4mis1";"SILVA (only NR);Eukaryota;Amorphea;Obazoa;Opisthokonta;Nucletmycea;Fungi;Dikarya;Ascomycota;Pezizomycotina;Lecanoromycetes;Baeomycetales;Anamylopsora;";"0.0";"0";"1";"1";"0";"1";"0";"457182";"373894"
"V4mis1";"SILVA (only NR);Eukaryota;Amorphea;Obazoa;Opisthokonta;Nucletmycea;Fungi;Dikarya;Ascomycota;Pezizomycotina;Lecanoromycetes;Baeomycetales;Baeomyces;";"0.0";"0";"3";"3";"0";"3";"0";"457180";"373894"
"V4mis1";"SILVA (only NR);Eukaryota;Amorphea;Obazoa;Opisthokonta;Nucletmycea;Fungi;Dikarya;Ascomycota;Pezizomycotina;Lecanoromycetes;Caliciales;";"0.0";"0";"32";"32";"0";"32";"0";"457151";"373894"
"V4mis1";"SILVA (only NR);Eukaryota;Amorphea;Obazoa;Opisthokonta;Nucletmycea;Fungi;Dikarya;Ascomycota;Pezizomycotina;Lecanoromycetes;Caliciales;Caliciaceae;";"0.0";"0";"18";"18";"0";"18";"0";"457165";"373894"
"V4mis1";"SILVA (only NR);Eukaryota;Amorphea;Obazoa;Opisthokonta;Nucletmycea;Fungi;Dikarya;Ascomycota;Pezizomycotina;Lecanoromycetes;Caliciales;Caliciaceae;Buellia;";"0.0";"0";"9";"9";"0";"9";"0";"457174";"373894"
"V4mis1";"SILVA (only NR);Eukaryota;Amorphea;Obazoa;Opisthokonta;Nucletmycea;Fungi;Dikarya;Ascomycota;Pezizomycotina;Lecanoromycetes;Caliciales;Caliciaceae;Calicium;";"0.0";"0";"1";"1";"0";"1";"0";"457182";"373894"
"V4mis1";"SILVA (only NR);Eukaryota;Amorphea;Obazoa;Opisthokonta;Nucletmycea;Fungi;Dikarya;Ascomycota;Pezizomycotina;Lecanoromycetes;Caliciales;Caliciaceae;Cyphelium;";"0.0";"0";"3";"3";"0";"3";"0";"457180";"373894"
"V4mis1";"SILVA (only NR);Eukaryota;Amorphea;Obazoa;Opisthokonta;Nucletmycea;Fungi;Dikarya;Ascomycota;Pezizomycotina;Lecanoromycetes;Caliciales;Caliciaceae;Dimelaena;";"0.0";"0";"1";"1";"0";"1";"0";"457182";"373894"
"V4mis1";"SILVA (only NR);Eukaryota;Amorphea;Obazoa;Opisthokonta;Nucletmycea;Fungi;Dikarya;Ascomycota;Pezizomycotina;Lecanoromycetes;Caliciales;Caliciaceae;Diploicia;";"0.0";"0";"1";"1";"0";"1";"0";"457182";"373894"
"V4mis1";"SILVA (only NR);Eukaryota;Amorphea;Obazoa;Opisthokonta;Nucletmycea;Fungi;Dikarya;Ascomycota;Pezizomycotina;Lecanoromycetes;Caliciales;Caliciaceae;Pyxine;";"0.0";"0";"2";"2";"0";"2";"0";"457181";"373894"
"V4mis1";"SILVA (only NR);Eukaryota;Amorphea;Obazoa;Opisthokonta;Nucletmycea;Fungi;Dikarya;Ascomycota;Pezizomycotina;Lecanoromycetes;Caliciales;Caliciaceae;Texosporium;";"0.0";"0";"1";"1";"0";"1";"0";"457182";"373894"
"V4mis1";"SILVA (only NR);Eukaryota;Amorphea;Obazoa;Opisthokonta;Nucletmycea;Fungi;Dikarya;Ascomycota;Pezizomycotina;Lecanoromycetes;Caliciales;Physciaceae;";"0.0";"0";"14";"14";"0";"14";"0";"457169";"373894"
"V4mis1";"SILVA (only NR);Eukaryota;Amorphea;Obazoa;Opisthokonta;Nucletmycea;Fungi;Dikarya;Ascomycota;Pezizomycotina;Lecanoromycetes;Caliciales;Physciaceae;Anaptychia;";"0.0";"0";"1";"1";"0";"1";"0";"457182";"373894"
"V4mis1";"SILVA (only NR);Eukaryota;Amorphea;Obazoa;Opisthokonta;Nucletmycea;Fungi;Dikarya;Ascomycota;Pezizomycotina;Lecanoromycetes;Caliciales;Physciaceae;Heterodermia;";"0.0";"0";"2";"2";"0";"2";"0";"457181";"373894"
"V4mis1";"SILVA (only NR);Eukaryota;Amorphea;Obazoa;Opisthokonta;Nucletmycea;Fungi;Dikarya;Ascomycota;Pezizomycotina;Lecanoromycetes;Caliciales;Physciaceae;Phaeophyscia;";"0.0";"0";"1";"1";"0";"1";"0";"457182";"373894"
"V4mis1";"SILVA (only NR);Eukaryota;Amorphea;Obazoa;Opisthokonta;Nucletmycea;Fungi;Dikarya;Ascomycota;Pezizomycotina;Lecanoromycetes;Caliciales;Physciaceae;Physcia;";"0.0";"0";"5";"5";"0";"5";"0";"457178";"373894"
"V4mis1";"SILVA (only NR);Eukaryota;Amorphea;Obazoa;Opisthokonta;Nucletmycea;Fungi;Dikarya;Ascomycota;Pezizomycotina;Lecanoromycetes;Caliciales;Physciaceae;Physconia;";"0.0";"0";"1";"1";"0";"1";"0";"457182";"373894"
"V4mis1";"SILVA (only NR);Eukaryota;Amorphea;Obazoa;Opisthokonta;Nucletmycea;Fungi;Dikarya;Ascomycota;Pezizomycotina;Lecanoromycetes;Caliciales;Physciaceae;Rinodina;";"0.0";"0";"2";"2";"0";"2";"0";"457181";"373894"
"V4mis1";"SILVA (only NR);Eukaryota;Amorphea;Obazoa;Opisthokonta;Nucletmycea;Fungi;Dikarya;Ascomycota;Pezizomycotina;Lecanoromycetes;Caliciales;Physciaceae;Rinodinella;";"0.0";"0";"1";"1";"0";"1";"0";"457182";"373894"
"V4mis1";"SILVA (only NR);Eukaryota;Amorphea;Obazoa;Opisthokonta;Nucletmycea;Fungi;Dikarya;Ascomycota;Pezizomycotina;Lecanoromycetes;Lecanorales;";"0.0";"0";"98";"98";"0";"98";"0";"457085";"373894"
"V4mis1";"SILVA (only NR);Eukaryota;Amorphea;Obazoa;Opisthokonta;Nucletmycea;Fungi;Dikarya;Ascomycota;Pezizomycotina;Lecanoromycetes;Lecanorales;Allocetraria;";"0.0";"0";"1";"1";"0";"1";"0";"457182";"373894"
"V4mis1";"SILVA (only NR);Eukaryota;Amorphea;Obazoa;Opisthokonta;Nucletmycea;Fungi;Dikarya;Ascomycota;Pezizomycotina;Lecanoromycetes;Lecanorales;Austropeltum;";"0.0";"0";"1";"1";"0";"1";"0";"457182";"373894"
"V4mis1";"SILVA (only NR);Eukaryota;Amorphea;Obazoa;Opisthokonta;Nucletmycea;Fungi;Dikarya;Ascomycota;Pezizomycotina;Lecanoromycetes;Lecanorales;Bachmanniomyces;";"0.0";"0";"1";"1";"0";"1";"0";"457182";"373894"
"V4mis1";"SILVA (only NR);Eukaryota;Amorphea;Obazoa;Opisthokonta;Nucletmycea;Fungi;Dikarya;Ascomycota;Pezizomycotina;Lecanoromycetes;Lecanorales;Bunodophoron;";"0.0";"0";"2";"2";"0";"2";"0";"457181";"373894"
"V4mis1";"SILVA (only NR);Eukaryota;Amorphea;Obazoa;Opisthokonta;Nucletmycea;Fungi;Dikarya;Ascomycota;Pezizomycotina;Lecanoromycetes;Lecanorales;Byssoloma;";"0.0";"0";"1";"1";"0";"1";"0";"457182";"373894"
"V4mis1";"SILVA (only NR);Eukaryota;Amorphea;Obazoa;Opisthokonta;Nucletmycea;Fungi;Dikarya;Ascomycota;Pezizomycotina;Lecanoromycetes;Lecanorales;Cetradonia;";"0.0";"0";"1";"1";"0";"1";"0";"457182";"373894"
"V4mis1";"SILVA (only NR);Eukaryota;Amorphea;Obazoa;Opisthokonta;Nucletmycea;Fungi;Dikarya;Ascomycota;Pezizomycotina;Lecanoromycetes;Lecanorales;Cladoniaceae;";"0.0";"0";"7";"7";"0";"7";"0";"457176";"373894"
"V4mis1";"SILVA (only NR);Eukaryota;Amorphea;Obazoa;Opisthokonta;Nucletmycea;Fungi;Dikarya;Ascomycota;Pezizomycotina;Lecanoromycetes;Lecanorales;Cladoniaceae;Cladia;";"0.0";"0";"2";"2";"0";"2";"0";"457181";"373894"
"V4mis1";"SILVA (only NR);Eukaryota;Amorphea;Obazoa;Opisthokonta;Nucletmycea;Fungi;Dikarya;Ascomycota;Pezizomycotina;Lecanoromycetes;Lecanorales;Cladoniaceae;Cladonia;";"0.0";"0";"3";"3";"0";"3";"0";"457180";"373894"
"V4mis1";"SILVA (only NR);Eukaryota;Amorphea;Obazoa;Opisthokonta;Nucletmycea;Fungi;Dikarya;Ascomycota;Pezizomycotina;Lecanoromycetes;Lecanorales;Cladoniaceae;Gymnoderma;";"0.0";"0";"1";"1";"0";"1";"0";"457182";"373894"
"V4mis1";"SILVA (only NR);Eukaryota;Amorphea;Obazoa;Opisthokonta;Nucletmycea;Fungi;Dikarya;Ascomycota;Pezizomycotina;Lecanoromycetes;Lecanorales;Cladoniaceae;Pilophorus;";"0.0";"0";"1";"1";"0";"1";"0";"457182";"373894"
"V4mis1";"SILVA (only NR);Eukaryota;Amorphea;Obazoa;Opisthokonta;Nucletmycea;Fungi;Dikarya;Ascomycota;Pezizomycotina;Lecanoromycetes;Lecanorales;Crocynia;";"0.0";"0";"1";"1";"0";"1";"0";"457182";"373894"
"V4mis1";"SILVA (only NR);Eukaryota;Amorphea;Obazoa;Opisthokonta;Nucletmycea;Fungi;Dikarya;Ascomycota;Pezizomycotina;Lecanoromycetes;Lecanorales;Lecanoraceae;";"0.0";"0";"12";"12";"0";"12";"0";"457171";"373894"
"V4mis1";"SILVA (only NR);Eukaryota;Amorphea;Obazoa;Opisthokonta;Nucletmycea;Fungi;Dikarya;Ascomycota;Pezizomycotina;Lecanoromycetes;Lecanorales;Lecanoraceae;Lecanora;";"0.0";"0";"4";"4";"0";"4";"0";"457179";"373894"
"V4mis1";"SILVA (only NR);Eukaryota;Amorphea;Obazoa;Opisthokonta;Nucletmycea;Fungi;Dikarya;Ascomycota;Pezizomycotina;Lecanoromycetes;Lecanorales;Lecanoraceae;Lecidella;";"0.0";"0";"1";"1";"0";"1";"0";"457182";"373894"
"V4mis1";"SILVA (only NR);Eukaryota;Amorphea;Obazoa;Opisthokonta;Nucletmycea;Fungi;Dikarya;Ascomycota;Pezizomycotina;Lecanoromycetes;Lecanorales;Lecanoraceae;Miriquidica;";"0.0";"0";"1";"1";"0";"1";"0";"457182";"373894"
"V4mis1";"SILVA (only NR);Eukaryota;Amorphea;Obazoa;Opisthokonta;Nucletmycea;Fungi;Dikarya;Ascomycota;Pezizomycotina;Lecanoromycetes;Lecanorales;Lecanoraceae;Protoparmeliopsis;";"0.0";"0";"1";"1";"0";"1";"0";"457182";"373894"
"V4mis1";"SILVA (only NR);Eukaryota;Amorphea;Obazoa;Opisthokonta;Nucletmycea;Fungi;Dikarya;Ascomycota;Pezizomycotina;Lecanoromycetes;Lecanorales;Lecanoraceae;Pyrrhospora;";"0.0";"0";"1";"1";"0";"1";"0";"457182";"373894"
"V4mis1";"SILVA (only NR);Eukaryota;Amorphea;Obazoa;Opisthokonta;Nucletmycea;Fungi;Dikarya;Ascomycota;Pezizomycotina;Lecanoromycetes;Lecanorales;Lecanoraceae;Rhizoplaca;";"0.0";"0";"2";"2";"0";"2";"0";"457181";"373894"
"V4mis1";"SILVA (only NR);Eukaryota;Amorphea;Obazoa;Opisthokonta;Nucletmycea;Fungi;Dikarya;Ascomycota;Pezizomycotina;Lecanoromycetes;Lecanorales;Lecanoraceae;Scoliciosporum;";"0.0";"0";"2";"2";"0";"2";"0";"457181";"373894"
"V4mis1";"SILVA (only NR);Eukaryota;Amorphea;Obazoa;Opisthokonta;Nucletmycea;Fungi;Dikarya;Ascomycota;Pezizomycotina;Lecanoromycetes;Lecanorales;Micareaceae;";"0.0";"0";"2";"2";"0";"2";"0";"457181";"373894"
"V4mis1";"SILVA (only NR);Eukaryota;Amorphea;Obazoa;Opisthokonta;Nucletmycea;Fungi;Dikarya;Ascomycota;Pezizomycotina;Lecanoromycetes;Lecanorales;Micareaceae;Micarea;";"0.0";"0";"2";"2";"0";"2";"0";"457181";"373894"
"V4mis1";"SILVA (only NR);Eukaryota;Amorphea;Obazoa;Opisthokonta;Nucletmycea;Fungi;Dikarya;Ascomycota;Pezizomycotina;Lecanoromycetes;Lecanorales;Mycoblastaceae;";"0.0";"0";"1";"1";"0";"1";"0";"457182";"373894"
"V4mis1";"SILVA (only NR);Eukaryota;Amorphea;Obazoa;Opisthokonta;Nucletmycea;Fungi;Dikarya;Ascomycota;Pezizomycotina;Lecanoromycetes;Lecanorales;Mycoblastaceae;Mycoblastus;";"0.0";"0";"1";"1";"0";"1";"0";"457182";"373894"
"V4mis1";"SILVA (only NR);Eukaryota;Amorphea;Obazoa;Opisthokonta;Nucletmycea;Fungi;Dikarya;Ascomycota;Pezizomycotina;Lecanoromycetes;Lecanorales;Neophyllis;";"0.0";"0";"1";"1";"0";"1";"0";"457182";"373894"
"V4mis1";"SILVA (only NR);Eukaryota;Amorphea;Obazoa;Opisthokonta;Nucletmycea;Fungi;Dikarya;Ascomycota;Pezizomycotina;Lecanoromycetes;Lecanorales;Parmeliaceae;";"0.0";"0";"30";"30";"0";"30";"0";"457153";"373894"
"V4mis1";"SILVA (only NR);Eukaryota;Amorphea;Obazoa;Opisthokonta;Nucletmycea;Fungi;Dikarya;Ascomycota;Pezizomycotina;Lecanoromycetes;Lecanorales;Parmeliaceae;Anzia;";"0.0";"0";"2";"2";"0";"2";"0";"457181";"373894"
"V4mis1";"SILVA (only NR);Eukaryota;Amorphea;Obazoa;Opisthokonta;Nucletmycea;Fungi;Dikarya;Ascomycota;Pezizomycotina;Lecanoromycetes;Lecanorales;Parmeliaceae;Cetraria;";"0.0";"0";"1";"1";"0";"1";"0";"457182";"373894"
"V4mis1";"SILVA (only NR);Eukaryota;Amorphea;Obazoa;Opisthokonta;Nucletmycea;Fungi;Dikarya;Ascomycota;Pezizomycotina;Lecanoromycetes;Lecanorales;Parmeliaceae;Cornicularia;";"0.0";"0";"1";"1";"0";"1";"0";"457182";"373894"
"V4mis1";"SILVA (only NR);Eukaryota;Amorphea;Obazoa;Opisthokonta;Nucletmycea;Fungi;Dikarya;Ascomycota;Pezizomycotina;Lecanoromycetes;Lecanorales;Parmeliaceae;Evernia;";"0.0";"0";"1";"1";"0";"1";"0";"457182";"373894"
"V4mis1";"SILVA (only NR);Eukaryota;Amorphea;Obazoa;Opisthokonta;Nucletmycea;Fungi;Dikarya;Ascomycota;Pezizomycotina;Lecanoromycetes;Lecanorales;Parmeliaceae;Hypogymnia;";"0.0";"0";"5";"5";"0";"5";"0";"457178";"373894"
"V4mis1";"SILVA (only NR);Eukaryota;Amorphea;Obazoa;Opisthokonta;Nucletmycea;Fungi;Dikarya;Ascomycota;Pezizomycotina;Lecanoromycetes;Lecanorales;Parmeliaceae;Letharia;";"0.0";"0";"1";"1";"0";"1";"0";"457182";"373894"
"V4mis1";"SILVA (only NR);Eukaryota;Amorphea;Obazoa;Opisthokonta;Nucletmycea;Fungi;Dikarya;Ascomycota;Pezizomycotina;Lecanoromycetes;Lecanorales;Parmeliaceae;Menegazzia;";"0.0";"0";"2";"2";"0";"2";"0";"457181";"373894"
"V4mis1";"SILVA (only NR);Eukaryota;Amorphea;Obazoa;Opisthokonta;Nucletmycea;Fungi;Dikarya;Ascomycota;Pezizomycotina;Lecanoromycetes;Lecanorales;Parmeliaceae;Pannoparmelia;";"0.0";"0";"1";"1";"0";"1";"0";"457182";"373894"
"V4mis1";"SILVA (only NR);Eukaryota;Amorphea;Obazoa;Opisthokonta;Nucletmycea;Fungi;Dikarya;Ascomycota;Pezizomycotina;Lecanoromycetes;Lecanorales;Parmeliaceae;Parmelia;";"0.0";"0";"1";"1";"0";"1";"0";"457182";"373894"
"V4mis1";"SILVA (only NR);Eukaryota;Amorphea;Obazoa;Opisthokonta;Nucletmycea;Fungi;Dikarya;Ascomycota;Pezizomycotina;Lecanoromycetes;Lecanorales;Parmeliaceae;Parmeliopsis;";"0.0";"0";"1";"1";"0";"1";"0";"457182";"373894"
"V4mis1";"SILVA (only NR);Eukaryota;Amorphea;Obazoa;Opisthokonta;Nucletmycea;Fungi;Dikarya;Ascomycota;Pezizomycotina;Lecanoromycetes;Lecanorales;Parmeliaceae;Parmotrema;";"0.0";"0";"3";"3";"0";"3";"0";"457180";"373894"
"V4mis1";"SILVA (only NR);Eukaryota;Amorphea;Obazoa;Opisthokonta;Nucletmycea;Fungi;Dikarya;Ascomycota;Pezizomycotina;Lecanoromycetes;Lecanorales;Parmeliaceae;Pleurosticta;";"0.0";"0";"2";"2";"0";"2";"0";"457181";"373894"
"V4mis1";"SILVA (only NR);Eukaryota;Amorphea;Obazoa;Opisthokonta;Nucletmycea;Fungi;Dikarya;Ascomycota;Pezizomycotina;Lecanoromycetes;Lecanorales;Parmeliaceae;Punctelia;";"0.0";"0";"1";"1";"0";"1";"0";"457182";"373894"
"V4mis1";"SILVA (only NR);Eukaryota;Amorphea;Obazoa;Opisthokonta;Nucletmycea;Fungi;Dikarya;Ascomycota;Pezizomycotina;Lecanoromycetes;Lecanorales;Parmeliaceae;Usnea;";"0.0";"0";"3";"3";"0";"3";"0";"457180";"373894"
"V4mis1";"SILVA (only NR);Eukaryota;Amorphea;Obazoa;Opisthokonta;Nucletmycea;Fungi;Dikarya;Ascomycota;Pezizomycotina;Lecanoromycetes;Lecanorales;Parmeliaceae;Vulpicida;";"0.0";"0";"1";"1";"0";"1";"0";"457182";"373894"
"V4mis1";"SILVA (only NR);Eukaryota;Amorphea;Obazoa;Opisthokonta;Nucletmycea;Fungi;Dikarya;Ascomycota;Pezizomycotina;Lecanoromycetes;Lecanorales;Parmeliaceae;Xanthoparmelia;";"0.0";"0";"2";"2";"0";"2";"0";"457181";"373894"
"V4mis1";"SILVA (only NR);Eukaryota;Amorphea;Obazoa;Opisthokonta;Nucletmycea;Fungi;Dikarya;Ascomycota;Pezizomycotina;Lecanoromycetes;Lecanorales;Porpidiaceae;";"0.0";"0";"2";"2";"0";"2";"0";"457181";"373894"
"V4mis1";"SILVA (only NR);Eukaryota;Amorphea;Obazoa;Opisthokonta;Nucletmycea;Fungi;Dikarya;Ascomycota;Pezizomycotina;Lecanoromycetes;Lecanorales;Porpidiaceae;Porpidia;";"0.0";"0";"1";"1";"0";"1";"0";"457182";"373894"
"V4mis1";"SILVA (only NR);Eukaryota;Amorphea;Obazoa;Opisthokonta;Nucletmycea;Fungi;Dikarya;Ascomycota;Pezizomycotina;Lecanoromycetes;Lecanorales;Porpidiaceae;Romjularia;";"0.0";"0";"1";"1";"0";"1";"0";"457182";"373894"
"V4mis1";"SILVA (only NR);Eukaryota;Amorphea;Obazoa;Opisthokonta;Nucletmycea;Fungi;Dikarya;Ascomycota;Pezizomycotina;Lecanoromycetes;Lecanorales;Psilolechia;";"0.0";"0";"1";"1";"0";"1";"0";"457182";"373894"
"V4mis1";"SILVA (only NR);Eukaryota;Amorphea;Obazoa;Opisthokonta;Nucletmycea;Fungi;Dikarya;Ascomycota;Pezizomycotina;Lecanoromycetes;Lecanorales;Psoraceae;";"0.0";"0";"5";"5";"0";"5";"0";"457178";"373894"
"V4mis1";"SILVA (only NR);Eukaryota;Amorphea;Obazoa;Opisthokonta;Nucletmycea;Fungi;Dikarya;Ascomycota;Pezizomycotina;Lecanoromycetes;Lecanorales;Psoraceae;Protoblastenia;";"0.0";"0";"3";"3";"0";"3";"0";"457180";"373894"
"V4mis1";"SILVA (only NR);Eukaryota;Amorphea;Obazoa;Opisthokonta;Nucletmycea;Fungi;Dikarya;Ascomycota;Pezizomycotina;Lecanoromycetes;Lecanorales;Psoraceae;Psora;";"0.0";"0";"2";"2";"0";"2";"0";"457181";"373894"
"V4mis1";"SILVA (only NR);Eukaryota;Amorphea;Obazoa;Opisthokonta;Nucletmycea;Fungi;Dikarya;Ascomycota;Pezizomycotina;Lecanoromycetes;Lecanorales;Ramalinaceae;";"0.0";"0";"16";"16";"0";"16";"0";"457167";"373894"
"V4mis1";"SILVA (only NR);Eukaryota;Amorphea;Obazoa;Opisthokonta;Nucletmycea;Fungi;Dikarya;Ascomycota;Pezizomycotina;Lecanoromycetes;Lecanorales;Ramalinaceae;Bacidia;";"0.0";"0";"1";"1";"0";"1";"0";"457182";"373894"
"V4mis1";"SILVA (only NR);Eukaryota;Amorphea;Obazoa;Opisthokonta;Nucletmycea;Fungi;Dikarya;Ascomycota;Pezizomycotina;Lecanoromycetes;Lecanorales;Ramalinaceae;Bacidina;";"0.0";"0";"3";"3";"0";"3";"0";"457180";"373894"
"V4mis1";"SILVA (only NR);Eukaryota;Amorphea;Obazoa;Opisthokonta;Nucletmycea;Fungi;Dikarya;Ascomycota;Pezizomycotina;Lecanoromycetes;Lecanorales;Ramalinaceae;Biatora;";"0.0";"0";"1";"1";"0";"1";"0";"457182";"373894"
"V4mis1";"SILVA (only NR);Eukaryota;Amorphea;Obazoa;Opisthokonta;Nucletmycea;Fungi;Dikarya;Ascomycota;Pezizomycotina;Lecanoromycetes;Lecanorales;Ramalinaceae;Bilimbia;";"0.0";"0";"1";"1";"0";"1";"0";"457182";"373894"
"V4mis1";"SILVA (only NR);Eukaryota;Amorphea;Obazoa;Opisthokonta;Nucletmycea;Fungi;Dikarya;Ascomycota;Pezizomycotina;Lecanoromycetes;Lecanorales;Ramalinaceae;Cliostomum;";"0.0";"0";"1";"1";"0";"1";"0";"457182";"373894"
"V4mis1";"SILVA (only NR);Eukaryota;Amorphea;Obazoa;Opisthokonta;Nucletmycea;Fungi;Dikarya;Ascomycota;Pezizomycotina;Lecanoromycetes;Lecanorales;Ramalinaceae;Lecania;";"0.0";"0";"3";"3";"0";"3";"0";"457180";"373894"
"V4mis1";"SILVA (only NR);Eukaryota;Amorphea;Obazoa;Opisthokonta;Nucletmycea;Fungi;Dikarya;Ascomycota;Pezizomycotina;Lecanoromycetes;Lecanorales;Ramalinaceae;Lopezaria;";"0.0";"0";"1";"1";"0";"1";"0";"457182";"373894"
"V4mis1";"SILVA (only NR);Eukaryota;Amorphea;Obazoa;Opisthokonta;Nucletmycea;Fungi;Dikarya;Ascomycota;Pezizomycotina;Lecanoromycetes;Lecanorales;Ramalinaceae;Ramalina;";"0.0";"0";"1";"1";"0";"1";"0";"457182";"373894"
"V4mis1";"SILVA (only NR);Eukaryota;Amorphea;Obazoa;Opisthokonta;Nucletmycea;Fungi;Dikarya;Ascomycota;Pezizomycotina;Lecanoromycetes;Lecanorales;Ramalinaceae;Toninia;";"0.0";"0";"2";"2";"0";"2";"0";"457181";"373894"
"V4mis1";"SILVA (only NR);Eukaryota;Amorphea;Obazoa;Opisthokonta;Nucletmycea;Fungi;Dikarya;Ascomycota;Pezizomycotina;Lecanoromycetes;Lecanorales;Ramalinaceae;[Epicladonia];";"0.0";"0";"1";"1";"0";"1";"0";"457182";"373894"
"V4mis1";"SILVA (only NR);Eukaryota;Amorphea;Obazoa;Opisthokonta;Nucletmycea;Fungi;Dikarya;Ascomycota;Pezizomycotina;Lecanoromycetes;Lecanorales;Ramboldiaceae;";"0.0";"0";"2";"2";"0";"2";"0";"457181";"373894"
"V4mis1";"SILVA (only NR);Eukaryota;Amorphea;Obazoa;Opisthokonta;Nucletmycea;Fungi;Dikarya;Ascomycota;Pezizomycotina;Lecanoromycetes;Lecanorales;Ramboldiaceae;Ramboldia;";"0.0";"0";"2";"2";"0";"2";"0";"457181";"373894"
"V4mis1";"SILVA (only NR);Eukaryota;Amorphea;Obazoa;Opisthokonta;Nucletmycea;Fungi;Dikarya;Ascomycota;Pezizomycotina;Lecanoromycetes;Lecanorales;Sphaerophorus;";"0.0";"0";"1";"1";"0";"1";"0";"457182";"373894"
"V4mis1";"SILVA (only NR);Eukaryota;Amorphea;Obazoa;Opisthokonta;Nucletmycea;Fungi;Dikarya;Ascomycota;Pezizomycotina;Lecanoromycetes;Lecanorales;Squamarinaceae;";"0.0";"0";"2";"2";"0";"2";"0";"457181";"373894"
"V4mis1";"SILVA (only NR);Eukaryota;Amorphea;Obazoa;Opisthokonta;Nucletmycea;Fungi;Dikarya;Ascomycota;Pezizomycotina;Lecanoromycetes;Lecanorales;Squamarinaceae;Squamarina;";"0.0";"0";"2";"2";"0";"2";"0";"457181";"373894"
"V4mis1";"SILVA (only NR);Eukaryota;Amorphea;Obazoa;Opisthokonta;Nucletmycea;Fungi;Dikarya;Ascomycota;Pezizomycotina;Lecanoromycetes;Lecanorales;Stereocaulaceae;";"0.0";"0";"6";"6";"0";"6";"0";"457177";"373894"
"V4mis1";"SILVA (only NR);Eukaryota;Amorphea;Obazoa;Opisthokonta;Nucletmycea;Fungi;Dikarya;Ascomycota;Pezizomycotina;Lecanoromycetes;Lecanorales;Stereocaulaceae;Lepraria;";"0.0";"0";"1";"1";"0";"1";"0";"457182";"373894"
"V4mis1";"SILVA (only NR);Eukaryota;Amorphea;Obazoa;Opisthokonta;Nucletmycea;Fungi;Dikarya;Ascomycota;Pezizomycotina;Lecanoromycetes;Lecanorales;Stereocaulaceae;Stereocaulon;";"0.0";"0";"5";"5";"0";"5";"0";"457178";"373894"
"V4mis1";"SILVA (only NR);Eukaryota;Amorphea;Obazoa;Opisthokonta;Nucletmycea;Fungi;Dikarya;Ascomycota;Pezizomycotina;Lecanoromycetes;Lecanorales;Tephromela;";"0.0";"0";"1";"1";"0";"1";"0";"457182";"373894"
"V4mis1";"SILVA (only NR);Eukaryota;Amorphea;Obazoa;Opisthokonta;Nucletmycea;Fungi;Dikarya;Ascomycota;Pezizomycotina;Lecanoromycetes;Lecideales;";"0.0";"0";"2";"2";"0";"2";"0";"457181";"373894"
"V4mis1";"SILVA (only NR);Eukaryota;Amorphea;Obazoa;Opisthokonta;Nucletmycea;Fungi;Dikarya;Ascomycota;Pezizomycotina;Lecanoromycetes;Lecideales;Lecideaceae;";"0.0";"0";"2";"2";"0";"2";"0";"457181";"373894"
"V4mis1";"SILVA (only NR);Eukaryota;Amorphea;Obazoa;Opisthokonta;Nucletmycea;Fungi;Dikarya;Ascomycota;Pezizomycotina;Lecanoromycetes;Lecideales;Lecideaceae;Lecidea;";"0.0";"0";"2";"2";"0";"2";"0";"457181";"373894"
"V4mis1";"SILVA (only NR);Eukaryota;Amorphea;Obazoa;Opisthokonta;Nucletmycea;Fungi;Dikarya;Ascomycota;Pezizomycotina;Lecanoromycetes;Ostropales;";"0.0";"0";"12";"12";"0";"12";"0";"457171";"373894"
"V4mis1";"SILVA (only NR);Eukaryota;Amorphea;Obazoa;Opisthokonta;Nucletmycea;Fungi;Dikarya;Ascomycota;Pezizomycotina;Lecanoromycetes;Ostropales;Gomphillaceae;";"0.0";"0";"1";"1";"0";"1";"0";"457182";"373894"
"V4mis1";"SILVA (only NR);Eukaryota;Amorphea;Obazoa;Opisthokonta;Nucletmycea;Fungi;Dikarya;Ascomycota;Pezizomycotina;Lecanoromycetes;Ostropales;Gomphillaceae;Gyalideopsis;";"0.0";"0";"1";"1";"0";"1";"0";"457182";"373894"
"V4mis1";"SILVA (only NR);Eukaryota;Amorphea;Obazoa;Opisthokonta;Nucletmycea;Fungi;Dikarya;Ascomycota;Pezizomycotina;Lecanoromycetes;Ostropales;Graphidaceae;";"0.0";"0";"6";"6";"0";"6";"0";"457177";"373894"
"V4mis1";"SILVA (only NR);Eukaryota;Amorphea;Obazoa;Opisthokonta;Nucletmycea;Fungi;Dikarya;Ascomycota;Pezizomycotina;Lecanoromycetes;Ostropales;Graphidaceae;Diploschistes;";"0.0";"0";"1";"1";"0";"1";"0";"457182";"373894"
"V4mis1";"SILVA (only NR);Eukaryota;Amorphea;Obazoa;Opisthokonta;Nucletmycea;Fungi;Dikarya;Ascomycota;Pezizomycotina;Lecanoromycetes;Ostropales;Graphidaceae;Gomphillus;";"0.0";"0";"1";"1";"0";"1";"0";"457182";"373894"
"V4mis1";"SILVA (only NR);Eukaryota;Amorphea;Obazoa;Opisthokonta;Nucletmycea;Fungi;Dikarya;Ascomycota;Pezizomycotina;Lecanoromycetes;Ostropales;Graphidaceae;Graphis;";"0.0";"0";"3";"3";"0";"3";"0";"457180";"373894"
"V4mis1";"SILVA (only NR);Eukaryota;Amorphea;Obazoa;Opisthokonta;Nucletmycea;Fungi;Dikarya;Ascomycota;Pezizomycotina;Lecanoromycetes;Ostropales;Graphidaceae;Xalocoa;";"0.0";"0";"1";"1";"0";"1";"0";"457182";"373894"
"V4mis1";"SILVA (only NR);Eukaryota;Amorphea;Obazoa;Opisthokonta;Nucletmycea;Fungi;Dikarya;Ascomycota;Pezizomycotina;Lecanoromycetes;Ostropales;Gyalecta;";"0.0";"0";"1";"1";"0";"1";"0";"457182";"373894"
"V4mis1";"SILVA (only NR);Eukaryota;Amorphea;Obazoa;Opisthokonta;Nucletmycea;Fungi;Dikarya;Ascomycota;Pezizomycotina;Lecanoromycetes;Ostropales;Petractis;";"0.0";"0";"1";"1";"0";"1";"0";"457182";"373894"
"V4mis1";"SILVA (only NR);Eukaryota;Amorphea;Obazoa;Opisthokonta;Nucletmycea;Fungi;Dikarya;Ascomycota;Pezizomycotina;Lecanoromycetes;Ostropales;Stictidaceae;";"0.0";"0";"3";"3";"0";"3";"0";"457180";"373894"
"V4mis1";"SILVA (only NR);Eukaryota;Amorphea;Obazoa;Opisthokonta;Nucletmycea;Fungi;Dikarya;Ascomycota;Pezizomycotina;Lecanoromycetes;Ostropales;Stictidaceae;Acarosporina;";"0.0";"0";"1";"1";"0";"1";"0";"457182";"373894"
"V4mis1";"SILVA (only NR);Eukaryota;Amorphea;Obazoa;Opisthokonta;Nucletmycea;Fungi;Dikarya;Ascomycota;Pezizomycotina;Lecanoromycetes;Ostropales;Stictidaceae;Cyanodermella;";"0.0";"0";"1";"1";"0";"1";"0";"457182";"373894"
"V4mis1";"SILVA (only NR);Eukaryota;Amorphea;Obazoa;Opisthokonta;Nucletmycea;Fungi;Dikarya;Ascomycota;Pezizomycotina;Lecanoromycetes;Ostropales;Stictidaceae;Stictis;";"0.0";"0";"1";"1";"0";"1";"0";"457182";"373894"
"V4mis1";"SILVA (only NR);Eukaryota;Amorphea;Obazoa;Opisthokonta;Nucletmycea;Fungi;Dikarya;Ascomycota;Pezizomycotina;Lecanoromycetes;Peltigerales;";"0.0";"0";"23";"23";"0";"23";"0";"457160";"373894"
"V4mis1";"SILVA (only NR);Eukaryota;Amorphea;Obazoa;Opisthokonta;Nucletmycea;Fungi;Dikarya;Ascomycota;Pezizomycotina;Lecanoromycetes;Peltigerales;Coccocarpiaceae;";"0.0";"0";"3";"3";"0";"3";"0";"457180";"373894"
"V4mis1";"SILVA (only NR);Eukaryota;Amorphea;Obazoa;Opisthokonta;Nucletmycea;Fungi;Dikarya;Ascomycota;Pezizomycotina;Lecanoromycetes;Peltigerales;Coccocarpiaceae;Coccocarpia;";"0.0";"0";"3";"3";"0";"3";"0";"457180";"373894"
"V4mis1";"SILVA (only NR);Eukaryota;Amorphea;Obazoa;Opisthokonta;Nucletmycea;Fungi;Dikarya;Ascomycota;Pezizomycotina;Lecanoromycetes;Peltigerales;Collemataceae;";"0.0";"0";"5";"5";"0";"5";"0";"457178";"373894"
"V4mis1";"SILVA (only NR);Eukaryota;Amorphea;Obazoa;Opisthokonta;Nucletmycea;Fungi;Dikarya;Ascomycota;Pezizomycotina;Lecanoromycetes;Peltigerales;Collemataceae;Collema;";"0.0";"0";"2";"2";"0";"2";"0";"457181";"373894"
"V4mis1";"SILVA (only NR);Eukaryota;Amorphea;Obazoa;Opisthokonta;Nucletmycea;Fungi;Dikarya;Ascomycota;Pezizomycotina;Lecanoromycetes;Peltigerales;Collemataceae;Leptogium;";"0.0";"0";"3";"3";"0";"3";"0";"457180";"373894"
"V4mis1";"SILVA (only NR);Eukaryota;Amorphea;Obazoa;Opisthokonta;Nucletmycea;Fungi;Dikarya;Ascomycota;Pezizomycotina;Lecanoromycetes;Peltigerales;Fuscopannaria;";"0.0";"0";"1";"1";"0";"1";"0";"457182";"373894"
"V4mis1";"SILVA (only NR);Eukaryota;Amorphea;Obazoa;Opisthokonta;Nucletmycea;Fungi;Dikarya;Ascomycota;Pezizomycotina;Lecanoromycetes;Peltigerales;Koerberiaceae;";"0.0";"0";"1";"1";"0";"1";"0";"457182";"373894"
"V4mis1";"SILVA (only NR);Eukaryota;Amorphea;Obazoa;Opisthokonta;Nucletmycea;Fungi;Dikarya;Ascomycota;Pezizomycotina;Lecanoromycetes;Peltigerales;Koerberiaceae;Koerberia;";"0.0";"0";"1";"1";"0";"1";"0";"457182";"373894"
"V4mis1";"SILVA (only NR);Eukaryota;Amorphea;Obazoa;Opisthokonta;Nucletmycea;Fungi;Dikarya;Ascomycota;Pezizomycotina;Lecanoromycetes;Peltigerales;Leciophysma;";"0.0";"0";"1";"1";"0";"1";"0";"457182";"373894"
"V4mis1";"SILVA (only NR);Eukaryota;Amorphea;Obazoa;Opisthokonta;Nucletmycea;Fungi;Dikarya;Ascomycota;Pezizomycotina;Lecanoromycetes;Peltigerales;Leptochidium;";"0.0";"0";"1";"1";"0";"1";"0";"457182";"373894"
"V4mis1";"SILVA (only NR);Eukaryota;Amorphea;Obazoa;Opisthokonta;Nucletmycea;Fungi;Dikarya;Ascomycota;Pezizomycotina;Lecanoromycetes;Peltigerales;Lobaria;";"0.0";"0";"1";"1";"0";"1";"0";"457182";"373894"
"V4mis1";"SILVA (only NR);Eukaryota;Amorphea;Obazoa;Opisthokonta;Nucletmycea;Fungi;Dikarya;Ascomycota;Pezizomycotina;Lecanoromycetes;Peltigerales;Massalongia;";"0.0";"0";"1";"1";"0";"1";"0";"457182";"373894"
"V4mis1";"SILVA (only NR);Eukaryota;Amorphea;Obazoa;Opisthokonta;Nucletmycea;Fungi;Dikarya;Ascomycota;Pezizomycotina;Lecanoromycetes;Peltigerales;Nephroma;";"0.0";"0";"1";"1";"0";"1";"0";"457182";"373894"
"V4mis1";"SILVA (only NR);Eukaryota;Amorphea;Obazoa;Opisthokonta;Nucletmycea;Fungi;Dikarya;Ascomycota;Pezizomycotina;Lecanoromycetes;Peltigerales;Parmeliella;";"0.0";"0";"1";"1";"0";"1";"0";"457182";"373894"
"V4mis1";"SILVA (only NR);Eukaryota;Amorphea;Obazoa;Opisthokonta;Nucletmycea;Fungi;Dikarya;Ascomycota;Pezizomycotina;Lecanoromycetes;Peltigerales;Peltigeraceae;";"0.0";"0";"4";"4";"0";"4";"0";"457179";"373894"
"V4mis1";"SILVA (only NR);Eukaryota;Amorphea;Obazoa;Opisthokonta;Nucletmycea;Fungi;Dikarya;Ascomycota;Pezizomycotina;Lecanoromycetes;Peltigerales;Peltigeraceae;Peltigera;";"0.0";"0";"2";"2";"0";"2";"0";"457181";"373894"
"V4mis1";"SILVA (only NR);Eukaryota;Amorphea;Obazoa;Opisthokonta;Nucletmycea;Fungi;Dikarya;Ascomycota;Pezizomycotina;Lecanoromycetes;Peltigerales;Peltigeraceae;Solorina;";"0.0";"0";"2";"2";"0";"2";"0";"457181";"373894"
"V4mis1";"SILVA (only NR);Eukaryota;Amorphea;Obazoa;Opisthokonta;Nucletmycea;Fungi;Dikarya;Ascomycota;Pezizomycotina;Lecanoromycetes;Peltigerales;Placynthium;";"0.0";"0";"1";"1";"0";"1";"0";"457182";"373894"
"V4mis1";"SILVA (only NR);Eukaryota;Amorphea;Obazoa;Opisthokonta;Nucletmycea;Fungi;Dikarya;Ascomycota;Pezizomycotina;Lecanoromycetes;Peltigerales;Pseudocyphellaria;";"0.0";"0";"1";"1";"0";"1";"0";"457182";"373894"
"V4mis1";"SILVA (only NR);Eukaryota;Amorphea;Obazoa;Opisthokonta;Nucletmycea;Fungi;Dikarya;Ascomycota;Pezizomycotina;Lecanoromycetes;Peltigerales;Vahliella;";"0.0";"0";"1";"1";"0";"1";"0";"457182";"373894"
"V4mis1";"SILVA (only NR);Eukaryota;Amorphea;Obazoa;Opisthokonta;Nucletmycea;Fungi;Dikarya;Ascomycota;Pezizomycotina;Lecanoromycetes;Pertusariales;";"0.0";"0";"24";"24";"0";"24";"0";"457159";"373894"
"V4mis1";"SILVA (only NR);Eukaryota;Amorphea;Obazoa;Opisthokonta;Nucletmycea;Fungi;Dikarya;Ascomycota;Pezizomycotina;Lecanoromycetes;Pertusariales;Coccotrema;";"0.0";"0";"1";"1";"0";"1";"0";"457182";"373894"
"V4mis1";"SILVA (only NR);Eukaryota;Amorphea;Obazoa;Opisthokonta;Nucletmycea;Fungi;Dikarya;Ascomycota;Pezizomycotina;Lecanoromycetes;Pertusariales;Icmadophilaceae;";"0.0";"0";"8";"8";"0";"8";"0";"457175";"373894"
"V4mis1";"SILVA (only NR);Eukaryota;Amorphea;Obazoa;Opisthokonta;Nucletmycea;Fungi;Dikarya;Ascomycota;Pezizomycotina;Lecanoromycetes;Pertusariales;Icmadophilaceae;Dibaeis;";"0.0";"0";"2";"2";"0";"2";"0";"457181";"373894"
"V4mis1";"SILVA (only NR);Eukaryota;Amorphea;Obazoa;Opisthokonta;Nucletmycea;Fungi;Dikarya;Ascomycota;Pezizomycotina;Lecanoromycetes;Pertusariales;Icmadophilaceae;Icmadophila;";"0.0";"0";"1";"1";"0";"1";"0";"457182";"373894"
"V4mis1";"SILVA (only NR);Eukaryota;Amorphea;Obazoa;Opisthokonta;Nucletmycea;Fungi;Dikarya;Ascomycota;Pezizomycotina;Lecanoromycetes;Pertusariales;Icmadophilaceae;Siphula;";"0.0";"0";"4";"4";"0";"4";"0";"457179";"373894"
"V4mis1";"SILVA (only NR);Eukaryota;Amorphea;Obazoa;Opisthokonta;Nucletmycea;Fungi;Dikarya;Ascomycota;Pezizomycotina;Lecanoromycetes;Pertusariales;Icmadophilaceae;Thamnolia;";"0.0";"0";"1";"1";"0";"1";"0";"457182";"373894"
"V4mis1";"SILVA (only NR);Eukaryota;Amorphea;Obazoa;Opisthokonta;Nucletmycea;Fungi;Dikarya;Ascomycota;Pezizomycotina;Lecanoromycetes;Pertusariales;Ochrolechiaceae;";"0.0";"0";"4";"4";"0";"4";"0";"457179";"373894"
"V4mis1";"SILVA (only NR);Eukaryota;Amorphea;Obazoa;Opisthokonta;Nucletmycea;Fungi;Dikarya;Ascomycota;Pezizomycotina;Lecanoromycetes;Pertusariales;Ochrolechiaceae;Ochrolechia;";"0.0";"0";"4";"4";"0";"4";"0";"457179";"373894"
"V4mis1";"SILVA (only NR);Eukaryota;Amorphea;Obazoa;Opisthokonta;Nucletmycea;Fungi;Dikarya;Ascomycota;Pezizomycotina;Lecanoromycetes;Pertusariales;Pertusariaceae;";"0.0";"0";"10";"10";"0";"10";"0";"457173";"373894"
"V4mis1";"SILVA (only NR);Eukaryota;Amorphea;Obazoa;Opisthokonta;Nucletmycea;Fungi;Dikarya;Ascomycota;Pezizomycotina;Lecanoromycetes;Pertusariales;Pertusariaceae;Loxosporopsis;";"0.0";"0";"1";"1";"0";"1";"0";"457182";"373894"
"V4mis1";"SILVA (only NR);Eukaryota;Amorphea;Obazoa;Opisthokonta;Nucletmycea;Fungi;Dikarya;Ascomycota;Pezizomycotina;Lecanoromycetes;Pertusariales;Pertusariaceae;Pertusaria;";"0.0";"0";"8";"8";"0";"8";"0";"457175";"373894"
"V4mis1";"SILVA (only NR);Eukaryota;Amorphea;Obazoa;Opisthokonta;Nucletmycea;Fungi;Dikarya;Ascomycota;Pezizomycotina;Lecanoromycetes;Rhizocarpales;";"0.0";"0";"2";"2";"0";"2";"0";"457181";"373894"
"V4mis1";"SILVA (only NR);Eukaryota;Amorphea;Obazoa;Opisthokonta;Nucletmycea;Fungi;Dikarya;Ascomycota;Pezizomycotina;Lecanoromycetes;Rhizocarpales;Rhizocarpaceae;";"0.0";"0";"2";"2";"0";"2";"0";"457181";"373894"
"V4mis1";"SILVA (only NR);Eukaryota;Amorphea;Obazoa;Opisthokonta;Nucletmycea;Fungi;Dikarya;Ascomycota;Pezizomycotina;Lecanoromycetes;Rhizocarpales;Rhizocarpaceae;Rhizocarpon;";"0.0";"0";"2";"2";"0";"2";"0";"457181";"373894"
"V4mis1";"SILVA (only NR);Eukaryota;Amorphea;Obazoa;Opisthokonta;Nucletmycea;Fungi;Dikarya;Ascomycota;Pezizomycotina;Lecanoromycetes;Teloschistales;";"0.0";"0";"48";"48";"0";"48";"0";"457135";"373894"
"V4mis1";"SILVA (only NR);Eukaryota;Amorphea;Obazoa;Opisthokonta;Nucletmycea;Fungi;Dikarya;Ascomycota;Pezizomycotina;Lecanoromycetes;Teloschistales;Brigantiaeaceae;";"0.0";"0";"2";"2";"0";"2";"0";"457181";"373894"
"V4mis1";"SILVA (only NR);Eukaryota;Amorphea;Obazoa;Opisthokonta;Nucletmycea;Fungi;Dikarya;Ascomycota;Pezizomycotina;Lecanoromycetes;Teloschistales;Brigantiaeaceae;Brigantiaea;";"0.0";"0";"2";"2";"0";"2";"0";"457181";"373894"
"V4mis1";"SILVA (only NR);Eukaryota;Amorphea;Obazoa;Opisthokonta;Nucletmycea;Fungi;Dikarya;Ascomycota;Pezizomycotina;Lecanoromycetes;Teloschistales;Letrouitiaceae;";"0.0";"0";"4";"4";"0";"4";"0";"457179";"373894"
"V4mis1";"SILVA (only NR);Eukaryota;Amorphea;Obazoa;Opisthokonta;Nucletmycea;Fungi;Dikarya;Ascomycota;Pezizomycotina;Lecanoromycetes;Teloschistales;Letrouitiaceae;Letrouitia;";"0.0";"0";"4";"4";"0";"4";"0";"457179";"373894"
"V4mis1";"SILVA (only NR);Eukaryota;Amorphea;Obazoa;Opisthokonta;Nucletmycea;Fungi;Dikarya;Ascomycota;Pezizomycotina;Lecanoromycetes;Teloschistales;Megalosporaceae;";"0.0";"0";"3";"3";"0";"3";"0";"457180";"373894"
"V4mis1";"SILVA (only NR);Eukaryota;Amorphea;Obazoa;Opisthokonta;Nucletmycea;Fungi;Dikarya;Ascomycota;Pezizomycotina;Lecanoromycetes;Teloschistales;Megalosporaceae;Megalospora;";"0.0";"0";"2";"2";"0";"2";"0";"457181";"373894"
"V4mis1";"SILVA (only NR);Eukaryota;Amorphea;Obazoa;Opisthokonta;Nucletmycea;Fungi;Dikarya;Ascomycota;Pezizomycotina;Lecanoromycetes;Teloschistales;Megalosporaceae;Sipmaniella;";"0.0";"0";"1";"1";"0";"1";"0";"457182";"373894"
"V4mis1";"SILVA (only NR);Eukaryota;Amorphea;Obazoa;Opisthokonta;Nucletmycea;Fungi;Dikarya;Ascomycota;Pezizomycotina;Lecanoromycetes;Teloschistales;Teloschistaceae;";"0.0";"0";"39";"39";"0";"39";"0";"457144";"373894"
"V4mis1";"SILVA (only NR);Eukaryota;Amorphea;Obazoa;Opisthokonta;Nucletmycea;Fungi;Dikarya;Ascomycota;Pezizomycotina;Lecanoromycetes;Teloschistales;Teloschistaceae;Caloplaca;";"0.0";"0";"3";"3";"0";"3";"0";"457180";"373894"
"V4mis1";"SILVA (only NR);Eukaryota;Amorphea;Obazoa;Opisthokonta;Nucletmycea;Fungi;Dikarya;Ascomycota;Pezizomycotina;Lecanoromycetes;Teloschistales;Teloschistaceae;Dufourea;";"0.0";"0";"2";"2";"0";"2";"0";"457181";"373894"
"V4mis1";"SILVA (only NR);Eukaryota;Amorphea;Obazoa;Opisthokonta;Nucletmycea;Fungi;Dikarya;Ascomycota;Pezizomycotina;Lecanoromycetes;Teloschistales;Teloschistaceae;Flavoplaca;";"0.0";"0";"1";"1";"0";"1";"0";"457182";"373894"
"V4mis1";"SILVA (only NR);Eukaryota;Amorphea;Obazoa;Opisthokonta;Nucletmycea;Fungi;Dikarya;Ascomycota;Pezizomycotina;Lecanoromycetes;Teloschistales;Teloschistaceae;Gyalolechia;";"0.0";"0";"1";"1";"0";"1";"0";"457182";"373894"
"V4mis1";"SILVA (only NR);Eukaryota;Amorphea;Obazoa;Opisthokonta;Nucletmycea;Fungi;Dikarya;Ascomycota;Pezizomycotina;Lecanoromycetes;Teloschistales;Teloschistaceae;Hosseusiella;";"0.0";"0";"1";"1";"0";"1";"0";"457182";"373894"
"V4mis1";"SILVA (only NR);Eukaryota;Amorphea;Obazoa;Opisthokonta;Nucletmycea;Fungi;Dikarya;Ascomycota;Pezizomycotina;Lecanoromycetes;Teloschistales;Teloschistaceae;Josefpoeltia;";"0.0";"0";"1";"1";"0";"1";"0";"457182";"373894"
"V4mis1";"SILVA (only NR);Eukaryota;Amorphea;Obazoa;Opisthokonta;Nucletmycea;Fungi;Dikarya;Ascomycota;Pezizomycotina;Lecanoromycetes;Teloschistales;Teloschistaceae;Niorma;";"0.0";"0";"3";"3";"0";"3";"0";"457180";"373894"
"V4mis1";"SILVA (only NR);Eukaryota;Amorphea;Obazoa;Opisthokonta;Nucletmycea;Fungi;Dikarya;Ascomycota;Pezizomycotina;Lecanoromycetes;Teloschistales;Teloschistaceae;Olegblumia;";"0.0";"0";"1";"1";"0";"1";"0";"457182";"373894"
"V4mis1";"SILVA (only NR);Eukaryota;Amorphea;Obazoa;Opisthokonta;Nucletmycea;Fungi;Dikarya;Ascomycota;Pezizomycotina;Lecanoromycetes;Teloschistales;Teloschistaceae;Polycauliona;";"0.0";"0";"1";"1";"0";"1";"0";"457182";"373894"
"V4mis1";"SILVA (only NR);Eukaryota;Amorphea;Obazoa;Opisthokonta;Nucletmycea;Fungi;Dikarya;Ascomycota;Pezizomycotina;Lecanoromycetes;Teloschistales;Teloschistaceae;Pyrenodesmia;";"0.0";"0";"1";"1";"0";"1";"0";"457182";"373894"
"V4mis1";"SILVA (only NR);Eukaryota;Amorphea;Obazoa;Opisthokonta;Nucletmycea;Fungi;Dikarya;Ascomycota;Pezizomycotina;Lecanoromycetes;Teloschistales;Teloschistaceae;Rusavskia;";"0.0";"0";"4";"4";"0";"4";"0";"457179";"373894"
"V4mis1";"SILVA (only NR);Eukaryota;Amorphea;Obazoa;Opisthokonta;Nucletmycea;Fungi;Dikarya;Ascomycota;Pezizomycotina;Lecanoromycetes;Teloschistales;Teloschistaceae;Teloschistes;";"0.0";"0";"3";"3";"0";"3";"0";"457180";"373894"
"V4mis1";"SILVA (only NR);Eukaryota;Amorphea;Obazoa;Opisthokonta;Nucletmycea;Fungi;Dikarya;Ascomycota;Pezizomycotina;Lecanoromycetes;Teloschistales;Teloschistaceae;Usnochroma;";"0.0";"0";"1";"1";"0";"1";"0";"457182";"373894"
"V4mis1";"SILVA (only NR);Eukaryota;Amorphea;Obazoa;Opisthokonta;Nucletmycea;Fungi;Dikarya;Ascomycota;Pezizomycotina;Lecanoromycetes;Teloschistales;Teloschistaceae;Xanthocarpia;";"0.0";"0";"1";"1";"0";"1";"0";"457182";"373894"
"V4mis1";"SILVA (only NR);Eukaryota;Amorphea;Obazoa;Opisthokonta;Nucletmycea;Fungi;Dikarya;Ascomycota;Pezizomycotina;Lecanoromycetes;Teloschistales;Teloschistaceae;Xanthomendoza;";"0.0";"0";"9";"9";"0";"9";"0";"457174";"373894"
"V4mis1";"SILVA (only NR);Eukaryota;Amorphea;Obazoa;Opisthokonta;Nucletmycea;Fungi;Dikarya;Ascomycota;Pezizomycotina;Lecanoromycetes;Teloschistales;Teloschistaceae;Xanthoria;";"0.0";"0";"4";"4";"0";"4";"0";"457179";"373894"
"V4mis1";"SILVA (only NR);Eukaryota;Amorphea;Obazoa;Opisthokonta;Nucletmycea;Fungi;Dikarya;Ascomycota;Pezizomycotina;Lecanoromycetes;Trapeliales;";"0.0";"0";"4";"4";"0";"4";"0";"457179";"373894"
"V4mis1";"SILVA (only NR);Eukaryota;Amorphea;Obazoa;Opisthokonta;Nucletmycea;Fungi;Dikarya;Ascomycota;Pezizomycotina;Lecanoromycetes;Trapeliales;Trapeliaceae;";"0.0";"0";"4";"4";"0";"4";"0";"457179";"373894"
"V4mis1";"SILVA (only NR);Eukaryota;Amorphea;Obazoa;Opisthokonta;Nucletmycea;Fungi;Dikarya;Ascomycota;Pezizomycotina;Lecanoromycetes;Trapeliales;Trapeliaceae;Placopsis;";"0.0";"0";"1";"1";"0";"1";"0";"457182";"373894"
"V4mis1";"SILVA (only NR);Eukaryota;Amorphea;Obazoa;Opisthokonta;Nucletmycea;Fungi;Dikarya;Ascomycota;Pezizomycotina;Lecanoromycetes;Trapeliales;Trapeliaceae;Trapelia;";"0.0";"0";"1";"1";"0";"1";"0";"457182";"373894"
"V4mis1";"SILVA (only NR);Eukaryota;Amorphea;Obazoa;Opisthokonta;Nucletmycea;Fungi;Dikarya;Ascomycota;Pezizomycotina;Lecanoromycetes;Trapeliales;Trapeliaceae;Trapeliopsis;";"0.0";"0";"1";"1";"0";"1";"0";"457182";"373894"
"V4mis1";"SILVA (only NR);Eukaryota;Amorphea;Obazoa;Opisthokonta;Nucletmycea;Fungi;Dikarya;Ascomycota;Pezizomycotina;Lecanoromycetes;Trapeliales;Trapeliaceae;Xylographa;";"0.0";"0";"1";"1";"0";"1";"0";"457182";"373894"
"V4mis1";"SILVA (only NR);Eukaryota;Amorphea;Obazoa;Opisthokonta;Nucletmycea;Fungi;Dikarya;Ascomycota;Pezizomycotina;Lecanoromycetes;Umbilicariales;";"0.0";"0";"13";"13";"0";"13";"0";"457170";"373894"
"V4mis1";"SILVA (only NR);Eukaryota;Amorphea;Obazoa;Opisthokonta;Nucletmycea;Fungi;Dikarya;Ascomycota;Pezizomycotina;Lecanoromycetes;Umbilicariales;Umbilicariaceae;";"0.0";"0";"13";"13";"0";"13";"0";"457170";"373894"
"V4mis1";"SILVA (only NR);Eukaryota;Amorphea;Obazoa;Opisthokonta;Nucletmycea;Fungi;Dikarya;Ascomycota;Pezizomycotina;Lecanoromycetes;Umbilicariales;Umbilicariaceae;Umbilicaria;";"0.0";"0";"13";"13";"0";"13";"0";"457170";"373894"
"V4mis1";"SILVA (only NR);Eukaryota;Amorphea;Obazoa;Opisthokonta;Nucletmycea;Fungi;Dikarya;Ascomycota;Pezizomycotina;Leotiomyceta Incertae Sedis;";"0.0";"0";"2";"2";"0";"2";"0";"457181";"373894"
"V4mis1";"SILVA (only NR);Eukaryota;Amorphea;Obazoa;Opisthokonta;Nucletmycea;Fungi;Dikarya;Ascomycota;Pezizomycotina;Leotiomyceta Incertae Sedis;Candelariales;";"0.0";"0";"2";"2";"0";"2";"0";"457181";"373894"
"V4mis1";"SILVA (only NR);Eukaryota;Amorphea;Obazoa;Opisthokonta;Nucletmycea;Fungi;Dikarya;Ascomycota;Pezizomycotina;Leotiomyceta Incertae Sedis;Candelariales;Pycnoraceae;";"0.0";"0";"2";"2";"0";"2";"0";"457181";"373894"
"V4mis1";"SILVA (only NR);Eukaryota;Amorphea;Obazoa;Opisthokonta;Nucletmycea;Fungi;Dikarya;Ascomycota;Pezizomycotina;Leotiomyceta Incertae Sedis;Candelariales;Pycnoraceae;Pycnora;";"0.0";"0";"1";"1";"0";"1";"0";"457182";"373894"
"V4mis1";"SILVA (only NR);Eukaryota;Amorphea;Obazoa;Opisthokonta;Nucletmycea;Fungi;Dikarya;Ascomycota;Pezizomycotina;Leotiomycetes;";"0.0";"0";"226";"226";"0";"226";"0";"456957";"373894"
"V4mis1";"SILVA (only NR);Eukaryota;Amorphea;Obazoa;Opisthokonta;Nucletmycea;Fungi;Dikarya;Ascomycota;Pezizomycotina;Leotiomycetes;Cyttariales;";"0.0";"0";"6";"6";"0";"6";"0";"457177";"373894"
"V4mis1";"SILVA (only NR);Eukaryota;Amorphea;Obazoa;Opisthokonta;Nucletmycea;Fungi;Dikarya;Ascomycota;Pezizomycotina;Leotiomycetes;Cyttariales;Cyttariaceae;";"0.0";"0";"6";"6";"0";"6";"0";"457177";"373894"
"V4mis1";"SILVA (only NR);Eukaryota;Amorphea;Obazoa;Opisthokonta;Nucletmycea;Fungi;Dikarya;Ascomycota;Pezizomycotina;Leotiomycetes;Cyttariales;Cyttariaceae;Cyttaria;";"0.0";"0";"6";"6";"0";"6";"0";"457177";"373894"
"V4mis1";"SILVA (only NR);Eukaryota;Amorphea;Obazoa;Opisthokonta;Nucletmycea;Fungi;Dikarya;Ascomycota;Pezizomycotina;Leotiomycetes;Erysiphales;";"0.0";"0";"17";"17";"0";"17";"0";"457166";"373894"
"V4mis1";"SILVA (only NR);Eukaryota;Amorphea;Obazoa;Opisthokonta;Nucletmycea;Fungi;Dikarya;Ascomycota;Pezizomycotina;Leotiomycetes;Erysiphales;Erysiphaceae;";"0.0";"0";"17";"17";"0";"17";"0";"457166";"373894"
"V4mis1";"SILVA (only NR);Eukaryota;Amorphea;Obazoa;Opisthokonta;Nucletmycea;Fungi;Dikarya;Ascomycota;Pezizomycotina;Leotiomycetes;Erysiphales;Erysiphaceae;Arthrocladiella;";"0.0";"0";"1";"1";"0";"1";"0";"457182";"373894"
"V4mis1";"SILVA (only NR);Eukaryota;Amorphea;Obazoa;Opisthokonta;Nucletmycea;Fungi;Dikarya;Ascomycota;Pezizomycotina;Leotiomycetes;Erysiphales;Erysiphaceae;Blumeria;";"0.0";"0";"1";"1";"0";"1";"0";"457182";"373894"
"V4mis1";"SILVA (only NR);Eukaryota;Amorphea;Obazoa;Opisthokonta;Nucletmycea;Fungi;Dikarya;Ascomycota;Pezizomycotina;Leotiomycetes;Erysiphales;Erysiphaceae;Brasiliomyces;";"0.0";"0";"1";"1";"0";"1";"0";"457182";"373894"
"V4mis1";"SILVA (only NR);Eukaryota;Amorphea;Obazoa;Opisthokonta;Nucletmycea;Fungi;Dikarya;Ascomycota;Pezizomycotina;Leotiomycetes;Erysiphales;Erysiphaceae;Caespitotheca;";"0.0";"0";"1";"1";"0";"1";"0";"457182";"373894"
"V4mis1";"SILVA (only NR);Eukaryota;Amorphea;Obazoa;Opisthokonta;Nucletmycea;Fungi;Dikarya;Ascomycota;Pezizomycotina;Leotiomycetes;Erysiphales;Erysiphaceae;Erysiphe;";"0.0";"0";"5";"5";"0";"5";"0";"457178";"373894"
"V4mis1";"SILVA (only NR);Eukaryota;Amorphea;Obazoa;Opisthokonta;Nucletmycea;Fungi;Dikarya;Ascomycota;Pezizomycotina;Leotiomycetes;Erysiphales;Erysiphaceae;Golovinomyces;";"0.0";"0";"1";"1";"0";"1";"0";"457182";"373894"
"V4mis1";"SILVA (only NR);Eukaryota;Amorphea;Obazoa;Opisthokonta;Nucletmycea;Fungi;Dikarya;Ascomycota;Pezizomycotina;Leotiomycetes;Erysiphales;Erysiphaceae;Microidium;";"0.0";"0";"1";"1";"0";"1";"0";"457182";"373894"
"V4mis1";"SILVA (only NR);Eukaryota;Amorphea;Obazoa;Opisthokonta;Nucletmycea;Fungi;Dikarya;Ascomycota;Pezizomycotina;Leotiomycetes;Erysiphales;Erysiphaceae;Neoerysiphe;";"0.0";"0";"1";"1";"0";"1";"0";"457182";"373894"
"V4mis1";"SILVA (only NR);Eukaryota;Amorphea;Obazoa;Opisthokonta;Nucletmycea;Fungi;Dikarya;Ascomycota;Pezizomycotina;Leotiomycetes;Erysiphales;Erysiphaceae;Parauncinula;";"0.0";"0";"1";"1";"0";"1";"0";"457182";"373894"
"V4mis1";"SILVA (only NR);Eukaryota;Amorphea;Obazoa;Opisthokonta;Nucletmycea;Fungi;Dikarya;Ascomycota;Pezizomycotina;Leotiomycetes;Erysiphales;Erysiphaceae;Phyllactinia;";"0.0";"0";"1";"1";"0";"1";"0";"457182";"373894"
"V4mis1";"SILVA (only NR);Eukaryota;Amorphea;Obazoa;Opisthokonta;Nucletmycea;Fungi;Dikarya;Ascomycota;Pezizomycotina;Leotiomycetes;Erysiphales;Erysiphaceae;Pleochaeta;";"0.0";"0";"2";"2";"0";"2";"0";"457181";"373894"
"V4mis1";"SILVA (only NR);Eukaryota;Amorphea;Obazoa;Opisthokonta;Nucletmycea;Fungi;Dikarya;Ascomycota;Pezizomycotina;Leotiomycetes;Erysiphales;Erysiphaceae;Podosphaera;";"0.0";"0";"1";"1";"0";"1";"0";"457182";"373894"
"V4mis1";"SILVA (only NR);Eukaryota;Amorphea;Obazoa;Opisthokonta;Nucletmycea;Fungi;Dikarya;Ascomycota;Pezizomycotina;Leotiomycetes;Helotiales;";"0.0";"0";"147";"147";"0";"147";"0";"457036";"373894"
"V4mis1";"SILVA (only NR);Eukaryota;Amorphea;Obazoa;Opisthokonta;Nucletmycea;Fungi;Dikarya;Ascomycota;Pezizomycotina;Leotiomycetes;Helotiales;Bambusicola;";"0.0";"0";"1";"1";"0";"1";"0";"457182";"373894"
"V4mis1";"SILVA (only NR);Eukaryota;Amorphea;Obazoa;Opisthokonta;Nucletmycea;Fungi;Dikarya;Ascomycota;Pezizomycotina;Leotiomycetes;Helotiales;Bisporella;";"0.0";"0";"1";"1";"0";"1";"0";"457182";"373894"
"V4mis1";"SILVA (only NR);Eukaryota;Amorphea;Obazoa;Opisthokonta;Nucletmycea;Fungi;Dikarya;Ascomycota;Pezizomycotina;Leotiomycetes;Helotiales;Calycellinopsis;";"0.0";"0";"1";"1";"0";"1";"0";"457182";"373894"
"V4mis1";"SILVA (only NR);Eukaryota;Amorphea;Obazoa;Opisthokonta;Nucletmycea;Fungi;Dikarya;Ascomycota;Pezizomycotina;Leotiomycetes;Helotiales;Calycina;";"0.0";"0";"2";"2";"0";"2";"0";"457181";"373894"
"V4mis1";"SILVA (only NR);Eukaryota;Amorphea;Obazoa;Opisthokonta;Nucletmycea;Fungi;Dikarya;Ascomycota;Pezizomycotina;Leotiomycetes;Helotiales;Cashiella;";"0.0";"0";"1";"1";"0";"1";"0";"457182";"373894"
"V4mis1";"SILVA (only NR);Eukaryota;Amorphea;Obazoa;Opisthokonta;Nucletmycea;Fungi;Dikarya;Ascomycota;Pezizomycotina;Leotiomycetes;Helotiales;Cenangiaceae;";"0.0";"0";"5";"5";"0";"5";"0";"457178";"373894"
"V4mis1";"SILVA (only NR);Eukaryota;Amorphea;Obazoa;Opisthokonta;Nucletmycea;Fungi;Dikarya;Ascomycota;Pezizomycotina;Leotiomycetes;Helotiales;Cenangiaceae;Cenangium;";"0.0";"0";"2";"2";"0";"2";"0";"457181";"373894"
"V4mis1";"SILVA (only NR);Eukaryota;Amorphea;Obazoa;Opisthokonta;Nucletmycea;Fungi;Dikarya;Ascomycota;Pezizomycotina;Leotiomycetes;Helotiales;Cenangiaceae;Chlorencoelia;";"0.0";"0";"1";"1";"0";"1";"0";"457182";"373894"
"V4mis1";"SILVA (only NR);Eukaryota;Amorphea;Obazoa;Opisthokonta;Nucletmycea;Fungi;Dikarya;Ascomycota;Pezizomycotina;Leotiomycetes;Helotiales;Cenangiaceae;Heyderia;";"0.0";"0";"1";"1";"0";"1";"0";"457182";"373894"
"V4mis1";"SILVA (only NR);Eukaryota;Amorphea;Obazoa;Opisthokonta;Nucletmycea;Fungi;Dikarya;Ascomycota;Pezizomycotina;Leotiomycetes;Helotiales;Cenangiaceae;Sarcotrochila;";"0.0";"0";"1";"1";"0";"1";"0";"457182";"373894"
"V4mis1";"SILVA (only NR);Eukaryota;Amorphea;Obazoa;Opisthokonta;Nucletmycea;Fungi;Dikarya;Ascomycota;Pezizomycotina;Leotiomycetes;Helotiales;Chaetomellaceae;";"0.0";"0";"9";"9";"0";"9";"0";"457174";"373894"
"V4mis1";"SILVA (only NR);Eukaryota;Amorphea;Obazoa;Opisthokonta;Nucletmycea;Fungi;Dikarya;Ascomycota;Pezizomycotina;Leotiomycetes;Helotiales;Chaetomellaceae;Chaetomella;";"0.0";"0";"5";"5";"0";"5";"0";"457178";"373894"
"V4mis1";"SILVA (only NR);Eukaryota;Amorphea;Obazoa;Opisthokonta;Nucletmycea;Fungi;Dikarya;Ascomycota;Pezizomycotina;Leotiomycetes;Helotiales;Chaetomellaceae;Pilidium;";"0.0";"0";"2";"2";"0";"2";"0";"457181";"373894"
"V4mis1";"SILVA (only NR);Eukaryota;Amorphea;Obazoa;Opisthokonta;Nucletmycea;Fungi;Dikarya;Ascomycota;Pezizomycotina;Leotiomycetes;Helotiales;Chaetomellaceae;Sphaerographium;";"0.0";"0";"1";"1";"0";"1";"0";"457182";"373894"
"V4mis1";"SILVA (only NR);Eukaryota;Amorphea;Obazoa;Opisthokonta;Nucletmycea;Fungi;Dikarya;Ascomycota;Pezizomycotina;Leotiomycetes;Helotiales;Chaetomellaceae;Synchaetomella;";"0.0";"0";"1";"1";"0";"1";"0";"457182";"373894"
"V4mis1";"SILVA (only NR);Eukaryota;Amorphea;Obazoa;Opisthokonta;Nucletmycea;Fungi;Dikarya;Ascomycota;Pezizomycotina;Leotiomycetes;Helotiales;Chlorociboriaceae;";"0.0";"0";"4";"4";"0";"4";"0";"457179";"373894"
"V4mis1";"SILVA (only NR);Eukaryota;Amorphea;Obazoa;Opisthokonta;Nucletmycea;Fungi;Dikarya;Ascomycota;Pezizomycotina;Leotiomycetes;Helotiales;Chlorociboriaceae;Chlorociboria;";"0.0";"0";"4";"4";"0";"4";"0";"457179";"373894"
"V4mis1";"SILVA (only NR);Eukaryota;Amorphea;Obazoa;Opisthokonta;Nucletmycea;Fungi;Dikarya;Ascomycota;Pezizomycotina;Leotiomycetes;Helotiales;Chlorovibrissea;";"0.0";"0";"1";"1";"0";"1";"0";"457182";"373894"
"V4mis1";"SILVA (only NR);Eukaryota;Amorphea;Obazoa;Opisthokonta;Nucletmycea;Fungi;Dikarya;Ascomycota;Pezizomycotina;Leotiomycetes;Helotiales;Claussenomyces;";"0.0";"0";"1";"1";"0";"1";"0";"457182";"373894"
"V4mis1";"SILVA (only NR);Eukaryota;Amorphea;Obazoa;Opisthokonta;Nucletmycea;Fungi;Dikarya;Ascomycota;Pezizomycotina;Leotiomycetes;Helotiales;Cordieritidaceae;";"0.0";"0";"2";"2";"0";"2";"0";"457181";"373894"
"V4mis1";"SILVA (only NR);Eukaryota;Amorphea;Obazoa;Opisthokonta;Nucletmycea;Fungi;Dikarya;Ascomycota;Pezizomycotina;Leotiomycetes;Helotiales;Cordieritidaceae;Cordierites;";"0.0";"0";"1";"1";"0";"1";"0";"457182";"373894"
"V4mis1";"SILVA (only NR);Eukaryota;Amorphea;Obazoa;Opisthokonta;Nucletmycea;Fungi;Dikarya;Ascomycota;Pezizomycotina;Leotiomycetes;Helotiales;Cordieritidaceae;Thamnogalla;";"0.0";"0";"1";"1";"0";"1";"0";"457182";"373894"
"V4mis1";"SILVA (only NR);Eukaryota;Amorphea;Obazoa;Opisthokonta;Nucletmycea;Fungi;Dikarya;Ascomycota;Pezizomycotina;Leotiomycetes;Helotiales;Cyclaneusma;";"0.0";"0";"1";"1";"0";"1";"0";"457182";"373894"
"V4mis1";"SILVA (only NR);Eukaryota;Amorphea;Obazoa;Opisthokonta;Nucletmycea;Fungi;Dikarya;Ascomycota;Pezizomycotina;Leotiomycetes;Helotiales;Dermateaceae;";"0.0";"0";"2";"2";"0";"2";"0";"457181";"373894"
"V4mis1";"SILVA (only NR);Eukaryota;Amorphea;Obazoa;Opisthokonta;Nucletmycea;Fungi;Dikarya;Ascomycota;Pezizomycotina;Leotiomycetes;Helotiales;Dermateaceae;Dermea;";"0.0";"0";"1";"1";"0";"1";"0";"457182";"373894"
"V4mis1";"SILVA (only NR);Eukaryota;Amorphea;Obazoa;Opisthokonta;Nucletmycea;Fungi;Dikarya;Ascomycota;Pezizomycotina;Leotiomycetes;Helotiales;Dermateaceae;Pezicula;";"0.0";"0";"1";"1";"0";"1";"0";"457182";"373894"
"V4mis1";"SILVA (only NR);Eukaryota;Amorphea;Obazoa;Opisthokonta;Nucletmycea;Fungi;Dikarya;Ascomycota;Pezizomycotina;Leotiomycetes;Helotiales;Discohainesia;";"0.0";"0";"1";"1";"0";"1";"0";"457182";"373894"
"V4mis1";"SILVA (only NR);Eukaryota;Amorphea;Obazoa;Opisthokonta;Nucletmycea;Fungi;Dikarya;Ascomycota;Pezizomycotina;Leotiomycetes;Helotiales;Encoelia;";"0.0";"0";"1";"1";"0";"1";"0";"457182";"373894"
"V4mis1";"SILVA (only NR);Eukaryota;Amorphea;Obazoa;Opisthokonta;Nucletmycea;Fungi;Dikarya;Ascomycota;Pezizomycotina;Leotiomycetes;Helotiales;Glarea;";"0.0";"0";"1";"1";"0";"1";"0";"457182";"373894"
"V4mis1";"SILVA (only NR);Eukaryota;Amorphea;Obazoa;Opisthokonta;Nucletmycea;Fungi;Dikarya;Ascomycota;Pezizomycotina;Leotiomycetes;Helotiales;Helotiaceae;";"0.0";"0";"25";"25";"0";"25";"0";"457158";"373894"
"V4mis1";"SILVA (only NR);Eukaryota;Amorphea;Obazoa;Opisthokonta;Nucletmycea;Fungi;Dikarya;Ascomycota;Pezizomycotina;Leotiomycetes;Helotiales;Helotiaceae;Acidea;";"0.0";"0";"2";"2";"0";"2";"0";"457181";"373894"
"V4mis1";"SILVA (only NR);Eukaryota;Amorphea;Obazoa;Opisthokonta;Nucletmycea;Fungi;Dikarya;Ascomycota;Pezizomycotina;Leotiomycetes;Helotiales;Helotiaceae;Ascocoryne;";"0.0";"0";"1";"1";"0";"1";"0";"457182";"373894"
"V4mis1";"SILVA (only NR);Eukaryota;Amorphea;Obazoa;Opisthokonta;Nucletmycea;Fungi;Dikarya;Ascomycota;Pezizomycotina;Leotiomycetes;Helotiales;Helotiaceae;Chloroscypha;";"0.0";"0";"1";"1";"0";"1";"0";"457182";"373894"
"V4mis1";"SILVA (only NR);Eukaryota;Amorphea;Obazoa;Opisthokonta;Nucletmycea;Fungi;Dikarya;Ascomycota;Pezizomycotina;Leotiomycetes;Helotiales;Helotiaceae;Epiglia;";"0.0";"0";"1";"1";"0";"1";"0";"457182";"373894"
"V4mis1";"SILVA (only NR);Eukaryota;Amorphea;Obazoa;Opisthokonta;Nucletmycea;Fungi;Dikarya;Ascomycota;Pezizomycotina;Leotiomycetes;Helotiales;Helotiaceae;Epithamnolia;";"0.0";"0";"1";"1";"0";"1";"0";"457182";"373894"
"V4mis1";"SILVA (only NR);Eukaryota;Amorphea;Obazoa;Opisthokonta;Nucletmycea;Fungi;Dikarya;Ascomycota;Pezizomycotina;Leotiomycetes;Helotiales;Helotiaceae;Gremmeniella;";"0.0";"0";"1";"1";"0";"1";"0";"457182";"373894"
"V4mis1";"SILVA (only NR);Eukaryota;Amorphea;Obazoa;Opisthokonta;Nucletmycea;Fungi;Dikarya;Ascomycota;Pezizomycotina;Leotiomycetes;Helotiales;Helotiaceae;Helicodendron;";"0.0";"0";"2";"2";"0";"2";"0";"457181";"373894"
"V4mis1";"SILVA (only NR);Eukaryota;Amorphea;Obazoa;Opisthokonta;Nucletmycea;Fungi;Dikarya;Ascomycota;Pezizomycotina;Leotiomycetes;Helotiales;Helotiaceae;Holwaya;";"0.0";"0";"1";"1";"0";"1";"0";"457182";"373894"
"V4mis1";"SILVA (only NR);Eukaryota;Amorphea;Obazoa;Opisthokonta;Nucletmycea;Fungi;Dikarya;Ascomycota;Pezizomycotina;Leotiomycetes;Helotiales;Helotiaceae;Meliniomyces;";"0.0";"0";"4";"4";"0";"4";"0";"457179";"373894"
"V4mis1";"SILVA (only NR);Eukaryota;Amorphea;Obazoa;Opisthokonta;Nucletmycea;Fungi;Dikarya;Ascomycota;Pezizomycotina;Leotiomycetes;Helotiales;Helotiaceae;Mniaecia;";"0.0";"0";"1";"1";"0";"1";"0";"457182";"373894"
"V4mis1";"SILVA (only NR);Eukaryota;Amorphea;Obazoa;Opisthokonta;Nucletmycea;Fungi;Dikarya;Ascomycota;Pezizomycotina;Leotiomycetes;Helotiales;Helotiaceae;Tetrachaetum;";"0.0";"0";"1";"1";"0";"1";"0";"457182";"373894"
"V4mis1";"SILVA (only NR);Eukaryota;Amorphea;Obazoa;Opisthokonta;Nucletmycea;Fungi;Dikarya;Ascomycota;Pezizomycotina;Leotiomycetes;Helotiales;Helotiaceae;Varicosporium;";"0.0";"0";"1";"1";"0";"1";"0";"457182";"373894"
"V4mis1";"SILVA (only NR);Eukaryota;Amorphea;Obazoa;Opisthokonta;Nucletmycea;Fungi;Dikarya;Ascomycota;Pezizomycotina;Leotiomycetes;Helotiales;Hyaloscypha;";"0.0";"0";"1";"1";"0";"1";"0";"457182";"373894"
"V4mis1";"SILVA (only NR);Eukaryota;Amorphea;Obazoa;Opisthokonta;Nucletmycea;Fungi;Dikarya;Ascomycota;Pezizomycotina;Leotiomycetes;Helotiales;Hymenoscyphus;";"0.0";"0";"2";"2";"0";"2";"0";"457181";"373894"
"V4mis1";"SILVA (only NR);Eukaryota;Amorphea;Obazoa;Opisthokonta;Nucletmycea;Fungi;Dikarya;Ascomycota;Pezizomycotina;Leotiomycetes;Helotiales;Incertae Sedis;";"0.0";"0";"26";"26";"0";"26";"0";"457157";"373894"
"V4mis1";"SILVA (only NR);Eukaryota;Amorphea;Obazoa;Opisthokonta;Nucletmycea;Fungi;Dikarya;Ascomycota;Pezizomycotina;Leotiomycetes;Helotiales;Incertae Sedis;Brachyalara;";"0.0";"0";"2";"2";"0";"2";"0";"457181";"373894"
"V4mis1";"SILVA (only NR);Eukaryota;Amorphea;Obazoa;Opisthokonta;Nucletmycea;Fungi;Dikarya;Ascomycota;Pezizomycotina;Leotiomycetes;Helotiales;Incertae Sedis;Cadophora;";"0.0";"0";"1";"1";"0";"1";"0";"457182";"373894"
"V4mis1";"SILVA (only NR);Eukaryota;Amorphea;Obazoa;Opisthokonta;Nucletmycea;Fungi;Dikarya;Ascomycota;Pezizomycotina;Leotiomycetes;Helotiales;Incertae Sedis;Exochalara;";"0.0";"0";"2";"2";"0";"2";"0";"457181";"373894"
"V4mis1";"SILVA (only NR);Eukaryota;Amorphea;Obazoa;Opisthokonta;Nucletmycea;Fungi;Dikarya;Ascomycota;Pezizomycotina;Leotiomycetes;Helotiales;Incertae Sedis;Infundichalara;";"0.0";"0";"2";"2";"0";"2";"0";"457181";"373894"
"V4mis1";"SILVA (only NR);Eukaryota;Amorphea;Obazoa;Opisthokonta;Nucletmycea;Fungi;Dikarya;Ascomycota;Pezizomycotina;Leotiomycetes;Helotiales;Incertae Sedis;Lemonniera;";"0.0";"0";"3";"3";"0";"3";"0";"457180";"373894"
"V4mis1";"SILVA (only NR);Eukaryota;Amorphea;Obazoa;Opisthokonta;Nucletmycea;Fungi;Dikarya;Ascomycota;Pezizomycotina;Leotiomycetes;Helotiales;Incertae Sedis;Phialocephala;";"0.0";"0";"4";"4";"0";"4";"0";"457179";"373894"
"V4mis1";"SILVA (only NR);Eukaryota;Amorphea;Obazoa;Opisthokonta;Nucletmycea;Fungi;Dikarya;Ascomycota;Pezizomycotina;Leotiomycetes;Helotiales;Incertae Sedis;Rhexocercosporidium;";"0.0";"0";"1";"1";"0";"1";"0";"457182";"373894"
"V4mis1";"SILVA (only NR);Eukaryota;Amorphea;Obazoa;Opisthokonta;Nucletmycea;Fungi;Dikarya;Ascomycota;Pezizomycotina;Leotiomycetes;Helotiales;Incertae Sedis;Skyttea;";"0.0";"0";"2";"2";"0";"2";"0";"457181";"373894"
"V4mis1";"SILVA (only NR);Eukaryota;Amorphea;Obazoa;Opisthokonta;Nucletmycea;Fungi;Dikarya;Ascomycota;Pezizomycotina;Leotiomycetes;Helotiales;Incertae Sedis;Tetracladium;";"0.0";"0";"9";"9";"0";"9";"0";"457174";"373894"
"V4mis1";"SILVA (only NR);Eukaryota;Amorphea;Obazoa;Opisthokonta;Nucletmycea;Fungi;Dikarya;Ascomycota;Pezizomycotina;Leotiomycetes;Helotiales;Ionomidotis;";"0.0";"0";"1";"1";"0";"1";"0";"457182";"373894"
"V4mis1";"SILVA (only NR);Eukaryota;Amorphea;Obazoa;Opisthokonta;Nucletmycea;Fungi;Dikarya;Ascomycota;Pezizomycotina;Leotiomycetes;Helotiales;Lachnellula;";"0.0";"0";"1";"1";"0";"1";"0";"457182";"373894"
"V4mis1";"SILVA (only NR);Eukaryota;Amorphea;Obazoa;Opisthokonta;Nucletmycea;Fungi;Dikarya;Ascomycota;Pezizomycotina;Leotiomycetes;Helotiales;Lachnum;";"0.0";"0";"2";"2";"0";"2";"0";"457181";"373894"
"V4mis1";"SILVA (only NR);Eukaryota;Amorphea;Obazoa;Opisthokonta;Nucletmycea;Fungi;Dikarya;Ascomycota;Pezizomycotina;Leotiomycetes;Helotiales;Lambertella;";"0.0";"0";"1";"1";"0";"1";"0";"457182";"373894"
"V4mis1";"SILVA (only NR);Eukaryota;Amorphea;Obazoa;Opisthokonta;Nucletmycea;Fungi;Dikarya;Ascomycota;Pezizomycotina;Leotiomycetes;Helotiales;Leotiaceae;";"0.0";"0";"9";"9";"0";"9";"0";"457174";"373894"
"V4mis1";"SILVA (only NR);Eukaryota;Amorphea;Obazoa;Opisthokonta;Nucletmycea;Fungi;Dikarya;Ascomycota;Pezizomycotina;Leotiomycetes;Helotiales;Leotiaceae;Alatospora;";"0.0";"0";"3";"3";"0";"3";"0";"457180";"373894"
"V4mis1";"SILVA (only NR);Eukaryota;Amorphea;Obazoa;Opisthokonta;Nucletmycea;Fungi;Dikarya;Ascomycota;Pezizomycotina;Leotiomycetes;Helotiales;Leotiaceae;Leotia;";"0.0";"0";"3";"3";"0";"3";"0";"457180";"373894"
"V4mis1";"SILVA (only NR);Eukaryota;Amorphea;Obazoa;Opisthokonta;Nucletmycea;Fungi;Dikarya;Ascomycota;Pezizomycotina;Leotiomycetes;Helotiales;Leotiaceae;Pezoloma;";"0.0";"0";"3";"3";"0";"3";"0";"457180";"373894"
"V4mis1";"SILVA (only NR);Eukaryota;Amorphea;Obazoa;Opisthokonta;Nucletmycea;Fungi;Dikarya;Ascomycota;Pezizomycotina;Leotiomycetes;Helotiales;Loramyces;";"0.0";"0";"1";"1";"0";"1";"0";"457182";"373894"
"V4mis1";"SILVA (only NR);Eukaryota;Amorphea;Obazoa;Opisthokonta;Nucletmycea;Fungi;Dikarya;Ascomycota;Pezizomycotina;Leotiomycetes;Helotiales;Microglossum;";"0.0";"0";"1";"1";"0";"1";"0";"457182";"373894"
"V4mis1";"SILVA (only NR);Eukaryota;Amorphea;Obazoa;Opisthokonta;Nucletmycea;Fungi;Dikarya;Ascomycota;Pezizomycotina;Leotiomycetes;Helotiales;Neobulgaria;";"0.0";"0";"1";"1";"0";"1";"0";"457182";"373894"
"V4mis1";"SILVA (only NR);Eukaryota;Amorphea;Obazoa;Opisthokonta;Nucletmycea;Fungi;Dikarya;Ascomycota;Pezizomycotina;Leotiomycetes;Helotiales;Neocudoniella;";"0.0";"0";"1";"1";"0";"1";"0";"457182";"373894"
"V4mis1";"SILVA (only NR);Eukaryota;Amorphea;Obazoa;Opisthokonta;Nucletmycea;Fungi;Dikarya;Ascomycota;Pezizomycotina;Leotiomycetes;Helotiales;Rhymbocarpus;";"0.0";"0";"1";"1";"0";"1";"0";"457182";"373894"
"V4mis1";"SILVA (only NR);Eukaryota;Amorphea;Obazoa;Opisthokonta;Nucletmycea;Fungi;Dikarya;Ascomycota;Pezizomycotina;Leotiomycetes;Helotiales;Rhynchosporium;";"0.0";"0";"1";"1";"0";"1";"0";"457182";"373894"
"V4mis1";"SILVA (only NR);Eukaryota;Amorphea;Obazoa;Opisthokonta;Nucletmycea;Fungi;Dikarya;Ascomycota;Pezizomycotina;Leotiomycetes;Helotiales;Rutstroemia;";"0.0";"0";"1";"1";"0";"1";"0";"457182";"373894"
"V4mis1";"SILVA (only NR);Eukaryota;Amorphea;Obazoa;Opisthokonta;Nucletmycea;Fungi;Dikarya;Ascomycota;Pezizomycotina;Leotiomycetes;Helotiales;Sclerotiniaceae;";"0.0";"0";"10";"10";"0";"10";"0";"457173";"373894"
"V4mis1";"SILVA (only NR);Eukaryota;Amorphea;Obazoa;Opisthokonta;Nucletmycea;Fungi;Dikarya;Ascomycota;Pezizomycotina;Leotiomycetes;Helotiales;Sclerotiniaceae;Botrytis;";"0.0";"0";"2";"2";"0";"2";"0";"457181";"373894"
"V4mis1";"SILVA (only NR);Eukaryota;Amorphea;Obazoa;Opisthokonta;Nucletmycea;Fungi;Dikarya;Ascomycota;Pezizomycotina;Leotiomycetes;Helotiales;Sclerotiniaceae;Scleromitrula;";"0.0";"0";"1";"1";"0";"1";"0";"457182";"373894"
"V4mis1";"SILVA (only NR);Eukaryota;Amorphea;Obazoa;Opisthokonta;Nucletmycea;Fungi;Dikarya;Ascomycota;Pezizomycotina;Leotiomycetes;Helotiales;Sclerotiniaceae;Sclerotinia;";"0.0";"0";"5";"5";"0";"5";"0";"457178";"373894"
"V4mis1";"SILVA (only NR);Eukaryota;Amorphea;Obazoa;Opisthokonta;Nucletmycea;Fungi;Dikarya;Ascomycota;Pezizomycotina;Leotiomycetes;Helotiales;Tornabea;";"0.0";"0";"1";"1";"0";"1";"0";"457182";"373894"
"V4mis1";"SILVA (only NR);Eukaryota;Amorphea;Obazoa;Opisthokonta;Nucletmycea;Fungi;Dikarya;Ascomycota;Pezizomycotina;Leotiomycetes;Helotiales;Tricladium;";"0.0";"0";"1";"1";"0";"1";"0";"457182";"373894"
"V4mis1";"SILVA (only NR);Eukaryota;Amorphea;Obazoa;Opisthokonta;Nucletmycea;Fungi;Dikarya;Ascomycota;Pezizomycotina;Leotiomycetes;Helotiales;uncultured;";"0.0";"0";"4";"4";"0";"4";"0";"457179";"373894"
"V4mis1";"SILVA (only NR);Eukaryota;Amorphea;Obazoa;Opisthokonta;Nucletmycea;Fungi;Dikarya;Ascomycota;Pezizomycotina;Leotiomycetes;Incertae Sedis;";"0.0";"0";"16";"16";"0";"16";"0";"457167";"373894"
"V4mis1";"SILVA (only NR);Eukaryota;Amorphea;Obazoa;Opisthokonta;Nucletmycea;Fungi;Dikarya;Ascomycota;Pezizomycotina;Leotiomycetes;Incertae Sedis;Incertae Sedis;";"0.0";"0";"12";"12";"0";"12";"0";"457171";"373894"
"V4mis1";"SILVA (only NR);Eukaryota;Amorphea;Obazoa;Opisthokonta;Nucletmycea;Fungi;Dikarya;Ascomycota;Pezizomycotina;Leotiomycetes;Incertae Sedis;Incertae Sedis;Collophora;";"0.0";"0";"1";"1";"0";"1";"0";"457182";"373894"
"V4mis1";"SILVA (only NR);Eukaryota;Amorphea;Obazoa;Opisthokonta;Nucletmycea;Fungi;Dikarya;Ascomycota;Pezizomycotina;Leotiomycetes;Incertae Sedis;Incertae Sedis;Gelatinomyces;";"0.0";"0";"1";"1";"0";"1";"0";"457182";"373894"
"V4mis1";"SILVA (only NR);Eukaryota;Amorphea;Obazoa;Opisthokonta;Nucletmycea;Fungi;Dikarya;Ascomycota;Pezizomycotina;Leotiomycetes;Incertae Sedis;Incertae Sedis;Leohumicola;";"0.0";"0";"2";"2";"0";"2";"0";"457181";"373894"
"V4mis1";"SILVA (only NR);Eukaryota;Amorphea;Obazoa;Opisthokonta;Nucletmycea;Fungi;Dikarya;Ascomycota;Pezizomycotina;Leotiomycetes;Incertae Sedis;Incertae Sedis;Scytalidium;";"0.0";"0";"5";"5";"0";"5";"0";"457178";"373894"
"V4mis1";"SILVA (only NR);Eukaryota;Amorphea;Obazoa;Opisthokonta;Nucletmycea;Fungi;Dikarya;Ascomycota;Pezizomycotina;Leotiomycetes;Incertae Sedis;Incertae Sedis;Soosiella;";"0.0";"0";"1";"1";"0";"1";"0";"457182";"373894"
"V4mis1";"SILVA (only NR);Eukaryota;Amorphea;Obazoa;Opisthokonta;Nucletmycea;Fungi;Dikarya;Ascomycota;Pezizomycotina;Leotiomycetes;Incertae Sedis;Incertae Sedis;Xylogone;";"0.0";"0";"2";"2";"0";"2";"0";"457181";"373894"
"V4mis1";"SILVA (only NR);Eukaryota;Amorphea;Obazoa;Opisthokonta;Nucletmycea;Fungi;Dikarya;Ascomycota;Pezizomycotina;Leotiomycetes;Incertae Sedis;Myxotrichaceae;";"0.0";"0";"4";"4";"0";"4";"0";"457179";"373894"
"V4mis1";"SILVA (only NR);Eukaryota;Amorphea;Obazoa;Opisthokonta;Nucletmycea;Fungi;Dikarya;Ascomycota;Pezizomycotina;Leotiomycetes;Incertae Sedis;Myxotrichaceae;Byssoascus;";"0.0";"0";"1";"1";"0";"1";"0";"457182";"373894"
"V4mis1";"SILVA (only NR);Eukaryota;Amorphea;Obazoa;Opisthokonta;Nucletmycea;Fungi;Dikarya;Ascomycota;Pezizomycotina;Leotiomycetes;Incertae Sedis;Myxotrichaceae;Myxotrichum;";"0.0";"0";"1";"1";"0";"1";"0";"457182";"373894"
"V4mis1";"SILVA (only NR);Eukaryota;Amorphea;Obazoa;Opisthokonta;Nucletmycea;Fungi;Dikarya;Ascomycota;Pezizomycotina;Leotiomycetes;Incertae Sedis;Myxotrichaceae;Oidiodendron;";"0.0";"0";"1";"1";"0";"1";"0";"457182";"373894"
"V4mis1";"SILVA (only NR);Eukaryota;Amorphea;Obazoa;Opisthokonta;Nucletmycea;Fungi;Dikarya;Ascomycota;Pezizomycotina;Leotiomycetes;Phacidiales;";"0.0";"0";"2";"2";"0";"2";"0";"457181";"373894"
"V4mis1";"SILVA (only NR);Eukaryota;Amorphea;Obazoa;Opisthokonta;Nucletmycea;Fungi;Dikarya;Ascomycota;Pezizomycotina;Leotiomycetes;Phacidiales;Bulgariaceae;";"0.0";"0";"2";"2";"0";"2";"0";"457181";"373894"
"V4mis1";"SILVA (only NR);Eukaryota;Amorphea;Obazoa;Opisthokonta;Nucletmycea;Fungi;Dikarya;Ascomycota;Pezizomycotina;Leotiomycetes;Phacidiales;Bulgariaceae;Bulgaria;";"0.0";"0";"1";"1";"0";"1";"0";"457182";"373894"
"V4mis1";"SILVA (only NR);Eukaryota;Amorphea;Obazoa;Opisthokonta;Nucletmycea;Fungi;Dikarya;Ascomycota;Pezizomycotina;Leotiomycetes;Phacidiales;Bulgariaceae;Bulgariella;";"0.0";"0";"1";"1";"0";"1";"0";"457182";"373894"
"V4mis1";"SILVA (only NR);Eukaryota;Amorphea;Obazoa;Opisthokonta;Nucletmycea;Fungi;Dikarya;Ascomycota;Pezizomycotina;Leotiomycetes;Pseudogymnoascus;";"0.0";"0";"4";"4";"0";"4";"0";"457179";"373894"
"V4mis1";"SILVA (only NR);Eukaryota;Amorphea;Obazoa;Opisthokonta;Nucletmycea;Fungi;Dikarya;Ascomycota;Pezizomycotina;Leotiomycetes;Rhytismatales;";"0.0";"0";"7";"7";"0";"7";"0";"457176";"373894"
"V4mis1";"SILVA (only NR);Eukaryota;Amorphea;Obazoa;Opisthokonta;Nucletmycea;Fungi;Dikarya;Ascomycota;Pezizomycotina;Leotiomycetes;Rhytismatales;Cudoniaceae;";"0.0";"0";"2";"2";"0";"2";"0";"457181";"373894"
"V4mis1";"SILVA (only NR);Eukaryota;Amorphea;Obazoa;Opisthokonta;Nucletmycea;Fungi;Dikarya;Ascomycota;Pezizomycotina;Leotiomycetes;Rhytismatales;Cudoniaceae;Spathularia;";"0.0";"0";"2";"2";"0";"2";"0";"457181";"373894"
"V4mis1";"SILVA (only NR);Eukaryota;Amorphea;Obazoa;Opisthokonta;Nucletmycea;Fungi;Dikarya;Ascomycota;Pezizomycotina;Leotiomycetes;Rhytismatales;Darkera;";"0.0";"0";"1";"1";"0";"1";"0";"457182";"373894"
"V4mis1";"SILVA (only NR);Eukaryota;Amorphea;Obazoa;Opisthokonta;Nucletmycea;Fungi;Dikarya;Ascomycota;Pezizomycotina;Leotiomycetes;Rhytismatales;Rhytismataceae;";"0.0";"0";"4";"4";"0";"4";"0";"457179";"373894"
"V4mis1";"SILVA (only NR);Eukaryota;Amorphea;Obazoa;Opisthokonta;Nucletmycea;Fungi;Dikarya;Ascomycota;Pezizomycotina;Leotiomycetes;Rhytismatales;Rhytismataceae;Coccomyces;";"0.0";"0";"1";"1";"0";"1";"0";"457182";"373894"
"V4mis1";"SILVA (only NR);Eukaryota;Amorphea;Obazoa;Opisthokonta;Nucletmycea;Fungi;Dikarya;Ascomycota;Pezizomycotina;Leotiomycetes;Rhytismatales;Rhytismataceae;Meria;";"0.0";"0";"1";"1";"0";"1";"0";"457182";"373894"
"V4mis1";"SILVA (only NR);Eukaryota;Amorphea;Obazoa;Opisthokonta;Nucletmycea;Fungi;Dikarya;Ascomycota;Pezizomycotina;Leotiomycetes;Rhytismatales;Rhytismataceae;Propolis;";"0.0";"0";"1";"1";"0";"1";"0";"457182";"373894"
"V4mis1";"SILVA (only NR);Eukaryota;Amorphea;Obazoa;Opisthokonta;Nucletmycea;Fungi;Dikarya;Ascomycota;Pezizomycotina;Leotiomycetes;Rhytismatales;Rhytismataceae;Rhytisma;";"0.0";"0";"1";"1";"0";"1";"0";"457182";"373894"
"V4mis1";"SILVA (only NR);Eukaryota;Amorphea;Obazoa;Opisthokonta;Nucletmycea;Fungi;Dikarya;Ascomycota;Pezizomycotina;Leotiomycetes;Satchmopsis;";"0.0";"0";"1";"1";"0";"1";"0";"457182";"373894"
"V4mis1";"SILVA (only NR);Eukaryota;Amorphea;Obazoa;Opisthokonta;Nucletmycea;Fungi;Dikarya;Ascomycota;Pezizomycotina;Leotiomycetes;Thelebolales;";"0.0";"0";"19";"19";"0";"19";"0";"457164";"373894"
"V4mis1";"SILVA (only NR);Eukaryota;Amorphea;Obazoa;Opisthokonta;Nucletmycea;Fungi;Dikarya;Ascomycota;Pezizomycotina;Leotiomycetes;Thelebolales;Thelebolaceae;";"0.0";"0";"19";"19";"0";"19";"0";"457164";"373894"
"V4mis1";"SILVA (only NR);Eukaryota;Amorphea;Obazoa;Opisthokonta;Nucletmycea;Fungi;Dikarya;Ascomycota;Pezizomycotina;Leotiomycetes;Thelebolales;Thelebolaceae;Ascozonus;";"0.0";"0";"1";"1";"0";"1";"0";"457182";"373894"
"V4mis1";"SILVA (only NR);Eukaryota;Amorphea;Obazoa;Opisthokonta;Nucletmycea;Fungi;Dikarya;Ascomycota;Pezizomycotina;Leotiomycetes;Thelebolales;Thelebolaceae;Hyphozyma;";"0.0";"0";"2";"2";"0";"2";"0";"457181";"373894"
"V4mis1";"SILVA (only NR);Eukaryota;Amorphea;Obazoa;Opisthokonta;Nucletmycea;Fungi;Dikarya;Ascomycota;Pezizomycotina;Leotiomycetes;Thelebolales;Thelebolaceae;Thelebolus;";"0.0";"0";"16";"16";"0";"16";"0";"457167";"373894"
"V4mis1";"SILVA (only NR);Eukaryota;Amorphea;Obazoa;Opisthokonta;Nucletmycea;Fungi;Dikarya;Ascomycota;Pezizomycotina;Leotiomycetes;uncultured;";"0.0";"0";"2";"2";"0";"2";"0";"457181";"373894"
"V4mis1";"SILVA (only NR);Eukaryota;Amorphea;Obazoa;Opisthokonta;Nucletmycea;Fungi;Dikarya;Ascomycota;Pezizomycotina;Lichinomycetes;";"0.0";"0";"45";"45";"0";"45";"0";"457138";"373894"
"V4mis1";"SILVA (only NR);Eukaryota;Amorphea;Obazoa;Opisthokonta;Nucletmycea;Fungi;Dikarya;Ascomycota;Pezizomycotina;Lichinomycetes;Lichinales;";"0.0";"0";"45";"45";"0";"45";"0";"457138";"373894"
"V4mis1";"SILVA (only NR);Eukaryota;Amorphea;Obazoa;Opisthokonta;Nucletmycea;Fungi;Dikarya;Ascomycota;Pezizomycotina;Lichinomycetes;Lichinales;Heppiaceae;";"0.0";"0";"2";"2";"0";"2";"0";"457181";"373894"
"V4mis1";"SILVA (only NR);Eukaryota;Amorphea;Obazoa;Opisthokonta;Nucletmycea;Fungi;Dikarya;Ascomycota;Pezizomycotina;Lichinomycetes;Lichinales;Heppiaceae;Heppia;";"0.0";"0";"2";"2";"0";"2";"0";"457181";"373894"
"V4mis1";"SILVA (only NR);Eukaryota;Amorphea;Obazoa;Opisthokonta;Nucletmycea;Fungi;Dikarya;Ascomycota;Pezizomycotina;Lichinomycetes;Lichinales;Lichinaceae;";"0.0";"0";"28";"28";"0";"28";"0";"457155";"373894"
"V4mis1";"SILVA (only NR);Eukaryota;Amorphea;Obazoa;Opisthokonta;Nucletmycea;Fungi;Dikarya;Ascomycota;Pezizomycotina;Lichinomycetes;Lichinales;Lichinaceae;Anema;";"0.0";"0";"1";"1";"0";"1";"0";"457182";"373894"
"V4mis1";"SILVA (only NR);Eukaryota;Amorphea;Obazoa;Opisthokonta;Nucletmycea;Fungi;Dikarya;Ascomycota;Pezizomycotina;Lichinomycetes;Lichinales;Lichinaceae;Digitothyrea;";"0.0";"0";"1";"1";"0";"1";"0";"457182";"373894"
"V4mis1";"SILVA (only NR);Eukaryota;Amorphea;Obazoa;Opisthokonta;Nucletmycea;Fungi;Dikarya;Ascomycota;Pezizomycotina;Lichinomycetes;Lichinales;Lichinaceae;Ephebe;";"0.0";"0";"1";"1";"0";"1";"0";"457182";"373894"
"V4mis1";"SILVA (only NR);Eukaryota;Amorphea;Obazoa;Opisthokonta;Nucletmycea;Fungi;Dikarya;Ascomycota;Pezizomycotina;Lichinomycetes;Lichinales;Lichinaceae;Euopsis;";"0.0";"0";"1";"1";"0";"1";"0";"457182";"373894"
"V4mis1";"SILVA (only NR);Eukaryota;Amorphea;Obazoa;Opisthokonta;Nucletmycea;Fungi;Dikarya;Ascomycota;Pezizomycotina;Lichinomycetes;Lichinales;Lichinaceae;Harpidium;";"0.0";"0";"1";"1";"0";"1";"0";"457182";"373894"
"V4mis1";"SILVA (only NR);Eukaryota;Amorphea;Obazoa;Opisthokonta;Nucletmycea;Fungi;Dikarya;Ascomycota;Pezizomycotina;Lichinomycetes;Lichinales;Lichinaceae;Jenmania;";"0.0";"0";"1";"1";"0";"1";"0";"457182";"373894"
"V4mis1";"SILVA (only NR);Eukaryota;Amorphea;Obazoa;Opisthokonta;Nucletmycea;Fungi;Dikarya;Ascomycota;Pezizomycotina;Lichinomycetes;Lichinales;Lichinaceae;Lichina;";"0.0";"0";"2";"2";"0";"2";"0";"457181";"373894"
"V4mis1";"SILVA (only NR);Eukaryota;Amorphea;Obazoa;Opisthokonta;Nucletmycea;Fungi;Dikarya;Ascomycota;Pezizomycotina;Lichinomycetes;Lichinales;Lichinaceae;Lichinella;";"0.0";"0";"1";"1";"0";"1";"0";"457182";"373894"
"V4mis1";"SILVA (only NR);Eukaryota;Amorphea;Obazoa;Opisthokonta;Nucletmycea;Fungi;Dikarya;Ascomycota;Pezizomycotina;Lichinomycetes;Lichinales;Lichinaceae;Paulia;";"0.0";"0";"4";"4";"0";"4";"0";"457179";"373894"
"V4mis1";"SILVA (only NR);Eukaryota;Amorphea;Obazoa;Opisthokonta;Nucletmycea;Fungi;Dikarya;Ascomycota;Pezizomycotina;Lichinomycetes;Lichinales;Lichinaceae;Peccania;";"0.0";"0";"4";"4";"0";"4";"0";"457179";"373894"
"V4mis1";"SILVA (only NR);Eukaryota;Amorphea;Obazoa;Opisthokonta;Nucletmycea;Fungi;Dikarya;Ascomycota;Pezizomycotina;Lichinomycetes;Lichinales;Lichinaceae;Phloeopeccania;";"0.0";"0";"1";"1";"0";"1";"0";"457182";"373894"
"V4mis1";"SILVA (only NR);Eukaryota;Amorphea;Obazoa;Opisthokonta;Nucletmycea;Fungi;Dikarya;Ascomycota;Pezizomycotina;Lichinomycetes;Lichinales;Lichinaceae;Porocyphus;";"0.0";"0";"1";"1";"0";"1";"0";"457182";"373894"
"V4mis1";"SILVA (only NR);Eukaryota;Amorphea;Obazoa;Opisthokonta;Nucletmycea;Fungi;Dikarya;Ascomycota;Pezizomycotina;Lichinomycetes;Lichinales;Lichinaceae;Psorotichia;";"0.0";"0";"3";"3";"0";"3";"0";"457180";"373894"
"V4mis1";"SILVA (only NR);Eukaryota;Amorphea;Obazoa;Opisthokonta;Nucletmycea;Fungi;Dikarya;Ascomycota;Pezizomycotina;Lichinomycetes;Lichinales;Lichinaceae;Pterygiopsis;";"0.0";"0";"1";"1";"0";"1";"0";"457182";"373894"
"V4mis1";"SILVA (only NR);Eukaryota;Amorphea;Obazoa;Opisthokonta;Nucletmycea;Fungi;Dikarya;Ascomycota;Pezizomycotina;Lichinomycetes;Lichinales;Lichinaceae;Stromatella;";"0.0";"0";"1";"1";"0";"1";"0";"457182";"373894"
"V4mis1";"SILVA (only NR);Eukaryota;Amorphea;Obazoa;Opisthokonta;Nucletmycea;Fungi;Dikarya;Ascomycota;Pezizomycotina;Lichinomycetes;Lichinales;Lichinaceae;Thyrea;";"0.0";"0";"2";"2";"0";"2";"0";"457181";"373894"
"V4mis1";"SILVA (only NR);Eukaryota;Amorphea;Obazoa;Opisthokonta;Nucletmycea;Fungi;Dikarya;Ascomycota;Pezizomycotina;Lichinomycetes;Lichinales;Peltulaceae;";"0.0";"0";"14";"14";"0";"14";"0";"457169";"373894"
"V4mis1";"SILVA (only NR);Eukaryota;Amorphea;Obazoa;Opisthokonta;Nucletmycea;Fungi;Dikarya;Ascomycota;Pezizomycotina;Lichinomycetes;Lichinales;Peltulaceae;Peltula;";"0.0";"0";"14";"14";"0";"14";"0";"457169";"373894"
"V4mis1";"SILVA (only NR);Eukaryota;Amorphea;Obazoa;Opisthokonta;Nucletmycea;Fungi;Dikarya;Ascomycota;Pezizomycotina;Orbiliomycetes;";"0.0";"0";"17";"17";"0";"17";"0";"457166";"373894"
"V4mis1";"SILVA (only NR);Eukaryota;Amorphea;Obazoa;Opisthokonta;Nucletmycea;Fungi;Dikarya;Ascomycota;Pezizomycotina;Orbiliomycetes;Orbiliales;";"0.0";"0";"17";"17";"0";"17";"0";"457166";"373894"
"V4mis1";"SILVA (only NR);Eukaryota;Amorphea;Obazoa;Opisthokonta;Nucletmycea;Fungi;Dikarya;Ascomycota;Pezizomycotina;Orbiliomycetes;Orbiliales;Orbiliaceae;";"0.0";"0";"17";"17";"0";"17";"0";"457166";"373894"
"V4mis1";"SILVA (only NR);Eukaryota;Amorphea;Obazoa;Opisthokonta;Nucletmycea;Fungi;Dikarya;Ascomycota;Pezizomycotina;Orbiliomycetes;Orbiliales;Orbiliaceae;Arthrobotrys;";"0.0";"0";"8";"8";"0";"8";"0";"457175";"373894"
"V4mis1";"SILVA (only NR);Eukaryota;Amorphea;Obazoa;Opisthokonta;Nucletmycea;Fungi;Dikarya;Ascomycota;Pezizomycotina;Orbiliomycetes;Orbiliales;Orbiliaceae;Dactylella;";"0.0";"0";"2";"2";"0";"2";"0";"457181";"373894"
"V4mis1";"SILVA (only NR);Eukaryota;Amorphea;Obazoa;Opisthokonta;Nucletmycea;Fungi;Dikarya;Ascomycota;Pezizomycotina;Orbiliomycetes;Orbiliales;Orbiliaceae;Dactylellina;";"0.0";"0";"2";"2";"0";"2";"0";"457181";"373894"
"V4mis1";"SILVA (only NR);Eukaryota;Amorphea;Obazoa;Opisthokonta;Nucletmycea;Fungi;Dikarya;Ascomycota;Pezizomycotina;Orbiliomycetes;Orbiliales;Orbiliaceae;Drechslerella;";"0.0";"0";"1";"1";"0";"1";"0";"457182";"373894"
"V4mis1";"SILVA (only NR);Eukaryota;Amorphea;Obazoa;Opisthokonta;Nucletmycea;Fungi;Dikarya;Ascomycota;Pezizomycotina;Orbiliomycetes;Orbiliales;Orbiliaceae;Duddingtonia;";"0.0";"0";"1";"1";"0";"1";"0";"457182";"373894"
"V4mis1";"SILVA (only NR);Eukaryota;Amorphea;Obazoa;Opisthokonta;Nucletmycea;Fungi;Dikarya;Ascomycota;Pezizomycotina;Orbiliomycetes;Orbiliales;Orbiliaceae;Monacrosporium;";"0.0";"0";"1";"1";"0";"1";"0";"457182";"373894"
"V4mis1";"SILVA (only NR);Eukaryota;Amorphea;Obazoa;Opisthokonta;Nucletmycea;Fungi;Dikarya;Ascomycota;Pezizomycotina;Orbiliomycetes;Orbiliales;Orbiliaceae;Orbilia;";"0.0";"0";"2";"2";"0";"2";"0";"457181";"373894"
"V4mis1";"SILVA (only NR);Eukaryota;Amorphea;Obazoa;Opisthokonta;Nucletmycea;Fungi;Dikarya;Ascomycota;Pezizomycotina;Pezizomycetes;";"0.0";"0";"189";"188";"0";"188";"1";"456995";"373894"
"V4mis1";"SILVA (only NR);Eukaryota;Amorphea;Obazoa;Opisthokonta;Nucletmycea;Fungi;Dikarya;Ascomycota;Pezizomycotina;Pezizomycetes;Pezizales;";"0.0";"0";"189";"188";"0";"188";"1";"456995";"373894"
"V4mis1";"SILVA (only NR);Eukaryota;Amorphea;Obazoa;Opisthokonta;Nucletmycea;Fungi;Dikarya;Ascomycota;Pezizomycotina;Pezizomycetes;Pezizales;Ascobolaceae;";"0.0";"0";"7";"7";"0";"7";"0";"457176";"373894"
"V4mis1";"SILVA (only NR);Eukaryota;Amorphea;Obazoa;Opisthokonta;Nucletmycea;Fungi;Dikarya;Ascomycota;Pezizomycotina;Pezizomycetes;Pezizales;Ascobolaceae;Ascobolus;";"0.0";"0";"2";"2";"0";"2";"0";"457181";"373894"
"V4mis1";"SILVA (only NR);Eukaryota;Amorphea;Obazoa;Opisthokonta;Nucletmycea;Fungi;Dikarya;Ascomycota;Pezizomycotina;Pezizomycetes;Pezizales;Ascobolaceae;Saccobolus;";"0.0";"0";"1";"1";"0";"1";"0";"457182";"373894"
"V4mis1";"SILVA (only NR);Eukaryota;Amorphea;Obazoa;Opisthokonta;Nucletmycea;Fungi;Dikarya;Ascomycota;Pezizomycotina;Pezizomycetes;Pezizales;Ascobolaceae;Thecotheus;";"0.0";"0";"1";"1";"0";"1";"0";"457182";"373894"
"V4mis1";"SILVA (only NR);Eukaryota;Amorphea;Obazoa;Opisthokonta;Nucletmycea;Fungi;Dikarya;Ascomycota;Pezizomycotina;Pezizomycetes;Pezizales;Ascobolaceae;uncultured;";"0.0";"0";"3";"3";"0";"3";"0";"457180";"373894"
"V4mis1";"SILVA (only NR);Eukaryota;Amorphea;Obazoa;Opisthokonta;Nucletmycea;Fungi;Dikarya;Ascomycota;Pezizomycotina;Pezizomycetes;Pezizales;Ascodesmidaceae;";"0.0";"0";"9";"9";"0";"9";"0";"457174";"373894"
"V4mis1";"SILVA (only NR);Eukaryota;Amorphea;Obazoa;Opisthokonta;Nucletmycea;Fungi;Dikarya;Ascomycota;Pezizomycotina;Pezizomycetes;Pezizales;Ascodesmidaceae;Cephaliophora;";"0.0";"0";"5";"5";"0";"5";"0";"457178";"373894"
"V4mis1";"SILVA (only NR);Eukaryota;Amorphea;Obazoa;Opisthokonta;Nucletmycea;Fungi;Dikarya;Ascomycota;Pezizomycotina;Pezizomycetes;Pezizales;Ascodesmidaceae;Eleutherascus;";"0.0";"0";"2";"2";"0";"2";"0";"457181";"373894"
"V4mis1";"SILVA (only NR);Eukaryota;Amorphea;Obazoa;Opisthokonta;Nucletmycea;Fungi;Dikarya;Ascomycota;Pezizomycotina;Pezizomycetes;Pezizales;Ascodesmidaceae;Lasiobolus;";"0.0";"0";"1";"1";"0";"1";"0";"457182";"373894"
"V4mis1";"SILVA (only NR);Eukaryota;Amorphea;Obazoa;Opisthokonta;Nucletmycea;Fungi;Dikarya;Ascomycota;Pezizomycotina;Pezizomycetes;Pezizales;Caloscypha;";"0.0";"0";"2";"2";"0";"2";"0";"457181";"373894"
"V4mis1";"SILVA (only NR);Eukaryota;Amorphea;Obazoa;Opisthokonta;Nucletmycea;Fungi;Dikarya;Ascomycota;Pezizomycotina;Pezizomycetes;Pezizales;Chalazion;";"0.0";"0";"1";"1";"0";"1";"0";"457182";"373894"
"V4mis1";"SILVA (only NR);Eukaryota;Amorphea;Obazoa;Opisthokonta;Nucletmycea;Fungi;Dikarya;Ascomycota;Pezizomycotina;Pezizomycetes;Pezizales;Chorioactidaceae;";"0.0";"0";"3";"3";"0";"3";"0";"457180";"373894"
"V4mis1";"SILVA (only NR);Eukaryota;Amorphea;Obazoa;Opisthokonta;Nucletmycea;Fungi;Dikarya;Ascomycota;Pezizomycotina;Pezizomycetes;Pezizales;Chorioactidaceae;Chorioactis;";"0.0";"0";"1";"1";"0";"1";"0";"457182";"373894"
"V4mis1";"SILVA (only NR);Eukaryota;Amorphea;Obazoa;Opisthokonta;Nucletmycea;Fungi;Dikarya;Ascomycota;Pezizomycotina;Pezizomycetes;Pezizales;Chorioactidaceae;Neournula;";"0.0";"0";"1";"1";"0";"1";"0";"457182";"373894"
"V4mis1";"SILVA (only NR);Eukaryota;Amorphea;Obazoa;Opisthokonta;Nucletmycea;Fungi;Dikarya;Ascomycota;Pezizomycotina;Pezizomycetes;Pezizales;Chorioactidaceae;Pseudosarcosoma;";"0.0";"0";"1";"1";"0";"1";"0";"457182";"373894"
"V4mis1";"SILVA (only NR);Eukaryota;Amorphea;Obazoa;Opisthokonta;Nucletmycea;Fungi;Dikarya;Ascomycota;Pezizomycotina;Pezizomycetes;Pezizales;Desmazierella;";"0.0";"0";"1";"1";"0";"1";"0";"457182";"373894"
"V4mis1";"SILVA (only NR);Eukaryota;Amorphea;Obazoa;Opisthokonta;Nucletmycea;Fungi;Dikarya;Ascomycota;Pezizomycotina;Pezizomycetes;Pezizales;Glaziella;";"0.0";"0";"1";"1";"0";"1";"0";"457182";"373894"
"V4mis1";"SILVA (only NR);Eukaryota;Amorphea;Obazoa;Opisthokonta;Nucletmycea;Fungi;Dikarya;Ascomycota;Pezizomycotina;Pezizomycetes;Pezizales;Gyromitra;";"0.0";"0";"4";"4";"0";"4";"0";"457179";"373894"
"V4mis1";"SILVA (only NR);Eukaryota;Amorphea;Obazoa;Opisthokonta;Nucletmycea;Fungi;Dikarya;Ascomycota;Pezizomycotina;Pezizomycetes;Pezizales;Helvellaceae;";"0.0";"0";"15";"15";"0";"15";"0";"457168";"373894"
"V4mis1";"SILVA (only NR);Eukaryota;Amorphea;Obazoa;Opisthokonta;Nucletmycea;Fungi;Dikarya;Ascomycota;Pezizomycotina;Pezizomycetes;Pezizales;Helvellaceae;Balsamia;";"0.0";"0";"1";"1";"0";"1";"0";"457182";"373894"
"V4mis1";"SILVA (only NR);Eukaryota;Amorphea;Obazoa;Opisthokonta;Nucletmycea;Fungi;Dikarya;Ascomycota;Pezizomycotina;Pezizomycetes;Pezizales;Helvellaceae;Barssia;";"0.0";"0";"1";"1";"0";"1";"0";"457182";"373894"
"V4mis1";"SILVA (only NR);Eukaryota;Amorphea;Obazoa;Opisthokonta;Nucletmycea;Fungi;Dikarya;Ascomycota;Pezizomycotina;Pezizomycetes;Pezizales;Helvellaceae;Fischerula;";"0.0";"0";"1";"1";"0";"1";"0";"457182";"373894"
"V4mis1";"SILVA (only NR);Eukaryota;Amorphea;Obazoa;Opisthokonta;Nucletmycea;Fungi;Dikarya;Ascomycota;Pezizomycotina;Pezizomycetes;Pezizales;Helvellaceae;Helvella;";"0.0";"0";"10";"10";"0";"10";"0";"457173";"373894"
"V4mis1";"SILVA (only NR);Eukaryota;Amorphea;Obazoa;Opisthokonta;Nucletmycea;Fungi;Dikarya;Ascomycota;Pezizomycotina;Pezizomycetes;Pezizales;Helvellaceae;Imaia;";"0.0";"0";"1";"1";"0";"1";"0";"457182";"373894"
"V4mis1";"SILVA (only NR);Eukaryota;Amorphea;Obazoa;Opisthokonta;Nucletmycea;Fungi;Dikarya;Ascomycota;Pezizomycotina;Pezizomycetes;Pezizales;Helvellaceae;Leucangium;";"0.0";"0";"1";"1";"0";"1";"0";"457182";"373894"
"V4mis1";"SILVA (only NR);Eukaryota;Amorphea;Obazoa;Opisthokonta;Nucletmycea;Fungi;Dikarya;Ascomycota;Pezizomycotina;Pezizomycetes;Pezizales;Hydnotrya;";"0.0";"0";"1";"1";"0";"1";"0";"457182";"373894"
"V4mis1";"SILVA (only NR);Eukaryota;Amorphea;Obazoa;Opisthokonta;Nucletmycea;Fungi;Dikarya;Ascomycota;Pezizomycotina;Pezizomycetes;Pezizales;Incertae Sedis;";"0.0";"0";"2";"2";"0";"2";"0";"457181";"373894"
"V4mis1";"SILVA (only NR);Eukaryota;Amorphea;Obazoa;Opisthokonta;Nucletmycea;Fungi;Dikarya;Ascomycota;Pezizomycotina;Pezizomycetes;Pezizales;Incertae Sedis;Pulchromyces;";"0.0";"0";"2";"2";"0";"2";"0";"457181";"373894"
"V4mis1";"SILVA (only NR);Eukaryota;Amorphea;Obazoa;Opisthokonta;Nucletmycea;Fungi;Dikarya;Ascomycota;Pezizomycotina;Pezizomycetes;Pezizales;Karstenella;";"0.0";"0";"1";"1";"0";"1";"0";"457182";"373894"
"V4mis1";"SILVA (only NR);Eukaryota;Amorphea;Obazoa;Opisthokonta;Nucletmycea;Fungi;Dikarya;Ascomycota;Pezizomycotina;Pezizomycetes;Pezizales;Morchellaceae;";"0.0";"0";"4";"4";"0";"4";"0";"457179";"373894"
"V4mis1";"SILVA (only NR);Eukaryota;Amorphea;Obazoa;Opisthokonta;Nucletmycea;Fungi;Dikarya;Ascomycota;Pezizomycotina;Pezizomycetes;Pezizales;Morchellaceae;Morchella;";"0.0";"0";"1";"1";"0";"1";"0";"457182";"373894"
"V4mis1";"SILVA (only NR);Eukaryota;Amorphea;Obazoa;Opisthokonta;Nucletmycea;Fungi;Dikarya;Ascomycota;Pezizomycotina;Pezizomycetes;Pezizales;Morchellaceae;Verpa;";"0.0";"0";"3";"3";"0";"3";"0";"457180";"373894"
"V4mis1";"SILVA (only NR);Eukaryota;Amorphea;Obazoa;Opisthokonta;Nucletmycea;Fungi;Dikarya;Ascomycota;Pezizomycotina;Pezizomycetes;Pezizales;Pezizaceae;";"0.0";"0";"34";"34";"0";"34";"0";"457149";"373894"
"V4mis1";"SILVA (only NR);Eukaryota;Amorphea;Obazoa;Opisthokonta;Nucletmycea;Fungi;Dikarya;Ascomycota;Pezizomycotina;Pezizomycetes;Pezizales;Pezizaceae;Boudiera;";"0.0";"0";"1";"1";"0";"1";"0";"457182";"373894"
"V4mis1";"SILVA (only NR);Eukaryota;Amorphea;Obazoa;Opisthokonta;Nucletmycea;Fungi;Dikarya;Ascomycota;Pezizomycotina;Pezizomycetes;Pezizales;Pezizaceae;Cazia;";"0.0";"0";"1";"1";"0";"1";"0";"457182";"373894"
"V4mis1";"SILVA (only NR);Eukaryota;Amorphea;Obazoa;Opisthokonta;Nucletmycea;Fungi;Dikarya;Ascomycota;Pezizomycotina;Pezizomycetes;Pezizales;Pezizaceae;Iodowynnea;";"0.0";"0";"1";"1";"0";"1";"0";"457182";"373894"
"V4mis1";"SILVA (only NR);Eukaryota;Amorphea;Obazoa;Opisthokonta;Nucletmycea;Fungi;Dikarya;Ascomycota;Pezizomycotina;Pezizomycetes;Pezizales;Pezizaceae;Mattirolomyces;";"0.0";"0";"1";"1";"0";"1";"0";"457182";"373894"
"V4mis1";"SILVA (only NR);Eukaryota;Amorphea;Obazoa;Opisthokonta;Nucletmycea;Fungi;Dikarya;Ascomycota;Pezizomycotina;Pezizomycetes;Pezizales;Pezizaceae;Pachyella;";"0.0";"0";"3";"3";"0";"3";"0";"457180";"373894"
"V4mis1";"SILVA (only NR);Eukaryota;Amorphea;Obazoa;Opisthokonta;Nucletmycea;Fungi;Dikarya;Ascomycota;Pezizomycotina;Pezizomycetes;Pezizales;Pezizaceae;Peziza;";"0.0";"0";"15";"15";"0";"15";"0";"457168";"373894"
"V4mis1";"SILVA (only NR);Eukaryota;Amorphea;Obazoa;Opisthokonta;Nucletmycea;Fungi;Dikarya;Ascomycota;Pezizomycotina;Pezizomycetes;Pezizales;Pezizaceae;Plicaria;";"0.0";"0";"2";"2";"0";"2";"0";"457181";"373894"
"V4mis1";"SILVA (only NR);Eukaryota;Amorphea;Obazoa;Opisthokonta;Nucletmycea;Fungi;Dikarya;Ascomycota;Pezizomycotina;Pezizomycetes;Pezizales;Pezizaceae;Sarcosphaera;";"0.0";"0";"2";"2";"0";"2";"0";"457181";"373894"
"V4mis1";"SILVA (only NR);Eukaryota;Amorphea;Obazoa;Opisthokonta;Nucletmycea;Fungi;Dikarya;Ascomycota;Pezizomycotina;Pezizomycetes;Pezizales;Pezizaceae;uncultured;";"0.0";"0";"3";"3";"0";"3";"0";"457180";"373894"
"V4mis1";"SILVA (only NR);Eukaryota;Amorphea;Obazoa;Opisthokonta;Nucletmycea;Fungi;Dikarya;Ascomycota;Pezizomycotina;Pezizomycetes;Pezizales;Pyronemataceae;";"0.0";"0";"57";"57";"0";"57";"0";"457126";"373894"
"V4mis1";"SILVA (only NR);Eukaryota;Amorphea;Obazoa;Opisthokonta;Nucletmycea;Fungi;Dikarya;Ascomycota;Pezizomycotina;Pezizomycetes;Pezizales;Pyronemataceae;Acervus;";"0.0";"0";"2";"2";"0";"2";"0";"457181";"373894"
"V4mis1";"SILVA (only NR);Eukaryota;Amorphea;Obazoa;Opisthokonta;Nucletmycea;Fungi;Dikarya;Ascomycota;Pezizomycotina;Pezizomycetes;Pezizales;Pyronemataceae;Anthracobia;";"0.0";"0";"1";"1";"0";"1";"0";"457182";"373894"
"V4mis1";"SILVA (only NR);Eukaryota;Amorphea;Obazoa;Opisthokonta;Nucletmycea;Fungi;Dikarya;Ascomycota;Pezizomycotina;Pezizomycetes;Pezizales;Pyronemataceae;Byssonectria;";"0.0";"0";"1";"1";"0";"1";"0";"457182";"373894"
"V4mis1";"SILVA (only NR);Eukaryota;Amorphea;Obazoa;Opisthokonta;Nucletmycea;Fungi;Dikarya;Ascomycota;Pezizomycotina;Pezizomycetes;Pezizales;Pyronemataceae;Cheilymenia;";"0.0";"0";"3";"3";"0";"3";"0";"457180";"373894"
"V4mis1";"SILVA (only NR);Eukaryota;Amorphea;Obazoa;Opisthokonta;Nucletmycea;Fungi;Dikarya;Ascomycota;Pezizomycotina;Pezizomycetes;Pezizales;Pyronemataceae;Diehliomyces;";"0.0";"0";"1";"1";"0";"1";"0";"457182";"373894"
"V4mis1";"SILVA (only NR);Eukaryota;Amorphea;Obazoa;Opisthokonta;Nucletmycea;Fungi;Dikarya;Ascomycota;Pezizomycotina;Pezizomycetes;Pezizales;Pyronemataceae;Geopora;";"0.0";"0";"3";"3";"0";"3";"0";"457180";"373894"
"V4mis1";"SILVA (only NR);Eukaryota;Amorphea;Obazoa;Opisthokonta;Nucletmycea;Fungi;Dikarya;Ascomycota;Pezizomycotina;Pezizomycetes;Pezizales;Pyronemataceae;Geopyxis;";"0.0";"0";"3";"3";"0";"3";"0";"457180";"373894"
"V4mis1";"SILVA (only NR);Eukaryota;Amorphea;Obazoa;Opisthokonta;Nucletmycea;Fungi;Dikarya;Ascomycota;Pezizomycotina;Pezizomycetes;Pezizales;Pyronemataceae;Humaria;";"0.0";"0";"1";"1";"0";"1";"0";"457182";"373894"
"V4mis1";"SILVA (only NR);Eukaryota;Amorphea;Obazoa;Opisthokonta;Nucletmycea;Fungi;Dikarya;Ascomycota;Pezizomycotina;Pezizomycetes;Pezizales;Pyronemataceae;Inermisia;";"0.0";"0";"1";"1";"0";"1";"0";"457182";"373894"
"V4mis1";"SILVA (only NR);Eukaryota;Amorphea;Obazoa;Opisthokonta;Nucletmycea;Fungi;Dikarya;Ascomycota;Pezizomycotina;Pezizomycetes;Pezizales;Pyronemataceae;Lamprospora;";"0.0";"0";"2";"2";"0";"2";"0";"457181";"373894"
"V4mis1";"SILVA (only NR);Eukaryota;Amorphea;Obazoa;Opisthokonta;Nucletmycea;Fungi;Dikarya;Ascomycota;Pezizomycotina;Pezizomycetes;Pezizales;Pyronemataceae;Lasiobolidium;";"0.0";"0";"2";"2";"0";"2";"0";"457181";"373894"
"V4mis1";"SILVA (only NR);Eukaryota;Amorphea;Obazoa;Opisthokonta;Nucletmycea;Fungi;Dikarya;Ascomycota;Pezizomycotina;Pezizomycetes;Pezizales;Pyronemataceae;Leucoscypha;";"0.0";"0";"1";"1";"0";"1";"0";"457182";"373894"
"V4mis1";"SILVA (only NR);Eukaryota;Amorphea;Obazoa;Opisthokonta;Nucletmycea;Fungi;Dikarya;Ascomycota;Pezizomycotina;Pezizomycetes;Pezizales;Pyronemataceae;Marcelleina;";"0.0";"0";"2";"2";"0";"2";"0";"457181";"373894"
"V4mis1";"SILVA (only NR);Eukaryota;Amorphea;Obazoa;Opisthokonta;Nucletmycea;Fungi;Dikarya;Ascomycota;Pezizomycotina;Pezizomycetes;Pezizales;Pyronemataceae;Melastiza;";"0.0";"0";"1";"1";"0";"1";"0";"457182";"373894"
"V4mis1";"SILVA (only NR);Eukaryota;Amorphea;Obazoa;Opisthokonta;Nucletmycea;Fungi;Dikarya;Ascomycota;Pezizomycotina;Pezizomycetes;Pezizales;Pyronemataceae;Miladina;";"0.0";"0";"1";"1";"0";"1";"0";"457182";"373894"
"V4mis1";"SILVA (only NR);Eukaryota;Amorphea;Obazoa;Opisthokonta;Nucletmycea;Fungi;Dikarya;Ascomycota;Pezizomycotina;Pezizomycetes;Pezizales;Pyronemataceae;Octospora;";"0.0";"0";"2";"2";"0";"2";"0";"457181";"373894"
"V4mis1";"SILVA (only NR);Eukaryota;Amorphea;Obazoa;Opisthokonta;Nucletmycea;Fungi;Dikarya;Ascomycota;Pezizomycotina;Pezizomycetes;Pezizales;Pyronemataceae;Octosporella;";"0.0";"0";"2";"2";"0";"2";"0";"457181";"373894"
"V4mis1";"SILVA (only NR);Eukaryota;Amorphea;Obazoa;Opisthokonta;Nucletmycea;Fungi;Dikarya;Ascomycota;Pezizomycotina;Pezizomycetes;Pezizales;Pyronemataceae;Otidea;";"0.0";"0";"3";"3";"0";"3";"0";"457180";"373894"
"V4mis1";"SILVA (only NR);Eukaryota;Amorphea;Obazoa;Opisthokonta;Nucletmycea;Fungi;Dikarya;Ascomycota;Pezizomycotina;Pezizomycetes;Pezizales;Pyronemataceae;Parascutellinia;";"0.0";"0";"1";"1";"0";"1";"0";"457182";"373894"
"V4mis1";"SILVA (only NR);Eukaryota;Amorphea;Obazoa;Opisthokonta;Nucletmycea;Fungi;Dikarya;Ascomycota;Pezizomycotina;Pezizomycetes;Pezizales;Pyronemataceae;Pseudombrophila;";"0.0";"0";"1";"1";"0";"1";"0";"457182";"373894"
"V4mis1";"SILVA (only NR);Eukaryota;Amorphea;Obazoa;Opisthokonta;Nucletmycea;Fungi;Dikarya;Ascomycota;Pezizomycotina;Pezizomycetes;Pezizales;Pyronemataceae;Pulvinula;";"0.0";"0";"2";"2";"0";"2";"0";"457181";"373894"
"V4mis1";"SILVA (only NR);Eukaryota;Amorphea;Obazoa;Opisthokonta;Nucletmycea;Fungi;Dikarya;Ascomycota;Pezizomycotina;Pezizomycetes;Pezizales;Pyronemataceae;Pyronema;";"0.0";"0";"1";"1";"0";"1";"0";"457182";"373894"
"V4mis1";"SILVA (only NR);Eukaryota;Amorphea;Obazoa;Opisthokonta;Nucletmycea;Fungi;Dikarya;Ascomycota;Pezizomycotina;Pezizomycetes;Pezizales;Pyronemataceae;Rhodoscypha;";"0.0";"0";"1";"1";"0";"1";"0";"457182";"373894"
"V4mis1";"SILVA (only NR);Eukaryota;Amorphea;Obazoa;Opisthokonta;Nucletmycea;Fungi;Dikarya;Ascomycota;Pezizomycotina;Pezizomycetes;Pezizales;Pyronemataceae;Rhodotarzetta;";"0.0";"0";"1";"1";"0";"1";"0";"457182";"373894"
"V4mis1";"SILVA (only NR);Eukaryota;Amorphea;Obazoa;Opisthokonta;Nucletmycea;Fungi;Dikarya;Ascomycota;Pezizomycotina;Pezizomycetes;Pezizales;Pyronemataceae;Scutellinia;";"0.0";"0";"1";"1";"0";"1";"0";"457182";"373894"
"V4mis1";"SILVA (only NR);Eukaryota;Amorphea;Obazoa;Opisthokonta;Nucletmycea;Fungi;Dikarya;Ascomycota;Pezizomycotina;Pezizomycetes;Pezizales;Pyronemataceae;Selenaspora;";"0.0";"0";"1";"1";"0";"1";"0";"457182";"373894"
"V4mis1";"SILVA (only NR);Eukaryota;Amorphea;Obazoa;Opisthokonta;Nucletmycea;Fungi;Dikarya;Ascomycota;Pezizomycotina;Pezizomycetes;Pezizales;Pyronemataceae;Sowerbyella;";"0.0";"0";"3";"3";"0";"3";"0";"457180";"373894"
"V4mis1";"SILVA (only NR);Eukaryota;Amorphea;Obazoa;Opisthokonta;Nucletmycea;Fungi;Dikarya;Ascomycota;Pezizomycotina;Pezizomycetes;Pezizales;Pyronemataceae;Sporendonema;";"0.0";"0";"1";"1";"0";"1";"0";"457182";"373894"
"V4mis1";"SILVA (only NR);Eukaryota;Amorphea;Obazoa;Opisthokonta;Nucletmycea;Fungi;Dikarya;Ascomycota;Pezizomycotina;Pezizomycetes;Pezizales;Pyronemataceae;Tarzetta;";"0.0";"0";"2";"2";"0";"2";"0";"457181";"373894"
"V4mis1";"SILVA (only NR);Eukaryota;Amorphea;Obazoa;Opisthokonta;Nucletmycea;Fungi;Dikarya;Ascomycota;Pezizomycotina;Pezizomycetes;Pezizales;Pyronemataceae;Tricharina;";"0.0";"0";"1";"1";"0";"1";"0";"457182";"373894"
"V4mis1";"SILVA (only NR);Eukaryota;Amorphea;Obazoa;Opisthokonta;Nucletmycea;Fungi;Dikarya;Ascomycota;Pezizomycotina;Pezizomycetes;Pezizales;Pyronemataceae;Trichophaea;";"0.0";"0";"1";"1";"0";"1";"0";"457182";"373894"
"V4mis1";"SILVA (only NR);Eukaryota;Amorphea;Obazoa;Opisthokonta;Nucletmycea;Fungi;Dikarya;Ascomycota;Pezizomycotina;Pezizomycetes;Pezizales;Pyronemataceae;Wilcoxina;";"0.0";"0";"1";"1";"0";"1";"0";"457182";"373894"
"V4mis1";"SILVA (only NR);Eukaryota;Amorphea;Obazoa;Opisthokonta;Nucletmycea;Fungi;Dikarya;Ascomycota;Pezizomycotina;Pezizomycetes;Pezizales;Pyronemataceae;uncultured;";"0.0";"0";"5";"5";"0";"5";"0";"457178";"373894"
"V4mis1";"SILVA (only NR);Eukaryota;Amorphea;Obazoa;Opisthokonta;Nucletmycea;Fungi;Dikarya;Ascomycota;Pezizomycotina;Pezizomycetes;Pezizales;Reddellomyces;";"0.0";"0";"1";"1";"0";"1";"0";"457182";"373894"
"V4mis1";"SILVA (only NR);Eukaryota;Amorphea;Obazoa;Opisthokonta;Nucletmycea;Fungi;Dikarya;Ascomycota;Pezizomycotina;Pezizomycetes;Pezizales;Rhizinaceae;";"0.0";"0";"14";"14";"0";"14";"0";"457169";"373894"
"V4mis1";"SILVA (only NR);Eukaryota;Amorphea;Obazoa;Opisthokonta;Nucletmycea;Fungi;Dikarya;Ascomycota;Pezizomycotina;Pezizomycetes;Pezizales;Rhizinaceae;Phymatotrichopsis;";"0.0";"0";"9";"9";"0";"9";"0";"457174";"373894"
"V4mis1";"SILVA (only NR);Eukaryota;Amorphea;Obazoa;Opisthokonta;Nucletmycea;Fungi;Dikarya;Ascomycota;Pezizomycotina;Pezizomycetes;Pezizales;Rhizinaceae;Psilopezia;";"0.0";"0";"3";"3";"0";"3";"0";"457180";"373894"
"V4mis1";"SILVA (only NR);Eukaryota;Amorphea;Obazoa;Opisthokonta;Nucletmycea;Fungi;Dikarya;Ascomycota;Pezizomycotina;Pezizomycetes;Pezizales;Rhizinaceae;Rhizina;";"0.0";"0";"2";"2";"0";"2";"0";"457181";"373894"
"V4mis1";"SILVA (only NR);Eukaryota;Amorphea;Obazoa;Opisthokonta;Nucletmycea;Fungi;Dikarya;Ascomycota;Pezizomycotina;Pezizomycetes;Pezizales;Sarcoscyphaceae;";"0.0";"0";"13";"13";"0";"13";"0";"457170";"373894"
"V4mis1";"SILVA (only NR);Eukaryota;Amorphea;Obazoa;Opisthokonta;Nucletmycea;Fungi;Dikarya;Ascomycota;Pezizomycotina;Pezizomycetes;Pezizales;Sarcoscyphaceae;Cookeina;";"0.0";"0";"2";"2";"0";"2";"0";"457181";"373894"
"V4mis1";"SILVA (only NR);Eukaryota;Amorphea;Obazoa;Opisthokonta;Nucletmycea;Fungi;Dikarya;Ascomycota;Pezizomycotina;Pezizomycetes;Pezizales;Sarcoscyphaceae;Microstoma;";"0.0";"0";"2";"2";"0";"2";"0";"457181";"373894"
"V4mis1";"SILVA (only NR);Eukaryota;Amorphea;Obazoa;Opisthokonta;Nucletmycea;Fungi;Dikarya;Ascomycota;Pezizomycotina;Pezizomycetes;Pezizales;Sarcoscyphaceae;Nanoscypha;";"0.0";"0";"1";"1";"0";"1";"0";"457182";"373894"
"V4mis1";"SILVA (only NR);Eukaryota;Amorphea;Obazoa;Opisthokonta;Nucletmycea;Fungi;Dikarya;Ascomycota;Pezizomycotina;Pezizomycetes;Pezizales;Sarcoscyphaceae;Phillipsia;";"0.0";"0";"2";"2";"0";"2";"0";"457181";"373894"
"V4mis1";"SILVA (only NR);Eukaryota;Amorphea;Obazoa;Opisthokonta;Nucletmycea;Fungi;Dikarya;Ascomycota;Pezizomycotina;Pezizomycetes;Pezizales;Sarcoscyphaceae;Pithya;";"0.0";"0";"1";"1";"0";"1";"0";"457182";"373894"
"V4mis1";"SILVA (only NR);Eukaryota;Amorphea;Obazoa;Opisthokonta;Nucletmycea;Fungi;Dikarya;Ascomycota;Pezizomycotina;Pezizomycetes;Pezizales;Sarcoscyphaceae;Pseudopithyella;";"0.0";"0";"1";"1";"0";"1";"0";"457182";"373894"
"V4mis1";"SILVA (only NR);Eukaryota;Amorphea;Obazoa;Opisthokonta;Nucletmycea;Fungi;Dikarya;Ascomycota;Pezizomycotina;Pezizomycetes;Pezizales;Sarcoscyphaceae;Rickiella;";"0.0";"0";"1";"1";"0";"1";"0";"457182";"373894"
"V4mis1";"SILVA (only NR);Eukaryota;Amorphea;Obazoa;Opisthokonta;Nucletmycea;Fungi;Dikarya;Ascomycota;Pezizomycotina;Pezizomycetes;Pezizales;Sarcoscyphaceae;Sarcoscypha;";"0.0";"0";"2";"2";"0";"2";"0";"457181";"373894"
"V4mis1";"SILVA (only NR);Eukaryota;Amorphea;Obazoa;Opisthokonta;Nucletmycea;Fungi;Dikarya;Ascomycota;Pezizomycotina;Pezizomycetes;Pezizales;Sarcosomataceae;";"0.0";"0";"3";"3";"0";"3";"0";"457180";"373894"
"V4mis1";"SILVA (only NR);Eukaryota;Amorphea;Obazoa;Opisthokonta;Nucletmycea;Fungi;Dikarya;Ascomycota;Pezizomycotina;Pezizomycetes;Pezizales;Sarcosomataceae;Plectania;";"0.0";"0";"1";"1";"0";"1";"0";"457182";"373894"
"V4mis1";"SILVA (only NR);Eukaryota;Amorphea;Obazoa;Opisthokonta;Nucletmycea;Fungi;Dikarya;Ascomycota;Pezizomycotina;Pezizomycetes;Pezizales;Sarcosomataceae;Pseudoplectania;";"0.0";"0";"1";"1";"0";"1";"0";"457182";"373894"
"V4mis1";"SILVA (only NR);Eukaryota;Amorphea;Obazoa;Opisthokonta;Nucletmycea;Fungi;Dikarya;Ascomycota;Pezizomycotina;Pezizomycetes;Pezizales;Sarcosomataceae;Sarcosoma;";"0.0";"0";"1";"1";"0";"1";"0";"457182";"373894"
"V4mis1";"SILVA (only NR);Eukaryota;Amorphea;Obazoa;Opisthokonta;Nucletmycea;Fungi;Dikarya;Ascomycota;Pezizomycotina;Pezizomycetes;Pezizales;Strobiloscypha;";"0.0";"0";"1";"1";"0";"1";"0";"457182";"373894"
"V4mis1";"SILVA (only NR);Eukaryota;Amorphea;Obazoa;Opisthokonta;Nucletmycea;Fungi;Dikarya;Ascomycota;Pezizomycotina;Pezizomycetes;Pezizales;Tuberaceae;";"0.0";"0";"10";"9";"0";"9";"1";"457174";"373894"
"V4mis1";"SILVA (only NR);Eukaryota;Amorphea;Obazoa;Opisthokonta;Nucletmycea;Fungi;Dikarya;Ascomycota;Pezizomycotina;Pezizomycetes;Pezizales;Tuberaceae;Choiromyces;";"0.0";"0";"1";"1";"0";"1";"0";"457182";"373894"
"V4mis1";"SILVA (only NR);Eukaryota;Amorphea;Obazoa;Opisthokonta;Nucletmycea;Fungi;Dikarya;Ascomycota;Pezizomycotina;Pezizomycetes;Pezizales;Tuberaceae;Tuber;";"0.0";"0";"9";"8";"0";"8";"1";"457175";"373894"
"V4mis1";"SILVA (only NR);Eukaryota;Amorphea;Obazoa;Opisthokonta;Nucletmycea;Fungi;Dikarya;Ascomycota;Pezizomycotina;Pezizomycetes;Pezizales;Wolfina;";"0.0";"0";"1";"1";"0";"1";"0";"457182";"373894"
"V4mis1";"SILVA (only NR);Eukaryota;Amorphea;Obazoa;Opisthokonta;Nucletmycea;Fungi;Dikarya;Ascomycota;Pezizomycotina;Rhopalophora;";"0.0";"0";"2";"2";"0";"2";"0";"457181";"373894"
"V4mis1";"SILVA (only NR);Eukaryota;Amorphea;Obazoa;Opisthokonta;Nucletmycea;Fungi;Dikarya;Ascomycota;Pezizomycotina;Sordariomycetes;";"0.0";"0";"989";"988";"0";"988";"1";"456195";"373894"
"V4mis1";"SILVA (only NR);Eukaryota;Amorphea;Obazoa;Opisthokonta;Nucletmycea;Fungi;Dikarya;Ascomycota;Pezizomycotina;Sordariomycetes;Annulatascales;";"0.0";"0";"1";"1";"0";"1";"0";"457182";"373894"
"V4mis1";"SILVA (only NR);Eukaryota;Amorphea;Obazoa;Opisthokonta;Nucletmycea;Fungi;Dikarya;Ascomycota;Pezizomycotina;Sordariomycetes;Annulatascales;Annulatascaceae;";"0.0";"0";"1";"1";"0";"1";"0";"457182";"373894"
"V4mis1";"SILVA (only NR);Eukaryota;Amorphea;Obazoa;Opisthokonta;Nucletmycea;Fungi;Dikarya;Ascomycota;Pezizomycotina;Sordariomycetes;Annulatascales;Annulatascaceae;Ascitendus;";"0.0";"0";"1";"1";"0";"1";"0";"457182";"373894"
"V4mis1";"SILVA (only NR);Eukaryota;Amorphea;Obazoa;Opisthokonta;Nucletmycea;Fungi;Dikarya;Ascomycota;Pezizomycotina;Sordariomycetes;Boliniales;";"0.0";"0";"1";"1";"0";"1";"0";"457182";"373894"
"V4mis1";"SILVA (only NR);Eukaryota;Amorphea;Obazoa;Opisthokonta;Nucletmycea;Fungi;Dikarya;Ascomycota;Pezizomycotina;Sordariomycetes;Boliniales;Boliniaceae;";"0.0";"0";"1";"1";"0";"1";"0";"457182";"373894"
"V4mis1";"SILVA (only NR);Eukaryota;Amorphea;Obazoa;Opisthokonta;Nucletmycea;Fungi;Dikarya;Ascomycota;Pezizomycotina;Sordariomycetes;Boliniales;Boliniaceae;Camarops;";"0.0";"0";"1";"1";"0";"1";"0";"457182";"373894"
"V4mis1";"SILVA (only NR);Eukaryota;Amorphea;Obazoa;Opisthokonta;Nucletmycea;Fungi;Dikarya;Ascomycota;Pezizomycotina;Sordariomycetes;Calosphaeriales;";"0.0";"0";"6";"6";"0";"6";"0";"457177";"373894"
"V4mis1";"SILVA (only NR);Eukaryota;Amorphea;Obazoa;Opisthokonta;Nucletmycea;Fungi;Dikarya;Ascomycota;Pezizomycotina;Sordariomycetes;Calosphaeriales;Calosphaeriaceae;";"0.0";"0";"4";"4";"0";"4";"0";"457179";"373894"
"V4mis1";"SILVA (only NR);Eukaryota;Amorphea;Obazoa;Opisthokonta;Nucletmycea;Fungi;Dikarya;Ascomycota;Pezizomycotina;Sordariomycetes;Calosphaeriales;Calosphaeriaceae;Calosphaeria;";"0.0";"0";"1";"1";"0";"1";"0";"457182";"373894"
"V4mis1";"SILVA (only NR);Eukaryota;Amorphea;Obazoa;Opisthokonta;Nucletmycea;Fungi;Dikarya;Ascomycota;Pezizomycotina;Sordariomycetes;Calosphaeriales;Calosphaeriaceae;Jattaea;";"0.0";"0";"2";"2";"0";"2";"0";"457181";"373894"
"V4mis1";"SILVA (only NR);Eukaryota;Amorphea;Obazoa;Opisthokonta;Nucletmycea;Fungi;Dikarya;Ascomycota;Pezizomycotina;Sordariomycetes;Calosphaeriales;Calosphaeriaceae;Togniniella;";"0.0";"0";"1";"1";"0";"1";"0";"457182";"373894"
"V4mis1";"SILVA (only NR);Eukaryota;Amorphea;Obazoa;Opisthokonta;Nucletmycea;Fungi;Dikarya;Ascomycota;Pezizomycotina;Sordariomycetes;Calosphaeriales;Pleurostomataceae;";"0.0";"0";"2";"2";"0";"2";"0";"457181";"373894"
"V4mis1";"SILVA (only NR);Eukaryota;Amorphea;Obazoa;Opisthokonta;Nucletmycea;Fungi;Dikarya;Ascomycota;Pezizomycotina;Sordariomycetes;Calosphaeriales;Pleurostomataceae;Pleurostoma;";"0.0";"0";"2";"2";"0";"2";"0";"457181";"373894"
"V4mis1";"SILVA (only NR);Eukaryota;Amorphea;Obazoa;Opisthokonta;Nucletmycea;Fungi;Dikarya;Ascomycota;Pezizomycotina;Sordariomycetes;Coniochaetales;";"0.0";"0";"6";"6";"0";"6";"0";"457177";"373894"
"V4mis1";"SILVA (only NR);Eukaryota;Amorphea;Obazoa;Opisthokonta;Nucletmycea;Fungi;Dikarya;Ascomycota;Pezizomycotina;Sordariomycetes;Coniochaetales;Coniochaetaceae;";"0.0";"0";"6";"6";"0";"6";"0";"457177";"373894"
"V4mis1";"SILVA (only NR);Eukaryota;Amorphea;Obazoa;Opisthokonta;Nucletmycea;Fungi;Dikarya;Ascomycota;Pezizomycotina;Sordariomycetes;Coniochaetales;Coniochaetaceae;Coniochaeta;";"0.0";"0";"6";"6";"0";"6";"0";"457177";"373894"
"V4mis1";"SILVA (only NR);Eukaryota;Amorphea;Obazoa;Opisthokonta;Nucletmycea;Fungi;Dikarya;Ascomycota;Pezizomycotina;Sordariomycetes;Conioscyphales;";"0.0";"0";"3";"3";"0";"3";"0";"457180";"373894"
"V4mis1";"SILVA (only NR);Eukaryota;Amorphea;Obazoa;Opisthokonta;Nucletmycea;Fungi;Dikarya;Ascomycota;Pezizomycotina;Sordariomycetes;Conioscyphales;Conioscyphaceae;";"0.0";"0";"3";"3";"0";"3";"0";"457180";"373894"
"V4mis1";"SILVA (only NR);Eukaryota;Amorphea;Obazoa;Opisthokonta;Nucletmycea;Fungi;Dikarya;Ascomycota;Pezizomycotina;Sordariomycetes;Conioscyphales;Conioscyphaceae;Conioscypha;";"0.0";"0";"3";"3";"0";"3";"0";"457180";"373894"
"V4mis1";"SILVA (only NR);Eukaryota;Amorphea;Obazoa;Opisthokonta;Nucletmycea;Fungi;Dikarya;Ascomycota;Pezizomycotina;Sordariomycetes;Diaporthales;";"0.0";"0";"23";"23";"0";"23";"0";"457160";"373894"
"V4mis1";"SILVA (only NR);Eukaryota;Amorphea;Obazoa;Opisthokonta;Nucletmycea;Fungi;Dikarya;Ascomycota;Pezizomycotina;Sordariomycetes;Diaporthales;Cryphonectriaceae;";"0.0";"0";"9";"9";"0";"9";"0";"457174";"373894"
"V4mis1";"SILVA (only NR);Eukaryota;Amorphea;Obazoa;Opisthokonta;Nucletmycea;Fungi;Dikarya;Ascomycota;Pezizomycotina;Sordariomycetes;Diaporthales;Cryphonectriaceae;Cryphonectria-Endothia complex;";"0.0";"0";"9";"9";"0";"9";"0";"457174";"373894"
"V4mis1";"SILVA (only NR);Eukaryota;Amorphea;Obazoa;Opisthokonta;Nucletmycea;Fungi;Dikarya;Ascomycota;Pezizomycotina;Sordariomycetes;Diaporthales;Diaporthe;";"0.0";"0";"1";"1";"0";"1";"0";"457182";"373894"
"V4mis1";"SILVA (only NR);Eukaryota;Amorphea;Obazoa;Opisthokonta;Nucletmycea;Fungi;Dikarya;Ascomycota;Pezizomycotina;Sordariomycetes;Diaporthales;Gnomoniaceae;";"0.0";"0";"4";"4";"0";"4";"0";"457179";"373894"
"V4mis1";"SILVA (only NR);Eukaryota;Amorphea;Obazoa;Opisthokonta;Nucletmycea;Fungi;Dikarya;Ascomycota;Pezizomycotina;Sordariomycetes;Diaporthales;Gnomoniaceae;Cryptosporella;";"0.0";"0";"1";"1";"0";"1";"0";"457182";"373894"
"V4mis1";"SILVA (only NR);Eukaryota;Amorphea;Obazoa;Opisthokonta;Nucletmycea;Fungi;Dikarya;Ascomycota;Pezizomycotina;Sordariomycetes;Diaporthales;Gnomoniaceae;Gnomonia;";"0.0";"0";"1";"1";"0";"1";"0";"457182";"373894"
"V4mis1";"SILVA (only NR);Eukaryota;Amorphea;Obazoa;Opisthokonta;Nucletmycea;Fungi;Dikarya;Ascomycota;Pezizomycotina;Sordariomycetes;Diaporthales;Gnomoniaceae;Ophiognomonia;";"0.0";"0";"1";"1";"0";"1";"0";"457182";"373894"
"V4mis1";"SILVA (only NR);Eukaryota;Amorphea;Obazoa;Opisthokonta;Nucletmycea;Fungi;Dikarya;Ascomycota;Pezizomycotina;Sordariomycetes;Diaporthales;Gnomoniaceae;Plagiostoma;";"0.0";"0";"1";"1";"0";"1";"0";"457182";"373894"
"V4mis1";"SILVA (only NR);Eukaryota;Amorphea;Obazoa;Opisthokonta;Nucletmycea;Fungi;Dikarya;Ascomycota;Pezizomycotina;Sordariomycetes;Diaporthales;Melanconidaceae;";"0.0";"0";"2";"2";"0";"2";"0";"457181";"373894"
"V4mis1";"SILVA (only NR);Eukaryota;Amorphea;Obazoa;Opisthokonta;Nucletmycea;Fungi;Dikarya;Ascomycota;Pezizomycotina;Sordariomycetes;Diaporthales;Melanconidaceae;Melanconis;";"0.0";"0";"2";"2";"0";"2";"0";"457181";"373894"
"V4mis1";"SILVA (only NR);Eukaryota;Amorphea;Obazoa;Opisthokonta;Nucletmycea;Fungi;Dikarya;Ascomycota;Pezizomycotina;Sordariomycetes;Diaporthales;Phomopsis;";"0.0";"0";"1";"1";"0";"1";"0";"457182";"373894"
"V4mis1";"SILVA (only NR);Eukaryota;Amorphea;Obazoa;Opisthokonta;Nucletmycea;Fungi;Dikarya;Ascomycota;Pezizomycotina;Sordariomycetes;Diaporthales;Sirococcus;";"0.0";"0";"1";"1";"0";"1";"0";"457182";"373894"
"V4mis1";"SILVA (only NR);Eukaryota;Amorphea;Obazoa;Opisthokonta;Nucletmycea;Fungi;Dikarya;Ascomycota;Pezizomycotina;Sordariomycetes;Diaporthales;Valsa;";"0.0";"0";"1";"1";"0";"1";"0";"457182";"373894"
"V4mis1";"SILVA (only NR);Eukaryota;Amorphea;Obazoa;Opisthokonta;Nucletmycea;Fungi;Dikarya;Ascomycota;Pezizomycotina;Sordariomycetes;Diaporthales;Valsaceae;";"0.0";"0";"3";"3";"0";"3";"0";"457180";"373894"
"V4mis1";"SILVA (only NR);Eukaryota;Amorphea;Obazoa;Opisthokonta;Nucletmycea;Fungi;Dikarya;Ascomycota;Pezizomycotina;Sordariomycetes;Diaporthales;Valsaceae;Phruensis;";"0.0";"0";"2";"2";"0";"2";"0";"457181";"373894"
"V4mis1";"SILVA (only NR);Eukaryota;Amorphea;Obazoa;Opisthokonta;Nucletmycea;Fungi;Dikarya;Ascomycota;Pezizomycotina;Sordariomycetes;Glomerellales;";"0.0";"0";"92";"92";"0";"92";"0";"457091";"373894"
"V4mis1";"SILVA (only NR);Eukaryota;Amorphea;Obazoa;Opisthokonta;Nucletmycea;Fungi;Dikarya;Ascomycota;Pezizomycotina;Sordariomycetes;Glomerellales;Australiascaceae;";"0.0";"0";"5";"5";"0";"5";"0";"457178";"373894"
"V4mis1";"SILVA (only NR);Eukaryota;Amorphea;Obazoa;Opisthokonta;Nucletmycea;Fungi;Dikarya;Ascomycota;Pezizomycotina;Sordariomycetes;Glomerellales;Australiascaceae;Australiasca;";"0.0";"0";"1";"1";"0";"1";"0";"457182";"373894"
"V4mis1";"SILVA (only NR);Eukaryota;Amorphea;Obazoa;Opisthokonta;Nucletmycea;Fungi;Dikarya;Ascomycota;Pezizomycotina;Sordariomycetes;Glomerellales;Australiascaceae;Monilochaetes;";"0.0";"0";"4";"4";"0";"4";"0";"457179";"373894"
"V4mis1";"SILVA (only NR);Eukaryota;Amorphea;Obazoa;Opisthokonta;Nucletmycea;Fungi;Dikarya;Ascomycota;Pezizomycotina;Sordariomycetes;Glomerellales;Glomerellaceae;";"0.0";"0";"64";"64";"0";"64";"0";"457119";"373894"
"V4mis1";"SILVA (only NR);Eukaryota;Amorphea;Obazoa;Opisthokonta;Nucletmycea;Fungi;Dikarya;Ascomycota;Pezizomycotina;Sordariomycetes;Glomerellales;Glomerellaceae;Colletotrichum;";"0.0";"0";"64";"64";"0";"64";"0";"457119";"373894"
"V4mis1";"SILVA (only NR);Eukaryota;Amorphea;Obazoa;Opisthokonta;Nucletmycea;Fungi;Dikarya;Ascomycota;Pezizomycotina;Sordariomycetes;Glomerellales;Plectosphaerellaceae;";"0.0";"0";"18";"18";"0";"18";"0";"457165";"373894"
"V4mis1";"SILVA (only NR);Eukaryota;Amorphea;Obazoa;Opisthokonta;Nucletmycea;Fungi;Dikarya;Ascomycota;Pezizomycotina;Sordariomycetes;Glomerellales;Plectosphaerellaceae;Acrostalagmus;";"0.0";"0";"1";"1";"0";"1";"0";"457182";"373894"
"V4mis1";"SILVA (only NR);Eukaryota;Amorphea;Obazoa;Opisthokonta;Nucletmycea;Fungi;Dikarya;Ascomycota;Pezizomycotina;Sordariomycetes;Glomerellales;Plectosphaerellaceae;Gibellulopsis;";"0.0";"0";"1";"1";"0";"1";"0";"457182";"373894"
"V4mis1";"SILVA (only NR);Eukaryota;Amorphea;Obazoa;Opisthokonta;Nucletmycea;Fungi;Dikarya;Ascomycota;Pezizomycotina;Sordariomycetes;Glomerellales;Plectosphaerellaceae;Plectosphaerella;";"0.0";"0";"2";"2";"0";"2";"0";"457181";"373894"
"V4mis1";"SILVA (only NR);Eukaryota;Amorphea;Obazoa;Opisthokonta;Nucletmycea;Fungi;Dikarya;Ascomycota;Pezizomycotina;Sordariomycetes;Glomerellales;Plectosphaerellaceae;Verticillium;";"0.0";"0";"12";"12";"0";"12";"0";"457171";"373894"
"V4mis1";"SILVA (only NR);Eukaryota;Amorphea;Obazoa;Opisthokonta;Nucletmycea;Fungi;Dikarya;Ascomycota;Pezizomycotina;Sordariomycetes;Glomerellales;Reticulascaceae;";"0.0";"0";"5";"5";"0";"5";"0";"457178";"373894"
"V4mis1";"SILVA (only NR);Eukaryota;Amorphea;Obazoa;Opisthokonta;Nucletmycea;Fungi;Dikarya;Ascomycota;Pezizomycotina;Sordariomycetes;Glomerellales;Reticulascaceae;Kylindria;";"0.0";"0";"1";"1";"0";"1";"0";"457182";"373894"
"V4mis1";"SILVA (only NR);Eukaryota;Amorphea;Obazoa;Opisthokonta;Nucletmycea;Fungi;Dikarya;Ascomycota;Pezizomycotina;Sordariomycetes;Glomerellales;Reticulascaceae;Reticulascus;";"0.0";"0";"3";"3";"0";"3";"0";"457180";"373894"
"V4mis1";"SILVA (only NR);Eukaryota;Amorphea;Obazoa;Opisthokonta;Nucletmycea;Fungi;Dikarya;Ascomycota;Pezizomycotina;Sordariomycetes;Glomerellales;Reticulascaceae;Sporoschismopsis;";"0.0";"0";"1";"1";"0";"1";"0";"457182";"373894"
"V4mis1";"SILVA (only NR);Eukaryota;Amorphea;Obazoa;Opisthokonta;Nucletmycea;Fungi;Dikarya;Ascomycota;Pezizomycotina;Sordariomycetes;Hypocreales;";"0.0";"0";"435";"434";"0";"434";"1";"456749";"373894"
"V4mis1";"SILVA (only NR);Eukaryota;Amorphea;Obazoa;Opisthokonta;Nucletmycea;Fungi;Dikarya;Ascomycota;Pezizomycotina;Sordariomycetes;Hypocreales;Bionectriaceae;";"0.0";"0";"19";"19";"0";"19";"0";"457164";"373894"
"V4mis1";"SILVA (only NR);Eukaryota;Amorphea;Obazoa;Opisthokonta;Nucletmycea;Fungi;Dikarya;Ascomycota;Pezizomycotina;Sordariomycetes;Hypocreales;Bionectriaceae;Bryocentria;";"0.0";"0";"1";"1";"0";"1";"0";"457182";"373894"
"V4mis1";"SILVA (only NR);Eukaryota;Amorphea;Obazoa;Opisthokonta;Nucletmycea;Fungi;Dikarya;Ascomycota;Pezizomycotina;Sordariomycetes;Hypocreales;Bionectriaceae;Clonostachys;";"0.0";"0";"5";"5";"0";"5";"0";"457178";"373894"
"V4mis1";"SILVA (only NR);Eukaryota;Amorphea;Obazoa;Opisthokonta;Nucletmycea;Fungi;Dikarya;Ascomycota;Pezizomycotina;Sordariomycetes;Hypocreales;Bionectriaceae;Geosmithia;";"0.0";"0";"9";"9";"0";"9";"0";"457174";"373894"
"V4mis1";"SILVA (only NR);Eukaryota;Amorphea;Obazoa;Opisthokonta;Nucletmycea;Fungi;Dikarya;Ascomycota;Pezizomycotina;Sordariomycetes;Hypocreales;Bionectriaceae;Mycoarachis;";"0.0";"0";"1";"1";"0";"1";"0";"457182";"373894"
"V4mis1";"SILVA (only NR);Eukaryota;Amorphea;Obazoa;Opisthokonta;Nucletmycea;Fungi;Dikarya;Ascomycota;Pezizomycotina;Sordariomycetes;Hypocreales;Bionectriaceae;Nigrosabulum;";"0.0";"0";"1";"1";"0";"1";"0";"457182";"373894"
"V4mis1";"SILVA (only NR);Eukaryota;Amorphea;Obazoa;Opisthokonta;Nucletmycea;Fungi;Dikarya;Ascomycota;Pezizomycotina;Sordariomycetes;Hypocreales;Bionectriaceae;Ochronectria;";"0.0";"0";"1";"1";"0";"1";"0";"457182";"373894"
"V4mis1";"SILVA (only NR);Eukaryota;Amorphea;Obazoa;Opisthokonta;Nucletmycea;Fungi;Dikarya;Ascomycota;Pezizomycotina;Sordariomycetes;Hypocreales;Claviceps;";"0.0";"0";"1";"1";"0";"1";"0";"457182";"373894"
"V4mis1";"SILVA (only NR);Eukaryota;Amorphea;Obazoa;Opisthokonta;Nucletmycea;Fungi;Dikarya;Ascomycota;Pezizomycotina;Sordariomycetes;Hypocreales;Clavicipitaceae;";"0.0";"0";"39";"38";"0";"38";"1";"457145";"373894"
"V4mis1";"SILVA (only NR);Eukaryota;Amorphea;Obazoa;Opisthokonta;Nucletmycea;Fungi;Dikarya;Ascomycota;Pezizomycotina;Sordariomycetes;Hypocreales;Clavicipitaceae;Aciculosporium;";"0.0";"0";"1";"1";"0";"1";"0";"457182";"373894"
"V4mis1";"SILVA (only NR);Eukaryota;Amorphea;Obazoa;Opisthokonta;Nucletmycea;Fungi;Dikarya;Ascomycota;Pezizomycotina;Sordariomycetes;Hypocreales;Clavicipitaceae;Balansia;";"0.0";"0";"1";"1";"0";"1";"0";"457182";"373894"
"V4mis1";"SILVA (only NR);Eukaryota;Amorphea;Obazoa;Opisthokonta;Nucletmycea;Fungi;Dikarya;Ascomycota;Pezizomycotina;Sordariomycetes;Hypocreales;Clavicipitaceae;Conoideocrella;";"0.0";"0";"3";"3";"0";"3";"0";"457180";"373894"
"V4mis1";"SILVA (only NR);Eukaryota;Amorphea;Obazoa;Opisthokonta;Nucletmycea;Fungi;Dikarya;Ascomycota;Pezizomycotina;Sordariomycetes;Hypocreales;Clavicipitaceae;Epichloe;";"0.0";"0";"6";"5";"0";"5";"1";"457178";"373894"
"V4mis1";"SILVA (only NR);Eukaryota;Amorphea;Obazoa;Opisthokonta;Nucletmycea;Fungi;Dikarya;Ascomycota;Pezizomycotina;Sordariomycetes;Hypocreales;Clavicipitaceae;Hypocrella;";"0.0";"0";"1";"1";"0";"1";"0";"457182";"373894"
"V4mis1";"SILVA (only NR);Eukaryota;Amorphea;Obazoa;Opisthokonta;Nucletmycea;Fungi;Dikarya;Ascomycota;Pezizomycotina;Sordariomycetes;Hypocreales;Clavicipitaceae;Metapochonia;";"0.0";"0";"2";"2";"0";"2";"0";"457181";"373894"
"V4mis1";"SILVA (only NR);Eukaryota;Amorphea;Obazoa;Opisthokonta;Nucletmycea;Fungi;Dikarya;Ascomycota;Pezizomycotina;Sordariomycetes;Hypocreales;Clavicipitaceae;Metarhizium;";"0.0";"0";"18";"18";"0";"18";"0";"457165";"373894"
"V4mis1";"SILVA (only NR);Eukaryota;Amorphea;Obazoa;Opisthokonta;Nucletmycea;Fungi;Dikarya;Ascomycota;Pezizomycotina;Sordariomycetes;Hypocreales;Clavicipitaceae;Pochonia;";"0.0";"0";"2";"2";"0";"2";"0";"457181";"373894"
"V4mis1";"SILVA (only NR);Eukaryota;Amorphea;Obazoa;Opisthokonta;Nucletmycea;Fungi;Dikarya;Ascomycota;Pezizomycotina;Sordariomycetes;Hypocreales;Clavicipitaceae;Torrubiella;";"0.0";"0";"1";"1";"0";"1";"0";"457182";"373894"
"V4mis1";"SILVA (only NR);Eukaryota;Amorphea;Obazoa;Opisthokonta;Nucletmycea;Fungi;Dikarya;Ascomycota;Pezizomycotina;Sordariomycetes;Hypocreales;Cordycipitaceae;";"0.0";"0";"95";"95";"0";"95";"0";"457088";"373894"
"V4mis1";"SILVA (only NR);Eukaryota;Amorphea;Obazoa;Opisthokonta;Nucletmycea;Fungi;Dikarya;Ascomycota;Pezizomycotina;Sordariomycetes;Hypocreales;Cordycipitaceae;Akanthomyces;";"0.0";"0";"1";"1";"0";"1";"0";"457182";"373894"
"V4mis1";"SILVA (only NR);Eukaryota;Amorphea;Obazoa;Opisthokonta;Nucletmycea;Fungi;Dikarya;Ascomycota;Pezizomycotina;Sordariomycetes;Hypocreales;Cordycipitaceae;Beauveria;";"0.0";"0";"15";"15";"0";"15";"0";"457168";"373894"
"V4mis1";"SILVA (only NR);Eukaryota;Amorphea;Obazoa;Opisthokonta;Nucletmycea;Fungi;Dikarya;Ascomycota;Pezizomycotina;Sordariomycetes;Hypocreales;Cordycipitaceae;Blackwellomyces;";"0.0";"0";"1";"1";"0";"1";"0";"457182";"373894"
"V4mis1";"SILVA (only NR);Eukaryota;Amorphea;Obazoa;Opisthokonta;Nucletmycea;Fungi;Dikarya;Ascomycota;Pezizomycotina;Sordariomycetes;Hypocreales;Cordycipitaceae;Cordyceps;";"0.0";"0";"43";"43";"0";"43";"0";"457140";"373894"
"V4mis1";"SILVA (only NR);Eukaryota;Amorphea;Obazoa;Opisthokonta;Nucletmycea;Fungi;Dikarya;Ascomycota;Pezizomycotina;Sordariomycetes;Hypocreales;Cordycipitaceae;Gibellula;";"0.0";"0";"1";"1";"0";"1";"0";"457182";"373894"
"V4mis1";"SILVA (only NR);Eukaryota;Amorphea;Obazoa;Opisthokonta;Nucletmycea;Fungi;Dikarya;Ascomycota;Pezizomycotina;Sordariomycetes;Hypocreales;Cordycipitaceae;Hevansia;";"0.0";"0";"1";"1";"0";"1";"0";"457182";"373894"
"V4mis1";"SILVA (only NR);Eukaryota;Amorphea;Obazoa;Opisthokonta;Nucletmycea;Fungi;Dikarya;Ascomycota;Pezizomycotina;Sordariomycetes;Hypocreales;Cordycipitaceae;Isaria;";"0.0";"0";"16";"16";"0";"16";"0";"457167";"373894"
"V4mis1";"SILVA (only NR);Eukaryota;Amorphea;Obazoa;Opisthokonta;Nucletmycea;Fungi;Dikarya;Ascomycota;Pezizomycotina;Sordariomycetes;Hypocreales;Cordycipitaceae;Lecanicillium;";"0.0";"0";"5";"5";"0";"5";"0";"457178";"373894"
"V4mis1";"SILVA (only NR);Eukaryota;Amorphea;Obazoa;Opisthokonta;Nucletmycea;Fungi;Dikarya;Ascomycota;Pezizomycotina;Sordariomycetes;Hypocreales;Cordycipitaceae;Parengyodontium;";"0.0";"0";"4";"4";"0";"4";"0";"457179";"373894"
"V4mis1";"SILVA (only NR);Eukaryota;Amorphea;Obazoa;Opisthokonta;Nucletmycea;Fungi;Dikarya;Ascomycota;Pezizomycotina;Sordariomycetes;Hypocreales;Cordycipitaceae;Simplicillium;";"0.0";"0";"3";"3";"0";"3";"0";"457180";"373894"
"V4mis1";"SILVA (only NR);Eukaryota;Amorphea;Obazoa;Opisthokonta;Nucletmycea;Fungi;Dikarya;Ascomycota;Pezizomycotina;Sordariomycetes;Hypocreales;Drechmeria;";"0.0";"0";"1";"1";"0";"1";"0";"457182";"373894"
"V4mis1";"SILVA (only NR);Eukaryota;Amorphea;Obazoa;Opisthokonta;Nucletmycea;Fungi;Dikarya;Ascomycota;Pezizomycotina;Sordariomycetes;Hypocreales;Hypocreaceae;";"0.0";"0";"30";"30";"0";"30";"0";"457153";"373894"
"V4mis1";"SILVA (only NR);Eukaryota;Amorphea;Obazoa;Opisthokonta;Nucletmycea;Fungi;Dikarya;Ascomycota;Pezizomycotina;Sordariomycetes;Hypocreales;Hypocreaceae;Trichoderma;";"0.0";"0";"30";"30";"0";"30";"0";"457153";"373894"
"V4mis1";"SILVA (only NR);Eukaryota;Amorphea;Obazoa;Opisthokonta;Nucletmycea;Fungi;Dikarya;Ascomycota;Pezizomycotina;Sordariomycetes;Hypocreales;Incertae Sedis;";"0.0";"0";"50";"50";"0";"50";"0";"457133";"373894"
"V4mis1";"SILVA (only NR);Eukaryota;Amorphea;Obazoa;Opisthokonta;Nucletmycea;Fungi;Dikarya;Ascomycota;Pezizomycotina;Sordariomycetes;Hypocreales;Incertae Sedis;Acremonium;";"0.0";"0";"31";"31";"0";"31";"0";"457152";"373894"
"V4mis1";"SILVA (only NR);Eukaryota;Amorphea;Obazoa;Opisthokonta;Nucletmycea;Fungi;Dikarya;Ascomycota;Pezizomycotina;Sordariomycetes;Hypocreales;Incertae Sedis;Emericellopsis;";"0.0";"0";"1";"1";"0";"1";"0";"457182";"373894"
"V4mis1";"SILVA (only NR);Eukaryota;Amorphea;Obazoa;Opisthokonta;Nucletmycea;Fungi;Dikarya;Ascomycota;Pezizomycotina;Sordariomycetes;Hypocreales;Incertae Sedis;Sarocladium;";"0.0";"0";"14";"14";"0";"14";"0";"457169";"373894"
"V4mis1";"SILVA (only NR);Eukaryota;Amorphea;Obazoa;Opisthokonta;Nucletmycea;Fungi;Dikarya;Ascomycota;Pezizomycotina;Sordariomycetes;Hypocreales;Incertae Sedis;Trichothecium;";"0.0";"0";"2";"2";"0";"2";"0";"457181";"373894"
"V4mis1";"SILVA (only NR);Eukaryota;Amorphea;Obazoa;Opisthokonta;Nucletmycea;Fungi;Dikarya;Ascomycota;Pezizomycotina;Sordariomycetes;Hypocreales;Juncigena;";"0.0";"0";"1";"1";"0";"1";"0";"457182";"373894"
"V4mis1";"SILVA (only NR);Eukaryota;Amorphea;Obazoa;Opisthokonta;Nucletmycea;Fungi;Dikarya;Ascomycota;Pezizomycotina;Sordariomycetes;Hypocreales;Nectriaceae;";"0.0";"0";"71";"71";"0";"71";"0";"457112";"373894"
"V4mis1";"SILVA (only NR);Eukaryota;Amorphea;Obazoa;Opisthokonta;Nucletmycea;Fungi;Dikarya;Ascomycota;Pezizomycotina;Sordariomycetes;Hypocreales;Nectriaceae;Chaetopsina;";"0.0";"0";"1";"1";"0";"1";"0";"457182";"373894"
"V4mis1";"SILVA (only NR);Eukaryota;Amorphea;Obazoa;Opisthokonta;Nucletmycea;Fungi;Dikarya;Ascomycota;Pezizomycotina;Sordariomycetes;Hypocreales;Nectriaceae;Fusarium;";"0.0";"0";"57";"57";"0";"57";"0";"457126";"373894"
"V4mis1";"SILVA (only NR);Eukaryota;Amorphea;Obazoa;Opisthokonta;Nucletmycea;Fungi;Dikarya;Ascomycota;Pezizomycotina;Sordariomycetes;Hypocreales;Nectriaceae;Mariannaea;";"0.0";"0";"5";"5";"0";"5";"0";"457178";"373894"
"V4mis1";"SILVA (only NR);Eukaryota;Amorphea;Obazoa;Opisthokonta;Nucletmycea;Fungi;Dikarya;Ascomycota;Pezizomycotina;Sordariomycetes;Hypocreales;Nectriaceae;Nectria;";"0.0";"0";"5";"5";"0";"5";"0";"457178";"373894"
"V4mis1";"SILVA (only NR);Eukaryota;Amorphea;Obazoa;Opisthokonta;Nucletmycea;Fungi;Dikarya;Ascomycota;Pezizomycotina;Sordariomycetes;Hypocreales;Nectriaceae;Neonectria;";"0.0";"0";"2";"2";"0";"2";"0";"457181";"373894"
"V4mis1";"SILVA (only NR);Eukaryota;Amorphea;Obazoa;Opisthokonta;Nucletmycea;Fungi;Dikarya;Ascomycota;Pezizomycotina;Sordariomycetes;Hypocreales;Nectriaceae;Xenoacremonium;";"0.0";"0";"1";"1";"0";"1";"0";"457182";"373894"
"V4mis1";"SILVA (only NR);Eukaryota;Amorphea;Obazoa;Opisthokonta;Nucletmycea;Fungi;Dikarya;Ascomycota;Pezizomycotina;Sordariomycetes;Hypocreales;Nectriopsis;";"0.0";"0";"1";"1";"0";"1";"0";"457182";"373894"
"V4mis1";"SILVA (only NR);Eukaryota;Amorphea;Obazoa;Opisthokonta;Nucletmycea;Fungi;Dikarya;Ascomycota;Pezizomycotina;Sordariomycetes;Hypocreales;Niesslia;";"0.0";"0";"2";"2";"0";"2";"0";"457181";"373894"
"V4mis1";"SILVA (only NR);Eukaryota;Amorphea;Obazoa;Opisthokonta;Nucletmycea;Fungi;Dikarya;Ascomycota;Pezizomycotina;Sordariomycetes;Hypocreales;Ophiocordycipitaceae;";"0.0";"0";"81";"81";"0";"81";"0";"457102";"373894"
"V4mis1";"SILVA (only NR);Eukaryota;Amorphea;Obazoa;Opisthokonta;Nucletmycea;Fungi;Dikarya;Ascomycota;Pezizomycotina;Sordariomycetes;Hypocreales;Ophiocordycipitaceae;Hirsutella;";"0.0";"0";"4";"4";"0";"4";"0";"457179";"373894"
"V4mis1";"SILVA (only NR);Eukaryota;Amorphea;Obazoa;Opisthokonta;Nucletmycea;Fungi;Dikarya;Ascomycota;Pezizomycotina;Sordariomycetes;Hypocreales;Ophiocordycipitaceae;Hymenostilbe;";"0.0";"0";"1";"1";"0";"1";"0";"457182";"373894"
"V4mis1";"SILVA (only NR);Eukaryota;Amorphea;Obazoa;Opisthokonta;Nucletmycea;Fungi;Dikarya;Ascomycota;Pezizomycotina;Sordariomycetes;Hypocreales;Ophiocordycipitaceae;Ophiocordyceps;";"0.0";"0";"42";"42";"0";"42";"0";"457141";"373894"
"V4mis1";"SILVA (only NR);Eukaryota;Amorphea;Obazoa;Opisthokonta;Nucletmycea;Fungi;Dikarya;Ascomycota;Pezizomycotina;Sordariomycetes;Hypocreales;Ophiocordycipitaceae;Polycephalomyces;";"0.0";"0";"5";"5";"0";"5";"0";"457178";"373894"
"V4mis1";"SILVA (only NR);Eukaryota;Amorphea;Obazoa;Opisthokonta;Nucletmycea;Fungi;Dikarya;Ascomycota;Pezizomycotina;Sordariomycetes;Hypocreales;Ophiocordycipitaceae;Purpureocillium;";"0.0";"0";"4";"4";"0";"4";"0";"457179";"373894"
"V4mis1";"SILVA (only NR);Eukaryota;Amorphea;Obazoa;Opisthokonta;Nucletmycea;Fungi;Dikarya;Ascomycota;Pezizomycotina;Sordariomycetes;Hypocreales;Ophiocordycipitaceae;Tolypocladium;";"0.0";"0";"19";"19";"0";"19";"0";"457164";"373894"
"V4mis1";"SILVA (only NR);Eukaryota;Amorphea;Obazoa;Opisthokonta;Nucletmycea;Fungi;Dikarya;Ascomycota;Pezizomycotina;Sordariomycetes;Hypocreales;Septofusidium;";"0.0";"0";"1";"1";"0";"1";"0";"457182";"373894"
"V4mis1";"SILVA (only NR);Eukaryota;Amorphea;Obazoa;Opisthokonta;Nucletmycea;Fungi;Dikarya;Ascomycota;Pezizomycotina;Sordariomycetes;Hypocreales;Stachybotryaceae;";"0.0";"0";"32";"32";"0";"32";"0";"457151";"373894"
"V4mis1";"SILVA (only NR);Eukaryota;Amorphea;Obazoa;Opisthokonta;Nucletmycea;Fungi;Dikarya;Ascomycota;Pezizomycotina;Sordariomycetes;Hypocreales;Stachybotryaceae;Melanopsamma;";"0.0";"0";"2";"2";"0";"2";"0";"457181";"373894"
"V4mis1";"SILVA (only NR);Eukaryota;Amorphea;Obazoa;Opisthokonta;Nucletmycea;Fungi;Dikarya;Ascomycota;Pezizomycotina;Sordariomycetes;Hypocreales;Stachybotryaceae;Myrothecium;";"0.0";"0";"15";"15";"0";"15";"0";"457168";"373894"
"V4mis1";"SILVA (only NR);Eukaryota;Amorphea;Obazoa;Opisthokonta;Nucletmycea;Fungi;Dikarya;Ascomycota;Pezizomycotina;Sordariomycetes;Hypocreales;Stachybotryaceae;Paramyrothecium;";"0.0";"0";"1";"1";"0";"1";"0";"457182";"373894"
"V4mis1";"SILVA (only NR);Eukaryota;Amorphea;Obazoa;Opisthokonta;Nucletmycea;Fungi;Dikarya;Ascomycota;Pezizomycotina;Sordariomycetes;Hypocreales;Stachybotryaceae;Stachybotrys;";"0.0";"0";"12";"12";"0";"12";"0";"457171";"373894"
"V4mis1";"SILVA (only NR);Eukaryota;Amorphea;Obazoa;Opisthokonta;Nucletmycea;Fungi;Dikarya;Ascomycota;Pezizomycotina;Sordariomycetes;Hypocreales;Stachybotryaceae;Virgatospora;";"0.0";"0";"1";"1";"0";"1";"0";"457182";"373894"
"V4mis1";"SILVA (only NR);Eukaryota;Amorphea;Obazoa;Opisthokonta;Nucletmycea;Fungi;Dikarya;Ascomycota;Pezizomycotina;Sordariomycetes;Hypocreales;Stachybotryaceae;Xepicula;";"0.0";"0";"1";"1";"0";"1";"0";"457182";"373894"
"V4mis1";"SILVA (only NR);Eukaryota;Amorphea;Obazoa;Opisthokonta;Nucletmycea;Fungi;Dikarya;Ascomycota;Pezizomycotina;Sordariomycetes;Hypocreales;Ustilaginoidea;";"0.0";"0";"3";"3";"0";"3";"0";"457180";"373894"
"V4mis1";"SILVA (only NR);Eukaryota;Amorphea;Obazoa;Opisthokonta;Nucletmycea;Fungi;Dikarya;Ascomycota;Pezizomycotina;Sordariomycetes;Hypocreales;uncultured;";"0.0";"0";"2";"2";"0";"2";"0";"457181";"373894"
"V4mis1";"SILVA (only NR);Eukaryota;Amorphea;Obazoa;Opisthokonta;Nucletmycea;Fungi;Dikarya;Ascomycota;Pezizomycotina;Sordariomycetes;Incertae Sedis;";"0.0";"0";"37";"37";"0";"37";"0";"457146";"373894"
"V4mis1";"SILVA (only NR);Eukaryota;Amorphea;Obazoa;Opisthokonta;Nucletmycea;Fungi;Dikarya;Ascomycota;Pezizomycotina;Sordariomycetes;Incertae Sedis;Calcarisporium;";"0.0";"0";"2";"2";"0";"2";"0";"457181";"373894"
"V4mis1";"SILVA (only NR);Eukaryota;Amorphea;Obazoa;Opisthokonta;Nucletmycea;Fungi;Dikarya;Ascomycota;Pezizomycotina;Sordariomycetes;Incertae Sedis;Etheirophoraceae;";"0.0";"0";"1";"1";"0";"1";"0";"457182";"373894"
"V4mis1";"SILVA (only NR);Eukaryota;Amorphea;Obazoa;Opisthokonta;Nucletmycea;Fungi;Dikarya;Ascomycota;Pezizomycotina;Sordariomycetes;Incertae Sedis;Etheirophoraceae;Etheirophora;";"0.0";"0";"1";"1";"0";"1";"0";"457182";"373894"
"V4mis1";"SILVA (only NR);Eukaryota;Amorphea;Obazoa;Opisthokonta;Nucletmycea;Fungi;Dikarya;Ascomycota;Pezizomycotina;Sordariomycetes;Incertae Sedis;Incertae Sedis;";"0.0";"0";"27";"27";"0";"27";"0";"457156";"373894"
"V4mis1";"SILVA (only NR);Eukaryota;Amorphea;Obazoa;Opisthokonta;Nucletmycea;Fungi;Dikarya;Ascomycota;Pezizomycotina;Sordariomycetes;Incertae Sedis;Incertae Sedis;Asteroma;";"0.0";"0";"1";"1";"0";"1";"0";"457182";"373894"
"V4mis1";"SILVA (only NR);Eukaryota;Amorphea;Obazoa;Opisthokonta;Nucletmycea;Fungi;Dikarya;Ascomycota;Pezizomycotina;Sordariomycetes;Incertae Sedis;Incertae Sedis;Atractospora;";"0.0";"0";"1";"1";"0";"1";"0";"457182";"373894"
"V4mis1";"SILVA (only NR);Eukaryota;Amorphea;Obazoa;Opisthokonta;Nucletmycea;Fungi;Dikarya;Ascomycota;Pezizomycotina;Sordariomycetes;Incertae Sedis;Incertae Sedis;Bahusakala;";"0.0";"0";"1";"1";"0";"1";"0";"457182";"373894"
"V4mis1";"SILVA (only NR);Eukaryota;Amorphea;Obazoa;Opisthokonta;Nucletmycea;Fungi;Dikarya;Ascomycota;Pezizomycotina;Sordariomycetes;Incertae Sedis;Incertae Sedis;Barbatosphaeria;";"0.0";"0";"2";"2";"0";"2";"0";"457181";"373894"
"V4mis1";"SILVA (only NR);Eukaryota;Amorphea;Obazoa;Opisthokonta;Nucletmycea;Fungi;Dikarya;Ascomycota;Pezizomycotina;Sordariomycetes;Incertae Sedis;Incertae Sedis;Canalisporium;";"0.0";"0";"2";"2";"0";"2";"0";"457181";"373894"
"V4mis1";"SILVA (only NR);Eukaryota;Amorphea;Obazoa;Opisthokonta;Nucletmycea;Fungi;Dikarya;Ascomycota;Pezizomycotina;Sordariomycetes;Incertae Sedis;Incertae Sedis;Ceratolenta;";"0.0";"0";"1";"1";"0";"1";"0";"457182";"373894"
"V4mis1";"SILVA (only NR);Eukaryota;Amorphea;Obazoa;Opisthokonta;Nucletmycea;Fungi;Dikarya;Ascomycota;Pezizomycotina;Sordariomycetes;Incertae Sedis;Incertae Sedis;Ceratostomella;";"0.0";"0";"2";"2";"0";"2";"0";"457181";"373894"
"V4mis1";"SILVA (only NR);Eukaryota;Amorphea;Obazoa;Opisthokonta;Nucletmycea;Fungi;Dikarya;Ascomycota;Pezizomycotina;Sordariomycetes;Incertae Sedis;Incertae Sedis;Flammispora;";"0.0";"0";"2";"2";"0";"2";"0";"457181";"373894"
"V4mis1";"SILVA (only NR);Eukaryota;Amorphea;Obazoa;Opisthokonta;Nucletmycea;Fungi;Dikarya;Ascomycota;Pezizomycotina;Sordariomycetes;Incertae Sedis;Incertae Sedis;Infundibulomyces;";"0.0";"0";"2";"2";"0";"2";"0";"457181";"373894"
"V4mis1";"SILVA (only NR);Eukaryota;Amorphea;Obazoa;Opisthokonta;Nucletmycea;Fungi;Dikarya;Ascomycota;Pezizomycotina;Sordariomycetes;Incertae Sedis;Incertae Sedis;Lentomitella;";"0.0";"0";"2";"2";"0";"2";"0";"457181";"373894"
"V4mis1";"SILVA (only NR);Eukaryota;Amorphea;Obazoa;Opisthokonta;Nucletmycea;Fungi;Dikarya;Ascomycota;Pezizomycotina;Sordariomycetes;Incertae Sedis;Incertae Sedis;Lunulospora;";"0.0";"0";"1";"1";"0";"1";"0";"457182";"373894"
"V4mis1";"SILVA (only NR);Eukaryota;Amorphea;Obazoa;Opisthokonta;Nucletmycea;Fungi;Dikarya;Ascomycota;Pezizomycotina;Sordariomycetes;Incertae Sedis;Incertae Sedis;Orbimyces;";"0.0";"0";"1";"1";"0";"1";"0";"457182";"373894"
"V4mis1";"SILVA (only NR);Eukaryota;Amorphea;Obazoa;Opisthokonta;Nucletmycea;Fungi;Dikarya;Ascomycota;Pezizomycotina;Sordariomycetes;Incertae Sedis;Incertae Sedis;Platytrachelon;";"0.0";"0";"1";"1";"0";"1";"0";"457182";"373894"
"V4mis1";"SILVA (only NR);Eukaryota;Amorphea;Obazoa;Opisthokonta;Nucletmycea;Fungi;Dikarya;Ascomycota;Pezizomycotina;Sordariomycetes;Incertae Sedis;Incertae Sedis;Rhodoveronaea;";"0.0";"0";"1";"1";"0";"1";"0";"457182";"373894"
"V4mis1";"SILVA (only NR);Eukaryota;Amorphea;Obazoa;Opisthokonta;Nucletmycea;Fungi;Dikarya;Ascomycota;Pezizomycotina;Sordariomycetes;Incertae Sedis;Incertae Sedis;Rubellisphaeria;";"0.0";"0";"1";"1";"0";"1";"0";"457182";"373894"
"V4mis1";"SILVA (only NR);Eukaryota;Amorphea;Obazoa;Opisthokonta;Nucletmycea;Fungi;Dikarya;Ascomycota;Pezizomycotina;Sordariomycetes;Incertae Sedis;Incertae Sedis;Woswasia;";"0.0";"0";"1";"1";"0";"1";"0";"457182";"373894"
"V4mis1";"SILVA (only NR);Eukaryota;Amorphea;Obazoa;Opisthokonta;Nucletmycea;Fungi;Dikarya;Ascomycota;Pezizomycotina;Sordariomycetes;Incertae Sedis;Incertae Sedis;Xylochrysis;";"0.0";"0";"1";"1";"0";"1";"0";"457182";"373894"
"V4mis1";"SILVA (only NR);Eukaryota;Amorphea;Obazoa;Opisthokonta;Nucletmycea;Fungi;Dikarya;Ascomycota;Pezizomycotina;Sordariomycetes;Incertae Sedis;Incertae Sedis;Xylomelasma;";"0.0";"0";"3";"3";"0";"3";"0";"457180";"373894"
"V4mis1";"SILVA (only NR);Eukaryota;Amorphea;Obazoa;Opisthokonta;Nucletmycea;Fungi;Dikarya;Ascomycota;Pezizomycotina;Sordariomycetes;Incertae Sedis;Papulosaceae;";"0.0";"0";"2";"2";"0";"2";"0";"457181";"373894"
"V4mis1";"SILVA (only NR);Eukaryota;Amorphea;Obazoa;Opisthokonta;Nucletmycea;Fungi;Dikarya;Ascomycota;Pezizomycotina;Sordariomycetes;Incertae Sedis;Papulosaceae;Papulosa;";"0.0";"0";"2";"2";"0";"2";"0";"457181";"373894"
"V4mis1";"SILVA (only NR);Eukaryota;Amorphea;Obazoa;Opisthokonta;Nucletmycea;Fungi;Dikarya;Ascomycota;Pezizomycotina;Sordariomycetes;Incertae Sedis;Thyridiaceae;";"0.0";"0";"1";"1";"0";"1";"0";"457182";"373894"
"V4mis1";"SILVA (only NR);Eukaryota;Amorphea;Obazoa;Opisthokonta;Nucletmycea;Fungi;Dikarya;Ascomycota;Pezizomycotina;Sordariomycetes;Incertae Sedis;Thyridiaceae;Thyridium;";"0.0";"0";"1";"1";"0";"1";"0";"457182";"373894"
"V4mis1";"SILVA (only NR);Eukaryota;Amorphea;Obazoa;Opisthokonta;Nucletmycea;Fungi;Dikarya;Ascomycota;Pezizomycotina;Sordariomycetes;Lulworthiales;";"0.0";"0";"23";"23";"0";"23";"0";"457160";"373894"
"V4mis1";"SILVA (only NR);Eukaryota;Amorphea;Obazoa;Opisthokonta;Nucletmycea;Fungi;Dikarya;Ascomycota;Pezizomycotina;Sordariomycetes;Lulworthiales;Lulworthiaceae;";"0.0";"0";"21";"21";"0";"21";"0";"457162";"373894"
"V4mis1";"SILVA (only NR);Eukaryota;Amorphea;Obazoa;Opisthokonta;Nucletmycea;Fungi;Dikarya;Ascomycota;Pezizomycotina;Sordariomycetes;Lulworthiales;Lulworthiaceae;Kohlmeyeriella;";"0.0";"0";"2";"2";"0";"2";"0";"457181";"373894"
"V4mis1";"SILVA (only NR);Eukaryota;Amorphea;Obazoa;Opisthokonta;Nucletmycea;Fungi;Dikarya;Ascomycota;Pezizomycotina;Sordariomycetes;Lulworthiales;Lulworthiaceae;Lindra;";"0.0";"0";"4";"4";"0";"4";"0";"457179";"373894"
"V4mis1";"SILVA (only NR);Eukaryota;Amorphea;Obazoa;Opisthokonta;Nucletmycea;Fungi;Dikarya;Ascomycota;Pezizomycotina;Sordariomycetes;Lulworthiales;Lulworthiaceae;Lulwoana;";"0.0";"0";"2";"2";"0";"2";"0";"457181";"373894"
"V4mis1";"SILVA (only NR);Eukaryota;Amorphea;Obazoa;Opisthokonta;Nucletmycea;Fungi;Dikarya;Ascomycota;Pezizomycotina;Sordariomycetes;Lulworthiales;Lulworthiaceae;Lulwoidea;";"0.0";"0";"3";"3";"0";"3";"0";"457180";"373894"
"V4mis1";"SILVA (only NR);Eukaryota;Amorphea;Obazoa;Opisthokonta;Nucletmycea;Fungi;Dikarya;Ascomycota;Pezizomycotina;Sordariomycetes;Lulworthiales;Lulworthiaceae;Lulworthia;";"0.0";"0";"8";"8";"0";"8";"0";"457175";"373894"
"V4mis1";"SILVA (only NR);Eukaryota;Amorphea;Obazoa;Opisthokonta;Nucletmycea;Fungi;Dikarya;Ascomycota;Pezizomycotina;Sordariomycetes;Lulworthiales;Spathulosporaceae;";"0.0";"0";"2";"2";"0";"2";"0";"457181";"373894"
"V4mis1";"SILVA (only NR);Eukaryota;Amorphea;Obazoa;Opisthokonta;Nucletmycea;Fungi;Dikarya;Ascomycota;Pezizomycotina;Sordariomycetes;Lulworthiales;Spathulosporaceae;Spathulospora;";"0.0";"0";"2";"2";"0";"2";"0";"457181";"373894"
"V4mis1";"SILVA (only NR);Eukaryota;Amorphea;Obazoa;Opisthokonta;Nucletmycea;Fungi;Dikarya;Ascomycota;Pezizomycotina;Sordariomycetes;Magnaporthales;";"0.0";"0";"6";"6";"0";"6";"0";"457177";"373894"
"V4mis1";"SILVA (only NR);Eukaryota;Amorphea;Obazoa;Opisthokonta;Nucletmycea;Fungi;Dikarya;Ascomycota;Pezizomycotina;Sordariomycetes;Magnaporthales;Magnaporthaceae;";"0.0";"0";"6";"6";"0";"6";"0";"457177";"373894"
"V4mis1";"SILVA (only NR);Eukaryota;Amorphea;Obazoa;Opisthokonta;Nucletmycea;Fungi;Dikarya;Ascomycota;Pezizomycotina;Sordariomycetes;Magnaporthales;Magnaporthaceae;Ceratosphaeria;";"0.0";"0";"1";"1";"0";"1";"0";"457182";"373894"
"V4mis1";"SILVA (only NR);Eukaryota;Amorphea;Obazoa;Opisthokonta;Nucletmycea;Fungi;Dikarya;Ascomycota;Pezizomycotina;Sordariomycetes;Magnaporthales;Magnaporthaceae;Kohlmeyeriopsis;";"0.0";"0";"1";"1";"0";"1";"0";"457182";"373894"
"V4mis1";"SILVA (only NR);Eukaryota;Amorphea;Obazoa;Opisthokonta;Nucletmycea;Fungi;Dikarya;Ascomycota;Pezizomycotina;Sordariomycetes;Magnaporthales;Magnaporthaceae;Magnaporthe;";"0.0";"0";"1";"1";"0";"1";"0";"457182";"373894"
"V4mis1";"SILVA (only NR);Eukaryota;Amorphea;Obazoa;Opisthokonta;Nucletmycea;Fungi;Dikarya;Ascomycota;Pezizomycotina;Sordariomycetes;Magnaporthales;Magnaporthaceae;Ophioceras;";"0.0";"0";"1";"1";"0";"1";"0";"457182";"373894"
"V4mis1";"SILVA (only NR);Eukaryota;Amorphea;Obazoa;Opisthokonta;Nucletmycea;Fungi;Dikarya;Ascomycota;Pezizomycotina;Sordariomycetes;Magnaporthales;Magnaporthaceae;Pseudohalonectria;";"0.0";"0";"1";"1";"0";"1";"0";"457182";"373894"
"V4mis1";"SILVA (only NR);Eukaryota;Amorphea;Obazoa;Opisthokonta;Nucletmycea;Fungi;Dikarya;Ascomycota;Pezizomycotina;Sordariomycetes;Meliolales;";"0.0";"0";"2";"2";"0";"2";"0";"457181";"373894"
"V4mis1";"SILVA (only NR);Eukaryota;Amorphea;Obazoa;Opisthokonta;Nucletmycea;Fungi;Dikarya;Ascomycota;Pezizomycotina;Sordariomycetes;Meliolales;Meliolaceae;";"0.0";"0";"2";"2";"0";"2";"0";"457181";"373894"
"V4mis1";"SILVA (only NR);Eukaryota;Amorphea;Obazoa;Opisthokonta;Nucletmycea;Fungi;Dikarya;Ascomycota;Pezizomycotina;Sordariomycetes;Meliolales;Meliolaceae;Meliola;";"0.0";"0";"2";"2";"0";"2";"0";"457181";"373894"
"V4mis1";"SILVA (only NR);Eukaryota;Amorphea;Obazoa;Opisthokonta;Nucletmycea;Fungi;Dikarya;Ascomycota;Pezizomycotina;Sordariomycetes;Microascales;";"0.0";"0";"83";"83";"0";"83";"0";"457100";"373894"
"V4mis1";"SILVA (only NR);Eukaryota;Amorphea;Obazoa;Opisthokonta;Nucletmycea;Fungi;Dikarya;Ascomycota;Pezizomycotina;Sordariomycetes;Microascales;Cephalotrichiella;";"0.0";"0";"1";"1";"0";"1";"0";"457182";"373894"
"V4mis1";"SILVA (only NR);Eukaryota;Amorphea;Obazoa;Opisthokonta;Nucletmycea;Fungi;Dikarya;Ascomycota;Pezizomycotina;Sordariomycetes;Microascales;Ceratocystidaceae;";"0.0";"0";"6";"6";"0";"6";"0";"457177";"373894"
"V4mis1";"SILVA (only NR);Eukaryota;Amorphea;Obazoa;Opisthokonta;Nucletmycea;Fungi;Dikarya;Ascomycota;Pezizomycotina;Sordariomycetes;Microascales;Ceratocystidaceae;Ambrosiella;";"0.0";"0";"2";"2";"0";"2";"0";"457181";"373894"
"V4mis1";"SILVA (only NR);Eukaryota;Amorphea;Obazoa;Opisthokonta;Nucletmycea;Fungi;Dikarya;Ascomycota;Pezizomycotina;Sordariomycetes;Microascales;Ceratocystidaceae;Ceratocystis;";"0.0";"0";"1";"1";"0";"1";"0";"457182";"373894"
"V4mis1";"SILVA (only NR);Eukaryota;Amorphea;Obazoa;Opisthokonta;Nucletmycea;Fungi;Dikarya;Ascomycota;Pezizomycotina;Sordariomycetes;Microascales;Ceratocystidaceae;Huntiella;";"0.0";"0";"1";"1";"0";"1";"0";"457182";"373894"
"V4mis1";"SILVA (only NR);Eukaryota;Amorphea;Obazoa;Opisthokonta;Nucletmycea;Fungi;Dikarya;Ascomycota;Pezizomycotina;Sordariomycetes;Microascales;Ceratocystidaceae;Phialophoropsis;";"0.0";"0";"1";"1";"0";"1";"0";"457182";"373894"
"V4mis1";"SILVA (only NR);Eukaryota;Amorphea;Obazoa;Opisthokonta;Nucletmycea;Fungi;Dikarya;Ascomycota;Pezizomycotina;Sordariomycetes;Microascales;Graphiaceae;";"0.0";"0";"14";"14";"0";"14";"0";"457169";"373894"
"V4mis1";"SILVA (only NR);Eukaryota;Amorphea;Obazoa;Opisthokonta;Nucletmycea;Fungi;Dikarya;Ascomycota;Pezizomycotina;Sordariomycetes;Microascales;Graphiaceae;Graphium;";"0.0";"0";"14";"14";"0";"14";"0";"457169";"373894"
"V4mis1";"SILVA (only NR);Eukaryota;Amorphea;Obazoa;Opisthokonta;Nucletmycea;Fungi;Dikarya;Ascomycota;Pezizomycotina;Sordariomycetes;Microascales;Halosphaeriaceae;";"0.0";"0";"32";"32";"0";"32";"0";"457151";"373894"
"V4mis1";"SILVA (only NR);Eukaryota;Amorphea;Obazoa;Opisthokonta;Nucletmycea;Fungi;Dikarya;Ascomycota;Pezizomycotina;Sordariomycetes;Microascales;Halosphaeriaceae;Cirrenalia;";"0.0";"0";"2";"2";"0";"2";"0";"457181";"373894"
"V4mis1";"SILVA (only NR);Eukaryota;Amorphea;Obazoa;Opisthokonta;Nucletmycea;Fungi;Dikarya;Ascomycota;Pezizomycotina;Sordariomycetes;Microascales;Halosphaeriaceae;Corollospora;";"0.0";"0";"12";"12";"0";"12";"0";"457171";"373894"
"V4mis1";"SILVA (only NR);Eukaryota;Amorphea;Obazoa;Opisthokonta;Nucletmycea;Fungi;Dikarya;Ascomycota;Pezizomycotina;Sordariomycetes;Microascales;Halosphaeriaceae;Halosarpheia;";"0.0";"0";"1";"1";"0";"1";"0";"457182";"373894"
"V4mis1";"SILVA (only NR);Eukaryota;Amorphea;Obazoa;Opisthokonta;Nucletmycea;Fungi;Dikarya;Ascomycota;Pezizomycotina;Sordariomycetes;Microascales;Halosphaeriaceae;Lignincola;";"0.0";"0";"1";"1";"0";"1";"0";"457182";"373894"
"V4mis1";"SILVA (only NR);Eukaryota;Amorphea;Obazoa;Opisthokonta;Nucletmycea;Fungi;Dikarya;Ascomycota;Pezizomycotina;Sordariomycetes;Microascales;Halosphaeriaceae;Magnisphaera;";"0.0";"0";"1";"1";"0";"1";"0";"457182";"373894"
"V4mis1";"SILVA (only NR);Eukaryota;Amorphea;Obazoa;Opisthokonta;Nucletmycea;Fungi;Dikarya;Ascomycota;Pezizomycotina;Sordariomycetes;Microascales;Halosphaeriaceae;Natantispora;";"0.0";"0";"3";"3";"0";"3";"0";"457180";"373894"
"V4mis1";"SILVA (only NR);Eukaryota;Amorphea;Obazoa;Opisthokonta;Nucletmycea;Fungi;Dikarya;Ascomycota;Pezizomycotina;Sordariomycetes;Microascales;Halosphaeriaceae;Oceanitis;";"0.0";"0";"1";"1";"0";"1";"0";"457182";"373894"
"V4mis1";"SILVA (only NR);Eukaryota;Amorphea;Obazoa;Opisthokonta;Nucletmycea;Fungi;Dikarya;Ascomycota;Pezizomycotina;Sordariomycetes;Microascales;Halosphaeriaceae;Panorbis;";"0.0";"0";"2";"2";"0";"2";"0";"457181";"373894"
"V4mis1";"SILVA (only NR);Eukaryota;Amorphea;Obazoa;Opisthokonta;Nucletmycea;Fungi;Dikarya;Ascomycota;Pezizomycotina;Sordariomycetes;Microascales;Halosphaeriaceae;Phaeonectriella;";"0.0";"0";"1";"1";"0";"1";"0";"457182";"373894"
"V4mis1";"SILVA (only NR);Eukaryota;Amorphea;Obazoa;Opisthokonta;Nucletmycea;Fungi;Dikarya;Ascomycota;Pezizomycotina;Sordariomycetes;Microascales;Halosphaeriaceae;Sigmoidea;";"0.0";"0";"1";"1";"0";"1";"0";"457182";"373894"
"V4mis1";"SILVA (only NR);Eukaryota;Amorphea;Obazoa;Opisthokonta;Nucletmycea;Fungi;Dikarya;Ascomycota;Pezizomycotina;Sordariomycetes;Microascales;Halosphaeriaceae;Trichocladium;";"0.0";"0";"1";"1";"0";"1";"0";"457182";"373894"
"V4mis1";"SILVA (only NR);Eukaryota;Amorphea;Obazoa;Opisthokonta;Nucletmycea;Fungi;Dikarya;Ascomycota;Pezizomycotina;Sordariomycetes;Microascales;Incertae Sedis;";"0.0";"0";"2";"2";"0";"2";"0";"457181";"373894"
"V4mis1";"SILVA (only NR);Eukaryota;Amorphea;Obazoa;Opisthokonta;Nucletmycea;Fungi;Dikarya;Ascomycota;Pezizomycotina;Sordariomycetes;Microascales;Incertae Sedis;Gabarnaudia;";"0.0";"0";"1";"1";"0";"1";"0";"457182";"373894"
"V4mis1";"SILVA (only NR);Eukaryota;Amorphea;Obazoa;Opisthokonta;Nucletmycea;Fungi;Dikarya;Ascomycota;Pezizomycotina;Sordariomycetes;Microascales;Incertae Sedis;Sphaeronaemella;";"0.0";"0";"1";"1";"0";"1";"0";"457182";"373894"
"V4mis1";"SILVA (only NR);Eukaryota;Amorphea;Obazoa;Opisthokonta;Nucletmycea;Fungi;Dikarya;Ascomycota;Pezizomycotina;Sordariomycetes;Microascales;Knoxdaviesia;";"0.0";"0";"1";"1";"0";"1";"0";"457182";"373894"
"V4mis1";"SILVA (only NR);Eukaryota;Amorphea;Obazoa;Opisthokonta;Nucletmycea;Fungi;Dikarya;Ascomycota;Pezizomycotina;Sordariomycetes;Microascales;Microascaceae;";"0.0";"0";"23";"23";"0";"23";"0";"457160";"373894"
"V4mis1";"SILVA (only NR);Eukaryota;Amorphea;Obazoa;Opisthokonta;Nucletmycea;Fungi;Dikarya;Ascomycota;Pezizomycotina;Sordariomycetes;Microascales;Microascaceae;Basipetospora;";"0.0";"0";"1";"1";"0";"1";"0";"457182";"373894"
"V4mis1";"SILVA (only NR);Eukaryota;Amorphea;Obazoa;Opisthokonta;Nucletmycea;Fungi;Dikarya;Ascomycota;Pezizomycotina;Sordariomycetes;Microascales;Microascaceae;Brachyconidiellopsis;";"0.0";"0";"1";"1";"0";"1";"0";"457182";"373894"
"V4mis1";"SILVA (only NR);Eukaryota;Amorphea;Obazoa;Opisthokonta;Nucletmycea;Fungi;Dikarya;Ascomycota;Pezizomycotina;Sordariomycetes;Microascales;Microascaceae;Doratomyces;";"0.0";"0";"2";"2";"0";"2";"0";"457181";"373894"
"V4mis1";"SILVA (only NR);Eukaryota;Amorphea;Obazoa;Opisthokonta;Nucletmycea;Fungi;Dikarya;Ascomycota;Pezizomycotina;Sordariomycetes;Microascales;Microascaceae;Lomentospora;";"0.0";"0";"2";"2";"0";"2";"0";"457181";"373894"
"V4mis1";"SILVA (only NR);Eukaryota;Amorphea;Obazoa;Opisthokonta;Nucletmycea;Fungi;Dikarya;Ascomycota;Pezizomycotina;Sordariomycetes;Microascales;Microascaceae;Microascus;";"0.0";"0";"3";"3";"0";"3";"0";"457180";"373894"
"V4mis1";"SILVA (only NR);Eukaryota;Amorphea;Obazoa;Opisthokonta;Nucletmycea;Fungi;Dikarya;Ascomycota;Pezizomycotina;Sordariomycetes;Microascales;Microascaceae;Parascedosporium;";"0.0";"0";"5";"5";"0";"5";"0";"457178";"373894"
"V4mis1";"SILVA (only NR);Eukaryota;Amorphea;Obazoa;Opisthokonta;Nucletmycea;Fungi;Dikarya;Ascomycota;Pezizomycotina;Sordariomycetes;Microascales;Microascaceae;Petriella;";"0.0";"0";"2";"2";"0";"2";"0";"457181";"373894"
"V4mis1";"SILVA (only NR);Eukaryota;Amorphea;Obazoa;Opisthokonta;Nucletmycea;Fungi;Dikarya;Ascomycota;Pezizomycotina;Sordariomycetes;Microascales;Microascaceae;Pseudallescheria;";"0.0";"0";"1";"1";"0";"1";"0";"457182";"373894"
"V4mis1";"SILVA (only NR);Eukaryota;Amorphea;Obazoa;Opisthokonta;Nucletmycea;Fungi;Dikarya;Ascomycota;Pezizomycotina;Sordariomycetes;Microascales;Microascaceae;Scedosporium;";"0.0";"0";"2";"2";"0";"2";"0";"457181";"373894"
"V4mis1";"SILVA (only NR);Eukaryota;Amorphea;Obazoa;Opisthokonta;Nucletmycea;Fungi;Dikarya;Ascomycota;Pezizomycotina;Sordariomycetes;Microascales;Microascaceae;Scopulariopsis;";"0.0";"0";"1";"1";"0";"1";"0";"457182";"373894"
"V4mis1";"SILVA (only NR);Eukaryota;Amorphea;Obazoa;Opisthokonta;Nucletmycea;Fungi;Dikarya;Ascomycota;Pezizomycotina;Sordariomycetes;Microascales;Tubakiella;";"0.0";"0";"1";"1";"0";"1";"0";"457182";"373894"
"V4mis1";"SILVA (only NR);Eukaryota;Amorphea;Obazoa;Opisthokonta;Nucletmycea;Fungi;Dikarya;Ascomycota;Pezizomycotina;Sordariomycetes;Microascales;uncultured;";"0.0";"0";"2";"2";"0";"2";"0";"457181";"373894"
"V4mis1";"SILVA (only NR);Eukaryota;Amorphea;Obazoa;Opisthokonta;Nucletmycea;Fungi;Dikarya;Ascomycota;Pezizomycotina;Sordariomycetes;Myrmecridiales;";"0.0";"0";"2";"2";"0";"2";"0";"457181";"373894"
"V4mis1";"SILVA (only NR);Eukaryota;Amorphea;Obazoa;Opisthokonta;Nucletmycea;Fungi;Dikarya;Ascomycota;Pezizomycotina;Sordariomycetes;Myrmecridiales;Myrmecridiaceae;";"0.0";"0";"2";"2";"0";"2";"0";"457181";"373894"
"V4mis1";"SILVA (only NR);Eukaryota;Amorphea;Obazoa;Opisthokonta;Nucletmycea;Fungi;Dikarya;Ascomycota;Pezizomycotina;Sordariomycetes;Myrmecridiales;Myrmecridiaceae;Myrmecridium;";"0.0";"0";"2";"2";"0";"2";"0";"457181";"373894"
"V4mis1";"SILVA (only NR);Eukaryota;Amorphea;Obazoa;Opisthokonta;Nucletmycea;Fungi;Dikarya;Ascomycota;Pezizomycotina;Sordariomycetes;Ophiostomatales;";"0.0";"0";"39";"39";"0";"39";"0";"457144";"373894"
"V4mis1";"SILVA (only NR);Eukaryota;Amorphea;Obazoa;Opisthokonta;Nucletmycea;Fungi;Dikarya;Ascomycota;Pezizomycotina;Sordariomycetes;Ophiostomatales;Ophiostomataceae;";"0.0";"0";"39";"39";"0";"39";"0";"457144";"373894"
"V4mis1";"SILVA (only NR);Eukaryota;Amorphea;Obazoa;Opisthokonta;Nucletmycea;Fungi;Dikarya;Ascomycota;Pezizomycotina;Sordariomycetes;Ophiostomatales;Ophiostomataceae;Ceratocystiopsis;";"0.0";"0";"4";"4";"0";"4";"0";"457179";"373894"
"V4mis1";"SILVA (only NR);Eukaryota;Amorphea;Obazoa;Opisthokonta;Nucletmycea;Fungi;Dikarya;Ascomycota;Pezizomycotina;Sordariomycetes;Ophiostomatales;Ophiostomataceae;Fragosphaeria;";"0.0";"0";"2";"2";"0";"2";"0";"457181";"373894"
"V4mis1";"SILVA (only NR);Eukaryota;Amorphea;Obazoa;Opisthokonta;Nucletmycea;Fungi;Dikarya;Ascomycota;Pezizomycotina;Sordariomycetes;Ophiostomatales;Ophiostomataceae;Graphilbum;";"0.0";"0";"1";"1";"0";"1";"0";"457182";"373894"
"V4mis1";"SILVA (only NR);Eukaryota;Amorphea;Obazoa;Opisthokonta;Nucletmycea;Fungi;Dikarya;Ascomycota;Pezizomycotina;Sordariomycetes;Ophiostomatales;Ophiostomataceae;Grosmannia;";"0.0";"0";"4";"4";"0";"4";"0";"457179";"373894"
"V4mis1";"SILVA (only NR);Eukaryota;Amorphea;Obazoa;Opisthokonta;Nucletmycea;Fungi;Dikarya;Ascomycota;Pezizomycotina;Sordariomycetes;Ophiostomatales;Ophiostomataceae;Leptographium;";"0.0";"0";"1";"1";"0";"1";"0";"457182";"373894"
"V4mis1";"SILVA (only NR);Eukaryota;Amorphea;Obazoa;Opisthokonta;Nucletmycea;Fungi;Dikarya;Ascomycota;Pezizomycotina;Sordariomycetes;Ophiostomatales;Ophiostomataceae;Ophiostoma;";"0.0";"0";"10";"10";"0";"10";"0";"457173";"373894"
"V4mis1";"SILVA (only NR);Eukaryota;Amorphea;Obazoa;Opisthokonta;Nucletmycea;Fungi;Dikarya;Ascomycota;Pezizomycotina;Sordariomycetes;Ophiostomatales;Ophiostomataceae;Pesotum;";"0.0";"0";"1";"1";"0";"1";"0";"457182";"373894"
"V4mis1";"SILVA (only NR);Eukaryota;Amorphea;Obazoa;Opisthokonta;Nucletmycea;Fungi;Dikarya;Ascomycota;Pezizomycotina;Sordariomycetes;Ophiostomatales;Ophiostomataceae;Raffaelea;";"0.0";"0";"11";"11";"0";"11";"0";"457172";"373894"
"V4mis1";"SILVA (only NR);Eukaryota;Amorphea;Obazoa;Opisthokonta;Nucletmycea;Fungi;Dikarya;Ascomycota;Pezizomycotina;Sordariomycetes;Ophiostomatales;Ophiostomataceae;Sporothrix;";"0.0";"0";"2";"2";"0";"2";"0";"457181";"373894"
"V4mis1";"SILVA (only NR);Eukaryota;Amorphea;Obazoa;Opisthokonta;Nucletmycea;Fungi;Dikarya;Ascomycota;Pezizomycotina;Sordariomycetes;Phomatosporaceae;";"0.0";"0";"1";"1";"0";"1";"0";"457182";"373894"
"V4mis1";"SILVA (only NR);Eukaryota;Amorphea;Obazoa;Opisthokonta;Nucletmycea;Fungi;Dikarya;Ascomycota;Pezizomycotina;Sordariomycetes;Phomatosporaceae;Lanspora;";"0.0";"0";"1";"1";"0";"1";"0";"457182";"373894"
"V4mis1";"SILVA (only NR);Eukaryota;Amorphea;Obazoa;Opisthokonta;Nucletmycea;Fungi;Dikarya;Ascomycota;Pezizomycotina;Sordariomycetes;Phyllachorales;";"0.0";"0";"2";"2";"0";"2";"0";"457181";"373894"
"V4mis1";"SILVA (only NR);Eukaryota;Amorphea;Obazoa;Opisthokonta;Nucletmycea;Fungi;Dikarya;Ascomycota;Pezizomycotina;Sordariomycetes;Phyllachorales;Phyllachoraceae;";"0.0";"0";"2";"2";"0";"2";"0";"457181";"373894"
"V4mis1";"SILVA (only NR);Eukaryota;Amorphea;Obazoa;Opisthokonta;Nucletmycea;Fungi;Dikarya;Ascomycota;Pezizomycotina;Sordariomycetes;Phyllachorales;Phyllachoraceae;Haloguignardia;";"0.0";"0";"1";"1";"0";"1";"0";"457182";"373894"
"V4mis1";"SILVA (only NR);Eukaryota;Amorphea;Obazoa;Opisthokonta;Nucletmycea;Fungi;Dikarya;Ascomycota;Pezizomycotina;Sordariomycetes;Phyllachorales;Phyllachoraceae;Phyllachora;";"0.0";"0";"1";"1";"0";"1";"0";"457182";"373894"
"V4mis1";"SILVA (only NR);Eukaryota;Amorphea;Obazoa;Opisthokonta;Nucletmycea;Fungi;Dikarya;Ascomycota;Pezizomycotina;Sordariomycetes;Pisorisporiales;";"0.0";"0";"1";"1";"0";"1";"0";"457182";"373894"
"V4mis1";"SILVA (only NR);Eukaryota;Amorphea;Obazoa;Opisthokonta;Nucletmycea;Fungi;Dikarya;Ascomycota;Pezizomycotina;Sordariomycetes;Pisorisporiales;Incertae Sedis;";"0.0";"0";"1";"1";"0";"1";"0";"457182";"373894"
"V4mis1";"SILVA (only NR);Eukaryota;Amorphea;Obazoa;Opisthokonta;Nucletmycea;Fungi;Dikarya;Ascomycota;Pezizomycotina;Sordariomycetes;Pisorisporiales;Incertae Sedis;Achroceratosphaeria;";"0.0";"0";"1";"1";"0";"1";"0";"457182";"373894"
"V4mis1";"SILVA (only NR);Eukaryota;Amorphea;Obazoa;Opisthokonta;Nucletmycea;Fungi;Dikarya;Ascomycota;Pezizomycotina;Sordariomycetes;Pleurotheciales;";"0.0";"0";"8";"8";"0";"8";"0";"457175";"373894"
"V4mis1";"SILVA (only NR);Eukaryota;Amorphea;Obazoa;Opisthokonta;Nucletmycea;Fungi;Dikarya;Ascomycota;Pezizomycotina;Sordariomycetes;Pleurotheciales;Pleurotheciaceae;";"0.0";"0";"8";"8";"0";"8";"0";"457175";"373894"
"V4mis1";"SILVA (only NR);Eukaryota;Amorphea;Obazoa;Opisthokonta;Nucletmycea;Fungi;Dikarya;Ascomycota;Pezizomycotina;Sordariomycetes;Pleurotheciales;Pleurotheciaceae;Parafuscospora;";"0.0";"0";"1";"1";"0";"1";"0";"457182";"373894"
"V4mis1";"SILVA (only NR);Eukaryota;Amorphea;Obazoa;Opisthokonta;Nucletmycea;Fungi;Dikarya;Ascomycota;Pezizomycotina;Sordariomycetes;Pleurotheciales;Pleurotheciaceae;Phaeoisaria;";"0.0";"0";"1";"1";"0";"1";"0";"457182";"373894"
"V4mis1";"SILVA (only NR);Eukaryota;Amorphea;Obazoa;Opisthokonta;Nucletmycea;Fungi;Dikarya;Ascomycota;Pezizomycotina;Sordariomycetes;Pleurotheciales;Pleurotheciaceae;Plagiascoma;";"0.0";"0";"1";"1";"0";"1";"0";"457182";"373894"
"V4mis1";"SILVA (only NR);Eukaryota;Amorphea;Obazoa;Opisthokonta;Nucletmycea;Fungi;Dikarya;Ascomycota;Pezizomycotina;Sordariomycetes;Pleurotheciales;Pleurotheciaceae;Pleurotheciella;";"0.0";"0";"1";"1";"0";"1";"0";"457182";"373894"
"V4mis1";"SILVA (only NR);Eukaryota;Amorphea;Obazoa;Opisthokonta;Nucletmycea;Fungi;Dikarya;Ascomycota;Pezizomycotina;Sordariomycetes;Pleurotheciales;Pleurotheciaceae;Pleurothecium;";"0.0";"0";"4";"4";"0";"4";"0";"457179";"373894"
"V4mis1";"SILVA (only NR);Eukaryota;Amorphea;Obazoa;Opisthokonta;Nucletmycea;Fungi;Dikarya;Ascomycota;Pezizomycotina;Sordariomycetes;Pontogeneia;";"0.0";"0";"1";"1";"0";"1";"0";"457182";"373894"
"V4mis1";"SILVA (only NR);Eukaryota;Amorphea;Obazoa;Opisthokonta;Nucletmycea;Fungi;Dikarya;Ascomycota;Pezizomycotina;Sordariomycetes;Savoryellales;";"0.0";"0";"10";"10";"0";"10";"0";"457173";"373894"
"V4mis1";"SILVA (only NR);Eukaryota;Amorphea;Obazoa;Opisthokonta;Nucletmycea;Fungi;Dikarya;Ascomycota;Pezizomycotina;Sordariomycetes;Savoryellales;Incertae Sedis;";"0.0";"0";"10";"10";"0";"10";"0";"457173";"373894"
"V4mis1";"SILVA (only NR);Eukaryota;Amorphea;Obazoa;Opisthokonta;Nucletmycea;Fungi;Dikarya;Ascomycota;Pezizomycotina;Sordariomycetes;Savoryellales;Incertae Sedis;Ascotaiwania;";"0.0";"0";"2";"2";"0";"2";"0";"457181";"373894"
"V4mis1";"SILVA (only NR);Eukaryota;Amorphea;Obazoa;Opisthokonta;Nucletmycea;Fungi;Dikarya;Ascomycota;Pezizomycotina;Sordariomycetes;Savoryellales;Incertae Sedis;Savoryella;";"0.0";"0";"8";"8";"0";"8";"0";"457175";"373894"
"V4mis1";"SILVA (only NR);Eukaryota;Amorphea;Obazoa;Opisthokonta;Nucletmycea;Fungi;Dikarya;Ascomycota;Pezizomycotina;Sordariomycetes;Sordariales;";"0.0";"0";"49";"49";"0";"49";"0";"457134";"373894"
"V4mis1";"SILVA (only NR);Eukaryota;Amorphea;Obazoa;Opisthokonta;Nucletmycea;Fungi;Dikarya;Ascomycota;Pezizomycotina;Sordariomycetes;Sordariales;Cephalothecaceae;";"0.0";"0";"8";"8";"0";"8";"0";"457175";"373894"
"V4mis1";"SILVA (only NR);Eukaryota;Amorphea;Obazoa;Opisthokonta;Nucletmycea;Fungi;Dikarya;Ascomycota;Pezizomycotina;Sordariomycetes;Sordariales;Cephalothecaceae;Albertiniella;";"0.0";"0";"2";"2";"0";"2";"0";"457181";"373894"
"V4mis1";"SILVA (only NR);Eukaryota;Amorphea;Obazoa;Opisthokonta;Nucletmycea;Fungi;Dikarya;Ascomycota;Pezizomycotina;Sordariomycetes;Sordariales;Cephalothecaceae;Cephalotheca;";"0.0";"0";"2";"2";"0";"2";"0";"457181";"373894"
"V4mis1";"SILVA (only NR);Eukaryota;Amorphea;Obazoa;Opisthokonta;Nucletmycea;Fungi;Dikarya;Ascomycota;Pezizomycotina;Sordariomycetes;Sordariales;Cephalothecaceae;Phialemonium;";"0.0";"0";"4";"4";"0";"4";"0";"457179";"373894"
"V4mis1";"SILVA (only NR);Eukaryota;Amorphea;Obazoa;Opisthokonta;Nucletmycea;Fungi;Dikarya;Ascomycota;Pezizomycotina;Sordariomycetes;Sordariales;Chaetomiaceae;";"0.0";"0";"25";"25";"0";"25";"0";"457158";"373894"
"V4mis1";"SILVA (only NR);Eukaryota;Amorphea;Obazoa;Opisthokonta;Nucletmycea;Fungi;Dikarya;Ascomycota;Pezizomycotina;Sordariomycetes;Sordariales;Chaetomiaceae;Chaetomium;";"0.0";"0";"17";"17";"0";"17";"0";"457166";"373894"
"V4mis1";"SILVA (only NR);Eukaryota;Amorphea;Obazoa;Opisthokonta;Nucletmycea;Fungi;Dikarya;Ascomycota;Pezizomycotina;Sordariomycetes;Sordariales;Chaetomiaceae;Corynascus;";"0.0";"0";"1";"1";"0";"1";"0";"457182";"373894"
"V4mis1";"SILVA (only NR);Eukaryota;Amorphea;Obazoa;Opisthokonta;Nucletmycea;Fungi;Dikarya;Ascomycota;Pezizomycotina;Sordariomycetes;Sordariales;Chaetomiaceae;Humicola;";"0.0";"0";"2";"2";"0";"2";"0";"457181";"373894"
"V4mis1";"SILVA (only NR);Eukaryota;Amorphea;Obazoa;Opisthokonta;Nucletmycea;Fungi;Dikarya;Ascomycota;Pezizomycotina;Sordariomycetes;Sordariales;Chaetomiaceae;Melanocarpus;";"0.0";"0";"1";"1";"0";"1";"0";"457182";"373894"
"V4mis1";"SILVA (only NR);Eukaryota;Amorphea;Obazoa;Opisthokonta;Nucletmycea;Fungi;Dikarya;Ascomycota;Pezizomycotina;Sordariomycetes;Sordariales;Chaetomiaceae;Remersonia;";"0.0";"0";"1";"1";"0";"1";"0";"457182";"373894"
"V4mis1";"SILVA (only NR);Eukaryota;Amorphea;Obazoa;Opisthokonta;Nucletmycea;Fungi;Dikarya;Ascomycota;Pezizomycotina;Sordariomycetes;Sordariales;Chaetomiaceae;Thielavia;";"0.0";"0";"1";"1";"0";"1";"0";"457182";"373894"
"V4mis1";"SILVA (only NR);Eukaryota;Amorphea;Obazoa;Opisthokonta;Nucletmycea;Fungi;Dikarya;Ascomycota;Pezizomycotina;Sordariomycetes;Sordariales;Incertae Sedis;";"0.0";"0";"4";"4";"0";"4";"0";"457179";"373894"
"V4mis1";"SILVA (only NR);Eukaryota;Amorphea;Obazoa;Opisthokonta;Nucletmycea;Fungi;Dikarya;Ascomycota;Pezizomycotina;Sordariomycetes;Sordariales;Incertae Sedis;Kionochaeta;";"0.0";"0";"4";"4";"0";"4";"0";"457179";"373894"
"V4mis1";"SILVA (only NR);Eukaryota;Amorphea;Obazoa;Opisthokonta;Nucletmycea;Fungi;Dikarya;Ascomycota;Pezizomycotina;Sordariomycetes;Sordariales;Lasiosphaeriaceae;";"0.0";"0";"3";"3";"0";"3";"0";"457180";"373894"
"V4mis1";"SILVA (only NR);Eukaryota;Amorphea;Obazoa;Opisthokonta;Nucletmycea;Fungi;Dikarya;Ascomycota;Pezizomycotina;Sordariomycetes;Sordariales;Lasiosphaeriaceae;Ascovaginospora;";"0.0";"0";"1";"1";"0";"1";"0";"457182";"373894"
"V4mis1";"SILVA (only NR);Eukaryota;Amorphea;Obazoa;Opisthokonta;Nucletmycea;Fungi;Dikarya;Ascomycota;Pezizomycotina;Sordariomycetes;Sordariales;Lasiosphaeriaceae;Podospora;";"0.0";"0";"2";"2";"0";"2";"0";"457181";"373894"
"V4mis1";"SILVA (only NR);Eukaryota;Amorphea;Obazoa;Opisthokonta;Nucletmycea;Fungi;Dikarya;Ascomycota;Pezizomycotina;Sordariomycetes;Sordariales;Sordariaceae;";"0.0";"0";"3";"3";"0";"3";"0";"457180";"373894"
"V4mis1";"SILVA (only NR);Eukaryota;Amorphea;Obazoa;Opisthokonta;Nucletmycea;Fungi;Dikarya;Ascomycota;Pezizomycotina;Sordariomycetes;Sordariales;Sordariaceae;Neurospora;";"0.0";"0";"2";"2";"0";"2";"0";"457181";"373894"
"V4mis1";"SILVA (only NR);Eukaryota;Amorphea;Obazoa;Opisthokonta;Nucletmycea;Fungi;Dikarya;Ascomycota;Pezizomycotina;Sordariomycetes;Sordariales;Sordariaceae;Sordaria;";"0.0";"0";"1";"1";"0";"1";"0";"457182";"373894"
"V4mis1";"SILVA (only NR);Eukaryota;Amorphea;Obazoa;Opisthokonta;Nucletmycea;Fungi;Dikarya;Ascomycota;Pezizomycotina;Sordariomycetes;Sordariales;uncultured;";"0.0";"0";"4";"4";"0";"4";"0";"457179";"373894"
"V4mis1";"SILVA (only NR);Eukaryota;Amorphea;Obazoa;Opisthokonta;Nucletmycea;Fungi;Dikarya;Ascomycota;Pezizomycotina;Sordariomycetes;Togniniales;";"0.0";"0";"10";"10";"0";"10";"0";"457173";"373894"
"V4mis1";"SILVA (only NR);Eukaryota;Amorphea;Obazoa;Opisthokonta;Nucletmycea;Fungi;Dikarya;Ascomycota;Pezizomycotina;Sordariomycetes;Togniniales;Togniniaceae;";"0.0";"0";"10";"10";"0";"10";"0";"457173";"373894"
"V4mis1";"SILVA (only NR);Eukaryota;Amorphea;Obazoa;Opisthokonta;Nucletmycea;Fungi;Dikarya;Ascomycota;Pezizomycotina;Sordariomycetes;Togniniales;Togniniaceae;Phaeoacremonium;";"0.0";"0";"10";"10";"0";"10";"0";"457173";"373894"
"V4mis1";"SILVA (only NR);Eukaryota;Amorphea;Obazoa;Opisthokonta;Nucletmycea;Fungi;Dikarya;Ascomycota;Pezizomycotina;Sordariomycetes;Torpedosporales;";"0.0";"0";"4";"4";"0";"4";"0";"457179";"373894"
"V4mis1";"SILVA (only NR);Eukaryota;Amorphea;Obazoa;Opisthokonta;Nucletmycea;Fungi;Dikarya;Ascomycota;Pezizomycotina;Sordariomycetes;Torpedosporales;Torpedosporaceae;";"0.0";"0";"4";"4";"0";"4";"0";"457179";"373894"
"V4mis1";"SILVA (only NR);Eukaryota;Amorphea;Obazoa;Opisthokonta;Nucletmycea;Fungi;Dikarya;Ascomycota;Pezizomycotina;Sordariomycetes;Torpedosporales;Torpedosporaceae;Torpedospora;";"0.0";"0";"4";"4";"0";"4";"0";"457179";"373894"
"V4mis1";"SILVA (only NR);Eukaryota;Amorphea;Obazoa;Opisthokonta;Nucletmycea;Fungi;Dikarya;Ascomycota;Pezizomycotina;Sordariomycetes;Xylariales;";"0.0";"0";"114";"114";"0";"114";"0";"457069";"373894"
"V4mis1";"SILVA (only NR);Eukaryota;Amorphea;Obazoa;Opisthokonta;Nucletmycea;Fungi;Dikarya;Ascomycota;Pezizomycotina;Sordariomycetes;Xylariales;Amphisphaeriaceae;";"0.0";"0";"4";"4";"0";"4";"0";"457179";"373894"
"V4mis1";"SILVA (only NR);Eukaryota;Amorphea;Obazoa;Opisthokonta;Nucletmycea;Fungi;Dikarya;Ascomycota;Pezizomycotina;Sordariomycetes;Xylariales;Amphisphaeriaceae;Amphisphaeria;";"0.0";"0";"2";"2";"0";"2";"0";"457181";"373894"
"V4mis1";"SILVA (only NR);Eukaryota;Amorphea;Obazoa;Opisthokonta;Nucletmycea;Fungi;Dikarya;Ascomycota;Pezizomycotina;Sordariomycetes;Xylariales;Amphisphaeriaceae;Pestalosphaeria;";"0.0";"0";"1";"1";"0";"1";"0";"457182";"373894"
"V4mis1";"SILVA (only NR);Eukaryota;Amorphea;Obazoa;Opisthokonta;Nucletmycea;Fungi;Dikarya;Ascomycota;Pezizomycotina;Sordariomycetes;Xylariales;Amphisphaeriaceae;Pestalotia;";"0.0";"0";"1";"1";"0";"1";"0";"457182";"373894"
"V4mis1";"SILVA (only NR);Eukaryota;Amorphea;Obazoa;Opisthokonta;Nucletmycea;Fungi;Dikarya;Ascomycota;Pezizomycotina;Sordariomycetes;Xylariales;Apiosporaceae;";"0.0";"0";"42";"42";"0";"42";"0";"457141";"373894"
"V4mis1";"SILVA (only NR);Eukaryota;Amorphea;Obazoa;Opisthokonta;Nucletmycea;Fungi;Dikarya;Ascomycota;Pezizomycotina;Sordariomycetes;Xylariales;Apiosporaceae;Arthrinium;";"0.0";"0";"42";"42";"0";"42";"0";"457141";"373894"
"V4mis1";"SILVA (only NR);Eukaryota;Amorphea;Obazoa;Opisthokonta;Nucletmycea;Fungi;Dikarya;Ascomycota;Pezizomycotina;Sordariomycetes;Xylariales;Cainia;";"0.0";"0";"1";"1";"0";"1";"0";"457182";"373894"
"V4mis1";"SILVA (only NR);Eukaryota;Amorphea;Obazoa;Opisthokonta;Nucletmycea;Fungi;Dikarya;Ascomycota;Pezizomycotina;Sordariomycetes;Xylariales;Circinotrichum;";"0.0";"0";"1";"1";"0";"1";"0";"457182";"373894"
"V4mis1";"SILVA (only NR);Eukaryota;Amorphea;Obazoa;Opisthokonta;Nucletmycea;Fungi;Dikarya;Ascomycota;Pezizomycotina;Sordariomycetes;Xylariales;Diatrypaceae;";"0.0";"0";"8";"8";"0";"8";"0";"457175";"373894"
"V4mis1";"SILVA (only NR);Eukaryota;Amorphea;Obazoa;Opisthokonta;Nucletmycea;Fungi;Dikarya;Ascomycota;Pezizomycotina;Sordariomycetes;Xylariales;Diatrypaceae;Cryptovalsa;";"0.0";"0";"1";"1";"0";"1";"0";"457182";"373894"
"V4mis1";"SILVA (only NR);Eukaryota;Amorphea;Obazoa;Opisthokonta;Nucletmycea;Fungi;Dikarya;Ascomycota;Pezizomycotina;Sordariomycetes;Xylariales;Diatrypaceae;Diatrype;";"0.0";"0";"2";"2";"0";"2";"0";"457181";"373894"
"V4mis1";"SILVA (only NR);Eukaryota;Amorphea;Obazoa;Opisthokonta;Nucletmycea;Fungi;Dikarya;Ascomycota;Pezizomycotina;Sordariomycetes;Xylariales;Diatrypaceae;Eutypa;";"0.0";"0";"1";"1";"0";"1";"0";"457182";"373894"
"V4mis1";"SILVA (only NR);Eukaryota;Amorphea;Obazoa;Opisthokonta;Nucletmycea;Fungi;Dikarya;Ascomycota;Pezizomycotina;Sordariomycetes;Xylariales;Diatrypaceae;Melanospora;";"0.0";"0";"2";"2";"0";"2";"0";"457181";"373894"
"V4mis1";"SILVA (only NR);Eukaryota;Amorphea;Obazoa;Opisthokonta;Nucletmycea;Fungi;Dikarya;Ascomycota;Pezizomycotina;Sordariomycetes;Xylariales;Diatrypaceae;Sphaerodes;";"0.0";"0";"1";"1";"0";"1";"0";"457182";"373894"
"V4mis1";"SILVA (only NR);Eukaryota;Amorphea;Obazoa;Opisthokonta;Nucletmycea;Fungi;Dikarya;Ascomycota;Pezizomycotina;Sordariomycetes;Xylariales;Diatrypasimilis;";"0.0";"0";"1";"1";"0";"1";"0";"457182";"373894"
"V4mis1";"SILVA (only NR);Eukaryota;Amorphea;Obazoa;Opisthokonta;Nucletmycea;Fungi;Dikarya;Ascomycota;Pezizomycotina;Sordariomycetes;Xylariales;Hyponectria;";"0.0";"0";"2";"2";"0";"2";"0";"457181";"373894"
"V4mis1";"SILVA (only NR);Eukaryota;Amorphea;Obazoa;Opisthokonta;Nucletmycea;Fungi;Dikarya;Ascomycota;Pezizomycotina;Sordariomycetes;Xylariales;Incertae Sedis;";"0.0";"0";"4";"4";"0";"4";"0";"457179";"373894"
"V4mis1";"SILVA (only NR);Eukaryota;Amorphea;Obazoa;Opisthokonta;Nucletmycea;Fungi;Dikarya;Ascomycota;Pezizomycotina;Sordariomycetes;Xylariales;Incertae Sedis;Dicyma;";"0.0";"0";"1";"1";"0";"1";"0";"457182";"373894"
"V4mis1";"SILVA (only NR);Eukaryota;Amorphea;Obazoa;Opisthokonta;Nucletmycea;Fungi;Dikarya;Ascomycota;Pezizomycotina;Sordariomycetes;Xylariales;Incertae Sedis;Phialemoniopsis;";"0.0";"0";"1";"1";"0";"1";"0";"457182";"373894"
"V4mis1";"SILVA (only NR);Eukaryota;Amorphea;Obazoa;Opisthokonta;Nucletmycea;Fungi;Dikarya;Ascomycota;Pezizomycotina;Sordariomycetes;Xylariales;Incertae Sedis;Surculiseries;";"0.0";"0";"2";"2";"0";"2";"0";"457181";"373894"
"V4mis1";"SILVA (only NR);Eukaryota;Amorphea;Obazoa;Opisthokonta;Nucletmycea;Fungi;Dikarya;Ascomycota;Pezizomycotina;Sordariomycetes;Xylariales;Liberomyces;";"0.0";"0";"1";"1";"0";"1";"0";"457182";"373894"
"V4mis1";"SILVA (only NR);Eukaryota;Amorphea;Obazoa;Opisthokonta;Nucletmycea;Fungi;Dikarya;Ascomycota;Pezizomycotina;Sordariomycetes;Xylariales;Sporocadaceae;";"0.0";"0";"5";"5";"0";"5";"0";"457178";"373894"
"V4mis1";"SILVA (only NR);Eukaryota;Amorphea;Obazoa;Opisthokonta;Nucletmycea;Fungi;Dikarya;Ascomycota;Pezizomycotina;Sordariomycetes;Xylariales;Sporocadaceae;Pestalotiopsis;";"0.0";"0";"2";"2";"0";"2";"0";"457181";"373894"
"V4mis1";"SILVA (only NR);Eukaryota;Amorphea;Obazoa;Opisthokonta;Nucletmycea;Fungi;Dikarya;Ascomycota;Pezizomycotina;Sordariomycetes;Xylariales;Sporocadaceae;Seiridium;";"0.0";"0";"2";"2";"0";"2";"0";"457181";"373894"
"V4mis1";"SILVA (only NR);Eukaryota;Amorphea;Obazoa;Opisthokonta;Nucletmycea;Fungi;Dikarya;Ascomycota;Pezizomycotina;Sordariomycetes;Xylariales;Sporocadaceae;Truncatella;";"0.0";"0";"1";"1";"0";"1";"0";"457182";"373894"
"V4mis1";"SILVA (only NR);Eukaryota;Amorphea;Obazoa;Opisthokonta;Nucletmycea;Fungi;Dikarya;Ascomycota;Pezizomycotina;Sordariomycetes;Xylariales;Xylariaceae;";"0.0";"0";"38";"38";"0";"38";"0";"457145";"373894"
"V4mis1";"SILVA (only NR);Eukaryota;Amorphea;Obazoa;Opisthokonta;Nucletmycea;Fungi;Dikarya;Ascomycota;Pezizomycotina;Sordariomycetes;Xylariales;Xylariaceae;Anthostomella;";"0.0";"0";"1";"1";"0";"1";"0";"457182";"373894"
"V4mis1";"SILVA (only NR);Eukaryota;Amorphea;Obazoa;Opisthokonta;Nucletmycea;Fungi;Dikarya;Ascomycota;Pezizomycotina;Sordariomycetes;Xylariales;Xylariaceae;Ascotricha;";"0.0";"0";"3";"3";"0";"3";"0";"457180";"373894"
"V4mis1";"SILVA (only NR);Eukaryota;Amorphea;Obazoa;Opisthokonta;Nucletmycea;Fungi;Dikarya;Ascomycota;Pezizomycotina;Sordariomycetes;Xylariales;Xylariaceae;Barrmaelia;";"0.0";"0";"1";"1";"0";"1";"0";"457182";"373894"
"V4mis1";"SILVA (only NR);Eukaryota;Amorphea;Obazoa;Opisthokonta;Nucletmycea;Fungi;Dikarya;Ascomycota;Pezizomycotina;Sordariomycetes;Xylariales;Xylariaceae;Biscogniauxia;";"0.0";"0";"1";"1";"0";"1";"0";"457182";"373894"
"V4mis1";"SILVA (only NR);Eukaryota;Amorphea;Obazoa;Opisthokonta;Nucletmycea;Fungi;Dikarya;Ascomycota;Pezizomycotina;Sordariomycetes;Xylariales;Xylariaceae;Geniculisynnema;";"0.0";"0";"1";"1";"0";"1";"0";"457182";"373894"
"V4mis1";"SILVA (only NR);Eukaryota;Amorphea;Obazoa;Opisthokonta;Nucletmycea;Fungi;Dikarya;Ascomycota;Pezizomycotina;Sordariomycetes;Xylariales;Xylariaceae;Hypoxylon;";"0.0";"0";"11";"11";"0";"11";"0";"457172";"373894"
"V4mis1";"SILVA (only NR);Eukaryota;Amorphea;Obazoa;Opisthokonta;Nucletmycea;Fungi;Dikarya;Ascomycota;Pezizomycotina;Sordariomycetes;Xylariales;Xylariaceae;Kretzschmaria;";"0.0";"0";"1";"1";"0";"1";"0";"457182";"373894"
"V4mis1";"SILVA (only NR);Eukaryota;Amorphea;Obazoa;Opisthokonta;Nucletmycea;Fungi;Dikarya;Ascomycota;Pezizomycotina;Sordariomycetes;Xylariales;Xylariaceae;Muscodor;";"0.0";"0";"4";"4";"0";"4";"0";"457179";"373894"
"V4mis1";"SILVA (only NR);Eukaryota;Amorphea;Obazoa;Opisthokonta;Nucletmycea;Fungi;Dikarya;Ascomycota;Pezizomycotina;Sordariomycetes;Xylariales;Xylariaceae;Rosellinia;";"0.0";"0";"1";"1";"0";"1";"0";"457182";"373894"
"V4mis1";"SILVA (only NR);Eukaryota;Amorphea;Obazoa;Opisthokonta;Nucletmycea;Fungi;Dikarya;Ascomycota;Pezizomycotina;Sordariomycetes;Xylariales;Xylariaceae;Xylaria;";"0.0";"0";"7";"7";"0";"7";"0";"457176";"373894"
"V4mis1";"SILVA (only NR);Eukaryota;Amorphea;Obazoa;Opisthokonta;Nucletmycea;Fungi;Dikarya;Ascomycota;Pezizomycotina;Sordariomycetes;Xylariales;Xylariaceae;artificial;";"0.0";"0";"1";"1";"0";"1";"0";"457182";"373894"
"V4mis1";"SILVA (only NR);Eukaryota;Amorphea;Obazoa;Opisthokonta;Nucletmycea;Fungi;Dikarya;Ascomycota;Pezizomycotina;Sordariomycetes;uncultured;";"0.0";"0";"6";"6";"0";"6";"0";"457177";"373894"
"V4mis1";"SILVA (only NR);Eukaryota;Amorphea;Obazoa;Opisthokonta;Nucletmycea;Fungi;Dikarya;Ascomycota;Pezizomycotina;Xylobotryomycetes;";"0.0";"0";"3";"3";"0";"3";"0";"457180";"373894"
"V4mis1";"SILVA (only NR);Eukaryota;Amorphea;Obazoa;Opisthokonta;Nucletmycea;Fungi;Dikarya;Ascomycota;Pezizomycotina;Xylobotryomycetes;Xylobotryales;";"0.0";"0";"3";"3";"0";"3";"0";"457180";"373894"
"V4mis1";"SILVA (only NR);Eukaryota;Amorphea;Obazoa;Opisthokonta;Nucletmycea;Fungi;Dikarya;Ascomycota;Pezizomycotina;Xylobotryomycetes;Xylobotryales;Cirrosporium;";"0.0";"0";"1";"1";"0";"1";"0";"457182";"373894"
"V4mis1";"SILVA (only NR);Eukaryota;Amorphea;Obazoa;Opisthokonta;Nucletmycea;Fungi;Dikarya;Ascomycota;Pezizomycotina;Xylobotryomycetes;Xylobotryales;Xylobotryum;";"0.0";"0";"1";"1";"0";"1";"0";"457182";"373894"
"V4mis1";"SILVA (only NR);Eukaryota;Amorphea;Obazoa;Opisthokonta;Nucletmycea;Fungi;Dikarya;Ascomycota;Pezizomycotina;Xylonomycetes;";"0.0";"0";"5";"5";"0";"5";"0";"457178";"373894"
"V4mis1";"SILVA (only NR);Eukaryota;Amorphea;Obazoa;Opisthokonta;Nucletmycea;Fungi;Dikarya;Ascomycota;Pezizomycotina;Xylonomycetes;Incertae Sedis;";"0.0";"0";"4";"4";"0";"4";"0";"457179";"373894"
"V4mis1";"SILVA (only NR);Eukaryota;Amorphea;Obazoa;Opisthokonta;Nucletmycea;Fungi;Dikarya;Ascomycota;Pezizomycotina;Xylonomycetes;Incertae Sedis;Incertae Sedis;";"0.0";"0";"4";"4";"0";"4";"0";"457179";"373894"
"V4mis1";"SILVA (only NR);Eukaryota;Amorphea;Obazoa;Opisthokonta;Nucletmycea;Fungi;Dikarya;Ascomycota;Pezizomycotina;Xylonomycetes;Incertae Sedis;Incertae Sedis;Symbiotaphrina;";"0.0";"0";"4";"4";"0";"4";"0";"457179";"373894"
"V4mis1";"SILVA (only NR);Eukaryota;Amorphea;Obazoa;Opisthokonta;Nucletmycea;Fungi;Dikarya;Ascomycota;Pezizomycotina;Xylonomycetes;Xylonomycetales;";"0.0";"0";"1";"1";"0";"1";"0";"457182";"373894"
"V4mis1";"SILVA (only NR);Eukaryota;Amorphea;Obazoa;Opisthokonta;Nucletmycea;Fungi;Dikarya;Ascomycota;Pezizomycotina;Xylonomycetes;Xylonomycetales;Xylonomycetaceae;";"0.0";"0";"1";"1";"0";"1";"0";"457182";"373894"
"V4mis1";"SILVA (only NR);Eukaryota;Amorphea;Obazoa;Opisthokonta;Nucletmycea;Fungi;Dikarya;Ascomycota;Pezizomycotina;Xylonomycetes;Xylonomycetales;Xylonomycetaceae;Xylona;";"0.0";"0";"1";"1";"0";"1";"0";"457182";"373894"
"V4mis1";"SILVA (only NR);Eukaryota;Amorphea;Obazoa;Opisthokonta;Nucletmycea;Fungi;Dikarya;Ascomycota;Pezizomycotina;uncultured;";"0.0";"0";"8";"7";"0";"7";"1";"457176";"373894"
"V4mis1";"SILVA (only NR);Eukaryota;Amorphea;Obazoa;Opisthokonta;Nucletmycea;Fungi;Dikarya;Ascomycota;Saccharomycotina;";"0.0";"0";"1418";"1416";"0";"1416";"2";"455767";"373894"
"V4mis1";"SILVA (only NR);Eukaryota;Amorphea;Obazoa;Opisthokonta;Nucletmycea;Fungi;Dikarya;Ascomycota;Saccharomycotina;Saccharomycetes;";"0.0";"0";"1418";"1416";"0";"1416";"2";"455767";"373894"
"V4mis1";"SILVA (only NR);Eukaryota;Amorphea;Obazoa;Opisthokonta;Nucletmycea;Fungi;Dikarya;Ascomycota;Saccharomycotina;Saccharomycetes;Saccharomycetales;";"0.0";"0";"1418";"1416";"0";"1416";"2";"455767";"373894"
"V4mis1";"SILVA (only NR);Eukaryota;Amorphea;Obazoa;Opisthokonta;Nucletmycea;Fungi;Dikarya;Ascomycota;Saccharomycotina;Saccharomycetes;Saccharomycetales;Alloascoideaceae;";"0.0";"0";"2";"2";"0";"2";"0";"457181";"373894"
"V4mis1";"SILVA (only NR);Eukaryota;Amorphea;Obazoa;Opisthokonta;Nucletmycea;Fungi;Dikarya;Ascomycota;Saccharomycotina;Saccharomycetes;Saccharomycetales;Alloascoideaceae;Alloascoidea;";"0.0";"0";"2";"2";"0";"2";"0";"457181";"373894"
"V4mis1";"SILVA (only NR);Eukaryota;Amorphea;Obazoa;Opisthokonta;Nucletmycea;Fungi;Dikarya;Ascomycota;Saccharomycotina;Saccharomycetes;Saccharomycetales;Ascoideaceae;";"0.0";"0";"4";"4";"0";"4";"0";"457179";"373894"
"V4mis1";"SILVA (only NR);Eukaryota;Amorphea;Obazoa;Opisthokonta;Nucletmycea;Fungi;Dikarya;Ascomycota;Saccharomycotina;Saccharomycetes;Saccharomycetales;Ascoideaceae;Ascoidea;";"0.0";"0";"2";"2";"0";"2";"0";"457181";"373894"
"V4mis1";"SILVA (only NR);Eukaryota;Amorphea;Obazoa;Opisthokonta;Nucletmycea;Fungi;Dikarya;Ascomycota;Saccharomycotina;Saccharomycetes;Saccharomycetales;Candida;";"0.0";"0";"4";"4";"0";"4";"0";"457179";"373894"
"V4mis1";"SILVA (only NR);Eukaryota;Amorphea;Obazoa;Opisthokonta;Nucletmycea;Fungi;Dikarya;Ascomycota;Saccharomycotina;Saccharomycetes;Saccharomycetales;Cephaloascus;";"0.0";"0";"1";"1";"0";"1";"0";"457182";"373894"
"V4mis1";"SILVA (only NR);Eukaryota;Amorphea;Obazoa;Opisthokonta;Nucletmycea;Fungi;Dikarya;Ascomycota;Saccharomycotina;Saccharomycetes;Saccharomycetales;Debaryomycetaceae;";"0.0";"0";"314";"312";"0";"312";"2";"456871";"373894"
"V4mis1";"SILVA (only NR);Eukaryota;Amorphea;Obazoa;Opisthokonta;Nucletmycea;Fungi;Dikarya;Ascomycota;Saccharomycotina;Saccharomycetes;Saccharomycetales;Debaryomycetaceae;Babjeviella;";"0.0";"0";"3";"3";"0";"3";"0";"457180";"373894"
"V4mis1";"SILVA (only NR);Eukaryota;Amorphea;Obazoa;Opisthokonta;Nucletmycea;Fungi;Dikarya;Ascomycota;Saccharomycotina;Saccharomycetes;Saccharomycetales;Debaryomycetaceae;Candida glaebosa clade;";"0.0";"0";"13";"13";"0";"13";"0";"457170";"373894"
"V4mis1";"SILVA (only NR);Eukaryota;Amorphea;Obazoa;Opisthokonta;Nucletmycea;Fungi;Dikarya;Ascomycota;Saccharomycotina;Saccharomycetes;Saccharomycetales;Debaryomycetaceae;Candida kruisii clade;";"0.0";"0";"5";"5";"0";"5";"0";"457178";"373894"
"V4mis1";"SILVA (only NR);Eukaryota;Amorphea;Obazoa;Opisthokonta;Nucletmycea;Fungi;Dikarya;Ascomycota;Saccharomycotina;Saccharomycetes;Saccharomycetales;Debaryomycetaceae;Candida tanzawaensis clade;";"0.0";"0";"9";"9";"0";"9";"0";"457174";"373894"
"V4mis1";"SILVA (only NR);Eukaryota;Amorphea;Obazoa;Opisthokonta;Nucletmycea;Fungi;Dikarya;Ascomycota;Saccharomycotina;Saccharomycetes;Saccharomycetales;Debaryomycetaceae;Candida-Lodderomyces clade;";"0.0";"0";"65";"65";"0";"65";"0";"457118";"373894"
"V4mis1";"SILVA (only NR);Eukaryota;Amorphea;Obazoa;Opisthokonta;Nucletmycea;Fungi;Dikarya;Ascomycota;Saccharomycotina;Saccharomycetes;Saccharomycetales;Debaryomycetaceae;Debaryomyces;";"0.0";"0";"38";"36";"0";"36";"2";"457147";"373894"
"V4mis1";"SILVA (only NR);Eukaryota;Amorphea;Obazoa;Opisthokonta;Nucletmycea;Fungi;Dikarya;Ascomycota;Saccharomycotina;Saccharomycetes;Saccharomycetales;Debaryomycetaceae;Hypopichia-Candida clade;";"0.0";"0";"13";"13";"0";"13";"0";"457170";"373894"
"V4mis1";"SILVA (only NR);Eukaryota;Amorphea;Obazoa;Opisthokonta;Nucletmycea;Fungi;Dikarya;Ascomycota;Saccharomycotina;Saccharomycetes;Saccharomycetales;Debaryomycetaceae;Kurtzmaniella-Candida clade;";"0.0";"0";"24";"24";"0";"24";"0";"457159";"373894"
"V4mis1";"SILVA (only NR);Eukaryota;Amorphea;Obazoa;Opisthokonta;Nucletmycea;Fungi;Dikarya;Ascomycota;Saccharomycotina;Saccharomycetes;Saccharomycetales;Debaryomycetaceae;Meyerozyma-Candida clade;";"0.0";"0";"34";"34";"0";"34";"0";"457149";"373894"
"V4mis1";"SILVA (only NR);Eukaryota;Amorphea;Obazoa;Opisthokonta;Nucletmycea;Fungi;Dikarya;Ascomycota;Saccharomycotina;Saccharomycetes;Saccharomycetales;Debaryomycetaceae;Millerozyma;";"0.0";"0";"4";"4";"0";"4";"0";"457179";"373894"
"V4mis1";"SILVA (only NR);Eukaryota;Amorphea;Obazoa;Opisthokonta;Nucletmycea;Fungi;Dikarya;Ascomycota;Saccharomycotina;Saccharomycetes;Saccharomycetales;Debaryomycetaceae;Peterozyma;";"0.0";"0";"2";"2";"0";"2";"0";"457181";"373894"
"V4mis1";"SILVA (only NR);Eukaryota;Amorphea;Obazoa;Opisthokonta;Nucletmycea;Fungi;Dikarya;Ascomycota;Saccharomycotina;Saccharomycetes;Saccharomycetales;Debaryomycetaceae;Priceomyces;";"0.0";"0";"8";"8";"0";"8";"0";"457175";"373894"
"V4mis1";"SILVA (only NR);Eukaryota;Amorphea;Obazoa;Opisthokonta;Nucletmycea;Fungi;Dikarya;Ascomycota;Saccharomycotina;Saccharomycetes;Saccharomycetales;Debaryomycetaceae;Scheffersomyces;";"0.0";"0";"34";"34";"0";"34";"0";"457149";"373894"
"V4mis1";"SILVA (only NR);Eukaryota;Amorphea;Obazoa;Opisthokonta;Nucletmycea;Fungi;Dikarya;Ascomycota;Saccharomycotina;Saccharomycetes;Saccharomycetales;Debaryomycetaceae;Schwanniomyces;";"0.0";"0";"12";"12";"0";"12";"0";"457171";"373894"
"V4mis1";"SILVA (only NR);Eukaryota;Amorphea;Obazoa;Opisthokonta;Nucletmycea;Fungi;Dikarya;Ascomycota;Saccharomycotina;Saccharomycetes;Saccharomycetales;Debaryomycetaceae;Spathospora;";"0.0";"0";"6";"6";"0";"6";"0";"457177";"373894"
"V4mis1";"SILVA (only NR);Eukaryota;Amorphea;Obazoa;Opisthokonta;Nucletmycea;Fungi;Dikarya;Ascomycota;Saccharomycotina;Saccharomycetes;Saccharomycetales;Debaryomycetaceae;Yamadazyma-Candida clade;";"0.0";"0";"44";"44";"0";"44";"0";"457139";"373894"
"V4mis1";"SILVA (only NR);Eukaryota;Amorphea;Obazoa;Opisthokonta;Nucletmycea;Fungi;Dikarya;Ascomycota;Saccharomycotina;Saccharomycetes;Saccharomycetales;Dipodascaceae;";"0.0";"0";"60";"60";"0";"60";"0";"457123";"373894"
"V4mis1";"SILVA (only NR);Eukaryota;Amorphea;Obazoa;Opisthokonta;Nucletmycea;Fungi;Dikarya;Ascomycota;Saccharomycotina;Saccharomycetes;Saccharomycetales;Dipodascaceae;Dipodascus;";"0.0";"0";"10";"10";"0";"10";"0";"457173";"373894"
"V4mis1";"SILVA (only NR);Eukaryota;Amorphea;Obazoa;Opisthokonta;Nucletmycea;Fungi;Dikarya;Ascomycota;Saccharomycotina;Saccharomycetes;Saccharomycetales;Dipodascaceae;Galactomyces;";"0.0";"0";"5";"5";"0";"5";"0";"457178";"373894"
"V4mis1";"SILVA (only NR);Eukaryota;Amorphea;Obazoa;Opisthokonta;Nucletmycea;Fungi;Dikarya;Ascomycota;Saccharomycotina;Saccharomycetes;Saccharomycetales;Dipodascaceae;Geotrichum;";"0.0";"0";"13";"13";"0";"13";"0";"457170";"373894"
"V4mis1";"SILVA (only NR);Eukaryota;Amorphea;Obazoa;Opisthokonta;Nucletmycea;Fungi;Dikarya;Ascomycota;Saccharomycotina;Saccharomycetes;Saccharomycetales;Dipodascaceae;Magnusiomyces;";"0.0";"0";"8";"8";"0";"8";"0";"457175";"373894"
"V4mis1";"SILVA (only NR);Eukaryota;Amorphea;Obazoa;Opisthokonta;Nucletmycea;Fungi;Dikarya;Ascomycota;Saccharomycotina;Saccharomycetes;Saccharomycetales;Dipodascaceae;Saprochaete;";"0.0";"0";"4";"4";"0";"4";"0";"457179";"373894"
"V4mis1";"SILVA (only NR);Eukaryota;Amorphea;Obazoa;Opisthokonta;Nucletmycea;Fungi;Dikarya;Ascomycota;Saccharomycotina;Saccharomycetes;Saccharomycetales;Dipodascaceae;Yarrowia;";"0.0";"0";"20";"20";"0";"20";"0";"457163";"373894"
"V4mis1";"SILVA (only NR);Eukaryota;Amorphea;Obazoa;Opisthokonta;Nucletmycea;Fungi;Dikarya;Ascomycota;Saccharomycotina;Saccharomycetes;Saccharomycetales;Endomycetaceae;";"0.0";"0";"2";"2";"0";"2";"0";"457181";"373894"
"V4mis1";"SILVA (only NR);Eukaryota;Amorphea;Obazoa;Opisthokonta;Nucletmycea;Fungi;Dikarya;Ascomycota;Saccharomycotina;Saccharomycetes;Saccharomycetales;Endomycetaceae;Endomyces;";"0.0";"0";"2";"2";"0";"2";"0";"457181";"373894"
"V4mis1";"SILVA (only NR);Eukaryota;Amorphea;Obazoa;Opisthokonta;Nucletmycea;Fungi;Dikarya;Ascomycota;Saccharomycotina;Saccharomycetes;Saccharomycetales;Incertae Sedis;";"0.0";"0";"116";"116";"0";"116";"0";"457067";"373894"
"V4mis1";"SILVA (only NR);Eukaryota;Amorphea;Obazoa;Opisthokonta;Nucletmycea;Fungi;Dikarya;Ascomycota;Saccharomycotina;Saccharomycetes;Saccharomycetales;Incertae Sedis;Ambrosiozyma;";"0.0";"0";"16";"16";"0";"16";"0";"457167";"373894"
"V4mis1";"SILVA (only NR);Eukaryota;Amorphea;Obazoa;Opisthokonta;Nucletmycea;Fungi;Dikarya;Ascomycota;Saccharomycotina;Saccharomycetes;Saccharomycetales;Incertae Sedis;Candida;";"0.0";"0";"53";"53";"0";"53";"0";"457130";"373894"
"V4mis1";"SILVA (only NR);Eukaryota;Amorphea;Obazoa;Opisthokonta;Nucletmycea;Fungi;Dikarya;Ascomycota;Saccharomycotina;Saccharomycetes;Saccharomycetales;Incertae Sedis;Kuraishia;";"0.0";"0";"10";"10";"0";"10";"0";"457173";"373894"
"V4mis1";"SILVA (only NR);Eukaryota;Amorphea;Obazoa;Opisthokonta;Nucletmycea;Fungi;Dikarya;Ascomycota;Saccharomycotina;Saccharomycetes;Saccharomycetales;Incertae Sedis;Middelhovenomyces;";"0.0";"0";"8";"8";"0";"8";"0";"457175";"373894"
"V4mis1";"SILVA (only NR);Eukaryota;Amorphea;Obazoa;Opisthokonta;Nucletmycea;Fungi;Dikarya;Ascomycota;Saccharomycotina;Saccharomycetes;Saccharomycetales;Incertae Sedis;Nadsonia;";"0.0";"0";"2";"2";"0";"2";"0";"457181";"373894"
"V4mis1";"SILVA (only NR);Eukaryota;Amorphea;Obazoa;Opisthokonta;Nucletmycea;Fungi;Dikarya;Ascomycota;Saccharomycotina;Saccharomycetes;Saccharomycetales;Incertae Sedis;Starmerella-Candida clade;";"0.0";"0";"27";"27";"0";"27";"0";"457156";"373894"
"V4mis1";"SILVA (only NR);Eukaryota;Amorphea;Obazoa;Opisthokonta;Nucletmycea;Fungi;Dikarya;Ascomycota;Saccharomycotina;Saccharomycetes;Saccharomycetales;Lipomycetaceae;";"0.0";"0";"31";"31";"0";"31";"0";"457152";"373894"
"V4mis1";"SILVA (only NR);Eukaryota;Amorphea;Obazoa;Opisthokonta;Nucletmycea;Fungi;Dikarya;Ascomycota;Saccharomycotina;Saccharomycetes;Saccharomycetales;Lipomycetaceae;Dipodascopsis;";"0.0";"0";"4";"4";"0";"4";"0";"457179";"373894"
"V4mis1";"SILVA (only NR);Eukaryota;Amorphea;Obazoa;Opisthokonta;Nucletmycea;Fungi;Dikarya;Ascomycota;Saccharomycotina;Saccharomycetes;Saccharomycetales;Lipomycetaceae;Lipomyces;";"0.0";"0";"15";"15";"0";"15";"0";"457168";"373894"
"V4mis1";"SILVA (only NR);Eukaryota;Amorphea;Obazoa;Opisthokonta;Nucletmycea;Fungi;Dikarya;Ascomycota;Saccharomycotina;Saccharomycetes;Saccharomycetales;Lipomycetaceae;Myxozyma;";"0.0";"0";"12";"12";"0";"12";"0";"457171";"373894"
"V4mis1";"SILVA (only NR);Eukaryota;Amorphea;Obazoa;Opisthokonta;Nucletmycea;Fungi;Dikarya;Ascomycota;Saccharomycotina;Saccharomycetes;Saccharomycetales;Metschnikowiaceae;";"0.0";"0";"94";"94";"0";"94";"0";"457089";"373894"
"V4mis1";"SILVA (only NR);Eukaryota;Amorphea;Obazoa;Opisthokonta;Nucletmycea;Fungi;Dikarya;Ascomycota;Saccharomycotina;Saccharomycetes;Saccharomycetales;Metschnikowiaceae;Aciculoconidium;";"0.0";"0";"1";"1";"0";"1";"0";"457182";"373894"
"V4mis1";"SILVA (only NR);Eukaryota;Amorphea;Obazoa;Opisthokonta;Nucletmycea;Fungi;Dikarya;Ascomycota;Saccharomycotina;Saccharomycetes;Saccharomycetales;Metschnikowiaceae;Clavispora-Candida clade;";"0.0";"0";"38";"38";"0";"38";"0";"457145";"373894"
"V4mis1";"SILVA (only NR);Eukaryota;Amorphea;Obazoa;Opisthokonta;Nucletmycea;Fungi;Dikarya;Ascomycota;Saccharomycotina;Saccharomycetes;Saccharomycetales;Metschnikowiaceae;Danielozyma;";"0.0";"0";"2";"2";"0";"2";"0";"457181";"373894"
"V4mis1";"SILVA (only NR);Eukaryota;Amorphea;Obazoa;Opisthokonta;Nucletmycea;Fungi;Dikarya;Ascomycota;Saccharomycotina;Saccharomycetes;Saccharomycetales;Metschnikowiaceae;Kodamaea-Candida clade;";"0.0";"0";"6";"6";"0";"6";"0";"457177";"373894"
"V4mis1";"SILVA (only NR);Eukaryota;Amorphea;Obazoa;Opisthokonta;Nucletmycea;Fungi;Dikarya;Ascomycota;Saccharomycotina;Saccharomycetes;Saccharomycetales;Metschnikowiaceae;Kodamaea;";"0.0";"0";"7";"7";"0";"7";"0";"457176";"373894"
"V4mis1";"SILVA (only NR);Eukaryota;Amorphea;Obazoa;Opisthokonta;Nucletmycea;Fungi;Dikarya;Ascomycota;Saccharomycotina;Saccharomycetes;Saccharomycetales;Metschnikowiaceae;Metschnikowia;";"0.0";"0";"38";"38";"0";"38";"0";"457145";"373894"
"V4mis1";"SILVA (only NR);Eukaryota;Amorphea;Obazoa;Opisthokonta;Nucletmycea;Fungi;Dikarya;Ascomycota;Saccharomycotina;Saccharomycetes;Saccharomycetales;Phaffomycetaceae;";"0.0";"0";"168";"168";"0";"168";"0";"457015";"373894"
"V4mis1";"SILVA (only NR);Eukaryota;Amorphea;Obazoa;Opisthokonta;Nucletmycea;Fungi;Dikarya;Ascomycota;Saccharomycotina;Saccharomycetes;Saccharomycetales;Phaffomycetaceae;Barnettozyma-Candida clade;";"0.0";"0";"14";"14";"0";"14";"0";"457169";"373894"
"V4mis1";"SILVA (only NR);Eukaryota;Amorphea;Obazoa;Opisthokonta;Nucletmycea;Fungi;Dikarya;Ascomycota;Saccharomycotina;Saccharomycetes;Saccharomycetales;Phaffomycetaceae;Cyberlindnera-Candida clade;";"0.0";"0";"43";"43";"0";"43";"0";"457140";"373894"
"V4mis1";"SILVA (only NR);Eukaryota;Amorphea;Obazoa;Opisthokonta;Nucletmycea;Fungi;Dikarya;Ascomycota;Saccharomycotina;Saccharomycetes;Saccharomycetales;Phaffomycetaceae;Cyberlindnera;";"0.0";"0";"2";"2";"0";"2";"0";"457181";"373894"
"V4mis1";"SILVA (only NR);Eukaryota;Amorphea;Obazoa;Opisthokonta;Nucletmycea;Fungi;Dikarya;Ascomycota;Saccharomycotina;Saccharomycetes;Saccharomycetales;Phaffomycetaceae;Deakozyma;";"0.0";"0";"1";"1";"0";"1";"0";"457182";"373894"
"V4mis1";"SILVA (only NR);Eukaryota;Amorphea;Obazoa;Opisthokonta;Nucletmycea;Fungi;Dikarya;Ascomycota;Saccharomycotina;Saccharomycetes;Saccharomycetales;Phaffomycetaceae;Komagataella;";"0.0";"0";"21";"21";"0";"21";"0";"457162";"373894"
"V4mis1";"SILVA (only NR);Eukaryota;Amorphea;Obazoa;Opisthokonta;Nucletmycea;Fungi;Dikarya;Ascomycota;Saccharomycotina;Saccharomycetes;Saccharomycetales;Phaffomycetaceae;Phaffomyces;";"0.0";"0";"11";"11";"0";"11";"0";"457172";"373894"
"V4mis1";"SILVA (only NR);Eukaryota;Amorphea;Obazoa;Opisthokonta;Nucletmycea;Fungi;Dikarya;Ascomycota;Saccharomycotina;Saccharomycetes;Saccharomycetales;Phaffomycetaceae;Starmera-Candida clade;";"0.0";"0";"14";"14";"0";"14";"0";"457169";"373894"
"V4mis1";"SILVA (only NR);Eukaryota;Amorphea;Obazoa;Opisthokonta;Nucletmycea;Fungi;Dikarya;Ascomycota;Saccharomycotina;Saccharomycetes;Saccharomycetales;Phaffomycetaceae;Starmera;";"0.0";"0";"1";"1";"0";"1";"0";"457182";"373894"
"V4mis1";"SILVA (only NR);Eukaryota;Amorphea;Obazoa;Opisthokonta;Nucletmycea;Fungi;Dikarya;Ascomycota;Saccharomycotina;Saccharomycetes;Saccharomycetales;Phaffomycetaceae;Wickerhamomyces-Candida clade;";"0.0";"0";"37";"37";"0";"37";"0";"457146";"373894"
"V4mis1";"SILVA (only NR);Eukaryota;Amorphea;Obazoa;Opisthokonta;Nucletmycea;Fungi;Dikarya;Ascomycota;Saccharomycotina;Saccharomycetes;Saccharomycetales;Phaffomycetaceae;Wickerhamomyces;";"0.0";"0";"18";"18";"0";"18";"0";"457165";"373894"
"V4mis1";"SILVA (only NR);Eukaryota;Amorphea;Obazoa;Opisthokonta;Nucletmycea;Fungi;Dikarya;Ascomycota;Saccharomycotina;Saccharomycetes;Saccharomycetales;Pichiaceae;";"0.0";"0";"219";"219";"0";"219";"0";"456964";"373894"
"V4mis1";"SILVA (only NR);Eukaryota;Amorphea;Obazoa;Opisthokonta;Nucletmycea;Fungi;Dikarya;Ascomycota;Saccharomycotina;Saccharomycetes;Saccharomycetales;Pichiaceae;Brettanomyces;";"0.0";"0";"19";"19";"0";"19";"0";"457164";"373894"
"V4mis1";"SILVA (only NR);Eukaryota;Amorphea;Obazoa;Opisthokonta;Nucletmycea;Fungi;Dikarya;Ascomycota;Saccharomycotina;Saccharomycetes;Saccharomycetales;Pichiaceae;Kregervanrija;";"0.0";"0";"4";"4";"0";"4";"0";"457179";"373894"
"V4mis1";"SILVA (only NR);Eukaryota;Amorphea;Obazoa;Opisthokonta;Nucletmycea;Fungi;Dikarya;Ascomycota;Saccharomycotina;Saccharomycetes;Saccharomycetales;Pichiaceae;Martiniozyma;";"0.0";"0";"4";"4";"0";"4";"0";"457179";"373894"
"V4mis1";"SILVA (only NR);Eukaryota;Amorphea;Obazoa;Opisthokonta;Nucletmycea;Fungi;Dikarya;Ascomycota;Saccharomycotina;Saccharomycetes;Saccharomycetales;Pichiaceae;Nakazawaea;";"0.0";"0";"22";"22";"0";"22";"0";"457161";"373894"
"V4mis1";"SILVA (only NR);Eukaryota;Amorphea;Obazoa;Opisthokonta;Nucletmycea;Fungi;Dikarya;Ascomycota;Saccharomycotina;Saccharomycetes;Saccharomycetales;Pichiaceae;Ogataea-Candida clade;";"0.0";"0";"72";"72";"0";"72";"0";"457111";"373894"
"V4mis1";"SILVA (only NR);Eukaryota;Amorphea;Obazoa;Opisthokonta;Nucletmycea;Fungi;Dikarya;Ascomycota;Saccharomycotina;Saccharomycetes;Saccharomycetales;Pichiaceae;Pichia;";"0.0";"0";"77";"77";"0";"77";"0";"457106";"373894"
"V4mis1";"SILVA (only NR);Eukaryota;Amorphea;Obazoa;Opisthokonta;Nucletmycea;Fungi;Dikarya;Ascomycota;Saccharomycotina;Saccharomycetes;Saccharomycetales;Pichiaceae;Saturnispora;";"0.0";"0";"19";"19";"0";"19";"0";"457164";"373894"
"V4mis1";"SILVA (only NR);Eukaryota;Amorphea;Obazoa;Opisthokonta;Nucletmycea;Fungi;Dikarya;Ascomycota;Saccharomycotina;Saccharomycetes;Saccharomycetales;Saccharomycetaceae;";"0.0";"0";"268";"268";"0";"268";"0";"456915";"373894"
"V4mis1";"SILVA (only NR);Eukaryota;Amorphea;Obazoa;Opisthokonta;Nucletmycea;Fungi;Dikarya;Ascomycota;Saccharomycotina;Saccharomycetes;Saccharomycetales;Saccharomycetaceae;Citeromyces;";"0.0";"0";"9";"9";"0";"9";"0";"457174";"373894"
"V4mis1";"SILVA (only NR);Eukaryota;Amorphea;Obazoa;Opisthokonta;Nucletmycea;Fungi;Dikarya;Ascomycota;Saccharomycotina;Saccharomycetes;Saccharomycetales;Saccharomycetaceae;Cyniclomyces;";"0.0";"0";"1";"1";"0";"1";"0";"457182";"373894"
"V4mis1";"SILVA (only NR);Eukaryota;Amorphea;Obazoa;Opisthokonta;Nucletmycea;Fungi;Dikarya;Ascomycota;Saccharomycotina;Saccharomycetes;Saccharomycetales;Saccharomycetaceae;Eremothecium;";"0.0";"0";"13";"13";"0";"13";"0";"457170";"373894"
"V4mis1";"SILVA (only NR);Eukaryota;Amorphea;Obazoa;Opisthokonta;Nucletmycea;Fungi;Dikarya;Ascomycota;Saccharomycotina;Saccharomycetes;Saccharomycetales;Saccharomycetaceae;Hagleromyces;";"0.0";"0";"1";"1";"0";"1";"0";"457182";"373894"
"V4mis1";"SILVA (only NR);Eukaryota;Amorphea;Obazoa;Opisthokonta;Nucletmycea;Fungi;Dikarya;Ascomycota;Saccharomycotina;Saccharomycetes;Saccharomycetales;Saccharomycetaceae;Issatchenkia;";"0.0";"0";"2";"2";"0";"2";"0";"457181";"373894"
"V4mis1";"SILVA (only NR);Eukaryota;Amorphea;Obazoa;Opisthokonta;Nucletmycea;Fungi;Dikarya;Ascomycota;Saccharomycotina;Saccharomycetes;Saccharomycetales;Saccharomycetaceae;Kazachstania-Candida clade;";"0.0";"0";"29";"29";"0";"29";"0";"457154";"373894"
"V4mis1";"SILVA (only NR);Eukaryota;Amorphea;Obazoa;Opisthokonta;Nucletmycea;Fungi;Dikarya;Ascomycota;Saccharomycotina;Saccharomycetes;Saccharomycetales;Saccharomycetaceae;Kazachstania;";"0.0";"0";"35";"35";"0";"35";"0";"457148";"373894"
"V4mis1";"SILVA (only NR);Eukaryota;Amorphea;Obazoa;Opisthokonta;Nucletmycea;Fungi;Dikarya;Ascomycota;Saccharomycotina;Saccharomycetes;Saccharomycetales;Saccharomycetaceae;Kluyveromyces;";"0.0";"0";"23";"23";"0";"23";"0";"457160";"373894"
"V4mis1";"SILVA (only NR);Eukaryota;Amorphea;Obazoa;Opisthokonta;Nucletmycea;Fungi;Dikarya;Ascomycota;Saccharomycotina;Saccharomycetes;Saccharomycetales;Saccharomycetaceae;Lachancea;";"0.0";"0";"16";"16";"0";"16";"0";"457167";"373894"
"V4mis1";"SILVA (only NR);Eukaryota;Amorphea;Obazoa;Opisthokonta;Nucletmycea;Fungi;Dikarya;Ascomycota;Saccharomycotina;Saccharomycetes;Saccharomycetales;Saccharomycetaceae;Macrorhabdus;";"0.0";"0";"1";"1";"0";"1";"0";"457182";"373894"
"V4mis1";"SILVA (only NR);Eukaryota;Amorphea;Obazoa;Opisthokonta;Nucletmycea;Fungi;Dikarya;Ascomycota;Saccharomycotina;Saccharomycetes;Saccharomycetales;Saccharomycetaceae;Nakaseomyces-Candida clade;";"0.0";"0";"9";"9";"0";"9";"0";"457174";"373894"
"V4mis1";"SILVA (only NR);Eukaryota;Amorphea;Obazoa;Opisthokonta;Nucletmycea;Fungi;Dikarya;Ascomycota;Saccharomycotina;Saccharomycetes;Saccharomycetales;Saccharomycetaceae;Nakaseomyces;";"0.0";"0";"1";"1";"0";"1";"0";"457182";"373894"
"V4mis1";"SILVA (only NR);Eukaryota;Amorphea;Obazoa;Opisthokonta;Nucletmycea;Fungi;Dikarya;Ascomycota;Saccharomycotina;Saccharomycetes;Saccharomycetales;Saccharomycetaceae;Naumovozyma;";"0.0";"0";"6";"6";"0";"6";"0";"457177";"373894"
"V4mis1";"SILVA (only NR);Eukaryota;Amorphea;Obazoa;Opisthokonta;Nucletmycea;Fungi;Dikarya;Ascomycota;Saccharomycotina;Saccharomycetes;Saccharomycetales;Saccharomycetaceae;Pachysolen;";"0.0";"0";"3";"3";"0";"3";"0";"457180";"373894"
"V4mis1";"SILVA (only NR);Eukaryota;Amorphea;Obazoa;Opisthokonta;Nucletmycea;Fungi;Dikarya;Ascomycota;Saccharomycotina;Saccharomycetes;Saccharomycetales;Saccharomycetaceae;Saccharomyces;";"0.0";"0";"49";"49";"0";"49";"0";"457134";"373894"
"V4mis1";"SILVA (only NR);Eukaryota;Amorphea;Obazoa;Opisthokonta;Nucletmycea;Fungi;Dikarya;Ascomycota;Saccharomycotina;Saccharomycetes;Saccharomycetales;Saccharomycetaceae;Tetrapisispora;";"0.0";"0";"15";"15";"0";"15";"0";"457168";"373894"
"V4mis1";"SILVA (only NR);Eukaryota;Amorphea;Obazoa;Opisthokonta;Nucletmycea;Fungi;Dikarya;Ascomycota;Saccharomycotina;Saccharomycetes;Saccharomycetales;Saccharomycetaceae;Torulaspora;";"0.0";"0";"12";"12";"0";"12";"0";"457171";"373894"
"V4mis1";"SILVA (only NR);Eukaryota;Amorphea;Obazoa;Opisthokonta;Nucletmycea;Fungi;Dikarya;Ascomycota;Saccharomycotina;Saccharomycetes;Saccharomycetales;Saccharomycetaceae;Vanderwaltozyma;";"0.0";"0";"11";"11";"0";"11";"0";"457172";"373894"
"V4mis1";"SILVA (only NR);Eukaryota;Amorphea;Obazoa;Opisthokonta;Nucletmycea;Fungi;Dikarya;Ascomycota;Saccharomycotina;Saccharomycetes;Saccharomycetales;Saccharomycetaceae;Yueomyces;";"0.0";"0";"4";"4";"0";"4";"0";"457179";"373894"
"V4mis1";"SILVA (only NR);Eukaryota;Amorphea;Obazoa;Opisthokonta;Nucletmycea;Fungi;Dikarya;Ascomycota;Saccharomycotina;Saccharomycetes;Saccharomycetales;Saccharomycetaceae;Zygosaccharomyces;";"0.0";"0";"26";"26";"0";"26";"0";"457157";"373894"
"V4mis1";"SILVA (only NR);Eukaryota;Amorphea;Obazoa;Opisthokonta;Nucletmycea;Fungi;Dikarya;Ascomycota;Saccharomycotina;Saccharomycetes;Saccharomycetales;Saccharomycetaceae;Zygotorulaspora;";"0.0";"0";"2";"2";"0";"2";"0";"457181";"373894"
"V4mis1";"SILVA (only NR);Eukaryota;Amorphea;Obazoa;Opisthokonta;Nucletmycea;Fungi;Dikarya;Ascomycota;Saccharomycotina;Saccharomycetes;Saccharomycetales;Saccharomycodaceae;";"0.0";"0";"16";"16";"0";"16";"0";"457167";"373894"
"V4mis1";"SILVA (only NR);Eukaryota;Amorphea;Obazoa;Opisthokonta;Nucletmycea;Fungi;Dikarya;Ascomycota;Saccharomycotina;Saccharomycetes;Saccharomycetales;Saccharomycodaceae;Hanseniaspora;";"0.0";"0";"12";"12";"0";"12";"0";"457171";"373894"
"V4mis1";"SILVA (only NR);Eukaryota;Amorphea;Obazoa;Opisthokonta;Nucletmycea;Fungi;Dikarya;Ascomycota;Saccharomycotina;Saccharomycetes;Saccharomycetales;Saccharomycodaceae;Saccharomycodes;";"0.0";"0";"4";"4";"0";"4";"0";"457179";"373894"
"V4mis1";"SILVA (only NR);Eukaryota;Amorphea;Obazoa;Opisthokonta;Nucletmycea;Fungi;Dikarya;Ascomycota;Saccharomycotina;Saccharomycetes;Saccharomycetales;Saccharomycopsidaceae;";"0.0";"0";"25";"25";"0";"25";"0";"457158";"373894"
"V4mis1";"SILVA (only NR);Eukaryota;Amorphea;Obazoa;Opisthokonta;Nucletmycea;Fungi;Dikarya;Ascomycota;Saccharomycotina;Saccharomycetes;Saccharomycetales;Saccharomycopsidaceae;Saccharomycopsis;";"0.0";"0";"25";"25";"0";"25";"0";"457158";"373894"
"V4mis1";"SILVA (only NR);Eukaryota;Amorphea;Obazoa;Opisthokonta;Nucletmycea;Fungi;Dikarya;Ascomycota;Saccharomycotina;Saccharomycetes;Saccharomycetales;Sporopachydermia;";"0.0";"0";"1";"1";"0";"1";"0";"457182";"373894"
"V4mis1";"SILVA (only NR);Eukaryota;Amorphea;Obazoa;Opisthokonta;Nucletmycea;Fungi;Dikarya;Ascomycota;Saccharomycotina;Saccharomycetes;Saccharomycetales;Trichomonascaceae;";"0.0";"0";"79";"79";"0";"79";"0";"457104";"373894"
"V4mis1";"SILVA (only NR);Eukaryota;Amorphea;Obazoa;Opisthokonta;Nucletmycea;Fungi;Dikarya;Ascomycota;Saccharomycotina;Saccharomycetes;Saccharomycetales;Trichomonascaceae;BG02-7-13-27C-2-1;";"0.0";"0";"2";"2";"0";"2";"0";"457181";"373894"
"V4mis1";"SILVA (only NR);Eukaryota;Amorphea;Obazoa;Opisthokonta;Nucletmycea;Fungi;Dikarya;Ascomycota;Saccharomycotina;Saccharomycetes;Saccharomycetales;Trichomonascaceae;Blastobotrys;";"0.0";"0";"5";"5";"0";"5";"0";"457178";"373894"
"V4mis1";"SILVA (only NR);Eukaryota;Amorphea;Obazoa;Opisthokonta;Nucletmycea;Fungi;Dikarya;Ascomycota;Saccharomycotina;Saccharomycetes;Saccharomycetales;Trichomonascaceae;JCM8259;";"0.0";"0";"6";"6";"0";"6";"0";"457177";"373894"
"V4mis1";"SILVA (only NR);Eukaryota;Amorphea;Obazoa;Opisthokonta;Nucletmycea;Fungi;Dikarya;Ascomycota;Saccharomycotina;Saccharomycetes;Saccharomycetales;Trichomonascaceae;Spencermartinsiella;";"0.0";"0";"7";"7";"0";"7";"0";"457176";"373894"
"V4mis1";"SILVA (only NR);Eukaryota;Amorphea;Obazoa;Opisthokonta;Nucletmycea;Fungi;Dikarya;Ascomycota;Saccharomycotina;Saccharomycetes;Saccharomycetales;Trichomonascaceae;Sugiyamaella;";"0.0";"0";"19";"19";"0";"19";"0";"457164";"373894"
"V4mis1";"SILVA (only NR);Eukaryota;Amorphea;Obazoa;Opisthokonta;Nucletmycea;Fungi;Dikarya;Ascomycota;Saccharomycotina;Saccharomycetes;Saccharomycetales;Trichomonascaceae;Trichomonascus;";"0.0";"0";"18";"18";"0";"18";"0";"457165";"373894"
"V4mis1";"SILVA (only NR);Eukaryota;Amorphea;Obazoa;Opisthokonta;Nucletmycea;Fungi;Dikarya;Ascomycota;Saccharomycotina;Saccharomycetes;Saccharomycetales;Trichomonascaceae;Wicherhamiella-Candida clade;";"0.0";"0";"17";"17";"0";"17";"0";"457166";"373894"
"V4mis1";"SILVA (only NR);Eukaryota;Amorphea;Obazoa;Opisthokonta;Nucletmycea;Fungi;Dikarya;Ascomycota;Saccharomycotina;Saccharomycetes;Saccharomycetales;Trichomonascaceae;Zygoascus-Candida clade;";"0.0";"0";"5";"5";"0";"5";"0";"457178";"373894"
"V4mis1";"SILVA (only NR);Eukaryota;Amorphea;Obazoa;Opisthokonta;Nucletmycea;Fungi;Dikarya;Ascomycota;Saccharomycotina;Saccharomycetes;Saccharomycetales;Trigonopsidaceae;";"0.0";"0";"5";"5";"0";"5";"0";"457178";"373894"
"V4mis1";"SILVA (only NR);Eukaryota;Amorphea;Obazoa;Opisthokonta;Nucletmycea;Fungi;Dikarya;Ascomycota;Saccharomycotina;Saccharomycetes;Saccharomycetales;Trigonopsidaceae;Botryozyma;";"0.0";"0";"1";"1";"0";"1";"0";"457182";"373894"
"V4mis1";"SILVA (only NR);Eukaryota;Amorphea;Obazoa;Opisthokonta;Nucletmycea;Fungi;Dikarya;Ascomycota;Saccharomycotina;Saccharomycetes;Saccharomycetales;Trigonopsidaceae;Tortispora;";"0.0";"0";"1";"1";"0";"1";"0";"457182";"373894"
"V4mis1";"SILVA (only NR);Eukaryota;Amorphea;Obazoa;Opisthokonta;Nucletmycea;Fungi;Dikarya;Ascomycota;Saccharomycotina;Saccharomycetes;Saccharomycetales;Trigonopsidaceae;Trigonopsis;";"0.0";"0";"3";"3";"0";"3";"0";"457180";"373894"
"V4mis1";"SILVA (only NR);Eukaryota;Amorphea;Obazoa;Opisthokonta;Nucletmycea;Fungi;Dikarya;Ascomycota;Saccharomycotina;Saccharomycetes;Saccharomycetales;Wickerhamia;";"0.0";"0";"1";"1";"0";"1";"0";"457182";"373894"
"V4mis1";"SILVA (only NR);Eukaryota;Amorphea;Obazoa;Opisthokonta;Nucletmycea;Fungi;Dikarya;Ascomycota;Taphrinomycotina;";"0.0";"0";"68";"67";"0";"67";"1";"457116";"373894"
"V4mis1";"SILVA (only NR);Eukaryota;Amorphea;Obazoa;Opisthokonta;Nucletmycea;Fungi;Dikarya;Ascomycota;Taphrinomycotina;Archaeorhizomycetes;";"0.0";"0";"3";"3";"0";"3";"0";"457180";"373894"
"V4mis1";"SILVA (only NR);Eukaryota;Amorphea;Obazoa;Opisthokonta;Nucletmycea;Fungi;Dikarya;Ascomycota;Taphrinomycotina;Archaeorhizomycetes;Archaeorhizomycetales;";"0.0";"0";"3";"3";"0";"3";"0";"457180";"373894"
"V4mis1";"SILVA (only NR);Eukaryota;Amorphea;Obazoa;Opisthokonta;Nucletmycea;Fungi;Dikarya;Ascomycota;Taphrinomycotina;Archaeorhizomycetes;Archaeorhizomycetales;Archaeorhizomycetaceae;";"0.0";"0";"3";"3";"0";"3";"0";"457180";"373894"
"V4mis1";"SILVA (only NR);Eukaryota;Amorphea;Obazoa;Opisthokonta;Nucletmycea;Fungi;Dikarya;Ascomycota;Taphrinomycotina;Archaeorhizomycetes;Archaeorhizomycetales;Archaeorhizomycetaceae;Archaeorhizomyces;";"0.0";"0";"3";"3";"0";"3";"0";"457180";"373894"
"V4mis1";"SILVA (only NR);Eukaryota;Amorphea;Obazoa;Opisthokonta;Nucletmycea;Fungi;Dikarya;Ascomycota;Taphrinomycotina;Incertae Sedis;";"0.0";"0";"3";"3";"0";"3";"0";"457180";"373894"
"V4mis1";"SILVA (only NR);Eukaryota;Amorphea;Obazoa;Opisthokonta;Nucletmycea;Fungi;Dikarya;Ascomycota;Taphrinomycotina;Incertae Sedis;Incertae Sedis;";"0.0";"0";"3";"3";"0";"3";"0";"457180";"373894"
"V4mis1";"SILVA (only NR);Eukaryota;Amorphea;Obazoa;Opisthokonta;Nucletmycea;Fungi;Dikarya;Ascomycota;Taphrinomycotina;Incertae Sedis;Incertae Sedis;Incertae Sedis;";"0.0";"0";"3";"3";"0";"3";"0";"457180";"373894"
"V4mis1";"SILVA (only NR);Eukaryota;Amorphea;Obazoa;Opisthokonta;Nucletmycea;Fungi;Dikarya;Ascomycota;Taphrinomycotina;Incertae Sedis;Incertae Sedis;Incertae Sedis;Saitoella;";"0.0";"0";"3";"3";"0";"3";"0";"457180";"373894"
"V4mis1";"SILVA (only NR);Eukaryota;Amorphea;Obazoa;Opisthokonta;Nucletmycea;Fungi;Dikarya;Ascomycota;Taphrinomycotina;Neolectomycetes;";"0.0";"0";"1";"1";"0";"1";"0";"457182";"373894"
"V4mis1";"SILVA (only NR);Eukaryota;Amorphea;Obazoa;Opisthokonta;Nucletmycea;Fungi;Dikarya;Ascomycota;Taphrinomycotina;Neolectomycetes;Neolectales;";"0.0";"0";"1";"1";"0";"1";"0";"457182";"373894"
"V4mis1";"SILVA (only NR);Eukaryota;Amorphea;Obazoa;Opisthokonta;Nucletmycea;Fungi;Dikarya;Ascomycota;Taphrinomycotina;Neolectomycetes;Neolectales;Neolectaceae;";"0.0";"0";"1";"1";"0";"1";"0";"457182";"373894"
"V4mis1";"SILVA (only NR);Eukaryota;Amorphea;Obazoa;Opisthokonta;Nucletmycea;Fungi;Dikarya;Ascomycota;Taphrinomycotina;Neolectomycetes;Neolectales;Neolectaceae;Neolecta;";"0.0";"0";"1";"1";"0";"1";"0";"457182";"373894"
"V4mis1";"SILVA (only NR);Eukaryota;Amorphea;Obazoa;Opisthokonta;Nucletmycea;Fungi;Dikarya;Ascomycota;Taphrinomycotina;Pneumocystidomycetes;";"0.0";"0";"6";"6";"0";"6";"0";"457177";"373894"
"V4mis1";"SILVA (only NR);Eukaryota;Amorphea;Obazoa;Opisthokonta;Nucletmycea;Fungi;Dikarya;Ascomycota;Taphrinomycotina;Pneumocystidomycetes;Pneumocystidales;";"0.0";"0";"6";"6";"0";"6";"0";"457177";"373894"
"V4mis1";"SILVA (only NR);Eukaryota;Amorphea;Obazoa;Opisthokonta;Nucletmycea;Fungi;Dikarya;Ascomycota;Taphrinomycotina;Pneumocystidomycetes;Pneumocystidales;Pneumocystidaceae;";"0.0";"0";"6";"6";"0";"6";"0";"457177";"373894"
"V4mis1";"SILVA (only NR);Eukaryota;Amorphea;Obazoa;Opisthokonta;Nucletmycea;Fungi;Dikarya;Ascomycota;Taphrinomycotina;Pneumocystidomycetes;Pneumocystidales;Pneumocystidaceae;Pneumocystis;";"0.0";"0";"6";"6";"0";"6";"0";"457177";"373894"
"V4mis1";"SILVA (only NR);Eukaryota;Amorphea;Obazoa;Opisthokonta;Nucletmycea;Fungi;Dikarya;Ascomycota;Taphrinomycotina;Schizosaccharomycetes;";"0.0";"0";"26";"26";"0";"26";"0";"457157";"373894"
"V4mis1";"SILVA (only NR);Eukaryota;Amorphea;Obazoa;Opisthokonta;Nucletmycea;Fungi;Dikarya;Ascomycota;Taphrinomycotina;Schizosaccharomycetes;Schizosaccharomycetales;";"0.0";"0";"26";"26";"0";"26";"0";"457157";"373894"
"V4mis1";"SILVA (only NR);Eukaryota;Amorphea;Obazoa;Opisthokonta;Nucletmycea;Fungi;Dikarya;Ascomycota;Taphrinomycotina;Schizosaccharomycetes;Schizosaccharomycetales;Schizosaccharomycetaceae;";"0.0";"0";"26";"26";"0";"26";"0";"457157";"373894"
"V4mis1";"SILVA (only NR);Eukaryota;Amorphea;Obazoa;Opisthokonta;Nucletmycea;Fungi;Dikarya;Ascomycota;Taphrinomycotina;Schizosaccharomycetes;Schizosaccharomycetales;Schizosaccharomycetaceae;Schizosaccharomyces;";"0.0";"0";"26";"26";"0";"26";"0";"457157";"373894"
"V4mis1";"SILVA (only NR);Eukaryota;Amorphea;Obazoa;Opisthokonta;Nucletmycea;Fungi;Dikarya;Ascomycota;Taphrinomycotina;Taphrinomycetes;";"0.0";"0";"29";"28";"0";"28";"1";"457155";"373894"
"V4mis1";"SILVA (only NR);Eukaryota;Amorphea;Obazoa;Opisthokonta;Nucletmycea;Fungi;Dikarya;Ascomycota;Taphrinomycotina;Taphrinomycetes;Taphrinales;";"0.0";"0";"29";"28";"0";"28";"1";"457155";"373894"
"V4mis1";"SILVA (only NR);Eukaryota;Amorphea;Obazoa;Opisthokonta;Nucletmycea;Fungi;Dikarya;Ascomycota;Taphrinomycotina;Taphrinomycetes;Taphrinales;Protomycetaceae;";"0.0";"0";"4";"4";"0";"4";"0";"457179";"373894"
"V4mis1";"SILVA (only NR);Eukaryota;Amorphea;Obazoa;Opisthokonta;Nucletmycea;Fungi;Dikarya;Ascomycota;Taphrinomycotina;Taphrinomycetes;Taphrinales;Protomycetaceae;Protomyces;";"0.0";"0";"4";"4";"0";"4";"0";"457179";"373894"
"V4mis1";"SILVA (only NR);Eukaryota;Amorphea;Obazoa;Opisthokonta;Nucletmycea;Fungi;Dikarya;Ascomycota;Taphrinomycotina;Taphrinomycetes;Taphrinales;Taphrinaceae;";"0.0";"0";"23";"23";"0";"23";"0";"457160";"373894"
"V4mis1";"SILVA (only NR);Eukaryota;Amorphea;Obazoa;Opisthokonta;Nucletmycea;Fungi;Dikarya;Ascomycota;Taphrinomycotina;Taphrinomycetes;Taphrinales;Taphrinaceae;Taphrina;";"0.0";"0";"23";"23";"0";"23";"0";"457160";"373894"
"V4mis1";"SILVA (only NR);Eukaryota;Amorphea;Obazoa;Opisthokonta;Nucletmycea;Fungi;Dikarya;Basidiomycota;";"3.1";"17.8";"2538";"2521";"79";"2442";"17";"454662";"373815"
"V4mis1";"SILVA (only NR);Eukaryota;Amorphea;Obazoa;Opisthokonta;Nucletmycea;Fungi;Dikarya;Basidiomycota;Agaricomycotina;";"4.3";"18";"1366";"1353";"58";"1295";"13";"455830";"373836"
"V4mis1";"SILVA (only NR);Eukaryota;Amorphea;Obazoa;Opisthokonta;Nucletmycea;Fungi;Dikarya;Basidiomycota;Agaricomycotina;Agaricomycetes;";"0.4";"18.1";"864";"851";"3";"848";"13";"456332";"373891"
"V4mis1";"SILVA (only NR);Eukaryota;Amorphea;Obazoa;Opisthokonta;Nucletmycea;Fungi;Dikarya;Basidiomycota;Agaricomycotina;Agaricomycetes;Agaricales;";"0.0";"0";"303";"301";"0";"301";"2";"456882";"373894"
"V4mis1";"SILVA (only NR);Eukaryota;Amorphea;Obazoa;Opisthokonta;Nucletmycea;Fungi;Dikarya;Basidiomycota;Agaricomycotina;Agaricomycetes;Agaricales;Agaricaceae;";"0.0";"0";"11";"11";"0";"11";"0";"457172";"373894"
"V4mis1";"SILVA (only NR);Eukaryota;Amorphea;Obazoa;Opisthokonta;Nucletmycea;Fungi;Dikarya;Basidiomycota;Agaricomycotina;Agaricomycetes;Agaricales;Agaricaceae;Agaricus;";"0.0";"0";"4";"4";"0";"4";"0";"457179";"373894"
"V4mis1";"SILVA (only NR);Eukaryota;Amorphea;Obazoa;Opisthokonta;Nucletmycea;Fungi;Dikarya;Basidiomycota;Agaricomycotina;Agaricomycetes;Agaricales;Agaricaceae;Leucoagaricus;";"0.0";"0";"5";"5";"0";"5";"0";"457178";"373894"
"V4mis1";"SILVA (only NR);Eukaryota;Amorphea;Obazoa;Opisthokonta;Nucletmycea;Fungi;Dikarya;Basidiomycota;Agaricomycotina;Agaricomycetes;Agaricales;Agaricaceae;Macrolepiota;";"0.0";"0";"1";"1";"0";"1";"0";"457182";"373894"
"V4mis1";"SILVA (only NR);Eukaryota;Amorphea;Obazoa;Opisthokonta;Nucletmycea;Fungi;Dikarya;Basidiomycota;Agaricomycotina;Agaricomycetes;Agaricales;Agrocybe;";"0.0";"0";"1";"1";"0";"1";"0";"457182";"373894"
"V4mis1";"SILVA (only NR);Eukaryota;Amorphea;Obazoa;Opisthokonta;Nucletmycea;Fungi;Dikarya;Basidiomycota;Agaricomycotina;Agaricomycetes;Agaricales;Amanitaceae;";"0.0";"0";"8";"8";"0";"8";"0";"457175";"373894"
"V4mis1";"SILVA (only NR);Eukaryota;Amorphea;Obazoa;Opisthokonta;Nucletmycea;Fungi;Dikarya;Basidiomycota;Agaricomycotina;Agaricomycetes;Agaricales;Amanitaceae;Amanita;";"0.0";"0";"8";"8";"0";"8";"0";"457175";"373894"
"V4mis1";"SILVA (only NR);Eukaryota;Amorphea;Obazoa;Opisthokonta;Nucletmycea;Fungi;Dikarya;Basidiomycota;Agaricomycotina;Agaricomycetes;Agaricales;Ampulloclitocybe;";"0.0";"0";"1";"1";"0";"1";"0";"457182";"373894"
"V4mis1";"SILVA (only NR);Eukaryota;Amorphea;Obazoa;Opisthokonta;Nucletmycea;Fungi;Dikarya;Basidiomycota;Agaricomycotina;Agaricomycetes;Agaricales;Baeospora;";"0.0";"0";"1";"1";"0";"1";"0";"457182";"373894"
"V4mis1";"SILVA (only NR);Eukaryota;Amorphea;Obazoa;Opisthokonta;Nucletmycea;Fungi;Dikarya;Basidiomycota;Agaricomycotina;Agaricomycetes;Agaricales;Bolbitiaceae;";"0.0";"0";"3";"3";"0";"3";"0";"457180";"373894"
"V4mis1";"SILVA (only NR);Eukaryota;Amorphea;Obazoa;Opisthokonta;Nucletmycea;Fungi;Dikarya;Basidiomycota;Agaricomycotina;Agaricomycetes;Agaricales;Bolbitiaceae;Conocybe;";"0.0";"0";"3";"3";"0";"3";"0";"457180";"373894"
"V4mis1";"SILVA (only NR);Eukaryota;Amorphea;Obazoa;Opisthokonta;Nucletmycea;Fungi;Dikarya;Basidiomycota;Agaricomycotina;Agaricomycetes;Agaricales;Bolbitius;";"0.0";"0";"2";"2";"0";"2";"0";"457181";"373894"
"V4mis1";"SILVA (only NR);Eukaryota;Amorphea;Obazoa;Opisthokonta;Nucletmycea;Fungi;Dikarya;Basidiomycota;Agaricomycotina;Agaricomycetes;Agaricales;Calathella;";"0.0";"0";"1";"1";"0";"1";"0";"457182";"373894"
"V4mis1";"SILVA (only NR);Eukaryota;Amorphea;Obazoa;Opisthokonta;Nucletmycea;Fungi;Dikarya;Basidiomycota;Agaricomycotina;Agaricomycetes;Agaricales;Calvatia;";"0.0";"0";"1";"1";"0";"1";"0";"457182";"373894"
"V4mis1";"SILVA (only NR);Eukaryota;Amorphea;Obazoa;Opisthokonta;Nucletmycea;Fungi;Dikarya;Basidiomycota;Agaricomycotina;Agaricomycetes;Agaricales;Catathelasma;";"0.0";"0";"1";"1";"0";"1";"0";"457182";"373894"
"V4mis1";"SILVA (only NR);Eukaryota;Amorphea;Obazoa;Opisthokonta;Nucletmycea;Fungi;Dikarya;Basidiomycota;Agaricomycotina;Agaricomycetes;Agaricales;Chamaeota;";"0.0";"0";"1";"1";"0";"1";"0";"457182";"373894"
"V4mis1";"SILVA (only NR);Eukaryota;Amorphea;Obazoa;Opisthokonta;Nucletmycea;Fungi;Dikarya;Basidiomycota;Agaricomycotina;Agaricomycetes;Agaricales;Chlorophyllum;";"0.0";"0";"1";"1";"0";"1";"0";"457182";"373894"
"V4mis1";"SILVA (only NR);Eukaryota;Amorphea;Obazoa;Opisthokonta;Nucletmycea;Fungi;Dikarya;Basidiomycota;Agaricomycotina;Agaricomycetes;Agaricales;Chondrostereum;";"0.0";"0";"1";"1";"0";"1";"0";"457182";"373894"
"V4mis1";"SILVA (only NR);Eukaryota;Amorphea;Obazoa;Opisthokonta;Nucletmycea;Fungi;Dikarya;Basidiomycota;Agaricomycotina;Agaricomycetes;Agaricales;Chromosera;";"0.0";"0";"1";"1";"0";"1";"0";"457182";"373894"
"V4mis1";"SILVA (only NR);Eukaryota;Amorphea;Obazoa;Opisthokonta;Nucletmycea;Fungi;Dikarya;Basidiomycota;Agaricomycotina;Agaricomycetes;Agaricales;Chrysomphalina;";"0.0";"0";"2";"2";"0";"2";"0";"457181";"373894"
"V4mis1";"SILVA (only NR);Eukaryota;Amorphea;Obazoa;Opisthokonta;Nucletmycea;Fungi;Dikarya;Basidiomycota;Agaricomycotina;Agaricomycetes;Agaricales;Clavaria;";"0.0";"0";"1";"1";"0";"1";"0";"457182";"373894"
"V4mis1";"SILVA (only NR);Eukaryota;Amorphea;Obazoa;Opisthokonta;Nucletmycea;Fungi;Dikarya;Basidiomycota;Agaricomycotina;Agaricomycetes;Agaricales;Clitocybe;";"0.0";"0";"2";"2";"0";"2";"0";"457181";"373894"
"V4mis1";"SILVA (only NR);Eukaryota;Amorphea;Obazoa;Opisthokonta;Nucletmycea;Fungi;Dikarya;Basidiomycota;Agaricomycotina;Agaricomycetes;Agaricales;Coprinopsis;";"0.0";"0";"2";"2";"0";"2";"0";"457181";"373894"
"V4mis1";"SILVA (only NR);Eukaryota;Amorphea;Obazoa;Opisthokonta;Nucletmycea;Fungi;Dikarya;Basidiomycota;Agaricomycotina;Agaricomycetes;Agaricales;Corneriella;";"0.0";"0";"1";"1";"0";"1";"0";"457182";"373894"
"V4mis1";"SILVA (only NR);Eukaryota;Amorphea;Obazoa;Opisthokonta;Nucletmycea;Fungi;Dikarya;Basidiomycota;Agaricomycotina;Agaricomycetes;Agaricales;Cortinariaceae;";"0.0";"0";"4";"4";"0";"4";"0";"457179";"373894"
"V4mis1";"SILVA (only NR);Eukaryota;Amorphea;Obazoa;Opisthokonta;Nucletmycea;Fungi;Dikarya;Basidiomycota;Agaricomycotina;Agaricomycetes;Agaricales;Cortinariaceae;Cortinarius;";"0.0";"0";"4";"4";"0";"4";"0";"457179";"373894"
"V4mis1";"SILVA (only NR);Eukaryota;Amorphea;Obazoa;Opisthokonta;Nucletmycea;Fungi;Dikarya;Basidiomycota;Agaricomycotina;Agaricomycetes;Agaricales;Crepidotaceae;";"0.0";"0";"2";"2";"0";"2";"0";"457181";"373894"
"V4mis1";"SILVA (only NR);Eukaryota;Amorphea;Obazoa;Opisthokonta;Nucletmycea;Fungi;Dikarya;Basidiomycota;Agaricomycotina;Agaricomycetes;Agaricales;Crepidotaceae;Crepidotus;";"0.0";"0";"1";"1";"0";"1";"0";"457182";"373894"
"V4mis1";"SILVA (only NR);Eukaryota;Amorphea;Obazoa;Opisthokonta;Nucletmycea;Fungi;Dikarya;Basidiomycota;Agaricomycotina;Agaricomycetes;Agaricales;Cuphophyllus;";"0.0";"0";"1";"1";"0";"1";"0";"457182";"373894"
"V4mis1";"SILVA (only NR);Eukaryota;Amorphea;Obazoa;Opisthokonta;Nucletmycea;Fungi;Dikarya;Basidiomycota;Agaricomycotina;Agaricomycetes;Agaricales;Cyathus;";"0.0";"0";"1";"1";"0";"1";"0";"457182";"373894"
"V4mis1";"SILVA (only NR);Eukaryota;Amorphea;Obazoa;Opisthokonta;Nucletmycea;Fungi;Dikarya;Basidiomycota;Agaricomycotina;Agaricomycetes;Agaricales;Cyphellaceae;";"0.0";"0";"3";"3";"0";"3";"0";"457180";"373894"
"V4mis1";"SILVA (only NR);Eukaryota;Amorphea;Obazoa;Opisthokonta;Nucletmycea;Fungi;Dikarya;Basidiomycota;Agaricomycotina;Agaricomycetes;Agaricales;Cyphellaceae;Cyphellopsis;";"0.0";"0";"1";"1";"0";"1";"0";"457182";"373894"
"V4mis1";"SILVA (only NR);Eukaryota;Amorphea;Obazoa;Opisthokonta;Nucletmycea;Fungi;Dikarya;Basidiomycota;Agaricomycotina;Agaricomycetes;Agaricales;Cyphellaceae;Globulicium;";"0.0";"0";"1";"1";"0";"1";"0";"457182";"373894"
"V4mis1";"SILVA (only NR);Eukaryota;Amorphea;Obazoa;Opisthokonta;Nucletmycea;Fungi;Dikarya;Basidiomycota;Agaricomycotina;Agaricomycetes;Agaricales;Cyphellaceae;Halocyphina;";"0.0";"0";"1";"1";"0";"1";"0";"457182";"373894"
"V4mis1";"SILVA (only NR);Eukaryota;Amorphea;Obazoa;Opisthokonta;Nucletmycea;Fungi;Dikarya;Basidiomycota;Agaricomycotina;Agaricomycetes;Agaricales;Cystoderma;";"0.0";"0";"1";"1";"0";"1";"0";"457182";"373894"
"V4mis1";"SILVA (only NR);Eukaryota;Amorphea;Obazoa;Opisthokonta;Nucletmycea;Fungi;Dikarya;Basidiomycota;Agaricomycotina;Agaricomycetes;Agaricales;Entolomataceae;";"0.0";"0";"9";"9";"0";"9";"0";"457174";"373894"
"V4mis1";"SILVA (only NR);Eukaryota;Amorphea;Obazoa;Opisthokonta;Nucletmycea;Fungi;Dikarya;Basidiomycota;Agaricomycotina;Agaricomycetes;Agaricales;Entolomataceae;Clitopilus;";"0.0";"0";"2";"2";"0";"2";"0";"457181";"373894"
"V4mis1";"SILVA (only NR);Eukaryota;Amorphea;Obazoa;Opisthokonta;Nucletmycea;Fungi;Dikarya;Basidiomycota;Agaricomycotina;Agaricomycetes;Agaricales;Entolomataceae;Entoloma;";"0.0";"0";"4";"4";"0";"4";"0";"457179";"373894"
"V4mis1";"SILVA (only NR);Eukaryota;Amorphea;Obazoa;Opisthokonta;Nucletmycea;Fungi;Dikarya;Basidiomycota;Agaricomycotina;Agaricomycetes;Agaricales;Entolomataceae;Rhodocybe;";"0.0";"0";"1";"1";"0";"1";"0";"457182";"373894"
"V4mis1";"SILVA (only NR);Eukaryota;Amorphea;Obazoa;Opisthokonta;Nucletmycea;Fungi;Dikarya;Basidiomycota;Agaricomycotina;Agaricomycetes;Agaricales;Entolomataceae;Rhodocybella;";"0.0";"0";"1";"1";"0";"1";"0";"457182";"373894"
"V4mis1";"SILVA (only NR);Eukaryota;Amorphea;Obazoa;Opisthokonta;Nucletmycea;Fungi;Dikarya;Basidiomycota;Agaricomycotina;Agaricomycetes;Agaricales;Entolomataceae;Richoniella;";"0.0";"0";"1";"1";"0";"1";"0";"457182";"373894"
"V4mis1";"SILVA (only NR);Eukaryota;Amorphea;Obazoa;Opisthokonta;Nucletmycea;Fungi;Dikarya;Basidiomycota;Agaricomycotina;Agaricomycetes;Agaricales;Favolaschia;";"0.0";"0";"1";"1";"0";"1";"0";"457182";"373894"
"V4mis1";"SILVA (only NR);Eukaryota;Amorphea;Obazoa;Opisthokonta;Nucletmycea;Fungi;Dikarya;Basidiomycota;Agaricomycotina;Agaricomycetes;Agaricales;Fistulinaceae;";"0.0";"0";"4";"4";"0";"4";"0";"457179";"373894"
"V4mis1";"SILVA (only NR);Eukaryota;Amorphea;Obazoa;Opisthokonta;Nucletmycea;Fungi;Dikarya;Basidiomycota;Agaricomycotina;Agaricomycetes;Agaricales;Fistulinaceae;Fistulina;";"0.0";"0";"4";"4";"0";"4";"0";"457179";"373894"
"V4mis1";"SILVA (only NR);Eukaryota;Amorphea;Obazoa;Opisthokonta;Nucletmycea;Fungi;Dikarya;Basidiomycota;Agaricomycotina;Agaricomycetes;Agaricales;Galerina;";"0.0";"0";"1";"1";"0";"1";"0";"457182";"373894"
"V4mis1";"SILVA (only NR);Eukaryota;Amorphea;Obazoa;Opisthokonta;Nucletmycea;Fungi;Dikarya;Basidiomycota;Agaricomycotina;Agaricomycetes;Agaricales;Guyanagarika;";"0.0";"0";"1";"1";"0";"1";"0";"457182";"373894"
"V4mis1";"SILVA (only NR);Eukaryota;Amorphea;Obazoa;Opisthokonta;Nucletmycea;Fungi;Dikarya;Basidiomycota;Agaricomycotina;Agaricomycetes;Agaricales;Hebeloma;";"0.0";"0";"1";"1";"0";"1";"0";"457182";"373894"
"V4mis1";"SILVA (only NR);Eukaryota;Amorphea;Obazoa;Opisthokonta;Nucletmycea;Fungi;Dikarya;Basidiomycota;Agaricomycotina;Agaricomycetes;Agaricales;Henningsomyces;";"0.0";"0";"1";"1";"0";"1";"0";"457182";"373894"
"V4mis1";"SILVA (only NR);Eukaryota;Amorphea;Obazoa;Opisthokonta;Nucletmycea;Fungi;Dikarya;Basidiomycota;Agaricomycotina;Agaricomycetes;Agaricales;Hodophilus;";"0.0";"0";"1";"1";"0";"1";"0";"457182";"373894"
"V4mis1";"SILVA (only NR);Eukaryota;Amorphea;Obazoa;Opisthokonta;Nucletmycea;Fungi;Dikarya;Basidiomycota;Agaricomycotina;Agaricomycetes;Agaricales;Hohenbuehelia;";"0.0";"0";"1";"1";"0";"1";"0";"457182";"373894"
"V4mis1";"SILVA (only NR);Eukaryota;Amorphea;Obazoa;Opisthokonta;Nucletmycea;Fungi;Dikarya;Basidiomycota;Agaricomycotina;Agaricomycetes;Agaricales;Hygrophoraceae;";"0.0";"0";"29";"29";"0";"29";"0";"457154";"373894"
"V4mis1";"SILVA (only NR);Eukaryota;Amorphea;Obazoa;Opisthokonta;Nucletmycea;Fungi;Dikarya;Basidiomycota;Agaricomycotina;Agaricomycetes;Agaricales;Hygrophoraceae;Dictyonema;";"0.0";"0";"3";"3";"0";"3";"0";"457180";"373894"
"V4mis1";"SILVA (only NR);Eukaryota;Amorphea;Obazoa;Opisthokonta;Nucletmycea;Fungi;Dikarya;Basidiomycota;Agaricomycotina;Agaricomycetes;Agaricales;Hygrophoraceae;Gliophorus;";"0.0";"0";"5";"5";"0";"5";"0";"457178";"373894"
"V4mis1";"SILVA (only NR);Eukaryota;Amorphea;Obazoa;Opisthokonta;Nucletmycea;Fungi;Dikarya;Basidiomycota;Agaricomycotina;Agaricomycetes;Agaricales;Hygrophoraceae;Humidicutis;";"0.0";"0";"2";"2";"0";"2";"0";"457181";"373894"
"V4mis1";"SILVA (only NR);Eukaryota;Amorphea;Obazoa;Opisthokonta;Nucletmycea;Fungi;Dikarya;Basidiomycota;Agaricomycotina;Agaricomycetes;Agaricales;Hygrophoraceae;Hygroaster;";"0.0";"0";"2";"2";"0";"2";"0";"457181";"373894"
"V4mis1";"SILVA (only NR);Eukaryota;Amorphea;Obazoa;Opisthokonta;Nucletmycea;Fungi;Dikarya;Basidiomycota;Agaricomycotina;Agaricomycetes;Agaricales;Hygrophoraceae;Hygrocybe;";"0.0";"0";"11";"11";"0";"11";"0";"457172";"373894"
"V4mis1";"SILVA (only NR);Eukaryota;Amorphea;Obazoa;Opisthokonta;Nucletmycea;Fungi;Dikarya;Basidiomycota;Agaricomycotina;Agaricomycetes;Agaricales;Hygrophoraceae;Hygrophorus;";"0.0";"0";"5";"5";"0";"5";"0";"457178";"373894"
"V4mis1";"SILVA (only NR);Eukaryota;Amorphea;Obazoa;Opisthokonta;Nucletmycea;Fungi;Dikarya;Basidiomycota;Agaricomycotina;Agaricomycetes;Agaricales;Hygrophoraceae;Typhula;";"0.0";"0";"1";"1";"0";"1";"0";"457182";"373894"
"V4mis1";"SILVA (only NR);Eukaryota;Amorphea;Obazoa;Opisthokonta;Nucletmycea;Fungi;Dikarya;Basidiomycota;Agaricomycotina;Agaricomycetes;Agaricales;Incertae Sedis;";"0.0";"0";"1";"1";"0";"1";"0";"457182";"373894"
"V4mis1";"SILVA (only NR);Eukaryota;Amorphea;Obazoa;Opisthokonta;Nucletmycea;Fungi;Dikarya;Basidiomycota;Agaricomycotina;Agaricomycetes;Agaricales;Incertae Sedis;Dendrothele;";"0.0";"0";"1";"1";"0";"1";"0";"457182";"373894"
"V4mis1";"SILVA (only NR);Eukaryota;Amorphea;Obazoa;Opisthokonta;Nucletmycea;Fungi;Dikarya;Basidiomycota;Agaricomycotina;Agaricomycetes;Agaricales;Inocybaceae;";"0.0";"0";"5";"5";"0";"5";"0";"457178";"373894"
"V4mis1";"SILVA (only NR);Eukaryota;Amorphea;Obazoa;Opisthokonta;Nucletmycea;Fungi;Dikarya;Basidiomycota;Agaricomycotina;Agaricomycetes;Agaricales;Inocybaceae;Inocybe;";"0.0";"0";"5";"5";"0";"5";"0";"457178";"373894"
"V4mis1";"SILVA (only NR);Eukaryota;Amorphea;Obazoa;Opisthokonta;Nucletmycea;Fungi;Dikarya;Basidiomycota;Agaricomycotina;Agaricomycetes;Agaricales;Limnoperdon;";"0.0";"0";"1";"1";"0";"1";"0";"457182";"373894"
"V4mis1";"SILVA (only NR);Eukaryota;Amorphea;Obazoa;Opisthokonta;Nucletmycea;Fungi;Dikarya;Basidiomycota;Agaricomycotina;Agaricomycetes;Agaricales;Lyophyllaceae;";"0.0";"0";"4";"4";"0";"4";"0";"457179";"373894"
"V4mis1";"SILVA (only NR);Eukaryota;Amorphea;Obazoa;Opisthokonta;Nucletmycea;Fungi;Dikarya;Basidiomycota;Agaricomycotina;Agaricomycetes;Agaricales;Lyophyllaceae;Asterophora;";"0.0";"0";"3";"3";"0";"3";"0";"457180";"373894"
"V4mis1";"SILVA (only NR);Eukaryota;Amorphea;Obazoa;Opisthokonta;Nucletmycea;Fungi;Dikarya;Basidiomycota;Agaricomycotina;Agaricomycetes;Agaricales;Lyophyllaceae;Hypsizygus;";"0.0";"0";"1";"1";"0";"1";"0";"457182";"373894"
"V4mis1";"SILVA (only NR);Eukaryota;Amorphea;Obazoa;Opisthokonta;Nucletmycea;Fungi;Dikarya;Basidiomycota;Agaricomycotina;Agaricomycetes;Agaricales;Lyophyllum;";"0.0";"0";"2";"2";"0";"2";"0";"457181";"373894"
"V4mis1";"SILVA (only NR);Eukaryota;Amorphea;Obazoa;Opisthokonta;Nucletmycea;Fungi;Dikarya;Basidiomycota;Agaricomycotina;Agaricomycetes;Agaricales;Marasmiaceae;";"0.0";"0";"15";"15";"0";"15";"0";"457168";"373894"
"V4mis1";"SILVA (only NR);Eukaryota;Amorphea;Obazoa;Opisthokonta;Nucletmycea;Fungi;Dikarya;Basidiomycota;Agaricomycotina;Agaricomycetes;Agaricales;Marasmiaceae;Campanella;";"0.0";"0";"1";"1";"0";"1";"0";"457182";"373894"
"V4mis1";"SILVA (only NR);Eukaryota;Amorphea;Obazoa;Opisthokonta;Nucletmycea;Fungi;Dikarya;Basidiomycota;Agaricomycotina;Agaricomycetes;Agaricales;Marasmiaceae;Chaetocalathus;";"0.0";"0";"1";"1";"0";"1";"0";"457182";"373894"
"V4mis1";"SILVA (only NR);Eukaryota;Amorphea;Obazoa;Opisthokonta;Nucletmycea;Fungi;Dikarya;Basidiomycota;Agaricomycotina;Agaricomycetes;Agaricales;Marasmiaceae;Crinipellis;";"0.0";"0";"1";"1";"0";"1";"0";"457182";"373894"
"V4mis1";"SILVA (only NR);Eukaryota;Amorphea;Obazoa;Opisthokonta;Nucletmycea;Fungi;Dikarya;Basidiomycota;Agaricomycotina;Agaricomycetes;Agaricales;Marasmiaceae;Marasmius;";"0.0";"0";"3";"3";"0";"3";"0";"457180";"373894"
"V4mis1";"SILVA (only NR);Eukaryota;Amorphea;Obazoa;Opisthokonta;Nucletmycea;Fungi;Dikarya;Basidiomycota;Agaricomycotina;Agaricomycetes;Agaricales;Marasmiaceae;Moniliophthora;";"0.0";"0";"2";"2";"0";"2";"0";"457181";"373894"
"V4mis1";"SILVA (only NR);Eukaryota;Amorphea;Obazoa;Opisthokonta;Nucletmycea;Fungi;Dikarya;Basidiomycota;Agaricomycotina;Agaricomycetes;Agaricales;Marasmiaceae;Neocampanella;";"0.0";"0";"1";"1";"0";"1";"0";"457182";"373894"
"V4mis1";"SILVA (only NR);Eukaryota;Amorphea;Obazoa;Opisthokonta;Nucletmycea;Fungi;Dikarya;Basidiomycota;Agaricomycotina;Agaricomycetes;Agaricales;Marasmiaceae;uncultured;";"0.0";"0";"5";"5";"0";"5";"0";"457178";"373894"
"V4mis1";"SILVA (only NR);Eukaryota;Amorphea;Obazoa;Opisthokonta;Nucletmycea;Fungi;Dikarya;Basidiomycota;Agaricomycotina;Agaricomycetes;Agaricales;Megacollybia;";"0.0";"0";"1";"1";"0";"1";"0";"457182";"373894"
"V4mis1";"SILVA (only NR);Eukaryota;Amorphea;Obazoa;Opisthokonta;Nucletmycea;Fungi;Dikarya;Basidiomycota;Agaricomycotina;Agaricomycetes;Agaricales;Mycocalia;";"0.0";"0";"1";"1";"0";"1";"0";"457182";"373894"
"V4mis1";"SILVA (only NR);Eukaryota;Amorphea;Obazoa;Opisthokonta;Nucletmycea;Fungi;Dikarya;Basidiomycota;Agaricomycotina;Agaricomycetes;Agaricales;Neohygrocybe;";"0.0";"0";"3";"3";"0";"3";"0";"457180";"373894"
"V4mis1";"SILVA (only NR);Eukaryota;Amorphea;Obazoa;Opisthokonta;Nucletmycea;Fungi;Dikarya;Basidiomycota;Agaricomycotina;Agaricomycetes;Agaricales;Nia;";"0.0";"0";"1";"1";"0";"1";"0";"457182";"373894"
"V4mis1";"SILVA (only NR);Eukaryota;Amorphea;Obazoa;Opisthokonta;Nucletmycea;Fungi;Dikarya;Basidiomycota;Agaricomycotina;Agaricomycetes;Agaricales;Nidula;";"0.0";"0";"1";"1";"0";"1";"0";"457182";"373894"
"V4mis1";"SILVA (only NR);Eukaryota;Amorphea;Obazoa;Opisthokonta;Nucletmycea;Fungi;Dikarya;Basidiomycota;Agaricomycotina;Agaricomycetes;Agaricales;Omphalotaceae;";"0.0";"0";"9";"8";"0";"8";"1";"457175";"373894"
"V4mis1";"SILVA (only NR);Eukaryota;Amorphea;Obazoa;Opisthokonta;Nucletmycea;Fungi;Dikarya;Basidiomycota;Agaricomycotina;Agaricomycetes;Agaricales;Omphalotaceae;Collybia;";"0.0";"0";"1";"1";"0";"1";"0";"457182";"373894"
"V4mis1";"SILVA (only NR);Eukaryota;Amorphea;Obazoa;Opisthokonta;Nucletmycea;Fungi;Dikarya;Basidiomycota;Agaricomycotina;Agaricomycetes;Agaricales;Omphalotaceae;Gymnopus;";"0.0";"0";"2";"2";"0";"2";"0";"457181";"373894"
"V4mis1";"SILVA (only NR);Eukaryota;Amorphea;Obazoa;Opisthokonta;Nucletmycea;Fungi;Dikarya;Basidiomycota;Agaricomycotina;Agaricomycetes;Agaricales;Omphalotaceae;Lentinula;";"0.0";"0";"3";"2";"0";"2";"1";"457181";"373894"
"V4mis1";"SILVA (only NR);Eukaryota;Amorphea;Obazoa;Opisthokonta;Nucletmycea;Fungi;Dikarya;Basidiomycota;Agaricomycotina;Agaricomycetes;Agaricales;Omphalotaceae;Omphalotus;";"0.0";"0";"1";"1";"0";"1";"0";"457182";"373894"
"V4mis1";"SILVA (only NR);Eukaryota;Amorphea;Obazoa;Opisthokonta;Nucletmycea;Fungi;Dikarya;Basidiomycota;Agaricomycotina;Agaricomycetes;Agaricales;Omphalotaceae;uncultured;";"0.0";"0";"2";"2";"0";"2";"0";"457181";"373894"
"V4mis1";"SILVA (only NR);Eukaryota;Amorphea;Obazoa;Opisthokonta;Nucletmycea;Fungi;Dikarya;Basidiomycota;Agaricomycotina;Agaricomycetes;Agaricales;Pholiotina;";"0.0";"0";"1";"1";"0";"1";"0";"457182";"373894"
"V4mis1";"SILVA (only NR);Eukaryota;Amorphea;Obazoa;Opisthokonta;Nucletmycea;Fungi;Dikarya;Basidiomycota;Agaricomycotina;Agaricomycetes;Agaricales;Physalacriaceae;";"0.0";"0";"7";"7";"0";"7";"0";"457176";"373894"
"V4mis1";"SILVA (only NR);Eukaryota;Amorphea;Obazoa;Opisthokonta;Nucletmycea;Fungi;Dikarya;Basidiomycota;Agaricomycotina;Agaricomycetes;Agaricales;Physalacriaceae;Armillaria;";"0.0";"0";"1";"1";"0";"1";"0";"457182";"373894"
"V4mis1";"SILVA (only NR);Eukaryota;Amorphea;Obazoa;Opisthokonta;Nucletmycea;Fungi;Dikarya;Basidiomycota;Agaricomycotina;Agaricomycetes;Agaricales;Physalacriaceae;Cylindrobasidium;";"0.0";"0";"1";"1";"0";"1";"0";"457182";"373894"
"V4mis1";"SILVA (only NR);Eukaryota;Amorphea;Obazoa;Opisthokonta;Nucletmycea;Fungi;Dikarya;Basidiomycota;Agaricomycotina;Agaricomycetes;Agaricales;Physalacriaceae;Flammulina;";"0.0";"0";"2";"2";"0";"2";"0";"457181";"373894"
"V4mis1";"SILVA (only NR);Eukaryota;Amorphea;Obazoa;Opisthokonta;Nucletmycea;Fungi;Dikarya;Basidiomycota;Agaricomycotina;Agaricomycetes;Agaricales;Physalacriaceae;Hymenopellis;";"0.0";"0";"1";"1";"0";"1";"0";"457182";"373894"
"V4mis1";"SILVA (only NR);Eukaryota;Amorphea;Obazoa;Opisthokonta;Nucletmycea;Fungi;Dikarya;Basidiomycota;Agaricomycotina;Agaricomycetes;Agaricales;Physalacriaceae;Mycotribulus;";"0.0";"0";"1";"1";"0";"1";"0";"457182";"373894"
"V4mis1";"SILVA (only NR);Eukaryota;Amorphea;Obazoa;Opisthokonta;Nucletmycea;Fungi;Dikarya;Basidiomycota;Agaricomycotina;Agaricomycetes;Agaricales;Physalacriaceae;Physalacria;";"0.0";"0";"1";"1";"0";"1";"0";"457182";"373894"
"V4mis1";"SILVA (only NR);Eukaryota;Amorphea;Obazoa;Opisthokonta;Nucletmycea;Fungi;Dikarya;Basidiomycota;Agaricomycotina;Agaricomycetes;Agaricales;Pleuroflammula;";"0.0";"0";"1";"1";"0";"1";"0";"457182";"373894"
"V4mis1";"SILVA (only NR);Eukaryota;Amorphea;Obazoa;Opisthokonta;Nucletmycea;Fungi;Dikarya;Basidiomycota;Agaricomycotina;Agaricomycetes;Agaricales;Pleurotaceae;";"0.0";"0";"8";"8";"0";"8";"0";"457175";"373894"
"V4mis1";"SILVA (only NR);Eukaryota;Amorphea;Obazoa;Opisthokonta;Nucletmycea;Fungi;Dikarya;Basidiomycota;Agaricomycotina;Agaricomycetes;Agaricales;Pleurotaceae;Pleurotus;";"0.0";"0";"8";"8";"0";"8";"0";"457175";"373894"
"V4mis1";"SILVA (only NR);Eukaryota;Amorphea;Obazoa;Opisthokonta;Nucletmycea;Fungi;Dikarya;Basidiomycota;Agaricomycotina;Agaricomycetes;Agaricales;Pleurotopsis;";"0.0";"0";"1";"1";"0";"1";"0";"457182";"373894"
"V4mis1";"SILVA (only NR);Eukaryota;Amorphea;Obazoa;Opisthokonta;Nucletmycea;Fungi;Dikarya;Basidiomycota;Agaricomycotina;Agaricomycetes;Agaricales;Plicaturopsis;";"0.0";"0";"1";"1";"0";"1";"0";"457182";"373894"
"V4mis1";"SILVA (only NR);Eukaryota;Amorphea;Obazoa;Opisthokonta;Nucletmycea;Fungi;Dikarya;Basidiomycota;Agaricomycotina;Agaricomycetes;Agaricales;Pluteaceae;";"0.0";"0";"9";"9";"0";"9";"0";"457174";"373894"
"V4mis1";"SILVA (only NR);Eukaryota;Amorphea;Obazoa;Opisthokonta;Nucletmycea;Fungi;Dikarya;Basidiomycota;Agaricomycotina;Agaricomycetes;Agaricales;Pluteaceae;Pluteus;";"0.0";"0";"4";"4";"0";"4";"0";"457179";"373894"
"V4mis1";"SILVA (only NR);Eukaryota;Amorphea;Obazoa;Opisthokonta;Nucletmycea;Fungi;Dikarya;Basidiomycota;Agaricomycotina;Agaricomycetes;Agaricales;Pluteaceae;Volvariella;";"0.0";"0";"5";"5";"0";"5";"0";"457178";"373894"
"V4mis1";"SILVA (only NR);Eukaryota;Amorphea;Obazoa;Opisthokonta;Nucletmycea;Fungi;Dikarya;Basidiomycota;Agaricomycotina;Agaricomycetes;Agaricales;Psathyrellaceae;";"0.0";"0";"2";"2";"0";"2";"0";"457181";"373894"
"V4mis1";"SILVA (only NR);Eukaryota;Amorphea;Obazoa;Opisthokonta;Nucletmycea;Fungi;Dikarya;Basidiomycota;Agaricomycotina;Agaricomycetes;Agaricales;Psathyrellaceae;Psathyrella;";"0.0";"0";"2";"2";"0";"2";"0";"457181";"373894"
"V4mis1";"SILVA (only NR);Eukaryota;Amorphea;Obazoa;Opisthokonta;Nucletmycea;Fungi;Dikarya;Basidiomycota;Agaricomycotina;Agaricomycetes;Agaricales;Pseudoomphalina;";"0.0";"0";"1";"1";"0";"1";"0";"457182";"373894"
"V4mis1";"SILVA (only NR);Eukaryota;Amorphea;Obazoa;Opisthokonta;Nucletmycea;Fungi;Dikarya;Basidiomycota;Agaricomycotina;Agaricomycetes;Agaricales;Pseudotricholoma;";"0.0";"0";"1";"1";"0";"1";"0";"457182";"373894"
"V4mis1";"SILVA (only NR);Eukaryota;Amorphea;Obazoa;Opisthokonta;Nucletmycea;Fungi;Dikarya;Basidiomycota;Agaricomycotina;Agaricomycetes;Agaricales;Pterulaceae;";"0.0";"0";"3";"3";"0";"3";"0";"457180";"373894"
"V4mis1";"SILVA (only NR);Eukaryota;Amorphea;Obazoa;Opisthokonta;Nucletmycea;Fungi;Dikarya;Basidiomycota;Agaricomycotina;Agaricomycetes;Agaricales;Pterulaceae;Aphanobasidium;";"0.0";"0";"1";"1";"0";"1";"0";"457182";"373894"
"V4mis1";"SILVA (only NR);Eukaryota;Amorphea;Obazoa;Opisthokonta;Nucletmycea;Fungi;Dikarya;Basidiomycota;Agaricomycotina;Agaricomycetes;Agaricales;Pterulaceae;Pterula;";"0.0";"0";"1";"1";"0";"1";"0";"457182";"373894"
"V4mis1";"SILVA (only NR);Eukaryota;Amorphea;Obazoa;Opisthokonta;Nucletmycea;Fungi;Dikarya;Basidiomycota;Agaricomycotina;Agaricomycetes;Agaricales;Rugosomyces;";"0.0";"0";"1";"1";"0";"1";"0";"457182";"373894"
"V4mis1";"SILVA (only NR);Eukaryota;Amorphea;Obazoa;Opisthokonta;Nucletmycea;Fungi;Dikarya;Basidiomycota;Agaricomycotina;Agaricomycetes;Agaricales;Sarcomyxa;";"0.0";"0";"1";"1";"0";"1";"0";"457182";"373894"
"V4mis1";"SILVA (only NR);Eukaryota;Amorphea;Obazoa;Opisthokonta;Nucletmycea;Fungi;Dikarya;Basidiomycota;Agaricomycotina;Agaricomycetes;Agaricales;Schizophyllaceae;";"0.0";"0";"5";"5";"0";"5";"0";"457178";"373894"
"V4mis1";"SILVA (only NR);Eukaryota;Amorphea;Obazoa;Opisthokonta;Nucletmycea;Fungi;Dikarya;Basidiomycota;Agaricomycotina;Agaricomycetes;Agaricales;Schizophyllaceae;Grifola;";"0.0";"0";"2";"2";"0";"2";"0";"457181";"373894"
"V4mis1";"SILVA (only NR);Eukaryota;Amorphea;Obazoa;Opisthokonta;Nucletmycea;Fungi;Dikarya;Basidiomycota;Agaricomycotina;Agaricomycetes;Agaricales;Schizophyllaceae;Schizophyllum;";"0.0";"0";"3";"3";"0";"3";"0";"457180";"373894"
"V4mis1";"SILVA (only NR);Eukaryota;Amorphea;Obazoa;Opisthokonta;Nucletmycea;Fungi;Dikarya;Basidiomycota;Agaricomycotina;Agaricomycetes;Agaricales;Serendipita;";"0.0";"0";"1";"1";"0";"1";"0";"457182";"373894"
"V4mis1";"SILVA (only NR);Eukaryota;Amorphea;Obazoa;Opisthokonta;Nucletmycea;Fungi;Dikarya;Basidiomycota;Agaricomycotina;Agaricomycetes;Agaricales;Stephanospora;";"0.0";"0";"1";"1";"0";"1";"0";"457182";"373894"
"V4mis1";"SILVA (only NR);Eukaryota;Amorphea;Obazoa;Opisthokonta;Nucletmycea;Fungi;Dikarya;Basidiomycota;Agaricomycotina;Agaricomycetes;Agaricales;Stropharia;";"0.0";"0";"2";"2";"0";"2";"0";"457181";"373894"
"V4mis1";"SILVA (only NR);Eukaryota;Amorphea;Obazoa;Opisthokonta;Nucletmycea;Fungi;Dikarya;Basidiomycota;Agaricomycotina;Agaricomycetes;Agaricales;Strophariaceae;";"0.0";"0";"3";"3";"0";"3";"0";"457180";"373894"
"V4mis1";"SILVA (only NR);Eukaryota;Amorphea;Obazoa;Opisthokonta;Nucletmycea;Fungi;Dikarya;Basidiomycota;Agaricomycotina;Agaricomycetes;Agaricales;Strophariaceae;Phaeomarasmius;";"0.0";"0";"1";"1";"0";"1";"0";"457182";"373894"
"V4mis1";"SILVA (only NR);Eukaryota;Amorphea;Obazoa;Opisthokonta;Nucletmycea;Fungi;Dikarya;Basidiomycota;Agaricomycotina;Agaricomycetes;Agaricales;Strophariaceae;Tubaria;";"0.0";"0";"2";"2";"0";"2";"0";"457181";"373894"
"V4mis1";"SILVA (only NR);Eukaryota;Amorphea;Obazoa;Opisthokonta;Nucletmycea;Fungi;Dikarya;Basidiomycota;Agaricomycotina;Agaricomycetes;Agaricales;Tephrocybe;";"0.0";"0";"1";"1";"0";"1";"0";"457182";"373894"
"V4mis1";"SILVA (only NR);Eukaryota;Amorphea;Obazoa;Opisthokonta;Nucletmycea;Fungi;Dikarya;Basidiomycota;Agaricomycotina;Agaricomycetes;Agaricales;Termitomyces;";"0.0";"0";"1";"1";"0";"1";"0";"457182";"373894"
"V4mis1";"SILVA (only NR);Eukaryota;Amorphea;Obazoa;Opisthokonta;Nucletmycea;Fungi;Dikarya;Basidiomycota;Agaricomycotina;Agaricomycetes;Agaricales;Tricholoma;";"0.0";"0";"1";"1";"0";"1";"0";"457182";"373894"
"V4mis1";"SILVA (only NR);Eukaryota;Amorphea;Obazoa;Opisthokonta;Nucletmycea;Fungi;Dikarya;Basidiomycota;Agaricomycotina;Agaricomycetes;Agaricales;Tricholomataceae;";"0.0";"0";"54";"54";"0";"54";"0";"457129";"373894"
"V4mis1";"SILVA (only NR);Eukaryota;Amorphea;Obazoa;Opisthokonta;Nucletmycea;Fungi;Dikarya;Basidiomycota;Agaricomycotina;Agaricomycetes;Agaricales;Tricholomataceae;Albomagister;";"0.0";"0";"1";"1";"0";"1";"0";"457182";"373894"
"V4mis1";"SILVA (only NR);Eukaryota;Amorphea;Obazoa;Opisthokonta;Nucletmycea;Fungi;Dikarya;Basidiomycota;Agaricomycotina;Agaricomycetes;Agaricales;Tricholomataceae;Alloclavaria;";"0.0";"0";"1";"1";"0";"1";"0";"457182";"373894"
"V4mis1";"SILVA (only NR);Eukaryota;Amorphea;Obazoa;Opisthokonta;Nucletmycea;Fungi;Dikarya;Basidiomycota;Agaricomycotina;Agaricomycetes;Agaricales;Tricholomataceae;Callistosporium;";"0.0";"0";"1";"1";"0";"1";"0";"457182";"373894"
"V4mis1";"SILVA (only NR);Eukaryota;Amorphea;Obazoa;Opisthokonta;Nucletmycea;Fungi;Dikarya;Basidiomycota;Agaricomycotina;Agaricomycetes;Agaricales;Tricholomataceae;Camarophyllopsis;";"0.0";"0";"1";"1";"0";"1";"0";"457182";"373894"
"V4mis1";"SILVA (only NR);Eukaryota;Amorphea;Obazoa;Opisthokonta;Nucletmycea;Fungi;Dikarya;Basidiomycota;Agaricomycotina;Agaricomycetes;Agaricales;Tricholomataceae;Camarophyllus;";"0.0";"0";"2";"2";"0";"2";"0";"457181";"373894"
"V4mis1";"SILVA (only NR);Eukaryota;Amorphea;Obazoa;Opisthokonta;Nucletmycea;Fungi;Dikarya;Basidiomycota;Agaricomycotina;Agaricomycetes;Agaricales;Tricholomataceae;Cheimonophyllum;";"0.0";"0";"1";"1";"0";"1";"0";"457182";"373894"
"V4mis1";"SILVA (only NR);Eukaryota;Amorphea;Obazoa;Opisthokonta;Nucletmycea;Fungi;Dikarya;Basidiomycota;Agaricomycotina;Agaricomycetes;Agaricales;Tricholomataceae;Cleistocybe;";"0.0";"0";"1";"1";"0";"1";"0";"457182";"373894"
"V4mis1";"SILVA (only NR);Eukaryota;Amorphea;Obazoa;Opisthokonta;Nucletmycea;Fungi;Dikarya;Basidiomycota;Agaricomycotina;Agaricomycetes;Agaricales;Tricholomataceae;Cystostereum;";"0.0";"0";"1";"1";"0";"1";"0";"457182";"373894"
"V4mis1";"SILVA (only NR);Eukaryota;Amorphea;Obazoa;Opisthokonta;Nucletmycea;Fungi;Dikarya;Basidiomycota;Agaricomycotina;Agaricomycetes;Agaricales;Tricholomataceae;Dendrocollybia;";"0.0";"0";"1";"1";"0";"1";"0";"457182";"373894"
"V4mis1";"SILVA (only NR);Eukaryota;Amorphea;Obazoa;Opisthokonta;Nucletmycea;Fungi;Dikarya;Basidiomycota;Agaricomycotina;Agaricomycetes;Agaricales;Tricholomataceae;Granulobasidium;";"0.0";"0";"1";"1";"0";"1";"0";"457182";"373894"
"V4mis1";"SILVA (only NR);Eukaryota;Amorphea;Obazoa;Opisthokonta;Nucletmycea;Fungi;Dikarya;Basidiomycota;Agaricomycotina;Agaricomycetes;Agaricales;Tricholomataceae;Hemimycena;";"0.0";"0";"1";"1";"0";"1";"0";"457182";"373894"
"V4mis1";"SILVA (only NR);Eukaryota;Amorphea;Obazoa;Opisthokonta;Nucletmycea;Fungi;Dikarya;Basidiomycota;Agaricomycotina;Agaricomycetes;Agaricales;Tricholomataceae;Hydropus;";"0.0";"0";"2";"2";"0";"2";"0";"457181";"373894"
"V4mis1";"SILVA (only NR);Eukaryota;Amorphea;Obazoa;Opisthokonta;Nucletmycea;Fungi;Dikarya;Basidiomycota;Agaricomycotina;Agaricomycetes;Agaricales;Tricholomataceae;Infundibulicybe;";"0.0";"0";"1";"1";"0";"1";"0";"457182";"373894"
"V4mis1";"SILVA (only NR);Eukaryota;Amorphea;Obazoa;Opisthokonta;Nucletmycea;Fungi;Dikarya;Basidiomycota;Agaricomycotina;Agaricomycetes;Agaricales;Tricholomataceae;Lachnella;";"0.0";"0";"1";"1";"0";"1";"0";"457182";"373894"
"V4mis1";"SILVA (only NR);Eukaryota;Amorphea;Obazoa;Opisthokonta;Nucletmycea;Fungi;Dikarya;Basidiomycota;Agaricomycotina;Agaricomycetes;Agaricales;Tricholomataceae;Laetiporus;";"0.0";"0";"1";"1";"0";"1";"0";"457182";"373894"
"V4mis1";"SILVA (only NR);Eukaryota;Amorphea;Obazoa;Opisthokonta;Nucletmycea;Fungi;Dikarya;Basidiomycota;Agaricomycotina;Agaricomycetes;Agaricales;Tricholomataceae;Leucopaxillus;";"0.0";"0";"3";"3";"0";"3";"0";"457180";"373894"
"V4mis1";"SILVA (only NR);Eukaryota;Amorphea;Obazoa;Opisthokonta;Nucletmycea;Fungi;Dikarya;Basidiomycota;Agaricomycotina;Agaricomycetes;Agaricales;Tricholomataceae;Lichenomphalia;";"0.0";"0";"3";"3";"0";"3";"0";"457180";"373894"
"V4mis1";"SILVA (only NR);Eukaryota;Amorphea;Obazoa;Opisthokonta;Nucletmycea;Fungi;Dikarya;Basidiomycota;Agaricomycotina;Agaricomycetes;Agaricales;Tricholomataceae;Melanoleuca;";"0.0";"0";"1";"1";"0";"1";"0";"457182";"373894"
"V4mis1";"SILVA (only NR);Eukaryota;Amorphea;Obazoa;Opisthokonta;Nucletmycea;Fungi;Dikarya;Basidiomycota;Agaricomycotina;Agaricomycetes;Agaricales;Tricholomataceae;Mycena;";"0.0";"0";"3";"3";"0";"3";"0";"457180";"373894"
"V4mis1";"SILVA (only NR);Eukaryota;Amorphea;Obazoa;Opisthokonta;Nucletmycea;Fungi;Dikarya;Basidiomycota;Agaricomycotina;Agaricomycetes;Agaricales;Tricholomataceae;Panellus;";"0.0";"0";"1";"1";"0";"1";"0";"457182";"373894"
"V4mis1";"SILVA (only NR);Eukaryota;Amorphea;Obazoa;Opisthokonta;Nucletmycea;Fungi;Dikarya;Basidiomycota;Agaricomycotina;Agaricomycetes;Agaricales;Tricholomataceae;Phyllotopsis;";"0.0";"0";"1";"1";"0";"1";"0";"457182";"373894"
"V4mis1";"SILVA (only NR);Eukaryota;Amorphea;Obazoa;Opisthokonta;Nucletmycea;Fungi;Dikarya;Basidiomycota;Agaricomycotina;Agaricomycetes;Agaricales;Tricholomataceae;Pleurocybella;";"0.0";"0";"1";"1";"0";"1";"0";"457182";"373894"
"V4mis1";"SILVA (only NR);Eukaryota;Amorphea;Obazoa;Opisthokonta;Nucletmycea;Fungi;Dikarya;Basidiomycota;Agaricomycotina;Agaricomycetes;Agaricales;Tricholomataceae;Pogonoloma;";"0.0";"0";"1";"1";"0";"1";"0";"457182";"373894"
"V4mis1";"SILVA (only NR);Eukaryota;Amorphea;Obazoa;Opisthokonta;Nucletmycea;Fungi;Dikarya;Basidiomycota;Agaricomycotina;Agaricomycetes;Agaricales;Tricholomataceae;Porpoloma;";"0.0";"0";"1";"1";"0";"1";"0";"457182";"373894"
"V4mis1";"SILVA (only NR);Eukaryota;Amorphea;Obazoa;Opisthokonta;Nucletmycea;Fungi;Dikarya;Basidiomycota;Agaricomycotina;Agaricomycetes;Agaricales;Tricholomataceae;Porpolomopsis;";"0.0";"0";"1";"1";"0";"1";"0";"457182";"373894"
"V4mis1";"SILVA (only NR);Eukaryota;Amorphea;Obazoa;Opisthokonta;Nucletmycea;Fungi;Dikarya;Basidiomycota;Agaricomycotina;Agaricomycetes;Agaricales;Tricholomataceae;Pseudoarmillariella;";"0.0";"0";"1";"1";"0";"1";"0";"457182";"373894"
"V4mis1";"SILVA (only NR);Eukaryota;Amorphea;Obazoa;Opisthokonta;Nucletmycea;Fungi;Dikarya;Basidiomycota;Agaricomycotina;Agaricomycetes;Agaricales;Tricholomataceae;Pseudobaeospora;";"0.0";"0";"2";"2";"0";"2";"0";"457181";"373894"
"V4mis1";"SILVA (only NR);Eukaryota;Amorphea;Obazoa;Opisthokonta;Nucletmycea;Fungi;Dikarya;Basidiomycota;Agaricomycotina;Agaricomycetes;Agaricales;Tricholomataceae;Pseudoclitocybe;";"0.0";"0";"1";"1";"0";"1";"0";"457182";"373894"
"V4mis1";"SILVA (only NR);Eukaryota;Amorphea;Obazoa;Opisthokonta;Nucletmycea;Fungi;Dikarya;Basidiomycota;Agaricomycotina;Agaricomycetes;Agaricales;Tricholomataceae;Pseudolaccaria;";"0.0";"0";"1";"1";"0";"1";"0";"457182";"373894"
"V4mis1";"SILVA (only NR);Eukaryota;Amorphea;Obazoa;Opisthokonta;Nucletmycea;Fungi;Dikarya;Basidiomycota;Agaricomycotina;Agaricomycetes;Agaricales;Tricholomataceae;Singerocybe;";"0.0";"0";"1";"1";"0";"1";"0";"457182";"373894"
"V4mis1";"SILVA (only NR);Eukaryota;Amorphea;Obazoa;Opisthokonta;Nucletmycea;Fungi;Dikarya;Basidiomycota;Agaricomycotina;Agaricomycetes;Agaricales;Tricholomataceae;Squamanita;";"0.0";"0";"1";"1";"0";"1";"0";"457182";"373894"
"V4mis1";"SILVA (only NR);Eukaryota;Amorphea;Obazoa;Opisthokonta;Nucletmycea;Fungi;Dikarya;Basidiomycota;Agaricomycotina;Agaricomycetes;Agaricales;Tricholomataceae;Tricholoma;";"0.0";"0";"5";"5";"0";"5";"0";"457178";"373894"
"V4mis1";"SILVA (only NR);Eukaryota;Amorphea;Obazoa;Opisthokonta;Nucletmycea;Fungi;Dikarya;Basidiomycota;Agaricomycotina;Agaricomycetes;Agaricales;Tricholomataceae;Tricholomopsis;";"0.0";"0";"1";"1";"0";"1";"0";"457182";"373894"
"V4mis1";"SILVA (only NR);Eukaryota;Amorphea;Obazoa;Opisthokonta;Nucletmycea;Fungi;Dikarya;Basidiomycota;Agaricomycotina;Agaricomycetes;Agaricales;Tulostoma;";"0.0";"0";"1";"1";"0";"1";"0";"457182";"373894"
"V4mis1";"SILVA (only NR);Eukaryota;Amorphea;Obazoa;Opisthokonta;Nucletmycea;Fungi;Dikarya;Basidiomycota;Agaricomycotina;Agaricomycetes;Agaricales;Verrucospora;";"0.0";"0";"1";"1";"0";"1";"0";"457182";"373894"
"V4mis1";"SILVA (only NR);Eukaryota;Amorphea;Obazoa;Opisthokonta;Nucletmycea;Fungi;Dikarya;Basidiomycota;Agaricomycotina;Agaricomycetes;Agaricales;uncultured;";"0.0";"0";"22";"22";"0";"22";"0";"457161";"373894"
"V4mis1";"SILVA (only NR);Eukaryota;Amorphea;Obazoa;Opisthokonta;Nucletmycea;Fungi;Dikarya;Basidiomycota;Agaricomycotina;Agaricomycetes;Amylocorticiales;";"0.0";"0";"4";"4";"0";"4";"0";"457179";"373894"
"V4mis1";"SILVA (only NR);Eukaryota;Amorphea;Obazoa;Opisthokonta;Nucletmycea;Fungi;Dikarya;Basidiomycota;Agaricomycotina;Agaricomycetes;Amylocorticiales;Amylocorticiaceae;";"0.0";"0";"4";"4";"0";"4";"0";"457179";"373894"
"V4mis1";"SILVA (only NR);Eukaryota;Amorphea;Obazoa;Opisthokonta;Nucletmycea;Fungi;Dikarya;Basidiomycota;Agaricomycotina;Agaricomycetes;Amylocorticiales;Amylocorticiaceae;Amylocorticium;";"0.0";"0";"2";"2";"0";"2";"0";"457181";"373894"
"V4mis1";"SILVA (only NR);Eukaryota;Amorphea;Obazoa;Opisthokonta;Nucletmycea;Fungi;Dikarya;Basidiomycota;Agaricomycotina;Agaricomycetes;Amylocorticiales;Amylocorticiaceae;Anomoloma;";"0.0";"0";"1";"1";"0";"1";"0";"457182";"373894"
"V4mis1";"SILVA (only NR);Eukaryota;Amorphea;Obazoa;Opisthokonta;Nucletmycea;Fungi;Dikarya;Basidiomycota;Agaricomycotina;Agaricomycetes;Amylocorticiales;Amylocorticiaceae;Anomoporia;";"0.0";"0";"1";"1";"0";"1";"0";"457182";"373894"
"V4mis1";"SILVA (only NR);Eukaryota;Amorphea;Obazoa;Opisthokonta;Nucletmycea;Fungi;Dikarya;Basidiomycota;Agaricomycotina;Agaricomycetes;Atheliales;";"0.0";"0";"3";"3";"0";"3";"0";"457180";"373894"
"V4mis1";"SILVA (only NR);Eukaryota;Amorphea;Obazoa;Opisthokonta;Nucletmycea;Fungi;Dikarya;Basidiomycota;Agaricomycotina;Agaricomycetes;Atheliales;Atheliaceae;";"0.0";"0";"3";"3";"0";"3";"0";"457180";"373894"
"V4mis1";"SILVA (only NR);Eukaryota;Amorphea;Obazoa;Opisthokonta;Nucletmycea;Fungi;Dikarya;Basidiomycota;Agaricomycotina;Agaricomycetes;Atheliales;Atheliaceae;Athelia;";"0.0";"0";"2";"2";"0";"2";"0";"457181";"373894"
"V4mis1";"SILVA (only NR);Eukaryota;Amorphea;Obazoa;Opisthokonta;Nucletmycea;Fungi;Dikarya;Basidiomycota;Agaricomycotina;Agaricomycetes;Atheliales;Atheliaceae;Piloderma;";"0.0";"0";"1";"1";"0";"1";"0";"457182";"373894"
"V4mis1";"SILVA (only NR);Eukaryota;Amorphea;Obazoa;Opisthokonta;Nucletmycea;Fungi;Dikarya;Basidiomycota;Agaricomycotina;Agaricomycetes;Auriculariales;";"0.0";"0";"26";"26";"0";"26";"0";"457157";"373894"
"V4mis1";"SILVA (only NR);Eukaryota;Amorphea;Obazoa;Opisthokonta;Nucletmycea;Fungi;Dikarya;Basidiomycota;Agaricomycotina;Agaricomycetes;Auriculariales;Auriculariaceae;";"0.0";"0";"14";"14";"0";"14";"0";"457169";"373894"
"V4mis1";"SILVA (only NR);Eukaryota;Amorphea;Obazoa;Opisthokonta;Nucletmycea;Fungi;Dikarya;Basidiomycota;Agaricomycotina;Agaricomycetes;Auriculariales;Auriculariaceae;Auricularia;";"0.0";"0";"14";"14";"0";"14";"0";"457169";"373894"
"V4mis1";"SILVA (only NR);Eukaryota;Amorphea;Obazoa;Opisthokonta;Nucletmycea;Fungi;Dikarya;Basidiomycota;Agaricomycotina;Agaricomycetes;Auriculariales;Exidiaceae;";"0.0";"0";"5";"5";"0";"5";"0";"457178";"373894"
"V4mis1";"SILVA (only NR);Eukaryota;Amorphea;Obazoa;Opisthokonta;Nucletmycea;Fungi;Dikarya;Basidiomycota;Agaricomycotina;Agaricomycetes;Auriculariales;Exidiaceae;Exidia;";"0.0";"0";"3";"3";"0";"3";"0";"457180";"373894"
"V4mis1";"SILVA (only NR);Eukaryota;Amorphea;Obazoa;Opisthokonta;Nucletmycea;Fungi;Dikarya;Basidiomycota;Agaricomycotina;Agaricomycetes;Auriculariales;Exidiaceae;Exidiopsis;";"0.0";"0";"1";"1";"0";"1";"0";"457182";"373894"
"V4mis1";"SILVA (only NR);Eukaryota;Amorphea;Obazoa;Opisthokonta;Nucletmycea;Fungi;Dikarya;Basidiomycota;Agaricomycotina;Agaricomycetes;Auriculariales;Hyaloriaceae;";"0.0";"0";"6";"6";"0";"6";"0";"457177";"373894"
"V4mis1";"SILVA (only NR);Eukaryota;Amorphea;Obazoa;Opisthokonta;Nucletmycea;Fungi;Dikarya;Basidiomycota;Agaricomycotina;Agaricomycetes;Auriculariales;Hyaloriaceae;Pseudohydnum;";"0.0";"0";"2";"2";"0";"2";"0";"457181";"373894"
"V4mis1";"SILVA (only NR);Eukaryota;Amorphea;Obazoa;Opisthokonta;Nucletmycea;Fungi;Dikarya;Basidiomycota;Agaricomycotina;Agaricomycetes;Auriculariales;Hyaloriaceae;Tremiscus;";"0.0";"0";"4";"4";"0";"4";"0";"457179";"373894"
"V4mis1";"SILVA (only NR);Eukaryota;Amorphea;Obazoa;Opisthokonta;Nucletmycea;Fungi;Dikarya;Basidiomycota;Agaricomycotina;Agaricomycetes;Boletales;";"0.0";"0";"55";"53";"0";"53";"2";"457130";"373894"
"V4mis1";"SILVA (only NR);Eukaryota;Amorphea;Obazoa;Opisthokonta;Nucletmycea;Fungi;Dikarya;Basidiomycota;Agaricomycotina;Agaricomycetes;Boletales;Boletaceae;";"0.0";"0";"9";"9";"0";"9";"0";"457174";"373894"
"V4mis1";"SILVA (only NR);Eukaryota;Amorphea;Obazoa;Opisthokonta;Nucletmycea;Fungi;Dikarya;Basidiomycota;Agaricomycotina;Agaricomycetes;Boletales;Boletaceae;Aureoboletus;";"0.0";"0";"1";"1";"0";"1";"0";"457182";"373894"
"V4mis1";"SILVA (only NR);Eukaryota;Amorphea;Obazoa;Opisthokonta;Nucletmycea;Fungi;Dikarya;Basidiomycota;Agaricomycotina;Agaricomycetes;Boletales;Boletaceae;Boletellus;";"0.0";"0";"1";"1";"0";"1";"0";"457182";"373894"
"V4mis1";"SILVA (only NR);Eukaryota;Amorphea;Obazoa;Opisthokonta;Nucletmycea;Fungi;Dikarya;Basidiomycota;Agaricomycotina;Agaricomycetes;Boletales;Boletaceae;Boletus;";"0.0";"0";"3";"3";"0";"3";"0";"457180";"373894"
"V4mis1";"SILVA (only NR);Eukaryota;Amorphea;Obazoa;Opisthokonta;Nucletmycea;Fungi;Dikarya;Basidiomycota;Agaricomycotina;Agaricomycetes;Boletales;Boletaceae;Chalciporus;";"0.0";"0";"1";"1";"0";"1";"0";"457182";"373894"
"V4mis1";"SILVA (only NR);Eukaryota;Amorphea;Obazoa;Opisthokonta;Nucletmycea;Fungi;Dikarya;Basidiomycota;Agaricomycotina;Agaricomycetes;Boletales;Boletaceae;Strobilomyces;";"0.0";"0";"1";"1";"0";"1";"0";"457182";"373894"
"V4mis1";"SILVA (only NR);Eukaryota;Amorphea;Obazoa;Opisthokonta;Nucletmycea;Fungi;Dikarya;Basidiomycota;Agaricomycotina;Agaricomycetes;Boletales;Boletaceae;Tylopilus;";"0.0";"0";"1";"1";"0";"1";"0";"457182";"373894"
"V4mis1";"SILVA (only NR);Eukaryota;Amorphea;Obazoa;Opisthokonta;Nucletmycea;Fungi;Dikarya;Basidiomycota;Agaricomycotina;Agaricomycetes;Boletales;Boletinellaceae;";"0.0";"0";"2";"2";"0";"2";"0";"457181";"373894"
"V4mis1";"SILVA (only NR);Eukaryota;Amorphea;Obazoa;Opisthokonta;Nucletmycea;Fungi;Dikarya;Basidiomycota;Agaricomycotina;Agaricomycetes;Boletales;Boletinellaceae;Boletinellus;";"0.0";"0";"1";"1";"0";"1";"0";"457182";"373894"
"V4mis1";"SILVA (only NR);Eukaryota;Amorphea;Obazoa;Opisthokonta;Nucletmycea;Fungi;Dikarya;Basidiomycota;Agaricomycotina;Agaricomycetes;Boletales;Boletinellaceae;Phlebopus;";"0.0";"0";"1";"1";"0";"1";"0";"457182";"373894"
"V4mis1";"SILVA (only NR);Eukaryota;Amorphea;Obazoa;Opisthokonta;Nucletmycea;Fungi;Dikarya;Basidiomycota;Agaricomycotina;Agaricomycetes;Boletales;Calostoma;";"0.0";"0";"2";"2";"0";"2";"0";"457181";"373894"
"V4mis1";"SILVA (only NR);Eukaryota;Amorphea;Obazoa;Opisthokonta;Nucletmycea;Fungi;Dikarya;Basidiomycota;Agaricomycotina;Agaricomycetes;Boletales;Coniophoraceae;";"0.0";"0";"5";"5";"0";"5";"0";"457178";"373894"
"V4mis1";"SILVA (only NR);Eukaryota;Amorphea;Obazoa;Opisthokonta;Nucletmycea;Fungi;Dikarya;Basidiomycota;Agaricomycotina;Agaricomycetes;Boletales;Coniophoraceae;Coniophora;";"0.0";"0";"4";"4";"0";"4";"0";"457179";"373894"
"V4mis1";"SILVA (only NR);Eukaryota;Amorphea;Obazoa;Opisthokonta;Nucletmycea;Fungi;Dikarya;Basidiomycota;Agaricomycotina;Agaricomycetes;Boletales;Coniophoraceae;Gyrodontium;";"0.0";"0";"1";"1";"0";"1";"0";"457182";"373894"
"V4mis1";"SILVA (only NR);Eukaryota;Amorphea;Obazoa;Opisthokonta;Nucletmycea;Fungi;Dikarya;Basidiomycota;Agaricomycotina;Agaricomycetes;Boletales;Gomphidiaceae;";"0.0";"0";"2";"1";"0";"1";"1";"457182";"373894"
"V4mis1";"SILVA (only NR);Eukaryota;Amorphea;Obazoa;Opisthokonta;Nucletmycea;Fungi;Dikarya;Basidiomycota;Agaricomycotina;Agaricomycetes;Boletales;Gomphidiaceae;Gomphidius;";"0.0";"0";"2";"1";"0";"1";"1";"457182";"373894"
"V4mis1";"SILVA (only NR);Eukaryota;Amorphea;Obazoa;Opisthokonta;Nucletmycea;Fungi;Dikarya;Basidiomycota;Agaricomycotina;Agaricomycetes;Boletales;Gyroporus;";"0.0";"0";"1";"1";"0";"1";"0";"457182";"373894"
"V4mis1";"SILVA (only NR);Eukaryota;Amorphea;Obazoa;Opisthokonta;Nucletmycea;Fungi;Dikarya;Basidiomycota;Agaricomycotina;Agaricomycetes;Boletales;Hygrophoropsis;";"0.0";"0";"1";"1";"0";"1";"0";"457182";"373894"
"V4mis1";"SILVA (only NR);Eukaryota;Amorphea;Obazoa;Opisthokonta;Nucletmycea;Fungi;Dikarya;Basidiomycota;Agaricomycotina;Agaricomycetes;Boletales;Incertae Sedis;";"0.0";"0";"3";"3";"0";"3";"0";"457180";"373894"
"V4mis1";"SILVA (only NR);Eukaryota;Amorphea;Obazoa;Opisthokonta;Nucletmycea;Fungi;Dikarya;Basidiomycota;Agaricomycotina;Agaricomycetes;Boletales;Incertae Sedis;Leucogyrophana;";"0.0";"0";"3";"3";"0";"3";"0";"457180";"373894"
"V4mis1";"SILVA (only NR);Eukaryota;Amorphea;Obazoa;Opisthokonta;Nucletmycea;Fungi;Dikarya;Basidiomycota;Agaricomycotina;Agaricomycetes;Boletales;Melanogaster;";"0.0";"0";"1";"1";"0";"1";"0";"457182";"373894"
"V4mis1";"SILVA (only NR);Eukaryota;Amorphea;Obazoa;Opisthokonta;Nucletmycea;Fungi;Dikarya;Basidiomycota;Agaricomycotina;Agaricomycetes;Boletales;Paxillaceae;";"0.0";"0";"3";"3";"0";"3";"0";"457180";"373894"
"V4mis1";"SILVA (only NR);Eukaryota;Amorphea;Obazoa;Opisthokonta;Nucletmycea;Fungi;Dikarya;Basidiomycota;Agaricomycotina;Agaricomycetes;Boletales;Paxillaceae;Hydnomerulius;";"0.0";"0";"1";"1";"0";"1";"0";"457182";"373894"
"V4mis1";"SILVA (only NR);Eukaryota;Amorphea;Obazoa;Opisthokonta;Nucletmycea;Fungi;Dikarya;Basidiomycota;Agaricomycotina;Agaricomycetes;Boletales;Paxillaceae;Paxillus;";"0.0";"0";"2";"2";"0";"2";"0";"457181";"373894"
"V4mis1";"SILVA (only NR);Eukaryota;Amorphea;Obazoa;Opisthokonta;Nucletmycea;Fungi;Dikarya;Basidiomycota;Agaricomycotina;Agaricomycetes;Boletales;Phylloporus;";"0.0";"0";"1";"1";"0";"1";"0";"457182";"373894"
"V4mis1";"SILVA (only NR);Eukaryota;Amorphea;Obazoa;Opisthokonta;Nucletmycea;Fungi;Dikarya;Basidiomycota;Agaricomycotina;Agaricomycetes;Boletales;Pisolithus;";"0.0";"0";"1";"1";"0";"1";"0";"457182";"373894"
"V4mis1";"SILVA (only NR);Eukaryota;Amorphea;Obazoa;Opisthokonta;Nucletmycea;Fungi;Dikarya;Basidiomycota;Agaricomycotina;Agaricomycetes;Boletales;Rhizopogonaceae;";"0.0";"0";"2";"2";"0";"2";"0";"457181";"373894"
"V4mis1";"SILVA (only NR);Eukaryota;Amorphea;Obazoa;Opisthokonta;Nucletmycea;Fungi;Dikarya;Basidiomycota;Agaricomycotina;Agaricomycetes;Boletales;Rhizopogonaceae;Rhizopogon;";"0.0";"0";"2";"2";"0";"2";"0";"457181";"373894"
"V4mis1";"SILVA (only NR);Eukaryota;Amorphea;Obazoa;Opisthokonta;Nucletmycea;Fungi;Dikarya;Basidiomycota;Agaricomycotina;Agaricomycetes;Boletales;Sclerodermataceae;";"0.0";"0";"2";"2";"0";"2";"0";"457181";"373894"
"V4mis1";"SILVA (only NR);Eukaryota;Amorphea;Obazoa;Opisthokonta;Nucletmycea;Fungi;Dikarya;Basidiomycota;Agaricomycotina;Agaricomycetes;Boletales;Sclerodermataceae;Scleroderma;";"0.0";"0";"2";"2";"0";"2";"0";"457181";"373894"
"V4mis1";"SILVA (only NR);Eukaryota;Amorphea;Obazoa;Opisthokonta;Nucletmycea;Fungi;Dikarya;Basidiomycota;Agaricomycotina;Agaricomycetes;Boletales;Serpulaceae;";"0.0";"0";"7";"7";"0";"7";"0";"457176";"373894"
"V4mis1";"SILVA (only NR);Eukaryota;Amorphea;Obazoa;Opisthokonta;Nucletmycea;Fungi;Dikarya;Basidiomycota;Agaricomycotina;Agaricomycetes;Boletales;Serpulaceae;Serpula;";"0.0";"0";"7";"7";"0";"7";"0";"457176";"373894"
"V4mis1";"SILVA (only NR);Eukaryota;Amorphea;Obazoa;Opisthokonta;Nucletmycea;Fungi;Dikarya;Basidiomycota;Agaricomycotina;Agaricomycetes;Boletales;Suillaceae;";"0.0";"0";"2";"1";"0";"1";"1";"457182";"373894"
"V4mis1";"SILVA (only NR);Eukaryota;Amorphea;Obazoa;Opisthokonta;Nucletmycea;Fungi;Dikarya;Basidiomycota;Agaricomycotina;Agaricomycetes;Boletales;Suillaceae;Suillus;";"0.0";"0";"2";"1";"0";"1";"1";"457182";"373894"
"V4mis1";"SILVA (only NR);Eukaryota;Amorphea;Obazoa;Opisthokonta;Nucletmycea;Fungi;Dikarya;Basidiomycota;Agaricomycotina;Agaricomycetes;Boletales;Tapinella;";"0.0";"0";"1";"1";"0";"1";"0";"457182";"373894"
"V4mis1";"SILVA (only NR);Eukaryota;Amorphea;Obazoa;Opisthokonta;Nucletmycea;Fungi;Dikarya;Basidiomycota;Agaricomycotina;Agaricomycetes;Boletales;Tapinellaceae;";"0.0";"0";"3";"3";"0";"3";"0";"457180";"373894"
"V4mis1";"SILVA (only NR);Eukaryota;Amorphea;Obazoa;Opisthokonta;Nucletmycea;Fungi;Dikarya;Basidiomycota;Agaricomycotina;Agaricomycetes;Boletales;Tapinellaceae;Pseudomerulius;";"0.0";"0";"1";"1";"0";"1";"0";"457182";"373894"
"V4mis1";"SILVA (only NR);Eukaryota;Amorphea;Obazoa;Opisthokonta;Nucletmycea;Fungi;Dikarya;Basidiomycota;Agaricomycotina;Agaricomycetes;Boletales;Tapinellaceae;Tapinella;";"0.0";"0";"2";"2";"0";"2";"0";"457181";"373894"
"V4mis1";"SILVA (only NR);Eukaryota;Amorphea;Obazoa;Opisthokonta;Nucletmycea;Fungi;Dikarya;Basidiomycota;Agaricomycotina;Agaricomycetes;Boletales;Truncocolumella;";"0.0";"0";"1";"1";"0";"1";"0";"457182";"373894"
"V4mis1";"SILVA (only NR);Eukaryota;Amorphea;Obazoa;Opisthokonta;Nucletmycea;Fungi;Dikarya;Basidiomycota;Agaricomycotina;Agaricomycetes;Boletales;uncultured;";"0.0";"0";"5";"5";"0";"5";"0";"457178";"373894"
"V4mis1";"SILVA (only NR);Eukaryota;Amorphea;Obazoa;Opisthokonta;Nucletmycea;Fungi;Dikarya;Basidiomycota;Agaricomycotina;Agaricomycetes;Cantharellales;";"5.6";"18.2";"37";"36";"2";"34";"1";"457147";"373892"
"V4mis1";"SILVA (only NR);Eukaryota;Amorphea;Obazoa;Opisthokonta;Nucletmycea;Fungi;Dikarya;Basidiomycota;Agaricomycotina;Agaricomycetes;Cantharellales;Botryobasidiaceae;";"0.0";"0";"5";"5";"0";"5";"0";"457178";"373894"
"V4mis1";"SILVA (only NR);Eukaryota;Amorphea;Obazoa;Opisthokonta;Nucletmycea;Fungi;Dikarya;Basidiomycota;Agaricomycotina;Agaricomycetes;Cantharellales;Botryobasidiaceae;Botryobasidium;";"0.0";"0";"4";"4";"0";"4";"0";"457179";"373894"
"V4mis1";"SILVA (only NR);Eukaryota;Amorphea;Obazoa;Opisthokonta;Nucletmycea;Fungi;Dikarya;Basidiomycota;Agaricomycotina;Agaricomycetes;Cantharellales;Botryobasidiaceae;Botryohypochnus;";"0.0";"0";"1";"1";"0";"1";"0";"457182";"373894"
"V4mis1";"SILVA (only NR);Eukaryota;Amorphea;Obazoa;Opisthokonta;Nucletmycea;Fungi;Dikarya;Basidiomycota;Agaricomycotina;Agaricomycetes;Cantharellales;Cantharellaceae;";"33.3";"18.2";"6";"6";"2";"4";"0";"457177";"373892"
"V4mis1";"SILVA (only NR);Eukaryota;Amorphea;Obazoa;Opisthokonta;Nucletmycea;Fungi;Dikarya;Basidiomycota;Agaricomycotina;Agaricomycetes;Cantharellales;Cantharellaceae;Cantharellus;";"0.0";"0";"4";"4";"0";"4";"0";"457179";"373894"
"V4mis1";"SILVA (only NR);Eukaryota;Amorphea;Obazoa;Opisthokonta;Nucletmycea;Fungi;Dikarya;Basidiomycota;Agaricomycotina;Agaricomycetes;Cantharellales;Cantharellaceae;Craterellus;";"100.0";"18.2";"2";"2";"2";"0";"0";"457181";"373892"
"V4mis1";"SILVA (only NR);Eukaryota;Amorphea;Obazoa;Opisthokonta;Nucletmycea;Fungi;Dikarya;Basidiomycota;Agaricomycotina;Agaricomycetes;Cantharellales;Ceratobasidiaceae;";"0.0";"0";"11";"11";"0";"11";"0";"457172";"373894"
"V4mis1";"SILVA (only NR);Eukaryota;Amorphea;Obazoa;Opisthokonta;Nucletmycea;Fungi;Dikarya;Basidiomycota;Agaricomycotina;Agaricomycetes;Cantharellales;Ceratobasidiaceae;Ceratobasidium;";"0.0";"0";"1";"1";"0";"1";"0";"457182";"373894"
"V4mis1";"SILVA (only NR);Eukaryota;Amorphea;Obazoa;Opisthokonta;Nucletmycea;Fungi;Dikarya;Basidiomycota;Agaricomycotina;Agaricomycetes;Cantharellales;Ceratobasidiaceae;Rhizoctonia;";"0.0";"0";"5";"5";"0";"5";"0";"457178";"373894"
"V4mis1";"SILVA (only NR);Eukaryota;Amorphea;Obazoa;Opisthokonta;Nucletmycea;Fungi;Dikarya;Basidiomycota;Agaricomycotina;Agaricomycetes;Cantharellales;Ceratobasidiaceae;Thanatephorus;";"0.0";"0";"3";"3";"0";"3";"0";"457180";"373894"
"V4mis1";"SILVA (only NR);Eukaryota;Amorphea;Obazoa;Opisthokonta;Nucletmycea;Fungi;Dikarya;Basidiomycota;Agaricomycotina;Agaricomycetes;Cantharellales;Clavulinaceae;";"0.0";"0";"7";"6";"0";"6";"1";"457177";"373894"
"V4mis1";"SILVA (only NR);Eukaryota;Amorphea;Obazoa;Opisthokonta;Nucletmycea;Fungi;Dikarya;Basidiomycota;Agaricomycotina;Agaricomycetes;Cantharellales;Clavulinaceae;Clavulicium;";"0.0";"0";"3";"3";"0";"3";"0";"457180";"373894"
"V4mis1";"SILVA (only NR);Eukaryota;Amorphea;Obazoa;Opisthokonta;Nucletmycea;Fungi;Dikarya;Basidiomycota;Agaricomycotina;Agaricomycetes;Cantharellales;Clavulinaceae;Clavulina;";"0.0";"0";"1";"1";"0";"1";"0";"457182";"373894"
"V4mis1";"SILVA (only NR);Eukaryota;Amorphea;Obazoa;Opisthokonta;Nucletmycea;Fungi;Dikarya;Basidiomycota;Agaricomycotina;Agaricomycetes;Cantharellales;Clavulinaceae;Multiclavula;";"0.0";"0";"2";"1";"0";"1";"1";"457182";"373894"
"V4mis1";"SILVA (only NR);Eukaryota;Amorphea;Obazoa;Opisthokonta;Nucletmycea;Fungi;Dikarya;Basidiomycota;Agaricomycotina;Agaricomycetes;Cantharellales;Hydnum;";"0.0";"0";"1";"1";"0";"1";"0";"457182";"373894"
"V4mis1";"SILVA (only NR);Eukaryota;Amorphea;Obazoa;Opisthokonta;Nucletmycea;Fungi;Dikarya;Basidiomycota;Agaricomycotina;Agaricomycetes;Cantharellales;Incertae Sedis;";"0.0";"0";"3";"3";"0";"3";"0";"457180";"373894"
"V4mis1";"SILVA (only NR);Eukaryota;Amorphea;Obazoa;Opisthokonta;Nucletmycea;Fungi;Dikarya;Basidiomycota;Agaricomycotina;Agaricomycetes;Cantharellales;Incertae Sedis;Burgella;";"0.0";"0";"1";"1";"0";"1";"0";"457182";"373894"
"V4mis1";"SILVA (only NR);Eukaryota;Amorphea;Obazoa;Opisthokonta;Nucletmycea;Fungi;Dikarya;Basidiomycota;Agaricomycotina;Agaricomycetes;Cantharellales;Incertae Sedis;Marchandiobasidium;";"0.0";"0";"1";"1";"0";"1";"0";"457182";"373894"
"V4mis1";"SILVA (only NR);Eukaryota;Amorphea;Obazoa;Opisthokonta;Nucletmycea;Fungi;Dikarya;Basidiomycota;Agaricomycotina;Agaricomycetes;Cantharellales;Incertae Sedis;Minimedusa;";"0.0";"0";"1";"1";"0";"1";"0";"457182";"373894"
"V4mis1";"SILVA (only NR);Eukaryota;Amorphea;Obazoa;Opisthokonta;Nucletmycea;Fungi;Dikarya;Basidiomycota;Agaricomycotina;Agaricomycetes;Cantharellales;Tulasnellaceae;";"0.0";"0";"4";"4";"0";"4";"0";"457179";"373894"
"V4mis1";"SILVA (only NR);Eukaryota;Amorphea;Obazoa;Opisthokonta;Nucletmycea;Fungi;Dikarya;Basidiomycota;Agaricomycotina;Agaricomycetes;Cantharellales;Tulasnellaceae;Tulasnella;";"0.0";"0";"4";"4";"0";"4";"0";"457179";"373894"
"V4mis1";"SILVA (only NR);Eukaryota;Amorphea;Obazoa;Opisthokonta;Nucletmycea;Fungi;Dikarya;Basidiomycota;Agaricomycotina;Agaricomycetes;Corticiales;";"0.0";"0";"78";"78";"0";"78";"0";"457105";"373894"
"V4mis1";"SILVA (only NR);Eukaryota;Amorphea;Obazoa;Opisthokonta;Nucletmycea;Fungi;Dikarya;Basidiomycota;Agaricomycotina;Agaricomycetes;Corticiales;Corticiaceae;";"0.0";"0";"76";"76";"0";"76";"0";"457107";"373894"
"V4mis1";"SILVA (only NR);Eukaryota;Amorphea;Obazoa;Opisthokonta;Nucletmycea;Fungi;Dikarya;Basidiomycota;Agaricomycotina;Agaricomycetes;Corticiales;Corticiaceae;Acantholichen;";"0.0";"0";"2";"2";"0";"2";"0";"457181";"373894"
"V4mis1";"SILVA (only NR);Eukaryota;Amorphea;Obazoa;Opisthokonta;Nucletmycea;Fungi;Dikarya;Basidiomycota;Agaricomycotina;Agaricomycetes;Corticiales;Corticiaceae;Candelabrochaete;";"0.0";"0";"1";"1";"0";"1";"0";"457182";"373894"
"V4mis1";"SILVA (only NR);Eukaryota;Amorphea;Obazoa;Opisthokonta;Nucletmycea;Fungi;Dikarya;Basidiomycota;Agaricomycotina;Agaricomycetes;Corticiales;Corticiaceae;Dentocorticium;";"0.0";"0";"1";"1";"0";"1";"0";"457182";"373894"
"V4mis1";"SILVA (only NR);Eukaryota;Amorphea;Obazoa;Opisthokonta;Nucletmycea;Fungi;Dikarya;Basidiomycota;Agaricomycotina;Agaricomycetes;Corticiales;Corticiaceae;Fibricium;";"0.0";"0";"1";"1";"0";"1";"0";"457182";"373894"
"V4mis1";"SILVA (only NR);Eukaryota;Amorphea;Obazoa;Opisthokonta;Nucletmycea;Fungi;Dikarya;Basidiomycota;Agaricomycotina;Agaricomycetes;Corticiales;Corticiaceae;Haplotrichum;";"0.0";"0";"1";"1";"0";"1";"0";"457182";"373894"
"V4mis1";"SILVA (only NR);Eukaryota;Amorphea;Obazoa;Opisthokonta;Nucletmycea;Fungi;Dikarya;Basidiomycota;Agaricomycotina;Agaricomycetes;Corticiales;Corticiaceae;Hyphodontia;";"0.0";"0";"11";"11";"0";"11";"0";"457172";"373894"
"V4mis1";"SILVA (only NR);Eukaryota;Amorphea;Obazoa;Opisthokonta;Nucletmycea;Fungi;Dikarya;Basidiomycota;Agaricomycotina;Agaricomycetes;Corticiales;Corticiaceae;Hypochnicium;";"0.0";"0";"1";"1";"0";"1";"0";"457182";"373894"
"V4mis1";"SILVA (only NR);Eukaryota;Amorphea;Obazoa;Opisthokonta;Nucletmycea;Fungi;Dikarya;Basidiomycota;Agaricomycotina;Agaricomycetes;Corticiales;Corticiaceae;Laetisaria;";"0.0";"0";"1";"1";"0";"1";"0";"457182";"373894"
"V4mis1";"SILVA (only NR);Eukaryota;Amorphea;Obazoa;Opisthokonta;Nucletmycea;Fungi;Dikarya;Basidiomycota;Agaricomycotina;Agaricomycetes;Corticiales;Corticiaceae;Limonomyces;";"0.0";"0";"3";"3";"0";"3";"0";"457180";"373894"
"V4mis1";"SILVA (only NR);Eukaryota;Amorphea;Obazoa;Opisthokonta;Nucletmycea;Fungi;Dikarya;Basidiomycota;Agaricomycotina;Agaricomycetes;Corticiales;Corticiaceae;Lindtneria;";"0.0";"0";"1";"1";"0";"1";"0";"457182";"373894"
"V4mis1";"SILVA (only NR);Eukaryota;Amorphea;Obazoa;Opisthokonta;Nucletmycea;Fungi;Dikarya;Basidiomycota;Agaricomycotina;Agaricomycetes;Corticiales;Corticiaceae;Odonticium;";"0.0";"0";"1";"1";"0";"1";"0";"457182";"373894"
"V4mis1";"SILVA (only NR);Eukaryota;Amorphea;Obazoa;Opisthokonta;Nucletmycea;Fungi;Dikarya;Basidiomycota;Agaricomycotina;Agaricomycetes;Corticiales;Corticiaceae;Peniophorella;";"0.0";"0";"5";"5";"0";"5";"0";"457178";"373894"
"V4mis1";"SILVA (only NR);Eukaryota;Amorphea;Obazoa;Opisthokonta;Nucletmycea;Fungi;Dikarya;Basidiomycota;Agaricomycotina;Agaricomycetes;Corticiales;Corticiaceae;Phlebia;";"0.0";"0";"14";"14";"0";"14";"0";"457169";"373894"
"V4mis1";"SILVA (only NR);Eukaryota;Amorphea;Obazoa;Opisthokonta;Nucletmycea;Fungi;Dikarya;Basidiomycota;Agaricomycotina;Agaricomycetes;Corticiales;Corticiaceae;Pulcherricium;";"0.0";"0";"1";"1";"0";"1";"0";"457182";"373894"
"V4mis1";"SILVA (only NR);Eukaryota;Amorphea;Obazoa;Opisthokonta;Nucletmycea;Fungi;Dikarya;Basidiomycota;Agaricomycotina;Agaricomycetes;Corticiales;Corticiaceae;Repetobasidium;";"0.0";"0";"1";"1";"0";"1";"0";"457182";"373894"
"V4mis1";"SILVA (only NR);Eukaryota;Amorphea;Obazoa;Opisthokonta;Nucletmycea;Fungi;Dikarya;Basidiomycota;Agaricomycotina;Agaricomycetes;Corticiales;Corticiaceae;Rhizochaete;";"0.0";"0";"1";"1";"0";"1";"0";"457182";"373894"
"V4mis1";"SILVA (only NR);Eukaryota;Amorphea;Obazoa;Opisthokonta;Nucletmycea;Fungi;Dikarya;Basidiomycota;Agaricomycotina;Agaricomycetes;Corticiales;Corticiaceae;Rogersella;";"0.0";"0";"1";"1";"0";"1";"0";"457182";"373894"
"V4mis1";"SILVA (only NR);Eukaryota;Amorphea;Obazoa;Opisthokonta;Nucletmycea;Fungi;Dikarya;Basidiomycota;Agaricomycotina;Agaricomycetes;Corticiales;Corticiaceae;Schizopora;";"0.0";"0";"1";"1";"0";"1";"0";"457182";"373894"
"V4mis1";"SILVA (only NR);Eukaryota;Amorphea;Obazoa;Opisthokonta;Nucletmycea;Fungi;Dikarya;Basidiomycota;Agaricomycotina;Agaricomycetes;Corticiales;Corticiaceae;Sistotrema;";"0.0";"0";"23";"23";"0";"23";"0";"457160";"373894"
"V4mis1";"SILVA (only NR);Eukaryota;Amorphea;Obazoa;Opisthokonta;Nucletmycea;Fungi;Dikarya;Basidiomycota;Agaricomycotina;Agaricomycetes;Corticiales;Dendrocorticium;";"0.0";"0";"1";"1";"0";"1";"0";"457182";"373894"
"V4mis1";"SILVA (only NR);Eukaryota;Amorphea;Obazoa;Opisthokonta;Nucletmycea;Fungi;Dikarya;Basidiomycota;Agaricomycotina;Agaricomycetes;Corticiales;Vuilleminia;";"0.0";"0";"1";"1";"0";"1";"0";"457182";"373894"
"V4mis1";"SILVA (only NR);Eukaryota;Amorphea;Obazoa;Opisthokonta;Nucletmycea;Fungi;Dikarya;Basidiomycota;Agaricomycotina;Agaricomycetes;Geastrales;";"0.0";"0";"2";"2";"0";"2";"0";"457181";"373894"
"V4mis1";"SILVA (only NR);Eukaryota;Amorphea;Obazoa;Opisthokonta;Nucletmycea;Fungi;Dikarya;Basidiomycota;Agaricomycotina;Agaricomycetes;Geastrales;Geastraceae;";"0.0";"0";"2";"2";"0";"2";"0";"457181";"373894"
"V4mis1";"SILVA (only NR);Eukaryota;Amorphea;Obazoa;Opisthokonta;Nucletmycea;Fungi;Dikarya;Basidiomycota;Agaricomycotina;Agaricomycetes;Geastrales;Geastraceae;Geastrum;";"0.0";"0";"1";"1";"0";"1";"0";"457182";"373894"
"V4mis1";"SILVA (only NR);Eukaryota;Amorphea;Obazoa;Opisthokonta;Nucletmycea;Fungi;Dikarya;Basidiomycota;Agaricomycotina;Agaricomycetes;Geastrales;Geastraceae;Sphaerobolus;";"0.0";"0";"1";"1";"0";"1";"0";"457182";"373894"
"V4mis1";"SILVA (only NR);Eukaryota;Amorphea;Obazoa;Opisthokonta;Nucletmycea;Fungi;Dikarya;Basidiomycota;Agaricomycotina;Agaricomycetes;Gloeophyllales;";"0.0";"0";"8";"8";"0";"8";"0";"457175";"373894"
"V4mis1";"SILVA (only NR);Eukaryota;Amorphea;Obazoa;Opisthokonta;Nucletmycea;Fungi;Dikarya;Basidiomycota;Agaricomycotina;Agaricomycetes;Gloeophyllales;Gloeophyllaceae;";"0.0";"0";"8";"8";"0";"8";"0";"457175";"373894"
"V4mis1";"SILVA (only NR);Eukaryota;Amorphea;Obazoa;Opisthokonta;Nucletmycea;Fungi;Dikarya;Basidiomycota;Agaricomycotina;Agaricomycetes;Gloeophyllales;Gloeophyllaceae;Gloeophyllum;";"0.0";"0";"3";"3";"0";"3";"0";"457180";"373894"
"V4mis1";"SILVA (only NR);Eukaryota;Amorphea;Obazoa;Opisthokonta;Nucletmycea;Fungi;Dikarya;Basidiomycota;Agaricomycotina;Agaricomycetes;Gloeophyllales;Gloeophyllaceae;Griseoporia;";"0.0";"0";"1";"1";"0";"1";"0";"457182";"373894"
"V4mis1";"SILVA (only NR);Eukaryota;Amorphea;Obazoa;Opisthokonta;Nucletmycea;Fungi;Dikarya;Basidiomycota;Agaricomycotina;Agaricomycetes;Gloeophyllales;Gloeophyllaceae;Neolentinus;";"0.0";"0";"1";"1";"0";"1";"0";"457182";"373894"
"V4mis1";"SILVA (only NR);Eukaryota;Amorphea;Obazoa;Opisthokonta;Nucletmycea;Fungi;Dikarya;Basidiomycota;Agaricomycotina;Agaricomycetes;Gloeophyllales;Gloeophyllaceae;Veluticeps;";"0.0";"0";"3";"3";"0";"3";"0";"457180";"373894"
"V4mis1";"SILVA (only NR);Eukaryota;Amorphea;Obazoa;Opisthokonta;Nucletmycea;Fungi;Dikarya;Basidiomycota;Agaricomycotina;Agaricomycetes;Gomphales;";"0.0";"0";"5";"5";"0";"5";"0";"457178";"373894"
"V4mis1";"SILVA (only NR);Eukaryota;Amorphea;Obazoa;Opisthokonta;Nucletmycea;Fungi;Dikarya;Basidiomycota;Agaricomycotina;Agaricomycetes;Gomphales;Gautieria;";"0.0";"0";"1";"1";"0";"1";"0";"457182";"373894"
"V4mis1";"SILVA (only NR);Eukaryota;Amorphea;Obazoa;Opisthokonta;Nucletmycea;Fungi;Dikarya;Basidiomycota;Agaricomycotina;Agaricomycetes;Gomphales;Gomphaceae;";"0.0";"0";"4";"4";"0";"4";"0";"457179";"373894"
"V4mis1";"SILVA (only NR);Eukaryota;Amorphea;Obazoa;Opisthokonta;Nucletmycea;Fungi;Dikarya;Basidiomycota;Agaricomycotina;Agaricomycetes;Gomphales;Gomphaceae;Clavariadelphus;";"0.0";"0";"1";"1";"0";"1";"0";"457182";"373894"
"V4mis1";"SILVA (only NR);Eukaryota;Amorphea;Obazoa;Opisthokonta;Nucletmycea;Fungi;Dikarya;Basidiomycota;Agaricomycotina;Agaricomycetes;Gomphales;Gomphaceae;Kavinia;";"0.0";"0";"1";"1";"0";"1";"0";"457182";"373894"
"V4mis1";"SILVA (only NR);Eukaryota;Amorphea;Obazoa;Opisthokonta;Nucletmycea;Fungi;Dikarya;Basidiomycota;Agaricomycotina;Agaricomycetes;Gomphales;Gomphaceae;Ramaria;";"0.0";"0";"2";"2";"0";"2";"0";"457181";"373894"
"V4mis1";"SILVA (only NR);Eukaryota;Amorphea;Obazoa;Opisthokonta;Nucletmycea;Fungi;Dikarya;Basidiomycota;Agaricomycotina;Agaricomycetes;Hymenochaetales;";"0.0";"0";"19";"19";"0";"19";"0";"457164";"373894"
"V4mis1";"SILVA (only NR);Eukaryota;Amorphea;Obazoa;Opisthokonta;Nucletmycea;Fungi;Dikarya;Basidiomycota;Agaricomycotina;Agaricomycetes;Hymenochaetales;Basidioradulum;";"0.0";"0";"1";"1";"0";"1";"0";"457182";"373894"
"V4mis1";"SILVA (only NR);Eukaryota;Amorphea;Obazoa;Opisthokonta;Nucletmycea;Fungi;Dikarya;Basidiomycota;Agaricomycotina;Agaricomycetes;Hymenochaetales;Coltricia;";"0.0";"0";"1";"1";"0";"1";"0";"457182";"373894"
"V4mis1";"SILVA (only NR);Eukaryota;Amorphea;Obazoa;Opisthokonta;Nucletmycea;Fungi;Dikarya;Basidiomycota;Agaricomycotina;Agaricomycetes;Hymenochaetales;Hymenochaetaceae;";"0.0";"0";"11";"11";"0";"11";"0";"457172";"373894"
"V4mis1";"SILVA (only NR);Eukaryota;Amorphea;Obazoa;Opisthokonta;Nucletmycea;Fungi;Dikarya;Basidiomycota;Agaricomycotina;Agaricomycetes;Hymenochaetales;Hymenochaetaceae;Fomitiporia;";"0.0";"0";"1";"1";"0";"1";"0";"457182";"373894"
"V4mis1";"SILVA (only NR);Eukaryota;Amorphea;Obazoa;Opisthokonta;Nucletmycea;Fungi;Dikarya;Basidiomycota;Agaricomycotina;Agaricomycetes;Hymenochaetales;Hymenochaetaceae;Hydnochaete;";"0.0";"0";"1";"1";"0";"1";"0";"457182";"373894"
"V4mis1";"SILVA (only NR);Eukaryota;Amorphea;Obazoa;Opisthokonta;Nucletmycea;Fungi;Dikarya;Basidiomycota;Agaricomycotina;Agaricomycetes;Hymenochaetales;Hymenochaetaceae;Hymenochaetopsis;";"0.0";"0";"1";"1";"0";"1";"0";"457182";"373894"
"V4mis1";"SILVA (only NR);Eukaryota;Amorphea;Obazoa;Opisthokonta;Nucletmycea;Fungi;Dikarya;Basidiomycota;Agaricomycotina;Agaricomycetes;Hymenochaetales;Hymenochaetaceae;Inonotus;";"0.0";"0";"1";"1";"0";"1";"0";"457182";"373894"
"V4mis1";"SILVA (only NR);Eukaryota;Amorphea;Obazoa;Opisthokonta;Nucletmycea;Fungi;Dikarya;Basidiomycota;Agaricomycotina;Agaricomycetes;Hymenochaetales;Hymenochaetaceae;Phaeolus;";"0.0";"0";"1";"1";"0";"1";"0";"457182";"373894"
"V4mis1";"SILVA (only NR);Eukaryota;Amorphea;Obazoa;Opisthokonta;Nucletmycea;Fungi;Dikarya;Basidiomycota;Agaricomycotina;Agaricomycetes;Hymenochaetales;Hymenochaetaceae;Phellinus;";"0.0";"0";"2";"2";"0";"2";"0";"457181";"373894"
"V4mis1";"SILVA (only NR);Eukaryota;Amorphea;Obazoa;Opisthokonta;Nucletmycea;Fungi;Dikarya;Basidiomycota;Agaricomycotina;Agaricomycetes;Hymenochaetales;Hymenochaetaceae;Sanghuangporus;";"0.0";"0";"1";"1";"0";"1";"0";"457182";"373894"
"V4mis1";"SILVA (only NR);Eukaryota;Amorphea;Obazoa;Opisthokonta;Nucletmycea;Fungi;Dikarya;Basidiomycota;Agaricomycotina;Agaricomycetes;Hymenochaetales;Hymenochaetaceae;Tropicoporus;";"0.0";"0";"2";"2";"0";"2";"0";"457181";"373894"
"V4mis1";"SILVA (only NR);Eukaryota;Amorphea;Obazoa;Opisthokonta;Nucletmycea;Fungi;Dikarya;Basidiomycota;Agaricomycotina;Agaricomycetes;Hymenochaetales;Schizoporaceae;";"0.0";"0";"2";"2";"0";"2";"0";"457181";"373894"
"V4mis1";"SILVA (only NR);Eukaryota;Amorphea;Obazoa;Opisthokonta;Nucletmycea;Fungi;Dikarya;Basidiomycota;Agaricomycotina;Agaricomycetes;Hymenochaetales;Schizoporaceae;Xylodon;";"0.0";"0";"2";"2";"0";"2";"0";"457181";"373894"
"V4mis1";"SILVA (only NR);Eukaryota;Amorphea;Obazoa;Opisthokonta;Nucletmycea;Fungi;Dikarya;Basidiomycota;Agaricomycotina;Agaricomycetes;Hymenochaetales;Tubulicrinaceae;";"0.0";"0";"3";"3";"0";"3";"0";"457180";"373894"
"V4mis1";"SILVA (only NR);Eukaryota;Amorphea;Obazoa;Opisthokonta;Nucletmycea;Fungi;Dikarya;Basidiomycota;Agaricomycotina;Agaricomycetes;Hymenochaetales;Tubulicrinaceae;Tubulicrinis;";"0.0";"0";"3";"3";"0";"3";"0";"457180";"373894"
"V4mis1";"SILVA (only NR);Eukaryota;Amorphea;Obazoa;Opisthokonta;Nucletmycea;Fungi;Dikarya;Basidiomycota;Agaricomycotina;Agaricomycetes;Incertae Sedis;";"0.0";"0";"6";"6";"0";"6";"0";"457177";"373894"
"V4mis1";"SILVA (only NR);Eukaryota;Amorphea;Obazoa;Opisthokonta;Nucletmycea;Fungi;Dikarya;Basidiomycota;Agaricomycotina;Agaricomycetes;Incertae Sedis;Incertae Sedis;";"0.0";"0";"2";"2";"0";"2";"0";"457181";"373894"
"V4mis1";"SILVA (only NR);Eukaryota;Amorphea;Obazoa;Opisthokonta;Nucletmycea;Fungi;Dikarya;Basidiomycota;Agaricomycotina;Agaricomycetes;Incertae Sedis;Incertae Sedis;Giulia;";"0.0";"0";"1";"1";"0";"1";"0";"457182";"373894"
"V4mis1";"SILVA (only NR);Eukaryota;Amorphea;Obazoa;Opisthokonta;Nucletmycea;Fungi;Dikarya;Basidiomycota;Agaricomycotina;Agaricomycetes;Incertae Sedis;Incertae Sedis;Tremellodendropsis;";"0.0";"0";"1";"1";"0";"1";"0";"457182";"373894"
"V4mis1";"SILVA (only NR);Eukaryota;Amorphea;Obazoa;Opisthokonta;Nucletmycea;Fungi;Dikarya;Basidiomycota;Agaricomycotina;Agaricomycetes;Incertae Sedis;Resinicium;";"0.0";"0";"2";"2";"0";"2";"0";"457181";"373894"
"V4mis1";"SILVA (only NR);Eukaryota;Amorphea;Obazoa;Opisthokonta;Nucletmycea;Fungi;Dikarya;Basidiomycota;Agaricomycotina;Agaricomycetes;Incertae Sedis;Stereopsidaceae;";"0.0";"0";"2";"2";"0";"2";"0";"457181";"373894"
"V4mis1";"SILVA (only NR);Eukaryota;Amorphea;Obazoa;Opisthokonta;Nucletmycea;Fungi;Dikarya;Basidiomycota;Agaricomycotina;Agaricomycetes;Incertae Sedis;Stereopsidaceae;Stereopsis;";"0.0";"0";"2";"2";"0";"2";"0";"457181";"373894"
"V4mis1";"SILVA (only NR);Eukaryota;Amorphea;Obazoa;Opisthokonta;Nucletmycea;Fungi;Dikarya;Basidiomycota;Agaricomycotina;Agaricomycetes;Jaapiales;";"0.0";"0";"1";"1";"0";"1";"0";"457182";"373894"
"V4mis1";"SILVA (only NR);Eukaryota;Amorphea;Obazoa;Opisthokonta;Nucletmycea;Fungi;Dikarya;Basidiomycota;Agaricomycotina;Agaricomycetes;Jaapiales;Jaapiaceae;";"0.0";"0";"1";"1";"0";"1";"0";"457182";"373894"
"V4mis1";"SILVA (only NR);Eukaryota;Amorphea;Obazoa;Opisthokonta;Nucletmycea;Fungi;Dikarya;Basidiomycota;Agaricomycotina;Agaricomycetes;Jaapiales;Jaapiaceae;Jaapia;";"0.0";"0";"1";"1";"0";"1";"0";"457182";"373894"
"V4mis1";"SILVA (only NR);Eukaryota;Amorphea;Obazoa;Opisthokonta;Nucletmycea;Fungi;Dikarya;Basidiomycota;Agaricomycotina;Agaricomycetes;Lepidostromatales;";"0.0";"0";"2";"2";"0";"2";"0";"457181";"373894"
"V4mis1";"SILVA (only NR);Eukaryota;Amorphea;Obazoa;Opisthokonta;Nucletmycea;Fungi;Dikarya;Basidiomycota;Agaricomycotina;Agaricomycetes;Lepidostromatales;Lepidostromataceae;";"0.0";"0";"2";"2";"0";"2";"0";"457181";"373894"
"V4mis1";"SILVA (only NR);Eukaryota;Amorphea;Obazoa;Opisthokonta;Nucletmycea;Fungi;Dikarya;Basidiomycota;Agaricomycotina;Agaricomycetes;Lepidostromatales;Lepidostromataceae;Lepidostroma;";"0.0";"0";"2";"2";"0";"2";"0";"457181";"373894"
"V4mis1";"SILVA (only NR);Eukaryota;Amorphea;Obazoa;Opisthokonta;Nucletmycea;Fungi;Dikarya;Basidiomycota;Agaricomycotina;Agaricomycetes;Parmastomyces;";"0.0";"0";"1";"1";"0";"1";"0";"457182";"373894"
"V4mis1";"SILVA (only NR);Eukaryota;Amorphea;Obazoa;Opisthokonta;Nucletmycea;Fungi;Dikarya;Basidiomycota;Agaricomycotina;Agaricomycetes;Phallales;";"0.0";"0";"2";"2";"0";"2";"0";"457181";"373894"
"V4mis1";"SILVA (only NR);Eukaryota;Amorphea;Obazoa;Opisthokonta;Nucletmycea;Fungi;Dikarya;Basidiomycota;Agaricomycotina;Agaricomycetes;Phallales;Clathraceae;";"0.0";"0";"1";"1";"0";"1";"0";"457182";"373894"
"V4mis1";"SILVA (only NR);Eukaryota;Amorphea;Obazoa;Opisthokonta;Nucletmycea;Fungi;Dikarya;Basidiomycota;Agaricomycotina;Agaricomycetes;Phallales;Clathraceae;Pseudocolus;";"0.0";"0";"1";"1";"0";"1";"0";"457182";"373894"
"V4mis1";"SILVA (only NR);Eukaryota;Amorphea;Obazoa;Opisthokonta;Nucletmycea;Fungi;Dikarya;Basidiomycota;Agaricomycotina;Agaricomycetes;Phallales;Phallaceae;";"0.0";"0";"1";"1";"0";"1";"0";"457182";"373894"
"V4mis1";"SILVA (only NR);Eukaryota;Amorphea;Obazoa;Opisthokonta;Nucletmycea;Fungi;Dikarya;Basidiomycota;Agaricomycotina;Agaricomycetes;Phallales;Phallaceae;Phallus;";"0.0";"0";"1";"1";"0";"1";"0";"457182";"373894"
"V4mis1";"SILVA (only NR);Eukaryota;Amorphea;Obazoa;Opisthokonta;Nucletmycea;Fungi;Dikarya;Basidiomycota;Agaricomycotina;Agaricomycetes;Polyporales;";"0.0";"0";"156";"149";"0";"149";"7";"457034";"373894"
"V4mis1";"SILVA (only NR);Eukaryota;Amorphea;Obazoa;Opisthokonta;Nucletmycea;Fungi;Dikarya;Basidiomycota;Agaricomycotina;Agaricomycetes;Polyporales;Adustoporia;";"0.0";"0";"1";"1";"0";"1";"0";"457182";"373894"
"V4mis1";"SILVA (only NR);Eukaryota;Amorphea;Obazoa;Opisthokonta;Nucletmycea;Fungi;Dikarya;Basidiomycota;Agaricomycotina;Agaricomycetes;Polyporales;Amylocystis;";"0.0";"0";"1";"1";"0";"1";"0";"457182";"373894"
"V4mis1";"SILVA (only NR);Eukaryota;Amorphea;Obazoa;Opisthokonta;Nucletmycea;Fungi;Dikarya;Basidiomycota;Agaricomycotina;Agaricomycetes;Polyporales;Antrodiella;";"0.0";"0";"1";"1";"0";"1";"0";"457182";"373894"
"V4mis1";"SILVA (only NR);Eukaryota;Amorphea;Obazoa;Opisthokonta;Nucletmycea;Fungi;Dikarya;Basidiomycota;Agaricomycotina;Agaricomycetes;Polyporales;Auriporia;";"0.0";"0";"1";"1";"0";"1";"0";"457182";"373894"
"V4mis1";"SILVA (only NR);Eukaryota;Amorphea;Obazoa;Opisthokonta;Nucletmycea;Fungi;Dikarya;Basidiomycota;Agaricomycotina;Agaricomycetes;Polyporales;Brunneoporus;";"0.0";"0";"1";"1";"0";"1";"0";"457182";"373894"
"V4mis1";"SILVA (only NR);Eukaryota;Amorphea;Obazoa;Opisthokonta;Nucletmycea;Fungi;Dikarya;Basidiomycota;Agaricomycotina;Agaricomycetes;Polyporales;Ceriporiopsis;";"0.0";"0";"1";"1";"0";"1";"0";"457182";"373894"
"V4mis1";"SILVA (only NR);Eukaryota;Amorphea;Obazoa;Opisthokonta;Nucletmycea;Fungi;Dikarya;Basidiomycota;Agaricomycotina;Agaricomycetes;Polyporales;Climacodon;";"0.0";"0";"2";"2";"0";"2";"0";"457181";"373894"
"V4mis1";"SILVA (only NR);Eukaryota;Amorphea;Obazoa;Opisthokonta;Nucletmycea;Fungi;Dikarya;Basidiomycota;Agaricomycotina;Agaricomycetes;Polyporales;Coriolaceae;";"0.0";"0";"14";"10";"0";"10";"4";"457173";"373894"
"V4mis1";"SILVA (only NR);Eukaryota;Amorphea;Obazoa;Opisthokonta;Nucletmycea;Fungi;Dikarya;Basidiomycota;Agaricomycotina;Agaricomycetes;Polyporales;Coriolaceae;Abortiporus;";"0.0";"0";"1";"1";"0";"1";"0";"457182";"373894"
"V4mis1";"SILVA (only NR);Eukaryota;Amorphea;Obazoa;Opisthokonta;Nucletmycea;Fungi;Dikarya;Basidiomycota;Agaricomycotina;Agaricomycetes;Polyporales;Coriolaceae;Coriolopsis;";"0.0";"0";"8";"4";"0";"4";"4";"457179";"373894"
"V4mis1";"SILVA (only NR);Eukaryota;Amorphea;Obazoa;Opisthokonta;Nucletmycea;Fungi;Dikarya;Basidiomycota;Agaricomycotina;Agaricomycetes;Polyporales;Coriolaceae;Meripilus;";"0.0";"0";"1";"1";"0";"1";"0";"457182";"373894"
"V4mis1";"SILVA (only NR);Eukaryota;Amorphea;Obazoa;Opisthokonta;Nucletmycea;Fungi;Dikarya;Basidiomycota;Agaricomycotina;Agaricomycetes;Polyporales;Coriolaceae;Oxyporus;";"0.0";"0";"1";"1";"0";"1";"0";"457182";"373894"
"V4mis1";"SILVA (only NR);Eukaryota;Amorphea;Obazoa;Opisthokonta;Nucletmycea;Fungi;Dikarya;Basidiomycota;Agaricomycotina;Agaricomycetes;Polyporales;Coriolaceae;Rigidoporus;";"0.0";"0";"3";"3";"0";"3";"0";"457180";"373894"
"V4mis1";"SILVA (only NR);Eukaryota;Amorphea;Obazoa;Opisthokonta;Nucletmycea;Fungi;Dikarya;Basidiomycota;Agaricomycotina;Agaricomycetes;Polyporales;Dacryobolus;";"0.0";"0";"1";"1";"0";"1";"0";"457182";"373894"
"V4mis1";"SILVA (only NR);Eukaryota;Amorphea;Obazoa;Opisthokonta;Nucletmycea;Fungi;Dikarya;Basidiomycota;Agaricomycotina;Agaricomycetes;Polyporales;Daedalea;";"0.0";"0";"1";"1";"0";"1";"0";"457182";"373894"
"V4mis1";"SILVA (only NR);Eukaryota;Amorphea;Obazoa;Opisthokonta;Nucletmycea;Fungi;Dikarya;Basidiomycota;Agaricomycotina;Agaricomycetes;Polyporales;Donkia;";"0.0";"0";"1";"1";"0";"1";"0";"457182";"373894"
"V4mis1";"SILVA (only NR);Eukaryota;Amorphea;Obazoa;Opisthokonta;Nucletmycea;Fungi;Dikarya;Basidiomycota;Agaricomycotina;Agaricomycetes;Polyporales;Donkioporia;";"0.0";"0";"1";"1";"0";"1";"0";"457182";"373894"
"V4mis1";"SILVA (only NR);Eukaryota;Amorphea;Obazoa;Opisthokonta;Nucletmycea;Fungi;Dikarya;Basidiomycota;Agaricomycotina;Agaricomycetes;Polyporales;Emmia;";"0.0";"0";"1";"1";"0";"1";"0";"457182";"373894"
"V4mis1";"SILVA (only NR);Eukaryota;Amorphea;Obazoa;Opisthokonta;Nucletmycea;Fungi;Dikarya;Basidiomycota;Agaricomycotina;Agaricomycetes;Polyporales;Flaviporus;";"0.0";"0";"1";"1";"0";"1";"0";"457182";"373894"
"V4mis1";"SILVA (only NR);Eukaryota;Amorphea;Obazoa;Opisthokonta;Nucletmycea;Fungi;Dikarya;Basidiomycota;Agaricomycotina;Agaricomycetes;Polyporales;Fomes;";"0.0";"0";"1";"1";"0";"1";"0";"457182";"373894"
"V4mis1";"SILVA (only NR);Eukaryota;Amorphea;Obazoa;Opisthokonta;Nucletmycea;Fungi;Dikarya;Basidiomycota;Agaricomycotina;Agaricomycetes;Polyporales;Fomitopsidaceae;";"0.0";"0";"1";"1";"0";"1";"0";"457182";"373894"
"V4mis1";"SILVA (only NR);Eukaryota;Amorphea;Obazoa;Opisthokonta;Nucletmycea;Fungi;Dikarya;Basidiomycota;Agaricomycotina;Agaricomycetes;Polyporales;Fomitopsidaceae;Antrodia;";"0.0";"0";"1";"1";"0";"1";"0";"457182";"373894"
"V4mis1";"SILVA (only NR);Eukaryota;Amorphea;Obazoa;Opisthokonta;Nucletmycea;Fungi;Dikarya;Basidiomycota;Agaricomycotina;Agaricomycetes;Polyporales;Fomitopsis;";"0.0";"0";"2";"2";"0";"2";"0";"457181";"373894"
"V4mis1";"SILVA (only NR);Eukaryota;Amorphea;Obazoa;Opisthokonta;Nucletmycea;Fungi;Dikarya;Basidiomycota;Agaricomycotina;Agaricomycetes;Polyporales;Ganoderma;";"0.0";"0";"2";"2";"0";"2";"0";"457181";"373894"
"V4mis1";"SILVA (only NR);Eukaryota;Amorphea;Obazoa;Opisthokonta;Nucletmycea;Fungi;Dikarya;Basidiomycota;Agaricomycotina;Agaricomycetes;Polyporales;Hyphodermella;";"0.0";"0";"1";"1";"0";"1";"0";"457182";"373894"
"V4mis1";"SILVA (only NR);Eukaryota;Amorphea;Obazoa;Opisthokonta;Nucletmycea;Fungi;Dikarya;Basidiomycota;Agaricomycotina;Agaricomycetes;Polyporales;Incertae Sedis;";"0.0";"0";"41";"41";"0";"41";"0";"457142";"373894"
"V4mis1";"SILVA (only NR);Eukaryota;Amorphea;Obazoa;Opisthokonta;Nucletmycea;Fungi;Dikarya;Basidiomycota;Agaricomycotina;Agaricomycetes;Polyporales;Incertae Sedis;Burgoa;";"0.0";"0";"2";"2";"0";"2";"0";"457181";"373894"
"V4mis1";"SILVA (only NR);Eukaryota;Amorphea;Obazoa;Opisthokonta;Nucletmycea;Fungi;Dikarya;Basidiomycota;Agaricomycotina;Agaricomycetes;Polyporales;Incertae Sedis;Diplomitoporus;";"0.0";"0";"4";"4";"0";"4";"0";"457179";"373894"
"V4mis1";"SILVA (only NR);Eukaryota;Amorphea;Obazoa;Opisthokonta;Nucletmycea;Fungi;Dikarya;Basidiomycota;Agaricomycotina;Agaricomycetes;Polyporales;Incertae Sedis;Gelatoporiaceae;";"0.0";"0";"1";"1";"0";"1";"0";"457182";"373894"
"V4mis1";"SILVA (only NR);Eukaryota;Amorphea;Obazoa;Opisthokonta;Nucletmycea;Fungi;Dikarya;Basidiomycota;Agaricomycotina;Agaricomycetes;Polyporales;Incertae Sedis;Gelatoporiaceae;Gelatoporia;";"0.0";"0";"1";"1";"0";"1";"0";"457182";"373894"
"V4mis1";"SILVA (only NR);Eukaryota;Amorphea;Obazoa;Opisthokonta;Nucletmycea;Fungi;Dikarya;Basidiomycota;Agaricomycotina;Agaricomycetes;Polyporales;Incertae Sedis;Marchandiomyces;";"0.0";"0";"7";"7";"0";"7";"0";"457176";"373894"
"V4mis1";"SILVA (only NR);Eukaryota;Amorphea;Obazoa;Opisthokonta;Nucletmycea;Fungi;Dikarya;Basidiomycota;Agaricomycotina;Agaricomycetes;Polyporales;Incertae Sedis;Melanoporia;";"0.0";"0";"1";"1";"0";"1";"0";"457182";"373894"
"V4mis1";"SILVA (only NR);Eukaryota;Amorphea;Obazoa;Opisthokonta;Nucletmycea;Fungi;Dikarya;Basidiomycota;Agaricomycotina;Agaricomycetes;Polyporales;Incertae Sedis;Oligoporus;";"0.0";"0";"1";"1";"0";"1";"0";"457182";"373894"
"V4mis1";"SILVA (only NR);Eukaryota;Amorphea;Obazoa;Opisthokonta;Nucletmycea;Fungi;Dikarya;Basidiomycota;Agaricomycotina;Agaricomycetes;Polyporales;Incertae Sedis;Steccherinum;";"0.0";"0";"1";"1";"0";"1";"0";"457182";"373894"
"V4mis1";"SILVA (only NR);Eukaryota;Amorphea;Obazoa;Opisthokonta;Nucletmycea;Fungi;Dikarya;Basidiomycota;Agaricomycotina;Agaricomycetes;Polyporales;Incertae Sedis;Taiwanofungus;";"0.0";"0";"3";"3";"0";"3";"0";"457180";"373894"
"V4mis1";"SILVA (only NR);Eukaryota;Amorphea;Obazoa;Opisthokonta;Nucletmycea;Fungi;Dikarya;Basidiomycota;Agaricomycotina;Agaricomycetes;Polyporales;Incertae Sedis;Trametes;";"0.0";"0";"12";"12";"0";"12";"0";"457171";"373894"
"V4mis1";"SILVA (only NR);Eukaryota;Amorphea;Obazoa;Opisthokonta;Nucletmycea;Fungi;Dikarya;Basidiomycota;Agaricomycotina;Agaricomycetes;Polyporales;Incertae Sedis;Tretopileus;";"0.0";"0";"1";"1";"0";"1";"0";"457182";"373894"
"V4mis1";"SILVA (only NR);Eukaryota;Amorphea;Obazoa;Opisthokonta;Nucletmycea;Fungi;Dikarya;Basidiomycota;Agaricomycotina;Agaricomycetes;Polyporales;Incertae Sedis;Trichaptum;";"0.0";"0";"6";"6";"0";"6";"0";"457177";"373894"
"V4mis1";"SILVA (only NR);Eukaryota;Amorphea;Obazoa;Opisthokonta;Nucletmycea;Fungi;Dikarya;Basidiomycota;Agaricomycotina;Agaricomycetes;Polyporales;Irpex;";"0.0";"0";"1";"1";"0";"1";"0";"457182";"373894"
"V4mis1";"SILVA (only NR);Eukaryota;Amorphea;Obazoa;Opisthokonta;Nucletmycea;Fungi;Dikarya;Basidiomycota;Agaricomycotina;Agaricomycetes;Polyporales;Irpicaceae;";"0.0";"0";"5";"5";"0";"5";"0";"457178";"373894"
"V4mis1";"SILVA (only NR);Eukaryota;Amorphea;Obazoa;Opisthokonta;Nucletmycea;Fungi;Dikarya;Basidiomycota;Agaricomycotina;Agaricomycetes;Polyporales;Irpicaceae;Ceriporia;";"0.0";"0";"4";"4";"0";"4";"0";"457179";"373894"
"V4mis1";"SILVA (only NR);Eukaryota;Amorphea;Obazoa;Opisthokonta;Nucletmycea;Fungi;Dikarya;Basidiomycota;Agaricomycotina;Agaricomycetes;Polyporales;Irpicaceae;Leptoporus;";"0.0";"0";"1";"1";"0";"1";"0";"457182";"373894"
"V4mis1";"SILVA (only NR);Eukaryota;Amorphea;Obazoa;Opisthokonta;Nucletmycea;Fungi;Dikarya;Basidiomycota;Agaricomycotina;Agaricomycetes;Polyporales;Junghuhnia;";"0.0";"0";"1";"1";"0";"1";"0";"457182";"373894"
"V4mis1";"SILVA (only NR);Eukaryota;Amorphea;Obazoa;Opisthokonta;Nucletmycea;Fungi;Dikarya;Basidiomycota;Agaricomycotina;Agaricomycetes;Polyporales;Laetiporaceae;";"0.0";"0";"2";"2";"0";"2";"0";"457181";"373894"
"V4mis1";"SILVA (only NR);Eukaryota;Amorphea;Obazoa;Opisthokonta;Nucletmycea;Fungi;Dikarya;Basidiomycota;Agaricomycotina;Agaricomycetes;Polyporales;Laetiporaceae;Wolfiporia;";"0.0";"0";"2";"2";"0";"2";"0";"457181";"373894"
"V4mis1";"SILVA (only NR);Eukaryota;Amorphea;Obazoa;Opisthokonta;Nucletmycea;Fungi;Dikarya;Basidiomycota;Agaricomycotina;Agaricomycetes;Polyporales;Lentinus;";"0.0";"0";"1";"1";"0";"1";"0";"457182";"373894"
"V4mis1";"SILVA (only NR);Eukaryota;Amorphea;Obazoa;Opisthokonta;Nucletmycea;Fungi;Dikarya;Basidiomycota;Agaricomycotina;Agaricomycetes;Polyporales;Meruliaceae;";"0.0";"0";"5";"5";"0";"5";"0";"457178";"373894"
"V4mis1";"SILVA (only NR);Eukaryota;Amorphea;Obazoa;Opisthokonta;Nucletmycea;Fungi;Dikarya;Basidiomycota;Agaricomycotina;Agaricomycetes;Polyporales;Meruliaceae;Gloeoporus;";"0.0";"0";"3";"3";"0";"3";"0";"457180";"373894"
"V4mis1";"SILVA (only NR);Eukaryota;Amorphea;Obazoa;Opisthokonta;Nucletmycea;Fungi;Dikarya;Basidiomycota;Agaricomycotina;Agaricomycetes;Polyporales;Meruliaceae;Skvortzovia;";"0.0";"0";"1";"1";"0";"1";"0";"457182";"373894"
"V4mis1";"SILVA (only NR);Eukaryota;Amorphea;Obazoa;Opisthokonta;Nucletmycea;Fungi;Dikarya;Basidiomycota;Agaricomycotina;Agaricomycetes;Polyporales;Neolentiporus;";"0.0";"0";"1";"1";"0";"1";"0";"457182";"373894"
"V4mis1";"SILVA (only NR);Eukaryota;Amorphea;Obazoa;Opisthokonta;Nucletmycea;Fungi;Dikarya;Basidiomycota;Agaricomycotina;Agaricomycetes;Polyporales;Phanerochaetaceae;";"0.0";"0";"11";"9";"0";"9";"2";"457174";"373894"
"V4mis1";"SILVA (only NR);Eukaryota;Amorphea;Obazoa;Opisthokonta;Nucletmycea;Fungi;Dikarya;Basidiomycota;Agaricomycotina;Agaricomycetes;Polyporales;Phanerochaetaceae;Bjerkandera;";"0.0";"0";"6";"6";"0";"6";"0";"457177";"373894"
"V4mis1";"SILVA (only NR);Eukaryota;Amorphea;Obazoa;Opisthokonta;Nucletmycea;Fungi;Dikarya;Basidiomycota;Agaricomycotina;Agaricomycetes;Polyporales;Phanerochaetaceae;Hapalopilus;";"0.0";"0";"1";"1";"0";"1";"0";"457182";"373894"
"V4mis1";"SILVA (only NR);Eukaryota;Amorphea;Obazoa;Opisthokonta;Nucletmycea;Fungi;Dikarya;Basidiomycota;Agaricomycotina;Agaricomycetes;Polyporales;Phanerochaetaceae;Phanerochaete;";"0.0";"0";"2";"0";"0";"0";"2";"457183";"373894"
"V4mis1";"SILVA (only NR);Eukaryota;Amorphea;Obazoa;Opisthokonta;Nucletmycea;Fungi;Dikarya;Basidiomycota;Agaricomycotina;Agaricomycetes;Polyporales;Phanerochaetaceae;Phlebiopsis;";"0.0";"0";"2";"2";"0";"2";"0";"457181";"373894"
"V4mis1";"SILVA (only NR);Eukaryota;Amorphea;Obazoa;Opisthokonta;Nucletmycea;Fungi;Dikarya;Basidiomycota;Agaricomycotina;Agaricomycetes;Polyporales;Polyporaceae;";"0.0";"0";"21";"20";"0";"20";"1";"457163";"373894"
"V4mis1";"SILVA (only NR);Eukaryota;Amorphea;Obazoa;Opisthokonta;Nucletmycea;Fungi;Dikarya;Basidiomycota;Agaricomycotina;Agaricomycetes;Polyporales;Polyporaceae;Amyloporia;";"0.0";"0";"2";"2";"0";"2";"0";"457181";"373894"
"V4mis1";"SILVA (only NR);Eukaryota;Amorphea;Obazoa;Opisthokonta;Nucletmycea;Fungi;Dikarya;Basidiomycota;Agaricomycotina;Agaricomycetes;Polyporales;Polyporaceae;Cerrena;";"0.0";"0";"3";"3";"0";"3";"0";"457180";"373894"
"V4mis1";"SILVA (only NR);Eukaryota;Amorphea;Obazoa;Opisthokonta;Nucletmycea;Fungi;Dikarya;Basidiomycota;Agaricomycotina;Agaricomycetes;Polyporales;Polyporaceae;Datronia;";"0.0";"0";"1";"1";"0";"1";"0";"457182";"373894"
"V4mis1";"SILVA (only NR);Eukaryota;Amorphea;Obazoa;Opisthokonta;Nucletmycea;Fungi;Dikarya;Basidiomycota;Agaricomycotina;Agaricomycetes;Polyporales;Polyporaceae;Fibroporia;";"0.0";"0";"2";"2";"0";"2";"0";"457181";"373894"
"V4mis1";"SILVA (only NR);Eukaryota;Amorphea;Obazoa;Opisthokonta;Nucletmycea;Fungi;Dikarya;Basidiomycota;Agaricomycotina;Agaricomycetes;Polyporales;Polyporaceae;Haploporus;";"0.0";"0";"1";"1";"0";"1";"0";"457182";"373894"
"V4mis1";"SILVA (only NR);Eukaryota;Amorphea;Obazoa;Opisthokonta;Nucletmycea;Fungi;Dikarya;Basidiomycota;Agaricomycotina;Agaricomycetes;Polyporales;Polyporaceae;Hexagonia;";"0.0";"0";"2";"2";"0";"2";"0";"457181";"373894"
"V4mis1";"SILVA (only NR);Eukaryota;Amorphea;Obazoa;Opisthokonta;Nucletmycea;Fungi;Dikarya;Basidiomycota;Agaricomycotina;Agaricomycetes;Polyporales;Polyporaceae;Lignosus;";"0.0";"0";"2";"1";"0";"1";"1";"457182";"373894"
"V4mis1";"SILVA (only NR);Eukaryota;Amorphea;Obazoa;Opisthokonta;Nucletmycea;Fungi;Dikarya;Basidiomycota;Agaricomycotina;Agaricomycetes;Polyporales;Polyporaceae;Megasporoporiella;";"0.0";"0";"1";"1";"0";"1";"0";"457182";"373894"
"V4mis1";"SILVA (only NR);Eukaryota;Amorphea;Obazoa;Opisthokonta;Nucletmycea;Fungi;Dikarya;Basidiomycota;Agaricomycotina;Agaricomycetes;Polyporales;Polyporaceae;Perenniporia;";"0.0";"0";"4";"4";"0";"4";"0";"457179";"373894"
"V4mis1";"SILVA (only NR);Eukaryota;Amorphea;Obazoa;Opisthokonta;Nucletmycea;Fungi;Dikarya;Basidiomycota;Agaricomycotina;Agaricomycetes;Polyporales;Polyporaceae;Spongipellis;";"0.0";"0";"2";"2";"0";"2";"0";"457181";"373894"
"V4mis1";"SILVA (only NR);Eukaryota;Amorphea;Obazoa;Opisthokonta;Nucletmycea;Fungi;Dikarya;Basidiomycota;Agaricomycotina;Agaricomycetes;Polyporales;Polyporus;";"0.0";"0";"1";"1";"0";"1";"0";"457182";"373894"
"V4mis1";"SILVA (only NR);Eukaryota;Amorphea;Obazoa;Opisthokonta;Nucletmycea;Fungi;Dikarya;Basidiomycota;Agaricomycotina;Agaricomycetes;Polyporales;Poria;";"0.0";"0";"1";"1";"0";"1";"0";"457182";"373894"
"V4mis1";"SILVA (only NR);Eukaryota;Amorphea;Obazoa;Opisthokonta;Nucletmycea;Fungi;Dikarya;Basidiomycota;Agaricomycotina;Agaricomycetes;Polyporales;Porostereum;";"0.0";"0";"1";"1";"0";"1";"0";"457182";"373894"
"V4mis1";"SILVA (only NR);Eukaryota;Amorphea;Obazoa;Opisthokonta;Nucletmycea;Fungi;Dikarya;Basidiomycota;Agaricomycotina;Agaricomycetes;Polyporales;Postia;";"0.0";"0";"3";"3";"0";"3";"0";"457180";"373894"
"V4mis1";"SILVA (only NR);Eukaryota;Amorphea;Obazoa;Opisthokonta;Nucletmycea;Fungi;Dikarya;Basidiomycota;Agaricomycotina;Agaricomycetes;Polyporales;Sparassidaceae;";"0.0";"0";"11";"11";"0";"11";"0";"457172";"373894"
"V4mis1";"SILVA (only NR);Eukaryota;Amorphea;Obazoa;Opisthokonta;Nucletmycea;Fungi;Dikarya;Basidiomycota;Agaricomycotina;Agaricomycetes;Polyporales;Sparassidaceae;Sparassis;";"0.0";"0";"11";"11";"0";"11";"0";"457172";"373894"
"V4mis1";"SILVA (only NR);Eukaryota;Amorphea;Obazoa;Opisthokonta;Nucletmycea;Fungi;Dikarya;Basidiomycota;Agaricomycotina;Agaricomycetes;Polyporales;Tinctoporellus;";"0.0";"0";"1";"1";"0";"1";"0";"457182";"373894"
"V4mis1";"SILVA (only NR);Eukaryota;Amorphea;Obazoa;Opisthokonta;Nucletmycea;Fungi;Dikarya;Basidiomycota;Agaricomycotina;Agaricomycetes;Polyporales;Tyromyces;";"0.0";"0";"2";"2";"0";"2";"0";"457181";"373894"
"V4mis1";"SILVA (only NR);Eukaryota;Amorphea;Obazoa;Opisthokonta;Nucletmycea;Fungi;Dikarya;Basidiomycota;Agaricomycotina;Agaricomycetes;Polyporales;[Ceraceomyces];";"0.0";"0";"1";"1";"0";"1";"0";"457182";"373894"
"V4mis1";"SILVA (only NR);Eukaryota;Amorphea;Obazoa;Opisthokonta;Nucletmycea;Fungi;Dikarya;Basidiomycota;Agaricomycotina;Agaricomycetes;Polyporales;basidiomycete;";"0.0";"0";"1";"1";"0";"1";"0";"457182";"373894"
"V4mis1";"SILVA (only NR);Eukaryota;Amorphea;Obazoa;Opisthokonta;Nucletmycea;Fungi;Dikarya;Basidiomycota;Agaricomycotina;Agaricomycetes;Polyporales;uncultured;";"0.0";"0";"4";"4";"0";"4";"0";"457179";"373894"
"V4mis1";"SILVA (only NR);Eukaryota;Amorphea;Obazoa;Opisthokonta;Nucletmycea;Fungi;Dikarya;Basidiomycota;Agaricomycotina;Agaricomycetes;Russulales;";"0.0";"0";"77";"76";"0";"76";"1";"457107";"373894"
"V4mis1";"SILVA (only NR);Eukaryota;Amorphea;Obazoa;Opisthokonta;Nucletmycea;Fungi;Dikarya;Basidiomycota;Agaricomycotina;Agaricomycetes;Russulales;Albatrellaceae;";"0.0";"0";"2";"2";"0";"2";"0";"457181";"373894"
"V4mis1";"SILVA (only NR);Eukaryota;Amorphea;Obazoa;Opisthokonta;Nucletmycea;Fungi;Dikarya;Basidiomycota;Agaricomycotina;Agaricomycetes;Russulales;Albatrellaceae;Albatrellus;";"0.0";"0";"2";"2";"0";"2";"0";"457181";"373894"
"V4mis1";"SILVA (only NR);Eukaryota;Amorphea;Obazoa;Opisthokonta;Nucletmycea;Fungi;Dikarya;Basidiomycota;Agaricomycotina;Agaricomycetes;Russulales;Auriscalpiaceae;";"0.0";"0";"6";"6";"0";"6";"0";"457177";"373894"
"V4mis1";"SILVA (only NR);Eukaryota;Amorphea;Obazoa;Opisthokonta;Nucletmycea;Fungi;Dikarya;Basidiomycota;Agaricomycotina;Agaricomycetes;Russulales;Auriscalpiaceae;Artomyces;";"0.0";"0";"2";"2";"0";"2";"0";"457181";"373894"
"V4mis1";"SILVA (only NR);Eukaryota;Amorphea;Obazoa;Opisthokonta;Nucletmycea;Fungi;Dikarya;Basidiomycota;Agaricomycotina;Agaricomycetes;Russulales;Auriscalpiaceae;Auriscalpium;";"0.0";"0";"2";"2";"0";"2";"0";"457181";"373894"
"V4mis1";"SILVA (only NR);Eukaryota;Amorphea;Obazoa;Opisthokonta;Nucletmycea;Fungi;Dikarya;Basidiomycota;Agaricomycotina;Agaricomycetes;Russulales;Auriscalpiaceae;Lentinellus;";"0.0";"0";"2";"2";"0";"2";"0";"457181";"373894"
"V4mis1";"SILVA (only NR);Eukaryota;Amorphea;Obazoa;Opisthokonta;Nucletmycea;Fungi;Dikarya;Basidiomycota;Agaricomycotina;Agaricomycetes;Russulales;Bondarzewiaceae;";"0.0";"0";"5";"5";"0";"5";"0";"457178";"373894"
"V4mis1";"SILVA (only NR);Eukaryota;Amorphea;Obazoa;Opisthokonta;Nucletmycea;Fungi;Dikarya;Basidiomycota;Agaricomycotina;Agaricomycetes;Russulales;Bondarzewiaceae;Bondarzewia;";"0.0";"0";"1";"1";"0";"1";"0";"457182";"373894"
"V4mis1";"SILVA (only NR);Eukaryota;Amorphea;Obazoa;Opisthokonta;Nucletmycea;Fungi;Dikarya;Basidiomycota;Agaricomycotina;Agaricomycetes;Russulales;Bondarzewiaceae;Heterobasidion;";"0.0";"0";"4";"4";"0";"4";"0";"457179";"373894"
"V4mis1";"SILVA (only NR);Eukaryota;Amorphea;Obazoa;Opisthokonta;Nucletmycea;Fungi;Dikarya;Basidiomycota;Agaricomycotina;Agaricomycetes;Russulales;Dentipellis;";"0.0";"0";"1";"1";"0";"1";"0";"457182";"373894"
"V4mis1";"SILVA (only NR);Eukaryota;Amorphea;Obazoa;Opisthokonta;Nucletmycea;Fungi;Dikarya;Basidiomycota;Agaricomycotina;Agaricomycetes;Russulales;Echinodontiaceae;";"0.0";"0";"2";"2";"0";"2";"0";"457181";"373894"
"V4mis1";"SILVA (only NR);Eukaryota;Amorphea;Obazoa;Opisthokonta;Nucletmycea;Fungi;Dikarya;Basidiomycota;Agaricomycotina;Agaricomycetes;Russulales;Echinodontiaceae;Echinodontium;";"0.0";"0";"2";"2";"0";"2";"0";"457181";"373894"
"V4mis1";"SILVA (only NR);Eukaryota;Amorphea;Obazoa;Opisthokonta;Nucletmycea;Fungi;Dikarya;Basidiomycota;Agaricomycotina;Agaricomycetes;Russulales;Haloaleurodiscus;";"0.0";"0";"1";"1";"0";"1";"0";"457182";"373894"
"V4mis1";"SILVA (only NR);Eukaryota;Amorphea;Obazoa;Opisthokonta;Nucletmycea;Fungi;Dikarya;Basidiomycota;Agaricomycotina;Agaricomycetes;Russulales;Hericiaceae;";"0.0";"0";"4";"4";"0";"4";"0";"457179";"373894"
"V4mis1";"SILVA (only NR);Eukaryota;Amorphea;Obazoa;Opisthokonta;Nucletmycea;Fungi;Dikarya;Basidiomycota;Agaricomycotina;Agaricomycetes;Russulales;Hericiaceae;Hericium;";"0.0";"0";"4";"4";"0";"4";"0";"457179";"373894"
"V4mis1";"SILVA (only NR);Eukaryota;Amorphea;Obazoa;Opisthokonta;Nucletmycea;Fungi;Dikarya;Basidiomycota;Agaricomycotina;Agaricomycetes;Russulales;Hyphodermataceae;";"0.0";"0";"1";"1";"0";"1";"0";"457182";"373894"
"V4mis1";"SILVA (only NR);Eukaryota;Amorphea;Obazoa;Opisthokonta;Nucletmycea;Fungi;Dikarya;Basidiomycota;Agaricomycotina;Agaricomycetes;Russulales;Hyphodermataceae;Galzinia;";"0.0";"0";"1";"1";"0";"1";"0";"457182";"373894"
"V4mis1";"SILVA (only NR);Eukaryota;Amorphea;Obazoa;Opisthokonta;Nucletmycea;Fungi;Dikarya;Basidiomycota;Agaricomycotina;Agaricomycetes;Russulales;Lachnocladiaceae;";"0.0";"0";"7";"7";"0";"7";"0";"457176";"373894"
"V4mis1";"SILVA (only NR);Eukaryota;Amorphea;Obazoa;Opisthokonta;Nucletmycea;Fungi;Dikarya;Basidiomycota;Agaricomycotina;Agaricomycetes;Russulales;Lachnocladiaceae;Asterostroma;";"0.0";"0";"1";"1";"0";"1";"0";"457182";"373894"
"V4mis1";"SILVA (only NR);Eukaryota;Amorphea;Obazoa;Opisthokonta;Nucletmycea;Fungi;Dikarya;Basidiomycota;Agaricomycotina;Agaricomycetes;Russulales;Lachnocladiaceae;Baltazaria;";"0.0";"0";"1";"1";"0";"1";"0";"457182";"373894"
"V4mis1";"SILVA (only NR);Eukaryota;Amorphea;Obazoa;Opisthokonta;Nucletmycea;Fungi;Dikarya;Basidiomycota;Agaricomycotina;Agaricomycetes;Russulales;Lachnocladiaceae;Dichostereum;";"0.0";"0";"1";"1";"0";"1";"0";"457182";"373894"
"V4mis1";"SILVA (only NR);Eukaryota;Amorphea;Obazoa;Opisthokonta;Nucletmycea;Fungi;Dikarya;Basidiomycota;Agaricomycotina;Agaricomycetes;Russulales;Lachnocladiaceae;Scytinostroma;";"0.0";"0";"2";"2";"0";"2";"0";"457181";"373894"
"V4mis1";"SILVA (only NR);Eukaryota;Amorphea;Obazoa;Opisthokonta;Nucletmycea;Fungi;Dikarya;Basidiomycota;Agaricomycotina;Agaricomycetes;Russulales;Lachnocladiaceae;Vararia;";"0.0";"0";"1";"1";"0";"1";"0";"457182";"373894"
"V4mis1";"SILVA (only NR);Eukaryota;Amorphea;Obazoa;Opisthokonta;Nucletmycea;Fungi;Dikarya;Basidiomycota;Agaricomycotina;Agaricomycetes;Russulales;Laurilia;";"0.0";"0";"1";"1";"0";"1";"0";"457182";"373894"
"V4mis1";"SILVA (only NR);Eukaryota;Amorphea;Obazoa;Opisthokonta;Nucletmycea;Fungi;Dikarya;Basidiomycota;Agaricomycotina;Agaricomycetes;Russulales;Laxitextum;";"0.0";"0";"1";"1";"0";"1";"0";"457182";"373894"
"V4mis1";"SILVA (only NR);Eukaryota;Amorphea;Obazoa;Opisthokonta;Nucletmycea;Fungi;Dikarya;Basidiomycota;Agaricomycotina;Agaricomycetes;Russulales;Peniophora;";"0.0";"0";"1";"1";"0";"1";"0";"457182";"373894"
"V4mis1";"SILVA (only NR);Eukaryota;Amorphea;Obazoa;Opisthokonta;Nucletmycea;Fungi;Dikarya;Basidiomycota;Agaricomycotina;Agaricomycetes;Russulales;Podoscyphaceae;";"0.0";"0";"4";"4";"0";"4";"0";"457179";"373894"
"V4mis1";"SILVA (only NR);Eukaryota;Amorphea;Obazoa;Opisthokonta;Nucletmycea;Fungi;Dikarya;Basidiomycota;Agaricomycotina;Agaricomycetes;Russulales;Podoscyphaceae;Cymatoderma;";"0.0";"0";"1";"1";"0";"1";"0";"457182";"373894"
"V4mis1";"SILVA (only NR);Eukaryota;Amorphea;Obazoa;Opisthokonta;Nucletmycea;Fungi;Dikarya;Basidiomycota;Agaricomycotina;Agaricomycetes;Russulales;Podoscyphaceae;Podoscypha;";"0.0";"0";"3";"3";"0";"3";"0";"457180";"373894"
"V4mis1";"SILVA (only NR);Eukaryota;Amorphea;Obazoa;Opisthokonta;Nucletmycea;Fungi;Dikarya;Basidiomycota;Agaricomycotina;Agaricomycetes;Russulales;Russulaceae;";"0.0";"0";"14";"13";"0";"13";"1";"457170";"373894"
"V4mis1";"SILVA (only NR);Eukaryota;Amorphea;Obazoa;Opisthokonta;Nucletmycea;Fungi;Dikarya;Basidiomycota;Agaricomycotina;Agaricomycetes;Russulales;Russulaceae;Lactarius;";"0.0";"0";"6";"5";"0";"5";"1";"457178";"373894"
"V4mis1";"SILVA (only NR);Eukaryota;Amorphea;Obazoa;Opisthokonta;Nucletmycea;Fungi;Dikarya;Basidiomycota;Agaricomycotina;Agaricomycetes;Russulales;Russulaceae;Russula;";"0.0";"0";"8";"8";"0";"8";"0";"457175";"373894"
"V4mis1";"SILVA (only NR);Eukaryota;Amorphea;Obazoa;Opisthokonta;Nucletmycea;Fungi;Dikarya;Basidiomycota;Agaricomycotina;Agaricomycetes;Russulales;Stereaceae;";"0.0";"0";"20";"20";"0";"20";"0";"457163";"373894"
"V4mis1";"SILVA (only NR);Eukaryota;Amorphea;Obazoa;Opisthokonta;Nucletmycea;Fungi;Dikarya;Basidiomycota;Agaricomycotina;Agaricomycetes;Russulales;Stereaceae;Aleurobotrys;";"0.0";"0";"1";"1";"0";"1";"0";"457182";"373894"
"V4mis1";"SILVA (only NR);Eukaryota;Amorphea;Obazoa;Opisthokonta;Nucletmycea;Fungi;Dikarya;Basidiomycota;Agaricomycotina;Agaricomycetes;Russulales;Stereaceae;Amylostereum;";"0.0";"0";"3";"3";"0";"3";"0";"457180";"373894"
"V4mis1";"SILVA (only NR);Eukaryota;Amorphea;Obazoa;Opisthokonta;Nucletmycea;Fungi;Dikarya;Basidiomycota;Agaricomycotina;Agaricomycetes;Russulales;Stereaceae;Boreostereum;";"0.0";"0";"1";"1";"0";"1";"0";"457182";"373894"
"V4mis1";"SILVA (only NR);Eukaryota;Amorphea;Obazoa;Opisthokonta;Nucletmycea;Fungi;Dikarya;Basidiomycota;Agaricomycotina;Agaricomycetes;Russulales;Stereaceae;Lopharia;";"0.0";"0";"2";"2";"0";"2";"0";"457181";"373894"
"V4mis1";"SILVA (only NR);Eukaryota;Amorphea;Obazoa;Opisthokonta;Nucletmycea;Fungi;Dikarya;Basidiomycota;Agaricomycotina;Agaricomycetes;Russulales;Stereaceae;Megalocystidium;";"0.0";"0";"1";"1";"0";"1";"0";"457182";"373894"
"V4mis1";"SILVA (only NR);Eukaryota;Amorphea;Obazoa;Opisthokonta;Nucletmycea;Fungi;Dikarya;Basidiomycota;Agaricomycotina;Agaricomycetes;Russulales;Stereaceae;Stereum;";"0.0";"0";"3";"3";"0";"3";"0";"457180";"373894"
"V4mis1";"SILVA (only NR);Eukaryota;Amorphea;Obazoa;Opisthokonta;Nucletmycea;Fungi;Dikarya;Basidiomycota;Agaricomycotina;Agaricomycetes;Russulales;Stereaceae;Xylobolus;";"0.0";"0";"2";"2";"0";"2";"0";"457181";"373894"
"V4mis1";"SILVA (only NR);Eukaryota;Amorphea;Obazoa;Opisthokonta;Nucletmycea;Fungi;Dikarya;Basidiomycota;Agaricomycotina;Agaricomycetes;Russulales;Stereaceae;uncultured;";"0.0";"0";"6";"6";"0";"6";"0";"457177";"373894"
"V4mis1";"SILVA (only NR);Eukaryota;Amorphea;Obazoa;Opisthokonta;Nucletmycea;Fungi;Dikarya;Basidiomycota;Agaricomycotina;Agaricomycetes;Russulales;Xenasma;";"0.0";"0";"1";"1";"0";"1";"0";"457182";"373894"
"V4mis1";"SILVA (only NR);Eukaryota;Amorphea;Obazoa;Opisthokonta;Nucletmycea;Fungi;Dikarya;Basidiomycota;Agaricomycotina;Agaricomycetes;Russulales;uncultured;";"0.0";"0";"2";"2";"0";"2";"0";"457181";"373894"
"V4mis1";"SILVA (only NR);Eukaryota;Amorphea;Obazoa;Opisthokonta;Nucletmycea;Fungi;Dikarya;Basidiomycota;Agaricomycotina;Agaricomycetes;Sebacinales;";"0.0";"0";"7";"7";"0";"7";"0";"457176";"373894"
"V4mis1";"SILVA (only NR);Eukaryota;Amorphea;Obazoa;Opisthokonta;Nucletmycea;Fungi;Dikarya;Basidiomycota;Agaricomycotina;Agaricomycetes;Sebacinales;Chaetospermum;";"0.0";"0";"1";"1";"0";"1";"0";"457182";"373894"
"V4mis1";"SILVA (only NR);Eukaryota;Amorphea;Obazoa;Opisthokonta;Nucletmycea;Fungi;Dikarya;Basidiomycota;Agaricomycotina;Agaricomycetes;Sebacinales;Sebacinaceae;";"0.0";"0";"6";"6";"0";"6";"0";"457177";"373894"
"V4mis1";"SILVA (only NR);Eukaryota;Amorphea;Obazoa;Opisthokonta;Nucletmycea;Fungi;Dikarya;Basidiomycota;Agaricomycotina;Agaricomycetes;Sebacinales;Sebacinaceae;Craterocolla;";"0.0";"0";"1";"1";"0";"1";"0";"457182";"373894"
"V4mis1";"SILVA (only NR);Eukaryota;Amorphea;Obazoa;Opisthokonta;Nucletmycea;Fungi;Dikarya;Basidiomycota;Agaricomycotina;Agaricomycetes;Sebacinales;Sebacinaceae;Sebacina;";"0.0";"0";"4";"4";"0";"4";"0";"457179";"373894"
"V4mis1";"SILVA (only NR);Eukaryota;Amorphea;Obazoa;Opisthokonta;Nucletmycea;Fungi;Dikarya;Basidiomycota;Agaricomycotina;Agaricomycetes;Thelephorales;";"0.0";"0";"18";"18";"0";"18";"0";"457165";"373894"
"V4mis1";"SILVA (only NR);Eukaryota;Amorphea;Obazoa;Opisthokonta;Nucletmycea;Fungi;Dikarya;Basidiomycota;Agaricomycotina;Agaricomycetes;Thelephorales;Boletopsis;";"0.0";"0";"1";"1";"0";"1";"0";"457182";"373894"
"V4mis1";"SILVA (only NR);Eukaryota;Amorphea;Obazoa;Opisthokonta;Nucletmycea;Fungi;Dikarya;Basidiomycota;Agaricomycotina;Agaricomycetes;Thelephorales;Thelephoraceae;";"0.0";"0";"5";"5";"0";"5";"0";"457178";"373894"
"V4mis1";"SILVA (only NR);Eukaryota;Amorphea;Obazoa;Opisthokonta;Nucletmycea;Fungi;Dikarya;Basidiomycota;Agaricomycotina;Agaricomycetes;Thelephorales;Thelephoraceae;Hydnellum;";"0.0";"0";"2";"2";"0";"2";"0";"457181";"373894"
"V4mis1";"SILVA (only NR);Eukaryota;Amorphea;Obazoa;Opisthokonta;Nucletmycea;Fungi;Dikarya;Basidiomycota;Agaricomycotina;Agaricomycetes;Thelephorales;Thelephoraceae;Polyozellus;";"0.0";"0";"1";"1";"0";"1";"0";"457182";"373894"
"V4mis1";"SILVA (only NR);Eukaryota;Amorphea;Obazoa;Opisthokonta;Nucletmycea;Fungi;Dikarya;Basidiomycota;Agaricomycotina;Agaricomycetes;Thelephorales;Thelephoraceae;Sarcodon;";"0.0";"0";"1";"1";"0";"1";"0";"457182";"373894"
"V4mis1";"SILVA (only NR);Eukaryota;Amorphea;Obazoa;Opisthokonta;Nucletmycea;Fungi;Dikarya;Basidiomycota;Agaricomycotina;Agaricomycetes;Thelephorales;uncultured;";"0.0";"0";"9";"9";"0";"9";"0";"457174";"373894"
"V4mis1";"SILVA (only NR);Eukaryota;Amorphea;Obazoa;Opisthokonta;Nucletmycea;Fungi;Dikarya;Basidiomycota;Agaricomycotina;Agaricomycetes;Trechisporales;";"0.0";"0";"2";"2";"0";"2";"0";"457181";"373894"
"V4mis1";"SILVA (only NR);Eukaryota;Amorphea;Obazoa;Opisthokonta;Nucletmycea;Fungi;Dikarya;Basidiomycota;Agaricomycotina;Agaricomycetes;Trechisporales;Hydnodontaceae;";"0.0";"0";"2";"2";"0";"2";"0";"457181";"373894"
"V4mis1";"SILVA (only NR);Eukaryota;Amorphea;Obazoa;Opisthokonta;Nucletmycea;Fungi;Dikarya;Basidiomycota;Agaricomycotina;Agaricomycetes;Trechisporales;Hydnodontaceae;Trechispora;";"0.0";"0";"2";"2";"0";"2";"0";"457181";"373894"
"V4mis1";"SILVA (only NR);Eukaryota;Amorphea;Obazoa;Opisthokonta;Nucletmycea;Fungi;Dikarya;Basidiomycota;Agaricomycotina;Agaricomycetes;uncultured;";"0.0";"0";"13";"13";"0";"13";"0";"457170";"373894"
"V4mis1";"SILVA (only NR);Eukaryota;Amorphea;Obazoa;Opisthokonta;Nucletmycea;Fungi;Dikarya;Basidiomycota;Agaricomycotina;Dacrymycetes;";"0.0";"0";"50";"50";"0";"50";"0";"457133";"373894"
"V4mis1";"SILVA (only NR);Eukaryota;Amorphea;Obazoa;Opisthokonta;Nucletmycea;Fungi;Dikarya;Basidiomycota;Agaricomycotina;Dacrymycetes;Dacrymycetales;";"0.0";"0";"50";"50";"0";"50";"0";"457133";"373894"
"V4mis1";"SILVA (only NR);Eukaryota;Amorphea;Obazoa;Opisthokonta;Nucletmycea;Fungi;Dikarya;Basidiomycota;Agaricomycotina;Dacrymycetes;Dacrymycetales;Cerinomycetaceae;";"0.0";"0";"7";"7";"0";"7";"0";"457176";"373894"
"V4mis1";"SILVA (only NR);Eukaryota;Amorphea;Obazoa;Opisthokonta;Nucletmycea;Fungi;Dikarya;Basidiomycota;Agaricomycotina;Dacrymycetes;Dacrymycetales;Cerinomycetaceae;Cerinomyces;";"0.0";"0";"7";"7";"0";"7";"0";"457176";"373894"
"V4mis1";"SILVA (only NR);Eukaryota;Amorphea;Obazoa;Opisthokonta;Nucletmycea;Fungi;Dikarya;Basidiomycota;Agaricomycotina;Dacrymycetes;Dacrymycetales;Dacrymycetaceae;";"0.0";"0";"42";"42";"0";"42";"0";"457141";"373894"
"V4mis1";"SILVA (only NR);Eukaryota;Amorphea;Obazoa;Opisthokonta;Nucletmycea;Fungi;Dikarya;Basidiomycota;Agaricomycotina;Dacrymycetes;Dacrymycetales;Dacrymycetaceae;Calocera;";"0.0";"0";"4";"4";"0";"4";"0";"457179";"373894"
"V4mis1";"SILVA (only NR);Eukaryota;Amorphea;Obazoa;Opisthokonta;Nucletmycea;Fungi;Dikarya;Basidiomycota;Agaricomycotina;Dacrymycetes;Dacrymycetales;Dacrymycetaceae;Dacrymyces;";"0.0";"0";"30";"30";"0";"30";"0";"457153";"373894"
"V4mis1";"SILVA (only NR);Eukaryota;Amorphea;Obazoa;Opisthokonta;Nucletmycea;Fungi;Dikarya;Basidiomycota;Agaricomycotina;Dacrymycetes;Dacrymycetales;Dacrymycetaceae;Dacryopinax;";"0.0";"0";"1";"1";"0";"1";"0";"457182";"373894"
"V4mis1";"SILVA (only NR);Eukaryota;Amorphea;Obazoa;Opisthokonta;Nucletmycea;Fungi;Dikarya;Basidiomycota;Agaricomycotina;Dacrymycetes;Dacrymycetales;Dacrymycetaceae;Ditiola;";"0.0";"0";"1";"1";"0";"1";"0";"457182";"373894"
"V4mis1";"SILVA (only NR);Eukaryota;Amorphea;Obazoa;Opisthokonta;Nucletmycea;Fungi;Dikarya;Basidiomycota;Agaricomycotina;Dacrymycetes;Dacrymycetales;Dacrymycetaceae;Femsjonia;";"0.0";"0";"1";"1";"0";"1";"0";"457182";"373894"
"V4mis1";"SILVA (only NR);Eukaryota;Amorphea;Obazoa;Opisthokonta;Nucletmycea;Fungi;Dikarya;Basidiomycota;Agaricomycotina;Dacrymycetes;Dacrymycetales;Dacrymycetaceae;Guepiniopsis;";"0.0";"0";"1";"1";"0";"1";"0";"457182";"373894"
"V4mis1";"SILVA (only NR);Eukaryota;Amorphea;Obazoa;Opisthokonta;Nucletmycea;Fungi;Dikarya;Basidiomycota;Agaricomycotina;Dacrymycetes;Dacrymycetales;Dacrymycetaceae;Heterotextus;";"0.0";"0";"2";"2";"0";"2";"0";"457181";"373894"
"V4mis1";"SILVA (only NR);Eukaryota;Amorphea;Obazoa;Opisthokonta;Nucletmycea;Fungi;Dikarya;Basidiomycota;Agaricomycotina;Geminibasidiomycetes;";"0.0";"0";"2";"2";"0";"2";"0";"457181";"373894"
"V4mis1";"SILVA (only NR);Eukaryota;Amorphea;Obazoa;Opisthokonta;Nucletmycea;Fungi;Dikarya;Basidiomycota;Agaricomycotina;Geminibasidiomycetes;Geminibasidiales;";"0.0";"0";"2";"2";"0";"2";"0";"457181";"373894"
"V4mis1";"SILVA (only NR);Eukaryota;Amorphea;Obazoa;Opisthokonta;Nucletmycea;Fungi;Dikarya;Basidiomycota;Agaricomycotina;Geminibasidiomycetes;Geminibasidiales;Geminibasidiaceae;";"0.0";"0";"2";"2";"0";"2";"0";"457181";"373894"
"V4mis1";"SILVA (only NR);Eukaryota;Amorphea;Obazoa;Opisthokonta;Nucletmycea;Fungi;Dikarya;Basidiomycota;Agaricomycotina;Geminibasidiomycetes;Geminibasidiales;Geminibasidiaceae;Basidioascus;";"0.0";"0";"1";"1";"0";"1";"0";"457182";"373894"
"V4mis1";"SILVA (only NR);Eukaryota;Amorphea;Obazoa;Opisthokonta;Nucletmycea;Fungi;Dikarya;Basidiomycota;Agaricomycotina;Geminibasidiomycetes;Geminibasidiales;Geminibasidiaceae;Geminibasidium;";"0.0";"0";"1";"1";"0";"1";"0";"457182";"373894"
"V4mis1";"SILVA (only NR);Eukaryota;Amorphea;Obazoa;Opisthokonta;Nucletmycea;Fungi;Dikarya;Basidiomycota;Agaricomycotina;Tremellomycetes;";"11.9";"18.1";"444";"444";"53";"391";"0";"456739";"373841"
"V4mis1";"SILVA (only NR);Eukaryota;Amorphea;Obazoa;Opisthokonta;Nucletmycea;Fungi;Dikarya;Basidiomycota;Agaricomycotina;Tremellomycetes;Cystofilobasidiales;";"0.0";"0";"30";"30";"0";"30";"0";"457153";"373894"
"V4mis1";"SILVA (only NR);Eukaryota;Amorphea;Obazoa;Opisthokonta;Nucletmycea;Fungi;Dikarya;Basidiomycota;Agaricomycotina;Tremellomycetes;Cystofilobasidiales;Cystofilobasidiaceae;";"0.0";"0";"11";"11";"0";"11";"0";"457172";"373894"
"V4mis1";"SILVA (only NR);Eukaryota;Amorphea;Obazoa;Opisthokonta;Nucletmycea;Fungi;Dikarya;Basidiomycota;Agaricomycotina;Tremellomycetes;Cystofilobasidiales;Cystofilobasidiaceae;Cystofilobasidium;";"0.0";"0";"11";"11";"0";"11";"0";"457172";"373894"
"V4mis1";"SILVA (only NR);Eukaryota;Amorphea;Obazoa;Opisthokonta;Nucletmycea;Fungi;Dikarya;Basidiomycota;Agaricomycotina;Tremellomycetes;Cystofilobasidiales;Mrakiaceae;";"0.0";"0";"19";"19";"0";"19";"0";"457164";"373894"
"V4mis1";"SILVA (only NR);Eukaryota;Amorphea;Obazoa;Opisthokonta;Nucletmycea;Fungi;Dikarya;Basidiomycota;Agaricomycotina;Tremellomycetes;Cystofilobasidiales;Mrakiaceae;Itersonilia;";"0.0";"0";"3";"3";"0";"3";"0";"457180";"373894"
"V4mis1";"SILVA (only NR);Eukaryota;Amorphea;Obazoa;Opisthokonta;Nucletmycea;Fungi;Dikarya;Basidiomycota;Agaricomycotina;Tremellomycetes;Cystofilobasidiales;Mrakiaceae;Mrakia;";"0.0";"0";"6";"6";"0";"6";"0";"457177";"373894"
"V4mis1";"SILVA (only NR);Eukaryota;Amorphea;Obazoa;Opisthokonta;Nucletmycea;Fungi;Dikarya;Basidiomycota;Agaricomycotina;Tremellomycetes;Cystofilobasidiales;Mrakiaceae;Phaffia;";"0.0";"0";"1";"1";"0";"1";"0";"457182";"373894"
"V4mis1";"SILVA (only NR);Eukaryota;Amorphea;Obazoa;Opisthokonta;Nucletmycea;Fungi;Dikarya;Basidiomycota;Agaricomycotina;Tremellomycetes;Cystofilobasidiales;Mrakiaceae;Tausonia;";"0.0";"0";"1";"1";"0";"1";"0";"457182";"373894"
"V4mis1";"SILVA (only NR);Eukaryota;Amorphea;Obazoa;Opisthokonta;Nucletmycea;Fungi;Dikarya;Basidiomycota;Agaricomycotina;Tremellomycetes;Cystofilobasidiales;Mrakiaceae;Udeniomyces;";"0.0";"0";"4";"4";"0";"4";"0";"457179";"373894"
"V4mis1";"SILVA (only NR);Eukaryota;Amorphea;Obazoa;Opisthokonta;Nucletmycea;Fungi;Dikarya;Basidiomycota;Agaricomycotina;Tremellomycetes;Cystofilobasidiales;Mrakiaceae;Xanthophyllomyces;";"0.0";"0";"1";"1";"0";"1";"0";"457182";"373894"
"V4mis1";"SILVA (only NR);Eukaryota;Amorphea;Obazoa;Opisthokonta;Nucletmycea;Fungi;Dikarya;Basidiomycota;Agaricomycotina;Tremellomycetes;Filobasidiales;";"50.0";"18.2";"106";"106";"53";"53";"0";"457077";"373841"
"V4mis1";"SILVA (only NR);Eukaryota;Amorphea;Obazoa;Opisthokonta;Nucletmycea;Fungi;Dikarya;Basidiomycota;Agaricomycotina;Tremellomycetes;Filobasidiales;Filobasidiaceae;";"55.3";"18.2";"94";"94";"52";"42";"0";"457089";"373842"
"V4mis1";"SILVA (only NR);Eukaryota;Amorphea;Obazoa;Opisthokonta;Nucletmycea;Fungi;Dikarya;Basidiomycota;Agaricomycotina;Tremellomycetes;Filobasidiales;Filobasidiaceae;Filobasidium;";"0.0";"0";"12";"12";"0";"12";"0";"457171";"373894"
"V4mis1";"SILVA (only NR);Eukaryota;Amorphea;Obazoa;Opisthokonta;Nucletmycea;Fungi;Dikarya;Basidiomycota;Agaricomycotina;Tremellomycetes;Filobasidiales;Filobasidiaceae;Goffeauzyma;";"0.0";"0";"7";"7";"0";"7";"0";"457176";"373894"
"V4mis1";"SILVA (only NR);Eukaryota;Amorphea;Obazoa;Opisthokonta;Nucletmycea;Fungi;Dikarya;Basidiomycota;Agaricomycotina;Tremellomycetes;Filobasidiales;Filobasidiaceae;Heterocephalacria;";"0.0";"0";"10";"10";"0";"10";"0";"457173";"373894"
"V4mis1";"SILVA (only NR);Eukaryota;Amorphea;Obazoa;Opisthokonta;Nucletmycea;Fungi;Dikarya;Basidiomycota;Agaricomycotina;Tremellomycetes;Filobasidiales;Filobasidiaceae;Naganishia;";"96.3";"18.2";"54";"54";"52";"2";"0";"457129";"373842"
"V4mis1";"SILVA (only NR);Eukaryota;Amorphea;Obazoa;Opisthokonta;Nucletmycea;Fungi;Dikarya;Basidiomycota;Agaricomycotina;Tremellomycetes;Filobasidiales;Filobasidiaceae;[Cryptococcus];";"0.0";"0";"1";"1";"0";"1";"0";"457182";"373894"
"V4mis1";"SILVA (only NR);Eukaryota;Amorphea;Obazoa;Opisthokonta;Nucletmycea;Fungi;Dikarya;Basidiomycota;Agaricomycotina;Tremellomycetes;Filobasidiales;Filobasidiaceae;uncultured;";"0.0";"0";"8";"8";"0";"8";"0";"457175";"373894"
"V4mis1";"SILVA (only NR);Eukaryota;Amorphea;Obazoa;Opisthokonta;Nucletmycea;Fungi;Dikarya;Basidiomycota;Agaricomycotina;Tremellomycetes;Filobasidiales;Piskurozymaceae;";"0.0";"0";"11";"11";"0";"11";"0";"457172";"373894"
"V4mis1";"SILVA (only NR);Eukaryota;Amorphea;Obazoa;Opisthokonta;Nucletmycea;Fungi;Dikarya;Basidiomycota;Agaricomycotina;Tremellomycetes;Filobasidiales;Piskurozymaceae;Piskurozyma;";"0.0";"0";"3";"3";"0";"3";"0";"457180";"373894"
"V4mis1";"SILVA (only NR);Eukaryota;Amorphea;Obazoa;Opisthokonta;Nucletmycea;Fungi;Dikarya;Basidiomycota;Agaricomycotina;Tremellomycetes;Filobasidiales;Piskurozymaceae;Solicoccozyma;";"0.0";"0";"8";"8";"0";"8";"0";"457175";"373894"
"V4mis1";"SILVA (only NR);Eukaryota;Amorphea;Obazoa;Opisthokonta;Nucletmycea;Fungi;Dikarya;Basidiomycota;Agaricomycotina;Tremellomycetes;Holtermanniales;";"0.0";"0";"2";"2";"0";"2";"0";"457181";"373894"
"V4mis1";"SILVA (only NR);Eukaryota;Amorphea;Obazoa;Opisthokonta;Nucletmycea;Fungi;Dikarya;Basidiomycota;Agaricomycotina;Tremellomycetes;Holtermanniales;Incertae Sedis;";"0.0";"0";"2";"2";"0";"2";"0";"457181";"373894"
"V4mis1";"SILVA (only NR);Eukaryota;Amorphea;Obazoa;Opisthokonta;Nucletmycea;Fungi;Dikarya;Basidiomycota;Agaricomycotina;Tremellomycetes;Holtermanniales;Incertae Sedis;Holtermanniella;";"0.0";"0";"2";"2";"0";"2";"0";"457181";"373894"
"V4mis1";"SILVA (only NR);Eukaryota;Amorphea;Obazoa;Opisthokonta;Nucletmycea;Fungi;Dikarya;Basidiomycota;Agaricomycotina;Tremellomycetes;Tremellales;";"0.0";"0";"209";"209";"0";"209";"0";"456974";"373894"
"V4mis1";"SILVA (only NR);Eukaryota;Amorphea;Obazoa;Opisthokonta;Nucletmycea;Fungi;Dikarya;Basidiomycota;Agaricomycotina;Tremellomycetes;Tremellales;Bulleraceae;";"0.0";"0";"9";"9";"0";"9";"0";"457174";"373894"
"V4mis1";"SILVA (only NR);Eukaryota;Amorphea;Obazoa;Opisthokonta;Nucletmycea;Fungi;Dikarya;Basidiomycota;Agaricomycotina;Tremellomycetes;Tremellales;Bulleraceae;Bullera;";"0.0";"0";"7";"7";"0";"7";"0";"457176";"373894"
"V4mis1";"SILVA (only NR);Eukaryota;Amorphea;Obazoa;Opisthokonta;Nucletmycea;Fungi;Dikarya;Basidiomycota;Agaricomycotina;Tremellomycetes;Tremellales;Bulleraceae;Pseudotremella;";"0.0";"0";"2";"2";"0";"2";"0";"457181";"373894"
"V4mis1";"SILVA (only NR);Eukaryota;Amorphea;Obazoa;Opisthokonta;Nucletmycea;Fungi;Dikarya;Basidiomycota;Agaricomycotina;Tremellomycetes;Tremellales;Bulleribasidiaceae;";"0.0";"0";"62";"62";"0";"62";"0";"457121";"373894"
"V4mis1";"SILVA (only NR);Eukaryota;Amorphea;Obazoa;Opisthokonta;Nucletmycea;Fungi;Dikarya;Basidiomycota;Agaricomycotina;Tremellomycetes;Tremellales;Bulleribasidiaceae;Bulleribasidium;";"0.0";"0";"9";"9";"0";"9";"0";"457174";"373894"
"V4mis1";"SILVA (only NR);Eukaryota;Amorphea;Obazoa;Opisthokonta;Nucletmycea;Fungi;Dikarya;Basidiomycota;Agaricomycotina;Tremellomycetes;Tremellales;Bulleribasidiaceae;Derxomyces;";"0.0";"0";"22";"22";"0";"22";"0";"457161";"373894"
"V4mis1";"SILVA (only NR);Eukaryota;Amorphea;Obazoa;Opisthokonta;Nucletmycea;Fungi;Dikarya;Basidiomycota;Agaricomycotina;Tremellomycetes;Tremellales;Bulleribasidiaceae;Dioszegia;";"0.0";"0";"9";"9";"0";"9";"0";"457174";"373894"
"V4mis1";"SILVA (only NR);Eukaryota;Amorphea;Obazoa;Opisthokonta;Nucletmycea;Fungi;Dikarya;Basidiomycota;Agaricomycotina;Tremellomycetes;Tremellales;Bulleribasidiaceae;Hannaella;";"0.0";"0";"10";"10";"0";"10";"0";"457173";"373894"
"V4mis1";"SILVA (only NR);Eukaryota;Amorphea;Obazoa;Opisthokonta;Nucletmycea;Fungi;Dikarya;Basidiomycota;Agaricomycotina;Tremellomycetes;Tremellales;Bulleribasidiaceae;Nielozyma;";"0.0";"0";"1";"1";"0";"1";"0";"457182";"373894"
"V4mis1";"SILVA (only NR);Eukaryota;Amorphea;Obazoa;Opisthokonta;Nucletmycea;Fungi;Dikarya;Basidiomycota;Agaricomycotina;Tremellomycetes;Tremellales;Bulleribasidiaceae;Vishniacozyma;";"0.0";"0";"11";"11";"0";"11";"0";"457172";"373894"
"V4mis1";"SILVA (only NR);Eukaryota;Amorphea;Obazoa;Opisthokonta;Nucletmycea;Fungi;Dikarya;Basidiomycota;Agaricomycotina;Tremellomycetes;Tremellales;Carcinomycetaceae;";"0.0";"0";"6";"6";"0";"6";"0";"457177";"373894"
"V4mis1";"SILVA (only NR);Eukaryota;Amorphea;Obazoa;Opisthokonta;Nucletmycea;Fungi;Dikarya;Basidiomycota;Agaricomycotina;Tremellomycetes;Tremellales;Carcinomycetaceae;Carcinomyces;";"0.0";"0";"6";"6";"0";"6";"0";"457177";"373894"
"V4mis1";"SILVA (only NR);Eukaryota;Amorphea;Obazoa;Opisthokonta;Nucletmycea;Fungi;Dikarya;Basidiomycota;Agaricomycotina;Tremellomycetes;Tremellales;Cryptococcaceae;";"0.0";"0";"26";"26";"0";"26";"0";"457157";"373894"
"V4mis1";"SILVA (only NR);Eukaryota;Amorphea;Obazoa;Opisthokonta;Nucletmycea;Fungi;Dikarya;Basidiomycota;Agaricomycotina;Tremellomycetes;Tremellales;Cryptococcaceae;Cryptococcus;";"0.0";"0";"24";"24";"0";"24";"0";"457159";"373894"
"V4mis1";"SILVA (only NR);Eukaryota;Amorphea;Obazoa;Opisthokonta;Nucletmycea;Fungi;Dikarya;Basidiomycota;Agaricomycotina;Tremellomycetes;Tremellales;Cryptococcaceae;Kwoniella;";"0.0";"0";"2";"2";"0";"2";"0";"457181";"373894"
"V4mis1";"SILVA (only NR);Eukaryota;Amorphea;Obazoa;Opisthokonta;Nucletmycea;Fungi;Dikarya;Basidiomycota;Agaricomycotina;Tremellomycetes;Tremellales;Cuniculitremaceae;";"0.0";"0";"27";"27";"0";"27";"0";"457156";"373894"
"V4mis1";"SILVA (only NR);Eukaryota;Amorphea;Obazoa;Opisthokonta;Nucletmycea;Fungi;Dikarya;Basidiomycota;Agaricomycotina;Tremellomycetes;Tremellales;Cuniculitremaceae;Fellomyces;";"0.0";"0";"4";"4";"0";"4";"0";"457179";"373894"
"V4mis1";"SILVA (only NR);Eukaryota;Amorphea;Obazoa;Opisthokonta;Nucletmycea;Fungi;Dikarya;Basidiomycota;Agaricomycotina;Tremellomycetes;Tremellales;Cuniculitremaceae;Kockovaella;";"0.0";"0";"23";"23";"0";"23";"0";"457160";"373894"
"V4mis1";"SILVA (only NR);Eukaryota;Amorphea;Obazoa;Opisthokonta;Nucletmycea;Fungi;Dikarya;Basidiomycota;Agaricomycotina;Tremellomycetes;Tremellales;Dimennazyma;";"0.0";"0";"1";"1";"0";"1";"0";"457182";"373894"
"V4mis1";"SILVA (only NR);Eukaryota;Amorphea;Obazoa;Opisthokonta;Nucletmycea;Fungi;Dikarya;Basidiomycota;Agaricomycotina;Tremellomycetes;Tremellales;Genolevuria;";"0.0";"0";"1";"1";"0";"1";"0";"457182";"373894"
"V4mis1";"SILVA (only NR);Eukaryota;Amorphea;Obazoa;Opisthokonta;Nucletmycea;Fungi;Dikarya;Basidiomycota;Agaricomycotina;Tremellomycetes;Tremellales;Phaeotremellaceae;";"0.0";"0";"3";"3";"0";"3";"0";"457180";"373894"
"V4mis1";"SILVA (only NR);Eukaryota;Amorphea;Obazoa;Opisthokonta;Nucletmycea;Fungi;Dikarya;Basidiomycota;Agaricomycotina;Tremellomycetes;Tremellales;Phaeotremellaceae;Phaeotremella;";"0.0";"0";"3";"3";"0";"3";"0";"457180";"373894"
"V4mis1";"SILVA (only NR);Eukaryota;Amorphea;Obazoa;Opisthokonta;Nucletmycea;Fungi;Dikarya;Basidiomycota;Agaricomycotina;Tremellomycetes;Tremellales;Rhynchogastrema;";"0.0";"0";"1";"1";"0";"1";"0";"457182";"373894"
"V4mis1";"SILVA (only NR);Eukaryota;Amorphea;Obazoa;Opisthokonta;Nucletmycea;Fungi;Dikarya;Basidiomycota;Agaricomycotina;Tremellomycetes;Tremellales;Rhynchogastremataceae;";"0.0";"0";"16";"16";"0";"16";"0";"457167";"373894"
"V4mis1";"SILVA (only NR);Eukaryota;Amorphea;Obazoa;Opisthokonta;Nucletmycea;Fungi;Dikarya;Basidiomycota;Agaricomycotina;Tremellomycetes;Tremellales;Rhynchogastremataceae;Papiliotrema;";"0.0";"0";"12";"12";"0";"12";"0";"457171";"373894"
"V4mis1";"SILVA (only NR);Eukaryota;Amorphea;Obazoa;Opisthokonta;Nucletmycea;Fungi;Dikarya;Basidiomycota;Agaricomycotina;Tremellomycetes;Tremellales;Rhynchogastremataceae;Rhynchogastrema;";"0.0";"0";"3";"3";"0";"3";"0";"457180";"373894"
"V4mis1";"SILVA (only NR);Eukaryota;Amorphea;Obazoa;Opisthokonta;Nucletmycea;Fungi;Dikarya;Basidiomycota;Agaricomycotina;Tremellomycetes;Tremellales;Sirobasidiaceae;";"0.0";"0";"9";"9";"0";"9";"0";"457174";"373894"
"V4mis1";"SILVA (only NR);Eukaryota;Amorphea;Obazoa;Opisthokonta;Nucletmycea;Fungi;Dikarya;Basidiomycota;Agaricomycotina;Tremellomycetes;Tremellales;Sirobasidiaceae;Fibulobasidium;";"0.0";"0";"3";"3";"0";"3";"0";"457180";"373894"
"V4mis1";"SILVA (only NR);Eukaryota;Amorphea;Obazoa;Opisthokonta;Nucletmycea;Fungi;Dikarya;Basidiomycota;Agaricomycotina;Tremellomycetes;Tremellales;Sirobasidiaceae;Sirobasidium;";"0.0";"0";"6";"6";"0";"6";"0";"457177";"373894"
"V4mis1";"SILVA (only NR);Eukaryota;Amorphea;Obazoa;Opisthokonta;Nucletmycea;Fungi;Dikarya;Basidiomycota;Agaricomycotina;Tremellomycetes;Tremellales;Sterigmatosporidium;";"0.0";"0";"1";"1";"0";"1";"0";"457182";"373894"
"V4mis1";"SILVA (only NR);Eukaryota;Amorphea;Obazoa;Opisthokonta;Nucletmycea;Fungi;Dikarya;Basidiomycota;Agaricomycotina;Tremellomycetes;Tremellales;Sugitazyma;";"0.0";"0";"1";"1";"0";"1";"0";"457182";"373894"
"V4mis1";"SILVA (only NR);Eukaryota;Amorphea;Obazoa;Opisthokonta;Nucletmycea;Fungi;Dikarya;Basidiomycota;Agaricomycotina;Tremellomycetes;Tremellales;Syzygosporaceae;";"0.0";"0";"2";"2";"0";"2";"0";"457181";"373894"
"V4mis1";"SILVA (only NR);Eukaryota;Amorphea;Obazoa;Opisthokonta;Nucletmycea;Fungi;Dikarya;Basidiomycota;Agaricomycotina;Tremellomycetes;Tremellales;Syzygosporaceae;Syzygospora;";"0.0";"0";"2";"2";"0";"2";"0";"457181";"373894"
"V4mis1";"SILVA (only NR);Eukaryota;Amorphea;Obazoa;Opisthokonta;Nucletmycea;Fungi;Dikarya;Basidiomycota;Agaricomycotina;Tremellomycetes;Tremellales;Tremellaceae;";"0.0";"0";"26";"26";"0";"26";"0";"457157";"373894"
"V4mis1";"SILVA (only NR);Eukaryota;Amorphea;Obazoa;Opisthokonta;Nucletmycea;Fungi;Dikarya;Basidiomycota;Agaricomycotina;Tremellomycetes;Tremellales;Tremellaceae;Biatoropsis;";"0.0";"0";"1";"1";"0";"1";"0";"457182";"373894"
"V4mis1";"SILVA (only NR);Eukaryota;Amorphea;Obazoa;Opisthokonta;Nucletmycea;Fungi;Dikarya;Basidiomycota;Agaricomycotina;Tremellomycetes;Tremellales;Tremellaceae;Tremella;";"0.0";"0";"25";"25";"0";"25";"0";"457158";"373894"
"V4mis1";"SILVA (only NR);Eukaryota;Amorphea;Obazoa;Opisthokonta;Nucletmycea;Fungi;Dikarya;Basidiomycota;Agaricomycotina;Tremellomycetes;Tremellales;Trimorphomycetaceae;";"0.0";"0";"6";"6";"0";"6";"0";"457177";"373894"
"V4mis1";"SILVA (only NR);Eukaryota;Amorphea;Obazoa;Opisthokonta;Nucletmycea;Fungi;Dikarya;Basidiomycota;Agaricomycotina;Tremellomycetes;Tremellales;Trimorphomycetaceae;Saitozyma;";"0.0";"0";"4";"4";"0";"4";"0";"457179";"373894"
"V4mis1";"SILVA (only NR);Eukaryota;Amorphea;Obazoa;Opisthokonta;Nucletmycea;Fungi;Dikarya;Basidiomycota;Agaricomycotina;Tremellomycetes;Tremellales;Trimorphomycetaceae;Trimorphomyces;";"0.0";"0";"2";"2";"0";"2";"0";"457181";"373894"
"V4mis1";"SILVA (only NR);Eukaryota;Amorphea;Obazoa;Opisthokonta;Nucletmycea;Fungi;Dikarya;Basidiomycota;Agaricomycotina;Tremellomycetes;Tremellales;uncultured;";"0.0";"0";"7";"7";"0";"7";"0";"457176";"373894"
"V4mis1";"SILVA (only NR);Eukaryota;Amorphea;Obazoa;Opisthokonta;Nucletmycea;Fungi;Dikarya;Basidiomycota;Agaricomycotina;Tremellomycetes;Trichosporonales;";"0.0";"0";"92";"92";"0";"92";"0";"457091";"373894"
"V4mis1";"SILVA (only NR);Eukaryota;Amorphea;Obazoa;Opisthokonta;Nucletmycea;Fungi;Dikarya;Basidiomycota;Agaricomycotina;Tremellomycetes;Trichosporonales;Cryptotrichosporon;";"0.0";"0";"1";"1";"0";"1";"0";"457182";"373894"
"V4mis1";"SILVA (only NR);Eukaryota;Amorphea;Obazoa;Opisthokonta;Nucletmycea;Fungi;Dikarya;Basidiomycota;Agaricomycotina;Tremellomycetes;Trichosporonales;Tetragoniomycetaceae;";"0.0";"0";"1";"1";"0";"1";"0";"457182";"373894"
"V4mis1";"SILVA (only NR);Eukaryota;Amorphea;Obazoa;Opisthokonta;Nucletmycea;Fungi;Dikarya;Basidiomycota;Agaricomycotina;Tremellomycetes;Trichosporonales;Tetragoniomycetaceae;Bandonia;";"0.0";"0";"1";"1";"0";"1";"0";"457182";"373894"
"V4mis1";"SILVA (only NR);Eukaryota;Amorphea;Obazoa;Opisthokonta;Nucletmycea;Fungi;Dikarya;Basidiomycota;Agaricomycotina;Tremellomycetes;Trichosporonales;Trichosporonaceae;";"0.0";"0";"88";"88";"0";"88";"0";"457095";"373894"
"V4mis1";"SILVA (only NR);Eukaryota;Amorphea;Obazoa;Opisthokonta;Nucletmycea;Fungi;Dikarya;Basidiomycota;Agaricomycotina;Tremellomycetes;Trichosporonales;Trichosporonaceae;Apiotrichum;";"0.0";"0";"38";"38";"0";"38";"0";"457145";"373894"
"V4mis1";"SILVA (only NR);Eukaryota;Amorphea;Obazoa;Opisthokonta;Nucletmycea;Fungi;Dikarya;Basidiomycota;Agaricomycotina;Tremellomycetes;Trichosporonales;Trichosporonaceae;Cutaneotrichosporon;";"0.0";"0";"12";"12";"0";"12";"0";"457171";"373894"
"V4mis1";"SILVA (only NR);Eukaryota;Amorphea;Obazoa;Opisthokonta;Nucletmycea;Fungi;Dikarya;Basidiomycota;Agaricomycotina;Tremellomycetes;Trichosporonales;Trichosporonaceae;Haglerozyma;";"0.0";"0";"1";"1";"0";"1";"0";"457182";"373894"
"V4mis1";"SILVA (only NR);Eukaryota;Amorphea;Obazoa;Opisthokonta;Nucletmycea;Fungi;Dikarya;Basidiomycota;Agaricomycotina;Tremellomycetes;Trichosporonales;Trichosporonaceae;Trichosporon;";"0.0";"0";"24";"24";"0";"24";"0";"457159";"373894"
"V4mis1";"SILVA (only NR);Eukaryota;Amorphea;Obazoa;Opisthokonta;Nucletmycea;Fungi;Dikarya;Basidiomycota;Agaricomycotina;Tremellomycetes;Trichosporonales;Trichosporonaceae;Vanrija;";"0.0";"0";"13";"13";"0";"13";"0";"457170";"373894"
"V4mis1";"SILVA (only NR);Eukaryota;Amorphea;Obazoa;Opisthokonta;Nucletmycea;Fungi;Dikarya;Basidiomycota;Agaricomycotina;Wallemiomycetes;";"33.3";"18.2";"6";"6";"2";"4";"0";"457177";"373892"
"V4mis1";"SILVA (only NR);Eukaryota;Amorphea;Obazoa;Opisthokonta;Nucletmycea;Fungi;Dikarya;Basidiomycota;Agaricomycotina;Wallemiomycetes;Wallemiales;";"33.3";"18.2";"6";"6";"2";"4";"0";"457177";"373892"
"V4mis1";"SILVA (only NR);Eukaryota;Amorphea;Obazoa;Opisthokonta;Nucletmycea;Fungi;Dikarya;Basidiomycota;Agaricomycotina;Wallemiomycetes;Wallemiales;Incertae Sedis;";"33.3";"18.2";"6";"6";"2";"4";"0";"457177";"373892"
"V4mis1";"SILVA (only NR);Eukaryota;Amorphea;Obazoa;Opisthokonta;Nucletmycea;Fungi;Dikarya;Basidiomycota;Agaricomycotina;Wallemiomycetes;Wallemiales;Incertae Sedis;Wallemia;";"33.3";"18.2";"6";"6";"2";"4";"0";"457177";"373892"
"V4mis1";"SILVA (only NR);Eukaryota;Amorphea;Obazoa;Opisthokonta;Nucletmycea;Fungi;Dikarya;Basidiomycota;Pucciniomycotina;";"1.9";"18.1";"570";"569";"11";"558";"1";"456614";"373883"
"V4mis1";"SILVA (only NR);Eukaryota;Amorphea;Obazoa;Opisthokonta;Nucletmycea;Fungi;Dikarya;Basidiomycota;Pucciniomycotina;Agaricostilbomycetes;";"0.0";"0";"48";"48";"0";"48";"0";"457135";"373894"
"V4mis1";"SILVA (only NR);Eukaryota;Amorphea;Obazoa;Opisthokonta;Nucletmycea;Fungi;Dikarya;Basidiomycota;Pucciniomycotina;Agaricostilbomycetes;Agaricostilbales;";"0.0";"0";"46";"46";"0";"46";"0";"457137";"373894"
"V4mis1";"SILVA (only NR);Eukaryota;Amorphea;Obazoa;Opisthokonta;Nucletmycea;Fungi;Dikarya;Basidiomycota;Pucciniomycotina;Agaricostilbomycetes;Agaricostilbales;Agaricostilbaceae;";"0.0";"0";"11";"11";"0";"11";"0";"457172";"373894"
"V4mis1";"SILVA (only NR);Eukaryota;Amorphea;Obazoa;Opisthokonta;Nucletmycea;Fungi;Dikarya;Basidiomycota;Pucciniomycotina;Agaricostilbomycetes;Agaricostilbales;Agaricostilbaceae;Pseudobensingtonia;";"0.0";"0";"3";"3";"0";"3";"0";"457180";"373894"
"V4mis1";"SILVA (only NR);Eukaryota;Amorphea;Obazoa;Opisthokonta;Nucletmycea;Fungi;Dikarya;Basidiomycota;Pucciniomycotina;Agaricostilbomycetes;Agaricostilbales;Agaricostilbaceae;Sterigmatomyces;";"0.0";"0";"8";"8";"0";"8";"0";"457175";"373894"
"V4mis1";"SILVA (only NR);Eukaryota;Amorphea;Obazoa;Opisthokonta;Nucletmycea;Fungi;Dikarya;Basidiomycota;Pucciniomycotina;Agaricostilbomycetes;Agaricostilbales;Chionosphaeraceae;";"0.0";"0";"12";"12";"0";"12";"0";"457171";"373894"
"V4mis1";"SILVA (only NR);Eukaryota;Amorphea;Obazoa;Opisthokonta;Nucletmycea;Fungi;Dikarya;Basidiomycota;Pucciniomycotina;Agaricostilbomycetes;Agaricostilbales;Chionosphaeraceae;Ballistosporomyces;";"0.0";"0";"4";"4";"0";"4";"0";"457179";"373894"
"V4mis1";"SILVA (only NR);Eukaryota;Amorphea;Obazoa;Opisthokonta;Nucletmycea;Fungi;Dikarya;Basidiomycota;Pucciniomycotina;Agaricostilbomycetes;Agaricostilbales;Chionosphaeraceae;Chionosphaera;";"0.0";"0";"3";"3";"0";"3";"0";"457180";"373894"
"V4mis1";"SILVA (only NR);Eukaryota;Amorphea;Obazoa;Opisthokonta;Nucletmycea;Fungi;Dikarya;Basidiomycota;Pucciniomycotina;Agaricostilbomycetes;Agaricostilbales;Chionosphaeraceae;Cystobasidiopsis;";"0.0";"0";"1";"1";"0";"1";"0";"457182";"373894"
"V4mis1";"SILVA (only NR);Eukaryota;Amorphea;Obazoa;Opisthokonta;Nucletmycea;Fungi;Dikarya;Basidiomycota;Pucciniomycotina;Agaricostilbomycetes;Agaricostilbales;Chionosphaeraceae;Kurtzmanomyces;";"0.0";"0";"3";"3";"0";"3";"0";"457180";"373894"
"V4mis1";"SILVA (only NR);Eukaryota;Amorphea;Obazoa;Opisthokonta;Nucletmycea;Fungi;Dikarya;Basidiomycota;Pucciniomycotina;Agaricostilbomycetes;Agaricostilbales;Incertae Sedis;";"0.0";"0";"2";"2";"0";"2";"0";"457181";"373894"
"V4mis1";"SILVA (only NR);Eukaryota;Amorphea;Obazoa;Opisthokonta;Nucletmycea;Fungi;Dikarya;Basidiomycota;Pucciniomycotina;Agaricostilbomycetes;Agaricostilbales;Incertae Sedis;Jianyunia;";"0.0";"0";"2";"2";"0";"2";"0";"457181";"373894"
"V4mis1";"SILVA (only NR);Eukaryota;Amorphea;Obazoa;Opisthokonta;Nucletmycea;Fungi;Dikarya;Basidiomycota;Pucciniomycotina;Agaricostilbomycetes;Agaricostilbales;Kondoaceae;";"0.0";"0";"14";"14";"0";"14";"0";"457169";"373894"
"V4mis1";"SILVA (only NR);Eukaryota;Amorphea;Obazoa;Opisthokonta;Nucletmycea;Fungi;Dikarya;Basidiomycota;Pucciniomycotina;Agaricostilbomycetes;Agaricostilbales;Kondoaceae;Bensingtonia;";"0.0";"0";"3";"3";"0";"3";"0";"457180";"373894"
"V4mis1";"SILVA (only NR);Eukaryota;Amorphea;Obazoa;Opisthokonta;Nucletmycea;Fungi;Dikarya;Basidiomycota;Pucciniomycotina;Agaricostilbomycetes;Agaricostilbales;Kondoaceae;Kondoa;";"0.0";"0";"10";"10";"0";"10";"0";"457173";"373894"
"V4mis1";"SILVA (only NR);Eukaryota;Amorphea;Obazoa;Opisthokonta;Nucletmycea;Fungi;Dikarya;Basidiomycota;Pucciniomycotina;Agaricostilbomycetes;Agaricostilbales;Ruineniaceae;";"0.0";"0";"6";"6";"0";"6";"0";"457177";"373894"
"V4mis1";"SILVA (only NR);Eukaryota;Amorphea;Obazoa;Opisthokonta;Nucletmycea;Fungi;Dikarya;Basidiomycota;Pucciniomycotina;Agaricostilbomycetes;Agaricostilbales;Ruineniaceae;Ruinenia;";"0.0";"0";"6";"6";"0";"6";"0";"457177";"373894"
"V4mis1";"SILVA (only NR);Eukaryota;Amorphea;Obazoa;Opisthokonta;Nucletmycea;Fungi;Dikarya;Basidiomycota;Pucciniomycotina;Agaricostilbomycetes;Incertae Sedis;";"0.0";"0";"2";"2";"0";"2";"0";"457181";"373894"
"V4mis1";"SILVA (only NR);Eukaryota;Amorphea;Obazoa;Opisthokonta;Nucletmycea;Fungi;Dikarya;Basidiomycota;Pucciniomycotina;Agaricostilbomycetes;Incertae Sedis;Incertae Sedis;";"0.0";"0";"2";"2";"0";"2";"0";"457181";"373894"
"V4mis1";"SILVA (only NR);Eukaryota;Amorphea;Obazoa;Opisthokonta;Nucletmycea;Fungi;Dikarya;Basidiomycota;Pucciniomycotina;Agaricostilbomycetes;Incertae Sedis;Incertae Sedis;[Sporobolomyces] group;";"0.0";"0";"2";"2";"0";"2";"0";"457181";"373894"
"V4mis1";"SILVA (only NR);Eukaryota;Amorphea;Obazoa;Opisthokonta;Nucletmycea;Fungi;Dikarya;Basidiomycota;Pucciniomycotina;Atractiellomycetes;";"0.0";"0";"9";"9";"0";"9";"0";"457174";"373894"
"V4mis1";"SILVA (only NR);Eukaryota;Amorphea;Obazoa;Opisthokonta;Nucletmycea;Fungi;Dikarya;Basidiomycota;Pucciniomycotina;Atractiellomycetes;Atractiellales;";"0.0";"0";"9";"9";"0";"9";"0";"457174";"373894"
"V4mis1";"SILVA (only NR);Eukaryota;Amorphea;Obazoa;Opisthokonta;Nucletmycea;Fungi;Dikarya;Basidiomycota;Pucciniomycotina;Atractiellomycetes;Atractiellales;Atractidochium;";"0.0";"0";"1";"1";"0";"1";"0";"457182";"373894"
"V4mis1";"SILVA (only NR);Eukaryota;Amorphea;Obazoa;Opisthokonta;Nucletmycea;Fungi;Dikarya;Basidiomycota;Pucciniomycotina;Atractiellomycetes;Atractiellales;Atractiella;";"0.0";"0";"1";"1";"0";"1";"0";"457182";"373894"
"V4mis1";"SILVA (only NR);Eukaryota;Amorphea;Obazoa;Opisthokonta;Nucletmycea;Fungi;Dikarya;Basidiomycota;Pucciniomycotina;Atractiellomycetes;Atractiellales;Helicogloea;";"0.0";"0";"1";"1";"0";"1";"0";"457182";"373894"
"V4mis1";"SILVA (only NR);Eukaryota;Amorphea;Obazoa;Opisthokonta;Nucletmycea;Fungi;Dikarya;Basidiomycota;Pucciniomycotina;Atractiellomycetes;Atractiellales;Hobsonia;";"0.0";"0";"1";"1";"0";"1";"0";"457182";"373894"
"V4mis1";"SILVA (only NR);Eukaryota;Amorphea;Obazoa;Opisthokonta;Nucletmycea;Fungi;Dikarya;Basidiomycota;Pucciniomycotina;Atractiellomycetes;Atractiellales;Neogloea;";"0.0";"0";"2";"2";"0";"2";"0";"457181";"373894"
"V4mis1";"SILVA (only NR);Eukaryota;Amorphea;Obazoa;Opisthokonta;Nucletmycea;Fungi;Dikarya;Basidiomycota;Pucciniomycotina;Atractiellomycetes;Atractiellales;Phleogena;";"0.0";"0";"1";"1";"0";"1";"0";"457182";"373894"
"V4mis1";"SILVA (only NR);Eukaryota;Amorphea;Obazoa;Opisthokonta;Nucletmycea;Fungi;Dikarya;Basidiomycota;Pucciniomycotina;Atractiellomycetes;Atractiellales;Proceropycnis;";"0.0";"0";"1";"1";"0";"1";"0";"457182";"373894"
"V4mis1";"SILVA (only NR);Eukaryota;Amorphea;Obazoa;Opisthokonta;Nucletmycea;Fungi;Dikarya;Basidiomycota;Pucciniomycotina;Classiculomycetes;";"0.0";"0";"3";"3";"0";"3";"0";"457180";"373894"
"V4mis1";"SILVA (only NR);Eukaryota;Amorphea;Obazoa;Opisthokonta;Nucletmycea;Fungi;Dikarya;Basidiomycota;Pucciniomycotina;Classiculomycetes;Classiculales;";"0.0";"0";"3";"3";"0";"3";"0";"457180";"373894"
"V4mis1";"SILVA (only NR);Eukaryota;Amorphea;Obazoa;Opisthokonta;Nucletmycea;Fungi;Dikarya;Basidiomycota;Pucciniomycotina;Classiculomycetes;Classiculales;Classiculaceae;";"0.0";"0";"3";"3";"0";"3";"0";"457180";"373894"
"V4mis1";"SILVA (only NR);Eukaryota;Amorphea;Obazoa;Opisthokonta;Nucletmycea;Fungi;Dikarya;Basidiomycota;Pucciniomycotina;Classiculomycetes;Classiculales;Classiculaceae;Classicula;";"0.0";"0";"2";"2";"0";"2";"0";"457181";"373894"
"V4mis1";"SILVA (only NR);Eukaryota;Amorphea;Obazoa;Opisthokonta;Nucletmycea;Fungi;Dikarya;Basidiomycota;Pucciniomycotina;Classiculomycetes;Classiculales;Classiculaceae;Jaculispora;";"0.0";"0";"1";"1";"0";"1";"0";"457182";"373894"
"V4mis1";"SILVA (only NR);Eukaryota;Amorphea;Obazoa;Opisthokonta;Nucletmycea;Fungi;Dikarya;Basidiomycota;Pucciniomycotina;Cystobasidiomycetes;";"0.0";"0";"70";"69";"0";"69";"1";"457114";"373894"
"V4mis1";"SILVA (only NR);Eukaryota;Amorphea;Obazoa;Opisthokonta;Nucletmycea;Fungi;Dikarya;Basidiomycota;Pucciniomycotina;Cystobasidiomycetes;Cyphobasidiales;";"0.0";"0";"1";"1";"0";"1";"0";"457182";"373894"
"V4mis1";"SILVA (only NR);Eukaryota;Amorphea;Obazoa;Opisthokonta;Nucletmycea;Fungi;Dikarya;Basidiomycota;Pucciniomycotina;Cystobasidiomycetes;Cyphobasidiales;Cyphobasidiaceae;";"0.0";"0";"1";"1";"0";"1";"0";"457182";"373894"
"V4mis1";"SILVA (only NR);Eukaryota;Amorphea;Obazoa;Opisthokonta;Nucletmycea;Fungi;Dikarya;Basidiomycota;Pucciniomycotina;Cystobasidiomycetes;Cyphobasidiales;Cyphobasidiaceae;Cyphobasidium;";"0.0";"0";"1";"1";"0";"1";"0";"457182";"373894"
"V4mis1";"SILVA (only NR);Eukaryota;Amorphea;Obazoa;Opisthokonta;Nucletmycea;Fungi;Dikarya;Basidiomycota;Pucciniomycotina;Cystobasidiomycetes;Cystobasidiales;";"0.0";"0";"9";"9";"0";"9";"0";"457174";"373894"
"V4mis1";"SILVA (only NR);Eukaryota;Amorphea;Obazoa;Opisthokonta;Nucletmycea;Fungi;Dikarya;Basidiomycota;Pucciniomycotina;Cystobasidiomycetes;Cystobasidiales;Cystobasidiaceae;";"0.0";"0";"7";"7";"0";"7";"0";"457176";"373894"
"V4mis1";"SILVA (only NR);Eukaryota;Amorphea;Obazoa;Opisthokonta;Nucletmycea;Fungi;Dikarya;Basidiomycota;Pucciniomycotina;Cystobasidiomycetes;Cystobasidiales;Cystobasidiaceae;Cystobasidium;";"0.0";"0";"7";"7";"0";"7";"0";"457176";"373894"
"V4mis1";"SILVA (only NR);Eukaryota;Amorphea;Obazoa;Opisthokonta;Nucletmycea;Fungi;Dikarya;Basidiomycota;Pucciniomycotina;Cystobasidiomycetes;Cystobasidiales;Incertae Sedis;";"0.0";"0";"2";"2";"0";"2";"0";"457181";"373894"
"V4mis1";"SILVA (only NR);Eukaryota;Amorphea;Obazoa;Opisthokonta;Nucletmycea;Fungi;Dikarya;Basidiomycota;Pucciniomycotina;Cystobasidiomycetes;Cystobasidiales;Incertae Sedis;Occultifur;";"0.0";"0";"2";"2";"0";"2";"0";"457181";"373894"
"V4mis1";"SILVA (only NR);Eukaryota;Amorphea;Obazoa;Opisthokonta;Nucletmycea;Fungi;Dikarya;Basidiomycota;Pucciniomycotina;Cystobasidiomycetes;Erythrobasidiales;";"0.0";"0";"20";"20";"0";"20";"0";"457163";"373894"
"V4mis1";"SILVA (only NR);Eukaryota;Amorphea;Obazoa;Opisthokonta;Nucletmycea;Fungi;Dikarya;Basidiomycota;Pucciniomycotina;Cystobasidiomycetes;Erythrobasidiales;Erythrobasidiaceae;";"0.0";"0";"18";"18";"0";"18";"0";"457165";"373894"
"V4mis1";"SILVA (only NR);Eukaryota;Amorphea;Obazoa;Opisthokonta;Nucletmycea;Fungi;Dikarya;Basidiomycota;Pucciniomycotina;Cystobasidiomycetes;Erythrobasidiales;Erythrobasidiaceae;Bannoa;";"0.0";"0";"14";"14";"0";"14";"0";"457169";"373894"
"V4mis1";"SILVA (only NR);Eukaryota;Amorphea;Obazoa;Opisthokonta;Nucletmycea;Fungi;Dikarya;Basidiomycota;Pucciniomycotina;Cystobasidiomycetes;Erythrobasidiales;Erythrobasidiaceae;Erythrobasidium;";"0.0";"0";"4";"4";"0";"4";"0";"457179";"373894"
"V4mis1";"SILVA (only NR);Eukaryota;Amorphea;Obazoa;Opisthokonta;Nucletmycea;Fungi;Dikarya;Basidiomycota;Pucciniomycotina;Cystobasidiomycetes;Erythrobasidiales;Incertae Sedis;";"0.0";"0";"2";"2";"0";"2";"0";"457181";"373894"
"V4mis1";"SILVA (only NR);Eukaryota;Amorphea;Obazoa;Opisthokonta;Nucletmycea;Fungi;Dikarya;Basidiomycota;Pucciniomycotina;Cystobasidiomycetes;Erythrobasidiales;Incertae Sedis;Hasegawazyma;";"0.0";"0";"2";"2";"0";"2";"0";"457181";"373894"
"V4mis1";"SILVA (only NR);Eukaryota;Amorphea;Obazoa;Opisthokonta;Nucletmycea;Fungi;Dikarya;Basidiomycota;Pucciniomycotina;Cystobasidiomycetes;Incertae Sedis;";"0.0";"0";"35";"34";"0";"34";"1";"457149";"373894"
"V4mis1";"SILVA (only NR);Eukaryota;Amorphea;Obazoa;Opisthokonta;Nucletmycea;Fungi;Dikarya;Basidiomycota;Pucciniomycotina;Cystobasidiomycetes;Incertae Sedis;Incertae Sedis;";"0.0";"0";"35";"34";"0";"34";"1";"457149";"373894"
"V4mis1";"SILVA (only NR);Eukaryota;Amorphea;Obazoa;Opisthokonta;Nucletmycea;Fungi;Dikarya;Basidiomycota;Pucciniomycotina;Cystobasidiomycetes;Incertae Sedis;Incertae Sedis;Buckleyzyma;";"0.0";"0";"9";"9";"0";"9";"0";"457174";"373894"
"V4mis1";"SILVA (only NR);Eukaryota;Amorphea;Obazoa;Opisthokonta;Nucletmycea;Fungi;Dikarya;Basidiomycota;Pucciniomycotina;Cystobasidiomycetes;Incertae Sedis;Incertae Sedis;Cyrenella;";"0.0";"0";"1";"1";"0";"1";"0";"457182";"373894"
"V4mis1";"SILVA (only NR);Eukaryota;Amorphea;Obazoa;Opisthokonta;Nucletmycea;Fungi;Dikarya;Basidiomycota;Pucciniomycotina;Cystobasidiomycetes;Incertae Sedis;Incertae Sedis;Microsporomyces;";"0.0";"0";"2";"2";"0";"2";"0";"457181";"373894"
"V4mis1";"SILVA (only NR);Eukaryota;Amorphea;Obazoa;Opisthokonta;Nucletmycea;Fungi;Dikarya;Basidiomycota;Pucciniomycotina;Cystobasidiomycetes;Incertae Sedis;Incertae Sedis;Sakaguchia;";"0.0";"0";"7";"7";"0";"7";"0";"457176";"373894"
"V4mis1";"SILVA (only NR);Eukaryota;Amorphea;Obazoa;Opisthokonta;Nucletmycea;Fungi;Dikarya;Basidiomycota;Pucciniomycotina;Cystobasidiomycetes;Incertae Sedis;Incertae Sedis;Symmetrospora;";"0.0";"0";"9";"8";"0";"8";"1";"457175";"373894"
"V4mis1";"SILVA (only NR);Eukaryota;Amorphea;Obazoa;Opisthokonta;Nucletmycea;Fungi;Dikarya;Basidiomycota;Pucciniomycotina;Cystobasidiomycetes;Incertae Sedis;Incertae Sedis;uncultured;";"0.0";"0";"3";"3";"0";"3";"0";"457180";"373894"
"V4mis1";"SILVA (only NR);Eukaryota;Amorphea;Obazoa;Opisthokonta;Nucletmycea;Fungi;Dikarya;Basidiomycota;Pucciniomycotina;Cystobasidiomycetes;Naohideales;";"0.0";"0";"2";"2";"0";"2";"0";"457181";"373894"
"V4mis1";"SILVA (only NR);Eukaryota;Amorphea;Obazoa;Opisthokonta;Nucletmycea;Fungi;Dikarya;Basidiomycota;Pucciniomycotina;Cystobasidiomycetes;Naohideales;Naohideaceae;";"0.0";"0";"2";"2";"0";"2";"0";"457181";"373894"
"V4mis1";"SILVA (only NR);Eukaryota;Amorphea;Obazoa;Opisthokonta;Nucletmycea;Fungi;Dikarya;Basidiomycota;Pucciniomycotina;Cystobasidiomycetes;Naohideales;Naohideaceae;Naohidea;";"0.0";"0";"2";"2";"0";"2";"0";"457181";"373894"
"V4mis1";"SILVA (only NR);Eukaryota;Amorphea;Obazoa;Opisthokonta;Nucletmycea;Fungi;Dikarya;Basidiomycota;Pucciniomycotina;Microbotryomycetes;";"0.0";"0";"236";"236";"0";"236";"0";"456947";"373894"
"V4mis1";"SILVA (only NR);Eukaryota;Amorphea;Obazoa;Opisthokonta;Nucletmycea;Fungi;Dikarya;Basidiomycota;Pucciniomycotina;Microbotryomycetes;Heterogastridiales;";"0.0";"0";"1";"1";"0";"1";"0";"457182";"373894"
"V4mis1";"SILVA (only NR);Eukaryota;Amorphea;Obazoa;Opisthokonta;Nucletmycea;Fungi;Dikarya;Basidiomycota;Pucciniomycotina;Microbotryomycetes;Heterogastridiales;Heterogastridiaceae;";"0.0";"0";"1";"1";"0";"1";"0";"457182";"373894"
"V4mis1";"SILVA (only NR);Eukaryota;Amorphea;Obazoa;Opisthokonta;Nucletmycea;Fungi;Dikarya;Basidiomycota;Pucciniomycotina;Microbotryomycetes;Heterogastridiales;Heterogastridiaceae;Heterogastridium;";"0.0";"0";"1";"1";"0";"1";"0";"457182";"373894"
"V4mis1";"SILVA (only NR);Eukaryota;Amorphea;Obazoa;Opisthokonta;Nucletmycea;Fungi;Dikarya;Basidiomycota;Pucciniomycotina;Microbotryomycetes;Incertae Sedis;";"0.0";"0";"40";"40";"0";"40";"0";"457143";"373894"
"V4mis1";"SILVA (only NR);Eukaryota;Amorphea;Obazoa;Opisthokonta;Nucletmycea;Fungi;Dikarya;Basidiomycota;Pucciniomycotina;Microbotryomycetes;Incertae Sedis;Chrysozymaceae;";"0.0";"0";"25";"25";"0";"25";"0";"457158";"373894"
"V4mis1";"SILVA (only NR);Eukaryota;Amorphea;Obazoa;Opisthokonta;Nucletmycea;Fungi;Dikarya;Basidiomycota;Pucciniomycotina;Microbotryomycetes;Incertae Sedis;Chrysozymaceae;Bannozyma;";"0.0";"0";"2";"2";"0";"2";"0";"457181";"373894"
"V4mis1";"SILVA (only NR);Eukaryota;Amorphea;Obazoa;Opisthokonta;Nucletmycea;Fungi;Dikarya;Basidiomycota;Pucciniomycotina;Microbotryomycetes;Incertae Sedis;Chrysozymaceae;Chrysozyma;";"0.0";"0";"2";"2";"0";"2";"0";"457181";"373894"
"V4mis1";"SILVA (only NR);Eukaryota;Amorphea;Obazoa;Opisthokonta;Nucletmycea;Fungi;Dikarya;Basidiomycota;Pucciniomycotina;Microbotryomycetes;Incertae Sedis;Chrysozymaceae;Fellozyma;";"0.0";"0";"1";"1";"0";"1";"0";"457182";"373894"
"V4mis1";"SILVA (only NR);Eukaryota;Amorphea;Obazoa;Opisthokonta;Nucletmycea;Fungi;Dikarya;Basidiomycota;Pucciniomycotina;Microbotryomycetes;Incertae Sedis;Chrysozymaceae;Hamamotoa;";"0.0";"0";"2";"2";"0";"2";"0";"457181";"373894"
"V4mis1";"SILVA (only NR);Eukaryota;Amorphea;Obazoa;Opisthokonta;Nucletmycea;Fungi;Dikarya;Basidiomycota;Pucciniomycotina;Microbotryomycetes;Incertae Sedis;Chrysozymaceae;Oberwinklerozyma;";"0.0";"0";"2";"2";"0";"2";"0";"457181";"373894"
"V4mis1";"SILVA (only NR);Eukaryota;Amorphea;Obazoa;Opisthokonta;Nucletmycea;Fungi;Dikarya;Basidiomycota;Pucciniomycotina;Microbotryomycetes;Incertae Sedis;Chrysozymaceae;Pseudohyphozyma;";"0.0";"0";"1";"1";"0";"1";"0";"457182";"373894"
"V4mis1";"SILVA (only NR);Eukaryota;Amorphea;Obazoa;Opisthokonta;Nucletmycea;Fungi;Dikarya;Basidiomycota;Pucciniomycotina;Microbotryomycetes;Incertae Sedis;Chrysozymaceae;Sampaiozyma;";"0.0";"0";"2";"2";"0";"2";"0";"457181";"373894"
"V4mis1";"SILVA (only NR);Eukaryota;Amorphea;Obazoa;Opisthokonta;Nucletmycea;Fungi;Dikarya;Basidiomycota;Pucciniomycotina;Microbotryomycetes;Incertae Sedis;Chrysozymaceae;Slooffia;";"0.0";"0";"3";"3";"0";"3";"0";"457180";"373894"
"V4mis1";"SILVA (only NR);Eukaryota;Amorphea;Obazoa;Opisthokonta;Nucletmycea;Fungi;Dikarya;Basidiomycota;Pucciniomycotina;Microbotryomycetes;Incertae Sedis;Chrysozymaceae;Spencerozyma;";"0.0";"0";"1";"1";"0";"1";"0";"457182";"373894"
"V4mis1";"SILVA (only NR);Eukaryota;Amorphea;Obazoa;Opisthokonta;Nucletmycea;Fungi;Dikarya;Basidiomycota;Pucciniomycotina;Microbotryomycetes;Incertae Sedis;Chrysozymaceae;Trigonosporomyces;";"0.0";"0";"1";"1";"0";"1";"0";"457182";"373894"
"V4mis1";"SILVA (only NR);Eukaryota;Amorphea;Obazoa;Opisthokonta;Nucletmycea;Fungi;Dikarya;Basidiomycota;Pucciniomycotina;Microbotryomycetes;Incertae Sedis;Chrysozymaceae;Udeniozyma;";"0.0";"0";"1";"1";"0";"1";"0";"457182";"373894"
"V4mis1";"SILVA (only NR);Eukaryota;Amorphea;Obazoa;Opisthokonta;Nucletmycea;Fungi;Dikarya;Basidiomycota;Pucciniomycotina;Microbotryomycetes;Incertae Sedis;Chrysozymaceae;Vonarxula;";"0.0";"0";"1";"1";"0";"1";"0";"457182";"373894"
"V4mis1";"SILVA (only NR);Eukaryota;Amorphea;Obazoa;Opisthokonta;Nucletmycea;Fungi;Dikarya;Basidiomycota;Pucciniomycotina;Microbotryomycetes;Incertae Sedis;Chrysozymaceae;Yunzhangia;";"0.0";"0";"2";"2";"0";"2";"0";"457181";"373894"
"V4mis1";"SILVA (only NR);Eukaryota;Amorphea;Obazoa;Opisthokonta;Nucletmycea;Fungi;Dikarya;Basidiomycota;Pucciniomycotina;Microbotryomycetes;Incertae Sedis;Incertae Sedis;";"0.0";"0";"15";"15";"0";"15";"0";"457168";"373894"
"V4mis1";"SILVA (only NR);Eukaryota;Amorphea;Obazoa;Opisthokonta;Nucletmycea;Fungi;Dikarya;Basidiomycota;Pucciniomycotina;Microbotryomycetes;Incertae Sedis;Incertae Sedis;Colacogloea;";"0.0";"0";"11";"11";"0";"11";"0";"457172";"373894"
"V4mis1";"SILVA (only NR);Eukaryota;Amorphea;Obazoa;Opisthokonta;Nucletmycea;Fungi;Dikarya;Basidiomycota;Pucciniomycotina;Microbotryomycetes;Incertae Sedis;Incertae Sedis;Curvibasidium;";"0.0";"0";"3";"3";"0";"3";"0";"457180";"373894"
"V4mis1";"SILVA (only NR);Eukaryota;Amorphea;Obazoa;Opisthokonta;Nucletmycea;Fungi;Dikarya;Basidiomycota;Pucciniomycotina;Microbotryomycetes;Incertae Sedis;Incertae Sedis;Reniforma;";"0.0";"0";"1";"1";"0";"1";"0";"457182";"373894"
"V4mis1";"SILVA (only NR);Eukaryota;Amorphea;Obazoa;Opisthokonta;Nucletmycea;Fungi;Dikarya;Basidiomycota;Pucciniomycotina;Microbotryomycetes;Kriegeriales;";"0.0";"0";"11";"11";"0";"11";"0";"457172";"373894"
"V4mis1";"SILVA (only NR);Eukaryota;Amorphea;Obazoa;Opisthokonta;Nucletmycea;Fungi;Dikarya;Basidiomycota;Pucciniomycotina;Microbotryomycetes;Kriegeriales;Camptobasidiaceae;";"0.0";"0";"4";"4";"0";"4";"0";"457179";"373894"
"V4mis1";"SILVA (only NR);Eukaryota;Amorphea;Obazoa;Opisthokonta;Nucletmycea;Fungi;Dikarya;Basidiomycota;Pucciniomycotina;Microbotryomycetes;Kriegeriales;Camptobasidiaceae;Camptobasidium;";"0.0";"0";"3";"3";"0";"3";"0";"457180";"373894"
"V4mis1";"SILVA (only NR);Eukaryota;Amorphea;Obazoa;Opisthokonta;Nucletmycea;Fungi;Dikarya;Basidiomycota;Pucciniomycotina;Microbotryomycetes;Kriegeriales;Kriegeriaceae;";"0.0";"0";"6";"6";"0";"6";"0";"457177";"373894"
"V4mis1";"SILVA (only NR);Eukaryota;Amorphea;Obazoa;Opisthokonta;Nucletmycea;Fungi;Dikarya;Basidiomycota;Pucciniomycotina;Microbotryomycetes;Kriegeriales;Kriegeriaceae;Kriegeria;";"0.0";"0";"1";"1";"0";"1";"0";"457182";"373894"
"V4mis1";"SILVA (only NR);Eukaryota;Amorphea;Obazoa;Opisthokonta;Nucletmycea;Fungi;Dikarya;Basidiomycota;Pucciniomycotina;Microbotryomycetes;Kriegeriales;Kriegeriaceae;Phenoliferia;";"0.0";"0";"2";"2";"0";"2";"0";"457181";"373894"
"V4mis1";"SILVA (only NR);Eukaryota;Amorphea;Obazoa;Opisthokonta;Nucletmycea;Fungi;Dikarya;Basidiomycota;Pucciniomycotina;Microbotryomycetes;Kriegeriales;Kriegeriaceae;Yamadamyces;";"0.0";"0";"1";"1";"0";"1";"0";"457182";"373894"
"V4mis1";"SILVA (only NR);Eukaryota;Amorphea;Obazoa;Opisthokonta;Nucletmycea;Fungi;Dikarya;Basidiomycota;Pucciniomycotina;Microbotryomycetes;Leucosporidiales;";"0.0";"0";"10";"10";"0";"10";"0";"457173";"373894"
"V4mis1";"SILVA (only NR);Eukaryota;Amorphea;Obazoa;Opisthokonta;Nucletmycea;Fungi;Dikarya;Basidiomycota;Pucciniomycotina;Microbotryomycetes;Leucosporidiales;Leucosporidiaceae;";"0.0";"0";"10";"10";"0";"10";"0";"457173";"373894"
"V4mis1";"SILVA (only NR);Eukaryota;Amorphea;Obazoa;Opisthokonta;Nucletmycea;Fungi;Dikarya;Basidiomycota;Pucciniomycotina;Microbotryomycetes;Leucosporidiales;Leucosporidiaceae;Leucosporidium;";"0.0";"0";"10";"10";"0";"10";"0";"457173";"373894"
"V4mis1";"SILVA (only NR);Eukaryota;Amorphea;Obazoa;Opisthokonta;Nucletmycea;Fungi;Dikarya;Basidiomycota;Pucciniomycotina;Microbotryomycetes;Microbotryales;";"0.0";"0";"64";"64";"0";"64";"0";"457119";"373894"
"V4mis1";"SILVA (only NR);Eukaryota;Amorphea;Obazoa;Opisthokonta;Nucletmycea;Fungi;Dikarya;Basidiomycota;Pucciniomycotina;Microbotryomycetes;Microbotryales;Microbotryaceae;";"0.0";"0";"61";"61";"0";"61";"0";"457122";"373894"
"V4mis1";"SILVA (only NR);Eukaryota;Amorphea;Obazoa;Opisthokonta;Nucletmycea;Fungi;Dikarya;Basidiomycota;Pucciniomycotina;Microbotryomycetes;Microbotryales;Microbotryaceae;Microbotryum;";"0.0";"0";"60";"60";"0";"60";"0";"457123";"373894"
"V4mis1";"SILVA (only NR);Eukaryota;Amorphea;Obazoa;Opisthokonta;Nucletmycea;Fungi;Dikarya;Basidiomycota;Pucciniomycotina;Microbotryomycetes;Microbotryales;Microbotryaceae;Sphacelotheca;";"0.0";"0";"1";"1";"0";"1";"0";"457182";"373894"
"V4mis1";"SILVA (only NR);Eukaryota;Amorphea;Obazoa;Opisthokonta;Nucletmycea;Fungi;Dikarya;Basidiomycota;Pucciniomycotina;Microbotryomycetes;Microbotryales;Ustilentylomataceae;";"0.0";"0";"3";"3";"0";"3";"0";"457180";"373894"
"V4mis1";"SILVA (only NR);Eukaryota;Amorphea;Obazoa;Opisthokonta;Nucletmycea;Fungi;Dikarya;Basidiomycota;Pucciniomycotina;Microbotryomycetes;Microbotryales;Ustilentylomataceae;Ustilentyloma;";"0.0";"0";"3";"3";"0";"3";"0";"457180";"373894"
"V4mis1";"SILVA (only NR);Eukaryota;Amorphea;Obazoa;Opisthokonta;Nucletmycea;Fungi;Dikarya;Basidiomycota;Pucciniomycotina;Microbotryomycetes;Sporidiobolales;";"0.0";"0";"106";"106";"0";"106";"0";"457077";"373894"
"V4mis1";"SILVA (only NR);Eukaryota;Amorphea;Obazoa;Opisthokonta;Nucletmycea;Fungi;Dikarya;Basidiomycota;Pucciniomycotina;Microbotryomycetes;Sporidiobolales;Sporidiobolaceae;";"0.0";"0";"106";"106";"0";"106";"0";"457077";"373894"
"V4mis1";"SILVA (only NR);Eukaryota;Amorphea;Obazoa;Opisthokonta;Nucletmycea;Fungi;Dikarya;Basidiomycota;Pucciniomycotina;Microbotryomycetes;Sporidiobolales;Sporidiobolaceae;Rhodosporidiobolus;";"0.0";"0";"9";"9";"0";"9";"0";"457174";"373894"
"V4mis1";"SILVA (only NR);Eukaryota;Amorphea;Obazoa;Opisthokonta;Nucletmycea;Fungi;Dikarya;Basidiomycota;Pucciniomycotina;Microbotryomycetes;Sporidiobolales;Sporidiobolaceae;Rhodotorula;";"0.0";"0";"83";"83";"0";"83";"0";"457100";"373894"
"V4mis1";"SILVA (only NR);Eukaryota;Amorphea;Obazoa;Opisthokonta;Nucletmycea;Fungi;Dikarya;Basidiomycota;Pucciniomycotina;Microbotryomycetes;Sporidiobolales;Sporidiobolaceae;Sporidiobolus;";"0.0";"0";"2";"2";"0";"2";"0";"457181";"373894"
"V4mis1";"SILVA (only NR);Eukaryota;Amorphea;Obazoa;Opisthokonta;Nucletmycea;Fungi;Dikarya;Basidiomycota;Pucciniomycotina;Microbotryomycetes;Sporidiobolales;Sporidiobolaceae;Sporobolomyces;";"0.0";"0";"8";"8";"0";"8";"0";"457175";"373894"
"V4mis1";"SILVA (only NR);Eukaryota;Amorphea;Obazoa;Opisthokonta;Nucletmycea;Fungi;Dikarya;Basidiomycota;Pucciniomycotina;Microbotryomycetes;Sporidiobolales;Sporidiobolaceae;uncultured;";"0.0";"0";"4";"4";"0";"4";"0";"457179";"373894"
"V4mis1";"SILVA (only NR);Eukaryota;Amorphea;Obazoa;Opisthokonta;Nucletmycea;Fungi;Dikarya;Basidiomycota;Pucciniomycotina;Microbotryomycetes;uncultured;";"0.0";"0";"2";"2";"0";"2";"0";"457181";"373894"
"V4mis1";"SILVA (only NR);Eukaryota;Amorphea;Obazoa;Opisthokonta;Nucletmycea;Fungi;Dikarya;Basidiomycota;Pucciniomycotina;Mixiomycetes;";"0.0";"0";"2";"2";"0";"2";"0";"457181";"373894"
"V4mis1";"SILVA (only NR);Eukaryota;Amorphea;Obazoa;Opisthokonta;Nucletmycea;Fungi;Dikarya;Basidiomycota;Pucciniomycotina;Mixiomycetes;Mixiales;";"0.0";"0";"2";"2";"0";"2";"0";"457181";"373894"
"V4mis1";"SILVA (only NR);Eukaryota;Amorphea;Obazoa;Opisthokonta;Nucletmycea;Fungi;Dikarya;Basidiomycota;Pucciniomycotina;Mixiomycetes;Mixiales;Mixiaceae;";"0.0";"0";"2";"2";"0";"2";"0";"457181";"373894"
"V4mis1";"SILVA (only NR);Eukaryota;Amorphea;Obazoa;Opisthokonta;Nucletmycea;Fungi;Dikarya;Basidiomycota;Pucciniomycotina;Mixiomycetes;Mixiales;Mixiaceae;Mixia;";"0.0";"0";"2";"2";"0";"2";"0";"457181";"373894"
"V4mis1";"SILVA (only NR);Eukaryota;Amorphea;Obazoa;Opisthokonta;Nucletmycea;Fungi;Dikarya;Basidiomycota;Pucciniomycotina;Pucciniomycetes;";"0.0";"0";"181";"181";"0";"181";"0";"457002";"373894"
"V4mis1";"SILVA (only NR);Eukaryota;Amorphea;Obazoa;Opisthokonta;Nucletmycea;Fungi;Dikarya;Basidiomycota;Pucciniomycotina;Pucciniomycetes;Helicobasidiales;";"0.0";"0";"2";"2";"0";"2";"0";"457181";"373894"
"V4mis1";"SILVA (only NR);Eukaryota;Amorphea;Obazoa;Opisthokonta;Nucletmycea;Fungi;Dikarya;Basidiomycota;Pucciniomycotina;Pucciniomycetes;Helicobasidiales;Helicobasidiaceae;";"0.0";"0";"2";"2";"0";"2";"0";"457181";"373894"
"V4mis1";"SILVA (only NR);Eukaryota;Amorphea;Obazoa;Opisthokonta;Nucletmycea;Fungi;Dikarya;Basidiomycota;Pucciniomycotina;Pucciniomycetes;Helicobasidiales;Helicobasidiaceae;Helicobasidium;";"0.0";"0";"2";"2";"0";"2";"0";"457181";"373894"
"V4mis1";"SILVA (only NR);Eukaryota;Amorphea;Obazoa;Opisthokonta;Nucletmycea;Fungi;Dikarya;Basidiomycota;Pucciniomycotina;Pucciniomycetes;Platygloeaceae;";"0.0";"0";"4";"4";"0";"4";"0";"457179";"373894"
"V4mis1";"SILVA (only NR);Eukaryota;Amorphea;Obazoa;Opisthokonta;Nucletmycea;Fungi;Dikarya;Basidiomycota;Pucciniomycotina;Pucciniomycetes;Platygloeaceae;Insolibasidium;";"0.0";"0";"1";"1";"0";"1";"0";"457182";"373894"
"V4mis1";"SILVA (only NR);Eukaryota;Amorphea;Obazoa;Opisthokonta;Nucletmycea;Fungi;Dikarya;Basidiomycota;Pucciniomycotina;Pucciniomycetes;Platygloeaceae;Jola;";"0.0";"0";"1";"1";"0";"1";"0";"457182";"373894"
"V4mis1";"SILVA (only NR);Eukaryota;Amorphea;Obazoa;Opisthokonta;Nucletmycea;Fungi;Dikarya;Basidiomycota;Pucciniomycotina;Pucciniomycetes;Platygloeaceae;Platygloea;";"0.0";"0";"1";"1";"0";"1";"0";"457182";"373894"
"V4mis1";"SILVA (only NR);Eukaryota;Amorphea;Obazoa;Opisthokonta;Nucletmycea;Fungi;Dikarya;Basidiomycota;Pucciniomycotina;Pucciniomycetes;Pucciniales;";"0.0";"0";"166";"166";"0";"166";"0";"457017";"373894"
"V4mis1";"SILVA (only NR);Eukaryota;Amorphea;Obazoa;Opisthokonta;Nucletmycea;Fungi;Dikarya;Basidiomycota;Pucciniomycotina;Pucciniomycetes;Pucciniales;Achrotelium;";"0.0";"0";"1";"1";"0";"1";"0";"457182";"373894"
"V4mis1";"SILVA (only NR);Eukaryota;Amorphea;Obazoa;Opisthokonta;Nucletmycea;Fungi;Dikarya;Basidiomycota;Pucciniomycotina;Pucciniomycetes;Pucciniales;Aecidium;";"0.0";"0";"2";"2";"0";"2";"0";"457181";"373894"
"V4mis1";"SILVA (only NR);Eukaryota;Amorphea;Obazoa;Opisthokonta;Nucletmycea;Fungi;Dikarya;Basidiomycota;Pucciniomycotina;Pucciniomycetes;Pucciniales;Blastospora;";"0.0";"0";"1";"1";"0";"1";"0";"457182";"373894"
"V4mis1";"SILVA (only NR);Eukaryota;Amorphea;Obazoa;Opisthokonta;Nucletmycea;Fungi;Dikarya;Basidiomycota;Pucciniomycotina;Pucciniomycetes;Pucciniales;Coleosporiaceae;";"0.0";"0";"3";"3";"0";"3";"0";"457180";"373894"
"V4mis1";"SILVA (only NR);Eukaryota;Amorphea;Obazoa;Opisthokonta;Nucletmycea;Fungi;Dikarya;Basidiomycota;Pucciniomycotina;Pucciniomycetes;Pucciniales;Coleosporiaceae;Chrysomyxa;";"0.0";"0";"1";"1";"0";"1";"0";"457182";"373894"
"V4mis1";"SILVA (only NR);Eukaryota;Amorphea;Obazoa;Opisthokonta;Nucletmycea;Fungi;Dikarya;Basidiomycota;Pucciniomycotina;Pucciniomycetes;Pucciniales;Coleosporiaceae;Coleosporium;";"0.0";"0";"2";"2";"0";"2";"0";"457181";"373894"
"V4mis1";"SILVA (only NR);Eukaryota;Amorphea;Obazoa;Opisthokonta;Nucletmycea;Fungi;Dikarya;Basidiomycota;Pucciniomycotina;Pucciniomycetes;Pucciniales;Cronartium;";"0.0";"0";"1";"1";"0";"1";"0";"457182";"373894"
"V4mis1";"SILVA (only NR);Eukaryota;Amorphea;Obazoa;Opisthokonta;Nucletmycea;Fungi;Dikarya;Basidiomycota;Pucciniomycotina;Pucciniomycetes;Pucciniales;Dasturella;";"0.0";"0";"1";"1";"0";"1";"0";"457182";"373894"
"V4mis1";"SILVA (only NR);Eukaryota;Amorphea;Obazoa;Opisthokonta;Nucletmycea;Fungi;Dikarya;Basidiomycota;Pucciniomycotina;Pucciniomycetes;Pucciniales;Hemileia;";"0.0";"0";"1";"1";"0";"1";"0";"457182";"373894"
"V4mis1";"SILVA (only NR);Eukaryota;Amorphea;Obazoa;Opisthokonta;Nucletmycea;Fungi;Dikarya;Basidiomycota;Pucciniomycotina;Pucciniomycetes;Pucciniales;Incertae Sedis;";"0.0";"0";"2";"2";"0";"2";"0";"457181";"373894"
"V4mis1";"SILVA (only NR);Eukaryota;Amorphea;Obazoa;Opisthokonta;Nucletmycea;Fungi;Dikarya;Basidiomycota;Pucciniomycotina;Pucciniomycetes;Pucciniales;Incertae Sedis;Caeoma;";"0.0";"0";"1";"1";"0";"1";"0";"457182";"373894"
"V4mis1";"SILVA (only NR);Eukaryota;Amorphea;Obazoa;Opisthokonta;Nucletmycea;Fungi;Dikarya;Basidiomycota;Pucciniomycotina;Pucciniomycetes;Pucciniales;Incertae Sedis;Uredo;";"0.0";"0";"1";"1";"0";"1";"0";"457182";"373894"
"V4mis1";"SILVA (only NR);Eukaryota;Amorphea;Obazoa;Opisthokonta;Nucletmycea;Fungi;Dikarya;Basidiomycota;Pucciniomycotina;Pucciniomycetes;Pucciniales;Macruropyxis;";"0.0";"0";"1";"1";"0";"1";"0";"457182";"373894"
"V4mis1";"SILVA (only NR);Eukaryota;Amorphea;Obazoa;Opisthokonta;Nucletmycea;Fungi;Dikarya;Basidiomycota;Pucciniomycotina;Pucciniomycetes;Pucciniales;Melampsoraceae;";"0.0";"0";"5";"5";"0";"5";"0";"457178";"373894"
"V4mis1";"SILVA (only NR);Eukaryota;Amorphea;Obazoa;Opisthokonta;Nucletmycea;Fungi;Dikarya;Basidiomycota;Pucciniomycotina;Pucciniomycetes;Pucciniales;Melampsoraceae;Melampsora;";"0.0";"0";"5";"5";"0";"5";"0";"457178";"373894"
"V4mis1";"SILVA (only NR);Eukaryota;Amorphea;Obazoa;Opisthokonta;Nucletmycea;Fungi;Dikarya;Basidiomycota;Pucciniomycotina;Pucciniomycetes;Pucciniales;Mikronegeriaceae;";"0.0";"0";"1";"1";"0";"1";"0";"457182";"373894"
"V4mis1";"SILVA (only NR);Eukaryota;Amorphea;Obazoa;Opisthokonta;Nucletmycea;Fungi;Dikarya;Basidiomycota;Pucciniomycotina;Pucciniomycetes;Pucciniales;Mikronegeriaceae;Mikronegeria;";"0.0";"0";"1";"1";"0";"1";"0";"457182";"373894"
"V4mis1";"SILVA (only NR);Eukaryota;Amorphea;Obazoa;Opisthokonta;Nucletmycea;Fungi;Dikarya;Basidiomycota;Pucciniomycotina;Pucciniomycetes;Pucciniales;Milesina;";"0.0";"0";"1";"1";"0";"1";"0";"457182";"373894"
"V4mis1";"SILVA (only NR);Eukaryota;Amorphea;Obazoa;Opisthokonta;Nucletmycea;Fungi;Dikarya;Basidiomycota;Pucciniomycotina;Pucciniomycetes;Pucciniales;Nyssopsora;";"0.0";"0";"1";"1";"0";"1";"0";"457182";"373894"
"V4mis1";"SILVA (only NR);Eukaryota;Amorphea;Obazoa;Opisthokonta;Nucletmycea;Fungi;Dikarya;Basidiomycota;Pucciniomycotina;Pucciniomycetes;Pucciniales;Olivea;";"0.0";"0";"1";"1";"0";"1";"0";"457182";"373894"
"V4mis1";"SILVA (only NR);Eukaryota;Amorphea;Obazoa;Opisthokonta;Nucletmycea;Fungi;Dikarya;Basidiomycota;Pucciniomycotina;Pucciniomycetes;Pucciniales;Phakopsora;";"0.0";"0";"3";"3";"0";"3";"0";"457180";"373894"
"V4mis1";"SILVA (only NR);Eukaryota;Amorphea;Obazoa;Opisthokonta;Nucletmycea;Fungi;Dikarya;Basidiomycota;Pucciniomycotina;Pucciniomycetes;Pucciniales;Phakopsoraceae;";"0.0";"0";"2";"2";"0";"2";"0";"457181";"373894"
"V4mis1";"SILVA (only NR);Eukaryota;Amorphea;Obazoa;Opisthokonta;Nucletmycea;Fungi;Dikarya;Basidiomycota;Pucciniomycotina;Pucciniomycetes;Pucciniales;Phakopsoraceae;Prospodium;";"0.0";"0";"2";"2";"0";"2";"0";"457181";"373894"
"V4mis1";"SILVA (only NR);Eukaryota;Amorphea;Obazoa;Opisthokonta;Nucletmycea;Fungi;Dikarya;Basidiomycota;Pucciniomycotina;Pucciniomycetes;Pucciniales;Phragmidiaceae;";"0.0";"0";"68";"68";"0";"68";"0";"457115";"373894"
"V4mis1";"SILVA (only NR);Eukaryota;Amorphea;Obazoa;Opisthokonta;Nucletmycea;Fungi;Dikarya;Basidiomycota;Pucciniomycotina;Pucciniomycetes;Pucciniales;Phragmidiaceae;Gymnoconia;";"0.0";"0";"1";"1";"0";"1";"0";"457182";"373894"
"V4mis1";"SILVA (only NR);Eukaryota;Amorphea;Obazoa;Opisthokonta;Nucletmycea;Fungi;Dikarya;Basidiomycota;Pucciniomycotina;Pucciniomycetes;Pucciniales;Phragmidiaceae;Hamaspora;";"0.0";"0";"1";"1";"0";"1";"0";"457182";"373894"
"V4mis1";"SILVA (only NR);Eukaryota;Amorphea;Obazoa;Opisthokonta;Nucletmycea;Fungi;Dikarya;Basidiomycota;Pucciniomycotina;Pucciniomycetes;Pucciniales;Phragmidiaceae;Kuehneola;";"0.0";"0";"2";"2";"0";"2";"0";"457181";"373894"
"V4mis1";"SILVA (only NR);Eukaryota;Amorphea;Obazoa;Opisthokonta;Nucletmycea;Fungi;Dikarya;Basidiomycota;Pucciniomycotina;Pucciniomycetes;Pucciniales;Phragmidiaceae;Phragmidium;";"0.0";"0";"63";"63";"0";"63";"0";"457120";"373894"
"V4mis1";"SILVA (only NR);Eukaryota;Amorphea;Obazoa;Opisthokonta;Nucletmycea;Fungi;Dikarya;Basidiomycota;Pucciniomycotina;Pucciniomycetes;Pucciniales;Physopella;";"0.0";"0";"1";"1";"0";"1";"0";"457182";"373894"
"V4mis1";"SILVA (only NR);Eukaryota;Amorphea;Obazoa;Opisthokonta;Nucletmycea;Fungi;Dikarya;Basidiomycota;Pucciniomycotina;Pucciniomycetes;Pucciniales;Pileolaria;";"0.0";"0";"1";"1";"0";"1";"0";"457182";"373894"
"V4mis1";"SILVA (only NR);Eukaryota;Amorphea;Obazoa;Opisthokonta;Nucletmycea;Fungi;Dikarya;Basidiomycota;Pucciniomycotina;Pucciniomycetes;Pucciniales;Pileolariaceae;";"0.0";"0";"1";"1";"0";"1";"0";"457182";"373894"
"V4mis1";"SILVA (only NR);Eukaryota;Amorphea;Obazoa;Opisthokonta;Nucletmycea;Fungi;Dikarya;Basidiomycota;Pucciniomycotina;Pucciniomycetes;Pucciniales;Pileolariaceae;Uromycladium;";"0.0";"0";"1";"1";"0";"1";"0";"457182";"373894"
"V4mis1";"SILVA (only NR);Eukaryota;Amorphea;Obazoa;Opisthokonta;Nucletmycea;Fungi;Dikarya;Basidiomycota;Pucciniomycotina;Pucciniomycetes;Pucciniales;Porotenus;";"0.0";"0";"1";"1";"0";"1";"0";"457182";"373894"
"V4mis1";"SILVA (only NR);Eukaryota;Amorphea;Obazoa;Opisthokonta;Nucletmycea;Fungi;Dikarya;Basidiomycota;Pucciniomycotina;Pucciniomycetes;Pucciniales;Pucciniaceae;";"0.0";"0";"44";"44";"0";"44";"0";"457139";"373894"
"V4mis1";"SILVA (only NR);Eukaryota;Amorphea;Obazoa;Opisthokonta;Nucletmycea;Fungi;Dikarya;Basidiomycota;Pucciniomycotina;Pucciniomycetes;Pucciniales;Pucciniaceae;Allodus;";"0.0";"0";"1";"1";"0";"1";"0";"457182";"373894"
"V4mis1";"SILVA (only NR);Eukaryota;Amorphea;Obazoa;Opisthokonta;Nucletmycea;Fungi;Dikarya;Basidiomycota;Pucciniomycotina;Pucciniomycetes;Pucciniales;Pucciniaceae;Ceratocoma;";"0.0";"0";"1";"1";"0";"1";"0";"457182";"373894"
"V4mis1";"SILVA (only NR);Eukaryota;Amorphea;Obazoa;Opisthokonta;Nucletmycea;Fungi;Dikarya;Basidiomycota;Pucciniomycotina;Pucciniomycetes;Pucciniales;Pucciniaceae;Gymnosporangium;";"0.0";"0";"6";"6";"0";"6";"0";"457177";"373894"
"V4mis1";"SILVA (only NR);Eukaryota;Amorphea;Obazoa;Opisthokonta;Nucletmycea;Fungi;Dikarya;Basidiomycota;Pucciniomycotina;Pucciniomycetes;Pucciniales;Pucciniaceae;Puccinia;";"0.0";"0";"31";"31";"0";"31";"0";"457152";"373894"
"V4mis1";"SILVA (only NR);Eukaryota;Amorphea;Obazoa;Opisthokonta;Nucletmycea;Fungi;Dikarya;Basidiomycota;Pucciniomycotina;Pucciniomycetes;Pucciniales;Pucciniaceae;Puccorchidium;";"0.0";"0";"3";"3";"0";"3";"0";"457180";"373894"
"V4mis1";"SILVA (only NR);Eukaryota;Amorphea;Obazoa;Opisthokonta;Nucletmycea;Fungi;Dikarya;Basidiomycota;Pucciniomycotina;Pucciniomycetes;Pucciniales;Pucciniaceae;Uromyces;";"0.0";"0";"1";"1";"0";"1";"0";"457182";"373894"
"V4mis1";"SILVA (only NR);Eukaryota;Amorphea;Obazoa;Opisthokonta;Nucletmycea;Fungi;Dikarya;Basidiomycota;Pucciniomycotina;Pucciniomycetes;Pucciniales;Pucciniastraceae;";"0.0";"0";"9";"9";"0";"9";"0";"457174";"373894"
"V4mis1";"SILVA (only NR);Eukaryota;Amorphea;Obazoa;Opisthokonta;Nucletmycea;Fungi;Dikarya;Basidiomycota;Pucciniomycotina;Pucciniomycetes;Pucciniales;Pucciniastraceae;Hyalopsora;";"0.0";"0";"3";"3";"0";"3";"0";"457180";"373894"
"V4mis1";"SILVA (only NR);Eukaryota;Amorphea;Obazoa;Opisthokonta;Nucletmycea;Fungi;Dikarya;Basidiomycota;Pucciniomycotina;Pucciniomycetes;Pucciniales;Pucciniastraceae;Melampsorella;";"0.0";"0";"1";"1";"0";"1";"0";"457182";"373894"
"V4mis1";"SILVA (only NR);Eukaryota;Amorphea;Obazoa;Opisthokonta;Nucletmycea;Fungi;Dikarya;Basidiomycota;Pucciniomycotina;Pucciniomycetes;Pucciniales;Pucciniastraceae;Naohidemyces;";"0.0";"0";"1";"1";"0";"1";"0";"457182";"373894"
"V4mis1";"SILVA (only NR);Eukaryota;Amorphea;Obazoa;Opisthokonta;Nucletmycea;Fungi;Dikarya;Basidiomycota;Pucciniomycotina;Pucciniomycetes;Pucciniales;Pucciniastraceae;Pucciniastrum;";"0.0";"0";"2";"2";"0";"2";"0";"457181";"373894"
"V4mis1";"SILVA (only NR);Eukaryota;Amorphea;Obazoa;Opisthokonta;Nucletmycea;Fungi;Dikarya;Basidiomycota;Pucciniomycotina;Pucciniomycetes;Pucciniales;Pucciniastraceae;Thekopsora;";"0.0";"0";"2";"2";"0";"2";"0";"457181";"373894"
"V4mis1";"SILVA (only NR);Eukaryota;Amorphea;Obazoa;Opisthokonta;Nucletmycea;Fungi;Dikarya;Basidiomycota;Pucciniomycotina;Pucciniomycetes;Pucciniales;Racospermyces;";"0.0";"0";"1";"1";"0";"1";"0";"457182";"373894"
"V4mis1";"SILVA (only NR);Eukaryota;Amorphea;Obazoa;Opisthokonta;Nucletmycea;Fungi;Dikarya;Basidiomycota;Pucciniomycotina;Pucciniomycetes;Pucciniales;Raveneliaceae;";"0.0";"0";"4";"4";"0";"4";"0";"457179";"373894"
"V4mis1";"SILVA (only NR);Eukaryota;Amorphea;Obazoa;Opisthokonta;Nucletmycea;Fungi;Dikarya;Basidiomycota;Pucciniomycotina;Pucciniomycetes;Pucciniales;Raveneliaceae;Diorchidium;";"0.0";"0";"1";"1";"0";"1";"0";"457182";"373894"
"V4mis1";"SILVA (only NR);Eukaryota;Amorphea;Obazoa;Opisthokonta;Nucletmycea;Fungi;Dikarya;Basidiomycota;Pucciniomycotina;Pucciniomycetes;Pucciniales;Raveneliaceae;Ravenelia;";"0.0";"0";"1";"1";"0";"1";"0";"457182";"373894"
"V4mis1";"SILVA (only NR);Eukaryota;Amorphea;Obazoa;Opisthokonta;Nucletmycea;Fungi;Dikarya;Basidiomycota;Pucciniomycotina;Pucciniomycetes;Pucciniales;Raveneliaceae;Sphenospora;";"0.0";"0";"2";"2";"0";"2";"0";"457181";"373894"
"V4mis1";"SILVA (only NR);Eukaryota;Amorphea;Obazoa;Opisthokonta;Nucletmycea;Fungi;Dikarya;Basidiomycota;Pucciniomycotina;Pucciniomycetes;Pucciniales;Sphenorchidium;";"0.0";"0";"1";"1";"0";"1";"0";"457182";"373894"
"V4mis1";"SILVA (only NR);Eukaryota;Amorphea;Obazoa;Opisthokonta;Nucletmycea;Fungi;Dikarya;Basidiomycota;Pucciniomycotina;Pucciniomycetes;Pucciniales;Trachyspora;";"0.0";"0";"1";"1";"0";"1";"0";"457182";"373894"
"V4mis1";"SILVA (only NR);Eukaryota;Amorphea;Obazoa;Opisthokonta;Nucletmycea;Fungi;Dikarya;Basidiomycota;Pucciniomycotina;Pucciniomycetes;Pucciniales;Uropyxidaceae;";"0.0";"0";"5";"5";"0";"5";"0";"457178";"373894"
"V4mis1";"SILVA (only NR);Eukaryota;Amorphea;Obazoa;Opisthokonta;Nucletmycea;Fungi;Dikarya;Basidiomycota;Pucciniomycotina;Pucciniomycetes;Pucciniales;Uropyxidaceae;Dasyspora;";"0.0";"0";"2";"2";"0";"2";"0";"457181";"373894"
"V4mis1";"SILVA (only NR);Eukaryota;Amorphea;Obazoa;Opisthokonta;Nucletmycea;Fungi;Dikarya;Basidiomycota;Pucciniomycotina;Pucciniomycetes;Pucciniales;Uropyxidaceae;Leucotelium;";"0.0";"0";"1";"1";"0";"1";"0";"457182";"373894"
"V4mis1";"SILVA (only NR);Eukaryota;Amorphea;Obazoa;Opisthokonta;Nucletmycea;Fungi;Dikarya;Basidiomycota;Pucciniomycotina;Pucciniomycetes;Pucciniales;Uropyxidaceae;Tranzschelia;";"0.0";"0";"2";"2";"0";"2";"0";"457181";"373894"
"V4mis1";"SILVA (only NR);Eukaryota;Amorphea;Obazoa;Opisthokonta;Nucletmycea;Fungi;Dikarya;Basidiomycota;Pucciniomycotina;Pucciniomycetes;Septobasidiales;";"0.0";"0";"2";"2";"0";"2";"0";"457181";"373894"
"V4mis1";"SILVA (only NR);Eukaryota;Amorphea;Obazoa;Opisthokonta;Nucletmycea;Fungi;Dikarya;Basidiomycota;Pucciniomycotina;Pucciniomycetes;Septobasidiales;Septobasidiaceae;";"0.0";"0";"2";"2";"0";"2";"0";"457181";"373894"
"V4mis1";"SILVA (only NR);Eukaryota;Amorphea;Obazoa;Opisthokonta;Nucletmycea;Fungi;Dikarya;Basidiomycota;Pucciniomycotina;Pucciniomycetes;Septobasidiales;Septobasidiaceae;Septobasidium;";"0.0";"0";"2";"2";"0";"2";"0";"457181";"373894"
"V4mis1";"SILVA (only NR);Eukaryota;Amorphea;Obazoa;Opisthokonta;Nucletmycea;Fungi;Dikarya;Basidiomycota;Pucciniomycotina;Spiculogloeomycetes;";"66.7";"18.2";"6";"6";"4";"2";"0";"457177";"373890"
"V4mis1";"SILVA (only NR);Eukaryota;Amorphea;Obazoa;Opisthokonta;Nucletmycea;Fungi;Dikarya;Basidiomycota;Pucciniomycotina;Spiculogloeomycetes;Spiculogloeales;";"66.7";"18.2";"6";"6";"4";"2";"0";"457177";"373890"
"V4mis1";"SILVA (only NR);Eukaryota;Amorphea;Obazoa;Opisthokonta;Nucletmycea;Fungi;Dikarya;Basidiomycota;Pucciniomycotina;Spiculogloeomycetes;Spiculogloeales;Spiculogloeaceae;";"66.7";"18.2";"6";"6";"4";"2";"0";"457177";"373890"
"V4mis1";"SILVA (only NR);Eukaryota;Amorphea;Obazoa;Opisthokonta;Nucletmycea;Fungi;Dikarya;Basidiomycota;Pucciniomycotina;Spiculogloeomycetes;Spiculogloeales;Spiculogloeaceae;Mycogloea;";"0.0";"0";"1";"1";"0";"1";"0";"457182";"373894"
"V4mis1";"SILVA (only NR);Eukaryota;Amorphea;Obazoa;Opisthokonta;Nucletmycea;Fungi;Dikarya;Basidiomycota;Pucciniomycotina;Spiculogloeomycetes;Spiculogloeales;Spiculogloeaceae;Phyllozyma;";"100.0";"18.2";"4";"4";"4";"0";"0";"457179";"373890"
"V4mis1";"SILVA (only NR);Eukaryota;Amorphea;Obazoa;Opisthokonta;Nucletmycea;Fungi;Dikarya;Basidiomycota;Pucciniomycotina;Tritirachiomycetes;";"63.6";"18.2";"11";"11";"7";"4";"0";"457172";"373887"
"V4mis1";"SILVA (only NR);Eukaryota;Amorphea;Obazoa;Opisthokonta;Nucletmycea;Fungi;Dikarya;Basidiomycota;Pucciniomycotina;Tritirachiomycetes;Tritirachiales;";"63.6";"18.2";"11";"11";"7";"4";"0";"457172";"373887"
"V4mis1";"SILVA (only NR);Eukaryota;Amorphea;Obazoa;Opisthokonta;Nucletmycea;Fungi;Dikarya;Basidiomycota;Pucciniomycotina;Tritirachiomycetes;Tritirachiales;Tritirachiaceae;";"63.6";"18.2";"11";"11";"7";"4";"0";"457172";"373887"
"V4mis1";"SILVA (only NR);Eukaryota;Amorphea;Obazoa;Opisthokonta;Nucletmycea;Fungi;Dikarya;Basidiomycota;Pucciniomycotina;Tritirachiomycetes;Tritirachiales;Tritirachiaceae;Paratritirachium;";"0.0";"0";"2";"2";"0";"2";"0";"457181";"373894"
"V4mis1";"SILVA (only NR);Eukaryota;Amorphea;Obazoa;Opisthokonta;Nucletmycea;Fungi;Dikarya;Basidiomycota;Pucciniomycotina;Tritirachiomycetes;Tritirachiales;Tritirachiaceae;Tritirachium;";"77.8";"18.2";"9";"9";"7";"2";"0";"457174";"373887"
"V4mis1";"SILVA (only NR);Eukaryota;Amorphea;Obazoa;Opisthokonta;Nucletmycea;Fungi;Dikarya;Basidiomycota;Pucciniomycotina;uncultured;";"0.0";"0";"2";"2";"0";"2";"0";"457181";"373894"
"V4mis1";"SILVA (only NR);Eukaryota;Amorphea;Obazoa;Opisthokonta;Nucletmycea;Fungi;Dikarya;Basidiomycota;Ustilaginomycotina;";"1.7";"18.1";"594";"591";"10";"581";"3";"456592";"373884"
"V4mis1";"SILVA (only NR);Eukaryota;Amorphea;Obazoa;Opisthokonta;Nucletmycea;Fungi;Dikarya;Basidiomycota;Ustilaginomycotina;Exobasidiomycetes;";"0.0";"0";"52";"52";"0";"52";"0";"457131";"373894"
"V4mis1";"SILVA (only NR);Eukaryota;Amorphea;Obazoa;Opisthokonta;Nucletmycea;Fungi;Dikarya;Basidiomycota;Ustilaginomycotina;Exobasidiomycetes;Ceraceosorales;";"0.0";"0";"2";"2";"0";"2";"0";"457181";"373894"
"V4mis1";"SILVA (only NR);Eukaryota;Amorphea;Obazoa;Opisthokonta;Nucletmycea;Fungi;Dikarya;Basidiomycota;Ustilaginomycotina;Exobasidiomycetes;Ceraceosorales;Ceraceosoraceae;";"0.0";"0";"2";"2";"0";"2";"0";"457181";"373894"
"V4mis1";"SILVA (only NR);Eukaryota;Amorphea;Obazoa;Opisthokonta;Nucletmycea;Fungi;Dikarya;Basidiomycota;Ustilaginomycotina;Exobasidiomycetes;Ceraceosorales;Ceraceosoraceae;Ceraceosorus;";"0.0";"0";"2";"2";"0";"2";"0";"457181";"373894"
"V4mis1";"SILVA (only NR);Eukaryota;Amorphea;Obazoa;Opisthokonta;Nucletmycea;Fungi;Dikarya;Basidiomycota;Ustilaginomycotina;Exobasidiomycetes;Doassansiales;";"0.0";"0";"2";"2";"0";"2";"0";"457181";"373894"
"V4mis1";"SILVA (only NR);Eukaryota;Amorphea;Obazoa;Opisthokonta;Nucletmycea;Fungi;Dikarya;Basidiomycota;Ustilaginomycotina;Exobasidiomycetes;Doassansiales;Heterodoassansia;";"0.0";"0";"1";"1";"0";"1";"0";"457182";"373894"
"V4mis1";"SILVA (only NR);Eukaryota;Amorphea;Obazoa;Opisthokonta;Nucletmycea;Fungi;Dikarya;Basidiomycota;Ustilaginomycotina;Exobasidiomycetes;Doassansiales;Rhamphospora;";"0.0";"0";"1";"1";"0";"1";"0";"457182";"373894"
"V4mis1";"SILVA (only NR);Eukaryota;Amorphea;Obazoa;Opisthokonta;Nucletmycea;Fungi;Dikarya;Basidiomycota;Ustilaginomycotina;Exobasidiomycetes;Entylomatales;";"0.0";"0";"8";"8";"0";"8";"0";"457175";"373894"
"V4mis1";"SILVA (only NR);Eukaryota;Amorphea;Obazoa;Opisthokonta;Nucletmycea;Fungi;Dikarya;Basidiomycota;Ustilaginomycotina;Exobasidiomycetes;Entylomatales;Entylomataceae;";"0.0";"0";"1";"1";"0";"1";"0";"457182";"373894"
"V4mis1";"SILVA (only NR);Eukaryota;Amorphea;Obazoa;Opisthokonta;Nucletmycea;Fungi;Dikarya;Basidiomycota;Ustilaginomycotina;Exobasidiomycetes;Entylomatales;Entylomataceae;Entyloma;";"0.0";"0";"1";"1";"0";"1";"0";"457182";"373894"
"V4mis1";"SILVA (only NR);Eukaryota;Amorphea;Obazoa;Opisthokonta;Nucletmycea;Fungi;Dikarya;Basidiomycota;Ustilaginomycotina;Exobasidiomycetes;Entylomatales;Incertae Sedis;";"0.0";"0";"7";"7";"0";"7";"0";"457176";"373894"
"V4mis1";"SILVA (only NR);Eukaryota;Amorphea;Obazoa;Opisthokonta;Nucletmycea;Fungi;Dikarya;Basidiomycota;Ustilaginomycotina;Exobasidiomycetes;Entylomatales;Incertae Sedis;Tilletiopsis;";"0.0";"0";"7";"7";"0";"7";"0";"457176";"373894"
"V4mis1";"SILVA (only NR);Eukaryota;Amorphea;Obazoa;Opisthokonta;Nucletmycea;Fungi;Dikarya;Basidiomycota;Ustilaginomycotina;Exobasidiomycetes;Exobasidiales;";"0.0";"0";"10";"10";"0";"10";"0";"457173";"373894"
"V4mis1";"SILVA (only NR);Eukaryota;Amorphea;Obazoa;Opisthokonta;Nucletmycea;Fungi;Dikarya;Basidiomycota;Ustilaginomycotina;Exobasidiomycetes;Exobasidiales;Acaromyces;";"0.0";"0";"1";"1";"0";"1";"0";"457182";"373894"
"V4mis1";"SILVA (only NR);Eukaryota;Amorphea;Obazoa;Opisthokonta;Nucletmycea;Fungi;Dikarya;Basidiomycota;Ustilaginomycotina;Exobasidiomycetes;Exobasidiales;Brachybasidiaceae;";"0.0";"0";"3";"3";"0";"3";"0";"457180";"373894"
"V4mis1";"SILVA (only NR);Eukaryota;Amorphea;Obazoa;Opisthokonta;Nucletmycea;Fungi;Dikarya;Basidiomycota;Ustilaginomycotina;Exobasidiomycetes;Exobasidiales;Brachybasidiaceae;Dicellomyces;";"0.0";"0";"1";"1";"0";"1";"0";"457182";"373894"
"V4mis1";"SILVA (only NR);Eukaryota;Amorphea;Obazoa;Opisthokonta;Nucletmycea;Fungi;Dikarya;Basidiomycota;Ustilaginomycotina;Exobasidiomycetes;Exobasidiales;Brachybasidiaceae;Meira;";"0.0";"0";"1";"1";"0";"1";"0";"457182";"373894"
"V4mis1";"SILVA (only NR);Eukaryota;Amorphea;Obazoa;Opisthokonta;Nucletmycea;Fungi;Dikarya;Basidiomycota;Ustilaginomycotina;Exobasidiomycetes;Exobasidiales;Exobasidiaceae;";"0.0";"0";"4";"4";"0";"4";"0";"457179";"373894"
"V4mis1";"SILVA (only NR);Eukaryota;Amorphea;Obazoa;Opisthokonta;Nucletmycea;Fungi;Dikarya;Basidiomycota;Ustilaginomycotina;Exobasidiomycetes;Exobasidiales;Exobasidiaceae;Exobasidium;";"0.0";"0";"4";"4";"0";"4";"0";"457179";"373894"
"V4mis1";"SILVA (only NR);Eukaryota;Amorphea;Obazoa;Opisthokonta;Nucletmycea;Fungi;Dikarya;Basidiomycota;Ustilaginomycotina;Exobasidiomycetes;Exobasidiales;Graphiola;";"0.0";"0";"1";"1";"0";"1";"0";"457182";"373894"
"V4mis1";"SILVA (only NR);Eukaryota;Amorphea;Obazoa;Opisthokonta;Nucletmycea;Fungi;Dikarya;Basidiomycota;Ustilaginomycotina;Exobasidiomycetes;Georgefischeriales;";"0.0";"0";"12";"12";"0";"12";"0";"457171";"373894"
"V4mis1";"SILVA (only NR);Eukaryota;Amorphea;Obazoa;Opisthokonta;Nucletmycea;Fungi;Dikarya;Basidiomycota;Ustilaginomycotina;Exobasidiomycetes;Georgefischeriales;Georgefischeriaceae;";"0.0";"0";"2";"2";"0";"2";"0";"457181";"373894"
"V4mis1";"SILVA (only NR);Eukaryota;Amorphea;Obazoa;Opisthokonta;Nucletmycea;Fungi;Dikarya;Basidiomycota;Ustilaginomycotina;Exobasidiomycetes;Georgefischeriales;Georgefischeriaceae;Georgefischeria;";"0.0";"0";"1";"1";"0";"1";"0";"457182";"373894"
"V4mis1";"SILVA (only NR);Eukaryota;Amorphea;Obazoa;Opisthokonta;Nucletmycea;Fungi;Dikarya;Basidiomycota;Ustilaginomycotina;Exobasidiomycetes;Georgefischeriales;Gjaerumiaceae;";"0.0";"0";"3";"3";"0";"3";"0";"457180";"373894"
"V4mis1";"SILVA (only NR);Eukaryota;Amorphea;Obazoa;Opisthokonta;Nucletmycea;Fungi;Dikarya;Basidiomycota;Ustilaginomycotina;Exobasidiomycetes;Georgefischeriales;Gjaerumiaceae;Gjaerumia;";"0.0";"0";"3";"3";"0";"3";"0";"457180";"373894"
"V4mis1";"SILVA (only NR);Eukaryota;Amorphea;Obazoa;Opisthokonta;Nucletmycea;Fungi;Dikarya;Basidiomycota;Ustilaginomycotina;Exobasidiomycetes;Georgefischeriales;Tilletiariaceae;";"0.0";"0";"7";"7";"0";"7";"0";"457176";"373894"
"V4mis1";"SILVA (only NR);Eukaryota;Amorphea;Obazoa;Opisthokonta;Nucletmycea;Fungi;Dikarya;Basidiomycota;Ustilaginomycotina;Exobasidiomycetes;Georgefischeriales;Tilletiariaceae;Phragmotaenium;";"0.0";"0";"5";"5";"0";"5";"0";"457178";"373894"
"V4mis1";"SILVA (only NR);Eukaryota;Amorphea;Obazoa;Opisthokonta;Nucletmycea;Fungi;Dikarya;Basidiomycota;Ustilaginomycotina;Exobasidiomycetes;Georgefischeriales;Tilletiariaceae;Tilletiaria;";"0.0";"0";"2";"2";"0";"2";"0";"457181";"373894"
"V4mis1";"SILVA (only NR);Eukaryota;Amorphea;Obazoa;Opisthokonta;Nucletmycea;Fungi;Dikarya;Basidiomycota;Ustilaginomycotina;Exobasidiomycetes;Microstromatales;";"0.0";"0";"8";"8";"0";"8";"0";"457175";"373894"
"V4mis1";"SILVA (only NR);Eukaryota;Amorphea;Obazoa;Opisthokonta;Nucletmycea;Fungi;Dikarya;Basidiomycota;Ustilaginomycotina;Exobasidiomycetes;Microstromatales;Incertae Sedis;";"0.0";"0";"2";"2";"0";"2";"0";"457181";"373894"
"V4mis1";"SILVA (only NR);Eukaryota;Amorphea;Obazoa;Opisthokonta;Nucletmycea;Fungi;Dikarya;Basidiomycota;Ustilaginomycotina;Exobasidiomycetes;Microstromatales;Incertae Sedis;Sympodiomycopsis;";"0.0";"0";"2";"2";"0";"2";"0";"457181";"373894"
"V4mis1";"SILVA (only NR);Eukaryota;Amorphea;Obazoa;Opisthokonta;Nucletmycea;Fungi;Dikarya;Basidiomycota;Ustilaginomycotina;Exobasidiomycetes;Microstromatales;Jaminaea;";"0.0";"0";"1";"1";"0";"1";"0";"457182";"373894"
"V4mis1";"SILVA (only NR);Eukaryota;Amorphea;Obazoa;Opisthokonta;Nucletmycea;Fungi;Dikarya;Basidiomycota;Ustilaginomycotina;Exobasidiomycetes;Microstromatales;Microstromataceae;";"0.0";"0";"3";"3";"0";"3";"0";"457180";"373894"
"V4mis1";"SILVA (only NR);Eukaryota;Amorphea;Obazoa;Opisthokonta;Nucletmycea;Fungi;Dikarya;Basidiomycota;Ustilaginomycotina;Exobasidiomycetes;Microstromatales;Microstromataceae;Microstroma;";"0.0";"0";"3";"3";"0";"3";"0";"457180";"373894"
"V4mis1";"SILVA (only NR);Eukaryota;Amorphea;Obazoa;Opisthokonta;Nucletmycea;Fungi;Dikarya;Basidiomycota;Ustilaginomycotina;Exobasidiomycetes;Microstromatales;Quambalaria;";"0.0";"0";"1";"1";"0";"1";"0";"457182";"373894"
"V4mis1";"SILVA (only NR);Eukaryota;Amorphea;Obazoa;Opisthokonta;Nucletmycea;Fungi;Dikarya;Basidiomycota;Ustilaginomycotina;Exobasidiomycetes;Robbauerales;";"0.0";"0";"3";"3";"0";"3";"0";"457180";"373894"
"V4mis1";"SILVA (only NR);Eukaryota;Amorphea;Obazoa;Opisthokonta;Nucletmycea;Fungi;Dikarya;Basidiomycota;Ustilaginomycotina;Exobasidiomycetes;Robbauerales;Robbaueraceae;";"0.0";"0";"3";"3";"0";"3";"0";"457180";"373894"
"V4mis1";"SILVA (only NR);Eukaryota;Amorphea;Obazoa;Opisthokonta;Nucletmycea;Fungi;Dikarya;Basidiomycota;Ustilaginomycotina;Exobasidiomycetes;Robbauerales;Robbaueraceae;Robbauera;";"0.0";"0";"3";"3";"0";"3";"0";"457180";"373894"
"V4mis1";"SILVA (only NR);Eukaryota;Amorphea;Obazoa;Opisthokonta;Nucletmycea;Fungi;Dikarya;Basidiomycota;Ustilaginomycotina;Exobasidiomycetes;Tilletiales;";"0.0";"0";"6";"6";"0";"6";"0";"457177";"373894"
"V4mis1";"SILVA (only NR);Eukaryota;Amorphea;Obazoa;Opisthokonta;Nucletmycea;Fungi;Dikarya;Basidiomycota;Ustilaginomycotina;Exobasidiomycetes;Tilletiales;Tilletiaceae;";"0.0";"0";"6";"6";"0";"6";"0";"457177";"373894"
"V4mis1";"SILVA (only NR);Eukaryota;Amorphea;Obazoa;Opisthokonta;Nucletmycea;Fungi;Dikarya;Basidiomycota;Ustilaginomycotina;Exobasidiomycetes;Tilletiales;Tilletiaceae;Erratomyces;";"0.0";"0";"1";"1";"0";"1";"0";"457182";"373894"
"V4mis1";"SILVA (only NR);Eukaryota;Amorphea;Obazoa;Opisthokonta;Nucletmycea;Fungi;Dikarya;Basidiomycota;Ustilaginomycotina;Exobasidiomycetes;Tilletiales;Tilletiaceae;Salmacisia;";"0.0";"0";"1";"1";"0";"1";"0";"457182";"373894"
"V4mis1";"SILVA (only NR);Eukaryota;Amorphea;Obazoa;Opisthokonta;Nucletmycea;Fungi;Dikarya;Basidiomycota;Ustilaginomycotina;Exobasidiomycetes;Tilletiales;Tilletiaceae;Tilletia;";"0.0";"0";"4";"4";"0";"4";"0";"457179";"373894"
"V4mis1";"SILVA (only NR);Eukaryota;Amorphea;Obazoa;Opisthokonta;Nucletmycea;Fungi;Dikarya;Basidiomycota;Ustilaginomycotina;Malasseziomycetes;";"0.6";"18.1";"496";"493";"3";"490";"3";"456690";"373891"
"V4mis1";"SILVA (only NR);Eukaryota;Amorphea;Obazoa;Opisthokonta;Nucletmycea;Fungi;Dikarya;Basidiomycota;Ustilaginomycotina;Malasseziomycetes;Malasseziales;";"0.6";"18.1";"496";"493";"3";"490";"3";"456690";"373891"
"V4mis1";"SILVA (only NR);Eukaryota;Amorphea;Obazoa;Opisthokonta;Nucletmycea;Fungi;Dikarya;Basidiomycota;Ustilaginomycotina;Malasseziomycetes;Malasseziales;Malasseziaceae;";"0.6";"18.1";"496";"493";"3";"490";"3";"456690";"373891"
"V4mis1";"SILVA (only NR);Eukaryota;Amorphea;Obazoa;Opisthokonta;Nucletmycea;Fungi;Dikarya;Basidiomycota;Ustilaginomycotina;Malasseziomycetes;Malasseziales;Malasseziaceae;Malassezia;";"0.6";"18.1";"496";"493";"3";"490";"3";"456690";"373891"
"V4mis1";"SILVA (only NR);Eukaryota;Amorphea;Obazoa;Opisthokonta;Nucletmycea;Fungi;Dikarya;Basidiomycota;Ustilaginomycotina;Moniliellomycetes;";"0.0";"0";"6";"6";"0";"6";"0";"457177";"373894"
"V4mis1";"SILVA (only NR);Eukaryota;Amorphea;Obazoa;Opisthokonta;Nucletmycea;Fungi;Dikarya;Basidiomycota;Ustilaginomycotina;Moniliellomycetes;Moniliellales;";"0.0";"0";"6";"6";"0";"6";"0";"457177";"373894"
"V4mis1";"SILVA (only NR);Eukaryota;Amorphea;Obazoa;Opisthokonta;Nucletmycea;Fungi;Dikarya;Basidiomycota;Ustilaginomycotina;Moniliellomycetes;Moniliellales;Moniliellaceae;";"0.0";"0";"6";"6";"0";"6";"0";"457177";"373894"
"V4mis1";"SILVA (only NR);Eukaryota;Amorphea;Obazoa;Opisthokonta;Nucletmycea;Fungi;Dikarya;Basidiomycota;Ustilaginomycotina;Moniliellomycetes;Moniliellales;Moniliellaceae;Moniliella;";"0.0";"0";"6";"6";"0";"6";"0";"457177";"373894"
"V4mis1";"SILVA (only NR);Eukaryota;Amorphea;Obazoa;Opisthokonta;Nucletmycea;Fungi;Dikarya;Basidiomycota;Ustilaginomycotina;Ustilaginomycetes;";"17.5";"18.2";"40";"40";"7";"33";"0";"457143";"373887"
"V4mis1";"SILVA (only NR);Eukaryota;Amorphea;Obazoa;Opisthokonta;Nucletmycea;Fungi;Dikarya;Basidiomycota;Ustilaginomycotina;Ustilaginomycetes;Urocystidales;";"33.3";"18.2";"3";"3";"1";"2";"0";"457180";"373893"
"V4mis1";"SILVA (only NR);Eukaryota;Amorphea;Obazoa;Opisthokonta;Nucletmycea;Fungi;Dikarya;Basidiomycota;Ustilaginomycotina;Ustilaginomycetes;Urocystidales;Fereydounia;";"100.0";"18.2";"1";"1";"1";"0";"0";"457182";"373893"
"V4mis1";"SILVA (only NR);Eukaryota;Amorphea;Obazoa;Opisthokonta;Nucletmycea;Fungi;Dikarya;Basidiomycota;Ustilaginomycotina;Ustilaginomycetes;Urocystidales;Melanotaeniaceae;";"0.0";"0";"2";"2";"0";"2";"0";"457181";"373894"
"V4mis1";"SILVA (only NR);Eukaryota;Amorphea;Obazoa;Opisthokonta;Nucletmycea;Fungi;Dikarya;Basidiomycota;Ustilaginomycotina;Ustilaginomycetes;Urocystidales;Melanotaeniaceae;Melanotaenium;";"0.0";"0";"2";"2";"0";"2";"0";"457181";"373894"
"V4mis1";"SILVA (only NR);Eukaryota;Amorphea;Obazoa;Opisthokonta;Nucletmycea;Fungi;Dikarya;Basidiomycota;Ustilaginomycotina;Ustilaginomycetes;Ustilaginales;";"16.7";"18.2";"36";"36";"6";"30";"0";"457147";"373888"
"V4mis1";"SILVA (only NR);Eukaryota;Amorphea;Obazoa;Opisthokonta;Nucletmycea;Fungi;Dikarya;Basidiomycota;Ustilaginomycotina;Ustilaginomycetes;Ustilaginales;Anthracoideaceae;";"50.0";"18.2";"2";"2";"1";"1";"0";"457181";"373893"
"V4mis1";"SILVA (only NR);Eukaryota;Amorphea;Obazoa;Opisthokonta;Nucletmycea;Fungi;Dikarya;Basidiomycota;Ustilaginomycotina;Ustilaginomycetes;Ustilaginales;Anthracoideaceae;Anthracoidea;";"50.0";"18.2";"2";"2";"1";"1";"0";"457181";"373893"
"V4mis1";"SILVA (only NR);Eukaryota;Amorphea;Obazoa;Opisthokonta;Nucletmycea;Fungi;Dikarya;Basidiomycota;Ustilaginomycotina;Ustilaginomycetes;Ustilaginales;Ustilaginaceae;";"14.7";"18.2";"34";"34";"5";"29";"0";"457149";"373889"
"V4mis1";"SILVA (only NR);Eukaryota;Amorphea;Obazoa;Opisthokonta;Nucletmycea;Fungi;Dikarya;Basidiomycota;Ustilaginomycotina;Ustilaginomycetes;Ustilaginales;Ustilaginaceae;Anthracocystis;";"0.0";"0";"1";"1";"0";"1";"0";"457182";"373894"
"V4mis1";"SILVA (only NR);Eukaryota;Amorphea;Obazoa;Opisthokonta;Nucletmycea;Fungi;Dikarya;Basidiomycota;Ustilaginomycotina;Ustilaginomycetes;Ustilaginales;Ustilaginaceae;Cintractia;";"0.0";"0";"1";"1";"0";"1";"0";"457182";"373894"
"V4mis1";"SILVA (only NR);Eukaryota;Amorphea;Obazoa;Opisthokonta;Nucletmycea;Fungi;Dikarya;Basidiomycota;Ustilaginomycotina;Ustilaginomycetes;Ustilaginales;Ustilaginaceae;Farysia;";"100.0";"18.2";"2";"2";"2";"0";"0";"457181";"373892"
"V4mis1";"SILVA (only NR);Eukaryota;Amorphea;Obazoa;Opisthokonta;Nucletmycea;Fungi;Dikarya;Basidiomycota;Ustilaginomycotina;Ustilaginomycetes;Ustilaginales;Ustilaginaceae;Leucocintractia;";"0.0";"0";"1";"1";"0";"1";"0";"457182";"373894"
"V4mis1";"SILVA (only NR);Eukaryota;Amorphea;Obazoa;Opisthokonta;Nucletmycea;Fungi;Dikarya;Basidiomycota;Ustilaginomycotina;Ustilaginomycetes;Ustilaginales;Ustilaginaceae;Melanopsichium;";"0.0";"0";"5";"5";"0";"5";"0";"457178";"373894"
"V4mis1";"SILVA (only NR);Eukaryota;Amorphea;Obazoa;Opisthokonta;Nucletmycea;Fungi;Dikarya;Basidiomycota;Ustilaginomycotina;Ustilaginomycetes;Ustilaginales;Ustilaginaceae;Moesziomyces;";"0.0";"0";"2";"2";"0";"2";"0";"457181";"373894"
"V4mis1";"SILVA (only NR);Eukaryota;Amorphea;Obazoa;Opisthokonta;Nucletmycea;Fungi;Dikarya;Basidiomycota;Ustilaginomycotina;Ustilaginomycetes;Ustilaginales;Ustilaginaceae;Pseudozyma;";"0.0";"0";"2";"2";"0";"2";"0";"457181";"373894"
"V4mis1";"SILVA (only NR);Eukaryota;Amorphea;Obazoa;Opisthokonta;Nucletmycea;Fungi;Dikarya;Basidiomycota;Ustilaginomycotina;Ustilaginomycetes;Ustilaginales;Ustilaginaceae;Schizonella;";"100.0";"18.2";"3";"3";"3";"0";"0";"457180";"373891"
"V4mis1";"SILVA (only NR);Eukaryota;Amorphea;Obazoa;Opisthokonta;Nucletmycea;Fungi;Dikarya;Basidiomycota;Ustilaginomycotina;Ustilaginomycetes;Ustilaginales;Ustilaginaceae;Sporisorium;";"0.0";"0";"7";"7";"0";"7";"0";"457176";"373894"
"V4mis1";"SILVA (only NR);Eukaryota;Amorphea;Obazoa;Opisthokonta;Nucletmycea;Fungi;Dikarya;Basidiomycota;Ustilaginomycotina;Ustilaginomycetes;Ustilaginales;Ustilaginaceae;Testicularia;";"0.0";"0";"1";"1";"0";"1";"0";"457182";"373894"
"V4mis1";"SILVA (only NR);Eukaryota;Amorphea;Obazoa;Opisthokonta;Nucletmycea;Fungi;Dikarya;Basidiomycota;Ustilaginomycotina;Ustilaginomycetes;Ustilaginales;Ustilaginaceae;Tranzscheliella;";"0.0";"0";"1";"1";"0";"1";"0";"457182";"373894"
"V4mis1";"SILVA (only NR);Eukaryota;Amorphea;Obazoa;Opisthokonta;Nucletmycea;Fungi;Dikarya;Basidiomycota;Ustilaginomycotina;Ustilaginomycetes;Ustilaginales;Ustilaginaceae;Ustanciosporium;";"0.0";"0";"1";"1";"0";"1";"0";"457182";"373894"
"V4mis1";"SILVA (only NR);Eukaryota;Amorphea;Obazoa;Opisthokonta;Nucletmycea;Fungi;Dikarya;Basidiomycota;Ustilaginomycotina;Ustilaginomycetes;Ustilaginales;Ustilaginaceae;Ustilago;";"0.0";"0";"6";"6";"0";"6";"0";"457177";"373894"
"V4mis1";"SILVA (only NR);Eukaryota;Amorphea;Obazoa;Opisthokonta;Nucletmycea;Fungi;Dikarya;Basidiomycota;Ustilaginomycotina;Ustilaginomycetes;Violaceomycetales;";"0.0";"0";"1";"1";"0";"1";"0";"457182";"373894"
"V4mis1";"SILVA (only NR);Eukaryota;Amorphea;Obazoa;Opisthokonta;Nucletmycea;Fungi;Dikarya;Basidiomycota;Ustilaginomycotina;Ustilaginomycetes;Violaceomycetales;Violaceomycetaceae;";"0.0";"0";"1";"1";"0";"1";"0";"457182";"373894"
"V4mis1";"SILVA (only NR);Eukaryota;Amorphea;Obazoa;Opisthokonta;Nucletmycea;Fungi;Dikarya;Basidiomycota;Ustilaginomycotina;Ustilaginomycetes;Violaceomycetales;Violaceomycetaceae;Violaceomyces;";"0.0";"0";"1";"1";"0";"1";"0";"457182";"373894"
"V4mis1";"SILVA (only NR);Eukaryota;Amorphea;Obazoa;Opisthokonta;Nucletmycea;Fungi;Dikarya;Basidiomycota;uncultured;";"0.0";"0";"2";"2";"0";"2";"0";"457181";"373894"
"V4mis1";"SILVA (only NR);Eukaryota;Amorphea;Obazoa;Opisthokonta;Nucletmycea;Fungi;Dikarya;Dikarya Incertae Sedis;";"0.0";"0";"2";"2";"0";"2";"0";"457181";"373894"
"V4mis1";"SILVA (only NR);Eukaryota;Amorphea;Obazoa;Opisthokonta;Nucletmycea;Fungi;Dikarya;Dikarya Incertae Sedis;Entorrhizomycetes;";"0.0";"0";"2";"2";"0";"2";"0";"457181";"373894"
"V4mis1";"SILVA (only NR);Eukaryota;Amorphea;Obazoa;Opisthokonta;Nucletmycea;Fungi;Dikarya;Dikarya Incertae Sedis;Entorrhizomycetes;Entorrhizales;";"0.0";"0";"2";"2";"0";"2";"0";"457181";"373894"
"V4mis1";"SILVA (only NR);Eukaryota;Amorphea;Obazoa;Opisthokonta;Nucletmycea;Fungi;Dikarya;Dikarya Incertae Sedis;Entorrhizomycetes;Entorrhizales;Entorrhizaceae;";"0.0";"0";"2";"2";"0";"2";"0";"457181";"373894"
"V4mis1";"SILVA (only NR);Eukaryota;Amorphea;Obazoa;Opisthokonta;Nucletmycea;Fungi;Dikarya;Dikarya Incertae Sedis;Entorrhizomycetes;Entorrhizales;Entorrhizaceae;Entorrhiza;";"0.0";"0";"2";"2";"0";"2";"0";"457181";"373894"
"V4mis1";"SILVA (only NR);Eukaryota;Amorphea;Obazoa;Opisthokonta;Nucletmycea;Fungi;Incertae Sedis;";"0.0";"0";"3";"3";"0";"3";"0";"457180";"373894"
"V4mis1";"SILVA (only NR);Eukaryota;Amorphea;Obazoa;Opisthokonta;Nucletmycea;Fungi;Incertae Sedis;Incertae Sedis;";"0.0";"0";"3";"3";"0";"3";"0";"457180";"373894"
"V4mis1";"SILVA (only NR);Eukaryota;Amorphea;Obazoa;Opisthokonta;Nucletmycea;Fungi;Incertae Sedis;Incertae Sedis;Incertae Sedis;";"0.0";"0";"3";"3";"0";"3";"0";"457180";"373894"
"V4mis1";"SILVA (only NR);Eukaryota;Amorphea;Obazoa;Opisthokonta;Nucletmycea;Fungi;Incertae Sedis;Incertae Sedis;Incertae Sedis;Incertae Sedis;";"0.0";"0";"3";"3";"0";"3";"0";"457180";"373894"
"V4mis1";"SILVA (only NR);Eukaryota;Amorphea;Obazoa;Opisthokonta;Nucletmycea;Fungi;Incertae Sedis;Incertae Sedis;Incertae Sedis;Incertae Sedis;Incertae Sedis;";"0.0";"0";"3";"3";"0";"3";"0";"457180";"373894"
"V4mis1";"SILVA (only NR);Eukaryota;Amorphea;Obazoa;Opisthokonta;Nucletmycea;Fungi;Incertae Sedis;Incertae Sedis;Incertae Sedis;Incertae Sedis;Incertae Sedis;Nephridiophaga;";"0.0";"0";"3";"3";"0";"3";"0";"457180";"373894"
"V4mis1";"SILVA (only NR);Eukaryota;Amorphea;Obazoa;Opisthokonta;Nucletmycea;Fungi;LKM15;";"0.0";"0";"23";"22";"0";"22";"1";"457161";"373894"
"V4mis1";"SILVA (only NR);Eukaryota;Amorphea;Obazoa;Opisthokonta;Nucletmycea;Fungi;Microsporidia;";"1.4";"18.2";"70";"70";"1";"69";"0";"457113";"373893"
"V4mis1";"SILVA (only NR);Eukaryota;Amorphea;Obazoa;Opisthokonta;Nucletmycea;Fungi;Microsporidia;Amblyosporidae;";"0.0";"0";"40";"40";"0";"40";"0";"457143";"373894"
"V4mis1";"SILVA (only NR);Eukaryota;Amorphea;Obazoa;Opisthokonta;Nucletmycea;Fungi;Microsporidia;Amblyosporidae;Amblyospora;";"0.0";"0";"31";"31";"0";"31";"0";"457152";"373894"
"V4mis1";"SILVA (only NR);Eukaryota;Amorphea;Obazoa;Opisthokonta;Nucletmycea;Fungi;Microsporidia;Amblyosporidae;Andreanna;";"0.0";"0";"1";"1";"0";"1";"0";"457182";"373894"
"V4mis1";"SILVA (only NR);Eukaryota;Amorphea;Obazoa;Opisthokonta;Nucletmycea;Fungi;Microsporidia;Amblyosporidae;Berwaldia;";"0.0";"0";"1";"1";"0";"1";"0";"457182";"373894"
"V4mis1";"SILVA (only NR);Eukaryota;Amorphea;Obazoa;Opisthokonta;Nucletmycea;Fungi;Microsporidia;Amblyosporidae;Intrapredatorus;";"0.0";"0";"1";"1";"0";"1";"0";"457182";"373894"
"V4mis1";"SILVA (only NR);Eukaryota;Amorphea;Obazoa;Opisthokonta;Nucletmycea;Fungi;Microsporidia;Amblyosporidae;Novothelohania;";"0.0";"0";"1";"1";"0";"1";"0";"457182";"373894"
"V4mis1";"SILVA (only NR);Eukaryota;Amorphea;Obazoa;Opisthokonta;Nucletmycea;Fungi;Microsporidia;Amblyosporidae;Parathelohania;";"0.0";"0";"4";"4";"0";"4";"0";"457179";"373894"
"V4mis1";"SILVA (only NR);Eukaryota;Amorphea;Obazoa;Opisthokonta;Nucletmycea;Fungi;Microsporidia;Amblyosporidae;Takaokaspora;";"0.0";"0";"1";"1";"0";"1";"0";"457182";"373894"
"V4mis1";"SILVA (only NR);Eukaryota;Amorphea;Obazoa;Opisthokonta;Nucletmycea;Fungi;Microsporidia;Caudosporidae;";"0.0";"0";"1";"1";"0";"1";"0";"457182";"373894"
"V4mis1";"SILVA (only NR);Eukaryota;Amorphea;Obazoa;Opisthokonta;Nucletmycea;Fungi;Microsporidia;Caudosporidae;Culicosporella;";"0.0";"0";"1";"1";"0";"1";"0";"457182";"373894"
"V4mis1";"SILVA (only NR);Eukaryota;Amorphea;Obazoa;Opisthokonta;Nucletmycea;Fungi;Microsporidia;Culicosporidae;";"0.0";"0";"1";"1";"0";"1";"0";"457182";"373894"
"V4mis1";"SILVA (only NR);Eukaryota;Amorphea;Obazoa;Opisthokonta;Nucletmycea;Fungi;Microsporidia;Culicosporidae;Edhazardia;";"0.0";"0";"1";"1";"0";"1";"0";"457182";"373894"
"V4mis1";"SILVA (only NR);Eukaryota;Amorphea;Obazoa;Opisthokonta;Nucletmycea;Fungi;Microsporidia;Gurleyidae;";"0.0";"0";"3";"3";"0";"3";"0";"457180";"373894"
"V4mis1";"SILVA (only NR);Eukaryota;Amorphea;Obazoa;Opisthokonta;Nucletmycea;Fungi;Microsporidia;Gurleyidae;Gurleya;";"0.0";"0";"1";"1";"0";"1";"0";"457182";"373894"
"V4mis1";"SILVA (only NR);Eukaryota;Amorphea;Obazoa;Opisthokonta;Nucletmycea;Fungi;Microsporidia;Gurleyidae;Hazardia;";"0.0";"0";"2";"2";"0";"2";"0";"457181";"373894"
"V4mis1";"SILVA (only NR);Eukaryota;Amorphea;Obazoa;Opisthokonta;Nucletmycea;Fungi;Microsporidia;Incertae Sedis;";"0.0";"0";"6";"6";"0";"6";"0";"457177";"373894"
"V4mis1";"SILVA (only NR);Eukaryota;Amorphea;Obazoa;Opisthokonta;Nucletmycea;Fungi;Microsporidia;Incertae Sedis;Binucleata;";"0.0";"0";"1";"1";"0";"1";"0";"457182";"373894"
"V4mis1";"SILVA (only NR);Eukaryota;Amorphea;Obazoa;Opisthokonta;Nucletmycea;Fungi;Microsporidia;Incertae Sedis;Lanatospora;";"0.0";"0";"1";"1";"0";"1";"0";"457182";"373894"
"V4mis1";"SILVA (only NR);Eukaryota;Amorphea;Obazoa;Opisthokonta;Nucletmycea;Fungi;Microsporidia;Incertae Sedis;Neoperezia;";"0.0";"0";"2";"2";"0";"2";"0";"457181";"373894"
"V4mis1";"SILVA (only NR);Eukaryota;Amorphea;Obazoa;Opisthokonta;Nucletmycea;Fungi;Microsporidia;Incertae Sedis;Senoma;";"0.0";"0";"1";"1";"0";"1";"0";"457182";"373894"
"V4mis1";"SILVA (only NR);Eukaryota;Amorphea;Obazoa;Opisthokonta;Nucletmycea;Fungi;Microsporidia;Incertae Sedis;Trichotosporea;";"0.0";"0";"1";"1";"0";"1";"0";"457182";"373894"
"V4mis1";"SILVA (only NR);Eukaryota;Amorphea;Obazoa;Opisthokonta;Nucletmycea;Fungi;Microsporidia;Mrazekiidae;";"0.0";"0";"4";"4";"0";"4";"0";"457179";"373894"
"V4mis1";"SILVA (only NR);Eukaryota;Amorphea;Obazoa;Opisthokonta;Nucletmycea;Fungi;Microsporidia;Mrazekiidae;Bacillidium;";"0.0";"0";"2";"2";"0";"2";"0";"457181";"373894"
"V4mis1";"SILVA (only NR);Eukaryota;Amorphea;Obazoa;Opisthokonta;Nucletmycea;Fungi;Microsporidia;Mrazekiidae;Schroedera;";"0.0";"0";"2";"2";"0";"2";"0";"457181";"373894"
"V4mis1";"SILVA (only NR);Eukaryota;Amorphea;Obazoa;Opisthokonta;Nucletmycea;Fungi;Microsporidia;Pseudonosematidae;";"0.0";"0";"5";"5";"0";"5";"0";"457178";"373894"
"V4mis1";"SILVA (only NR);Eukaryota;Amorphea;Obazoa;Opisthokonta;Nucletmycea;Fungi;Microsporidia;Pseudonosematidae;Bryonosema;";"0.0";"0";"3";"3";"0";"3";"0";"457180";"373894"
"V4mis1";"SILVA (only NR);Eukaryota;Amorphea;Obazoa;Opisthokonta;Nucletmycea;Fungi;Microsporidia;Pseudonosematidae;Pseudonosema;";"0.0";"0";"1";"1";"0";"1";"0";"457182";"373894"
"V4mis1";"SILVA (only NR);Eukaryota;Amorphea;Obazoa;Opisthokonta;Nucletmycea;Fungi;Microsporidia;Pseudonosematidae;Trichonosema;";"0.0";"0";"1";"1";"0";"1";"0";"457182";"373894"
"V4mis1";"SILVA (only NR);Eukaryota;Amorphea;Obazoa;Opisthokonta;Nucletmycea;Fungi;Microsporidia;Thelohaniidae;";"100.0";"18.2";"1";"1";"1";"0";"0";"457182";"373893"
"V4mis1";"SILVA (only NR);Eukaryota;Amorphea;Obazoa;Opisthokonta;Nucletmycea;Fungi;Microsporidia;Thelohaniidae;Hyalinocysta;";"100.0";"18.2";"1";"1";"1";"0";"0";"457182";"373893"
"V4mis1";"SILVA (only NR);Eukaryota;Amorphea;Obazoa;Opisthokonta;Nucletmycea;Fungi;Microsporidia;Tuzetiidae;";"0.0";"0";"3";"3";"0";"3";"0";"457180";"373894"
"V4mis1";"SILVA (only NR);Eukaryota;Amorphea;Obazoa;Opisthokonta;Nucletmycea;Fungi;Microsporidia;Tuzetiidae;Janacekia;";"0.0";"0";"2";"2";"0";"2";"0";"457181";"373894"
"V4mis1";"SILVA (only NR);Eukaryota;Amorphea;Obazoa;Opisthokonta;Nucletmycea;Fungi;Microsporidia;Tuzetiidae;Marssoniella;";"0.0";"0";"1";"1";"0";"1";"0";"457182";"373894"
"V4mis1";"SILVA (only NR);Eukaryota;Amorphea;Obazoa;Opisthokonta;Nucletmycea;Fungi;Mucoromycota;";"0.8";"18.1";"752";"746";"6";"740";"6";"456437";"373888"
"V4mis1";"SILVA (only NR);Eukaryota;Amorphea;Obazoa;Opisthokonta;Nucletmycea;Fungi;Mucoromycota;Glomeromycotina;";"0.0";"0";"433";"427";"0";"427";"6";"456756";"373894"
"V4mis1";"SILVA (only NR);Eukaryota;Amorphea;Obazoa;Opisthokonta;Nucletmycea;Fungi;Mucoromycota;Glomeromycotina;Glomeromycetes;";"0.0";"0";"433";"427";"0";"427";"6";"456756";"373894"
"V4mis1";"SILVA (only NR);Eukaryota;Amorphea;Obazoa;Opisthokonta;Nucletmycea;Fungi;Mucoromycota;Glomeromycotina;Glomeromycetes;Archaeosporales;";"0.0";"0";"31";"31";"0";"31";"0";"457152";"373894"
"V4mis1";"SILVA (only NR);Eukaryota;Amorphea;Obazoa;Opisthokonta;Nucletmycea;Fungi;Mucoromycota;Glomeromycotina;Glomeromycetes;Archaeosporales;Ambisporaceae;";"0.0";"0";"10";"10";"0";"10";"0";"457173";"373894"
"V4mis1";"SILVA (only NR);Eukaryota;Amorphea;Obazoa;Opisthokonta;Nucletmycea;Fungi;Mucoromycota;Glomeromycotina;Glomeromycetes;Archaeosporales;Ambisporaceae;Ambispora;";"0.0";"0";"10";"10";"0";"10";"0";"457173";"373894"
"V4mis1";"SILVA (only NR);Eukaryota;Amorphea;Obazoa;Opisthokonta;Nucletmycea;Fungi;Mucoromycota;Glomeromycotina;Glomeromycetes;Archaeosporales;Archaeosporaceae;";"0.0";"0";"19";"19";"0";"19";"0";"457164";"373894"
"V4mis1";"SILVA (only NR);Eukaryota;Amorphea;Obazoa;Opisthokonta;Nucletmycea;Fungi;Mucoromycota;Glomeromycotina;Glomeromycetes;Archaeosporales;Archaeosporaceae;Archaeospora;";"0.0";"0";"3";"3";"0";"3";"0";"457180";"373894"
"V4mis1";"SILVA (only NR);Eukaryota;Amorphea;Obazoa;Opisthokonta;Nucletmycea;Fungi;Mucoromycota;Glomeromycotina;Glomeromycetes;Archaeosporales;Geosiphonaceae;";"0.0";"0";"2";"2";"0";"2";"0";"457181";"373894"
"V4mis1";"SILVA (only NR);Eukaryota;Amorphea;Obazoa;Opisthokonta;Nucletmycea;Fungi;Mucoromycota;Glomeromycotina;Glomeromycetes;Archaeosporales;Geosiphonaceae;Geosiphon;";"0.0";"0";"2";"2";"0";"2";"0";"457181";"373894"
"V4mis1";"SILVA (only NR);Eukaryota;Amorphea;Obazoa;Opisthokonta;Nucletmycea;Fungi;Mucoromycota;Glomeromycotina;Glomeromycetes;Diversisporales;";"0.0";"0";"86";"86";"0";"86";"0";"457097";"373894"
"V4mis1";"SILVA (only NR);Eukaryota;Amorphea;Obazoa;Opisthokonta;Nucletmycea;Fungi;Mucoromycota;Glomeromycotina;Glomeromycetes;Diversisporales;Acaulosporaceae;";"0.0";"0";"23";"23";"0";"23";"0";"457160";"373894"
"V4mis1";"SILVA (only NR);Eukaryota;Amorphea;Obazoa;Opisthokonta;Nucletmycea;Fungi;Mucoromycota;Glomeromycotina;Glomeromycetes;Diversisporales;Acaulosporaceae;Acaulospora;";"0.0";"0";"23";"23";"0";"23";"0";"457160";"373894"
"V4mis1";"SILVA (only NR);Eukaryota;Amorphea;Obazoa;Opisthokonta;Nucletmycea;Fungi;Mucoromycota;Glomeromycotina;Glomeromycetes;Diversisporales;Diversisporaceae;";"0.0";"0";"11";"11";"0";"11";"0";"457172";"373894"
"V4mis1";"SILVA (only NR);Eukaryota;Amorphea;Obazoa;Opisthokonta;Nucletmycea;Fungi;Mucoromycota;Glomeromycotina;Glomeromycetes;Diversisporales;Diversisporaceae;Diversispora;";"0.0";"0";"9";"9";"0";"9";"0";"457174";"373894"
"V4mis1";"SILVA (only NR);Eukaryota;Amorphea;Obazoa;Opisthokonta;Nucletmycea;Fungi;Mucoromycota;Glomeromycotina;Glomeromycetes;Diversisporales;Diversisporaceae;Otospora;";"0.0";"0";"1";"1";"0";"1";"0";"457182";"373894"
"V4mis1";"SILVA (only NR);Eukaryota;Amorphea;Obazoa;Opisthokonta;Nucletmycea;Fungi;Mucoromycota;Glomeromycotina;Glomeromycetes;Diversisporales;Diversisporaceae;Redeckera;";"0.0";"0";"1";"1";"0";"1";"0";"457182";"373894"
"V4mis1";"SILVA (only NR);Eukaryota;Amorphea;Obazoa;Opisthokonta;Nucletmycea;Fungi;Mucoromycota;Glomeromycotina;Glomeromycetes;Diversisporales;Entrophospora;";"0.0";"0";"1";"1";"0";"1";"0";"457182";"373894"
"V4mis1";"SILVA (only NR);Eukaryota;Amorphea;Obazoa;Opisthokonta;Nucletmycea;Fungi;Mucoromycota;Glomeromycotina;Glomeromycetes;Diversisporales;Gigasporaceae;";"0.0";"0";"37";"37";"0";"37";"0";"457146";"373894"
"V4mis1";"SILVA (only NR);Eukaryota;Amorphea;Obazoa;Opisthokonta;Nucletmycea;Fungi;Mucoromycota;Glomeromycotina;Glomeromycetes;Diversisporales;Gigasporaceae;Cetraspora;";"0.0";"0";"2";"2";"0";"2";"0";"457181";"373894"
"V4mis1";"SILVA (only NR);Eukaryota;Amorphea;Obazoa;Opisthokonta;Nucletmycea;Fungi;Mucoromycota;Glomeromycotina;Glomeromycetes;Diversisporales;Gigasporaceae;Dentiscutata;";"0.0";"0";"4";"4";"0";"4";"0";"457179";"373894"
"V4mis1";"SILVA (only NR);Eukaryota;Amorphea;Obazoa;Opisthokonta;Nucletmycea;Fungi;Mucoromycota;Glomeromycotina;Glomeromycetes;Diversisporales;Gigasporaceae;Gigaspora;";"0.0";"0";"13";"13";"0";"13";"0";"457170";"373894"
"V4mis1";"SILVA (only NR);Eukaryota;Amorphea;Obazoa;Opisthokonta;Nucletmycea;Fungi;Mucoromycota;Glomeromycotina;Glomeromycetes;Diversisporales;Gigasporaceae;Racocetra;";"0.0";"0";"3";"3";"0";"3";"0";"457180";"373894"
"V4mis1";"SILVA (only NR);Eukaryota;Amorphea;Obazoa;Opisthokonta;Nucletmycea;Fungi;Mucoromycota;Glomeromycotina;Glomeromycetes;Diversisporales;Gigasporaceae;Scutellospora;";"0.0";"0";"14";"14";"0";"14";"0";"457169";"373894"
"V4mis1";"SILVA (only NR);Eukaryota;Amorphea;Obazoa;Opisthokonta;Nucletmycea;Fungi;Mucoromycota;Glomeromycotina;Glomeromycetes;Diversisporales;Pacispora;";"0.0";"0";"3";"3";"0";"3";"0";"457180";"373894"
"V4mis1";"SILVA (only NR);Eukaryota;Amorphea;Obazoa;Opisthokonta;Nucletmycea;Fungi;Mucoromycota;Glomeromycotina;Glomeromycetes;Diversisporales;Sacculosporaceae;";"0.0";"0";"3";"3";"0";"3";"0";"457180";"373894"
"V4mis1";"SILVA (only NR);Eukaryota;Amorphea;Obazoa;Opisthokonta;Nucletmycea;Fungi;Mucoromycota;Glomeromycotina;Glomeromycetes;Diversisporales;Sacculosporaceae;Sacculospora;";"0.0";"0";"3";"3";"0";"3";"0";"457180";"373894"
"V4mis1";"SILVA (only NR);Eukaryota;Amorphea;Obazoa;Opisthokonta;Nucletmycea;Fungi;Mucoromycota;Glomeromycotina;Glomeromycetes;Glomerales;";"0.0";"0";"257";"251";"0";"251";"6";"456932";"373894"
"V4mis1";"SILVA (only NR);Eukaryota;Amorphea;Obazoa;Opisthokonta;Nucletmycea;Fungi;Mucoromycota;Glomeromycotina;Glomeromycetes;Glomerales;Claroideoglomeraceae;";"0.0";"0";"11";"10";"0";"10";"1";"457173";"373894"
"V4mis1";"SILVA (only NR);Eukaryota;Amorphea;Obazoa;Opisthokonta;Nucletmycea;Fungi;Mucoromycota;Glomeromycotina;Glomeromycetes;Glomerales;Claroideoglomeraceae;Claroideoglomus;";"0.0";"0";"11";"10";"0";"10";"1";"457173";"373894"
"V4mis1";"SILVA (only NR);Eukaryota;Amorphea;Obazoa;Opisthokonta;Nucletmycea;Fungi;Mucoromycota;Glomeromycotina;Glomeromycetes;Glomerales;Glomeraceae;";"0.0";"0";"220";"215";"0";"215";"5";"456968";"373894"
"V4mis1";"SILVA (only NR);Eukaryota;Amorphea;Obazoa;Opisthokonta;Nucletmycea;Fungi;Mucoromycota;Glomeromycotina;Glomeromycetes;Glomerales;Glomeraceae;Funneliformis;";"0.0";"0";"13";"13";"0";"13";"0";"457170";"373894"
"V4mis1";"SILVA (only NR);Eukaryota;Amorphea;Obazoa;Opisthokonta;Nucletmycea;Fungi;Mucoromycota;Glomeromycotina;Glomeromycetes;Glomerales;Glomeraceae;Glomus;";"0.0";"0";"130";"125";"0";"125";"5";"457058";"373894"
"V4mis1";"SILVA (only NR);Eukaryota;Amorphea;Obazoa;Opisthokonta;Nucletmycea;Fungi;Mucoromycota;Glomeromycotina;Glomeromycetes;Glomerales;Glomeraceae;Rhizophagus;";"0.0";"0";"62";"62";"0";"62";"0";"457121";"373894"
"V4mis1";"SILVA (only NR);Eukaryota;Amorphea;Obazoa;Opisthokonta;Nucletmycea;Fungi;Mucoromycota;Glomeromycotina;Glomeromycetes;Glomerales;Glomeraceae;Sclerocystis;";"0.0";"0";"4";"4";"0";"4";"0";"457179";"373894"
"V4mis1";"SILVA (only NR);Eukaryota;Amorphea;Obazoa;Opisthokonta;Nucletmycea;Fungi;Mucoromycota;Glomeromycotina;Glomeromycetes;Glomerales;Glomeraceae;Septoglomus;";"0.0";"0";"9";"9";"0";"9";"0";"457174";"373894"
"V4mis1";"SILVA (only NR);Eukaryota;Amorphea;Obazoa;Opisthokonta;Nucletmycea;Fungi;Mucoromycota;Glomeromycotina;Glomeromycetes;Glomerales;uncultured;";"0.0";"0";"23";"23";"0";"23";"0";"457160";"373894"
"V4mis1";"SILVA (only NR);Eukaryota;Amorphea;Obazoa;Opisthokonta;Nucletmycea;Fungi;Mucoromycota;Glomeromycotina;Glomeromycetes;Paraglomerales;";"0.0";"0";"2";"2";"0";"2";"0";"457181";"373894"
"V4mis1";"SILVA (only NR);Eukaryota;Amorphea;Obazoa;Opisthokonta;Nucletmycea;Fungi;Mucoromycota;Glomeromycotina;Glomeromycetes;Paraglomerales;Paraglomeraceae;";"0.0";"0";"2";"2";"0";"2";"0";"457181";"373894"
"V4mis1";"SILVA (only NR);Eukaryota;Amorphea;Obazoa;Opisthokonta;Nucletmycea;Fungi;Mucoromycota;Glomeromycotina;Glomeromycetes;Paraglomerales;Paraglomeraceae;Paraglomus;";"0.0";"0";"2";"2";"0";"2";"0";"457181";"373894"
"V4mis1";"SILVA (only NR);Eukaryota;Amorphea;Obazoa;Opisthokonta;Nucletmycea;Fungi;Mucoromycota;Glomeromycotina;Glomeromycetes;uncultured;";"0.0";"0";"32";"32";"0";"32";"0";"457151";"373894"
"V4mis1";"SILVA (only NR);Eukaryota;Amorphea;Obazoa;Opisthokonta;Nucletmycea;Fungi;Mucoromycota;Mortierellomycotina;";"0.0";"0";"55";"55";"0";"55";"0";"457128";"373894"
"V4mis1";"SILVA (only NR);Eukaryota;Amorphea;Obazoa;Opisthokonta;Nucletmycea;Fungi;Mucoromycota;Mortierellomycotina;Incertae Sedis;";"0.0";"0";"55";"55";"0";"55";"0";"457128";"373894"
"V4mis1";"SILVA (only NR);Eukaryota;Amorphea;Obazoa;Opisthokonta;Nucletmycea;Fungi;Mucoromycota;Mortierellomycotina;Incertae Sedis;Mortierellales;";"0.0";"0";"55";"55";"0";"55";"0";"457128";"373894"
"V4mis1";"SILVA (only NR);Eukaryota;Amorphea;Obazoa;Opisthokonta;Nucletmycea;Fungi;Mucoromycota;Mortierellomycotina;Incertae Sedis;Mortierellales;Modicella;";"0.0";"0";"1";"1";"0";"1";"0";"457182";"373894"
"V4mis1";"SILVA (only NR);Eukaryota;Amorphea;Obazoa;Opisthokonta;Nucletmycea;Fungi;Mucoromycota;Mortierellomycotina;Incertae Sedis;Mortierellales;Mortierellaceae;";"0.0";"0";"45";"45";"0";"45";"0";"457138";"373894"
"V4mis1";"SILVA (only NR);Eukaryota;Amorphea;Obazoa;Opisthokonta;Nucletmycea;Fungi;Mucoromycota;Mortierellomycotina;Incertae Sedis;Mortierellales;Mortierellaceae;Mortierella;";"0.0";"0";"45";"45";"0";"45";"0";"457138";"373894"
"V4mis1";"SILVA (only NR);Eukaryota;Amorphea;Obazoa;Opisthokonta;Nucletmycea;Fungi;Mucoromycota;Mortierellomycotina;Incertae Sedis;Mortierellales;uncultured;";"0.0";"0";"5";"5";"0";"5";"0";"457178";"373894"
"V4mis1";"SILVA (only NR);Eukaryota;Amorphea;Obazoa;Opisthokonta;Nucletmycea;Fungi;Mucoromycota;Mucoromycotina;";"2.3";"18.2";"264";"264";"6";"258";"0";"456919";"373888"
"V4mis1";"SILVA (only NR);Eukaryota;Amorphea;Obazoa;Opisthokonta;Nucletmycea;Fungi;Mucoromycota;Mucoromycotina;Incertae Sedis;";"2.3";"18.2";"264";"264";"6";"258";"0";"456919";"373888"
"V4mis1";"SILVA (only NR);Eukaryota;Amorphea;Obazoa;Opisthokonta;Nucletmycea;Fungi;Mucoromycota;Mucoromycotina;Incertae Sedis;Endogonales;";"0.0";"0";"39";"39";"0";"39";"0";"457144";"373894"
"V4mis1";"SILVA (only NR);Eukaryota;Amorphea;Obazoa;Opisthokonta;Nucletmycea;Fungi;Mucoromycota;Mucoromycotina;Incertae Sedis;Endogonales;Endogonaceae;";"0.0";"0";"39";"39";"0";"39";"0";"457144";"373894"
"V4mis1";"SILVA (only NR);Eukaryota;Amorphea;Obazoa;Opisthokonta;Nucletmycea;Fungi;Mucoromycota;Mucoromycotina;Incertae Sedis;Endogonales;Endogonaceae;Endogone;";"0.0";"0";"22";"22";"0";"22";"0";"457161";"373894"
"V4mis1";"SILVA (only NR);Eukaryota;Amorphea;Obazoa;Opisthokonta;Nucletmycea;Fungi;Mucoromycota;Mucoromycotina;Incertae Sedis;Endogonales;Endogonaceae;uncultured;";"0.0";"0";"17";"17";"0";"17";"0";"457166";"373894"
"V4mis1";"SILVA (only NR);Eukaryota;Amorphea;Obazoa;Opisthokonta;Nucletmycea;Fungi;Mucoromycota;Mucoromycotina;Incertae Sedis;Mucorales;";"2.8";"18.2";"218";"218";"6";"212";"0";"456965";"373888"
"V4mis1";"SILVA (only NR);Eukaryota;Amorphea;Obazoa;Opisthokonta;Nucletmycea;Fungi;Mucoromycota;Mucoromycotina;Incertae Sedis;Mucorales;Apophysomyces;";"100.0";"18.2";"1";"1";"1";"0";"0";"457182";"373893"
"V4mis1";"SILVA (only NR);Eukaryota;Amorphea;Obazoa;Opisthokonta;Nucletmycea;Fungi;Mucoromycota;Mucoromycotina;Incertae Sedis;Mucorales;Backusellaceae;";"0.0";"0";"3";"3";"0";"3";"0";"457180";"373894"
"V4mis1";"SILVA (only NR);Eukaryota;Amorphea;Obazoa;Opisthokonta;Nucletmycea;Fungi;Mucoromycota;Mucoromycotina;Incertae Sedis;Mucorales;Backusellaceae;Backusella;";"0.0";"0";"3";"3";"0";"3";"0";"457180";"373894"
"V4mis1";"SILVA (only NR);Eukaryota;Amorphea;Obazoa;Opisthokonta;Nucletmycea;Fungi;Mucoromycota;Mucoromycotina;Incertae Sedis;Mucorales;Chaetocladiaceae;";"0.0";"0";"2";"2";"0";"2";"0";"457181";"373894"
"V4mis1";"SILVA (only NR);Eukaryota;Amorphea;Obazoa;Opisthokonta;Nucletmycea;Fungi;Mucoromycota;Mucoromycotina;Incertae Sedis;Mucorales;Chaetocladiaceae;Chaetocladium;";"0.0";"0";"2";"2";"0";"2";"0";"457181";"373894"
"V4mis1";"SILVA (only NR);Eukaryota;Amorphea;Obazoa;Opisthokonta;Nucletmycea;Fungi;Mucoromycota;Mucoromycotina;Incertae Sedis;Mucorales;Choanephoraceae;";"0.0";"0";"10";"10";"0";"10";"0";"457173";"373894"
"V4mis1";"SILVA (only NR);Eukaryota;Amorphea;Obazoa;Opisthokonta;Nucletmycea;Fungi;Mucoromycota;Mucoromycotina;Incertae Sedis;Mucorales;Choanephoraceae;Blakeslea;";"0.0";"0";"1";"1";"0";"1";"0";"457182";"373894"
"V4mis1";"SILVA (only NR);Eukaryota;Amorphea;Obazoa;Opisthokonta;Nucletmycea;Fungi;Mucoromycota;Mucoromycotina;Incertae Sedis;Mucorales;Choanephoraceae;Choanephora;";"0.0";"0";"1";"1";"0";"1";"0";"457182";"373894"
"V4mis1";"SILVA (only NR);Eukaryota;Amorphea;Obazoa;Opisthokonta;Nucletmycea;Fungi;Mucoromycota;Mucoromycotina;Incertae Sedis;Mucorales;Choanephoraceae;Gilbertella;";"0.0";"0";"1";"1";"0";"1";"0";"457182";"373894"
"V4mis1";"SILVA (only NR);Eukaryota;Amorphea;Obazoa;Opisthokonta;Nucletmycea;Fungi;Mucoromycota;Mucoromycotina;Incertae Sedis;Mucorales;Choanephoraceae;Poitrasia;";"0.0";"0";"1";"1";"0";"1";"0";"457182";"373894"
"V4mis1";"SILVA (only NR);Eukaryota;Amorphea;Obazoa;Opisthokonta;Nucletmycea;Fungi;Mucoromycota;Mucoromycotina;Incertae Sedis;Mucorales;Choanephoraceae;uncultured;";"0.0";"0";"6";"6";"0";"6";"0";"457177";"373894"
"V4mis1";"SILVA (only NR);Eukaryota;Amorphea;Obazoa;Opisthokonta;Nucletmycea;Fungi;Mucoromycota;Mucoromycotina;Incertae Sedis;Mucorales;Cunninghamellaceae;";"0.0";"0";"25";"25";"0";"25";"0";"457158";"373894"
"V4mis1";"SILVA (only NR);Eukaryota;Amorphea;Obazoa;Opisthokonta;Nucletmycea;Fungi;Mucoromycota;Mucoromycotina;Incertae Sedis;Mucorales;Cunninghamellaceae;Absidia;";"0.0";"0";"10";"10";"0";"10";"0";"457173";"373894"
"V4mis1";"SILVA (only NR);Eukaryota;Amorphea;Obazoa;Opisthokonta;Nucletmycea;Fungi;Mucoromycota;Mucoromycotina;Incertae Sedis;Mucorales;Cunninghamellaceae;Chlamydoabsidia;";"0.0";"0";"2";"2";"0";"2";"0";"457181";"373894"
"V4mis1";"SILVA (only NR);Eukaryota;Amorphea;Obazoa;Opisthokonta;Nucletmycea;Fungi;Mucoromycota;Mucoromycotina;Incertae Sedis;Mucorales;Cunninghamellaceae;Cunninghamella;";"0.0";"0";"4";"4";"0";"4";"0";"457179";"373894"
"V4mis1";"SILVA (only NR);Eukaryota;Amorphea;Obazoa;Opisthokonta;Nucletmycea;Fungi;Mucoromycota;Mucoromycotina;Incertae Sedis;Mucorales;Cunninghamellaceae;Gongronella;";"0.0";"0";"4";"4";"0";"4";"0";"457179";"373894"
"V4mis1";"SILVA (only NR);Eukaryota;Amorphea;Obazoa;Opisthokonta;Nucletmycea;Fungi;Mucoromycota;Mucoromycotina;Incertae Sedis;Mucorales;Cunninghamellaceae;Halteromyces;";"0.0";"0";"1";"1";"0";"1";"0";"457182";"373894"
"V4mis1";"SILVA (only NR);Eukaryota;Amorphea;Obazoa;Opisthokonta;Nucletmycea;Fungi;Mucoromycota;Mucoromycotina;Incertae Sedis;Mucorales;Cunninghamellaceae;Hesseltinella;";"0.0";"0";"3";"3";"0";"3";"0";"457180";"373894"
"V4mis1";"SILVA (only NR);Eukaryota;Amorphea;Obazoa;Opisthokonta;Nucletmycea;Fungi;Mucoromycota;Mucoromycotina;Incertae Sedis;Mucorales;Kirkomyces;";"0.0";"0";"1";"1";"0";"1";"0";"457182";"373894"
"V4mis1";"SILVA (only NR);Eukaryota;Amorphea;Obazoa;Opisthokonta;Nucletmycea;Fungi;Mucoromycota;Mucoromycotina;Incertae Sedis;Mucorales;Lichtheimiaceae;";"0.0";"0";"28";"28";"0";"28";"0";"457155";"373894"
"V4mis1";"SILVA (only NR);Eukaryota;Amorphea;Obazoa;Opisthokonta;Nucletmycea;Fungi;Mucoromycota;Mucoromycotina;Incertae Sedis;Mucorales;Lichtheimiaceae;Circinella;";"0.0";"0";"7";"7";"0";"7";"0";"457176";"373894"
"V4mis1";"SILVA (only NR);Eukaryota;Amorphea;Obazoa;Opisthokonta;Nucletmycea;Fungi;Mucoromycota;Mucoromycotina;Incertae Sedis;Mucorales;Lichtheimiaceae;Dichotomocladium;";"0.0";"0";"1";"1";"0";"1";"0";"457182";"373894"
"V4mis1";"SILVA (only NR);Eukaryota;Amorphea;Obazoa;Opisthokonta;Nucletmycea;Fungi;Mucoromycota;Mucoromycotina;Incertae Sedis;Mucorales;Lichtheimiaceae;Fennellomyces;";"0.0";"0";"1";"1";"0";"1";"0";"457182";"373894"
"V4mis1";"SILVA (only NR);Eukaryota;Amorphea;Obazoa;Opisthokonta;Nucletmycea;Fungi;Mucoromycota;Mucoromycotina;Incertae Sedis;Mucorales;Lichtheimiaceae;Lichtheimia;";"0.0";"0";"4";"4";"0";"4";"0";"457179";"373894"
"V4mis1";"SILVA (only NR);Eukaryota;Amorphea;Obazoa;Opisthokonta;Nucletmycea;Fungi;Mucoromycota;Mucoromycotina;Incertae Sedis;Mucorales;Lichtheimiaceae;Phascolomyces;";"0.0";"0";"1";"1";"0";"1";"0";"457182";"373894"
"V4mis1";"SILVA (only NR);Eukaryota;Amorphea;Obazoa;Opisthokonta;Nucletmycea;Fungi;Mucoromycota;Mucoromycotina;Incertae Sedis;Mucorales;Lichtheimiaceae;Rhizomucor;";"0.0";"0";"7";"7";"0";"7";"0";"457176";"373894"
"V4mis1";"SILVA (only NR);Eukaryota;Amorphea;Obazoa;Opisthokonta;Nucletmycea;Fungi;Mucoromycota;Mucoromycotina;Incertae Sedis;Mucorales;Lichtheimiaceae;Thamnostylum;";"0.0";"0";"4";"4";"0";"4";"0";"457179";"373894"
"V4mis1";"SILVA (only NR);Eukaryota;Amorphea;Obazoa;Opisthokonta;Nucletmycea;Fungi;Mucoromycota;Mucoromycotina;Incertae Sedis;Mucorales;Lichtheimiaceae;Thermomucor;";"0.0";"0";"1";"1";"0";"1";"0";"457182";"373894"
"V4mis1";"SILVA (only NR);Eukaryota;Amorphea;Obazoa;Opisthokonta;Nucletmycea;Fungi;Mucoromycota;Mucoromycotina;Incertae Sedis;Mucorales;Lichtheimiaceae;Zychaea;";"0.0";"0";"1";"1";"0";"1";"0";"457182";"373894"
"V4mis1";"SILVA (only NR);Eukaryota;Amorphea;Obazoa;Opisthokonta;Nucletmycea;Fungi;Mucoromycota;Mucoromycotina;Incertae Sedis;Mucorales;Mucoraceae;";"1.4";"18.2";"70";"70";"1";"69";"0";"457113";"373893"
"V4mis1";"SILVA (only NR);Eukaryota;Amorphea;Obazoa;Opisthokonta;Nucletmycea;Fungi;Mucoromycota;Mucoromycotina;Incertae Sedis;Mucorales;Mucoraceae;Actinomucor;";"0.0";"0";"1";"1";"0";"1";"0";"457182";"373894"
"V4mis1";"SILVA (only NR);Eukaryota;Amorphea;Obazoa;Opisthokonta;Nucletmycea;Fungi;Mucoromycota;Mucoromycotina;Incertae Sedis;Mucorales;Mucoraceae;Ambomucor;";"0.0";"0";"1";"1";"0";"1";"0";"457182";"373894"
"V4mis1";"SILVA (only NR);Eukaryota;Amorphea;Obazoa;Opisthokonta;Nucletmycea;Fungi;Mucoromycota;Mucoromycotina;Incertae Sedis;Mucorales;Mucoraceae;Benjaminiella;";"0.0";"0";"1";"1";"0";"1";"0";"457182";"373894"
"V4mis1";"SILVA (only NR);Eukaryota;Amorphea;Obazoa;Opisthokonta;Nucletmycea;Fungi;Mucoromycota;Mucoromycotina;Incertae Sedis;Mucorales;Mucoraceae;Circinomucor;";"100.0";"18.2";"1";"1";"1";"0";"0";"457182";"373893"
"V4mis1";"SILVA (only NR);Eukaryota;Amorphea;Obazoa;Opisthokonta;Nucletmycea;Fungi;Mucoromycota;Mucoromycotina;Incertae Sedis;Mucorales;Mucoraceae;Cokeromyces;";"0.0";"0";"2";"2";"0";"2";"0";"457181";"373894"
"V4mis1";"SILVA (only NR);Eukaryota;Amorphea;Obazoa;Opisthokonta;Nucletmycea;Fungi;Mucoromycota;Mucoromycotina;Incertae Sedis;Mucorales;Mucoraceae;Dicranophora;";"0.0";"0";"1";"1";"0";"1";"0";"457182";"373894"
"V4mis1";"SILVA (only NR);Eukaryota;Amorphea;Obazoa;Opisthokonta;Nucletmycea;Fungi;Mucoromycota;Mucoromycotina;Incertae Sedis;Mucorales;Mucoraceae;Ellisomyces;";"0.0";"0";"1";"1";"0";"1";"0";"457182";"373894"
"V4mis1";"SILVA (only NR);Eukaryota;Amorphea;Obazoa;Opisthokonta;Nucletmycea;Fungi;Mucoromycota;Mucoromycotina;Incertae Sedis;Mucorales;Mucoraceae;Hyphomucor;";"0.0";"0";"1";"1";"0";"1";"0";"457182";"373894"
"V4mis1";"SILVA (only NR);Eukaryota;Amorphea;Obazoa;Opisthokonta;Nucletmycea;Fungi;Mucoromycota;Mucoromycotina;Incertae Sedis;Mucorales;Mucoraceae;Mucor;";"0.0";"0";"52";"52";"0";"52";"0";"457131";"373894"
"V4mis1";"SILVA (only NR);Eukaryota;Amorphea;Obazoa;Opisthokonta;Nucletmycea;Fungi;Mucoromycota;Mucoromycotina;Incertae Sedis;Mucorales;Mucoraceae;Parasitella;";"0.0";"0";"3";"3";"0";"3";"0";"457180";"373894"
"V4mis1";"SILVA (only NR);Eukaryota;Amorphea;Obazoa;Opisthokonta;Nucletmycea;Fungi;Mucoromycota;Mucoromycotina;Incertae Sedis;Mucorales;Mucoraceae;Pilaira;";"0.0";"0";"3";"3";"0";"3";"0";"457180";"373894"
"V4mis1";"SILVA (only NR);Eukaryota;Amorphea;Obazoa;Opisthokonta;Nucletmycea;Fungi;Mucoromycota;Mucoromycotina;Incertae Sedis;Mucorales;Mucoraceae;Pirella;";"0.0";"0";"1";"1";"0";"1";"0";"457182";"373894"
"V4mis1";"SILVA (only NR);Eukaryota;Amorphea;Obazoa;Opisthokonta;Nucletmycea;Fungi;Mucoromycota;Mucoromycotina;Incertae Sedis;Mucorales;Mucoraceae;Thamnidium;";"0.0";"0";"1";"1";"0";"1";"0";"457182";"373894"
"V4mis1";"SILVA (only NR);Eukaryota;Amorphea;Obazoa;Opisthokonta;Nucletmycea;Fungi;Mucoromycota;Mucoromycotina;Incertae Sedis;Mucorales;Mycotyphaceae;";"0.0";"0";"3";"3";"0";"3";"0";"457180";"373894"
"V4mis1";"SILVA (only NR);Eukaryota;Amorphea;Obazoa;Opisthokonta;Nucletmycea;Fungi;Mucoromycota;Mucoromycotina;Incertae Sedis;Mucorales;Mycotyphaceae;Mycotypha;";"0.0";"0";"3";"3";"0";"3";"0";"457180";"373894"
"V4mis1";"SILVA (only NR);Eukaryota;Amorphea;Obazoa;Opisthokonta;Nucletmycea;Fungi;Mucoromycota;Mucoromycotina;Incertae Sedis;Mucorales;Phycomycetaceae;";"0.0";"0";"3";"3";"0";"3";"0";"457180";"373894"
"V4mis1";"SILVA (only NR);Eukaryota;Amorphea;Obazoa;Opisthokonta;Nucletmycea;Fungi;Mucoromycota;Mucoromycotina;Incertae Sedis;Mucorales;Phycomycetaceae;Phycomyces;";"0.0";"0";"2";"2";"0";"2";"0";"457181";"373894"
"V4mis1";"SILVA (only NR);Eukaryota;Amorphea;Obazoa;Opisthokonta;Nucletmycea;Fungi;Mucoromycota;Mucoromycotina;Incertae Sedis;Mucorales;Phycomycetaceae;Spinellus;";"0.0";"0";"1";"1";"0";"1";"0";"457182";"373894"
"V4mis1";"SILVA (only NR);Eukaryota;Amorphea;Obazoa;Opisthokonta;Nucletmycea;Fungi;Mucoromycota;Mucoromycotina;Incertae Sedis;Mucorales;Pilobolaceae;";"0.0";"0";"17";"17";"0";"17";"0";"457166";"373894"
"V4mis1";"SILVA (only NR);Eukaryota;Amorphea;Obazoa;Opisthokonta;Nucletmycea;Fungi;Mucoromycota;Mucoromycotina;Incertae Sedis;Mucorales;Pilobolaceae;Pilobolus;";"0.0";"0";"14";"14";"0";"14";"0";"457169";"373894"
"V4mis1";"SILVA (only NR);Eukaryota;Amorphea;Obazoa;Opisthokonta;Nucletmycea;Fungi;Mucoromycota;Mucoromycotina;Incertae Sedis;Mucorales;Pilobolaceae;Utharomyces;";"0.0";"0";"3";"3";"0";"3";"0";"457180";"373894"
"V4mis1";"SILVA (only NR);Eukaryota;Amorphea;Obazoa;Opisthokonta;Nucletmycea;Fungi;Mucoromycota;Mucoromycotina;Incertae Sedis;Mucorales;Protomycocladus;";"0.0";"0";"1";"1";"0";"1";"0";"457182";"373894"
"V4mis1";"SILVA (only NR);Eukaryota;Amorphea;Obazoa;Opisthokonta;Nucletmycea;Fungi;Mucoromycota;Mucoromycotina;Incertae Sedis;Mucorales;Radiomyces;";"0.0";"0";"1";"1";"0";"1";"0";"457182";"373894"
"V4mis1";"SILVA (only NR);Eukaryota;Amorphea;Obazoa;Opisthokonta;Nucletmycea;Fungi;Mucoromycota;Mucoromycotina;Incertae Sedis;Mucorales;Rhizopodaceae;";"0.0";"0";"45";"45";"0";"45";"0";"457138";"373894"
"V4mis1";"SILVA (only NR);Eukaryota;Amorphea;Obazoa;Opisthokonta;Nucletmycea;Fungi;Mucoromycota;Mucoromycotina;Incertae Sedis;Mucorales;Rhizopodaceae;Amylomyces;";"0.0";"0";"4";"4";"0";"4";"0";"457179";"373894"
"V4mis1";"SILVA (only NR);Eukaryota;Amorphea;Obazoa;Opisthokonta;Nucletmycea;Fungi;Mucoromycota;Mucoromycotina;Incertae Sedis;Mucorales;Rhizopodaceae;Rhizopus;";"0.0";"0";"39";"39";"0";"39";"0";"457144";"373894"
"V4mis1";"SILVA (only NR);Eukaryota;Amorphea;Obazoa;Opisthokonta;Nucletmycea;Fungi;Mucoromycota;Mucoromycotina;Incertae Sedis;Mucorales;Rhizopodaceae;Sporodiniella;";"0.0";"0";"1";"1";"0";"1";"0";"457182";"373894"
"V4mis1";"SILVA (only NR);Eukaryota;Amorphea;Obazoa;Opisthokonta;Nucletmycea;Fungi;Mucoromycota;Mucoromycotina;Incertae Sedis;Mucorales;Rhizopodaceae;Syzygites;";"0.0";"0";"1";"1";"0";"1";"0";"457182";"373894"
"V4mis1";"SILVA (only NR);Eukaryota;Amorphea;Obazoa;Opisthokonta;Nucletmycea;Fungi;Mucoromycota;Mucoromycotina;Incertae Sedis;Mucorales;Saksenaea;";"100.0";"18.2";"1";"1";"1";"0";"0";"457182";"373893"
"V4mis1";"SILVA (only NR);Eukaryota;Amorphea;Obazoa;Opisthokonta;Nucletmycea;Fungi;Mucoromycota;Mucoromycotina;Incertae Sedis;Mucorales;Syncephalastraceae;";"50.0";"18.2";"4";"4";"2";"2";"0";"457179";"373892"
"V4mis1";"SILVA (only NR);Eukaryota;Amorphea;Obazoa;Opisthokonta;Nucletmycea;Fungi;Mucoromycota;Mucoromycotina;Incertae Sedis;Mucorales;Syncephalastraceae;Syncephalastrum;";"50.0";"18.2";"4";"4";"2";"2";"0";"457179";"373892"
"V4mis1";"SILVA (only NR);Eukaryota;Amorphea;Obazoa;Opisthokonta;Nucletmycea;Fungi;Mucoromycota;Mucoromycotina;Incertae Sedis;Umbelopsidales;";"0.0";"0";"4";"4";"0";"4";"0";"457179";"373894"
"V4mis1";"SILVA (only NR);Eukaryota;Amorphea;Obazoa;Opisthokonta;Nucletmycea;Fungi;Mucoromycota;Mucoromycotina;Incertae Sedis;Umbelopsidales;Umbelopsidaceae;";"0.0";"0";"4";"4";"0";"4";"0";"457179";"373894"
"V4mis1";"SILVA (only NR);Eukaryota;Amorphea;Obazoa;Opisthokonta;Nucletmycea;Fungi;Mucoromycota;Mucoromycotina;Incertae Sedis;Umbelopsidales;Umbelopsidaceae;Umbelopsis;";"0.0";"0";"4";"4";"0";"4";"0";"457179";"373894"
"V4mis1";"SILVA (only NR);Eukaryota;Amorphea;Obazoa;Opisthokonta;Nucletmycea;Fungi;Neocallimastigomycota;";"0.0";"0";"21";"20";"0";"20";"1";"457163";"373894"
"V4mis1";"SILVA (only NR);Eukaryota;Amorphea;Obazoa;Opisthokonta;Nucletmycea;Fungi;Neocallimastigomycota;Incertae Sedis;";"0.0";"0";"21";"20";"0";"20";"1";"457163";"373894"
"V4mis1";"SILVA (only NR);Eukaryota;Amorphea;Obazoa;Opisthokonta;Nucletmycea;Fungi;Neocallimastigomycota;Incertae Sedis;Neocallimastigomycetes;";"0.0";"0";"21";"20";"0";"20";"1";"457163";"373894"
"V4mis1";"SILVA (only NR);Eukaryota;Amorphea;Obazoa;Opisthokonta;Nucletmycea;Fungi;Neocallimastigomycota;Incertae Sedis;Neocallimastigomycetes;Neocallimastigales;";"0.0";"0";"21";"20";"0";"20";"1";"457163";"373894"
"V4mis1";"SILVA (only NR);Eukaryota;Amorphea;Obazoa;Opisthokonta;Nucletmycea;Fungi;Neocallimastigomycota;Incertae Sedis;Neocallimastigomycetes;Neocallimastigales;Neocallimastigaceae;";"0.0";"0";"21";"20";"0";"20";"1";"457163";"373894"
"V4mis1";"SILVA (only NR);Eukaryota;Amorphea;Obazoa;Opisthokonta;Nucletmycea;Fungi;Neocallimastigomycota;Incertae Sedis;Neocallimastigomycetes;Neocallimastigales;Neocallimastigaceae;Cyllamyces;";"0.0";"0";"2";"2";"0";"2";"0";"457181";"373894"
"V4mis1";"SILVA (only NR);Eukaryota;Amorphea;Obazoa;Opisthokonta;Nucletmycea;Fungi;Neocallimastigomycota;Incertae Sedis;Neocallimastigomycetes;Neocallimastigales;Neocallimastigaceae;Neocallimastix;";"0.0";"0";"2";"2";"0";"2";"0";"457181";"373894"
"V4mis1";"SILVA (only NR);Eukaryota;Amorphea;Obazoa;Opisthokonta;Nucletmycea;Fungi;Neocallimastigomycota;Incertae Sedis;Neocallimastigomycetes;Neocallimastigales;Neocallimastigaceae;Pecoramyces;";"0.0";"0";"5";"4";"0";"4";"1";"457179";"373894"
"V4mis1";"SILVA (only NR);Eukaryota;Amorphea;Obazoa;Opisthokonta;Nucletmycea;Fungi;Neocallimastigomycota;Incertae Sedis;Neocallimastigomycetes;Neocallimastigales;Neocallimastigaceae;Piromyces;";"0.0";"0";"1";"1";"0";"1";"0";"457182";"373894"
"V4mis1";"SILVA (only NR);Eukaryota;Amorphea;Obazoa;Opisthokonta;Nucletmycea;Fungi;Neocallimastigomycota;Incertae Sedis;Neocallimastigomycetes;Neocallimastigales;Neocallimastigaceae;uncultured;";"0.0";"0";"4";"4";"0";"4";"0";"457179";"373894"
"V4mis1";"SILVA (only NR);Eukaryota;Amorphea;Obazoa;Opisthokonta;Nucletmycea;Fungi;Zoopagomycota;";"0.0";"0";"209";"207";"0";"207";"2";"456976";"373894"
"V4mis1";"SILVA (only NR);Eukaryota;Amorphea;Obazoa;Opisthokonta;Nucletmycea;Fungi;Zoopagomycota;Entomophthoromycotina;";"0.0";"0";"52";"51";"0";"51";"1";"457132";"373894"
"V4mis1";"SILVA (only NR);Eukaryota;Amorphea;Obazoa;Opisthokonta;Nucletmycea;Fungi;Zoopagomycota;Entomophthoromycotina;Basidiobolomycetes;";"0.0";"0";"7";"6";"0";"6";"1";"457177";"373894"
"V4mis1";"SILVA (only NR);Eukaryota;Amorphea;Obazoa;Opisthokonta;Nucletmycea;Fungi;Zoopagomycota;Entomophthoromycotina;Basidiobolomycetes;Basidiobolales;";"0.0";"0";"7";"6";"0";"6";"1";"457177";"373894"
"V4mis1";"SILVA (only NR);Eukaryota;Amorphea;Obazoa;Opisthokonta;Nucletmycea;Fungi;Zoopagomycota;Entomophthoromycotina;Basidiobolomycetes;Basidiobolales;Basidiobolaceae;";"0.0";"0";"7";"6";"0";"6";"1";"457177";"373894"
"V4mis1";"SILVA (only NR);Eukaryota;Amorphea;Obazoa;Opisthokonta;Nucletmycea;Fungi;Zoopagomycota;Entomophthoromycotina;Basidiobolomycetes;Basidiobolales;Basidiobolaceae;Basidiobolus;";"0.0";"0";"6";"5";"0";"5";"1";"457178";"373894"
"V4mis1";"SILVA (only NR);Eukaryota;Amorphea;Obazoa;Opisthokonta;Nucletmycea;Fungi;Zoopagomycota;Entomophthoromycotina;Basidiobolomycetes;Basidiobolales;Basidiobolaceae;Schizangiella;";"0.0";"0";"1";"1";"0";"1";"0";"457182";"373894"
"V4mis1";"SILVA (only NR);Eukaryota;Amorphea;Obazoa;Opisthokonta;Nucletmycea;Fungi;Zoopagomycota;Entomophthoromycotina;Entomophthoromycetes;";"0.0";"0";"45";"45";"0";"45";"0";"457138";"373894"
"V4mis1";"SILVA (only NR);Eukaryota;Amorphea;Obazoa;Opisthokonta;Nucletmycea;Fungi;Zoopagomycota;Entomophthoromycotina;Entomophthoromycetes;Entomophthorales;";"0.0";"0";"45";"45";"0";"45";"0";"457138";"373894"
"V4mis1";"SILVA (only NR);Eukaryota;Amorphea;Obazoa;Opisthokonta;Nucletmycea;Fungi;Zoopagomycota;Entomophthoromycotina;Entomophthoromycetes;Entomophthorales;Ancylistaceae;";"0.0";"0";"13";"13";"0";"13";"0";"457170";"373894"
"V4mis1";"SILVA (only NR);Eukaryota;Amorphea;Obazoa;Opisthokonta;Nucletmycea;Fungi;Zoopagomycota;Entomophthoromycotina;Entomophthoromycetes;Entomophthorales;Ancylistaceae;Conidiobolus;";"0.0";"0";"13";"13";"0";"13";"0";"457170";"373894"
"V4mis1";"SILVA (only NR);Eukaryota;Amorphea;Obazoa;Opisthokonta;Nucletmycea;Fungi;Zoopagomycota;Entomophthoromycotina;Entomophthoromycetes;Entomophthorales;Entomophthoraceae;";"0.0";"0";"28";"28";"0";"28";"0";"457155";"373894"
"V4mis1";"SILVA (only NR);Eukaryota;Amorphea;Obazoa;Opisthokonta;Nucletmycea;Fungi;Zoopagomycota;Entomophthoromycotina;Entomophthoromycetes;Entomophthorales;Entomophthoraceae;Entomophaga;";"0.0";"0";"1";"1";"0";"1";"0";"457182";"373894"
"V4mis1";"SILVA (only NR);Eukaryota;Amorphea;Obazoa;Opisthokonta;Nucletmycea;Fungi;Zoopagomycota;Entomophthoromycotina;Entomophthoromycetes;Entomophthorales;Entomophthoraceae;Entomophthora;";"0.0";"0";"6";"6";"0";"6";"0";"457177";"373894"
"V4mis1";"SILVA (only NR);Eukaryota;Amorphea;Obazoa;Opisthokonta;Nucletmycea;Fungi;Zoopagomycota;Entomophthoromycotina;Entomophthoromycetes;Entomophthorales;Entomophthoraceae;Erynia;";"0.0";"0";"3";"3";"0";"3";"0";"457180";"373894"
"V4mis1";"SILVA (only NR);Eukaryota;Amorphea;Obazoa;Opisthokonta;Nucletmycea;Fungi;Zoopagomycota;Entomophthoromycotina;Entomophthoromycetes;Entomophthorales;Entomophthoraceae;Eryniopsis;";"0.0";"0";"2";"2";"0";"2";"0";"457181";"373894"
"V4mis1";"SILVA (only NR);Eukaryota;Amorphea;Obazoa;Opisthokonta;Nucletmycea;Fungi;Zoopagomycota;Entomophthoromycotina;Entomophthoromycetes;Entomophthorales;Entomophthoraceae;Furia;";"0.0";"0";"3";"3";"0";"3";"0";"457180";"373894"
"V4mis1";"SILVA (only NR);Eukaryota;Amorphea;Obazoa;Opisthokonta;Nucletmycea;Fungi;Zoopagomycota;Entomophthoromycotina;Entomophthoromycetes;Entomophthorales;Entomophthoraceae;Pandora;";"0.0";"0";"5";"5";"0";"5";"0";"457178";"373894"
"V4mis1";"SILVA (only NR);Eukaryota;Amorphea;Obazoa;Opisthokonta;Nucletmycea;Fungi;Zoopagomycota;Entomophthoromycotina;Entomophthoromycetes;Entomophthorales;Entomophthoraceae;Strongwellsea;";"0.0";"0";"1";"1";"0";"1";"0";"457182";"373894"
"V4mis1";"SILVA (only NR);Eukaryota;Amorphea;Obazoa;Opisthokonta;Nucletmycea;Fungi;Zoopagomycota;Entomophthoromycotina;Entomophthoromycetes;Entomophthorales;Entomophthoraceae;Zoophthora;";"0.0";"0";"6";"6";"0";"6";"0";"457177";"373894"
"V4mis1";"SILVA (only NR);Eukaryota;Amorphea;Obazoa;Opisthokonta;Nucletmycea;Fungi;Zoopagomycota;Entomophthoromycotina;Entomophthoromycetes;Entomophthorales;uncultured;";"0.0";"0";"4";"4";"0";"4";"0";"457179";"373894"
"V4mis1";"SILVA (only NR);Eukaryota;Amorphea;Obazoa;Opisthokonta;Nucletmycea;Fungi;Zoopagomycota;Kickxellomycotina;";"0.0";"0";"127";"127";"0";"127";"0";"457056";"373894"
"V4mis1";"SILVA (only NR);Eukaryota;Amorphea;Obazoa;Opisthokonta;Nucletmycea;Fungi;Zoopagomycota;Kickxellomycotina;Incertae Sedis;";"0.0";"0";"127";"127";"0";"127";"0";"457056";"373894"
"V4mis1";"SILVA (only NR);Eukaryota;Amorphea;Obazoa;Opisthokonta;Nucletmycea;Fungi;Zoopagomycota;Kickxellomycotina;Incertae Sedis;Harpellales;";"0.0";"0";"89";"89";"0";"89";"0";"457094";"373894"
"V4mis1";"SILVA (only NR);Eukaryota;Amorphea;Obazoa;Opisthokonta;Nucletmycea;Fungi;Zoopagomycota;Kickxellomycotina;Incertae Sedis;Harpellales;Furculomyces;";"0.0";"0";"2";"2";"0";"2";"0";"457181";"373894"
"V4mis1";"SILVA (only NR);Eukaryota;Amorphea;Obazoa;Opisthokonta;Nucletmycea;Fungi;Zoopagomycota;Kickxellomycotina;Incertae Sedis;Harpellales;Harpellaceae;";"0.0";"0";"9";"9";"0";"9";"0";"457174";"373894"
"V4mis1";"SILVA (only NR);Eukaryota;Amorphea;Obazoa;Opisthokonta;Nucletmycea;Fungi;Zoopagomycota;Kickxellomycotina;Incertae Sedis;Harpellales;Harpellaceae;Harpella;";"0.0";"0";"4";"4";"0";"4";"0";"457179";"373894"
"V4mis1";"SILVA (only NR);Eukaryota;Amorphea;Obazoa;Opisthokonta;Nucletmycea;Fungi;Zoopagomycota;Kickxellomycotina;Incertae Sedis;Harpellales;Harpellaceae;Legeriomyces;";"0.0";"0";"1";"1";"0";"1";"0";"457182";"373894"
"V4mis1";"SILVA (only NR);Eukaryota;Amorphea;Obazoa;Opisthokonta;Nucletmycea;Fungi;Zoopagomycota;Kickxellomycotina;Incertae Sedis;Harpellales;Harpellaceae;Stachylina;";"0.0";"0";"1";"1";"0";"1";"0";"457182";"373894"
"V4mis1";"SILVA (only NR);Eukaryota;Amorphea;Obazoa;Opisthokonta;Nucletmycea;Fungi;Zoopagomycota;Kickxellomycotina;Incertae Sedis;Harpellales;Legeriomycetaceae;";"0.0";"0";"76";"76";"0";"76";"0";"457107";"373894"
"V4mis1";"SILVA (only NR);Eukaryota;Amorphea;Obazoa;Opisthokonta;Nucletmycea;Fungi;Zoopagomycota;Kickxellomycotina;Incertae Sedis;Harpellales;Legeriomycetaceae;Barbatospora;";"0.0";"0";"1";"1";"0";"1";"0";"457182";"373894"
"V4mis1";"SILVA (only NR);Eukaryota;Amorphea;Obazoa;Opisthokonta;Nucletmycea;Fungi;Zoopagomycota;Kickxellomycotina;Incertae Sedis;Harpellales;Legeriomycetaceae;Bojamyces;";"0.0";"0";"1";"1";"0";"1";"0";"457182";"373894"
"V4mis1";"SILVA (only NR);Eukaryota;Amorphea;Obazoa;Opisthokonta;Nucletmycea;Fungi;Zoopagomycota;Kickxellomycotina;Incertae Sedis;Harpellales;Legeriomycetaceae;Capniomyces;";"0.0";"0";"2";"2";"0";"2";"0";"457181";"373894"
"V4mis1";"SILVA (only NR);Eukaryota;Amorphea;Obazoa;Opisthokonta;Nucletmycea;Fungi;Zoopagomycota;Kickxellomycotina;Incertae Sedis;Harpellales;Legeriomycetaceae;Coleopteromyces;";"0.0";"0";"1";"1";"0";"1";"0";"457182";"373894"
"V4mis1";"SILVA (only NR);Eukaryota;Amorphea;Obazoa;Opisthokonta;Nucletmycea;Fungi;Zoopagomycota;Kickxellomycotina;Incertae Sedis;Harpellales;Legeriomycetaceae;Genistelloides;";"0.0";"0";"5";"5";"0";"5";"0";"457178";"373894"
"V4mis1";"SILVA (only NR);Eukaryota;Amorphea;Obazoa;Opisthokonta;Nucletmycea;Fungi;Zoopagomycota;Kickxellomycotina;Incertae Sedis;Harpellales;Legeriomycetaceae;Genistellospora;";"0.0";"0";"1";"1";"0";"1";"0";"457182";"373894"
"V4mis1";"SILVA (only NR);Eukaryota;Amorphea;Obazoa;Opisthokonta;Nucletmycea;Fungi;Zoopagomycota;Kickxellomycotina;Incertae Sedis;Harpellales;Legeriomycetaceae;Graminella;";"0.0";"0";"1";"1";"0";"1";"0";"457182";"373894"
"V4mis1";"SILVA (only NR);Eukaryota;Amorphea;Obazoa;Opisthokonta;Nucletmycea;Fungi;Zoopagomycota;Kickxellomycotina;Incertae Sedis;Harpellales;Legeriomycetaceae;Lancisporomyces;";"0.0";"0";"2";"2";"0";"2";"0";"457181";"373894"
"V4mis1";"SILVA (only NR);Eukaryota;Amorphea;Obazoa;Opisthokonta;Nucletmycea;Fungi;Zoopagomycota;Kickxellomycotina;Incertae Sedis;Harpellales;Legeriomycetaceae;Legerioides;";"0.0";"0";"1";"1";"0";"1";"0";"457182";"373894"
"V4mis1";"SILVA (only NR);Eukaryota;Amorphea;Obazoa;Opisthokonta;Nucletmycea;Fungi;Zoopagomycota;Kickxellomycotina;Incertae Sedis;Harpellales;Legeriomycetaceae;Orphella;";"0.0";"0";"5";"5";"0";"5";"0";"457178";"373894"
"V4mis1";"SILVA (only NR);Eukaryota;Amorphea;Obazoa;Opisthokonta;Nucletmycea;Fungi;Zoopagomycota;Kickxellomycotina;Incertae Sedis;Harpellales;Legeriomycetaceae;Pennella;";"0.0";"0";"1";"1";"0";"1";"0";"457182";"373894"
"V4mis1";"SILVA (only NR);Eukaryota;Amorphea;Obazoa;Opisthokonta;Nucletmycea;Fungi;Zoopagomycota;Kickxellomycotina;Incertae Sedis;Harpellales;Legeriomycetaceae;Plecopteromyces;";"0.0";"0";"3";"3";"0";"3";"0";"457180";"373894"
"V4mis1";"SILVA (only NR);Eukaryota;Amorphea;Obazoa;Opisthokonta;Nucletmycea;Fungi;Zoopagomycota;Kickxellomycotina;Incertae Sedis;Harpellales;Legeriomycetaceae;Pteromaktron;";"0.0";"0";"1";"1";"0";"1";"0";"457182";"373894"
"V4mis1";"SILVA (only NR);Eukaryota;Amorphea;Obazoa;Opisthokonta;Nucletmycea;Fungi;Zoopagomycota;Kickxellomycotina;Incertae Sedis;Harpellales;Legeriomycetaceae;Smittium;";"0.0";"0";"39";"39";"0";"39";"0";"457144";"373894"
"V4mis1";"SILVA (only NR);Eukaryota;Amorphea;Obazoa;Opisthokonta;Nucletmycea;Fungi;Zoopagomycota;Kickxellomycotina;Incertae Sedis;Harpellales;Legeriomycetaceae;Spartiella;";"0.0";"0";"1";"1";"0";"1";"0";"457182";"373894"
"V4mis1";"SILVA (only NR);Eukaryota;Amorphea;Obazoa;Opisthokonta;Nucletmycea;Fungi;Zoopagomycota;Kickxellomycotina;Incertae Sedis;Harpellales;Legeriomycetaceae;Zancudomyces;";"0.0";"0";"3";"3";"0";"3";"0";"457180";"373894"
"V4mis1";"SILVA (only NR);Eukaryota;Amorphea;Obazoa;Opisthokonta;Nucletmycea;Fungi;Zoopagomycota;Kickxellomycotina;Incertae Sedis;Harpellales;Legeriomycetaceae;Zygopolaris;";"0.0";"0";"1";"1";"0";"1";"0";"457182";"373894"
"V4mis1";"SILVA (only NR);Eukaryota;Amorphea;Obazoa;Opisthokonta;Nucletmycea;Fungi;Zoopagomycota;Kickxellomycotina;Incertae Sedis;Harpellales;Pseudoharpella;";"0.0";"0";"1";"1";"0";"1";"0";"457182";"373894"
"V4mis1";"SILVA (only NR);Eukaryota;Amorphea;Obazoa;Opisthokonta;Nucletmycea;Fungi;Zoopagomycota;Kickxellomycotina;Incertae Sedis;Kickxellales;";"0.0";"0";"34";"34";"0";"34";"0";"457149";"373894"
"V4mis1";"SILVA (only NR);Eukaryota;Amorphea;Obazoa;Opisthokonta;Nucletmycea;Fungi;Zoopagomycota;Kickxellomycotina;Incertae Sedis;Kickxellales;Kickxellaceae;";"0.0";"0";"34";"34";"0";"34";"0";"457149";"373894"
"V4mis1";"SILVA (only NR);Eukaryota;Amorphea;Obazoa;Opisthokonta;Nucletmycea;Fungi;Zoopagomycota;Kickxellomycotina;Incertae Sedis;Kickxellales;Kickxellaceae;Coemansia;";"0.0";"0";"16";"16";"0";"16";"0";"457167";"373894"
"V4mis1";"SILVA (only NR);Eukaryota;Amorphea;Obazoa;Opisthokonta;Nucletmycea;Fungi;Zoopagomycota;Kickxellomycotina;Incertae Sedis;Kickxellales;Kickxellaceae;Dipsacomyces;";"0.0";"0";"1";"1";"0";"1";"0";"457182";"373894"
"V4mis1";"SILVA (only NR);Eukaryota;Amorphea;Obazoa;Opisthokonta;Nucletmycea;Fungi;Zoopagomycota;Kickxellomycotina;Incertae Sedis;Kickxellales;Kickxellaceae;Kickxella;";"0.0";"0";"1";"1";"0";"1";"0";"457182";"373894"
"V4mis1";"SILVA (only NR);Eukaryota;Amorphea;Obazoa;Opisthokonta;Nucletmycea;Fungi;Zoopagomycota;Kickxellomycotina;Incertae Sedis;Kickxellales;Kickxellaceae;Linderina;";"0.0";"0";"4";"4";"0";"4";"0";"457179";"373894"
"V4mis1";"SILVA (only NR);Eukaryota;Amorphea;Obazoa;Opisthokonta;Nucletmycea;Fungi;Zoopagomycota;Kickxellomycotina;Incertae Sedis;Kickxellales;Kickxellaceae;Martensiomyces;";"0.0";"0";"1";"1";"0";"1";"0";"457182";"373894"
"V4mis1";"SILVA (only NR);Eukaryota;Amorphea;Obazoa;Opisthokonta;Nucletmycea;Fungi;Zoopagomycota;Kickxellomycotina;Incertae Sedis;Kickxellales;Kickxellaceae;Mycoemilia;";"0.0";"0";"1";"1";"0";"1";"0";"457182";"373894"
"V4mis1";"SILVA (only NR);Eukaryota;Amorphea;Obazoa;Opisthokonta;Nucletmycea;Fungi;Zoopagomycota;Kickxellomycotina;Incertae Sedis;Kickxellales;Kickxellaceae;Myconymphaea;";"0.0";"0";"1";"1";"0";"1";"0";"457182";"373894"
"V4mis1";"SILVA (only NR);Eukaryota;Amorphea;Obazoa;Opisthokonta;Nucletmycea;Fungi;Zoopagomycota;Kickxellomycotina;Incertae Sedis;Kickxellales;Kickxellaceae;Pinnaticoemansia;";"0.0";"0";"1";"1";"0";"1";"0";"457182";"373894"
"V4mis1";"SILVA (only NR);Eukaryota;Amorphea;Obazoa;Opisthokonta;Nucletmycea;Fungi;Zoopagomycota;Kickxellomycotina;Incertae Sedis;Kickxellales;Kickxellaceae;Ramicandelaber;";"0.0";"0";"4";"4";"0";"4";"0";"457179";"373894"
"V4mis1";"SILVA (only NR);Eukaryota;Amorphea;Obazoa;Opisthokonta;Nucletmycea;Fungi;Zoopagomycota;Kickxellomycotina;Incertae Sedis;Kickxellales;Kickxellaceae;Spirodactylon;";"0.0";"0";"1";"1";"0";"1";"0";"457182";"373894"
"V4mis1";"SILVA (only NR);Eukaryota;Amorphea;Obazoa;Opisthokonta;Nucletmycea;Fungi;Zoopagomycota;Kickxellomycotina;Incertae Sedis;Kickxellales;Kickxellaceae;Spiromyces;";"0.0";"0";"2";"2";"0";"2";"0";"457181";"373894"
"V4mis1";"SILVA (only NR);Eukaryota;Amorphea;Obazoa;Opisthokonta;Nucletmycea;Fungi;Zoopagomycota;Zoopagomycotina;";"0.0";"0";"29";"28";"0";"28";"1";"457155";"373894"
"V4mis1";"SILVA (only NR);Eukaryota;Amorphea;Obazoa;Opisthokonta;Nucletmycea;Fungi;Zoopagomycota;Zoopagomycotina;Incertae Sedis;";"0.0";"0";"29";"28";"0";"28";"1";"457155";"373894"
"V4mis1";"SILVA (only NR);Eukaryota;Amorphea;Obazoa;Opisthokonta;Nucletmycea;Fungi;Zoopagomycota;Zoopagomycotina;Incertae Sedis;Zoopagales;";"0.0";"0";"29";"28";"0";"28";"1";"457155";"373894"
"V4mis1";"SILVA (only NR);Eukaryota;Amorphea;Obazoa;Opisthokonta;Nucletmycea;Fungi;Zoopagomycota;Zoopagomycotina;Incertae Sedis;Zoopagales;Acaulopage;";"0.0";"0";"3";"3";"0";"3";"0";"457180";"373894"
"V4mis1";"SILVA (only NR);Eukaryota;Amorphea;Obazoa;Opisthokonta;Nucletmycea;Fungi;Zoopagomycota;Zoopagomycotina;Incertae Sedis;Zoopagales;Cochlonema;";"0.0";"0";"1";"1";"0";"1";"0";"457182";"373894"
"V4mis1";"SILVA (only NR);Eukaryota;Amorphea;Obazoa;Opisthokonta;Nucletmycea;Fungi;Zoopagomycota;Zoopagomycotina;Incertae Sedis;Zoopagales;Kuzuhaea;";"0.0";"0";"1";"1";"0";"1";"0";"457182";"373894"
"V4mis1";"SILVA (only NR);Eukaryota;Amorphea;Obazoa;Opisthokonta;Nucletmycea;Fungi;Zoopagomycota;Zoopagomycotina;Incertae Sedis;Zoopagales;Piptocephalidaceae;";"0.0";"0";"6";"6";"0";"6";"0";"457177";"373894"
"V4mis1";"SILVA (only NR);Eukaryota;Amorphea;Obazoa;Opisthokonta;Nucletmycea;Fungi;Zoopagomycota;Zoopagomycotina;Incertae Sedis;Zoopagales;Piptocephalidaceae;Piptocephalis;";"0.0";"0";"6";"6";"0";"6";"0";"457177";"373894"
"V4mis1";"SILVA (only NR);Eukaryota;Amorphea;Obazoa;Opisthokonta;Nucletmycea;Fungi;Zoopagomycota;Zoopagomycotina;Incertae Sedis;Zoopagales;Rhopalomyces;";"0.0";"0";"1";"1";"0";"1";"0";"457182";"373894"
"V4mis1";"SILVA (only NR);Eukaryota;Amorphea;Obazoa;Opisthokonta;Nucletmycea;Fungi;Zoopagomycota;Zoopagomycotina;Incertae Sedis;Zoopagales;Sigmoideomycetaceae;";"0.0";"0";"1";"1";"0";"1";"0";"457182";"373894"
"V4mis1";"SILVA (only NR);Eukaryota;Amorphea;Obazoa;Opisthokonta;Nucletmycea;Fungi;Zoopagomycota;Zoopagomycotina;Incertae Sedis;Zoopagales;Sigmoideomycetaceae;Thamnocephalis;";"0.0";"0";"1";"1";"0";"1";"0";"457182";"373894"
"V4mis1";"SILVA (only NR);Eukaryota;Amorphea;Obazoa;Opisthokonta;Nucletmycea;Fungi;Zoopagomycota;Zoopagomycotina;Incertae Sedis;Zoopagales;Stylopage;";"0.0";"0";"1";"1";"0";"1";"0";"457182";"373894"
"V4mis1";"SILVA (only NR);Eukaryota;Amorphea;Obazoa;Opisthokonta;Nucletmycea;Fungi;Zoopagomycota;Zoopagomycotina;Incertae Sedis;Zoopagales;Syncephalis;";"0.0";"0";"1";"1";"0";"1";"0";"457182";"373894"
"V4mis1";"SILVA (only NR);Eukaryota;Amorphea;Obazoa;Opisthokonta;Nucletmycea;Fungi;Zoopagomycota;Zoopagomycotina;Incertae Sedis;Zoopagales;Zoophagus;";"0.0";"0";"1";"1";"0";"1";"0";"457182";"373894"
"V4mis1";"SILVA (only NR);Eukaryota;Amorphea;Obazoa;Opisthokonta;Nucletmycea;Fungi;uncultured;";"0.0";"0";"27";"26";"0";"26";"1";"457157";"373894"
"V4mis1";"SILVA (only NR);Eukaryota;Amorphea;Obazoa;Opisthokonta;Nucletmycea;Nucleariidae and Fonticula group;";"0.0";"0";"29";"28";"0";"28";"1";"457155";"373894"
"V4mis1";"SILVA (only NR);Eukaryota;Amorphea;Obazoa;Opisthokonta;Nucletmycea;Nucleariidae and Fonticula group;Fonticula;";"0.0";"0";"1";"1";"0";"1";"0";"457182";"373894"
"V4mis1";"SILVA (only NR);Eukaryota;Amorphea;Obazoa;Opisthokonta;Nucletmycea;Nucleariidae and Fonticula group;Nucleariidae;";"0.0";"0";"28";"27";"0";"27";"1";"457156";"373894"
"V4mis1";"SILVA (only NR);Eukaryota;Amorphea;Obazoa;Opisthokonta;Nucletmycea;Nucleariidae and Fonticula group;Nucleariidae;Nuclearia;";"0.0";"0";"28";"27";"0";"27";"1";"457156";"373894"
"V4mis1";"SILVA (only NR);Eukaryota;Archaeplastida;";"0.6";"16.9";"7535";"7476";"44";"7432";"59";"449707";"373850"
"V4mis1";"SILVA (only NR);Eukaryota;Archaeplastida;Chloroplastida;";"0.7";"17";"6646";"6591";"44";"6547";"55";"450592";"373850"
"V4mis1";"SILVA (only NR);Eukaryota;Archaeplastida;Chloroplastida;Charophyta;";"0.8";"17.4";"4738";"4717";"40";"4677";"21";"452466";"373854"
"V4mis1";"SILVA (only NR);Eukaryota;Archaeplastida;Chloroplastida;Charophyta;Amb-18S-504;";"0.0";"0";"7";"7";"0";"7";"0";"457176";"373894"
"V4mis1";"SILVA (only NR);Eukaryota;Archaeplastida;Chloroplastida;Charophyta;Chlorokybophyceae;";"0.0";"0";"1";"1";"0";"1";"0";"457182";"373894"
"V4mis1";"SILVA (only NR);Eukaryota;Archaeplastida;Chloroplastida;Charophyta;Chlorokybophyceae;Chlorokybus;";"0.0";"0";"1";"1";"0";"1";"0";"457182";"373894"
"V4mis1";"SILVA (only NR);Eukaryota;Archaeplastida;Chloroplastida;Charophyta;Klebsormidiophyceae;";"0.0";"0";"8";"8";"0";"8";"0";"457175";"373894"
"V4mis1";"SILVA (only NR);Eukaryota;Archaeplastida;Chloroplastida;Charophyta;Klebsormidiophyceae;Klebsormidiales;";"0.0";"0";"5";"5";"0";"5";"0";"457178";"373894"
"V4mis1";"SILVA (only NR);Eukaryota;Archaeplastida;Chloroplastida;Charophyta;Klebsormidiophyceae;Klebsormidiales;Entransia;";"0.0";"0";"1";"1";"0";"1";"0";"457182";"373894"
"V4mis1";"SILVA (only NR);Eukaryota;Archaeplastida;Chloroplastida;Charophyta;Klebsormidiophyceae;Klebsormidiales;Hormidiella;";"0.0";"0";"1";"1";"0";"1";"0";"457182";"373894"
"V4mis1";"SILVA (only NR);Eukaryota;Archaeplastida;Chloroplastida;Charophyta;Klebsormidiophyceae;Klebsormidiales;Klebsormidium;";"0.0";"0";"3";"3";"0";"3";"0";"457180";"373894"
"V4mis1";"SILVA (only NR);Eukaryota;Archaeplastida;Chloroplastida;Charophyta;Mesostigmatophyceae;";"0.0";"0";"1";"1";"0";"1";"0";"457182";"373894"
"V4mis1";"SILVA (only NR);Eukaryota;Archaeplastida;Chloroplastida;Charophyta;Mesostigmatophyceae;Mesostigma;";"0.0";"0";"1";"1";"0";"1";"0";"457182";"373894"
"V4mis1";"SILVA (only NR);Eukaryota;Archaeplastida;Chloroplastida;Charophyta;Phragmoplastophyta;";"0.9";"17.4";"4720";"4699";"40";"4659";"21";"452484";"373854"
"V4mis1";"SILVA (only NR);Eukaryota;Archaeplastida;Chloroplastida;Charophyta;Phragmoplastophyta;Coleochaetophyceae;";"0.0";"0";"12";"12";"0";"12";"0";"457171";"373894"
"V4mis1";"SILVA (only NR);Eukaryota;Archaeplastida;Chloroplastida;Charophyta;Phragmoplastophyta;Coleochaetophyceae;Chaetosphaeridiales;";"0.0";"0";"6";"6";"0";"6";"0";"457177";"373894"
"V4mis1";"SILVA (only NR);Eukaryota;Archaeplastida;Chloroplastida;Charophyta;Phragmoplastophyta;Coleochaetophyceae;Chaetosphaeridiales;Chaetosphaeridium;";"0.0";"0";"6";"6";"0";"6";"0";"457177";"373894"
"V4mis1";"SILVA (only NR);Eukaryota;Archaeplastida;Chloroplastida;Charophyta;Phragmoplastophyta;Coleochaetophyceae;Coleochaete;";"0.0";"0";"6";"6";"0";"6";"0";"457177";"373894"
"V4mis1";"SILVA (only NR);Eukaryota;Archaeplastida;Chloroplastida;Charophyta;Phragmoplastophyta;Streptophyta;";"0.9";"17.4";"4538";"4517";"40";"4477";"21";"452666";"373854"
"V4mis1";"SILVA (only NR);Eukaryota;Archaeplastida;Chloroplastida;Charophyta;Phragmoplastophyta;Streptophyta;Charophyceae;";"0.0";"0";"36";"36";"0";"36";"0";"457147";"373894"
"V4mis1";"SILVA (only NR);Eukaryota;Archaeplastida;Chloroplastida;Charophyta;Phragmoplastophyta;Streptophyta;Charophyceae;Charales;";"0.0";"0";"36";"36";"0";"36";"0";"457147";"373894"
"V4mis1";"SILVA (only NR);Eukaryota;Archaeplastida;Chloroplastida;Charophyta;Phragmoplastophyta;Streptophyta;Charophyceae;Charales;Chara;";"0.0";"0";"28";"28";"0";"28";"0";"457155";"373894"
"V4mis1";"SILVA (only NR);Eukaryota;Archaeplastida;Chloroplastida;Charophyta;Phragmoplastophyta;Streptophyta;Charophyceae;Charales;Lychnothamnus;";"0.0";"0";"1";"1";"0";"1";"0";"457182";"373894"
"V4mis1";"SILVA (only NR);Eukaryota;Archaeplastida;Chloroplastida;Charophyta;Phragmoplastophyta;Streptophyta;Charophyceae;Charales;Nitellaceae;";"0.0";"0";"6";"6";"0";"6";"0";"457177";"373894"
"V4mis1";"SILVA (only NR);Eukaryota;Archaeplastida;Chloroplastida;Charophyta;Phragmoplastophyta;Streptophyta;Charophyceae;Charales;Nitellaceae;Nitella;";"0.0";"0";"4";"4";"0";"4";"0";"457179";"373894"
"V4mis1";"SILVA (only NR);Eukaryota;Archaeplastida;Chloroplastida;Charophyta;Phragmoplastophyta;Streptophyta;Charophyceae;Charales;Nitellaceae;Tolypella;";"0.0";"0";"2";"2";"0";"2";"0";"457181";"373894"
"V4mis1";"SILVA (only NR);Eukaryota;Archaeplastida;Chloroplastida;Charophyta;Phragmoplastophyta;Streptophyta;Charophyceae;Charales;Nitellopsis;";"0.0";"0";"1";"1";"0";"1";"0";"457182";"373894"
"V4mis1";"SILVA (only NR);Eukaryota;Archaeplastida;Chloroplastida;Charophyta;Phragmoplastophyta;Streptophyta;Embryophyta;";"0.9";"17.4";"4502";"4481";"40";"4441";"21";"452702";"373854"
"V4mis1";"SILVA (only NR);Eukaryota;Archaeplastida;Chloroplastida;Charophyta;Phragmoplastophyta;Streptophyta;Embryophyta;Anthocerotophyta;";"0.0";"0";"13";"13";"0";"13";"0";"457170";"373894"
"V4mis1";"SILVA (only NR);Eukaryota;Archaeplastida;Chloroplastida;Charophyta;Phragmoplastophyta;Streptophyta;Embryophyta;Anthocerotophyta;Anthocerotales;";"0.0";"0";"2";"2";"0";"2";"0";"457181";"373894"
"V4mis1";"SILVA (only NR);Eukaryota;Archaeplastida;Chloroplastida;Charophyta;Phragmoplastophyta;Streptophyta;Embryophyta;Anthocerotophyta;Anthocerotales;Anthoceros;";"0.0";"0";"1";"1";"0";"1";"0";"457182";"373894"
"V4mis1";"SILVA (only NR);Eukaryota;Archaeplastida;Chloroplastida;Charophyta;Phragmoplastophyta;Streptophyta;Embryophyta;Anthocerotophyta;Anthocerotales;Folioceros;";"0.0";"0";"1";"1";"0";"1";"0";"457182";"373894"
"V4mis1";"SILVA (only NR);Eukaryota;Archaeplastida;Chloroplastida;Charophyta;Phragmoplastophyta;Streptophyta;Embryophyta;Anthocerotophyta;Dendrocerotales;";"0.0";"0";"7";"7";"0";"7";"0";"457176";"373894"
"V4mis1";"SILVA (only NR);Eukaryota;Archaeplastida;Chloroplastida;Charophyta;Phragmoplastophyta;Streptophyta;Embryophyta;Anthocerotophyta;Dendrocerotales;Megaceros;";"0.0";"0";"2";"2";"0";"2";"0";"457181";"373894"
"V4mis1";"SILVA (only NR);Eukaryota;Archaeplastida;Chloroplastida;Charophyta;Phragmoplastophyta;Streptophyta;Embryophyta;Anthocerotophyta;Dendrocerotales;Nothoceros;";"0.0";"0";"3";"3";"0";"3";"0";"457180";"373894"
"V4mis1";"SILVA (only NR);Eukaryota;Archaeplastida;Chloroplastida;Charophyta;Phragmoplastophyta;Streptophyta;Embryophyta;Anthocerotophyta;Dendrocerotales;Phaeomegaceros;";"0.0";"0";"2";"2";"0";"2";"0";"457181";"373894"
"V4mis1";"SILVA (only NR);Eukaryota;Archaeplastida;Chloroplastida;Charophyta;Phragmoplastophyta;Streptophyta;Embryophyta;Anthocerotophyta;Notothyladales;";"0.0";"0";"3";"3";"0";"3";"0";"457180";"373894"
"V4mis1";"SILVA (only NR);Eukaryota;Archaeplastida;Chloroplastida;Charophyta;Phragmoplastophyta;Streptophyta;Embryophyta;Anthocerotophyta;Notothyladales;Notothylas;";"0.0";"0";"1";"1";"0";"1";"0";"457182";"373894"
"V4mis1";"SILVA (only NR);Eukaryota;Archaeplastida;Chloroplastida;Charophyta;Phragmoplastophyta;Streptophyta;Embryophyta;Anthocerotophyta;Notothyladales;Phaeoceros;";"0.0";"0";"2";"2";"0";"2";"0";"457181";"373894"
"V4mis1";"SILVA (only NR);Eukaryota;Archaeplastida;Chloroplastida;Charophyta;Phragmoplastophyta;Streptophyta;Embryophyta;Anthocerotophyta;Phymatocerotales;";"0.0";"0";"1";"1";"0";"1";"0";"457182";"373894"
"V4mis1";"SILVA (only NR);Eukaryota;Archaeplastida;Chloroplastida;Charophyta;Phragmoplastophyta;Streptophyta;Embryophyta;Anthocerotophyta;Phymatocerotales;Phymatoceros;";"0.0";"0";"1";"1";"0";"1";"0";"457182";"373894"
"V4mis1";"SILVA (only NR);Eukaryota;Archaeplastida;Chloroplastida;Charophyta;Phragmoplastophyta;Streptophyta;Embryophyta;Bryophyta;";"0.0";"0";"93";"93";"0";"93";"0";"457090";"373894"
"V4mis1";"SILVA (only NR);Eukaryota;Archaeplastida;Chloroplastida;Charophyta;Phragmoplastophyta;Streptophyta;Embryophyta;Bryophyta;Andreaeales;";"0.0";"0";"2";"2";"0";"2";"0";"457181";"373894"
"V4mis1";"SILVA (only NR);Eukaryota;Archaeplastida;Chloroplastida;Charophyta;Phragmoplastophyta;Streptophyta;Embryophyta;Bryophyta;Andreaeales;Andreaeaceae;";"0.0";"0";"2";"2";"0";"2";"0";"457181";"373894"
"V4mis1";"SILVA (only NR);Eukaryota;Archaeplastida;Chloroplastida;Charophyta;Phragmoplastophyta;Streptophyta;Embryophyta;Bryophyta;Andreaeales;Andreaeaceae;Andreaea;";"0.0";"0";"2";"2";"0";"2";"0";"457181";"373894"
"V4mis1";"SILVA (only NR);Eukaryota;Archaeplastida;Chloroplastida;Charophyta;Phragmoplastophyta;Streptophyta;Embryophyta;Bryophyta;Bryales;";"0.0";"0";"13";"13";"0";"13";"0";"457170";"373894"
"V4mis1";"SILVA (only NR);Eukaryota;Archaeplastida;Chloroplastida;Charophyta;Phragmoplastophyta;Streptophyta;Embryophyta;Bryophyta;Bryales;Bryum;";"0.0";"0";"1";"1";"0";"1";"0";"457182";"373894"
"V4mis1";"SILVA (only NR);Eukaryota;Archaeplastida;Chloroplastida;Charophyta;Phragmoplastophyta;Streptophyta;Embryophyta;Bryophyta;Bryales;Cinclidium;";"0.0";"0";"1";"1";"0";"1";"0";"457182";"373894"
"V4mis1";"SILVA (only NR);Eukaryota;Archaeplastida;Chloroplastida;Charophyta;Phragmoplastophyta;Streptophyta;Embryophyta;Bryophyta;Bryales;Leptostomum;";"0.0";"0";"1";"1";"0";"1";"0";"457182";"373894"
"V4mis1";"SILVA (only NR);Eukaryota;Archaeplastida;Chloroplastida;Charophyta;Phragmoplastophyta;Streptophyta;Embryophyta;Bryophyta;Bryales;Leucolepis;";"0.0";"0";"1";"1";"0";"1";"0";"457182";"373894"
"V4mis1";"SILVA (only NR);Eukaryota;Archaeplastida;Chloroplastida;Charophyta;Phragmoplastophyta;Streptophyta;Embryophyta;Bryophyta;Bryales;Mielichhoferia;";"0.0";"0";"1";"1";"0";"1";"0";"457182";"373894"
"V4mis1";"SILVA (only NR);Eukaryota;Archaeplastida;Chloroplastida;Charophyta;Phragmoplastophyta;Streptophyta;Embryophyta;Bryophyta;Bryales;Mnium;";"0.0";"0";"1";"1";"0";"1";"0";"457182";"373894"
"V4mis1";"SILVA (only NR);Eukaryota;Archaeplastida;Chloroplastida;Charophyta;Phragmoplastophyta;Streptophyta;Embryophyta;Bryophyta;Bryales;Plagiobryoides;";"0.0";"0";"1";"1";"0";"1";"0";"457182";"373894"
"V4mis1";"SILVA (only NR);Eukaryota;Archaeplastida;Chloroplastida;Charophyta;Phragmoplastophyta;Streptophyta;Embryophyta;Bryophyta;Bryales;Plagiomnium;";"0.0";"0";"1";"1";"0";"1";"0";"457182";"373894"
"V4mis1";"SILVA (only NR);Eukaryota;Archaeplastida;Chloroplastida;Charophyta;Phragmoplastophyta;Streptophyta;Embryophyta;Bryophyta;Bryales;Pohlia;";"0.0";"0";"2";"2";"0";"2";"0";"457181";"373894"
"V4mis1";"SILVA (only NR);Eukaryota;Archaeplastida;Chloroplastida;Charophyta;Phragmoplastophyta;Streptophyta;Embryophyta;Bryophyta;Bryales;Rosulabryum;";"0.0";"0";"1";"1";"0";"1";"0";"457182";"373894"
"V4mis1";"SILVA (only NR);Eukaryota;Archaeplastida;Chloroplastida;Charophyta;Phragmoplastophyta;Streptophyta;Embryophyta;Bryophyta;Bryales;Scouleria;";"0.0";"0";"1";"1";"0";"1";"0";"457182";"373894"
"V4mis1";"SILVA (only NR);Eukaryota;Archaeplastida;Chloroplastida;Charophyta;Phragmoplastophyta;Streptophyta;Embryophyta;Bryophyta;Bryoxiphiales;";"0.0";"0";"1";"1";"0";"1";"0";"457182";"373894"
"V4mis1";"SILVA (only NR);Eukaryota;Archaeplastida;Chloroplastida;Charophyta;Phragmoplastophyta;Streptophyta;Embryophyta;Bryophyta;Bryoxiphiales;Bryoxiphium;";"0.0";"0";"1";"1";"0";"1";"0";"457182";"373894"
"V4mis1";"SILVA (only NR);Eukaryota;Archaeplastida;Chloroplastida;Charophyta;Phragmoplastophyta;Streptophyta;Embryophyta;Bryophyta;Dicranales;";"0.0";"0";"7";"7";"0";"7";"0";"457176";"373894"
"V4mis1";"SILVA (only NR);Eukaryota;Archaeplastida;Chloroplastida;Charophyta;Phragmoplastophyta;Streptophyta;Embryophyta;Bryophyta;Dicranales;Archidium;";"0.0";"0";"1";"1";"0";"1";"0";"457182";"373894"
"V4mis1";"SILVA (only NR);Eukaryota;Archaeplastida;Chloroplastida;Charophyta;Phragmoplastophyta;Streptophyta;Embryophyta;Bryophyta;Dicranales;Calymperes;";"0.0";"0";"1";"1";"0";"1";"0";"457182";"373894"
"V4mis1";"SILVA (only NR);Eukaryota;Archaeplastida;Chloroplastida;Charophyta;Phragmoplastophyta;Streptophyta;Embryophyta;Bryophyta;Dicranales;Fissidens;";"0.0";"0";"2";"2";"0";"2";"0";"457181";"373894"
"V4mis1";"SILVA (only NR);Eukaryota;Archaeplastida;Chloroplastida;Charophyta;Phragmoplastophyta;Streptophyta;Embryophyta;Bryophyta;Dicranales;Leucobryum;";"0.0";"0";"1";"1";"0";"1";"0";"457182";"373894"
"V4mis1";"SILVA (only NR);Eukaryota;Archaeplastida;Chloroplastida;Charophyta;Phragmoplastophyta;Streptophyta;Embryophyta;Bryophyta;Dicranales;Micromitrium;";"0.0";"0";"1";"1";"0";"1";"0";"457182";"373894"
"V4mis1";"SILVA (only NR);Eukaryota;Archaeplastida;Chloroplastida;Charophyta;Phragmoplastophyta;Streptophyta;Embryophyta;Bryophyta;Dicranales;Syrrhopodon;";"0.0";"0";"1";"1";"0";"1";"0";"457182";"373894"
"V4mis1";"SILVA (only NR);Eukaryota;Archaeplastida;Chloroplastida;Charophyta;Phragmoplastophyta;Streptophyta;Embryophyta;Bryophyta;Diphysciales;";"0.0";"0";"1";"1";"0";"1";"0";"457182";"373894"
"V4mis1";"SILVA (only NR);Eukaryota;Archaeplastida;Chloroplastida;Charophyta;Phragmoplastophyta;Streptophyta;Embryophyta;Bryophyta;Diphysciales;Theriotia;";"0.0";"0";"1";"1";"0";"1";"0";"457182";"373894"
"V4mis1";"SILVA (only NR);Eukaryota;Archaeplastida;Chloroplastida;Charophyta;Phragmoplastophyta;Streptophyta;Embryophyta;Bryophyta;Encalyptales;";"0.0";"0";"5";"5";"0";"5";"0";"457178";"373894"
"V4mis1";"SILVA (only NR);Eukaryota;Archaeplastida;Chloroplastida;Charophyta;Phragmoplastophyta;Streptophyta;Embryophyta;Bryophyta;Encalyptales;Bryobrittonia;";"0.0";"0";"1";"1";"0";"1";"0";"457182";"373894"
"V4mis1";"SILVA (only NR);Eukaryota;Archaeplastida;Chloroplastida;Charophyta;Phragmoplastophyta;Streptophyta;Embryophyta;Bryophyta;Encalyptales;Encalyptaceae;";"0.0";"0";"4";"4";"0";"4";"0";"457179";"373894"
"V4mis1";"SILVA (only NR);Eukaryota;Archaeplastida;Chloroplastida;Charophyta;Phragmoplastophyta;Streptophyta;Embryophyta;Bryophyta;Encalyptales;Encalyptaceae;Encalypta;";"0.0";"0";"4";"4";"0";"4";"0";"457179";"373894"
"V4mis1";"SILVA (only NR);Eukaryota;Archaeplastida;Chloroplastida;Charophyta;Phragmoplastophyta;Streptophyta;Embryophyta;Bryophyta;Eurhynchium;";"0.0";"0";"1";"1";"0";"1";"0";"457182";"373894"
"V4mis1";"SILVA (only NR);Eukaryota;Archaeplastida;Chloroplastida;Charophyta;Phragmoplastophyta;Streptophyta;Embryophyta;Bryophyta;Funariales;";"0.0";"0";"5";"5";"0";"5";"0";"457178";"373894"
"V4mis1";"SILVA (only NR);Eukaryota;Archaeplastida;Chloroplastida;Charophyta;Phragmoplastophyta;Streptophyta;Embryophyta;Bryophyta;Funariales;Aphanorrhegma;";"0.0";"0";"1";"1";"0";"1";"0";"457182";"373894"
"V4mis1";"SILVA (only NR);Eukaryota;Archaeplastida;Chloroplastida;Charophyta;Phragmoplastophyta;Streptophyta;Embryophyta;Bryophyta;Funariales;Chamaebryum;";"0.0";"0";"1";"1";"0";"1";"0";"457182";"373894"
"V4mis1";"SILVA (only NR);Eukaryota;Archaeplastida;Chloroplastida;Charophyta;Phragmoplastophyta;Streptophyta;Embryophyta;Bryophyta;Funariales;Physcomitrella;";"0.0";"0";"2";"2";"0";"2";"0";"457181";"373894"
"V4mis1";"SILVA (only NR);Eukaryota;Archaeplastida;Chloroplastida;Charophyta;Phragmoplastophyta;Streptophyta;Embryophyta;Bryophyta;Funariales;Physcomitrium;";"0.0";"0";"1";"1";"0";"1";"0";"457182";"373894"
"V4mis1";"SILVA (only NR);Eukaryota;Archaeplastida;Chloroplastida;Charophyta;Phragmoplastophyta;Streptophyta;Embryophyta;Bryophyta;Gigaspermum;";"0.0";"0";"1";"1";"0";"1";"0";"457182";"373894"
"V4mis1";"SILVA (only NR);Eukaryota;Archaeplastida;Chloroplastida;Charophyta;Phragmoplastophyta;Streptophyta;Embryophyta;Bryophyta;Grimmiales;";"0.0";"0";"5";"5";"0";"5";"0";"457178";"373894"
"V4mis1";"SILVA (only NR);Eukaryota;Archaeplastida;Chloroplastida;Charophyta;Phragmoplastophyta;Streptophyta;Embryophyta;Bryophyta;Grimmiales;Drummondia;";"0.0";"0";"1";"1";"0";"1";"0";"457182";"373894"
"V4mis1";"SILVA (only NR);Eukaryota;Archaeplastida;Chloroplastida;Charophyta;Phragmoplastophyta;Streptophyta;Embryophyta;Bryophyta;Grimmiales;Grimmia;";"0.0";"0";"1";"1";"0";"1";"0";"457182";"373894"
"V4mis1";"SILVA (only NR);Eukaryota;Archaeplastida;Chloroplastida;Charophyta;Phragmoplastophyta;Streptophyta;Embryophyta;Bryophyta;Grimmiales;Ptychomitrium;";"0.0";"0";"2";"2";"0";"2";"0";"457181";"373894"
"V4mis1";"SILVA (only NR);Eukaryota;Archaeplastida;Chloroplastida;Charophyta;Phragmoplastophyta;Streptophyta;Embryophyta;Bryophyta;Hedwigiales;";"0.0";"0";"2";"2";"0";"2";"0";"457181";"373894"
"V4mis1";"SILVA (only NR);Eukaryota;Archaeplastida;Chloroplastida;Charophyta;Phragmoplastophyta;Streptophyta;Embryophyta;Bryophyta;Hedwigiales;Hedwigia;";"0.0";"0";"1";"1";"0";"1";"0";"457182";"373894"
"V4mis1";"SILVA (only NR);Eukaryota;Archaeplastida;Chloroplastida;Charophyta;Phragmoplastophyta;Streptophyta;Embryophyta;Bryophyta;Hedwigiales;Rhacocarpus;";"0.0";"0";"1";"1";"0";"1";"0";"457182";"373894"
"V4mis1";"SILVA (only NR);Eukaryota;Archaeplastida;Chloroplastida;Charophyta;Phragmoplastophyta;Streptophyta;Embryophyta;Bryophyta;Hypnales;";"0.0";"0";"2";"2";"0";"2";"0";"457181";"373894"
"V4mis1";"SILVA (only NR);Eukaryota;Archaeplastida;Chloroplastida;Charophyta;Phragmoplastophyta;Streptophyta;Embryophyta;Bryophyta;Hypnales;Buckiella;";"0.0";"0";"1";"1";"0";"1";"0";"457182";"373894"
"V4mis1";"SILVA (only NR);Eukaryota;Archaeplastida;Chloroplastida;Charophyta;Phragmoplastophyta;Streptophyta;Embryophyta;Bryophyta;Hypnales;Fontinalis;";"0.0";"0";"1";"1";"0";"1";"0";"457182";"373894"
"V4mis1";"SILVA (only NR);Eukaryota;Archaeplastida;Chloroplastida;Charophyta;Phragmoplastophyta;Streptophyta;Embryophyta;Bryophyta;Hypnodendrales;";"0.0";"0";"3";"3";"0";"3";"0";"457180";"373894"
"V4mis1";"SILVA (only NR);Eukaryota;Archaeplastida;Chloroplastida;Charophyta;Phragmoplastophyta;Streptophyta;Embryophyta;Bryophyta;Hypnodendrales;Bescherellia;";"0.0";"0";"1";"1";"0";"1";"0";"457182";"373894"
"V4mis1";"SILVA (only NR);Eukaryota;Archaeplastida;Chloroplastida;Charophyta;Phragmoplastophyta;Streptophyta;Embryophyta;Bryophyta;Hypnodendrales;Mniodendron;";"0.0";"0";"1";"1";"0";"1";"0";"457182";"373894"
"V4mis1";"SILVA (only NR);Eukaryota;Archaeplastida;Chloroplastida;Charophyta;Phragmoplastophyta;Streptophyta;Embryophyta;Bryophyta;Hypnodendrales;Racopilum;";"0.0";"0";"1";"1";"0";"1";"0";"457182";"373894"
"V4mis1";"SILVA (only NR);Eukaryota;Archaeplastida;Chloroplastida;Charophyta;Phragmoplastophyta;Streptophyta;Embryophyta;Bryophyta;Orthotrichales;";"0.0";"0";"4";"4";"0";"4";"0";"457179";"373894"
"V4mis1";"SILVA (only NR);Eukaryota;Archaeplastida;Chloroplastida;Charophyta;Phragmoplastophyta;Streptophyta;Embryophyta;Bryophyta;Orthotrichales;Niphotrichum;";"0.0";"0";"1";"1";"0";"1";"0";"457182";"373894"
"V4mis1";"SILVA (only NR);Eukaryota;Archaeplastida;Chloroplastida;Charophyta;Phragmoplastophyta;Streptophyta;Embryophyta;Bryophyta;Orthotrichales;Orthotrichum;";"0.0";"0";"2";"2";"0";"2";"0";"457181";"373894"
"V4mis1";"SILVA (only NR);Eukaryota;Archaeplastida;Chloroplastida;Charophyta;Phragmoplastophyta;Streptophyta;Embryophyta;Bryophyta;Orthotrichales;Ulota;";"0.0";"0";"1";"1";"0";"1";"0";"457182";"373894"
"V4mis1";"SILVA (only NR);Eukaryota;Archaeplastida;Chloroplastida;Charophyta;Phragmoplastophyta;Streptophyta;Embryophyta;Bryophyta;Polytrichales;";"0.0";"0";"18";"18";"0";"18";"0";"457165";"373894"
"V4mis1";"SILVA (only NR);Eukaryota;Archaeplastida;Chloroplastida;Charophyta;Phragmoplastophyta;Streptophyta;Embryophyta;Bryophyta;Polytrichales;Atrichum;";"0.0";"0";"2";"2";"0";"2";"0";"457181";"373894"
"V4mis1";"SILVA (only NR);Eukaryota;Archaeplastida;Chloroplastida;Charophyta;Phragmoplastophyta;Streptophyta;Embryophyta;Bryophyta;Polytrichales;Dawsonia;";"0.0";"0";"1";"1";"0";"1";"0";"457182";"373894"
"V4mis1";"SILVA (only NR);Eukaryota;Archaeplastida;Chloroplastida;Charophyta;Phragmoplastophyta;Streptophyta;Embryophyta;Bryophyta;Polytrichales;Lyellia;";"0.0";"0";"1";"1";"0";"1";"0";"457182";"373894"
"V4mis1";"SILVA (only NR);Eukaryota;Archaeplastida;Chloroplastida;Charophyta;Phragmoplastophyta;Streptophyta;Embryophyta;Bryophyta;Polytrichales;Notoligotrichum;";"0.0";"0";"1";"1";"0";"1";"0";"457182";"373894"
"V4mis1";"SILVA (only NR);Eukaryota;Archaeplastida;Chloroplastida;Charophyta;Phragmoplastophyta;Streptophyta;Embryophyta;Bryophyta;Polytrichales;Pogonatum;";"0.0";"0";"7";"7";"0";"7";"0";"457176";"373894"
"V4mis1";"SILVA (only NR);Eukaryota;Archaeplastida;Chloroplastida;Charophyta;Phragmoplastophyta;Streptophyta;Embryophyta;Bryophyta;Polytrichales;Polytrichadelphus;";"0.0";"0";"1";"1";"0";"1";"0";"457182";"373894"
"V4mis1";"SILVA (only NR);Eukaryota;Archaeplastida;Chloroplastida;Charophyta;Phragmoplastophyta;Streptophyta;Embryophyta;Bryophyta;Polytrichales;Polytrichum;";"0.0";"0";"2";"2";"0";"2";"0";"457181";"373894"
"V4mis1";"SILVA (only NR);Eukaryota;Archaeplastida;Chloroplastida;Charophyta;Phragmoplastophyta;Streptophyta;Embryophyta;Bryophyta;Pottiales;";"0.0";"0";"4";"4";"0";"4";"0";"457179";"373894"
"V4mis1";"SILVA (only NR);Eukaryota;Archaeplastida;Chloroplastida;Charophyta;Phragmoplastophyta;Streptophyta;Embryophyta;Bryophyta;Pottiales;Pottia;";"0.0";"0";"3";"3";"0";"3";"0";"457180";"373894"
"V4mis1";"SILVA (only NR);Eukaryota;Archaeplastida;Chloroplastida;Charophyta;Phragmoplastophyta;Streptophyta;Embryophyta;Bryophyta;Pottiales;Syntrichia;";"0.0";"0";"1";"1";"0";"1";"0";"457182";"373894"
"V4mis1";"SILVA (only NR);Eukaryota;Archaeplastida;Chloroplastida;Charophyta;Phragmoplastophyta;Streptophyta;Embryophyta;Bryophyta;Sphagnales;";"0.0";"0";"2";"2";"0";"2";"0";"457181";"373894"
"V4mis1";"SILVA (only NR);Eukaryota;Archaeplastida;Chloroplastida;Charophyta;Phragmoplastophyta;Streptophyta;Embryophyta;Bryophyta;Sphagnales;Sphagnum;";"0.0";"0";"2";"2";"0";"2";"0";"457181";"373894"
"V4mis1";"SILVA (only NR);Eukaryota;Archaeplastida;Chloroplastida;Charophyta;Phragmoplastophyta;Streptophyta;Embryophyta;Bryophyta;Splachnales;";"0.0";"0";"1";"1";"0";"1";"0";"457182";"373894"
"V4mis1";"SILVA (only NR);Eukaryota;Archaeplastida;Chloroplastida;Charophyta;Phragmoplastophyta;Streptophyta;Embryophyta;Bryophyta;Splachnales;Splachnum;";"0.0";"0";"1";"1";"0";"1";"0";"457182";"373894"
"V4mis1";"SILVA (only NR);Eukaryota;Archaeplastida;Chloroplastida;Charophyta;Phragmoplastophyta;Streptophyta;Embryophyta;Bryophyta;Takakiales;";"0.0";"0";"1";"1";"0";"1";"0";"457182";"373894"
"V4mis1";"SILVA (only NR);Eukaryota;Archaeplastida;Chloroplastida;Charophyta;Phragmoplastophyta;Streptophyta;Embryophyta;Bryophyta;Takakiales;Takakia;";"0.0";"0";"1";"1";"0";"1";"0";"457182";"373894"
"V4mis1";"SILVA (only NR);Eukaryota;Archaeplastida;Chloroplastida;Charophyta;Phragmoplastophyta;Streptophyta;Embryophyta;Bryophyta;Tetraphidales;";"0.0";"0";"2";"2";"0";"2";"0";"457181";"373894"
"V4mis1";"SILVA (only NR);Eukaryota;Archaeplastida;Chloroplastida;Charophyta;Phragmoplastophyta;Streptophyta;Embryophyta;Bryophyta;Tetraphidales;Tetraphis;";"0.0";"0";"2";"2";"0";"2";"0";"457181";"373894"
"V4mis1";"SILVA (only NR);Eukaryota;Archaeplastida;Chloroplastida;Charophyta;Phragmoplastophyta;Streptophyta;Embryophyta;Bryophyta;Timmiales;";"0.0";"0";"1";"1";"0";"1";"0";"457182";"373894"
"V4mis1";"SILVA (only NR);Eukaryota;Archaeplastida;Chloroplastida;Charophyta;Phragmoplastophyta;Streptophyta;Embryophyta;Bryophyta;Timmiales;Timmia;";"0.0";"0";"1";"1";"0";"1";"0";"457182";"373894"
"V4mis1";"SILVA (only NR);Eukaryota;Archaeplastida;Chloroplastida;Charophyta;Phragmoplastophyta;Streptophyta;Embryophyta;Buxbaumiales;";"0.0";"0";"1";"1";"0";"1";"0";"457182";"373894"
"V4mis1";"SILVA (only NR);Eukaryota;Archaeplastida;Chloroplastida;Charophyta;Phragmoplastophyta;Streptophyta;Embryophyta;Buxbaumiales;Buxbaumia;";"0.0";"0";"1";"1";"0";"1";"0";"457182";"373894"
"V4mis1";"SILVA (only NR);Eukaryota;Archaeplastida;Chloroplastida;Charophyta;Phragmoplastophyta;Streptophyta;Embryophyta;Marchantiophyta;";"0.0";"0";"47";"47";"0";"47";"0";"457136";"373894"
"V4mis1";"SILVA (only NR);Eukaryota;Archaeplastida;Chloroplastida;Charophyta;Phragmoplastophyta;Streptophyta;Embryophyta;Marchantiophyta;Blasiales;";"0.0";"0";"2";"2";"0";"2";"0";"457181";"373894"
"V4mis1";"SILVA (only NR);Eukaryota;Archaeplastida;Chloroplastida;Charophyta;Phragmoplastophyta;Streptophyta;Embryophyta;Marchantiophyta;Blasiales;Blasia;";"0.0";"0";"2";"2";"0";"2";"0";"457181";"373894"
"V4mis1";"SILVA (only NR);Eukaryota;Archaeplastida;Chloroplastida;Charophyta;Phragmoplastophyta;Streptophyta;Embryophyta;Marchantiophyta;Calobryales;";"0.0";"0";"4";"4";"0";"4";"0";"457179";"373894"
"V4mis1";"SILVA (only NR);Eukaryota;Archaeplastida;Chloroplastida;Charophyta;Phragmoplastophyta;Streptophyta;Embryophyta;Marchantiophyta;Calobryales;Haplomitrium;";"0.0";"0";"4";"4";"0";"4";"0";"457179";"373894"
"V4mis1";"SILVA (only NR);Eukaryota;Archaeplastida;Chloroplastida;Charophyta;Phragmoplastophyta;Streptophyta;Embryophyta;Marchantiophyta;Fossombroniales;";"0.0";"0";"2";"2";"0";"2";"0";"457181";"373894"
"V4mis1";"SILVA (only NR);Eukaryota;Archaeplastida;Chloroplastida;Charophyta;Phragmoplastophyta;Streptophyta;Embryophyta;Marchantiophyta;Fossombroniales;Fossombronia;";"0.0";"0";"1";"1";"0";"1";"0";"457182";"373894"
"V4mis1";"SILVA (only NR);Eukaryota;Archaeplastida;Chloroplastida;Charophyta;Phragmoplastophyta;Streptophyta;Embryophyta;Marchantiophyta;Fossombroniales;Petalophyllum;";"0.0";"0";"1";"1";"0";"1";"0";"457182";"373894"
"V4mis1";"SILVA (only NR);Eukaryota;Archaeplastida;Chloroplastida;Charophyta;Phragmoplastophyta;Streptophyta;Embryophyta;Marchantiophyta;Jungermanniales;";"0.0";"0";"7";"7";"0";"7";"0";"457176";"373894"
"V4mis1";"SILVA (only NR);Eukaryota;Archaeplastida;Chloroplastida;Charophyta;Phragmoplastophyta;Streptophyta;Embryophyta;Marchantiophyta;Jungermanniales;Jungermannia;";"0.0";"0";"1";"1";"0";"1";"0";"457182";"373894"
"V4mis1";"SILVA (only NR);Eukaryota;Archaeplastida;Chloroplastida;Charophyta;Phragmoplastophyta;Streptophyta;Embryophyta;Marchantiophyta;Jungermanniales;Lepidozia;";"0.0";"0";"1";"1";"0";"1";"0";"457182";"373894"
"V4mis1";"SILVA (only NR);Eukaryota;Archaeplastida;Chloroplastida;Charophyta;Phragmoplastophyta;Streptophyta;Embryophyta;Marchantiophyta;Jungermanniales;Lophozia;";"0.0";"0";"1";"1";"0";"1";"0";"457182";"373894"
"V4mis1";"SILVA (only NR);Eukaryota;Archaeplastida;Chloroplastida;Charophyta;Phragmoplastophyta;Streptophyta;Embryophyta;Marchantiophyta;Jungermanniales;Marsupella;";"0.0";"0";"1";"1";"0";"1";"0";"457182";"373894"
"V4mis1";"SILVA (only NR);Eukaryota;Archaeplastida;Chloroplastida;Charophyta;Phragmoplastophyta;Streptophyta;Embryophyta;Marchantiophyta;Jungermanniales;Nowellia;";"0.0";"0";"1";"1";"0";"1";"0";"457182";"373894"
"V4mis1";"SILVA (only NR);Eukaryota;Archaeplastida;Chloroplastida;Charophyta;Phragmoplastophyta;Streptophyta;Embryophyta;Marchantiophyta;Jungermanniales;Odontoschisma;";"0.0";"0";"1";"1";"0";"1";"0";"457182";"373894"
"V4mis1";"SILVA (only NR);Eukaryota;Archaeplastida;Chloroplastida;Charophyta;Phragmoplastophyta;Streptophyta;Embryophyta;Marchantiophyta;Jungermanniales;Tylimanthus;";"0.0";"0";"1";"1";"0";"1";"0";"457182";"373894"
"V4mis1";"SILVA (only NR);Eukaryota;Archaeplastida;Chloroplastida;Charophyta;Phragmoplastophyta;Streptophyta;Embryophyta;Marchantiophyta;Lunulariales;";"0.0";"0";"1";"1";"0";"1";"0";"457182";"373894"
"V4mis1";"SILVA (only NR);Eukaryota;Archaeplastida;Chloroplastida;Charophyta;Phragmoplastophyta;Streptophyta;Embryophyta;Marchantiophyta;Lunulariales;Lunularia;";"0.0";"0";"1";"1";"0";"1";"0";"457182";"373894"
"V4mis1";"SILVA (only NR);Eukaryota;Archaeplastida;Chloroplastida;Charophyta;Phragmoplastophyta;Streptophyta;Embryophyta;Marchantiophyta;Marchantiales;";"0.0";"0";"12";"12";"0";"12";"0";"457171";"373894"
"V4mis1";"SILVA (only NR);Eukaryota;Archaeplastida;Chloroplastida;Charophyta;Phragmoplastophyta;Streptophyta;Embryophyta;Marchantiophyta;Marchantiales;Conocephalum;";"0.0";"0";"2";"2";"0";"2";"0";"457181";"373894"
"V4mis1";"SILVA (only NR);Eukaryota;Archaeplastida;Chloroplastida;Charophyta;Phragmoplastophyta;Streptophyta;Embryophyta;Marchantiophyta;Marchantiales;Dumortiera;";"0.0";"0";"1";"1";"0";"1";"0";"457182";"373894"
"V4mis1";"SILVA (only NR);Eukaryota;Archaeplastida;Chloroplastida;Charophyta;Phragmoplastophyta;Streptophyta;Embryophyta;Marchantiophyta;Marchantiales;Marchantia;";"0.0";"0";"1";"1";"0";"1";"0";"457182";"373894"
"V4mis1";"SILVA (only NR);Eukaryota;Archaeplastida;Chloroplastida;Charophyta;Phragmoplastophyta;Streptophyta;Embryophyta;Marchantiophyta;Marchantiales;Monoclea;";"0.0";"0";"2";"2";"0";"2";"0";"457181";"373894"
"V4mis1";"SILVA (only NR);Eukaryota;Archaeplastida;Chloroplastida;Charophyta;Phragmoplastophyta;Streptophyta;Embryophyta;Marchantiophyta;Marchantiales;Plagiochasma;";"0.0";"0";"1";"1";"0";"1";"0";"457182";"373894"
"V4mis1";"SILVA (only NR);Eukaryota;Archaeplastida;Chloroplastida;Charophyta;Phragmoplastophyta;Streptophyta;Embryophyta;Marchantiophyta;Marchantiales;Reboulia;";"0.0";"0";"2";"2";"0";"2";"0";"457181";"373894"
"V4mis1";"SILVA (only NR);Eukaryota;Archaeplastida;Chloroplastida;Charophyta;Phragmoplastophyta;Streptophyta;Embryophyta;Marchantiophyta;Marchantiales;Riccia;";"0.0";"0";"2";"2";"0";"2";"0";"457181";"373894"
"V4mis1";"SILVA (only NR);Eukaryota;Archaeplastida;Chloroplastida;Charophyta;Phragmoplastophyta;Streptophyta;Embryophyta;Marchantiophyta;Marchantiales;Targionia;";"0.0";"0";"1";"1";"0";"1";"0";"457182";"373894"
"V4mis1";"SILVA (only NR);Eukaryota;Archaeplastida;Chloroplastida;Charophyta;Phragmoplastophyta;Streptophyta;Embryophyta;Marchantiophyta;Metzgeriales;";"0.0";"0";"4";"4";"0";"4";"0";"457179";"373894"
"V4mis1";"SILVA (only NR);Eukaryota;Archaeplastida;Chloroplastida;Charophyta;Phragmoplastophyta;Streptophyta;Embryophyta;Marchantiophyta;Metzgeriales;Aneura;";"0.0";"0";"1";"1";"0";"1";"0";"457182";"373894"
"V4mis1";"SILVA (only NR);Eukaryota;Archaeplastida;Chloroplastida;Charophyta;Phragmoplastophyta;Streptophyta;Embryophyta;Marchantiophyta;Metzgeriales;Metzgeria;";"0.0";"0";"2";"2";"0";"2";"0";"457181";"373894"
"V4mis1";"SILVA (only NR);Eukaryota;Archaeplastida;Chloroplastida;Charophyta;Phragmoplastophyta;Streptophyta;Embryophyta;Marchantiophyta;Metzgeriales;Moerckia;";"0.0";"0";"1";"1";"0";"1";"0";"457182";"373894"
"V4mis1";"SILVA (only NR);Eukaryota;Archaeplastida;Chloroplastida;Charophyta;Phragmoplastophyta;Streptophyta;Embryophyta;Marchantiophyta;Neohodgsoniales;";"0.0";"0";"1";"1";"0";"1";"0";"457182";"373894"
"V4mis1";"SILVA (only NR);Eukaryota;Archaeplastida;Chloroplastida;Charophyta;Phragmoplastophyta;Streptophyta;Embryophyta;Marchantiophyta;Neohodgsoniales;Neohodgsonia;";"0.0";"0";"1";"1";"0";"1";"0";"457182";"373894"
"V4mis1";"SILVA (only NR);Eukaryota;Archaeplastida;Chloroplastida;Charophyta;Phragmoplastophyta;Streptophyta;Embryophyta;Marchantiophyta;Pallaviciniales;";"0.0";"0";"4";"4";"0";"4";"0";"457179";"373894"
"V4mis1";"SILVA (only NR);Eukaryota;Archaeplastida;Chloroplastida;Charophyta;Phragmoplastophyta;Streptophyta;Embryophyta;Marchantiophyta;Pallaviciniales;Hymenophyton;";"0.0";"0";"1";"1";"0";"1";"0";"457182";"373894"
"V4mis1";"SILVA (only NR);Eukaryota;Archaeplastida;Chloroplastida;Charophyta;Phragmoplastophyta;Streptophyta;Embryophyta;Marchantiophyta;Pallaviciniales;Pallavicinia;";"0.0";"0";"1";"1";"0";"1";"0";"457182";"373894"
"V4mis1";"SILVA (only NR);Eukaryota;Archaeplastida;Chloroplastida;Charophyta;Phragmoplastophyta;Streptophyta;Embryophyta;Marchantiophyta;Pallaviciniales;Symphyogyna;";"0.0";"0";"2";"2";"0";"2";"0";"457181";"373894"
"V4mis1";"SILVA (only NR);Eukaryota;Archaeplastida;Chloroplastida;Charophyta;Phragmoplastophyta;Streptophyta;Embryophyta;Marchantiophyta;Porellales;";"0.0";"0";"5";"5";"0";"5";"0";"457178";"373894"
"V4mis1";"SILVA (only NR);Eukaryota;Archaeplastida;Chloroplastida;Charophyta;Phragmoplastophyta;Streptophyta;Embryophyta;Marchantiophyta;Porellales;Cheilolejeunea;";"0.0";"0";"1";"1";"0";"1";"0";"457182";"373894"
"V4mis1";"SILVA (only NR);Eukaryota;Archaeplastida;Chloroplastida;Charophyta;Phragmoplastophyta;Streptophyta;Embryophyta;Marchantiophyta;Porellales;Frullania;";"0.0";"0";"1";"1";"0";"1";"0";"457182";"373894"
"V4mis1";"SILVA (only NR);Eukaryota;Archaeplastida;Chloroplastida;Charophyta;Phragmoplastophyta;Streptophyta;Embryophyta;Marchantiophyta;Porellales;Lejeunea;";"0.0";"0";"1";"1";"0";"1";"0";"457182";"373894"
"V4mis1";"SILVA (only NR);Eukaryota;Archaeplastida;Chloroplastida;Charophyta;Phragmoplastophyta;Streptophyta;Embryophyta;Marchantiophyta;Porellales;Porella;";"0.0";"0";"2";"2";"0";"2";"0";"457181";"373894"
"V4mis1";"SILVA (only NR);Eukaryota;Archaeplastida;Chloroplastida;Charophyta;Phragmoplastophyta;Streptophyta;Embryophyta;Marchantiophyta;Sphaerocarpales;";"0.0";"0";"3";"3";"0";"3";"0";"457180";"373894"
"V4mis1";"SILVA (only NR);Eukaryota;Archaeplastida;Chloroplastida;Charophyta;Phragmoplastophyta;Streptophyta;Embryophyta;Marchantiophyta;Sphaerocarpales;Riella;";"0.0";"0";"1";"1";"0";"1";"0";"457182";"373894"
"V4mis1";"SILVA (only NR);Eukaryota;Archaeplastida;Chloroplastida;Charophyta;Phragmoplastophyta;Streptophyta;Embryophyta;Marchantiophyta;Sphaerocarpales;Sphaerocarpos;";"0.0";"0";"2";"2";"0";"2";"0";"457181";"373894"
"V4mis1";"SILVA (only NR);Eukaryota;Archaeplastida;Chloroplastida;Charophyta;Phragmoplastophyta;Streptophyta;Embryophyta;Marchantiophyta;Treubiales;";"0.0";"0";"1";"1";"0";"1";"0";"457182";"373894"
"V4mis1";"SILVA (only NR);Eukaryota;Archaeplastida;Chloroplastida;Charophyta;Phragmoplastophyta;Streptophyta;Embryophyta;Marchantiophyta;Treubiales;Treubia;";"0.0";"0";"1";"1";"0";"1";"0";"457182";"373894"
"V4mis1";"SILVA (only NR);Eukaryota;Archaeplastida;Chloroplastida;Charophyta;Phragmoplastophyta;Streptophyta;Embryophyta;Tracheophyta;";"0.9";"17.4";"4341";"4320";"40";"4280";"21";"452863";"373854"
"V4mis1";"SILVA (only NR);Eukaryota;Archaeplastida;Chloroplastida;Charophyta;Phragmoplastophyta;Streptophyta;Embryophyta;Tracheophyta;Lycopodiophyta;";"0.0";"0";"21";"20";"0";"20";"1";"457163";"373894"
"V4mis1";"SILVA (only NR);Eukaryota;Archaeplastida;Chloroplastida;Charophyta;Phragmoplastophyta;Streptophyta;Embryophyta;Tracheophyta;Lycopodiophyta;Isoetales;";"0.0";"0";"2";"2";"0";"2";"0";"457181";"373894"
"V4mis1";"SILVA (only NR);Eukaryota;Archaeplastida;Chloroplastida;Charophyta;Phragmoplastophyta;Streptophyta;Embryophyta;Tracheophyta;Lycopodiophyta;Isoetales;Isoetaceae;";"0.0";"0";"2";"2";"0";"2";"0";"457181";"373894"
"V4mis1";"SILVA (only NR);Eukaryota;Archaeplastida;Chloroplastida;Charophyta;Phragmoplastophyta;Streptophyta;Embryophyta;Tracheophyta;Lycopodiophyta;Isoetales;Isoetaceae;Isoetes;";"0.0";"0";"2";"2";"0";"2";"0";"457181";"373894"
"V4mis1";"SILVA (only NR);Eukaryota;Archaeplastida;Chloroplastida;Charophyta;Phragmoplastophyta;Streptophyta;Embryophyta;Tracheophyta;Lycopodiophyta;Lycopodiales;";"0.0";"0";"4";"4";"0";"4";"0";"457179";"373894"
"V4mis1";"SILVA (only NR);Eukaryota;Archaeplastida;Chloroplastida;Charophyta;Phragmoplastophyta;Streptophyta;Embryophyta;Tracheophyta;Lycopodiophyta;Lycopodiales;Diphasiastrum;";"0.0";"0";"1";"1";"0";"1";"0";"457182";"373894"
"V4mis1";"SILVA (only NR);Eukaryota;Archaeplastida;Chloroplastida;Charophyta;Phragmoplastophyta;Streptophyta;Embryophyta;Tracheophyta;Lycopodiophyta;Lycopodiales;Lycopodiella;";"0.0";"0";"1";"1";"0";"1";"0";"457182";"373894"
"V4mis1";"SILVA (only NR);Eukaryota;Archaeplastida;Chloroplastida;Charophyta;Phragmoplastophyta;Streptophyta;Embryophyta;Tracheophyta;Lycopodiophyta;Lycopodiales;Lycopodium;";"0.0";"0";"1";"1";"0";"1";"0";"457182";"373894"
"V4mis1";"SILVA (only NR);Eukaryota;Archaeplastida;Chloroplastida;Charophyta;Phragmoplastophyta;Streptophyta;Embryophyta;Tracheophyta;Lycopodiophyta;Lycopodiales;Phlegmariurus;";"0.0";"0";"1";"1";"0";"1";"0";"457182";"373894"
"V4mis1";"SILVA (only NR);Eukaryota;Archaeplastida;Chloroplastida;Charophyta;Phragmoplastophyta;Streptophyta;Embryophyta;Tracheophyta;Lycopodiophyta;Selaginellales;";"0.0";"0";"15";"14";"0";"14";"1";"457169";"373894"
"V4mis1";"SILVA (only NR);Eukaryota;Archaeplastida;Chloroplastida;Charophyta;Phragmoplastophyta;Streptophyta;Embryophyta;Tracheophyta;Lycopodiophyta;Selaginellales;Selaginella;";"0.0";"0";"15";"14";"0";"14";"1";"457169";"373894"
"V4mis1";"SILVA (only NR);Eukaryota;Archaeplastida;Chloroplastida;Charophyta;Phragmoplastophyta;Streptophyta;Embryophyta;Tracheophyta;Monilophyta;";"0.0";"0";"43";"43";"0";"43";"0";"457140";"373894"
"V4mis1";"SILVA (only NR);Eukaryota;Archaeplastida;Chloroplastida;Charophyta;Phragmoplastophyta;Streptophyta;Embryophyta;Tracheophyta;Monilophyta;Anemia;";"0.0";"0";"1";"1";"0";"1";"0";"457182";"373894"
"V4mis1";"SILVA (only NR);Eukaryota;Archaeplastida;Chloroplastida;Charophyta;Phragmoplastophyta;Streptophyta;Embryophyta;Tracheophyta;Monilophyta;Cyatheales;";"0.0";"0";"2";"2";"0";"2";"0";"457181";"373894"
"V4mis1";"SILVA (only NR);Eukaryota;Archaeplastida;Chloroplastida;Charophyta;Phragmoplastophyta;Streptophyta;Embryophyta;Tracheophyta;Monilophyta;Cyatheales;Cyathea;";"0.0";"0";"1";"1";"0";"1";"0";"457182";"373894"
"V4mis1";"SILVA (only NR);Eukaryota;Archaeplastida;Chloroplastida;Charophyta;Phragmoplastophyta;Streptophyta;Embryophyta;Tracheophyta;Monilophyta;Cyatheales;Metaxya;";"0.0";"0";"1";"1";"0";"1";"0";"457182";"373894"
"V4mis1";"SILVA (only NR);Eukaryota;Archaeplastida;Chloroplastida;Charophyta;Phragmoplastophyta;Streptophyta;Embryophyta;Tracheophyta;Monilophyta;Equisetales;";"0.0";"0";"2";"2";"0";"2";"0";"457181";"373894"
"V4mis1";"SILVA (only NR);Eukaryota;Archaeplastida;Chloroplastida;Charophyta;Phragmoplastophyta;Streptophyta;Embryophyta;Tracheophyta;Monilophyta;Equisetales;Equisetaceae;";"0.0";"0";"2";"2";"0";"2";"0";"457181";"373894"
"V4mis1";"SILVA (only NR);Eukaryota;Archaeplastida;Chloroplastida;Charophyta;Phragmoplastophyta;Streptophyta;Embryophyta;Tracheophyta;Monilophyta;Equisetales;Equisetaceae;Equisetum;";"0.0";"0";"2";"2";"0";"2";"0";"457181";"373894"
"V4mis1";"SILVA (only NR);Eukaryota;Archaeplastida;Chloroplastida;Charophyta;Phragmoplastophyta;Streptophyta;Embryophyta;Tracheophyta;Monilophyta;Gleicheniales;";"0.0";"0";"4";"4";"0";"4";"0";"457179";"373894"
"V4mis1";"SILVA (only NR);Eukaryota;Archaeplastida;Chloroplastida;Charophyta;Phragmoplastophyta;Streptophyta;Embryophyta;Tracheophyta;Monilophyta;Gleicheniales;Cheiropleuria;";"0.0";"0";"1";"1";"0";"1";"0";"457182";"373894"
"V4mis1";"SILVA (only NR);Eukaryota;Archaeplastida;Chloroplastida;Charophyta;Phragmoplastophyta;Streptophyta;Embryophyta;Tracheophyta;Monilophyta;Gleicheniales;Dicranopteris;";"0.0";"0";"1";"1";"0";"1";"0";"457182";"373894"
"V4mis1";"SILVA (only NR);Eukaryota;Archaeplastida;Chloroplastida;Charophyta;Phragmoplastophyta;Streptophyta;Embryophyta;Tracheophyta;Monilophyta;Gleicheniales;Gleichenia;";"0.0";"0";"1";"1";"0";"1";"0";"457182";"373894"
"V4mis1";"SILVA (only NR);Eukaryota;Archaeplastida;Chloroplastida;Charophyta;Phragmoplastophyta;Streptophyta;Embryophyta;Tracheophyta;Monilophyta;Gleicheniales;Phanerosorus;";"0.0";"0";"1";"1";"0";"1";"0";"457182";"373894"
"V4mis1";"SILVA (only NR);Eukaryota;Archaeplastida;Chloroplastida;Charophyta;Phragmoplastophyta;Streptophyta;Embryophyta;Tracheophyta;Monilophyta;Hymenophyllales;";"0.0";"0";"2";"2";"0";"2";"0";"457181";"373894"
"V4mis1";"SILVA (only NR);Eukaryota;Archaeplastida;Chloroplastida;Charophyta;Phragmoplastophyta;Streptophyta;Embryophyta;Tracheophyta;Monilophyta;Hymenophyllales;Hymenophyllum;";"0.0";"0";"1";"1";"0";"1";"0";"457182";"373894"
"V4mis1";"SILVA (only NR);Eukaryota;Archaeplastida;Chloroplastida;Charophyta;Phragmoplastophyta;Streptophyta;Embryophyta;Tracheophyta;Monilophyta;Hymenophyllales;Vandenboschia;";"0.0";"0";"1";"1";"0";"1";"0";"457182";"373894"
"V4mis1";"SILVA (only NR);Eukaryota;Archaeplastida;Chloroplastida;Charophyta;Phragmoplastophyta;Streptophyta;Embryophyta;Tracheophyta;Monilophyta;Marattiales;";"0.0";"0";"4";"4";"0";"4";"0";"457179";"373894"
"V4mis1";"SILVA (only NR);Eukaryota;Archaeplastida;Chloroplastida;Charophyta;Phragmoplastophyta;Streptophyta;Embryophyta;Tracheophyta;Monilophyta;Marattiales;Angiopteris;";"0.0";"0";"1";"1";"0";"1";"0";"457182";"373894"
"V4mis1";"SILVA (only NR);Eukaryota;Archaeplastida;Chloroplastida;Charophyta;Phragmoplastophyta;Streptophyta;Embryophyta;Tracheophyta;Monilophyta;Marattiales;Danaea;";"0.0";"0";"2";"2";"0";"2";"0";"457181";"373894"
"V4mis1";"SILVA (only NR);Eukaryota;Archaeplastida;Chloroplastida;Charophyta;Phragmoplastophyta;Streptophyta;Embryophyta;Tracheophyta;Monilophyta;Marattiales;Ptisana;";"0.0";"0";"1";"1";"0";"1";"0";"457182";"373894"
"V4mis1";"SILVA (only NR);Eukaryota;Archaeplastida;Chloroplastida;Charophyta;Phragmoplastophyta;Streptophyta;Embryophyta;Tracheophyta;Monilophyta;Ophioglossales;";"0.0";"0";"4";"4";"0";"4";"0";"457179";"373894"
"V4mis1";"SILVA (only NR);Eukaryota;Archaeplastida;Chloroplastida;Charophyta;Phragmoplastophyta;Streptophyta;Embryophyta;Tracheophyta;Monilophyta;Ophioglossales;Botrypus;";"0.0";"0";"1";"1";"0";"1";"0";"457182";"373894"
"V4mis1";"SILVA (only NR);Eukaryota;Archaeplastida;Chloroplastida;Charophyta;Phragmoplastophyta;Streptophyta;Embryophyta;Tracheophyta;Monilophyta;Ophioglossales;Helminthostachys;";"0.0";"0";"1";"1";"0";"1";"0";"457182";"373894"
"V4mis1";"SILVA (only NR);Eukaryota;Archaeplastida;Chloroplastida;Charophyta;Phragmoplastophyta;Streptophyta;Embryophyta;Tracheophyta;Monilophyta;Ophioglossales;Ophioglossum;";"0.0";"0";"1";"1";"0";"1";"0";"457182";"373894"
"V4mis1";"SILVA (only NR);Eukaryota;Archaeplastida;Chloroplastida;Charophyta;Phragmoplastophyta;Streptophyta;Embryophyta;Tracheophyta;Monilophyta;Osmundales;";"0.0";"0";"2";"2";"0";"2";"0";"457181";"373894"
"V4mis1";"SILVA (only NR);Eukaryota;Archaeplastida;Chloroplastida;Charophyta;Phragmoplastophyta;Streptophyta;Embryophyta;Tracheophyta;Monilophyta;Osmundales;Osmundastrum;";"0.0";"0";"2";"2";"0";"2";"0";"457181";"373894"
"V4mis1";"SILVA (only NR);Eukaryota;Archaeplastida;Chloroplastida;Charophyta;Phragmoplastophyta;Streptophyta;Embryophyta;Tracheophyta;Monilophyta;Polypodiales;";"0.0";"0";"9";"9";"0";"9";"0";"457174";"373894"
"V4mis1";"SILVA (only NR);Eukaryota;Archaeplastida;Chloroplastida;Charophyta;Phragmoplastophyta;Streptophyta;Embryophyta;Tracheophyta;Monilophyta;Polypodiales;Adiantum;";"0.0";"0";"1";"1";"0";"1";"0";"457182";"373894"
"V4mis1";"SILVA (only NR);Eukaryota;Archaeplastida;Chloroplastida;Charophyta;Phragmoplastophyta;Streptophyta;Embryophyta;Tracheophyta;Monilophyta;Polypodiales;Asplenium;";"0.0";"0";"1";"1";"0";"1";"0";"457182";"373894"
"V4mis1";"SILVA (only NR);Eukaryota;Archaeplastida;Chloroplastida;Charophyta;Phragmoplastophyta;Streptophyta;Embryophyta;Tracheophyta;Monilophyta;Polypodiales;Dryopteris;";"0.0";"0";"1";"1";"0";"1";"0";"457182";"373894"
"V4mis1";"SILVA (only NR);Eukaryota;Archaeplastida;Chloroplastida;Charophyta;Phragmoplastophyta;Streptophyta;Embryophyta;Tracheophyta;Monilophyta;Polypodiales;Lindsaea;";"0.0";"0";"1";"1";"0";"1";"0";"457182";"373894"
"V4mis1";"SILVA (only NR);Eukaryota;Archaeplastida;Chloroplastida;Charophyta;Phragmoplastophyta;Streptophyta;Embryophyta;Tracheophyta;Monilophyta;Polypodiales;Lonchitis;";"0.0";"0";"1";"1";"0";"1";"0";"457182";"373894"
"V4mis1";"SILVA (only NR);Eukaryota;Archaeplastida;Chloroplastida;Charophyta;Phragmoplastophyta;Streptophyta;Embryophyta;Tracheophyta;Monilophyta;Polypodiales;Odontosoria;";"0.0";"0";"1";"1";"0";"1";"0";"457182";"373894"
"V4mis1";"SILVA (only NR);Eukaryota;Archaeplastida;Chloroplastida;Charophyta;Phragmoplastophyta;Streptophyta;Embryophyta;Tracheophyta;Monilophyta;Polypodiales;Polypodium;";"0.0";"0";"1";"1";"0";"1";"0";"457182";"373894"
"V4mis1";"SILVA (only NR);Eukaryota;Archaeplastida;Chloroplastida;Charophyta;Phragmoplastophyta;Streptophyta;Embryophyta;Tracheophyta;Monilophyta;Polypodiales;Pteridium;";"0.0";"0";"1";"1";"0";"1";"0";"457182";"373894"
"V4mis1";"SILVA (only NR);Eukaryota;Archaeplastida;Chloroplastida;Charophyta;Phragmoplastophyta;Streptophyta;Embryophyta;Tracheophyta;Monilophyta;Polypodiales;Vittaria;";"0.0";"0";"1";"1";"0";"1";"0";"457182";"373894"
"V4mis1";"SILVA (only NR);Eukaryota;Archaeplastida;Chloroplastida;Charophyta;Phragmoplastophyta;Streptophyta;Embryophyta;Tracheophyta;Monilophyta;Psilotales;";"0.0";"0";"4";"4";"0";"4";"0";"457179";"373894"
"V4mis1";"SILVA (only NR);Eukaryota;Archaeplastida;Chloroplastida;Charophyta;Phragmoplastophyta;Streptophyta;Embryophyta;Tracheophyta;Monilophyta;Psilotales;Psilotum;";"0.0";"0";"3";"3";"0";"3";"0";"457180";"373894"
"V4mis1";"SILVA (only NR);Eukaryota;Archaeplastida;Chloroplastida;Charophyta;Phragmoplastophyta;Streptophyta;Embryophyta;Tracheophyta;Monilophyta;Psilotales;Tmesipteris;";"0.0";"0";"1";"1";"0";"1";"0";"457182";"373894"
"V4mis1";"SILVA (only NR);Eukaryota;Archaeplastida;Chloroplastida;Charophyta;Phragmoplastophyta;Streptophyta;Embryophyta;Tracheophyta;Monilophyta;Salviniales;";"0.0";"0";"5";"5";"0";"5";"0";"457178";"373894"
"V4mis1";"SILVA (only NR);Eukaryota;Archaeplastida;Chloroplastida;Charophyta;Phragmoplastophyta;Streptophyta;Embryophyta;Tracheophyta;Monilophyta;Salviniales;Azolla;";"0.0";"0";"1";"1";"0";"1";"0";"457182";"373894"
"V4mis1";"SILVA (only NR);Eukaryota;Archaeplastida;Chloroplastida;Charophyta;Phragmoplastophyta;Streptophyta;Embryophyta;Tracheophyta;Monilophyta;Salviniales;Marsilea;";"0.0";"0";"2";"2";"0";"2";"0";"457181";"373894"
"V4mis1";"SILVA (only NR);Eukaryota;Archaeplastida;Chloroplastida;Charophyta;Phragmoplastophyta;Streptophyta;Embryophyta;Tracheophyta;Monilophyta;Salviniales;Pilularia;";"0.0";"0";"1";"1";"0";"1";"0";"457182";"373894"
"V4mis1";"SILVA (only NR);Eukaryota;Archaeplastida;Chloroplastida;Charophyta;Phragmoplastophyta;Streptophyta;Embryophyta;Tracheophyta;Monilophyta;Salviniales;Salvinia;";"0.0";"0";"1";"1";"0";"1";"0";"457182";"373894"
"V4mis1";"SILVA (only NR);Eukaryota;Archaeplastida;Chloroplastida;Charophyta;Phragmoplastophyta;Streptophyta;Embryophyta;Tracheophyta;Monilophyta;Schizaeales;";"0.0";"0";"2";"2";"0";"2";"0";"457181";"373894"
"V4mis1";"SILVA (only NR);Eukaryota;Archaeplastida;Chloroplastida;Charophyta;Phragmoplastophyta;Streptophyta;Embryophyta;Tracheophyta;Monilophyta;Schizaeales;Lygodium;";"0.0";"0";"1";"1";"0";"1";"0";"457182";"373894"
"V4mis1";"SILVA (only NR);Eukaryota;Archaeplastida;Chloroplastida;Charophyta;Phragmoplastophyta;Streptophyta;Embryophyta;Tracheophyta;Monilophyta;Schizaeales;Schizaea;";"0.0";"0";"1";"1";"0";"1";"0";"457182";"373894"
"V4mis1";"SILVA (only NR);Eukaryota;Archaeplastida;Chloroplastida;Charophyta;Phragmoplastophyta;Streptophyta;Embryophyta;Tracheophyta;Spermatophyta;";"0.9";"17.5";"4277";"4257";"40";"4217";"20";"452926";"373854"
"V4mis1";"SILVA (only NR);Eukaryota;Archaeplastida;Chloroplastida;Charophyta;Phragmoplastophyta;Streptophyta;Embryophyta;Tracheophyta;Spermatophyta;Cycadophyta;";"0.0";"0";"9";"9";"0";"9";"0";"457174";"373894"
"V4mis1";"SILVA (only NR);Eukaryota;Archaeplastida;Chloroplastida;Charophyta;Phragmoplastophyta;Streptophyta;Embryophyta;Tracheophyta;Spermatophyta;Cycadophyta;Cycadales;";"0.0";"0";"9";"9";"0";"9";"0";"457174";"373894"
"V4mis1";"SILVA (only NR);Eukaryota;Archaeplastida;Chloroplastida;Charophyta;Phragmoplastophyta;Streptophyta;Embryophyta;Tracheophyta;Spermatophyta;Cycadophyta;Cycadales;Bowenia;";"0.0";"0";"1";"1";"0";"1";"0";"457182";"373894"
"V4mis1";"SILVA (only NR);Eukaryota;Archaeplastida;Chloroplastida;Charophyta;Phragmoplastophyta;Streptophyta;Embryophyta;Tracheophyta;Spermatophyta;Cycadophyta;Cycadales;Ceratozamia;";"0.0";"0";"1";"1";"0";"1";"0";"457182";"373894"
"V4mis1";"SILVA (only NR);Eukaryota;Archaeplastida;Chloroplastida;Charophyta;Phragmoplastophyta;Streptophyta;Embryophyta;Tracheophyta;Spermatophyta;Cycadophyta;Cycadales;Cycas;";"0.0";"0";"1";"1";"0";"1";"0";"457182";"373894"
"V4mis1";"SILVA (only NR);Eukaryota;Archaeplastida;Chloroplastida;Charophyta;Phragmoplastophyta;Streptophyta;Embryophyta;Tracheophyta;Spermatophyta;Cycadophyta;Cycadales;Dioon;";"0.0";"0";"1";"1";"0";"1";"0";"457182";"373894"
"V4mis1";"SILVA (only NR);Eukaryota;Archaeplastida;Chloroplastida;Charophyta;Phragmoplastophyta;Streptophyta;Embryophyta;Tracheophyta;Spermatophyta;Cycadophyta;Cycadales;Encephalartos;";"0.0";"0";"1";"1";"0";"1";"0";"457182";"373894"
"V4mis1";"SILVA (only NR);Eukaryota;Archaeplastida;Chloroplastida;Charophyta;Phragmoplastophyta;Streptophyta;Embryophyta;Tracheophyta;Spermatophyta;Cycadophyta;Cycadales;Lepidozamia;";"0.0";"0";"1";"1";"0";"1";"0";"457182";"373894"
"V4mis1";"SILVA (only NR);Eukaryota;Archaeplastida;Chloroplastida;Charophyta;Phragmoplastophyta;Streptophyta;Embryophyta;Tracheophyta;Spermatophyta;Cycadophyta;Cycadales;Macrozamia;";"0.0";"0";"1";"1";"0";"1";"0";"457182";"373894"
"V4mis1";"SILVA (only NR);Eukaryota;Archaeplastida;Chloroplastida;Charophyta;Phragmoplastophyta;Streptophyta;Embryophyta;Tracheophyta;Spermatophyta;Cycadophyta;Cycadales;Stangeria;";"0.0";"0";"1";"1";"0";"1";"0";"457182";"373894"
"V4mis1";"SILVA (only NR);Eukaryota;Archaeplastida;Chloroplastida;Charophyta;Phragmoplastophyta;Streptophyta;Embryophyta;Tracheophyta;Spermatophyta;Cycadophyta;Cycadales;Zamia;";"0.0";"0";"1";"1";"0";"1";"0";"457182";"373894"
"V4mis1";"SILVA (only NR);Eukaryota;Archaeplastida;Chloroplastida;Charophyta;Phragmoplastophyta;Streptophyta;Embryophyta;Tracheophyta;Spermatophyta;Ginkgoidae;";"0.0";"0";"1";"1";"0";"1";"0";"457182";"373894"
"V4mis1";"SILVA (only NR);Eukaryota;Archaeplastida;Chloroplastida;Charophyta;Phragmoplastophyta;Streptophyta;Embryophyta;Tracheophyta;Spermatophyta;Ginkgoidae;Ginkgoales;";"0.0";"0";"1";"1";"0";"1";"0";"457182";"373894"
"V4mis1";"SILVA (only NR);Eukaryota;Archaeplastida;Chloroplastida;Charophyta;Phragmoplastophyta;Streptophyta;Embryophyta;Tracheophyta;Spermatophyta;Ginkgoidae;Ginkgoales;Ginkgo;";"0.0";"0";"1";"1";"0";"1";"0";"457182";"373894"
"V4mis1";"SILVA (only NR);Eukaryota;Archaeplastida;Chloroplastida;Charophyta;Phragmoplastophyta;Streptophyta;Embryophyta;Tracheophyta;Spermatophyta;Gnetophyta;";"0.0";"0";"8";"8";"0";"8";"0";"457175";"373894"
"V4mis1";"SILVA (only NR);Eukaryota;Archaeplastida;Chloroplastida;Charophyta;Phragmoplastophyta;Streptophyta;Embryophyta;Tracheophyta;Spermatophyta;Gnetophyta;Ephedra;";"0.0";"0";"1";"1";"0";"1";"0";"457182";"373894"
"V4mis1";"SILVA (only NR);Eukaryota;Archaeplastida;Chloroplastida;Charophyta;Phragmoplastophyta;Streptophyta;Embryophyta;Tracheophyta;Spermatophyta;Gnetophyta;Gnetales;";"0.0";"0";"6";"6";"0";"6";"0";"457177";"373894"
"V4mis1";"SILVA (only NR);Eukaryota;Archaeplastida;Chloroplastida;Charophyta;Phragmoplastophyta;Streptophyta;Embryophyta;Tracheophyta;Spermatophyta;Gnetophyta;Gnetales;Gnetaceae;";"0.0";"0";"6";"6";"0";"6";"0";"457177";"373894"
"V4mis1";"SILVA (only NR);Eukaryota;Archaeplastida;Chloroplastida;Charophyta;Phragmoplastophyta;Streptophyta;Embryophyta;Tracheophyta;Spermatophyta;Gnetophyta;Gnetales;Gnetaceae;Gnetum;";"0.0";"0";"6";"6";"0";"6";"0";"457177";"373894"
"V4mis1";"SILVA (only NR);Eukaryota;Archaeplastida;Chloroplastida;Charophyta;Phragmoplastophyta;Streptophyta;Embryophyta;Tracheophyta;Spermatophyta;Gnetophyta;Welwitschiales;";"0.0";"0";"1";"1";"0";"1";"0";"457182";"373894"
"V4mis1";"SILVA (only NR);Eukaryota;Archaeplastida;Chloroplastida;Charophyta;Phragmoplastophyta;Streptophyta;Embryophyta;Tracheophyta;Spermatophyta;Gnetophyta;Welwitschiales;Welwitschia;";"0.0";"0";"1";"1";"0";"1";"0";"457182";"373894"
"V4mis1";"SILVA (only NR);Eukaryota;Archaeplastida;Chloroplastida;Charophyta;Phragmoplastophyta;Streptophyta;Embryophyta;Tracheophyta;Spermatophyta;Magnoliophyta;";"1.1";"17.6";"3572";"3559";"38";"3521";"13";"453624";"373856"
"V4mis1";"SILVA (only NR);Eukaryota;Archaeplastida;Chloroplastida;Charophyta;Phragmoplastophyta;Streptophyta;Embryophyta;Tracheophyta;Spermatophyta;Magnoliophyta;Amborellales;";"0.0";"0";"10";"10";"0";"10";"0";"457173";"373894"
"V4mis1";"SILVA (only NR);Eukaryota;Archaeplastida;Chloroplastida;Charophyta;Phragmoplastophyta;Streptophyta;Embryophyta;Tracheophyta;Spermatophyta;Magnoliophyta;Amborellales;Amborella;";"0.0";"0";"10";"10";"0";"10";"0";"457173";"373894"
"V4mis1";"SILVA (only NR);Eukaryota;Archaeplastida;Chloroplastida;Charophyta;Phragmoplastophyta;Streptophyta;Embryophyta;Tracheophyta;Spermatophyta;Magnoliophyta;Apiales;";"0.0";"0";"13";"13";"0";"13";"0";"457170";"373894"
"V4mis1";"SILVA (only NR);Eukaryota;Archaeplastida;Chloroplastida;Charophyta;Phragmoplastophyta;Streptophyta;Embryophyta;Tracheophyta;Spermatophyta;Magnoliophyta;Apiales;Azorella;";"0.0";"0";"1";"1";"0";"1";"0";"457182";"373894"
"V4mis1";"SILVA (only NR);Eukaryota;Archaeplastida;Chloroplastida;Charophyta;Phragmoplastophyta;Streptophyta;Embryophyta;Tracheophyta;Spermatophyta;Magnoliophyta;Apiales;Billardiera;";"0.0";"0";"1";"1";"0";"1";"0";"457182";"373894"
"V4mis1";"SILVA (only NR);Eukaryota;Archaeplastida;Chloroplastida;Charophyta;Phragmoplastophyta;Streptophyta;Embryophyta;Tracheophyta;Spermatophyta;Magnoliophyta;Apiales;Bupleurum;";"0.0";"0";"1";"1";"0";"1";"0";"457182";"373894"
"V4mis1";"SILVA (only NR);Eukaryota;Archaeplastida;Chloroplastida;Charophyta;Phragmoplastophyta;Streptophyta;Embryophyta;Tracheophyta;Spermatophyta;Magnoliophyta;Apiales;Cnidium;";"0.0";"0";"1";"1";"0";"1";"0";"457182";"373894"
"V4mis1";"SILVA (only NR);Eukaryota;Archaeplastida;Chloroplastida;Charophyta;Phragmoplastophyta;Streptophyta;Embryophyta;Tracheophyta;Spermatophyta;Magnoliophyta;Apiales;Daucus;";"0.0";"0";"1";"1";"0";"1";"0";"457182";"373894"
"V4mis1";"SILVA (only NR);Eukaryota;Archaeplastida;Chloroplastida;Charophyta;Phragmoplastophyta;Streptophyta;Embryophyta;Tracheophyta;Spermatophyta;Magnoliophyta;Apiales;Heracleum;";"0.0";"0";"1";"1";"0";"1";"0";"457182";"373894"
"V4mis1";"SILVA (only NR);Eukaryota;Archaeplastida;Chloroplastida;Charophyta;Phragmoplastophyta;Streptophyta;Embryophyta;Tracheophyta;Spermatophyta;Magnoliophyta;Apiales;Mackinlaya;";"0.0";"0";"1";"1";"0";"1";"0";"457182";"373894"
"V4mis1";"SILVA (only NR);Eukaryota;Archaeplastida;Chloroplastida;Charophyta;Phragmoplastophyta;Streptophyta;Embryophyta;Tracheophyta;Spermatophyta;Magnoliophyta;Apiales;Melanophylla;";"0.0";"0";"1";"1";"0";"1";"0";"457182";"373894"
"V4mis1";"SILVA (only NR);Eukaryota;Archaeplastida;Chloroplastida;Charophyta;Phragmoplastophyta;Streptophyta;Embryophyta;Tracheophyta;Spermatophyta;Magnoliophyta;Apiales;Panax;";"0.0";"0";"3";"3";"0";"3";"0";"457180";"373894"
"V4mis1";"SILVA (only NR);Eukaryota;Archaeplastida;Chloroplastida;Charophyta;Phragmoplastophyta;Streptophyta;Embryophyta;Tracheophyta;Spermatophyta;Magnoliophyta;Apiales;Peucedanum;";"0.0";"0";"1";"1";"0";"1";"0";"457182";"373894"
"V4mis1";"SILVA (only NR);Eukaryota;Archaeplastida;Chloroplastida;Charophyta;Phragmoplastophyta;Streptophyta;Embryophyta;Tracheophyta;Spermatophyta;Magnoliophyta;Apiales;Pimpinella;";"0.0";"0";"1";"1";"0";"1";"0";"457182";"373894"
"V4mis1";"SILVA (only NR);Eukaryota;Archaeplastida;Chloroplastida;Charophyta;Phragmoplastophyta;Streptophyta;Embryophyta;Tracheophyta;Spermatophyta;Magnoliophyta;Aquifoliales;";"0.0";"0";"5";"5";"0";"5";"0";"457178";"373894"
"V4mis1";"SILVA (only NR);Eukaryota;Archaeplastida;Chloroplastida;Charophyta;Phragmoplastophyta;Streptophyta;Embryophyta;Tracheophyta;Spermatophyta;Magnoliophyta;Aquifoliales;Cardiopteris;";"0.0";"0";"1";"1";"0";"1";"0";"457182";"373894"
"V4mis1";"SILVA (only NR);Eukaryota;Archaeplastida;Chloroplastida;Charophyta;Phragmoplastophyta;Streptophyta;Embryophyta;Tracheophyta;Spermatophyta;Magnoliophyta;Aquifoliales;Gonocaryum;";"0.0";"0";"1";"1";"0";"1";"0";"457182";"373894"
"V4mis1";"SILVA (only NR);Eukaryota;Archaeplastida;Chloroplastida;Charophyta;Phragmoplastophyta;Streptophyta;Embryophyta;Tracheophyta;Spermatophyta;Magnoliophyta;Aquifoliales;Helwingia;";"0.0";"0";"1";"1";"0";"1";"0";"457182";"373894"
"V4mis1";"SILVA (only NR);Eukaryota;Archaeplastida;Chloroplastida;Charophyta;Phragmoplastophyta;Streptophyta;Embryophyta;Tracheophyta;Spermatophyta;Magnoliophyta;Aquifoliales;Ilex;";"0.0";"0";"1";"1";"0";"1";"0";"457182";"373894"
"V4mis1";"SILVA (only NR);Eukaryota;Archaeplastida;Chloroplastida;Charophyta;Phragmoplastophyta;Streptophyta;Embryophyta;Tracheophyta;Spermatophyta;Magnoliophyta;Aquifoliales;Phyllonoma;";"0.0";"0";"1";"1";"0";"1";"0";"457182";"373894"
"V4mis1";"SILVA (only NR);Eukaryota;Archaeplastida;Chloroplastida;Charophyta;Phragmoplastophyta;Streptophyta;Embryophyta;Tracheophyta;Spermatophyta;Magnoliophyta;Asterales;";"0.0";"0";"80";"80";"0";"80";"0";"457103";"373894"
"V4mis1";"SILVA (only NR);Eukaryota;Archaeplastida;Chloroplastida;Charophyta;Phragmoplastophyta;Streptophyta;Embryophyta;Tracheophyta;Spermatophyta;Magnoliophyta;Asterales;Alseuosmia;";"0.0";"0";"1";"1";"0";"1";"0";"457182";"373894"
"V4mis1";"SILVA (only NR);Eukaryota;Archaeplastida;Chloroplastida;Charophyta;Phragmoplastophyta;Streptophyta;Embryophyta;Tracheophyta;Spermatophyta;Magnoliophyta;Asterales;Atractylodes;";"0.0";"0";"1";"1";"0";"1";"0";"457182";"373894"
"V4mis1";"SILVA (only NR);Eukaryota;Archaeplastida;Chloroplastida;Charophyta;Phragmoplastophyta;Streptophyta;Embryophyta;Tracheophyta;Spermatophyta;Magnoliophyta;Asterales;Barnadesia;";"0.0";"0";"1";"1";"0";"1";"0";"457182";"373894"
"V4mis1";"SILVA (only NR);Eukaryota;Archaeplastida;Chloroplastida;Charophyta;Phragmoplastophyta;Streptophyta;Embryophyta;Tracheophyta;Spermatophyta;Magnoliophyta;Asterales;Campanula;";"0.0";"0";"1";"1";"0";"1";"0";"457182";"373894"
"V4mis1";"SILVA (only NR);Eukaryota;Archaeplastida;Chloroplastida;Charophyta;Phragmoplastophyta;Streptophyta;Embryophyta;Tracheophyta;Spermatophyta;Magnoliophyta;Asterales;Carpodetus;";"0.0";"0";"1";"1";"0";"1";"0";"457182";"373894"
"V4mis1";"SILVA (only NR);Eukaryota;Archaeplastida;Chloroplastida;Charophyta;Phragmoplastophyta;Streptophyta;Embryophyta;Tracheophyta;Spermatophyta;Magnoliophyta;Asterales;Codonopsis;";"0.0";"0";"1";"1";"0";"1";"0";"457182";"373894"
"V4mis1";"SILVA (only NR);Eukaryota;Archaeplastida;Chloroplastida;Charophyta;Phragmoplastophyta;Streptophyta;Embryophyta;Tracheophyta;Spermatophyta;Magnoliophyta;Asterales;Cynara;";"0.0";"0";"3";"3";"0";"3";"0";"457180";"373894"
"V4mis1";"SILVA (only NR);Eukaryota;Archaeplastida;Chloroplastida;Charophyta;Phragmoplastophyta;Streptophyta;Embryophyta;Tracheophyta;Spermatophyta;Magnoliophyta;Asterales;Dahlia;";"0.0";"0";"1";"1";"0";"1";"0";"457182";"373894"
"V4mis1";"SILVA (only NR);Eukaryota;Archaeplastida;Chloroplastida;Charophyta;Phragmoplastophyta;Streptophyta;Embryophyta;Tracheophyta;Spermatophyta;Magnoliophyta;Asterales;Donatia;";"0.0";"0";"1";"1";"0";"1";"0";"457182";"373894"
"V4mis1";"SILVA (only NR);Eukaryota;Archaeplastida;Chloroplastida;Charophyta;Phragmoplastophyta;Streptophyta;Embryophyta;Tracheophyta;Spermatophyta;Magnoliophyta;Asterales;Helianthus;";"0.0";"0";"58";"58";"0";"58";"0";"457125";"373894"
"V4mis1";"SILVA (only NR);Eukaryota;Archaeplastida;Chloroplastida;Charophyta;Phragmoplastophyta;Streptophyta;Embryophyta;Tracheophyta;Spermatophyta;Magnoliophyta;Asterales;Heliopsis;";"0.0";"0";"1";"1";"0";"1";"0";"457182";"373894"
"V4mis1";"SILVA (only NR);Eukaryota;Archaeplastida;Chloroplastida;Charophyta;Phragmoplastophyta;Streptophyta;Embryophyta;Tracheophyta;Spermatophyta;Magnoliophyta;Asterales;Lactuca;";"0.0";"0";"1";"1";"0";"1";"0";"457182";"373894"
"V4mis1";"SILVA (only NR);Eukaryota;Archaeplastida;Chloroplastida;Charophyta;Phragmoplastophyta;Streptophyta;Embryophyta;Tracheophyta;Spermatophyta;Magnoliophyta;Asterales;Lobelia;";"0.0";"0";"1";"1";"0";"1";"0";"457182";"373894"
"V4mis1";"SILVA (only NR);Eukaryota;Archaeplastida;Chloroplastida;Charophyta;Phragmoplastophyta;Streptophyta;Embryophyta;Tracheophyta;Spermatophyta;Magnoliophyta;Asterales;Megalodonta;";"0.0";"0";"1";"1";"0";"1";"0";"457182";"373894"
"V4mis1";"SILVA (only NR);Eukaryota;Archaeplastida;Chloroplastida;Charophyta;Phragmoplastophyta;Streptophyta;Embryophyta;Tracheophyta;Spermatophyta;Magnoliophyta;Asterales;Menyanthes;";"0.0";"0";"1";"1";"0";"1";"0";"457182";"373894"
"V4mis1";"SILVA (only NR);Eukaryota;Archaeplastida;Chloroplastida;Charophyta;Phragmoplastophyta;Streptophyta;Embryophyta;Tracheophyta;Spermatophyta;Magnoliophyta;Asterales;Myodocarpus;";"0.0";"0";"1";"1";"0";"1";"0";"457182";"373894"
"V4mis1";"SILVA (only NR);Eukaryota;Archaeplastida;Chloroplastida;Charophyta;Phragmoplastophyta;Streptophyta;Embryophyta;Tracheophyta;Spermatophyta;Magnoliophyta;Asterales;Nymphoides;";"0.0";"0";"1";"1";"0";"1";"0";"457182";"373894"
"V4mis1";"SILVA (only NR);Eukaryota;Archaeplastida;Chloroplastida;Charophyta;Phragmoplastophyta;Streptophyta;Embryophyta;Tracheophyta;Spermatophyta;Magnoliophyta;Asterales;Pentaphragma;";"0.0";"0";"1";"1";"0";"1";"0";"457182";"373894"
"V4mis1";"SILVA (only NR);Eukaryota;Archaeplastida;Chloroplastida;Charophyta;Phragmoplastophyta;Streptophyta;Embryophyta;Tracheophyta;Spermatophyta;Magnoliophyta;Asterales;Roussea;";"0.0";"0";"1";"1";"0";"1";"0";"457182";"373894"
"V4mis1";"SILVA (only NR);Eukaryota;Archaeplastida;Chloroplastida;Charophyta;Phragmoplastophyta;Streptophyta;Embryophyta;Tracheophyta;Spermatophyta;Magnoliophyta;Asterales;Rudbeckia;";"0.0";"0";"1";"1";"0";"1";"0";"457182";"373894"
"V4mis1";"SILVA (only NR);Eukaryota;Archaeplastida;Chloroplastida;Charophyta;Phragmoplastophyta;Streptophyta;Embryophyta;Tracheophyta;Spermatophyta;Magnoliophyta;Asterales;Stylidium;";"0.0";"0";"1";"1";"0";"1";"0";"457182";"373894"
"V4mis1";"SILVA (only NR);Eukaryota;Archaeplastida;Chloroplastida;Charophyta;Phragmoplastophyta;Streptophyta;Embryophyta;Tracheophyta;Spermatophyta;Magnoliophyta;Austrobaileyales;";"0.0";"0";"2";"2";"0";"2";"0";"457181";"373894"
"V4mis1";"SILVA (only NR);Eukaryota;Archaeplastida;Chloroplastida;Charophyta;Phragmoplastophyta;Streptophyta;Embryophyta;Tracheophyta;Spermatophyta;Magnoliophyta;Austrobaileyales;Austrobaileya;";"0.0";"0";"1";"1";"0";"1";"0";"457182";"373894"
"V4mis1";"SILVA (only NR);Eukaryota;Archaeplastida;Chloroplastida;Charophyta;Phragmoplastophyta;Streptophyta;Embryophyta;Tracheophyta;Spermatophyta;Magnoliophyta;Austrobaileyales;Kadsura;";"0.0";"0";"1";"1";"0";"1";"0";"457182";"373894"
"V4mis1";"SILVA (only NR);Eukaryota;Archaeplastida;Chloroplastida;Charophyta;Phragmoplastophyta;Streptophyta;Embryophyta;Tracheophyta;Spermatophyta;Magnoliophyta;Berberidopsidales;";"0.0";"0";"1";"1";"0";"1";"0";"457182";"373894"
"V4mis1";"SILVA (only NR);Eukaryota;Archaeplastida;Chloroplastida;Charophyta;Phragmoplastophyta;Streptophyta;Embryophyta;Tracheophyta;Spermatophyta;Magnoliophyta;Berberidopsidales;Aextoxicon;";"0.0";"0";"1";"1";"0";"1";"0";"457182";"373894"
"V4mis1";"SILVA (only NR);Eukaryota;Archaeplastida;Chloroplastida;Charophyta;Phragmoplastophyta;Streptophyta;Embryophyta;Tracheophyta;Spermatophyta;Magnoliophyta;Boraginales;";"0.0";"0";"6";"6";"0";"6";"0";"457177";"373894"
"V4mis1";"SILVA (only NR);Eukaryota;Archaeplastida;Chloroplastida;Charophyta;Phragmoplastophyta;Streptophyta;Embryophyta;Tracheophyta;Spermatophyta;Magnoliophyta;Boraginales;Borago;";"0.0";"0";"1";"1";"0";"1";"0";"457182";"373894"
"V4mis1";"SILVA (only NR);Eukaryota;Archaeplastida;Chloroplastida;Charophyta;Phragmoplastophyta;Streptophyta;Embryophyta;Tracheophyta;Spermatophyta;Magnoliophyta;Boraginales;Cryptantha;";"0.0";"0";"1";"1";"0";"1";"0";"457182";"373894"
"V4mis1";"SILVA (only NR);Eukaryota;Archaeplastida;Chloroplastida;Charophyta;Phragmoplastophyta;Streptophyta;Embryophyta;Tracheophyta;Spermatophyta;Magnoliophyta;Boraginales;Ehretia;";"0.0";"0";"1";"1";"0";"1";"0";"457182";"373894"
"V4mis1";"SILVA (only NR);Eukaryota;Archaeplastida;Chloroplastida;Charophyta;Phragmoplastophyta;Streptophyta;Embryophyta;Tracheophyta;Spermatophyta;Magnoliophyta;Boraginales;Ellisia;";"0.0";"0";"1";"1";"0";"1";"0";"457182";"373894"
"V4mis1";"SILVA (only NR);Eukaryota;Archaeplastida;Chloroplastida;Charophyta;Phragmoplastophyta;Streptophyta;Embryophyta;Tracheophyta;Spermatophyta;Magnoliophyta;Boraginales;Lithospermum;";"0.0";"0";"1";"1";"0";"1";"0";"457182";"373894"
"V4mis1";"SILVA (only NR);Eukaryota;Archaeplastida;Chloroplastida;Charophyta;Phragmoplastophyta;Streptophyta;Embryophyta;Tracheophyta;Spermatophyta;Magnoliophyta;Boraginales;Pholisma;";"0.0";"0";"1";"1";"0";"1";"0";"457182";"373894"
"V4mis1";"SILVA (only NR);Eukaryota;Archaeplastida;Chloroplastida;Charophyta;Phragmoplastophyta;Streptophyta;Embryophyta;Tracheophyta;Spermatophyta;Magnoliophyta;Brassicales;";"0.0";"0";"232";"230";"0";"230";"2";"456953";"373894"
"V4mis1";"SILVA (only NR);Eukaryota;Archaeplastida;Chloroplastida;Charophyta;Phragmoplastophyta;Streptophyta;Embryophyta;Tracheophyta;Spermatophyta;Magnoliophyta;Brassicales;Aethionema;";"0.0";"0";"1";"1";"0";"1";"0";"457182";"373894"
"V4mis1";"SILVA (only NR);Eukaryota;Archaeplastida;Chloroplastida;Charophyta;Phragmoplastophyta;Streptophyta;Embryophyta;Tracheophyta;Spermatophyta;Magnoliophyta;Brassicales;Arabidopsis;";"0.0";"0";"99";"99";"0";"99";"0";"457084";"373894"
"V4mis1";"SILVA (only NR);Eukaryota;Archaeplastida;Chloroplastida;Charophyta;Phragmoplastophyta;Streptophyta;Embryophyta;Tracheophyta;Spermatophyta;Magnoliophyta;Brassicales;Arabis;";"0.0";"0";"1";"1";"0";"1";"0";"457182";"373894"
"V4mis1";"SILVA (only NR);Eukaryota;Archaeplastida;Chloroplastida;Charophyta;Phragmoplastophyta;Streptophyta;Embryophyta;Tracheophyta;Spermatophyta;Magnoliophyta;Brassicales;Batis;";"0.0";"0";"1";"1";"0";"1";"0";"457182";"373894"
"V4mis1";"SILVA (only NR);Eukaryota;Archaeplastida;Chloroplastida;Charophyta;Phragmoplastophyta;Streptophyta;Embryophyta;Tracheophyta;Spermatophyta;Magnoliophyta;Brassicales;Brassica;";"0.0";"0";"86";"86";"0";"86";"0";"457097";"373894"
"V4mis1";"SILVA (only NR);Eukaryota;Archaeplastida;Chloroplastida;Charophyta;Phragmoplastophyta;Streptophyta;Embryophyta;Tracheophyta;Spermatophyta;Magnoliophyta;Brassicales;Camelina;";"0.0";"0";"2";"2";"0";"2";"0";"457181";"373894"
"V4mis1";"SILVA (only NR);Eukaryota;Archaeplastida;Chloroplastida;Charophyta;Phragmoplastophyta;Streptophyta;Embryophyta;Tracheophyta;Spermatophyta;Magnoliophyta;Brassicales;Capparis;";"0.0";"0";"1";"1";"0";"1";"0";"457182";"373894"
"V4mis1";"SILVA (only NR);Eukaryota;Archaeplastida;Chloroplastida;Charophyta;Phragmoplastophyta;Streptophyta;Embryophyta;Tracheophyta;Spermatophyta;Magnoliophyta;Brassicales;Carica;";"0.0";"0";"1";"1";"0";"1";"0";"457182";"373894"
"V4mis1";"SILVA (only NR);Eukaryota;Archaeplastida;Chloroplastida;Charophyta;Phragmoplastophyta;Streptophyta;Embryophyta;Tracheophyta;Spermatophyta;Magnoliophyta;Brassicales;Chorispora;";"0.0";"0";"1";"1";"0";"1";"0";"457182";"373894"
"V4mis1";"SILVA (only NR);Eukaryota;Archaeplastida;Chloroplastida;Charophyta;Phragmoplastophyta;Streptophyta;Embryophyta;Tracheophyta;Spermatophyta;Magnoliophyta;Brassicales;Cleome;";"0.0";"0";"1";"1";"0";"1";"0";"457182";"373894"
"V4mis1";"SILVA (only NR);Eukaryota;Archaeplastida;Chloroplastida;Charophyta;Phragmoplastophyta;Streptophyta;Embryophyta;Tracheophyta;Spermatophyta;Magnoliophyta;Brassicales;Cleomella;";"0.0";"0";"1";"1";"0";"1";"0";"457182";"373894"
"V4mis1";"SILVA (only NR);Eukaryota;Archaeplastida;Chloroplastida;Charophyta;Phragmoplastophyta;Streptophyta;Embryophyta;Tracheophyta;Spermatophyta;Magnoliophyta;Brassicales;Conringia;";"0.0";"0";"6";"6";"0";"6";"0";"457177";"373894"
"V4mis1";"SILVA (only NR);Eukaryota;Archaeplastida;Chloroplastida;Charophyta;Phragmoplastophyta;Streptophyta;Embryophyta;Tracheophyta;Spermatophyta;Magnoliophyta;Brassicales;Descurainia;";"0.0";"0";"1";"1";"0";"1";"0";"457182";"373894"
"V4mis1";"SILVA (only NR);Eukaryota;Archaeplastida;Chloroplastida;Charophyta;Phragmoplastophyta;Streptophyta;Embryophyta;Tracheophyta;Spermatophyta;Magnoliophyta;Brassicales;Eutrema;";"0.0";"0";"1";"1";"0";"1";"0";"457182";"373894"
"V4mis1";"SILVA (only NR);Eukaryota;Archaeplastida;Chloroplastida;Charophyta;Phragmoplastophyta;Streptophyta;Embryophyta;Tracheophyta;Spermatophyta;Magnoliophyta;Brassicales;Floerkea;";"0.0";"0";"1";"1";"0";"1";"0";"457182";"373894"
"V4mis1";"SILVA (only NR);Eukaryota;Archaeplastida;Chloroplastida;Charophyta;Phragmoplastophyta;Streptophyta;Embryophyta;Tracheophyta;Spermatophyta;Magnoliophyta;Brassicales;Gyrostemon;";"0.0";"0";"1";"1";"0";"1";"0";"457182";"373894"
"V4mis1";"SILVA (only NR);Eukaryota;Archaeplastida;Chloroplastida;Charophyta;Phragmoplastophyta;Streptophyta;Embryophyta;Tracheophyta;Spermatophyta;Magnoliophyta;Brassicales;Koeberlinia;";"0.0";"0";"1";"1";"0";"1";"0";"457182";"373894"
"V4mis1";"SILVA (only NR);Eukaryota;Archaeplastida;Chloroplastida;Charophyta;Phragmoplastophyta;Streptophyta;Embryophyta;Tracheophyta;Spermatophyta;Magnoliophyta;Brassicales;Lepidium;";"0.0";"0";"1";"1";"0";"1";"0";"457182";"373894"
"V4mis1";"SILVA (only NR);Eukaryota;Archaeplastida;Chloroplastida;Charophyta;Phragmoplastophyta;Streptophyta;Embryophyta;Tracheophyta;Spermatophyta;Magnoliophyta;Brassicales;Moringa;";"0.0";"0";"1";"1";"0";"1";"0";"457182";"373894"
"V4mis1";"SILVA (only NR);Eukaryota;Archaeplastida;Chloroplastida;Charophyta;Phragmoplastophyta;Streptophyta;Embryophyta;Tracheophyta;Spermatophyta;Magnoliophyta;Brassicales;Nasturtium;";"0.0";"0";"2";"2";"0";"2";"0";"457181";"373894"
"V4mis1";"SILVA (only NR);Eukaryota;Archaeplastida;Chloroplastida;Charophyta;Phragmoplastophyta;Streptophyta;Embryophyta;Tracheophyta;Spermatophyta;Magnoliophyta;Brassicales;Noccaea;";"0.0";"0";"1";"1";"0";"1";"0";"457182";"373894"
"V4mis1";"SILVA (only NR);Eukaryota;Archaeplastida;Chloroplastida;Charophyta;Phragmoplastophyta;Streptophyta;Embryophyta;Tracheophyta;Spermatophyta;Magnoliophyta;Brassicales;Pentadiplandra;";"0.0";"0";"1";"1";"0";"1";"0";"457182";"373894"
"V4mis1";"SILVA (only NR);Eukaryota;Archaeplastida;Chloroplastida;Charophyta;Phragmoplastophyta;Streptophyta;Embryophyta;Tracheophyta;Spermatophyta;Magnoliophyta;Brassicales;Physaria;";"0.0";"0";"1";"1";"0";"1";"0";"457182";"373894"
"V4mis1";"SILVA (only NR);Eukaryota;Archaeplastida;Chloroplastida;Charophyta;Phragmoplastophyta;Streptophyta;Embryophyta;Tracheophyta;Spermatophyta;Magnoliophyta;Brassicales;Raphanus;";"0.0";"0";"1";"1";"0";"1";"0";"457182";"373894"
"V4mis1";"SILVA (only NR);Eukaryota;Archaeplastida;Chloroplastida;Charophyta;Phragmoplastophyta;Streptophyta;Embryophyta;Tracheophyta;Spermatophyta;Magnoliophyta;Brassicales;Reseda;";"0.0";"0";"1";"1";"0";"1";"0";"457182";"373894"
"V4mis1";"SILVA (only NR);Eukaryota;Archaeplastida;Chloroplastida;Charophyta;Phragmoplastophyta;Streptophyta;Embryophyta;Tracheophyta;Spermatophyta;Magnoliophyta;Brassicales;Salvadora;";"0.0";"0";"1";"1";"0";"1";"0";"457182";"373894"
"V4mis1";"SILVA (only NR);Eukaryota;Archaeplastida;Chloroplastida;Charophyta;Phragmoplastophyta;Streptophyta;Embryophyta;Tracheophyta;Spermatophyta;Magnoliophyta;Brassicales;Schrenkiella;";"0.0";"0";"1";"1";"0";"1";"0";"457182";"373894"
"V4mis1";"SILVA (only NR);Eukaryota;Archaeplastida;Chloroplastida;Charophyta;Phragmoplastophyta;Streptophyta;Embryophyta;Tracheophyta;Spermatophyta;Magnoliophyta;Brassicales;Sinapis;";"0.0";"0";"1";"1";"0";"1";"0";"457182";"373894"
"V4mis1";"SILVA (only NR);Eukaryota;Archaeplastida;Chloroplastida;Charophyta;Phragmoplastophyta;Streptophyta;Embryophyta;Tracheophyta;Spermatophyta;Magnoliophyta;Brassicales;Tarenaya;";"0.0";"0";"11";"9";"0";"9";"2";"457174";"373894"
"V4mis1";"SILVA (only NR);Eukaryota;Archaeplastida;Chloroplastida;Charophyta;Phragmoplastophyta;Streptophyta;Embryophyta;Tracheophyta;Spermatophyta;Magnoliophyta;Brassicales;Thlaspi;";"0.0";"0";"2";"2";"0";"2";"0";"457181";"373894"
"V4mis1";"SILVA (only NR);Eukaryota;Archaeplastida;Chloroplastida;Charophyta;Phragmoplastophyta;Streptophyta;Embryophyta;Tracheophyta;Spermatophyta;Magnoliophyta;Brassicales;Tropaeolum;";"0.0";"0";"1";"1";"0";"1";"0";"457182";"373894"
"V4mis1";"SILVA (only NR);Eukaryota;Archaeplastida;Chloroplastida;Charophyta;Phragmoplastophyta;Streptophyta;Embryophyta;Tracheophyta;Spermatophyta;Magnoliophyta;Bruniales;";"0.0";"0";"1";"1";"0";"1";"0";"457182";"373894"
"V4mis1";"SILVA (only NR);Eukaryota;Archaeplastida;Chloroplastida;Charophyta;Phragmoplastophyta;Streptophyta;Embryophyta;Tracheophyta;Spermatophyta;Magnoliophyta;Bruniales;Berzelia;";"0.0";"0";"1";"1";"0";"1";"0";"457182";"373894"
"V4mis1";"SILVA (only NR);Eukaryota;Archaeplastida;Chloroplastida;Charophyta;Phragmoplastophyta;Streptophyta;Embryophyta;Tracheophyta;Spermatophyta;Magnoliophyta;Buxales;";"0.0";"0";"3";"3";"0";"3";"0";"457180";"373894"
"V4mis1";"SILVA (only NR);Eukaryota;Archaeplastida;Chloroplastida;Charophyta;Phragmoplastophyta;Streptophyta;Embryophyta;Tracheophyta;Spermatophyta;Magnoliophyta;Buxales;Buxus;";"0.0";"0";"1";"1";"0";"1";"0";"457182";"373894"
"V4mis1";"SILVA (only NR);Eukaryota;Archaeplastida;Chloroplastida;Charophyta;Phragmoplastophyta;Streptophyta;Embryophyta;Tracheophyta;Spermatophyta;Magnoliophyta;Buxales;Didymeles;";"0.0";"0";"1";"1";"0";"1";"0";"457182";"373894"
"V4mis1";"SILVA (only NR);Eukaryota;Archaeplastida;Chloroplastida;Charophyta;Phragmoplastophyta;Streptophyta;Embryophyta;Tracheophyta;Spermatophyta;Magnoliophyta;Buxales;Sarcococca;";"0.0";"0";"1";"1";"0";"1";"0";"457182";"373894"
"V4mis1";"SILVA (only NR);Eukaryota;Archaeplastida;Chloroplastida;Charophyta;Phragmoplastophyta;Streptophyta;Embryophyta;Tracheophyta;Spermatophyta;Magnoliophyta;Canellales;";"0.0";"0";"3";"3";"0";"3";"0";"457180";"373894"
"V4mis1";"SILVA (only NR);Eukaryota;Archaeplastida;Chloroplastida;Charophyta;Phragmoplastophyta;Streptophyta;Embryophyta;Tracheophyta;Spermatophyta;Magnoliophyta;Canellales;Canella;";"0.0";"0";"1";"1";"0";"1";"0";"457182";"373894"
"V4mis1";"SILVA (only NR);Eukaryota;Archaeplastida;Chloroplastida;Charophyta;Phragmoplastophyta;Streptophyta;Embryophyta;Tracheophyta;Spermatophyta;Magnoliophyta;Canellales;Cinnamodendron;";"0.0";"0";"1";"1";"0";"1";"0";"457182";"373894"
"V4mis1";"SILVA (only NR);Eukaryota;Archaeplastida;Chloroplastida;Charophyta;Phragmoplastophyta;Streptophyta;Embryophyta;Tracheophyta;Spermatophyta;Magnoliophyta;Canellales;Takhtajania;";"0.0";"0";"1";"1";"0";"1";"0";"457182";"373894"
"V4mis1";"SILVA (only NR);Eukaryota;Archaeplastida;Chloroplastida;Charophyta;Phragmoplastophyta;Streptophyta;Embryophyta;Tracheophyta;Spermatophyta;Magnoliophyta;Caryophyllales;";"0.0";"0";"106";"106";"0";"106";"0";"457077";"373894"
"V4mis1";"SILVA (only NR);Eukaryota;Archaeplastida;Chloroplastida;Charophyta;Phragmoplastophyta;Streptophyta;Embryophyta;Tracheophyta;Spermatophyta;Magnoliophyta;Caryophyllales;Aegialitis;";"0.0";"0";"1";"1";"0";"1";"0";"457182";"373894"
"V4mis1";"SILVA (only NR);Eukaryota;Archaeplastida;Chloroplastida;Charophyta;Phragmoplastophyta;Streptophyta;Embryophyta;Tracheophyta;Spermatophyta;Magnoliophyta;Caryophyllales;Aldrovanda;";"0.0";"0";"1";"1";"0";"1";"0";"457182";"373894"
"V4mis1";"SILVA (only NR);Eukaryota;Archaeplastida;Chloroplastida;Charophyta;Phragmoplastophyta;Streptophyta;Embryophyta;Tracheophyta;Spermatophyta;Magnoliophyta;Caryophyllales;Amaranthus;";"0.0";"0";"1";"1";"0";"1";"0";"457182";"373894"
"V4mis1";"SILVA (only NR);Eukaryota;Archaeplastida;Chloroplastida;Charophyta;Phragmoplastophyta;Streptophyta;Embryophyta;Tracheophyta;Spermatophyta;Magnoliophyta;Caryophyllales;Ancistrocladus;";"0.0";"0";"1";"1";"0";"1";"0";"457182";"373894"
"V4mis1";"SILVA (only NR);Eukaryota;Archaeplastida;Chloroplastida;Charophyta;Phragmoplastophyta;Streptophyta;Embryophyta;Tracheophyta;Spermatophyta;Magnoliophyta;Caryophyllales;Asteropeia;";"0.0";"0";"1";"1";"0";"1";"0";"457182";"373894"
"V4mis1";"SILVA (only NR);Eukaryota;Archaeplastida;Chloroplastida;Charophyta;Phragmoplastophyta;Streptophyta;Embryophyta;Tracheophyta;Spermatophyta;Magnoliophyta;Caryophyllales;Beta;";"0.0";"0";"10";"10";"0";"10";"0";"457173";"373894"
"V4mis1";"SILVA (only NR);Eukaryota;Archaeplastida;Chloroplastida;Charophyta;Phragmoplastophyta;Streptophyta;Embryophyta;Tracheophyta;Spermatophyta;Magnoliophyta;Caryophyllales;Chenopodium;";"0.0";"0";"12";"12";"0";"12";"0";"457171";"373894"
"V4mis1";"SILVA (only NR);Eukaryota;Archaeplastida;Chloroplastida;Charophyta;Phragmoplastophyta;Streptophyta;Embryophyta;Tracheophyta;Spermatophyta;Magnoliophyta;Caryophyllales;Coccoloba;";"0.0";"0";"1";"1";"0";"1";"0";"457182";"373894"
"V4mis1";"SILVA (only NR);Eukaryota;Archaeplastida;Chloroplastida;Charophyta;Phragmoplastophyta;Streptophyta;Embryophyta;Tracheophyta;Spermatophyta;Magnoliophyta;Caryophyllales;Delosperma;";"0.0";"0";"1";"1";"0";"1";"0";"457182";"373894"
"V4mis1";"SILVA (only NR);Eukaryota;Archaeplastida;Chloroplastida;Charophyta;Phragmoplastophyta;Streptophyta;Embryophyta;Tracheophyta;Spermatophyta;Magnoliophyta;Caryophyllales;Dianthus;";"0.0";"0";"3";"3";"0";"3";"0";"457180";"373894"
"V4mis1";"SILVA (only NR);Eukaryota;Archaeplastida;Chloroplastida;Charophyta;Phragmoplastophyta;Streptophyta;Embryophyta;Tracheophyta;Spermatophyta;Magnoliophyta;Caryophyllales;Dionaea;";"0.0";"0";"1";"1";"0";"1";"0";"457182";"373894"
"V4mis1";"SILVA (only NR);Eukaryota;Archaeplastida;Chloroplastida;Charophyta;Phragmoplastophyta;Streptophyta;Embryophyta;Tracheophyta;Spermatophyta;Magnoliophyta;Caryophyllales;Drosera;";"0.0";"0";"10";"10";"0";"10";"0";"457173";"373894"
"V4mis1";"SILVA (only NR);Eukaryota;Archaeplastida;Chloroplastida;Charophyta;Phragmoplastophyta;Streptophyta;Embryophyta;Tracheophyta;Spermatophyta;Magnoliophyta;Caryophyllales;Drosophyllum;";"0.0";"0";"1";"1";"0";"1";"0";"457182";"373894"
"V4mis1";"SILVA (only NR);Eukaryota;Archaeplastida;Chloroplastida;Charophyta;Phragmoplastophyta;Streptophyta;Embryophyta;Tracheophyta;Spermatophyta;Magnoliophyta;Caryophyllales;Fagopyrum;";"0.0";"0";"2";"2";"0";"2";"0";"457181";"373894"
"V4mis1";"SILVA (only NR);Eukaryota;Archaeplastida;Chloroplastida;Charophyta;Phragmoplastophyta;Streptophyta;Embryophyta;Tracheophyta;Spermatophyta;Magnoliophyta;Caryophyllales;Fallopia;";"0.0";"0";"1";"1";"0";"1";"0";"457182";"373894"
"V4mis1";"SILVA (only NR);Eukaryota;Archaeplastida;Chloroplastida;Charophyta;Phragmoplastophyta;Streptophyta;Embryophyta;Tracheophyta;Spermatophyta;Magnoliophyta;Caryophyllales;Frankenia;";"0.0";"0";"1";"1";"0";"1";"0";"457182";"373894"
"V4mis1";"SILVA (only NR);Eukaryota;Archaeplastida;Chloroplastida;Charophyta;Phragmoplastophyta;Streptophyta;Embryophyta;Tracheophyta;Spermatophyta;Magnoliophyta;Caryophyllales;Limeum;";"0.0";"0";"1";"1";"0";"1";"0";"457182";"373894"
"V4mis1";"SILVA (only NR);Eukaryota;Archaeplastida;Chloroplastida;Charophyta;Phragmoplastophyta;Streptophyta;Embryophyta;Tracheophyta;Spermatophyta;Magnoliophyta;Caryophyllales;Limonium;";"0.0";"0";"2";"2";"0";"2";"0";"457181";"373894"
"V4mis1";"SILVA (only NR);Eukaryota;Archaeplastida;Chloroplastida;Charophyta;Phragmoplastophyta;Streptophyta;Embryophyta;Tracheophyta;Spermatophyta;Magnoliophyta;Caryophyllales;Mirabilis;";"0.0";"0";"1";"1";"0";"1";"0";"457182";"373894"
"V4mis1";"SILVA (only NR);Eukaryota;Archaeplastida;Chloroplastida;Charophyta;Phragmoplastophyta;Streptophyta;Embryophyta;Tracheophyta;Spermatophyta;Magnoliophyta;Caryophyllales;Mollugo;";"0.0";"0";"1";"1";"0";"1";"0";"457182";"373894"
"V4mis1";"SILVA (only NR);Eukaryota;Archaeplastida;Chloroplastida;Charophyta;Phragmoplastophyta;Streptophyta;Embryophyta;Tracheophyta;Spermatophyta;Magnoliophyta;Caryophyllales;Nepenthes;";"0.0";"0";"1";"1";"0";"1";"0";"457182";"373894"
"V4mis1";"SILVA (only NR);Eukaryota;Archaeplastida;Chloroplastida;Charophyta;Phragmoplastophyta;Streptophyta;Embryophyta;Tracheophyta;Spermatophyta;Magnoliophyta;Caryophyllales;Opuntia;";"0.0";"0";"28";"28";"0";"28";"0";"457155";"373894"
"V4mis1";"SILVA (only NR);Eukaryota;Archaeplastida;Chloroplastida;Charophyta;Phragmoplastophyta;Streptophyta;Embryophyta;Tracheophyta;Spermatophyta;Magnoliophyta;Caryophyllales;Persicaria;";"0.0";"0";"6";"6";"0";"6";"0";"457177";"373894"
"V4mis1";"SILVA (only NR);Eukaryota;Archaeplastida;Chloroplastida;Charophyta;Phragmoplastophyta;Streptophyta;Embryophyta;Tracheophyta;Spermatophyta;Magnoliophyta;Caryophyllales;Phaulothamnus;";"0.0";"0";"1";"1";"0";"1";"0";"457182";"373894"
"V4mis1";"SILVA (only NR);Eukaryota;Archaeplastida;Chloroplastida;Charophyta;Phragmoplastophyta;Streptophyta;Embryophyta;Tracheophyta;Spermatophyta;Magnoliophyta;Caryophyllales;Phytolacca;";"0.0";"0";"1";"1";"0";"1";"0";"457182";"373894"
"V4mis1";"SILVA (only NR);Eukaryota;Archaeplastida;Chloroplastida;Charophyta;Phragmoplastophyta;Streptophyta;Embryophyta;Tracheophyta;Spermatophyta;Magnoliophyta;Caryophyllales;Plumbago;";"0.0";"0";"1";"1";"0";"1";"0";"457182";"373894"
"V4mis1";"SILVA (only NR);Eukaryota;Archaeplastida;Chloroplastida;Charophyta;Phragmoplastophyta;Streptophyta;Embryophyta;Tracheophyta;Spermatophyta;Magnoliophyta;Caryophyllales;Rhabdodendron;";"0.0";"0";"1";"1";"0";"1";"0";"457182";"373894"
"V4mis1";"SILVA (only NR);Eukaryota;Archaeplastida;Chloroplastida;Charophyta;Phragmoplastophyta;Streptophyta;Embryophyta;Tracheophyta;Spermatophyta;Magnoliophyta;Caryophyllales;Rheum;";"0.0";"0";"1";"1";"0";"1";"0";"457182";"373894"
"V4mis1";"SILVA (only NR);Eukaryota;Archaeplastida;Chloroplastida;Charophyta;Phragmoplastophyta;Streptophyta;Embryophyta;Tracheophyta;Spermatophyta;Magnoliophyta;Caryophyllales;Rivina;";"0.0";"0";"1";"1";"0";"1";"0";"457182";"373894"
"V4mis1";"SILVA (only NR);Eukaryota;Archaeplastida;Chloroplastida;Charophyta;Phragmoplastophyta;Streptophyta;Embryophyta;Tracheophyta;Spermatophyta;Magnoliophyta;Caryophyllales;Rumex;";"0.0";"0";"2";"2";"0";"2";"0";"457181";"373894"
"V4mis1";"SILVA (only NR);Eukaryota;Archaeplastida;Chloroplastida;Charophyta;Phragmoplastophyta;Streptophyta;Embryophyta;Tracheophyta;Spermatophyta;Magnoliophyta;Caryophyllales;Sarcobatus;";"0.0";"0";"1";"1";"0";"1";"0";"457182";"373894"
"V4mis1";"SILVA (only NR);Eukaryota;Archaeplastida;Chloroplastida;Charophyta;Phragmoplastophyta;Streptophyta;Embryophyta;Tracheophyta;Spermatophyta;Magnoliophyta;Caryophyllales;Silene;";"0.0";"0";"5";"5";"0";"5";"0";"457178";"373894"
"V4mis1";"SILVA (only NR);Eukaryota;Archaeplastida;Chloroplastida;Charophyta;Phragmoplastophyta;Streptophyta;Embryophyta;Tracheophyta;Spermatophyta;Magnoliophyta;Caryophyllales;Simmondsia;";"0.0";"0";"1";"1";"0";"1";"0";"457182";"373894"
"V4mis1";"SILVA (only NR);Eukaryota;Archaeplastida;Chloroplastida;Charophyta;Phragmoplastophyta;Streptophyta;Embryophyta;Tracheophyta;Spermatophyta;Magnoliophyta;Caryophyllales;Stellaria;";"0.0";"0";"1";"1";"0";"1";"0";"457182";"373894"
"V4mis1";"SILVA (only NR);Eukaryota;Archaeplastida;Chloroplastida;Charophyta;Phragmoplastophyta;Streptophyta;Embryophyta;Tracheophyta;Spermatophyta;Magnoliophyta;Caryophyllales;Tamarix;";"0.0";"0";"1";"1";"0";"1";"0";"457182";"373894"
"V4mis1";"SILVA (only NR);Eukaryota;Archaeplastida;Chloroplastida;Charophyta;Phragmoplastophyta;Streptophyta;Embryophyta;Tracheophyta;Spermatophyta;Magnoliophyta;Caryophyllales;Triphyophyllum;";"0.0";"0";"1";"1";"0";"1";"0";"457182";"373894"
"V4mis1";"SILVA (only NR);Eukaryota;Archaeplastida;Chloroplastida;Charophyta;Phragmoplastophyta;Streptophyta;Embryophyta;Tracheophyta;Spermatophyta;Magnoliophyta;Celastrales;";"0.0";"0";"14";"14";"0";"14";"0";"457169";"373894"
"V4mis1";"SILVA (only NR);Eukaryota;Archaeplastida;Chloroplastida;Charophyta;Phragmoplastophyta;Streptophyta;Embryophyta;Tracheophyta;Spermatophyta;Magnoliophyta;Celastrales;Canotia;";"0.0";"0";"1";"1";"0";"1";"0";"457182";"373894"
"V4mis1";"SILVA (only NR);Eukaryota;Archaeplastida;Chloroplastida;Charophyta;Phragmoplastophyta;Streptophyta;Embryophyta;Tracheophyta;Spermatophyta;Magnoliophyta;Celastrales;Celastrus;";"0.0";"0";"1";"1";"0";"1";"0";"457182";"373894"
"V4mis1";"SILVA (only NR);Eukaryota;Archaeplastida;Chloroplastida;Charophyta;Phragmoplastophyta;Streptophyta;Embryophyta;Tracheophyta;Spermatophyta;Magnoliophyta;Celastrales;Dicarpellum;";"0.0";"0";"1";"1";"0";"1";"0";"457182";"373894"
"V4mis1";"SILVA (only NR);Eukaryota;Archaeplastida;Chloroplastida;Charophyta;Phragmoplastophyta;Streptophyta;Embryophyta;Tracheophyta;Spermatophyta;Magnoliophyta;Celastrales;Euonymus;";"0.0";"0";"1";"1";"0";"1";"0";"457182";"373894"
"V4mis1";"SILVA (only NR);Eukaryota;Archaeplastida;Chloroplastida;Charophyta;Phragmoplastophyta;Streptophyta;Embryophyta;Tracheophyta;Spermatophyta;Magnoliophyta;Celastrales;Gymnosporia;";"0.0";"0";"1";"1";"0";"1";"0";"457182";"373894"
"V4mis1";"SILVA (only NR);Eukaryota;Archaeplastida;Chloroplastida;Charophyta;Phragmoplastophyta;Streptophyta;Embryophyta;Tracheophyta;Spermatophyta;Magnoliophyta;Celastrales;Lepidobotrys;";"0.0";"0";"1";"1";"0";"1";"0";"457182";"373894"
"V4mis1";"SILVA (only NR);Eukaryota;Archaeplastida;Chloroplastida;Charophyta;Phragmoplastophyta;Streptophyta;Embryophyta;Tracheophyta;Spermatophyta;Magnoliophyta;Celastrales;Lepuropetalon;";"0.0";"0";"1";"1";"0";"1";"0";"457182";"373894"
"V4mis1";"SILVA (only NR);Eukaryota;Archaeplastida;Chloroplastida;Charophyta;Phragmoplastophyta;Streptophyta;Embryophyta;Tracheophyta;Spermatophyta;Magnoliophyta;Celastrales;Mortonia;";"0.0";"0";"1";"1";"0";"1";"0";"457182";"373894"
"V4mis1";"SILVA (only NR);Eukaryota;Archaeplastida;Chloroplastida;Charophyta;Phragmoplastophyta;Streptophyta;Embryophyta;Tracheophyta;Spermatophyta;Magnoliophyta;Celastrales;Parnassia;";"0.0";"0";"1";"1";"0";"1";"0";"457182";"373894"
"V4mis1";"SILVA (only NR);Eukaryota;Archaeplastida;Chloroplastida;Charophyta;Phragmoplastophyta;Streptophyta;Embryophyta;Tracheophyta;Spermatophyta;Magnoliophyta;Celastrales;Plagiopteron;";"0.0";"0";"1";"1";"0";"1";"0";"457182";"373894"
"V4mis1";"SILVA (only NR);Eukaryota;Archaeplastida;Chloroplastida;Charophyta;Phragmoplastophyta;Streptophyta;Embryophyta;Tracheophyta;Spermatophyta;Magnoliophyta;Celastrales;Ruptiliocarpon;";"0.0";"0";"1";"1";"0";"1";"0";"457182";"373894"
"V4mis1";"SILVA (only NR);Eukaryota;Archaeplastida;Chloroplastida;Charophyta;Phragmoplastophyta;Streptophyta;Embryophyta;Tracheophyta;Spermatophyta;Magnoliophyta;Celastrales;Siphonodon;";"0.0";"0";"1";"1";"0";"1";"0";"457182";"373894"
"V4mis1";"SILVA (only NR);Eukaryota;Archaeplastida;Chloroplastida;Charophyta;Phragmoplastophyta;Streptophyta;Embryophyta;Tracheophyta;Spermatophyta;Magnoliophyta;Celastrales;Stackhousia;";"0.0";"0";"1";"1";"0";"1";"0";"457182";"373894"
"V4mis1";"SILVA (only NR);Eukaryota;Archaeplastida;Chloroplastida;Charophyta;Phragmoplastophyta;Streptophyta;Embryophyta;Tracheophyta;Spermatophyta;Magnoliophyta;Celastrales;Zinowiewia;";"0.0";"0";"1";"1";"0";"1";"0";"457182";"373894"
"V4mis1";"SILVA (only NR);Eukaryota;Archaeplastida;Chloroplastida;Charophyta;Phragmoplastophyta;Streptophyta;Embryophyta;Tracheophyta;Spermatophyta;Magnoliophyta;Ceratophyllales;";"0.0";"0";"1";"1";"0";"1";"0";"457182";"373894"
"V4mis1";"SILVA (only NR);Eukaryota;Archaeplastida;Chloroplastida;Charophyta;Phragmoplastophyta;Streptophyta;Embryophyta;Tracheophyta;Spermatophyta;Magnoliophyta;Ceratophyllales;Ceratophyllum;";"0.0";"0";"1";"1";"0";"1";"0";"457182";"373894"
"V4mis1";"SILVA (only NR);Eukaryota;Archaeplastida;Chloroplastida;Charophyta;Phragmoplastophyta;Streptophyta;Embryophyta;Tracheophyta;Spermatophyta;Magnoliophyta;Chloranthales;";"0.0";"0";"3";"3";"0";"3";"0";"457180";"373894"
"V4mis1";"SILVA (only NR);Eukaryota;Archaeplastida;Chloroplastida;Charophyta;Phragmoplastophyta;Streptophyta;Embryophyta;Tracheophyta;Spermatophyta;Magnoliophyta;Chloranthales;Chloranthus;";"0.0";"0";"1";"1";"0";"1";"0";"457182";"373894"
"V4mis1";"SILVA (only NR);Eukaryota;Archaeplastida;Chloroplastida;Charophyta;Phragmoplastophyta;Streptophyta;Embryophyta;Tracheophyta;Spermatophyta;Magnoliophyta;Chloranthales;Hedyosmum;";"0.0";"0";"1";"1";"0";"1";"0";"457182";"373894"
"V4mis1";"SILVA (only NR);Eukaryota;Archaeplastida;Chloroplastida;Charophyta;Phragmoplastophyta;Streptophyta;Embryophyta;Tracheophyta;Spermatophyta;Magnoliophyta;Chloranthales;Sarcandra;";"0.0";"0";"1";"1";"0";"1";"0";"457182";"373894"
"V4mis1";"SILVA (only NR);Eukaryota;Archaeplastida;Chloroplastida;Charophyta;Phragmoplastophyta;Streptophyta;Embryophyta;Tracheophyta;Spermatophyta;Magnoliophyta;Cornales;";"0.0";"0";"4";"4";"0";"4";"0";"457179";"373894"
"V4mis1";"SILVA (only NR);Eukaryota;Archaeplastida;Chloroplastida;Charophyta;Phragmoplastophyta;Streptophyta;Embryophyta;Tracheophyta;Spermatophyta;Magnoliophyta;Cornales;Alangium;";"0.0";"0";"1";"1";"0";"1";"0";"457182";"373894"
"V4mis1";"SILVA (only NR);Eukaryota;Archaeplastida;Chloroplastida;Charophyta;Phragmoplastophyta;Streptophyta;Embryophyta;Tracheophyta;Spermatophyta;Magnoliophyta;Cornales;Hydrostachys;";"0.0";"0";"1";"1";"0";"1";"0";"457182";"373894"
"V4mis1";"SILVA (only NR);Eukaryota;Archaeplastida;Chloroplastida;Charophyta;Phragmoplastophyta;Streptophyta;Embryophyta;Tracheophyta;Spermatophyta;Magnoliophyta;Cornales;Nasa;";"0.0";"0";"1";"1";"0";"1";"0";"457182";"373894"
"V4mis1";"SILVA (only NR);Eukaryota;Archaeplastida;Chloroplastida;Charophyta;Phragmoplastophyta;Streptophyta;Embryophyta;Tracheophyta;Spermatophyta;Magnoliophyta;Cornales;Philadelphus;";"0.0";"0";"1";"1";"0";"1";"0";"457182";"373894"
"V4mis1";"SILVA (only NR);Eukaryota;Archaeplastida;Chloroplastida;Charophyta;Phragmoplastophyta;Streptophyta;Embryophyta;Tracheophyta;Spermatophyta;Magnoliophyta;Crossosomatales;";"0.0";"0";"4";"4";"0";"4";"0";"457179";"373894"
"V4mis1";"SILVA (only NR);Eukaryota;Archaeplastida;Chloroplastida;Charophyta;Phragmoplastophyta;Streptophyta;Embryophyta;Tracheophyta;Spermatophyta;Magnoliophyta;Crossosomatales;Aphloia;";"0.0";"0";"1";"1";"0";"1";"0";"457182";"373894"
"V4mis1";"SILVA (only NR);Eukaryota;Archaeplastida;Chloroplastida;Charophyta;Phragmoplastophyta;Streptophyta;Embryophyta;Tracheophyta;Spermatophyta;Magnoliophyta;Crossosomatales;Crossosoma;";"0.0";"0";"1";"1";"0";"1";"0";"457182";"373894"
"V4mis1";"SILVA (only NR);Eukaryota;Archaeplastida;Chloroplastida;Charophyta;Phragmoplastophyta;Streptophyta;Embryophyta;Tracheophyta;Spermatophyta;Magnoliophyta;Crossosomatales;Stachyurus;";"0.0";"0";"1";"1";"0";"1";"0";"457182";"373894"
"V4mis1";"SILVA (only NR);Eukaryota;Archaeplastida;Chloroplastida;Charophyta;Phragmoplastophyta;Streptophyta;Embryophyta;Tracheophyta;Spermatophyta;Magnoliophyta;Crossosomatales;Strasburgeria;";"0.0";"0";"1";"1";"0";"1";"0";"457182";"373894"
"V4mis1";"SILVA (only NR);Eukaryota;Archaeplastida;Chloroplastida;Charophyta;Phragmoplastophyta;Streptophyta;Embryophyta;Tracheophyta;Spermatophyta;Magnoliophyta;Cucurbitales;";"0.0";"0";"292";"291";"0";"291";"1";"456892";"373894"
"V4mis1";"SILVA (only NR);Eukaryota;Archaeplastida;Chloroplastida;Charophyta;Phragmoplastophyta;Streptophyta;Embryophyta;Tracheophyta;Spermatophyta;Magnoliophyta;Cucurbitales;Abobra;";"0.0";"0";"1";"1";"0";"1";"0";"457182";"373894"
"V4mis1";"SILVA (only NR);Eukaryota;Archaeplastida;Chloroplastida;Charophyta;Phragmoplastophyta;Streptophyta;Embryophyta;Tracheophyta;Spermatophyta;Magnoliophyta;Cucurbitales;Anisophyllea;";"0.0";"0";"1";"1";"0";"1";"0";"457182";"373894"
"V4mis1";"SILVA (only NR);Eukaryota;Archaeplastida;Chloroplastida;Charophyta;Phragmoplastophyta;Streptophyta;Embryophyta;Tracheophyta;Spermatophyta;Magnoliophyta;Cucurbitales;Apodanthes;";"0.0";"0";"1";"1";"0";"1";"0";"457182";"373894"
"V4mis1";"SILVA (only NR);Eukaryota;Archaeplastida;Chloroplastida;Charophyta;Phragmoplastophyta;Streptophyta;Embryophyta;Tracheophyta;Spermatophyta;Magnoliophyta;Cucurbitales;Begonia;";"0.0";"0";"10";"10";"0";"10";"0";"457173";"373894"
"V4mis1";"SILVA (only NR);Eukaryota;Archaeplastida;Chloroplastida;Charophyta;Phragmoplastophyta;Streptophyta;Embryophyta;Tracheophyta;Spermatophyta;Magnoliophyta;Cucurbitales;Cephalopentandra;";"0.0";"0";"1";"1";"0";"1";"0";"457182";"373894"
"V4mis1";"SILVA (only NR);Eukaryota;Archaeplastida;Chloroplastida;Charophyta;Phragmoplastophyta;Streptophyta;Embryophyta;Tracheophyta;Spermatophyta;Magnoliophyta;Cucurbitales;Citrullus;";"0.0";"0";"2";"2";"0";"2";"0";"457181";"373894"
"V4mis1";"SILVA (only NR);Eukaryota;Archaeplastida;Chloroplastida;Charophyta;Phragmoplastophyta;Streptophyta;Embryophyta;Tracheophyta;Spermatophyta;Magnoliophyta;Cucurbitales;Coccinia;";"0.0";"0";"1";"1";"0";"1";"0";"457182";"373894"
"V4mis1";"SILVA (only NR);Eukaryota;Archaeplastida;Chloroplastida;Charophyta;Phragmoplastophyta;Streptophyta;Embryophyta;Tracheophyta;Spermatophyta;Magnoliophyta;Cucurbitales;Combretocarpus;";"0.0";"0";"1";"1";"0";"1";"0";"457182";"373894"
"V4mis1";"SILVA (only NR);Eukaryota;Archaeplastida;Chloroplastida;Charophyta;Phragmoplastophyta;Streptophyta;Embryophyta;Tracheophyta;Spermatophyta;Magnoliophyta;Cucurbitales;Corallocarpus;";"0.0";"0";"1";"1";"0";"1";"0";"457182";"373894"
"V4mis1";"SILVA (only NR);Eukaryota;Archaeplastida;Chloroplastida;Charophyta;Phragmoplastophyta;Streptophyta;Embryophyta;Tracheophyta;Spermatophyta;Magnoliophyta;Cucurbitales;Coriaria;";"0.0";"0";"2";"2";"0";"2";"0";"457181";"373894"
"V4mis1";"SILVA (only NR);Eukaryota;Archaeplastida;Chloroplastida;Charophyta;Phragmoplastophyta;Streptophyta;Embryophyta;Tracheophyta;Spermatophyta;Magnoliophyta;Cucurbitales;Corynocarpus;";"0.0";"0";"1";"1";"0";"1";"0";"457182";"373894"
"V4mis1";"SILVA (only NR);Eukaryota;Archaeplastida;Chloroplastida;Charophyta;Phragmoplastophyta;Streptophyta;Embryophyta;Tracheophyta;Spermatophyta;Magnoliophyta;Cucurbitales;Cucumis;";"0.0";"0";"246";"245";"0";"245";"1";"456938";"373894"
"V4mis1";"SILVA (only NR);Eukaryota;Archaeplastida;Chloroplastida;Charophyta;Phragmoplastophyta;Streptophyta;Embryophyta;Tracheophyta;Spermatophyta;Magnoliophyta;Cucurbitales;Datisca;";"0.0";"0";"2";"2";"0";"2";"0";"457181";"373894"
"V4mis1";"SILVA (only NR);Eukaryota;Archaeplastida;Chloroplastida;Charophyta;Phragmoplastophyta;Streptophyta;Embryophyta;Tracheophyta;Spermatophyta;Magnoliophyta;Cucurbitales;Ecballium;";"0.0";"0";"1";"1";"0";"1";"0";"457182";"373894"
"V4mis1";"SILVA (only NR);Eukaryota;Archaeplastida;Chloroplastida;Charophyta;Phragmoplastophyta;Streptophyta;Embryophyta;Tracheophyta;Spermatophyta;Magnoliophyta;Cucurbitales;Gurania;";"0.0";"0";"1";"1";"0";"1";"0";"457182";"373894"
"V4mis1";"SILVA (only NR);Eukaryota;Archaeplastida;Chloroplastida;Charophyta;Phragmoplastophyta;Streptophyta;Embryophyta;Tracheophyta;Spermatophyta;Magnoliophyta;Cucurbitales;Gynostemma;";"0.0";"0";"1";"1";"0";"1";"0";"457182";"373894"
"V4mis1";"SILVA (only NR);Eukaryota;Archaeplastida;Chloroplastida;Charophyta;Phragmoplastophyta;Streptophyta;Embryophyta;Tracheophyta;Spermatophyta;Magnoliophyta;Cucurbitales;Hillebrandia;";"0.0";"0";"1";"1";"0";"1";"0";"457182";"373894"
"V4mis1";"SILVA (only NR);Eukaryota;Archaeplastida;Chloroplastida;Charophyta;Phragmoplastophyta;Streptophyta;Embryophyta;Tracheophyta;Spermatophyta;Magnoliophyta;Cucurbitales;Lagenaria;";"0.0";"0";"2";"2";"0";"2";"0";"457181";"373894"
"V4mis1";"SILVA (only NR);Eukaryota;Archaeplastida;Chloroplastida;Charophyta;Phragmoplastophyta;Streptophyta;Embryophyta;Tracheophyta;Spermatophyta;Magnoliophyta;Cucurbitales;Luffa;";"0.0";"0";"1";"1";"0";"1";"0";"457182";"373894"
"V4mis1";"SILVA (only NR);Eukaryota;Archaeplastida;Chloroplastida;Charophyta;Phragmoplastophyta;Streptophyta;Embryophyta;Tracheophyta;Spermatophyta;Magnoliophyta;Cucurbitales;Marah;";"0.0";"0";"1";"1";"0";"1";"0";"457182";"373894"
"V4mis1";"SILVA (only NR);Eukaryota;Archaeplastida;Chloroplastida;Charophyta;Phragmoplastophyta;Streptophyta;Embryophyta;Tracheophyta;Spermatophyta;Magnoliophyta;Cucurbitales;Neoalsomitra;";"0.0";"0";"1";"1";"0";"1";"0";"457182";"373894"
"V4mis1";"SILVA (only NR);Eukaryota;Archaeplastida;Chloroplastida;Charophyta;Phragmoplastophyta;Streptophyta;Embryophyta;Tracheophyta;Spermatophyta;Magnoliophyta;Cucurbitales;Octomeles;";"0.0";"0";"1";"1";"0";"1";"0";"457182";"373894"
"V4mis1";"SILVA (only NR);Eukaryota;Archaeplastida;Chloroplastida;Charophyta;Phragmoplastophyta;Streptophyta;Embryophyta;Tracheophyta;Spermatophyta;Magnoliophyta;Cucurbitales;Pilostyles;";"0.0";"0";"8";"8";"0";"8";"0";"457175";"373894"
"V4mis1";"SILVA (only NR);Eukaryota;Archaeplastida;Chloroplastida;Charophyta;Phragmoplastophyta;Streptophyta;Embryophyta;Tracheophyta;Spermatophyta;Magnoliophyta;Cucurbitales;Symbegonia;";"0.0";"0";"1";"1";"0";"1";"0";"457182";"373894"
"V4mis1";"SILVA (only NR);Eukaryota;Archaeplastida;Chloroplastida;Charophyta;Phragmoplastophyta;Streptophyta;Embryophyta;Tracheophyta;Spermatophyta;Magnoliophyta;Cucurbitales;Tetrameles;";"0.0";"0";"1";"1";"0";"1";"0";"457182";"373894"
"V4mis1";"SILVA (only NR);Eukaryota;Archaeplastida;Chloroplastida;Charophyta;Phragmoplastophyta;Streptophyta;Embryophyta;Tracheophyta;Spermatophyta;Magnoliophyta;Cucurbitales;Trochomeria;";"0.0";"0";"1";"1";"0";"1";"0";"457182";"373894"
"V4mis1";"SILVA (only NR);Eukaryota;Archaeplastida;Chloroplastida;Charophyta;Phragmoplastophyta;Streptophyta;Embryophyta;Tracheophyta;Spermatophyta;Magnoliophyta;Cucurbitales;Xerosicyos;";"0.0";"0";"1";"1";"0";"1";"0";"457182";"373894"
"V4mis1";"SILVA (only NR);Eukaryota;Archaeplastida;Chloroplastida;Charophyta;Phragmoplastophyta;Streptophyta;Embryophyta;Tracheophyta;Spermatophyta;Magnoliophyta;Dilleniales;";"0.0";"0";"4";"4";"0";"4";"0";"457179";"373894"
"V4mis1";"SILVA (only NR);Eukaryota;Archaeplastida;Chloroplastida;Charophyta;Phragmoplastophyta;Streptophyta;Embryophyta;Tracheophyta;Spermatophyta;Magnoliophyta;Dilleniales;Dillenia;";"0.0";"0";"1";"1";"0";"1";"0";"457182";"373894"
"V4mis1";"SILVA (only NR);Eukaryota;Archaeplastida;Chloroplastida;Charophyta;Phragmoplastophyta;Streptophyta;Embryophyta;Tracheophyta;Spermatophyta;Magnoliophyta;Dilleniales;Hibbertia;";"0.0";"0";"1";"1";"0";"1";"0";"457182";"373894"
"V4mis1";"SILVA (only NR);Eukaryota;Archaeplastida;Chloroplastida;Charophyta;Phragmoplastophyta;Streptophyta;Embryophyta;Tracheophyta;Spermatophyta;Magnoliophyta;Dilleniales;Schumacheria;";"0.0";"0";"1";"1";"0";"1";"0";"457182";"373894"
"V4mis1";"SILVA (only NR);Eukaryota;Archaeplastida;Chloroplastida;Charophyta;Phragmoplastophyta;Streptophyta;Embryophyta;Tracheophyta;Spermatophyta;Magnoliophyta;Dilleniales;Tetracera;";"0.0";"0";"1";"1";"0";"1";"0";"457182";"373894"
"V4mis1";"SILVA (only NR);Eukaryota;Archaeplastida;Chloroplastida;Charophyta;Phragmoplastophyta;Streptophyta;Embryophyta;Tracheophyta;Spermatophyta;Magnoliophyta;Dipsacales;";"0.0";"0";"2";"2";"0";"2";"0";"457181";"373894"
"V4mis1";"SILVA (only NR);Eukaryota;Archaeplastida;Chloroplastida;Charophyta;Phragmoplastophyta;Streptophyta;Embryophyta;Tracheophyta;Spermatophyta;Magnoliophyta;Dipsacales;Lonicera;";"0.0";"0";"1";"1";"0";"1";"0";"457182";"373894"
"V4mis1";"SILVA (only NR);Eukaryota;Archaeplastida;Chloroplastida;Charophyta;Phragmoplastophyta;Streptophyta;Embryophyta;Tracheophyta;Spermatophyta;Magnoliophyta;Dipsacales;Valeriana;";"0.0";"0";"1";"1";"0";"1";"0";"457182";"373894"
"V4mis1";"SILVA (only NR);Eukaryota;Archaeplastida;Chloroplastida;Charophyta;Phragmoplastophyta;Streptophyta;Embryophyta;Tracheophyta;Spermatophyta;Magnoliophyta;Ericales;";"0.0";"0";"49";"49";"0";"49";"0";"457134";"373894"
"V4mis1";"SILVA (only NR);Eukaryota;Archaeplastida;Chloroplastida;Charophyta;Phragmoplastophyta;Streptophyta;Embryophyta;Tracheophyta;Spermatophyta;Magnoliophyta;Ericales;Actinidia;";"0.0";"0";"6";"6";"0";"6";"0";"457177";"373894"
"V4mis1";"SILVA (only NR);Eukaryota;Archaeplastida;Chloroplastida;Charophyta;Phragmoplastophyta;Streptophyta;Embryophyta;Tracheophyta;Spermatophyta;Magnoliophyta;Ericales;Anagallis;";"0.0";"0";"1";"1";"0";"1";"0";"457182";"373894"
"V4mis1";"SILVA (only NR);Eukaryota;Archaeplastida;Chloroplastida;Charophyta;Phragmoplastophyta;Streptophyta;Embryophyta;Tracheophyta;Spermatophyta;Magnoliophyta;Ericales;Androsace;";"0.0";"0";"1";"1";"0";"1";"0";"457182";"373894"
"V4mis1";"SILVA (only NR);Eukaryota;Archaeplastida;Chloroplastida;Charophyta;Phragmoplastophyta;Streptophyta;Embryophyta;Tracheophyta;Spermatophyta;Magnoliophyta;Ericales;Arbutus;";"0.0";"0";"1";"1";"0";"1";"0";"457182";"373894"
"V4mis1";"SILVA (only NR);Eukaryota;Archaeplastida;Chloroplastida;Charophyta;Phragmoplastophyta;Streptophyta;Embryophyta;Tracheophyta;Spermatophyta;Magnoliophyta;Ericales;Ardisia;";"0.0";"0";"1";"1";"0";"1";"0";"457182";"373894"
"V4mis1";"SILVA (only NR);Eukaryota;Archaeplastida;Chloroplastida;Charophyta;Phragmoplastophyta;Streptophyta;Embryophyta;Tracheophyta;Spermatophyta;Magnoliophyta;Ericales;Bonplandia;";"0.0";"0";"1";"1";"0";"1";"0";"457182";"373894"
"V4mis1";"SILVA (only NR);Eukaryota;Archaeplastida;Chloroplastida;Charophyta;Phragmoplastophyta;Streptophyta;Embryophyta;Tracheophyta;Spermatophyta;Magnoliophyta;Ericales;Calluna;";"0.0";"0";"1";"1";"0";"1";"0";"457182";"373894"
"V4mis1";"SILVA (only NR);Eukaryota;Archaeplastida;Chloroplastida;Charophyta;Phragmoplastophyta;Streptophyta;Embryophyta;Tracheophyta;Spermatophyta;Magnoliophyta;Ericales;Camellia;";"0.0";"0";"1";"1";"0";"1";"0";"457182";"373894"
"V4mis1";"SILVA (only NR);Eukaryota;Archaeplastida;Chloroplastida;Charophyta;Phragmoplastophyta;Streptophyta;Embryophyta;Tracheophyta;Spermatophyta;Magnoliophyta;Ericales;Cantua;";"0.0";"0";"1";"1";"0";"1";"0";"457182";"373894"
"V4mis1";"SILVA (only NR);Eukaryota;Archaeplastida;Chloroplastida;Charophyta;Phragmoplastophyta;Streptophyta;Embryophyta;Tracheophyta;Spermatophyta;Magnoliophyta;Ericales;Ceratiola;";"0.0";"0";"1";"1";"0";"1";"0";"457182";"373894"
"V4mis1";"SILVA (only NR);Eukaryota;Archaeplastida;Chloroplastida;Charophyta;Phragmoplastophyta;Streptophyta;Embryophyta;Tracheophyta;Spermatophyta;Magnoliophyta;Ericales;Chamaedaphne;";"0.0";"0";"1";"1";"0";"1";"0";"457182";"373894"
"V4mis1";"SILVA (only NR);Eukaryota;Archaeplastida;Chloroplastida;Charophyta;Phragmoplastophyta;Streptophyta;Embryophyta;Tracheophyta;Spermatophyta;Magnoliophyta;Ericales;Clavija;";"0.0";"0";"1";"1";"0";"1";"0";"457182";"373894"
"V4mis1";"SILVA (only NR);Eukaryota;Archaeplastida;Chloroplastida;Charophyta;Phragmoplastophyta;Streptophyta;Embryophyta;Tracheophyta;Spermatophyta;Magnoliophyta;Ericales;Clethra;";"0.0";"0";"1";"1";"0";"1";"0";"457182";"373894"
"V4mis1";"SILVA (only NR);Eukaryota;Archaeplastida;Chloroplastida;Charophyta;Phragmoplastophyta;Streptophyta;Embryophyta;Tracheophyta;Spermatophyta;Magnoliophyta;Ericales;Cosmelia;";"0.0";"0";"1";"1";"0";"1";"0";"457182";"373894"
"V4mis1";"SILVA (only NR);Eukaryota;Archaeplastida;Chloroplastida;Charophyta;Phragmoplastophyta;Streptophyta;Embryophyta;Tracheophyta;Spermatophyta;Magnoliophyta;Ericales;Couroupita;";"0.0";"0";"1";"1";"0";"1";"0";"457182";"373894"
"V4mis1";"SILVA (only NR);Eukaryota;Archaeplastida;Chloroplastida;Charophyta;Phragmoplastophyta;Streptophyta;Embryophyta;Tracheophyta;Spermatophyta;Magnoliophyta;Ericales;Cyrilla;";"0.0";"0";"1";"1";"0";"1";"0";"457182";"373894"
"V4mis1";"SILVA (only NR);Eukaryota;Archaeplastida;Chloroplastida;Charophyta;Phragmoplastophyta;Streptophyta;Embryophyta;Tracheophyta;Spermatophyta;Magnoliophyta;Ericales;Diospyros;";"0.0";"0";"2";"2";"0";"2";"0";"457181";"373894"
"V4mis1";"SILVA (only NR);Eukaryota;Archaeplastida;Chloroplastida;Charophyta;Phragmoplastophyta;Streptophyta;Embryophyta;Tracheophyta;Spermatophyta;Magnoliophyta;Ericales;Dracophyllum;";"0.0";"0";"1";"1";"0";"1";"0";"457182";"373894"
"V4mis1";"SILVA (only NR);Eukaryota;Archaeplastida;Chloroplastida;Charophyta;Phragmoplastophyta;Streptophyta;Embryophyta;Tracheophyta;Spermatophyta;Magnoliophyta;Ericales;Fouquieria;";"0.0";"0";"1";"1";"0";"1";"0";"457182";"373894"
"V4mis1";"SILVA (only NR);Eukaryota;Archaeplastida;Chloroplastida;Charophyta;Phragmoplastophyta;Streptophyta;Embryophyta;Tracheophyta;Spermatophyta;Magnoliophyta;Ericales;Galax;";"0.0";"0";"1";"1";"0";"1";"0";"457182";"373894"
"V4mis1";"SILVA (only NR);Eukaryota;Archaeplastida;Chloroplastida;Charophyta;Phragmoplastophyta;Streptophyta;Embryophyta;Tracheophyta;Spermatophyta;Magnoliophyta;Ericales;Gaultheria;";"0.0";"0";"1";"1";"0";"1";"0";"457182";"373894"
"V4mis1";"SILVA (only NR);Eukaryota;Archaeplastida;Chloroplastida;Charophyta;Phragmoplastophyta;Streptophyta;Embryophyta;Tracheophyta;Spermatophyta;Magnoliophyta;Ericales;Gilia;";"0.0";"0";"1";"1";"0";"1";"0";"457182";"373894"
"V4mis1";"SILVA (only NR);Eukaryota;Archaeplastida;Chloroplastida;Charophyta;Phragmoplastophyta;Streptophyta;Embryophyta;Tracheophyta;Spermatophyta;Magnoliophyta;Ericales;Halesia;";"0.0";"0";"1";"1";"0";"1";"0";"457182";"373894"
"V4mis1";"SILVA (only NR);Eukaryota;Archaeplastida;Chloroplastida;Charophyta;Phragmoplastophyta;Streptophyta;Embryophyta;Tracheophyta;Spermatophyta;Magnoliophyta;Ericales;Impatiens;";"0.0";"0";"1";"1";"0";"1";"0";"457182";"373894"
"V4mis1";"SILVA (only NR);Eukaryota;Archaeplastida;Chloroplastida;Charophyta;Phragmoplastophyta;Streptophyta;Embryophyta;Tracheophyta;Spermatophyta;Magnoliophyta;Ericales;Maesa;";"0.0";"0";"1";"1";"0";"1";"0";"457182";"373894"
"V4mis1";"SILVA (only NR);Eukaryota;Archaeplastida;Chloroplastida;Charophyta;Phragmoplastophyta;Streptophyta;Embryophyta;Tracheophyta;Spermatophyta;Magnoliophyta;Ericales;Manilkara;";"0.0";"0";"2";"2";"0";"2";"0";"457181";"373894"
"V4mis1";"SILVA (only NR);Eukaryota;Archaeplastida;Chloroplastida;Charophyta;Phragmoplastophyta;Streptophyta;Embryophyta;Tracheophyta;Spermatophyta;Magnoliophyta;Ericales;Mitrastemon;";"0.0";"0";"1";"1";"0";"1";"0";"457182";"373894"
"V4mis1";"SILVA (only NR);Eukaryota;Archaeplastida;Chloroplastida;Charophyta;Phragmoplastophyta;Streptophyta;Embryophyta;Tracheophyta;Spermatophyta;Magnoliophyta;Ericales;Monotropa;";"0.0";"0";"1";"1";"0";"1";"0";"457182";"373894"
"V4mis1";"SILVA (only NR);Eukaryota;Archaeplastida;Chloroplastida;Charophyta;Phragmoplastophyta;Streptophyta;Embryophyta;Tracheophyta;Spermatophyta;Magnoliophyta;Ericales;Pityopus;";"0.0";"0";"1";"1";"0";"1";"0";"457182";"373894"
"V4mis1";"SILVA (only NR);Eukaryota;Archaeplastida;Chloroplastida;Charophyta;Phragmoplastophyta;Streptophyta;Embryophyta;Tracheophyta;Spermatophyta;Magnoliophyta;Ericales;Primula;";"0.0";"0";"2";"2";"0";"2";"0";"457181";"373894"
"V4mis1";"SILVA (only NR);Eukaryota;Archaeplastida;Chloroplastida;Charophyta;Phragmoplastophyta;Streptophyta;Embryophyta;Tracheophyta;Spermatophyta;Magnoliophyta;Ericales;Prionotes;";"0.0";"0";"1";"1";"0";"1";"0";"457182";"373894"
"V4mis1";"SILVA (only NR);Eukaryota;Archaeplastida;Chloroplastida;Charophyta;Phragmoplastophyta;Streptophyta;Embryophyta;Tracheophyta;Spermatophyta;Magnoliophyta;Ericales;Pyrola;";"0.0";"0";"1";"1";"0";"1";"0";"457182";"373894"
"V4mis1";"SILVA (only NR);Eukaryota;Archaeplastida;Chloroplastida;Charophyta;Phragmoplastophyta;Streptophyta;Embryophyta;Tracheophyta;Spermatophyta;Magnoliophyta;Ericales;Rhododendron;";"0.0";"0";"1";"1";"0";"1";"0";"457182";"373894"
"V4mis1";"SILVA (only NR);Eukaryota;Archaeplastida;Chloroplastida;Charophyta;Phragmoplastophyta;Streptophyta;Embryophyta;Tracheophyta;Spermatophyta;Magnoliophyta;Ericales;Sarcodes;";"0.0";"0";"1";"1";"0";"1";"0";"457182";"373894"
"V4mis1";"SILVA (only NR);Eukaryota;Archaeplastida;Chloroplastida;Charophyta;Phragmoplastophyta;Streptophyta;Embryophyta;Tracheophyta;Spermatophyta;Magnoliophyta;Ericales;Sarracenia;";"0.0";"0";"1";"1";"0";"1";"0";"457182";"373894"
"V4mis1";"SILVA (only NR);Eukaryota;Archaeplastida;Chloroplastida;Charophyta;Phragmoplastophyta;Streptophyta;Embryophyta;Tracheophyta;Spermatophyta;Magnoliophyta;Ericales;Styrax;";"0.0";"0";"2";"2";"0";"2";"0";"457181";"373894"
"V4mis1";"SILVA (only NR);Eukaryota;Archaeplastida;Chloroplastida;Charophyta;Phragmoplastophyta;Streptophyta;Embryophyta;Tracheophyta;Spermatophyta;Magnoliophyta;Ericales;Symplocos;";"0.0";"0";"1";"1";"0";"1";"0";"457182";"373894"
"V4mis1";"SILVA (only NR);Eukaryota;Archaeplastida;Chloroplastida;Charophyta;Phragmoplastophyta;Streptophyta;Embryophyta;Tracheophyta;Spermatophyta;Magnoliophyta;Ericales;Tetramerista;";"0.0";"0";"1";"1";"0";"1";"0";"457182";"373894"
"V4mis1";"SILVA (only NR);Eukaryota;Archaeplastida;Chloroplastida;Charophyta;Phragmoplastophyta;Streptophyta;Embryophyta;Tracheophyta;Spermatophyta;Magnoliophyta;Ericales;Vaccinium;";"0.0";"0";"2";"2";"0";"2";"0";"457181";"373894"
"V4mis1";"SILVA (only NR);Eukaryota;Archaeplastida;Chloroplastida;Charophyta;Phragmoplastophyta;Streptophyta;Embryophyta;Tracheophyta;Spermatophyta;Magnoliophyta;Escalloniales;";"0.0";"0";"2";"2";"0";"2";"0";"457181";"373894"
"V4mis1";"SILVA (only NR);Eukaryota;Archaeplastida;Chloroplastida;Charophyta;Phragmoplastophyta;Streptophyta;Embryophyta;Tracheophyta;Spermatophyta;Magnoliophyta;Escalloniales;Eremosyne;";"0.0";"0";"1";"1";"0";"1";"0";"457182";"373894"
"V4mis1";"SILVA (only NR);Eukaryota;Archaeplastida;Chloroplastida;Charophyta;Phragmoplastophyta;Streptophyta;Embryophyta;Tracheophyta;Spermatophyta;Magnoliophyta;Escalloniales;Escallonia;";"0.0";"0";"1";"1";"0";"1";"0";"457182";"373894"
"V4mis1";"SILVA (only NR);Eukaryota;Archaeplastida;Chloroplastida;Charophyta;Phragmoplastophyta;Streptophyta;Embryophyta;Tracheophyta;Spermatophyta;Magnoliophyta;Fabales;";"7.4";"18.2";"209";"204";"15";"189";"5";"456979";"373879"
"V4mis1";"SILVA (only NR);Eukaryota;Archaeplastida;Chloroplastida;Charophyta;Phragmoplastophyta;Streptophyta;Embryophyta;Tracheophyta;Spermatophyta;Magnoliophyta;Fabales;Ammopiptanthus;";"6.7";"18.2";"15";"15";"1";"14";"0";"457168";"373893"
"V4mis1";"SILVA (only NR);Eukaryota;Archaeplastida;Chloroplastida;Charophyta;Phragmoplastophyta;Streptophyta;Embryophyta;Tracheophyta;Spermatophyta;Magnoliophyta;Fabales;Apios;";"0.0";"0";"1";"1";"0";"1";"0";"457182";"373894"
"V4mis1";"SILVA (only NR);Eukaryota;Archaeplastida;Chloroplastida;Charophyta;Phragmoplastophyta;Streptophyta;Embryophyta;Tracheophyta;Spermatophyta;Magnoliophyta;Fabales;Arachis;";"41.9";"18.2";"31";"31";"13";"18";"0";"457152";"373881"
"V4mis1";"SILVA (only NR);Eukaryota;Archaeplastida;Chloroplastida;Charophyta;Phragmoplastophyta;Streptophyta;Embryophyta;Tracheophyta;Spermatophyta;Magnoliophyta;Fabales;Astragalus;";"0.0";"0";"4";"4";"0";"4";"0";"457179";"373894"
"V4mis1";"SILVA (only NR);Eukaryota;Archaeplastida;Chloroplastida;Charophyta;Phragmoplastophyta;Streptophyta;Embryophyta;Tracheophyta;Spermatophyta;Magnoliophyta;Fabales;Bauhinia;";"0.0";"0";"1";"1";"0";"1";"0";"457182";"373894"
"V4mis1";"SILVA (only NR);Eukaryota;Archaeplastida;Chloroplastida;Charophyta;Phragmoplastophyta;Streptophyta;Embryophyta;Tracheophyta;Spermatophyta;Magnoliophyta;Fabales;Cajanus;";"0.0";"0";"6";"6";"0";"6";"0";"457177";"373894"
"V4mis1";"SILVA (only NR);Eukaryota;Archaeplastida;Chloroplastida;Charophyta;Phragmoplastophyta;Streptophyta;Embryophyta;Tracheophyta;Spermatophyta;Magnoliophyta;Fabales;Cercis;";"0.0";"0";"1";"1";"0";"1";"0";"457182";"373894"
"V4mis1";"SILVA (only NR);Eukaryota;Archaeplastida;Chloroplastida;Charophyta;Phragmoplastophyta;Streptophyta;Embryophyta;Tracheophyta;Spermatophyta;Magnoliophyta;Fabales;Chamaecrista;";"0.0";"0";"1";"1";"0";"1";"0";"457182";"373894"
"V4mis1";"SILVA (only NR);Eukaryota;Archaeplastida;Chloroplastida;Charophyta;Phragmoplastophyta;Streptophyta;Embryophyta;Tracheophyta;Spermatophyta;Magnoliophyta;Fabales;Cicer;";"0.0";"0";"11";"11";"0";"11";"0";"457172";"373894"
"V4mis1";"SILVA (only NR);Eukaryota;Archaeplastida;Chloroplastida;Charophyta;Phragmoplastophyta;Streptophyta;Embryophyta;Tracheophyta;Spermatophyta;Magnoliophyta;Fabales;Cynometra;";"0.0";"0";"1";"1";"0";"1";"0";"457182";"373894"
"V4mis1";"SILVA (only NR);Eukaryota;Archaeplastida;Chloroplastida;Charophyta;Phragmoplastophyta;Streptophyta;Embryophyta;Tracheophyta;Spermatophyta;Magnoliophyta;Fabales;Erythrina;";"0.0";"0";"1";"1";"0";"1";"0";"457182";"373894"
"V4mis1";"SILVA (only NR);Eukaryota;Archaeplastida;Chloroplastida;Charophyta;Phragmoplastophyta;Streptophyta;Embryophyta;Tracheophyta;Spermatophyta;Magnoliophyta;Fabales;Glycine;";"0.0";"0";"2";"2";"0";"2";"0";"457181";"373894"
"V4mis1";"SILVA (only NR);Eukaryota;Archaeplastida;Chloroplastida;Charophyta;Phragmoplastophyta;Streptophyta;Embryophyta;Tracheophyta;Spermatophyta;Magnoliophyta;Fabales;Lotus;";"0.0";"0";"2";"2";"0";"2";"0";"457181";"373894"
"V4mis1";"SILVA (only NR);Eukaryota;Archaeplastida;Chloroplastida;Charophyta;Phragmoplastophyta;Streptophyta;Embryophyta;Tracheophyta;Spermatophyta;Magnoliophyta;Fabales;Lupinus;";"3.3";"18.2";"31";"30";"1";"29";"1";"457153";"373893"
"V4mis1";"SILVA (only NR);Eukaryota;Archaeplastida;Chloroplastida;Charophyta;Phragmoplastophyta;Streptophyta;Embryophyta;Tracheophyta;Spermatophyta;Magnoliophyta;Fabales;Medicago;";"0.0";"0";"10";"10";"0";"10";"0";"457173";"373894"
"V4mis1";"SILVA (only NR);Eukaryota;Archaeplastida;Chloroplastida;Charophyta;Phragmoplastophyta;Streptophyta;Embryophyta;Tracheophyta;Spermatophyta;Magnoliophyta;Fabales;Mezoneuron;";"0.0";"0";"1";"1";"0";"1";"0";"457182";"373894"
"V4mis1";"SILVA (only NR);Eukaryota;Archaeplastida;Chloroplastida;Charophyta;Phragmoplastophyta;Streptophyta;Embryophyta;Tracheophyta;Spermatophyta;Magnoliophyta;Fabales;Oxytropis;";"0.0";"0";"2";"2";"0";"2";"0";"457181";"373894"
"V4mis1";"SILVA (only NR);Eukaryota;Archaeplastida;Chloroplastida;Charophyta;Phragmoplastophyta;Streptophyta;Embryophyta;Tracheophyta;Spermatophyta;Magnoliophyta;Fabales;Phaseolus;";"0.0";"0";"36";"33";"0";"33";"3";"457150";"373894"
"V4mis1";"SILVA (only NR);Eukaryota;Archaeplastida;Chloroplastida;Charophyta;Phragmoplastophyta;Streptophyta;Embryophyta;Tracheophyta;Spermatophyta;Magnoliophyta;Fabales;Polygala;";"0.0";"0";"2";"2";"0";"2";"0";"457181";"373894"
"V4mis1";"SILVA (only NR);Eukaryota;Archaeplastida;Chloroplastida;Charophyta;Phragmoplastophyta;Streptophyta;Embryophyta;Tracheophyta;Spermatophyta;Magnoliophyta;Fabales;Robinia;";"0.0";"0";"1";"1";"0";"1";"0";"457182";"373894"
"V4mis1";"SILVA (only NR);Eukaryota;Archaeplastida;Chloroplastida;Charophyta;Phragmoplastophyta;Streptophyta;Embryophyta;Tracheophyta;Spermatophyta;Magnoliophyta;Fabales;Securidaca;";"0.0";"0";"1";"1";"0";"1";"0";"457182";"373894"
"V4mis1";"SILVA (only NR);Eukaryota;Archaeplastida;Chloroplastida;Charophyta;Phragmoplastophyta;Streptophyta;Embryophyta;Tracheophyta;Spermatophyta;Magnoliophyta;Fabales;Senna;";"0.0";"0";"1";"1";"0";"1";"0";"457182";"373894"
"V4mis1";"SILVA (only NR);Eukaryota;Archaeplastida;Chloroplastida;Charophyta;Phragmoplastophyta;Streptophyta;Embryophyta;Tracheophyta;Spermatophyta;Magnoliophyta;Fabales;Stylobasium;";"0.0";"0";"1";"1";"0";"1";"0";"457182";"373894"
"V4mis1";"SILVA (only NR);Eukaryota;Archaeplastida;Chloroplastida;Charophyta;Phragmoplastophyta;Streptophyta;Embryophyta;Tracheophyta;Spermatophyta;Magnoliophyta;Fabales;Trifolium;";"0.0";"0";"1";"1";"0";"1";"0";"457182";"373894"
"V4mis1";"SILVA (only NR);Eukaryota;Archaeplastida;Chloroplastida;Charophyta;Phragmoplastophyta;Streptophyta;Embryophyta;Tracheophyta;Spermatophyta;Magnoliophyta;Fabales;Vigna;";"0.0";"0";"44";"43";"0";"43";"1";"457140";"373894"
"V4mis1";"SILVA (only NR);Eukaryota;Archaeplastida;Chloroplastida;Charophyta;Phragmoplastophyta;Streptophyta;Embryophyta;Tracheophyta;Spermatophyta;Magnoliophyta;Fabales;Wisteria;";"0.0";"0";"1";"1";"0";"1";"0";"457182";"373894"
"V4mis1";"SILVA (only NR);Eukaryota;Archaeplastida;Chloroplastida;Charophyta;Phragmoplastophyta;Streptophyta;Embryophyta;Tracheophyta;Spermatophyta;Magnoliophyta;Fagales;";"0.0";"0";"27";"27";"0";"27";"0";"457156";"373894"
"V4mis1";"SILVA (only NR);Eukaryota;Archaeplastida;Chloroplastida;Charophyta;Phragmoplastophyta;Streptophyta;Embryophyta;Tracheophyta;Spermatophyta;Magnoliophyta;Fagales;Alnus;";"0.0";"0";"1";"1";"0";"1";"0";"457182";"373894"
"V4mis1";"SILVA (only NR);Eukaryota;Archaeplastida;Chloroplastida;Charophyta;Phragmoplastophyta;Streptophyta;Embryophyta;Tracheophyta;Spermatophyta;Magnoliophyta;Fagales;Betula;";"0.0";"0";"5";"5";"0";"5";"0";"457178";"373894"
"V4mis1";"SILVA (only NR);Eukaryota;Archaeplastida;Chloroplastida;Charophyta;Phragmoplastophyta;Streptophyta;Embryophyta;Tracheophyta;Spermatophyta;Magnoliophyta;Fagales;Carya;";"0.0";"0";"1";"1";"0";"1";"0";"457182";"373894"
"V4mis1";"SILVA (only NR);Eukaryota;Archaeplastida;Chloroplastida;Charophyta;Phragmoplastophyta;Streptophyta;Embryophyta;Tracheophyta;Spermatophyta;Magnoliophyta;Fagales;Castanea;";"0.0";"0";"2";"2";"0";"2";"0";"457181";"373894"
"V4mis1";"SILVA (only NR);Eukaryota;Archaeplastida;Chloroplastida;Charophyta;Phragmoplastophyta;Streptophyta;Embryophyta;Tracheophyta;Spermatophyta;Magnoliophyta;Fagales;Castanopsis;";"0.0";"0";"1";"1";"0";"1";"0";"457182";"373894"
"V4mis1";"SILVA (only NR);Eukaryota;Archaeplastida;Chloroplastida;Charophyta;Phragmoplastophyta;Streptophyta;Embryophyta;Tracheophyta;Spermatophyta;Magnoliophyta;Fagales;Casuarina;";"0.0";"0";"1";"1";"0";"1";"0";"457182";"373894"
"V4mis1";"SILVA (only NR);Eukaryota;Archaeplastida;Chloroplastida;Charophyta;Phragmoplastophyta;Streptophyta;Embryophyta;Tracheophyta;Spermatophyta;Magnoliophyta;Fagales;Lithocarpus;";"0.0";"0";"1";"1";"0";"1";"0";"457182";"373894"
"V4mis1";"SILVA (only NR);Eukaryota;Archaeplastida;Chloroplastida;Charophyta;Phragmoplastophyta;Streptophyta;Embryophyta;Tracheophyta;Spermatophyta;Magnoliophyta;Fagales;Myrica;";"0.0";"0";"3";"3";"0";"3";"0";"457180";"373894"
"V4mis1";"SILVA (only NR);Eukaryota;Archaeplastida;Chloroplastida;Charophyta;Phragmoplastophyta;Streptophyta;Embryophyta;Tracheophyta;Spermatophyta;Magnoliophyta;Fagales;Nothofagus;";"0.0";"0";"1";"1";"0";"1";"0";"457182";"373894"
"V4mis1";"SILVA (only NR);Eukaryota;Archaeplastida;Chloroplastida;Charophyta;Phragmoplastophyta;Streptophyta;Embryophyta;Tracheophyta;Spermatophyta;Magnoliophyta;Fagales;Quercus;";"0.0";"0";"9";"9";"0";"9";"0";"457174";"373894"
"V4mis1";"SILVA (only NR);Eukaryota;Archaeplastida;Chloroplastida;Charophyta;Phragmoplastophyta;Streptophyta;Embryophyta;Tracheophyta;Spermatophyta;Magnoliophyta;Fagales;Ticodendron;";"0.0";"0";"1";"1";"0";"1";"0";"457182";"373894"
"V4mis1";"SILVA (only NR);Eukaryota;Archaeplastida;Chloroplastida;Charophyta;Phragmoplastophyta;Streptophyta;Embryophyta;Tracheophyta;Spermatophyta;Magnoliophyta;Fagales;Trigonobalanus;";"0.0";"0";"1";"1";"0";"1";"0";"457182";"373894"
"V4mis1";"SILVA (only NR);Eukaryota;Archaeplastida;Chloroplastida;Charophyta;Phragmoplastophyta;Streptophyta;Embryophyta;Tracheophyta;Spermatophyta;Magnoliophyta;Garryales;";"0.0";"0";"2";"2";"0";"2";"0";"457181";"373894"
"V4mis1";"SILVA (only NR);Eukaryota;Archaeplastida;Chloroplastida;Charophyta;Phragmoplastophyta;Streptophyta;Embryophyta;Tracheophyta;Spermatophyta;Magnoliophyta;Garryales;Eucommia;";"0.0";"0";"1";"1";"0";"1";"0";"457182";"373894"
"V4mis1";"SILVA (only NR);Eukaryota;Archaeplastida;Chloroplastida;Charophyta;Phragmoplastophyta;Streptophyta;Embryophyta;Tracheophyta;Spermatophyta;Magnoliophyta;Garryales;Garrya;";"0.0";"0";"1";"1";"0";"1";"0";"457182";"373894"
"V4mis1";"SILVA (only NR);Eukaryota;Archaeplastida;Chloroplastida;Charophyta;Phragmoplastophyta;Streptophyta;Embryophyta;Tracheophyta;Spermatophyta;Magnoliophyta;Gentianales;";"0.0";"0";"45";"45";"0";"45";"0";"457138";"373894"
"V4mis1";"SILVA (only NR);Eukaryota;Archaeplastida;Chloroplastida;Charophyta;Phragmoplastophyta;Streptophyta;Embryophyta;Tracheophyta;Spermatophyta;Magnoliophyta;Gentianales;Asclepias;";"0.0";"0";"1";"1";"0";"1";"0";"457182";"373894"
"V4mis1";"SILVA (only NR);Eukaryota;Archaeplastida;Chloroplastida;Charophyta;Phragmoplastophyta;Streptophyta;Embryophyta;Tracheophyta;Spermatophyta;Magnoliophyta;Gentianales;Catharanthus;";"0.0";"0";"8";"8";"0";"8";"0";"457175";"373894"
"V4mis1";"SILVA (only NR);Eukaryota;Archaeplastida;Chloroplastida;Charophyta;Phragmoplastophyta;Streptophyta;Embryophyta;Tracheophyta;Spermatophyta;Magnoliophyta;Gentianales;Chelonanthus;";"0.0";"0";"1";"1";"0";"1";"0";"457182";"373894"
"V4mis1";"SILVA (only NR);Eukaryota;Archaeplastida;Chloroplastida;Charophyta;Phragmoplastophyta;Streptophyta;Embryophyta;Tracheophyta;Spermatophyta;Magnoliophyta;Gentianales;Coffea;";"0.0";"0";"1";"1";"0";"1";"0";"457182";"373894"
"V4mis1";"SILVA (only NR);Eukaryota;Archaeplastida;Chloroplastida;Charophyta;Phragmoplastophyta;Streptophyta;Embryophyta;Tracheophyta;Spermatophyta;Magnoliophyta;Gentianales;Dialypetalanthus;";"0.0";"0";"1";"1";"0";"1";"0";"457182";"373894"
"V4mis1";"SILVA (only NR);Eukaryota;Archaeplastida;Chloroplastida;Charophyta;Phragmoplastophyta;Streptophyta;Embryophyta;Tracheophyta;Spermatophyta;Magnoliophyta;Gentianales;Erithalis;";"0.0";"0";"1";"1";"0";"1";"0";"457182";"373894"
"V4mis1";"SILVA (only NR);Eukaryota;Archaeplastida;Chloroplastida;Charophyta;Phragmoplastophyta;Streptophyta;Embryophyta;Tracheophyta;Spermatophyta;Magnoliophyta;Gentianales;Exacum;";"0.0";"0";"2";"2";"0";"2";"0";"457181";"373894"
"V4mis1";"SILVA (only NR);Eukaryota;Archaeplastida;Chloroplastida;Charophyta;Phragmoplastophyta;Streptophyta;Embryophyta;Tracheophyta;Spermatophyta;Magnoliophyta;Gentianales;Exochaenium;";"0.0";"0";"2";"2";"0";"2";"0";"457181";"373894"
"V4mis1";"SILVA (only NR);Eukaryota;Archaeplastida;Chloroplastida;Charophyta;Phragmoplastophyta;Streptophyta;Embryophyta;Tracheophyta;Spermatophyta;Magnoliophyta;Gentianales;Galium;";"0.0";"0";"1";"1";"0";"1";"0";"457182";"373894"
"V4mis1";"SILVA (only NR);Eukaryota;Archaeplastida;Chloroplastida;Charophyta;Phragmoplastophyta;Streptophyta;Embryophyta;Tracheophyta;Spermatophyta;Magnoliophyta;Gentianales;Gelsemium;";"0.0";"0";"1";"1";"0";"1";"0";"457182";"373894"
"V4mis1";"SILVA (only NR);Eukaryota;Archaeplastida;Chloroplastida;Charophyta;Phragmoplastophyta;Streptophyta;Embryophyta;Tracheophyta;Spermatophyta;Magnoliophyta;Gentianales;Geniostoma;";"0.0";"0";"1";"1";"0";"1";"0";"457182";"373894"
"V4mis1";"SILVA (only NR);Eukaryota;Archaeplastida;Chloroplastida;Charophyta;Phragmoplastophyta;Streptophyta;Embryophyta;Tracheophyta;Spermatophyta;Magnoliophyta;Gentianales;Gentianella;";"0.0";"0";"1";"1";"0";"1";"0";"457182";"373894"
"V4mis1";"SILVA (only NR);Eukaryota;Archaeplastida;Chloroplastida;Charophyta;Phragmoplastophyta;Streptophyta;Embryophyta;Tracheophyta;Spermatophyta;Magnoliophyta;Gentianales;Lisianthius;";"0.0";"0";"1";"1";"0";"1";"0";"457182";"373894"
"V4mis1";"SILVA (only NR);Eukaryota;Archaeplastida;Chloroplastida;Charophyta;Phragmoplastophyta;Streptophyta;Embryophyta;Tracheophyta;Spermatophyta;Magnoliophyta;Gentianales;Lomatogonium;";"0.0";"0";"1";"1";"0";"1";"0";"457182";"373894"
"V4mis1";"SILVA (only NR);Eukaryota;Archaeplastida;Chloroplastida;Charophyta;Phragmoplastophyta;Streptophyta;Embryophyta;Tracheophyta;Spermatophyta;Magnoliophyta;Gentianales;Macrocarpaea;";"0.0";"0";"1";"1";"0";"1";"0";"457182";"373894"
"V4mis1";"SILVA (only NR);Eukaryota;Archaeplastida;Chloroplastida;Charophyta;Phragmoplastophyta;Streptophyta;Embryophyta;Tracheophyta;Spermatophyta;Magnoliophyta;Gentianales;Mitchella;";"0.0";"0";"1";"1";"0";"1";"0";"457182";"373894"
"V4mis1";"SILVA (only NR);Eukaryota;Archaeplastida;Chloroplastida;Charophyta;Phragmoplastophyta;Streptophyta;Embryophyta;Tracheophyta;Spermatophyta;Magnoliophyta;Gentianales;Neolamarckia;";"0.0";"0";"1";"1";"0";"1";"0";"457182";"373894"
"V4mis1";"SILVA (only NR);Eukaryota;Archaeplastida;Chloroplastida;Charophyta;Phragmoplastophyta;Streptophyta;Embryophyta;Tracheophyta;Spermatophyta;Magnoliophyta;Gentianales;Nertera;";"0.0";"0";"1";"1";"0";"1";"0";"457182";"373894"
"V4mis1";"SILVA (only NR);Eukaryota;Archaeplastida;Chloroplastida;Charophyta;Phragmoplastophyta;Streptophyta;Embryophyta;Tracheophyta;Spermatophyta;Magnoliophyta;Gentianales;Ophiorrhiza;";"0.0";"0";"1";"1";"0";"1";"0";"457182";"373894"
"V4mis1";"SILVA (only NR);Eukaryota;Archaeplastida;Chloroplastida;Charophyta;Phragmoplastophyta;Streptophyta;Embryophyta;Tracheophyta;Spermatophyta;Magnoliophyta;Gentianales;Orphium;";"0.0";"0";"1";"1";"0";"1";"0";"457182";"373894"
"V4mis1";"SILVA (only NR);Eukaryota;Archaeplastida;Chloroplastida;Charophyta;Phragmoplastophyta;Streptophyta;Embryophyta;Tracheophyta;Spermatophyta;Magnoliophyta;Gentianales;Pentas;";"0.0";"0";"1";"1";"0";"1";"0";"457182";"373894"
"V4mis1";"SILVA (only NR);Eukaryota;Archaeplastida;Chloroplastida;Charophyta;Phragmoplastophyta;Streptophyta;Embryophyta;Tracheophyta;Spermatophyta;Magnoliophyta;Gentianales;Rhazya;";"0.0";"0";"1";"1";"0";"1";"0";"457182";"373894"
"V4mis1";"SILVA (only NR);Eukaryota;Archaeplastida;Chloroplastida;Charophyta;Phragmoplastophyta;Streptophyta;Embryophyta;Tracheophyta;Spermatophyta;Magnoliophyta;Gentianales;Rogiera;";"0.0";"0";"1";"1";"0";"1";"0";"457182";"373894"
"V4mis1";"SILVA (only NR);Eukaryota;Archaeplastida;Chloroplastida;Charophyta;Phragmoplastophyta;Streptophyta;Embryophyta;Tracheophyta;Spermatophyta;Magnoliophyta;Gentianales;Schinziella;";"0.0";"0";"1";"1";"0";"1";"0";"457182";"373894"
"V4mis1";"SILVA (only NR);Eukaryota;Archaeplastida;Chloroplastida;Charophyta;Phragmoplastophyta;Streptophyta;Embryophyta;Tracheophyta;Spermatophyta;Magnoliophyta;Gentianales;Schultesia;";"0.0";"0";"1";"1";"0";"1";"0";"457182";"373894"
"V4mis1";"SILVA (only NR);Eukaryota;Archaeplastida;Chloroplastida;Charophyta;Phragmoplastophyta;Streptophyta;Embryophyta;Tracheophyta;Spermatophyta;Magnoliophyta;Gentianales;Spigelia;";"0.0";"0";"1";"1";"0";"1";"0";"457182";"373894"
"V4mis1";"SILVA (only NR);Eukaryota;Archaeplastida;Chloroplastida;Charophyta;Phragmoplastophyta;Streptophyta;Embryophyta;Tracheophyta;Spermatophyta;Magnoliophyta;Gentianales;Swertia;";"0.0";"0";"1";"1";"0";"1";"0";"457182";"373894"
"V4mis1";"SILVA (only NR);Eukaryota;Archaeplastida;Chloroplastida;Charophyta;Phragmoplastophyta;Streptophyta;Embryophyta;Tracheophyta;Spermatophyta;Magnoliophyta;Gentianales;Voyria;";"0.0";"0";"8";"8";"0";"8";"0";"457175";"373894"
"V4mis1";"SILVA (only NR);Eukaryota;Archaeplastida;Chloroplastida;Charophyta;Phragmoplastophyta;Streptophyta;Embryophyta;Tracheophyta;Spermatophyta;Magnoliophyta;Gentianales;Voyriella;";"0.0";"0";"1";"1";"0";"1";"0";"457182";"373894"
"V4mis1";"SILVA (only NR);Eukaryota;Archaeplastida;Chloroplastida;Charophyta;Phragmoplastophyta;Streptophyta;Embryophyta;Tracheophyta;Spermatophyta;Magnoliophyta;Geraniales;";"0.0";"0";"5";"5";"0";"5";"0";"457178";"373894"
"V4mis1";"SILVA (only NR);Eukaryota;Archaeplastida;Chloroplastida;Charophyta;Phragmoplastophyta;Streptophyta;Embryophyta;Tracheophyta;Spermatophyta;Magnoliophyta;Geraniales;Bersama;";"0.0";"0";"1";"1";"0";"1";"0";"457182";"373894"
"V4mis1";"SILVA (only NR);Eukaryota;Archaeplastida;Chloroplastida;Charophyta;Phragmoplastophyta;Streptophyta;Embryophyta;Tracheophyta;Spermatophyta;Magnoliophyta;Geraniales;Francoa;";"0.0";"0";"1";"1";"0";"1";"0";"457182";"373894"
"V4mis1";"SILVA (only NR);Eukaryota;Archaeplastida;Chloroplastida;Charophyta;Phragmoplastophyta;Streptophyta;Embryophyta;Tracheophyta;Spermatophyta;Magnoliophyta;Geraniales;Geranium;";"0.0";"0";"1";"1";"0";"1";"0";"457182";"373894"
"V4mis1";"SILVA (only NR);Eukaryota;Archaeplastida;Chloroplastida;Charophyta;Phragmoplastophyta;Streptophyta;Embryophyta;Tracheophyta;Spermatophyta;Magnoliophyta;Geraniales;Greyia;";"0.0";"0";"1";"1";"0";"1";"0";"457182";"373894"
"V4mis1";"SILVA (only NR);Eukaryota;Archaeplastida;Chloroplastida;Charophyta;Phragmoplastophyta;Streptophyta;Embryophyta;Tracheophyta;Spermatophyta;Magnoliophyta;Geraniales;Viviania;";"0.0";"0";"1";"1";"0";"1";"0";"457182";"373894"
"V4mis1";"SILVA (only NR);Eukaryota;Archaeplastida;Chloroplastida;Charophyta;Phragmoplastophyta;Streptophyta;Embryophyta;Tracheophyta;Spermatophyta;Magnoliophyta;Gunnerales;";"0.0";"0";"2";"2";"0";"2";"0";"457181";"373894"
"V4mis1";"SILVA (only NR);Eukaryota;Archaeplastida;Chloroplastida;Charophyta;Phragmoplastophyta;Streptophyta;Embryophyta;Tracheophyta;Spermatophyta;Magnoliophyta;Gunnerales;Gunnera;";"0.0";"0";"1";"1";"0";"1";"0";"457182";"373894"
"V4mis1";"SILVA (only NR);Eukaryota;Archaeplastida;Chloroplastida;Charophyta;Phragmoplastophyta;Streptophyta;Embryophyta;Tracheophyta;Spermatophyta;Magnoliophyta;Gunnerales;Myrothamnus;";"0.0";"0";"1";"1";"0";"1";"0";"457182";"373894"
"V4mis1";"SILVA (only NR);Eukaryota;Archaeplastida;Chloroplastida;Charophyta;Phragmoplastophyta;Streptophyta;Embryophyta;Tracheophyta;Spermatophyta;Magnoliophyta;Huerteales;";"0.0";"0";"1";"1";"0";"1";"0";"457182";"373894"
"V4mis1";"SILVA (only NR);Eukaryota;Archaeplastida;Chloroplastida;Charophyta;Phragmoplastophyta;Streptophyta;Embryophyta;Tracheophyta;Spermatophyta;Magnoliophyta;Huerteales;Tapiscia;";"0.0";"0";"1";"1";"0";"1";"0";"457182";"373894"
"V4mis1";"SILVA (only NR);Eukaryota;Archaeplastida;Chloroplastida;Charophyta;Phragmoplastophyta;Streptophyta;Embryophyta;Tracheophyta;Spermatophyta;Magnoliophyta;Icacinales;";"0.0";"0";"1";"1";"0";"1";"0";"457182";"373894"
"V4mis1";"SILVA (only NR);Eukaryota;Archaeplastida;Chloroplastida;Charophyta;Phragmoplastophyta;Streptophyta;Embryophyta;Tracheophyta;Spermatophyta;Magnoliophyta;Icacinales;Nothapodytes;";"0.0";"0";"1";"1";"0";"1";"0";"457182";"373894"
"V4mis1";"SILVA (only NR);Eukaryota;Archaeplastida;Chloroplastida;Charophyta;Phragmoplastophyta;Streptophyta;Embryophyta;Tracheophyta;Spermatophyta;Magnoliophyta;Incertae Sedis;";"0.0";"0";"2";"2";"0";"2";"0";"457181";"373894"
"V4mis1";"SILVA (only NR);Eukaryota;Archaeplastida;Chloroplastida;Charophyta;Phragmoplastophyta;Streptophyta;Embryophyta;Tracheophyta;Spermatophyta;Magnoliophyta;Incertae Sedis;Oncotheca;";"0.0";"0";"1";"1";"0";"1";"0";"457182";"373894"
"V4mis1";"SILVA (only NR);Eukaryota;Archaeplastida;Chloroplastida;Charophyta;Phragmoplastophyta;Streptophyta;Embryophyta;Tracheophyta;Spermatophyta;Magnoliophyta;Incertae Sedis;Vahlia;";"0.0";"0";"1";"1";"0";"1";"0";"457182";"373894"
"V4mis1";"SILVA (only NR);Eukaryota;Archaeplastida;Chloroplastida;Charophyta;Phragmoplastophyta;Streptophyta;Embryophyta;Tracheophyta;Spermatophyta;Magnoliophyta;Lamiales;";"0.0";"0";"83";"83";"0";"83";"0";"457100";"373894"
"V4mis1";"SILVA (only NR);Eukaryota;Archaeplastida;Chloroplastida;Charophyta;Phragmoplastophyta;Streptophyta;Embryophyta;Tracheophyta;Spermatophyta;Magnoliophyta;Lamiales;Aeginetia;";"0.0";"0";"1";"1";"0";"1";"0";"457182";"373894"
"V4mis1";"SILVA (only NR);Eukaryota;Archaeplastida;Chloroplastida;Charophyta;Phragmoplastophyta;Streptophyta;Embryophyta;Tracheophyta;Spermatophyta;Magnoliophyta;Lamiales;Andrographis;";"0.0";"0";"1";"1";"0";"1";"0";"457182";"373894"
"V4mis1";"SILVA (only NR);Eukaryota;Archaeplastida;Chloroplastida;Charophyta;Phragmoplastophyta;Streptophyta;Embryophyta;Tracheophyta;Spermatophyta;Magnoliophyta;Lamiales;Aphyllon;";"0.0";"0";"2";"2";"0";"2";"0";"457181";"373894"
"V4mis1";"SILVA (only NR);Eukaryota;Archaeplastida;Chloroplastida;Charophyta;Phragmoplastophyta;Streptophyta;Embryophyta;Tracheophyta;Spermatophyta;Magnoliophyta;Lamiales;Avicennia;";"0.0";"0";"1";"1";"0";"1";"0";"457182";"373894"
"V4mis1";"SILVA (only NR);Eukaryota;Archaeplastida;Chloroplastida;Charophyta;Phragmoplastophyta;Streptophyta;Embryophyta;Tracheophyta;Spermatophyta;Magnoliophyta;Lamiales;Bacopa;";"0.0";"0";"1";"1";"0";"1";"0";"457182";"373894"
"V4mis1";"SILVA (only NR);Eukaryota;Archaeplastida;Chloroplastida;Charophyta;Phragmoplastophyta;Streptophyta;Embryophyta;Tracheophyta;Spermatophyta;Magnoliophyta;Lamiales;Byblis;";"0.0";"0";"1";"1";"0";"1";"0";"457182";"373894"
"V4mis1";"SILVA (only NR);Eukaryota;Archaeplastida;Chloroplastida;Charophyta;Phragmoplastophyta;Streptophyta;Embryophyta;Tracheophyta;Spermatophyta;Magnoliophyta;Lamiales;Callitriche;";"0.0";"0";"1";"1";"0";"1";"0";"457182";"373894"
"V4mis1";"SILVA (only NR);Eukaryota;Archaeplastida;Chloroplastida;Charophyta;Phragmoplastophyta;Streptophyta;Embryophyta;Tracheophyta;Spermatophyta;Magnoliophyta;Lamiales;Castilleja;";"0.0";"0";"1";"1";"0";"1";"0";"457182";"373894"
"V4mis1";"SILVA (only NR);Eukaryota;Archaeplastida;Chloroplastida;Charophyta;Phragmoplastophyta;Streptophyta;Embryophyta;Tracheophyta;Spermatophyta;Magnoliophyta;Lamiales;Clerodendrum;";"0.0";"0";"1";"1";"0";"1";"0";"457182";"373894"
"V4mis1";"SILVA (only NR);Eukaryota;Archaeplastida;Chloroplastida;Charophyta;Phragmoplastophyta;Streptophyta;Embryophyta;Tracheophyta;Spermatophyta;Magnoliophyta;Lamiales;Conopholis;";"0.0";"0";"1";"1";"0";"1";"0";"457182";"373894"
"V4mis1";"SILVA (only NR);Eukaryota;Archaeplastida;Chloroplastida;Charophyta;Phragmoplastophyta;Streptophyta;Embryophyta;Tracheophyta;Spermatophyta;Magnoliophyta;Lamiales;Cyrtandra;";"0.0";"0";"1";"1";"0";"1";"0";"457182";"373894"
"V4mis1";"SILVA (only NR);Eukaryota;Archaeplastida;Chloroplastida;Charophyta;Phragmoplastophyta;Streptophyta;Embryophyta;Tracheophyta;Spermatophyta;Magnoliophyta;Lamiales;Digitalis;";"0.0";"0";"1";"1";"0";"1";"0";"457182";"373894"
"V4mis1";"SILVA (only NR);Eukaryota;Archaeplastida;Chloroplastida;Charophyta;Phragmoplastophyta;Streptophyta;Embryophyta;Tracheophyta;Spermatophyta;Magnoliophyta;Lamiales;Dorcoceras;";"0.0";"0";"11";"11";"0";"11";"0";"457172";"373894"
"V4mis1";"SILVA (only NR);Eukaryota;Archaeplastida;Chloroplastida;Charophyta;Phragmoplastophyta;Streptophyta;Embryophyta;Tracheophyta;Spermatophyta;Magnoliophyta;Lamiales;Drymonia;";"0.0";"0";"1";"1";"0";"1";"0";"457182";"373894"
"V4mis1";"SILVA (only NR);Eukaryota;Archaeplastida;Chloroplastida;Charophyta;Phragmoplastophyta;Streptophyta;Embryophyta;Tracheophyta;Spermatophyta;Magnoliophyta;Lamiales;Erythranthe;";"0.0";"0";"15";"15";"0";"15";"0";"457168";"373894"
"V4mis1";"SILVA (only NR);Eukaryota;Archaeplastida;Chloroplastida;Charophyta;Phragmoplastophyta;Streptophyta;Embryophyta;Tracheophyta;Spermatophyta;Magnoliophyta;Lamiales;Fraxinus;";"0.0";"0";"1";"1";"0";"1";"0";"457182";"373894"
"V4mis1";"SILVA (only NR);Eukaryota;Archaeplastida;Chloroplastida;Charophyta;Phragmoplastophyta;Streptophyta;Embryophyta;Tracheophyta;Spermatophyta;Magnoliophyta;Lamiales;Genlisea;";"0.0";"0";"1";"1";"0";"1";"0";"457182";"373894"
"V4mis1";"SILVA (only NR);Eukaryota;Archaeplastida;Chloroplastida;Charophyta;Phragmoplastophyta;Streptophyta;Embryophyta;Tracheophyta;Spermatophyta;Magnoliophyta;Lamiales;Gratiola;";"0.0";"0";"1";"1";"0";"1";"0";"457182";"373894"
"V4mis1";"SILVA (only NR);Eukaryota;Archaeplastida;Chloroplastida;Charophyta;Phragmoplastophyta;Streptophyta;Embryophyta;Tracheophyta;Spermatophyta;Magnoliophyta;Lamiales;Harveya;";"0.0";"0";"1";"1";"0";"1";"0";"457182";"373894"
"V4mis1";"SILVA (only NR);Eukaryota;Archaeplastida;Chloroplastida;Charophyta;Phragmoplastophyta;Streptophyta;Embryophyta;Tracheophyta;Spermatophyta;Magnoliophyta;Lamiales;Hyobanche;";"0.0";"0";"1";"1";"0";"1";"0";"457182";"373894"
"V4mis1";"SILVA (only NR);Eukaryota;Archaeplastida;Chloroplastida;Charophyta;Phragmoplastophyta;Streptophyta;Embryophyta;Tracheophyta;Spermatophyta;Magnoliophyta;Lamiales;Jasminum;";"0.0";"0";"1";"1";"0";"1";"0";"457182";"373894"
"V4mis1";"SILVA (only NR);Eukaryota;Archaeplastida;Chloroplastida;Charophyta;Phragmoplastophyta;Streptophyta;Embryophyta;Tracheophyta;Spermatophyta;Magnoliophyta;Lamiales;Justicia;";"0.0";"0";"1";"1";"0";"1";"0";"457182";"373894"
"V4mis1";"SILVA (only NR);Eukaryota;Archaeplastida;Chloroplastida;Charophyta;Phragmoplastophyta;Streptophyta;Embryophyta;Tracheophyta;Spermatophyta;Magnoliophyta;Lamiales;Lathraea;";"0.0";"0";"1";"1";"0";"1";"0";"457182";"373894"
"V4mis1";"SILVA (only NR);Eukaryota;Archaeplastida;Chloroplastida;Charophyta;Phragmoplastophyta;Streptophyta;Embryophyta;Tracheophyta;Spermatophyta;Magnoliophyta;Lamiales;Lindernia;";"0.0";"0";"1";"1";"0";"1";"0";"457182";"373894"
"V4mis1";"SILVA (only NR);Eukaryota;Archaeplastida;Chloroplastida;Charophyta;Phragmoplastophyta;Streptophyta;Embryophyta;Tracheophyta;Spermatophyta;Magnoliophyta;Lamiales;Mazus;";"0.0";"0";"1";"1";"0";"1";"0";"457182";"373894"
"V4mis1";"SILVA (only NR);Eukaryota;Archaeplastida;Chloroplastida;Charophyta;Phragmoplastophyta;Streptophyta;Embryophyta;Tracheophyta;Spermatophyta;Magnoliophyta;Lamiales;Melampyrum;";"0.0";"0";"1";"1";"0";"1";"0";"457182";"373894"
"V4mis1";"SILVA (only NR);Eukaryota;Archaeplastida;Chloroplastida;Charophyta;Phragmoplastophyta;Streptophyta;Embryophyta;Tracheophyta;Spermatophyta;Magnoliophyta;Lamiales;Monarda;";"0.0";"0";"1";"1";"0";"1";"0";"457182";"373894"
"V4mis1";"SILVA (only NR);Eukaryota;Archaeplastida;Chloroplastida;Charophyta;Phragmoplastophyta;Streptophyta;Embryophyta;Tracheophyta;Spermatophyta;Magnoliophyta;Lamiales;Orobanche;";"0.0";"0";"1";"1";"0";"1";"0";"457182";"373894"
"V4mis1";"SILVA (only NR);Eukaryota;Archaeplastida;Chloroplastida;Charophyta;Phragmoplastophyta;Streptophyta;Embryophyta;Tracheophyta;Spermatophyta;Magnoliophyta;Lamiales;Perilla;";"0.0";"0";"2";"2";"0";"2";"0";"457181";"373894"
"V4mis1";"SILVA (only NR);Eukaryota;Archaeplastida;Chloroplastida;Charophyta;Phragmoplastophyta;Streptophyta;Embryophyta;Tracheophyta;Spermatophyta;Magnoliophyta;Lamiales;Pinguicula;";"0.0";"0";"2";"2";"0";"2";"0";"457181";"373894"
"V4mis1";"SILVA (only NR);Eukaryota;Archaeplastida;Chloroplastida;Charophyta;Phragmoplastophyta;Streptophyta;Embryophyta;Tracheophyta;Spermatophyta;Magnoliophyta;Lamiales;Plantago;";"0.0";"0";"1";"1";"0";"1";"0";"457182";"373894"
"V4mis1";"SILVA (only NR);Eukaryota;Archaeplastida;Chloroplastida;Charophyta;Phragmoplastophyta;Streptophyta;Embryophyta;Tracheophyta;Spermatophyta;Magnoliophyta;Lamiales;Proboscidea;";"0.0";"0";"1";"1";"0";"1";"0";"457182";"373894"
"V4mis1";"SILVA (only NR);Eukaryota;Archaeplastida;Chloroplastida;Charophyta;Phragmoplastophyta;Streptophyta;Embryophyta;Tracheophyta;Spermatophyta;Magnoliophyta;Lamiales;Rehmannia;";"0.0";"0";"2";"2";"0";"2";"0";"457181";"373894"
"V4mis1";"SILVA (only NR);Eukaryota;Archaeplastida;Chloroplastida;Charophyta;Phragmoplastophyta;Streptophyta;Embryophyta;Tracheophyta;Spermatophyta;Magnoliophyta;Lamiales;Rhynchoglossum;";"0.0";"0";"1";"1";"0";"1";"0";"457182";"373894"
"V4mis1";"SILVA (only NR);Eukaryota;Archaeplastida;Chloroplastida;Charophyta;Phragmoplastophyta;Streptophyta;Embryophyta;Tracheophyta;Spermatophyta;Magnoliophyta;Lamiales;Salvia;";"0.0";"0";"1";"1";"0";"1";"0";"457182";"373894"
"V4mis1";"SILVA (only NR);Eukaryota;Archaeplastida;Chloroplastida;Charophyta;Phragmoplastophyta;Streptophyta;Embryophyta;Tracheophyta;Spermatophyta;Magnoliophyta;Lamiales;Schlegelia;";"0.0";"0";"1";"1";"0";"1";"0";"457182";"373894"
"V4mis1";"SILVA (only NR);Eukaryota;Archaeplastida;Chloroplastida;Charophyta;Phragmoplastophyta;Streptophyta;Embryophyta;Tracheophyta;Spermatophyta;Magnoliophyta;Lamiales;Scrophularia;";"0.0";"0";"1";"1";"0";"1";"0";"457182";"373894"
"V4mis1";"SILVA (only NR);Eukaryota;Archaeplastida;Chloroplastida;Charophyta;Phragmoplastophyta;Streptophyta;Embryophyta;Tracheophyta;Spermatophyta;Magnoliophyta;Lamiales;Sesamum;";"0.0";"0";"13";"13";"0";"13";"0";"457170";"373894"
"V4mis1";"SILVA (only NR);Eukaryota;Archaeplastida;Chloroplastida;Charophyta;Phragmoplastophyta;Streptophyta;Embryophyta;Tracheophyta;Spermatophyta;Magnoliophyta;Lamiales;Streptocarpus;";"0.0";"0";"1";"1";"0";"1";"0";"457182";"373894"
"V4mis1";"SILVA (only NR);Eukaryota;Archaeplastida;Chloroplastida;Charophyta;Phragmoplastophyta;Streptophyta;Embryophyta;Tracheophyta;Spermatophyta;Magnoliophyta;Lamiales;Tectona;";"0.0";"0";"1";"1";"0";"1";"0";"457182";"373894"
"V4mis1";"SILVA (only NR);Eukaryota;Archaeplastida;Chloroplastida;Charophyta;Phragmoplastophyta;Streptophyta;Embryophyta;Tracheophyta;Spermatophyta;Magnoliophyta;Lamiales;Utricularia;";"0.0";"0";"2";"2";"0";"2";"0";"457181";"373894"
"V4mis1";"SILVA (only NR);Eukaryota;Archaeplastida;Chloroplastida;Charophyta;Phragmoplastophyta;Streptophyta;Embryophyta;Tracheophyta;Spermatophyta;Magnoliophyta;Lamiales;Veronica;";"0.0";"0";"1";"1";"0";"1";"0";"457182";"373894"
"V4mis1";"SILVA (only NR);Eukaryota;Archaeplastida;Chloroplastida;Charophyta;Phragmoplastophyta;Streptophyta;Embryophyta;Tracheophyta;Spermatophyta;Magnoliophyta;Laurales;";"0.0";"0";"12";"12";"0";"12";"0";"457171";"373894"
"V4mis1";"SILVA (only NR);Eukaryota;Archaeplastida;Chloroplastida;Charophyta;Phragmoplastophyta;Streptophyta;Embryophyta;Tracheophyta;Spermatophyta;Magnoliophyta;Laurales;Calycanthus;";"0.0";"0";"1";"1";"0";"1";"0";"457182";"373894"
"V4mis1";"SILVA (only NR);Eukaryota;Archaeplastida;Chloroplastida;Charophyta;Phragmoplastophyta;Streptophyta;Embryophyta;Tracheophyta;Spermatophyta;Magnoliophyta;Laurales;Cassytha;";"0.0";"0";"1";"1";"0";"1";"0";"457182";"373894"
"V4mis1";"SILVA (only NR);Eukaryota;Archaeplastida;Chloroplastida;Charophyta;Phragmoplastophyta;Streptophyta;Embryophyta;Tracheophyta;Spermatophyta;Magnoliophyta;Laurales;Cryptocarya;";"0.0";"0";"1";"1";"0";"1";"0";"457182";"373894"
"V4mis1";"SILVA (only NR);Eukaryota;Archaeplastida;Chloroplastida;Charophyta;Phragmoplastophyta;Streptophyta;Embryophyta;Tracheophyta;Spermatophyta;Magnoliophyta;Laurales;Doryphora;";"0.0";"0";"1";"1";"0";"1";"0";"457182";"373894"
"V4mis1";"SILVA (only NR);Eukaryota;Archaeplastida;Chloroplastida;Charophyta;Phragmoplastophyta;Streptophyta;Embryophyta;Tracheophyta;Spermatophyta;Magnoliophyta;Laurales;Gomortega;";"0.0";"0";"1";"1";"0";"1";"0";"457182";"373894"
"V4mis1";"SILVA (only NR);Eukaryota;Archaeplastida;Chloroplastida;Charophyta;Phragmoplastophyta;Streptophyta;Embryophyta;Tracheophyta;Spermatophyta;Magnoliophyta;Laurales;Gyrocarpus;";"0.0";"0";"1";"1";"0";"1";"0";"457182";"373894"
"V4mis1";"SILVA (only NR);Eukaryota;Archaeplastida;Chloroplastida;Charophyta;Phragmoplastophyta;Streptophyta;Embryophyta;Tracheophyta;Spermatophyta;Magnoliophyta;Laurales;Hedycarya;";"0.0";"0";"1";"1";"0";"1";"0";"457182";"373894"
"V4mis1";"SILVA (only NR);Eukaryota;Archaeplastida;Chloroplastida;Charophyta;Phragmoplastophyta;Streptophyta;Embryophyta;Tracheophyta;Spermatophyta;Magnoliophyta;Laurales;Hernandia;";"0.0";"0";"1";"1";"0";"1";"0";"457182";"373894"
"V4mis1";"SILVA (only NR);Eukaryota;Archaeplastida;Chloroplastida;Charophyta;Phragmoplastophyta;Streptophyta;Embryophyta;Tracheophyta;Spermatophyta;Magnoliophyta;Laurales;Idiospermum;";"0.0";"0";"1";"1";"0";"1";"0";"457182";"373894"
"V4mis1";"SILVA (only NR);Eukaryota;Archaeplastida;Chloroplastida;Charophyta;Phragmoplastophyta;Streptophyta;Embryophyta;Tracheophyta;Spermatophyta;Magnoliophyta;Laurales;Laurus;";"0.0";"0";"1";"1";"0";"1";"0";"457182";"373894"
"V4mis1";"SILVA (only NR);Eukaryota;Archaeplastida;Chloroplastida;Charophyta;Phragmoplastophyta;Streptophyta;Embryophyta;Tracheophyta;Spermatophyta;Magnoliophyta;Laurales;Palmeria;";"0.0";"0";"1";"1";"0";"1";"0";"457182";"373894"
"V4mis1";"SILVA (only NR);Eukaryota;Archaeplastida;Chloroplastida;Charophyta;Phragmoplastophyta;Streptophyta;Embryophyta;Tracheophyta;Spermatophyta;Magnoliophyta;Laurales;Siparuna;";"0.0";"0";"1";"1";"0";"1";"0";"457182";"373894"
"V4mis1";"SILVA (only NR);Eukaryota;Archaeplastida;Chloroplastida;Charophyta;Phragmoplastophyta;Streptophyta;Embryophyta;Tracheophyta;Spermatophyta;Magnoliophyta;Liliopsida;";"2.1";"18.1";"671";"669";"14";"655";"2";"456514";"373880"
"V4mis1";"SILVA (only NR);Eukaryota;Archaeplastida;Chloroplastida;Charophyta;Phragmoplastophyta;Streptophyta;Embryophyta;Tracheophyta;Spermatophyta;Magnoliophyta;Liliopsida;Acorales;";"0.0";"0";"2";"2";"0";"2";"0";"457181";"373894"
"V4mis1";"SILVA (only NR);Eukaryota;Archaeplastida;Chloroplastida;Charophyta;Phragmoplastophyta;Streptophyta;Embryophyta;Tracheophyta;Spermatophyta;Magnoliophyta;Liliopsida;Acorales;Acorus;";"0.0";"0";"2";"2";"0";"2";"0";"457181";"373894"
"V4mis1";"SILVA (only NR);Eukaryota;Archaeplastida;Chloroplastida;Charophyta;Phragmoplastophyta;Streptophyta;Embryophyta;Tracheophyta;Spermatophyta;Magnoliophyta;Liliopsida;Alismatales;";"0.0";"0";"46";"46";"0";"46";"0";"457137";"373894"
"V4mis1";"SILVA (only NR);Eukaryota;Archaeplastida;Chloroplastida;Charophyta;Phragmoplastophyta;Streptophyta;Embryophyta;Tracheophyta;Spermatophyta;Magnoliophyta;Liliopsida;Alismatales;Alisma;";"0.0";"0";"1";"1";"0";"1";"0";"457182";"373894"
"V4mis1";"SILVA (only NR);Eukaryota;Archaeplastida;Chloroplastida;Charophyta;Phragmoplastophyta;Streptophyta;Embryophyta;Tracheophyta;Spermatophyta;Magnoliophyta;Liliopsida;Alismatales;Aponogeton;";"0.0";"0";"1";"1";"0";"1";"0";"457182";"373894"
"V4mis1";"SILVA (only NR);Eukaryota;Archaeplastida;Chloroplastida;Charophyta;Phragmoplastophyta;Streptophyta;Embryophyta;Tracheophyta;Spermatophyta;Magnoliophyta;Liliopsida;Alismatales;Arisaema;";"0.0";"0";"1";"1";"0";"1";"0";"457182";"373894"
"V4mis1";"SILVA (only NR);Eukaryota;Archaeplastida;Chloroplastida;Charophyta;Phragmoplastophyta;Streptophyta;Embryophyta;Tracheophyta;Spermatophyta;Magnoliophyta;Liliopsida;Alismatales;Blyxa;";"0.0";"0";"2";"2";"0";"2";"0";"457181";"373894"
"V4mis1";"SILVA (only NR);Eukaryota;Archaeplastida;Chloroplastida;Charophyta;Phragmoplastophyta;Streptophyta;Embryophyta;Tracheophyta;Spermatophyta;Magnoliophyta;Liliopsida;Alismatales;Butomus;";"0.0";"0";"1";"1";"0";"1";"0";"457182";"373894"
"V4mis1";"SILVA (only NR);Eukaryota;Archaeplastida;Chloroplastida;Charophyta;Phragmoplastophyta;Streptophyta;Embryophyta;Tracheophyta;Spermatophyta;Magnoliophyta;Liliopsida;Alismatales;Caldesia;";"0.0";"0";"1";"1";"0";"1";"0";"457182";"373894"
"V4mis1";"SILVA (only NR);Eukaryota;Archaeplastida;Chloroplastida;Charophyta;Phragmoplastophyta;Streptophyta;Embryophyta;Tracheophyta;Spermatophyta;Magnoliophyta;Liliopsida;Alismatales;Calla;";"0.0";"0";"1";"1";"0";"1";"0";"457182";"373894"
"V4mis1";"SILVA (only NR);Eukaryota;Archaeplastida;Chloroplastida;Charophyta;Phragmoplastophyta;Streptophyta;Embryophyta;Tracheophyta;Spermatophyta;Magnoliophyta;Liliopsida;Alismatales;Cymodocea;";"0.0";"0";"2";"2";"0";"2";"0";"457181";"373894"
"V4mis1";"SILVA (only NR);Eukaryota;Archaeplastida;Chloroplastida;Charophyta;Phragmoplastophyta;Streptophyta;Embryophyta;Tracheophyta;Spermatophyta;Magnoliophyta;Liliopsida;Alismatales;Echinodorus;";"0.0";"0";"1";"1";"0";"1";"0";"457182";"373894"
"V4mis1";"SILVA (only NR);Eukaryota;Archaeplastida;Chloroplastida;Charophyta;Phragmoplastophyta;Streptophyta;Embryophyta;Tracheophyta;Spermatophyta;Magnoliophyta;Liliopsida;Alismatales;Egeria;";"0.0";"0";"1";"1";"0";"1";"0";"457182";"373894"
"V4mis1";"SILVA (only NR);Eukaryota;Archaeplastida;Chloroplastida;Charophyta;Phragmoplastophyta;Streptophyta;Embryophyta;Tracheophyta;Spermatophyta;Magnoliophyta;Liliopsida;Alismatales;Enhalus;";"0.0";"0";"1";"1";"0";"1";"0";"457182";"373894"
"V4mis1";"SILVA (only NR);Eukaryota;Archaeplastida;Chloroplastida;Charophyta;Phragmoplastophyta;Streptophyta;Embryophyta;Tracheophyta;Spermatophyta;Magnoliophyta;Liliopsida;Alismatales;Gymnostachys;";"0.0";"0";"1";"1";"0";"1";"0";"457182";"373894"
"V4mis1";"SILVA (only NR);Eukaryota;Archaeplastida;Chloroplastida;Charophyta;Phragmoplastophyta;Streptophyta;Embryophyta;Tracheophyta;Spermatophyta;Magnoliophyta;Liliopsida;Alismatales;Hydrilla;";"0.0";"0";"1";"1";"0";"1";"0";"457182";"373894"
"V4mis1";"SILVA (only NR);Eukaryota;Archaeplastida;Chloroplastida;Charophyta;Phragmoplastophyta;Streptophyta;Embryophyta;Tracheophyta;Spermatophyta;Magnoliophyta;Liliopsida;Alismatales;Hydrocharis;";"0.0";"0";"1";"1";"0";"1";"0";"457182";"373894"
"V4mis1";"SILVA (only NR);Eukaryota;Archaeplastida;Chloroplastida;Charophyta;Phragmoplastophyta;Streptophyta;Embryophyta;Tracheophyta;Spermatophyta;Magnoliophyta;Liliopsida;Alismatales;Hydrocleys;";"0.0";"0";"1";"1";"0";"1";"0";"457182";"373894"
"V4mis1";"SILVA (only NR);Eukaryota;Archaeplastida;Chloroplastida;Charophyta;Phragmoplastophyta;Streptophyta;Embryophyta;Tracheophyta;Spermatophyta;Magnoliophyta;Liliopsida;Alismatales;Lemna;";"0.0";"0";"2";"2";"0";"2";"0";"457181";"373894"
"V4mis1";"SILVA (only NR);Eukaryota;Archaeplastida;Chloroplastida;Charophyta;Phragmoplastophyta;Streptophyta;Embryophyta;Tracheophyta;Spermatophyta;Magnoliophyta;Liliopsida;Alismatales;Lilaea;";"0.0";"0";"1";"1";"0";"1";"0";"457182";"373894"
"V4mis1";"SILVA (only NR);Eukaryota;Archaeplastida;Chloroplastida;Charophyta;Phragmoplastophyta;Streptophyta;Embryophyta;Tracheophyta;Spermatophyta;Magnoliophyta;Liliopsida;Alismatales;Limnocharis;";"0.0";"0";"1";"1";"0";"1";"0";"457182";"373894"
"V4mis1";"SILVA (only NR);Eukaryota;Archaeplastida;Chloroplastida;Charophyta;Phragmoplastophyta;Streptophyta;Embryophyta;Tracheophyta;Spermatophyta;Magnoliophyta;Liliopsida;Alismatales;Limnophyton;";"0.0";"0";"1";"1";"0";"1";"0";"457182";"373894"
"V4mis1";"SILVA (only NR);Eukaryota;Archaeplastida;Chloroplastida;Charophyta;Phragmoplastophyta;Streptophyta;Embryophyta;Tracheophyta;Spermatophyta;Magnoliophyta;Liliopsida;Alismatales;Najas;";"0.0";"0";"2";"2";"0";"2";"0";"457181";"373894"
"V4mis1";"SILVA (only NR);Eukaryota;Archaeplastida;Chloroplastida;Charophyta;Phragmoplastophyta;Streptophyta;Embryophyta;Tracheophyta;Spermatophyta;Magnoliophyta;Liliopsida;Alismatales;Orontium;";"0.0";"0";"1";"1";"0";"1";"0";"457182";"373894"
"V4mis1";"SILVA (only NR);Eukaryota;Archaeplastida;Chloroplastida;Charophyta;Phragmoplastophyta;Streptophyta;Embryophyta;Tracheophyta;Spermatophyta;Magnoliophyta;Liliopsida;Alismatales;Ottelia;";"0.0";"0";"1";"1";"0";"1";"0";"457182";"373894"
"V4mis1";"SILVA (only NR);Eukaryota;Archaeplastida;Chloroplastida;Charophyta;Phragmoplastophyta;Streptophyta;Embryophyta;Tracheophyta;Spermatophyta;Magnoliophyta;Liliopsida;Alismatales;Phyllospadix;";"0.0";"0";"1";"1";"0";"1";"0";"457182";"373894"
"V4mis1";"SILVA (only NR);Eukaryota;Archaeplastida;Chloroplastida;Charophyta;Phragmoplastophyta;Streptophyta;Embryophyta;Tracheophyta;Spermatophyta;Magnoliophyta;Liliopsida;Alismatales;Pistia;";"0.0";"0";"1";"1";"0";"1";"0";"457182";"373894"
"V4mis1";"SILVA (only NR);Eukaryota;Archaeplastida;Chloroplastida;Charophyta;Phragmoplastophyta;Streptophyta;Embryophyta;Tracheophyta;Spermatophyta;Magnoliophyta;Liliopsida;Alismatales;Pleea;";"0.0";"0";"1";"1";"0";"1";"0";"457182";"373894"
"V4mis1";"SILVA (only NR);Eukaryota;Archaeplastida;Chloroplastida;Charophyta;Phragmoplastophyta;Streptophyta;Embryophyta;Tracheophyta;Spermatophyta;Magnoliophyta;Liliopsida;Alismatales;Ruppia;";"0.0";"0";"1";"1";"0";"1";"0";"457182";"373894"
"V4mis1";"SILVA (only NR);Eukaryota;Archaeplastida;Chloroplastida;Charophyta;Phragmoplastophyta;Streptophyta;Embryophyta;Tracheophyta;Spermatophyta;Magnoliophyta;Liliopsida;Alismatales;Sagittaria;";"0.0";"0";"1";"1";"0";"1";"0";"457182";"373894"
"V4mis1";"SILVA (only NR);Eukaryota;Archaeplastida;Chloroplastida;Charophyta;Phragmoplastophyta;Streptophyta;Embryophyta;Tracheophyta;Spermatophyta;Magnoliophyta;Liliopsida;Alismatales;Scheuchzeria;";"0.0";"0";"1";"1";"0";"1";"0";"457182";"373894"
"V4mis1";"SILVA (only NR);Eukaryota;Archaeplastida;Chloroplastida;Charophyta;Phragmoplastophyta;Streptophyta;Embryophyta;Tracheophyta;Spermatophyta;Magnoliophyta;Liliopsida;Alismatales;Spathiphyllum;";"0.0";"0";"1";"1";"0";"1";"0";"457182";"373894"
"V4mis1";"SILVA (only NR);Eukaryota;Archaeplastida;Chloroplastida;Charophyta;Phragmoplastophyta;Streptophyta;Embryophyta;Tracheophyta;Spermatophyta;Magnoliophyta;Liliopsida;Alismatales;Spirodela;";"0.0";"0";"1";"1";"0";"1";"0";"457182";"373894"
"V4mis1";"SILVA (only NR);Eukaryota;Archaeplastida;Chloroplastida;Charophyta;Phragmoplastophyta;Streptophyta;Embryophyta;Tracheophyta;Spermatophyta;Magnoliophyta;Liliopsida;Alismatales;Stratiotes;";"0.0";"0";"1";"1";"0";"1";"0";"457182";"373894"
"V4mis1";"SILVA (only NR);Eukaryota;Archaeplastida;Chloroplastida;Charophyta;Phragmoplastophyta;Streptophyta;Embryophyta;Tracheophyta;Spermatophyta;Magnoliophyta;Liliopsida;Alismatales;Stuckenia;";"0.0";"0";"1";"1";"0";"1";"0";"457182";"373894"
"V4mis1";"SILVA (only NR);Eukaryota;Archaeplastida;Chloroplastida;Charophyta;Phragmoplastophyta;Streptophyta;Embryophyta;Tracheophyta;Spermatophyta;Magnoliophyta;Liliopsida;Alismatales;Syringodium;";"0.0";"0";"1";"1";"0";"1";"0";"457182";"373894"
"V4mis1";"SILVA (only NR);Eukaryota;Archaeplastida;Chloroplastida;Charophyta;Phragmoplastophyta;Streptophyta;Embryophyta;Tracheophyta;Spermatophyta;Magnoliophyta;Liliopsida;Alismatales;Thalassia;";"0.0";"0";"2";"2";"0";"2";"0";"457181";"373894"
"V4mis1";"SILVA (only NR);Eukaryota;Archaeplastida;Chloroplastida;Charophyta;Phragmoplastophyta;Streptophyta;Embryophyta;Tracheophyta;Spermatophyta;Magnoliophyta;Liliopsida;Alismatales;Tofieldia;";"0.0";"0";"1";"1";"0";"1";"0";"457182";"373894"
"V4mis1";"SILVA (only NR);Eukaryota;Archaeplastida;Chloroplastida;Charophyta;Phragmoplastophyta;Streptophyta;Embryophyta;Tracheophyta;Spermatophyta;Magnoliophyta;Liliopsida;Alismatales;Triglochin;";"0.0";"0";"1";"1";"0";"1";"0";"457182";"373894"
"V4mis1";"SILVA (only NR);Eukaryota;Archaeplastida;Chloroplastida;Charophyta;Phragmoplastophyta;Streptophyta;Embryophyta;Tracheophyta;Spermatophyta;Magnoliophyta;Liliopsida;Alismatales;Wolffia;";"0.0";"0";"3";"3";"0";"3";"0";"457180";"373894"
"V4mis1";"SILVA (only NR);Eukaryota;Archaeplastida;Chloroplastida;Charophyta;Phragmoplastophyta;Streptophyta;Embryophyta;Tracheophyta;Spermatophyta;Magnoliophyta;Liliopsida;Alismatales;Zannichellia;";"0.0";"0";"1";"1";"0";"1";"0";"457182";"373894"
"V4mis1";"SILVA (only NR);Eukaryota;Archaeplastida;Chloroplastida;Charophyta;Phragmoplastophyta;Streptophyta;Embryophyta;Tracheophyta;Spermatophyta;Magnoliophyta;Liliopsida;Alismatales;Zantedeschia;";"0.0";"0";"1";"1";"0";"1";"0";"457182";"373894"
"V4mis1";"SILVA (only NR);Eukaryota;Archaeplastida;Chloroplastida;Charophyta;Phragmoplastophyta;Streptophyta;Embryophyta;Tracheophyta;Spermatophyta;Magnoliophyta;Liliopsida;Arecales;";"0.0";"0";"27";"27";"0";"27";"0";"457156";"373894"
"V4mis1";"SILVA (only NR);Eukaryota;Archaeplastida;Chloroplastida;Charophyta;Phragmoplastophyta;Streptophyta;Embryophyta;Tracheophyta;Spermatophyta;Magnoliophyta;Liliopsida;Arecales;Aphandra;";"0.0";"0";"1";"1";"0";"1";"0";"457182";"373894"
"V4mis1";"SILVA (only NR);Eukaryota;Archaeplastida;Chloroplastida;Charophyta;Phragmoplastophyta;Streptophyta;Embryophyta;Tracheophyta;Spermatophyta;Magnoliophyta;Liliopsida;Arecales;Arenga;";"0.0";"0";"1";"1";"0";"1";"0";"457182";"373894"
"V4mis1";"SILVA (only NR);Eukaryota;Archaeplastida;Chloroplastida;Charophyta;Phragmoplastophyta;Streptophyta;Embryophyta;Tracheophyta;Spermatophyta;Magnoliophyta;Liliopsida;Arecales;Bentinckia;";"0.0";"0";"1";"1";"0";"1";"0";"457182";"373894"
"V4mis1";"SILVA (only NR);Eukaryota;Archaeplastida;Chloroplastida;Charophyta;Phragmoplastophyta;Streptophyta;Embryophyta;Tracheophyta;Spermatophyta;Magnoliophyta;Liliopsida;Arecales;Borassus;";"0.0";"0";"1";"1";"0";"1";"0";"457182";"373894"
"V4mis1";"SILVA (only NR);Eukaryota;Archaeplastida;Chloroplastida;Charophyta;Phragmoplastophyta;Streptophyta;Embryophyta;Tracheophyta;Spermatophyta;Magnoliophyta;Liliopsida;Arecales;Calamus;";"0.0";"0";"1";"1";"0";"1";"0";"457182";"373894"
"V4mis1";"SILVA (only NR);Eukaryota;Archaeplastida;Chloroplastida;Charophyta;Phragmoplastophyta;Streptophyta;Embryophyta;Tracheophyta;Spermatophyta;Magnoliophyta;Liliopsida;Arecales;Calyptrocalyx;";"0.0";"0";"1";"1";"0";"1";"0";"457182";"373894"
"V4mis1";"SILVA (only NR);Eukaryota;Archaeplastida;Chloroplastida;Charophyta;Phragmoplastophyta;Streptophyta;Embryophyta;Tracheophyta;Spermatophyta;Magnoliophyta;Liliopsida;Arecales;Calyptronoma;";"0.0";"0";"1";"1";"0";"1";"0";"457182";"373894"
"V4mis1";"SILVA (only NR);Eukaryota;Archaeplastida;Chloroplastida;Charophyta;Phragmoplastophyta;Streptophyta;Embryophyta;Tracheophyta;Spermatophyta;Magnoliophyta;Liliopsida;Arecales;Caryota;";"0.0";"0";"1";"1";"0";"1";"0";"457182";"373894"
"V4mis1";"SILVA (only NR);Eukaryota;Archaeplastida;Chloroplastida;Charophyta;Phragmoplastophyta;Streptophyta;Embryophyta;Tracheophyta;Spermatophyta;Magnoliophyta;Liliopsida;Arecales;Chamaedorea;";"0.0";"0";"1";"1";"0";"1";"0";"457182";"373894"
"V4mis1";"SILVA (only NR);Eukaryota;Archaeplastida;Chloroplastida;Charophyta;Phragmoplastophyta;Streptophyta;Embryophyta;Tracheophyta;Spermatophyta;Magnoliophyta;Liliopsida;Arecales;Chamaerops;";"0.0";"0";"1";"1";"0";"1";"0";"457182";"373894"
"V4mis1";"SILVA (only NR);Eukaryota;Archaeplastida;Chloroplastida;Charophyta;Phragmoplastophyta;Streptophyta;Embryophyta;Tracheophyta;Spermatophyta;Magnoliophyta;Liliopsida;Arecales;Corypha;";"0.0";"0";"1";"1";"0";"1";"0";"457182";"373894"
"V4mis1";"SILVA (only NR);Eukaryota;Archaeplastida;Chloroplastida;Charophyta;Phragmoplastophyta;Streptophyta;Embryophyta;Tracheophyta;Spermatophyta;Magnoliophyta;Liliopsida;Arecales;Dictyocaryum;";"0.0";"0";"1";"1";"0";"1";"0";"457182";"373894"
"V4mis1";"SILVA (only NR);Eukaryota;Archaeplastida;Chloroplastida;Charophyta;Phragmoplastophyta;Streptophyta;Embryophyta;Tracheophyta;Spermatophyta;Magnoliophyta;Liliopsida;Arecales;Hydriastele;";"0.0";"0";"2";"2";"0";"2";"0";"457181";"373894"
"V4mis1";"SILVA (only NR);Eukaryota;Archaeplastida;Chloroplastida;Charophyta;Phragmoplastophyta;Streptophyta;Embryophyta;Tracheophyta;Spermatophyta;Magnoliophyta;Liliopsida;Arecales;Hyophorbe;";"0.0";"0";"1";"1";"0";"1";"0";"457182";"373894"
"V4mis1";"SILVA (only NR);Eukaryota;Archaeplastida;Chloroplastida;Charophyta;Phragmoplastophyta;Streptophyta;Embryophyta;Tracheophyta;Spermatophyta;Magnoliophyta;Liliopsida;Arecales;Hyphaene;";"0.0";"0";"1";"1";"0";"1";"0";"457182";"373894"
"V4mis1";"SILVA (only NR);Eukaryota;Archaeplastida;Chloroplastida;Charophyta;Phragmoplastophyta;Streptophyta;Embryophyta;Tracheophyta;Spermatophyta;Magnoliophyta;Liliopsida;Arecales;Iriartea;";"0.0";"0";"1";"1";"0";"1";"0";"457182";"373894"
"V4mis1";"SILVA (only NR);Eukaryota;Archaeplastida;Chloroplastida;Charophyta;Phragmoplastophyta;Streptophyta;Embryophyta;Tracheophyta;Spermatophyta;Magnoliophyta;Liliopsida;Arecales;Licuala;";"0.0";"0";"1";"1";"0";"1";"0";"457182";"373894"
"V4mis1";"SILVA (only NR);Eukaryota;Archaeplastida;Chloroplastida;Charophyta;Phragmoplastophyta;Streptophyta;Embryophyta;Tracheophyta;Spermatophyta;Magnoliophyta;Liliopsida;Arecales;Orania;";"0.0";"0";"1";"1";"0";"1";"0";"457182";"373894"
"V4mis1";"SILVA (only NR);Eukaryota;Archaeplastida;Chloroplastida;Charophyta;Phragmoplastophyta;Streptophyta;Embryophyta;Tracheophyta;Spermatophyta;Magnoliophyta;Liliopsida;Arecales;Phoenix;";"0.0";"0";"3";"3";"0";"3";"0";"457180";"373894"
"V4mis1";"SILVA (only NR);Eukaryota;Archaeplastida;Chloroplastida;Charophyta;Phragmoplastophyta;Streptophyta;Embryophyta;Tracheophyta;Spermatophyta;Magnoliophyta;Liliopsida;Arecales;Phytelephas;";"0.0";"0";"1";"1";"0";"1";"0";"457182";"373894"
"V4mis1";"SILVA (only NR);Eukaryota;Archaeplastida;Chloroplastida;Charophyta;Phragmoplastophyta;Streptophyta;Embryophyta;Tracheophyta;Spermatophyta;Magnoliophyta;Liliopsida;Arecales;Ravenea;";"0.0";"0";"1";"1";"0";"1";"0";"457182";"373894"
"V4mis1";"SILVA (only NR);Eukaryota;Archaeplastida;Chloroplastida;Charophyta;Phragmoplastophyta;Streptophyta;Embryophyta;Tracheophyta;Spermatophyta;Magnoliophyta;Liliopsida;Arecales;Sabal;";"0.0";"0";"1";"1";"0";"1";"0";"457182";"373894"
"V4mis1";"SILVA (only NR);Eukaryota;Archaeplastida;Chloroplastida;Charophyta;Phragmoplastophyta;Streptophyta;Embryophyta;Tracheophyta;Spermatophyta;Magnoliophyta;Liliopsida;Arecales;Salacca;";"0.0";"0";"1";"1";"0";"1";"0";"457182";"373894"
"V4mis1";"SILVA (only NR);Eukaryota;Archaeplastida;Chloroplastida;Charophyta;Phragmoplastophyta;Streptophyta;Embryophyta;Tracheophyta;Spermatophyta;Magnoliophyta;Liliopsida;Arecales;Wendlandiella;";"0.0";"0";"1";"1";"0";"1";"0";"457182";"373894"
"V4mis1";"SILVA (only NR);Eukaryota;Archaeplastida;Chloroplastida;Charophyta;Phragmoplastophyta;Streptophyta;Embryophyta;Tracheophyta;Spermatophyta;Magnoliophyta;Liliopsida;Asparagales;";"0.0";"0";"137";"137";"0";"137";"0";"457046";"373894"
"V4mis1";"SILVA (only NR);Eukaryota;Archaeplastida;Chloroplastida;Charophyta;Phragmoplastophyta;Streptophyta;Embryophyta;Tracheophyta;Spermatophyta;Magnoliophyta;Liliopsida;Asparagales;Agapanthus;";"0.0";"0";"1";"1";"0";"1";"0";"457182";"373894"
"V4mis1";"SILVA (only NR);Eukaryota;Archaeplastida;Chloroplastida;Charophyta;Phragmoplastophyta;Streptophyta;Embryophyta;Tracheophyta;Spermatophyta;Magnoliophyta;Liliopsida;Asparagales;Allium;";"0.0";"0";"12";"12";"0";"12";"0";"457171";"373894"
"V4mis1";"SILVA (only NR);Eukaryota;Archaeplastida;Chloroplastida;Charophyta;Phragmoplastophyta;Streptophyta;Embryophyta;Tracheophyta;Spermatophyta;Magnoliophyta;Liliopsida;Asparagales;Aloe;";"0.0";"0";"1";"1";"0";"1";"0";"457182";"373894"
"V4mis1";"SILVA (only NR);Eukaryota;Archaeplastida;Chloroplastida;Charophyta;Phragmoplastophyta;Streptophyta;Embryophyta;Tracheophyta;Spermatophyta;Magnoliophyta;Liliopsida;Asparagales;Aphyllanthes;";"0.0";"0";"1";"1";"0";"1";"0";"457182";"373894"
"V4mis1";"SILVA (only NR);Eukaryota;Archaeplastida;Chloroplastida;Charophyta;Phragmoplastophyta;Streptophyta;Embryophyta;Tracheophyta;Spermatophyta;Magnoliophyta;Liliopsida;Asparagales;Apostasia;";"0.0";"0";"2";"2";"0";"2";"0";"457181";"373894"
"V4mis1";"SILVA (only NR);Eukaryota;Archaeplastida;Chloroplastida;Charophyta;Phragmoplastophyta;Streptophyta;Embryophyta;Tracheophyta;Spermatophyta;Magnoliophyta;Liliopsida;Asparagales;Asparagus;";"0.0";"0";"14";"14";"0";"14";"0";"457169";"373894"
"V4mis1";"SILVA (only NR);Eukaryota;Archaeplastida;Chloroplastida;Charophyta;Phragmoplastophyta;Streptophyta;Embryophyta;Tracheophyta;Spermatophyta;Magnoliophyta;Liliopsida;Asparagales;Aspidogyne;";"0.0";"0";"1";"1";"0";"1";"0";"457182";"373894"
"V4mis1";"SILVA (only NR);Eukaryota;Archaeplastida;Chloroplastida;Charophyta;Phragmoplastophyta;Streptophyta;Embryophyta;Tracheophyta;Spermatophyta;Magnoliophyta;Liliopsida;Asparagales;Astelia;";"0.0";"0";"1";"1";"0";"1";"0";"457182";"373894"
"V4mis1";"SILVA (only NR);Eukaryota;Archaeplastida;Chloroplastida;Charophyta;Phragmoplastophyta;Streptophyta;Embryophyta;Tracheophyta;Spermatophyta;Magnoliophyta;Liliopsida;Asparagales;Bessera;";"0.0";"0";"1";"1";"0";"1";"0";"457182";"373894"
"V4mis1";"SILVA (only NR);Eukaryota;Archaeplastida;Chloroplastida;Charophyta;Phragmoplastophyta;Streptophyta;Embryophyta;Tracheophyta;Spermatophyta;Magnoliophyta;Liliopsida;Asparagales;Blandfordia;";"0.0";"0";"1";"1";"0";"1";"0";"457182";"373894"
"V4mis1";"SILVA (only NR);Eukaryota;Archaeplastida;Chloroplastida;Charophyta;Phragmoplastophyta;Streptophyta;Embryophyta;Tracheophyta;Spermatophyta;Magnoliophyta;Liliopsida;Asparagales;Borya;";"0.0";"0";"1";"1";"0";"1";"0";"457182";"373894"
"V4mis1";"SILVA (only NR);Eukaryota;Archaeplastida;Chloroplastida;Charophyta;Phragmoplastophyta;Streptophyta;Embryophyta;Tracheophyta;Spermatophyta;Magnoliophyta;Liliopsida;Asparagales;Bulbine;";"0.0";"0";"2";"2";"0";"2";"0";"457181";"373894"
"V4mis1";"SILVA (only NR);Eukaryota;Archaeplastida;Chloroplastida;Charophyta;Phragmoplastophyta;Streptophyta;Embryophyta;Tracheophyta;Spermatophyta;Magnoliophyta;Liliopsida;Asparagales;Cephalanthera;";"0.0";"0";"2";"2";"0";"2";"0";"457181";"373894"
"V4mis1";"SILVA (only NR);Eukaryota;Archaeplastida;Chloroplastida;Charophyta;Phragmoplastophyta;Streptophyta;Embryophyta;Tracheophyta;Spermatophyta;Magnoliophyta;Liliopsida;Asparagales;Chlorophytum;";"0.0";"0";"1";"1";"0";"1";"0";"457182";"373894"
"V4mis1";"SILVA (only NR);Eukaryota;Archaeplastida;Chloroplastida;Charophyta;Phragmoplastophyta;Streptophyta;Embryophyta;Tracheophyta;Spermatophyta;Magnoliophyta;Liliopsida;Asparagales;Cleistes;";"0.0";"0";"3";"3";"0";"3";"0";"457180";"373894"
"V4mis1";"SILVA (only NR);Eukaryota;Archaeplastida;Chloroplastida;Charophyta;Phragmoplastophyta;Streptophyta;Embryophyta;Tracheophyta;Spermatophyta;Magnoliophyta;Liliopsida;Asparagales;Cleistesiopsis;";"0.0";"0";"1";"1";"0";"1";"0";"457182";"373894"
"V4mis1";"SILVA (only NR);Eukaryota;Archaeplastida;Chloroplastida;Charophyta;Phragmoplastophyta;Streptophyta;Embryophyta;Tracheophyta;Spermatophyta;Magnoliophyta;Liliopsida;Asparagales;Clematepistephium;";"0.0";"0";"1";"1";"0";"1";"0";"457182";"373894"
"V4mis1";"SILVA (only NR);Eukaryota;Archaeplastida;Chloroplastida;Charophyta;Phragmoplastophyta;Streptophyta;Embryophyta;Tracheophyta;Spermatophyta;Magnoliophyta;Liliopsida;Asparagales;Corallorhiza;";"0.0";"0";"1";"1";"0";"1";"0";"457182";"373894"
"V4mis1";"SILVA (only NR);Eukaryota;Archaeplastida;Chloroplastida;Charophyta;Phragmoplastophyta;Streptophyta;Embryophyta;Tracheophyta;Spermatophyta;Magnoliophyta;Liliopsida;Asparagales;Crinum;";"0.0";"0";"1";"1";"0";"1";"0";"457182";"373894"
"V4mis1";"SILVA (only NR);Eukaryota;Archaeplastida;Chloroplastida;Charophyta;Phragmoplastophyta;Streptophyta;Embryophyta;Tracheophyta;Spermatophyta;Magnoliophyta;Liliopsida;Asparagales;Cyanella;";"0.0";"0";"1";"1";"0";"1";"0";"457182";"373894"
"V4mis1";"SILVA (only NR);Eukaryota;Archaeplastida;Chloroplastida;Charophyta;Phragmoplastophyta;Streptophyta;Embryophyta;Tracheophyta;Spermatophyta;Magnoliophyta;Liliopsida;Asparagales;Cyclopogon;";"0.0";"0";"1";"1";"0";"1";"0";"457182";"373894"
"V4mis1";"SILVA (only NR);Eukaryota;Archaeplastida;Chloroplastida;Charophyta;Phragmoplastophyta;Streptophyta;Embryophyta;Tracheophyta;Spermatophyta;Magnoliophyta;Liliopsida;Asparagales;Cymbidium;";"0.0";"0";"1";"1";"0";"1";"0";"457182";"373894"
"V4mis1";"SILVA (only NR);Eukaryota;Archaeplastida;Chloroplastida;Charophyta;Phragmoplastophyta;Streptophyta;Embryophyta;Tracheophyta;Spermatophyta;Magnoliophyta;Liliopsida;Asparagales;Cypripedium;";"0.0";"0";"1";"1";"0";"1";"0";"457182";"373894"
"V4mis1";"SILVA (only NR);Eukaryota;Archaeplastida;Chloroplastida;Charophyta;Phragmoplastophyta;Streptophyta;Embryophyta;Tracheophyta;Spermatophyta;Magnoliophyta;Liliopsida;Asparagales;Cyrtosia;";"0.0";"0";"1";"1";"0";"1";"0";"457182";"373894"
"V4mis1";"SILVA (only NR);Eukaryota;Archaeplastida;Chloroplastida;Charophyta;Phragmoplastophyta;Streptophyta;Embryophyta;Tracheophyta;Spermatophyta;Magnoliophyta;Liliopsida;Asparagales;Dactylorhiza;";"0.0";"0";"1";"1";"0";"1";"0";"457182";"373894"
"V4mis1";"SILVA (only NR);Eukaryota;Archaeplastida;Chloroplastida;Charophyta;Phragmoplastophyta;Streptophyta;Embryophyta;Tracheophyta;Spermatophyta;Magnoliophyta;Liliopsida;Asparagales;Dasylirion;";"0.0";"0";"1";"1";"0";"1";"0";"457182";"373894"
"V4mis1";"SILVA (only NR);Eukaryota;Archaeplastida;Chloroplastida;Charophyta;Phragmoplastophyta;Streptophyta;Embryophyta;Tracheophyta;Spermatophyta;Magnoliophyta;Liliopsida;Asparagales;Dendrobium;";"0.0";"0";"1";"1";"0";"1";"0";"457182";"373894"
"V4mis1";"SILVA (only NR);Eukaryota;Archaeplastida;Chloroplastida;Charophyta;Phragmoplastophyta;Streptophyta;Embryophyta;Tracheophyta;Spermatophyta;Magnoliophyta;Liliopsida;Asparagales;Dianella;";"0.0";"0";"1";"1";"0";"1";"0";"457182";"373894"
"V4mis1";"SILVA (only NR);Eukaryota;Archaeplastida;Chloroplastida;Charophyta;Phragmoplastophyta;Streptophyta;Embryophyta;Tracheophyta;Spermatophyta;Magnoliophyta;Liliopsida;Asparagales;Dichaea;";"0.0";"0";"1";"1";"0";"1";"0";"457182";"373894"
"V4mis1";"SILVA (only NR);Eukaryota;Archaeplastida;Chloroplastida;Charophyta;Phragmoplastophyta;Streptophyta;Embryophyta;Tracheophyta;Spermatophyta;Magnoliophyta;Liliopsida;Asparagales;Dichelostemma;";"0.0";"0";"1";"1";"0";"1";"0";"457182";"373894"
"V4mis1";"SILVA (only NR);Eukaryota;Archaeplastida;Chloroplastida;Charophyta;Phragmoplastophyta;Streptophyta;Embryophyta;Tracheophyta;Spermatophyta;Magnoliophyta;Liliopsida;Asparagales;Diuris;";"0.0";"0";"1";"1";"0";"1";"0";"457182";"373894"
"V4mis1";"SILVA (only NR);Eukaryota;Archaeplastida;Chloroplastida;Charophyta;Phragmoplastophyta;Streptophyta;Embryophyta;Tracheophyta;Spermatophyta;Magnoliophyta;Liliopsida;Asparagales;Doryanthes;";"0.0";"0";"1";"1";"0";"1";"0";"457182";"373894"
"V4mis1";"SILVA (only NR);Eukaryota;Archaeplastida;Chloroplastida;Charophyta;Phragmoplastophyta;Streptophyta;Embryophyta;Tracheophyta;Spermatophyta;Magnoliophyta;Liliopsida;Asparagales;Drimia;";"0.0";"0";"1";"1";"0";"1";"0";"457182";"373894"
"V4mis1";"SILVA (only NR);Eukaryota;Archaeplastida;Chloroplastida;Charophyta;Phragmoplastophyta;Streptophyta;Embryophyta;Tracheophyta;Spermatophyta;Magnoliophyta;Liliopsida;Asparagales;Duckeella;";"0.0";"0";"2";"2";"0";"2";"0";"457181";"373894"
"V4mis1";"SILVA (only NR);Eukaryota;Archaeplastida;Chloroplastida;Charophyta;Phragmoplastophyta;Streptophyta;Embryophyta;Tracheophyta;Spermatophyta;Magnoliophyta;Liliopsida;Asparagales;Echeandia;";"0.0";"0";"1";"1";"0";"1";"0";"457182";"373894"
"V4mis1";"SILVA (only NR);Eukaryota;Archaeplastida;Chloroplastida;Charophyta;Phragmoplastophyta;Streptophyta;Embryophyta;Tracheophyta;Spermatophyta;Magnoliophyta;Liliopsida;Asparagales;Epistephium;";"0.0";"0";"2";"2";"0";"2";"0";"457181";"373894"
"V4mis1";"SILVA (only NR);Eukaryota;Archaeplastida;Chloroplastida;Charophyta;Phragmoplastophyta;Streptophyta;Embryophyta;Tracheophyta;Spermatophyta;Magnoliophyta;Liliopsida;Asparagales;Eremurus;";"0.0";"0";"1";"1";"0";"1";"0";"457182";"373894"
"V4mis1";"SILVA (only NR);Eukaryota;Archaeplastida;Chloroplastida;Charophyta;Phragmoplastophyta;Streptophyta;Embryophyta;Tracheophyta;Spermatophyta;Magnoliophyta;Liliopsida;Asparagales;Eriaxis;";"0.0";"0";"1";"1";"0";"1";"0";"457182";"373894"
"V4mis1";"SILVA (only NR);Eukaryota;Archaeplastida;Chloroplastida;Charophyta;Phragmoplastophyta;Streptophyta;Embryophyta;Tracheophyta;Spermatophyta;Magnoliophyta;Liliopsida;Asparagales;Eriospermum;";"0.0";"0";"1";"1";"0";"1";"0";"457182";"373894"
"V4mis1";"SILVA (only NR);Eukaryota;Archaeplastida;Chloroplastida;Charophyta;Phragmoplastophyta;Streptophyta;Embryophyta;Tracheophyta;Spermatophyta;Magnoliophyta;Liliopsida;Asparagales;Erythrorchis;";"0.0";"0";"1";"1";"0";"1";"0";"457182";"373894"
"V4mis1";"SILVA (only NR);Eukaryota;Archaeplastida;Chloroplastida;Charophyta;Phragmoplastophyta;Streptophyta;Embryophyta;Tracheophyta;Spermatophyta;Magnoliophyta;Liliopsida;Asparagales;Eucharis;";"0.0";"0";"1";"1";"0";"1";"0";"457182";"373894"
"V4mis1";"SILVA (only NR);Eukaryota;Archaeplastida;Chloroplastida;Charophyta;Phragmoplastophyta;Streptophyta;Embryophyta;Tracheophyta;Spermatophyta;Magnoliophyta;Liliopsida;Asparagales;Eucomis;";"0.0";"0";"1";"1";"0";"1";"0";"457182";"373894"
"V4mis1";"SILVA (only NR);Eukaryota;Archaeplastida;Chloroplastida;Charophyta;Phragmoplastophyta;Streptophyta;Embryophyta;Tracheophyta;Spermatophyta;Magnoliophyta;Liliopsida;Asparagales;Eustrephus;";"0.0";"0";"1";"1";"0";"1";"0";"457182";"373894"
"V4mis1";"SILVA (only NR);Eukaryota;Archaeplastida;Chloroplastida;Charophyta;Phragmoplastophyta;Streptophyta;Embryophyta;Tracheophyta;Spermatophyta;Magnoliophyta;Liliopsida;Asparagales;Galeola;";"0.0";"0";"1";"1";"0";"1";"0";"457182";"373894"
"V4mis1";"SILVA (only NR);Eukaryota;Archaeplastida;Chloroplastida;Charophyta;Phragmoplastophyta;Streptophyta;Embryophyta;Tracheophyta;Spermatophyta;Magnoliophyta;Liliopsida;Asparagales;Gilliesia;";"0.0";"0";"1";"1";"0";"1";"0";"457182";"373894"
"V4mis1";"SILVA (only NR);Eukaryota;Archaeplastida;Chloroplastida;Charophyta;Phragmoplastophyta;Streptophyta;Embryophyta;Tracheophyta;Spermatophyta;Magnoliophyta;Liliopsida;Asparagales;Gladiolus;";"0.0";"0";"1";"1";"0";"1";"0";"457182";"373894"
"V4mis1";"SILVA (only NR);Eukaryota;Archaeplastida;Chloroplastida;Charophyta;Phragmoplastophyta;Streptophyta;Embryophyta;Tracheophyta;Spermatophyta;Magnoliophyta;Liliopsida;Asparagales;Habenaria;";"0.0";"0";"1";"1";"0";"1";"0";"457182";"373894"
"V4mis1";"SILVA (only NR);Eukaryota;Archaeplastida;Chloroplastida;Charophyta;Phragmoplastophyta;Streptophyta;Embryophyta;Tracheophyta;Spermatophyta;Magnoliophyta;Liliopsida;Asparagales;Herreria;";"0.0";"0";"2";"2";"0";"2";"0";"457181";"373894"
"V4mis1";"SILVA (only NR);Eukaryota;Archaeplastida;Chloroplastida;Charophyta;Phragmoplastophyta;Streptophyta;Embryophyta;Tracheophyta;Spermatophyta;Magnoliophyta;Liliopsida;Asparagales;Hypoxis;";"0.0";"0";"1";"1";"0";"1";"0";"457182";"373894"
"V4mis1";"SILVA (only NR);Eukaryota;Archaeplastida;Chloroplastida;Charophyta;Phragmoplastophyta;Streptophyta;Embryophyta;Tracheophyta;Spermatophyta;Magnoliophyta;Liliopsida;Asparagales;Iris;";"0.0";"0";"1";"1";"0";"1";"0";"457182";"373894"
"V4mis1";"SILVA (only NR);Eukaryota;Archaeplastida;Chloroplastida;Charophyta;Phragmoplastophyta;Streptophyta;Embryophyta;Tracheophyta;Spermatophyta;Magnoliophyta;Liliopsida;Asparagales;Isophysis;";"0.0";"0";"1";"1";"0";"1";"0";"457182";"373894"
"V4mis1";"SILVA (only NR);Eukaryota;Archaeplastida;Chloroplastida;Charophyta;Phragmoplastophyta;Streptophyta;Embryophyta;Tracheophyta;Spermatophyta;Magnoliophyta;Liliopsida;Asparagales;Isotria;";"0.0";"0";"1";"1";"0";"1";"0";"457182";"373894"
"V4mis1";"SILVA (only NR);Eukaryota;Archaeplastida;Chloroplastida;Charophyta;Phragmoplastophyta;Streptophyta;Embryophyta;Tracheophyta;Spermatophyta;Magnoliophyta;Liliopsida;Asparagales;Ixiolirion;";"0.0";"0";"1";"1";"0";"1";"0";"457182";"373894"
"V4mis1";"SILVA (only NR);Eukaryota;Archaeplastida;Chloroplastida;Charophyta;Phragmoplastophyta;Streptophyta;Embryophyta;Tracheophyta;Spermatophyta;Magnoliophyta;Liliopsida;Asparagales;Kniphofia;";"0.0";"0";"1";"1";"0";"1";"0";"457182";"373894"
"V4mis1";"SILVA (only NR);Eukaryota;Archaeplastida;Chloroplastida;Charophyta;Phragmoplastophyta;Streptophyta;Embryophyta;Tracheophyta;Spermatophyta;Magnoliophyta;Liliopsida;Asparagales;Lanaria;";"0.0";"0";"1";"1";"0";"1";"0";"457182";"373894"
"V4mis1";"SILVA (only NR);Eukaryota;Archaeplastida;Chloroplastida;Charophyta;Phragmoplastophyta;Streptophyta;Embryophyta;Tracheophyta;Spermatophyta;Magnoliophyta;Liliopsida;Asparagales;Laxmannia;";"0.0";"0";"1";"1";"0";"1";"0";"457182";"373894"
"V4mis1";"SILVA (only NR);Eukaryota;Archaeplastida;Chloroplastida;Charophyta;Phragmoplastophyta;Streptophyta;Embryophyta;Tracheophyta;Spermatophyta;Magnoliophyta;Liliopsida;Asparagales;Lecanorchis;";"0.0";"0";"1";"1";"0";"1";"0";"457182";"373894"
"V4mis1";"SILVA (only NR);Eukaryota;Archaeplastida;Chloroplastida;Charophyta;Phragmoplastophyta;Streptophyta;Embryophyta;Tracheophyta;Spermatophyta;Magnoliophyta;Liliopsida;Asparagales;Ledebouria;";"0.0";"0";"2";"2";"0";"2";"0";"457181";"373894"
"V4mis1";"SILVA (only NR);Eukaryota;Archaeplastida;Chloroplastida;Charophyta;Phragmoplastophyta;Streptophyta;Embryophyta;Tracheophyta;Spermatophyta;Magnoliophyta;Liliopsida;Asparagales;Liriope;";"0.0";"0";"1";"1";"0";"1";"0";"457182";"373894"
"V4mis1";"SILVA (only NR);Eukaryota;Archaeplastida;Chloroplastida;Charophyta;Phragmoplastophyta;Streptophyta;Embryophyta;Tracheophyta;Spermatophyta;Magnoliophyta;Liliopsida;Asparagales;Listera;";"0.0";"0";"1";"1";"0";"1";"0";"457182";"373894"
"V4mis1";"SILVA (only NR);Eukaryota;Archaeplastida;Chloroplastida;Charophyta;Phragmoplastophyta;Streptophyta;Embryophyta;Tracheophyta;Spermatophyta;Magnoliophyta;Liliopsida;Asparagales;Lomandra;";"0.0";"0";"2";"2";"0";"2";"0";"457181";"373894"
"V4mis1";"SILVA (only NR);Eukaryota;Archaeplastida;Chloroplastida;Charophyta;Phragmoplastophyta;Streptophyta;Embryophyta;Tracheophyta;Spermatophyta;Magnoliophyta;Liliopsida;Asparagales;Lycoris;";"0.0";"0";"5";"5";"0";"5";"0";"457178";"373894"
"V4mis1";"SILVA (only NR);Eukaryota;Archaeplastida;Chloroplastida;Charophyta;Phragmoplastophyta;Streptophyta;Embryophyta;Tracheophyta;Spermatophyta;Magnoliophyta;Liliopsida;Asparagales;Milligania;";"0.0";"0";"1";"1";"0";"1";"0";"457182";"373894"
"V4mis1";"SILVA (only NR);Eukaryota;Archaeplastida;Chloroplastida;Charophyta;Phragmoplastophyta;Streptophyta;Embryophyta;Tracheophyta;Spermatophyta;Magnoliophyta;Liliopsida;Asparagales;Narcissus;";"0.0";"0";"1";"1";"0";"1";"0";"457182";"373894"
"V4mis1";"SILVA (only NR);Eukaryota;Archaeplastida;Chloroplastida;Charophyta;Phragmoplastophyta;Streptophyta;Embryophyta;Tracheophyta;Spermatophyta;Magnoliophyta;Liliopsida;Asparagales;Neottia;";"0.0";"0";"1";"1";"0";"1";"0";"457182";"373894"
"V4mis1";"SILVA (only NR);Eukaryota;Archaeplastida;Chloroplastida;Charophyta;Phragmoplastophyta;Streptophyta;Embryophyta;Tracheophyta;Spermatophyta;Magnoliophyta;Liliopsida;Asparagales;Neuwiedia;";"0.0";"0";"1";"1";"0";"1";"0";"457182";"373894"
"V4mis1";"SILVA (only NR);Eukaryota;Archaeplastida;Chloroplastida;Charophyta;Phragmoplastophyta;Streptophyta;Embryophyta;Tracheophyta;Spermatophyta;Magnoliophyta;Liliopsida;Asparagales;Oncidium;";"0.0";"0";"2";"2";"0";"2";"0";"457181";"373894"
"V4mis1";"SILVA (only NR);Eukaryota;Archaeplastida;Chloroplastida;Charophyta;Phragmoplastophyta;Streptophyta;Embryophyta;Tracheophyta;Spermatophyta;Magnoliophyta;Liliopsida;Asparagales;Orchis;";"0.0";"0";"1";"1";"0";"1";"0";"457182";"373894"
"V4mis1";"SILVA (only NR);Eukaryota;Archaeplastida;Chloroplastida;Charophyta;Phragmoplastophyta;Streptophyta;Embryophyta;Tracheophyta;Spermatophyta;Magnoliophyta;Liliopsida;Asparagales;Palmorchis;";"0.0";"0";"1";"1";"0";"1";"0";"457182";"373894"
"V4mis1";"SILVA (only NR);Eukaryota;Archaeplastida;Chloroplastida;Charophyta;Phragmoplastophyta;Streptophyta;Embryophyta;Tracheophyta;Spermatophyta;Magnoliophyta;Liliopsida;Asparagales;Paphiopedilum;";"0.0";"0";"1";"1";"0";"1";"0";"457182";"373894"
"V4mis1";"SILVA (only NR);Eukaryota;Archaeplastida;Chloroplastida;Charophyta;Phragmoplastophyta;Streptophyta;Embryophyta;Tracheophyta;Spermatophyta;Magnoliophyta;Liliopsida;Asparagales;Peliosanthes;";"0.0";"0";"2";"2";"0";"2";"0";"457181";"373894"
"V4mis1";"SILVA (only NR);Eukaryota;Archaeplastida;Chloroplastida;Charophyta;Phragmoplastophyta;Streptophyta;Embryophyta;Tracheophyta;Spermatophyta;Magnoliophyta;Liliopsida;Asparagales;Phalaenopsis;";"0.0";"0";"3";"3";"0";"3";"0";"457180";"373894"
"V4mis1";"SILVA (only NR);Eukaryota;Archaeplastida;Chloroplastida;Charophyta;Phragmoplastophyta;Streptophyta;Embryophyta;Tracheophyta;Spermatophyta;Magnoliophyta;Liliopsida;Asparagales;Phormium;";"0.0";"0";"1";"1";"0";"1";"0";"457182";"373894"
"V4mis1";"SILVA (only NR);Eukaryota;Archaeplastida;Chloroplastida;Charophyta;Phragmoplastophyta;Streptophyta;Embryophyta;Tracheophyta;Spermatophyta;Magnoliophyta;Liliopsida;Asparagales;Pogonia;";"0.0";"0";"1";"1";"0";"1";"0";"457182";"373894"
"V4mis1";"SILVA (only NR);Eukaryota;Archaeplastida;Chloroplastida;Charophyta;Phragmoplastophyta;Streptophyta;Embryophyta;Tracheophyta;Spermatophyta;Magnoliophyta;Liliopsida;Asparagales;Pogoniopsis;";"0.0";"0";"1";"1";"0";"1";"0";"457182";"373894"
"V4mis1";"SILVA (only NR);Eukaryota;Archaeplastida;Chloroplastida;Charophyta;Phragmoplastophyta;Streptophyta;Embryophyta;Tracheophyta;Spermatophyta;Magnoliophyta;Liliopsida;Asparagales;Pseudovanilla;";"0.0";"0";"1";"1";"0";"1";"0";"457182";"373894"
"V4mis1";"SILVA (only NR);Eukaryota;Archaeplastida;Chloroplastida;Charophyta;Phragmoplastophyta;Streptophyta;Embryophyta;Tracheophyta;Spermatophyta;Magnoliophyta;Liliopsida;Asparagales;Psilochilus;";"0.0";"0";"1";"1";"0";"1";"0";"457182";"373894"
"V4mis1";"SILVA (only NR);Eukaryota;Archaeplastida;Chloroplastida;Charophyta;Phragmoplastophyta;Streptophyta;Embryophyta;Tracheophyta;Spermatophyta;Magnoliophyta;Liliopsida;Asparagales;Rhizanthella;";"0.0";"0";"1";"1";"0";"1";"0";"457182";"373894"
"V4mis1";"SILVA (only NR);Eukaryota;Archaeplastida;Chloroplastida;Charophyta;Phragmoplastophyta;Streptophyta;Embryophyta;Tracheophyta;Spermatophyta;Magnoliophyta;Liliopsida;Asparagales;Rhodohypoxis;";"0.0";"0";"1";"1";"0";"1";"0";"457182";"373894"
"V4mis1";"SILVA (only NR);Eukaryota;Archaeplastida;Chloroplastida;Charophyta;Phragmoplastophyta;Streptophyta;Embryophyta;Tracheophyta;Spermatophyta;Magnoliophyta;Liliopsida;Asparagales;Ruscus;";"0.0";"0";"1";"1";"0";"1";"0";"457182";"373894"
"V4mis1";"SILVA (only NR);Eukaryota;Archaeplastida;Chloroplastida;Charophyta;Phragmoplastophyta;Streptophyta;Embryophyta;Tracheophyta;Spermatophyta;Magnoliophyta;Liliopsida;Asparagales;Sansevieria;";"0.0";"0";"1";"1";"0";"1";"0";"457182";"373894"
"V4mis1";"SILVA (only NR);Eukaryota;Archaeplastida;Chloroplastida;Charophyta;Phragmoplastophyta;Streptophyta;Embryophyta;Tracheophyta;Spermatophyta;Magnoliophyta;Liliopsida;Asparagales;Scadoxus;";"0.0";"0";"1";"1";"0";"1";"0";"457182";"373894"
"V4mis1";"SILVA (only NR);Eukaryota;Archaeplastida;Chloroplastida;Charophyta;Phragmoplastophyta;Streptophyta;Embryophyta;Tracheophyta;Spermatophyta;Magnoliophyta;Liliopsida;Asparagales;Spiranthes;";"0.0";"0";"1";"1";"0";"1";"0";"457182";"373894"
"V4mis1";"SILVA (only NR);Eukaryota;Archaeplastida;Chloroplastida;Charophyta;Phragmoplastophyta;Streptophyta;Embryophyta;Tracheophyta;Spermatophyta;Magnoliophyta;Liliopsida;Asparagales;Triphora;";"0.0";"0";"2";"2";"0";"2";"0";"457181";"373894"
"V4mis1";"SILVA (only NR);Eukaryota;Archaeplastida;Chloroplastida;Charophyta;Phragmoplastophyta;Streptophyta;Embryophyta;Tracheophyta;Spermatophyta;Magnoliophyta;Liliopsida;Asparagales;Tristagma;";"0.0";"0";"1";"1";"0";"1";"0";"457182";"373894"
"V4mis1";"SILVA (only NR);Eukaryota;Archaeplastida;Chloroplastida;Charophyta;Phragmoplastophyta;Streptophyta;Embryophyta;Tracheophyta;Spermatophyta;Magnoliophyta;Liliopsida;Asparagales;Tropidia;";"0.0";"0";"1";"1";"0";"1";"0";"457182";"373894"
"V4mis1";"SILVA (only NR);Eukaryota;Archaeplastida;Chloroplastida;Charophyta;Phragmoplastophyta;Streptophyta;Embryophyta;Tracheophyta;Spermatophyta;Magnoliophyta;Liliopsida;Asparagales;Vanilla;";"0.0";"0";"3";"3";"0";"3";"0";"457180";"373894"
"V4mis1";"SILVA (only NR);Eukaryota;Archaeplastida;Chloroplastida;Charophyta;Phragmoplastophyta;Streptophyta;Embryophyta;Tracheophyta;Spermatophyta;Magnoliophyta;Liliopsida;Asparagales;Wullschlaegelia;";"0.0";"0";"1";"1";"0";"1";"0";"457182";"373894"
"V4mis1";"SILVA (only NR);Eukaryota;Archaeplastida;Chloroplastida;Charophyta;Phragmoplastophyta;Streptophyta;Embryophyta;Tracheophyta;Spermatophyta;Magnoliophyta;Liliopsida;Asparagales;Xanthorrhoea;";"0.0";"0";"1";"1";"0";"1";"0";"457182";"373894"
"V4mis1";"SILVA (only NR);Eukaryota;Archaeplastida;Chloroplastida;Charophyta;Phragmoplastophyta;Streptophyta;Embryophyta;Tracheophyta;Spermatophyta;Magnoliophyta;Liliopsida;Asparagales;Xeronema;";"0.0";"0";"1";"1";"0";"1";"0";"457182";"373894"
"V4mis1";"SILVA (only NR);Eukaryota;Archaeplastida;Chloroplastida;Charophyta;Phragmoplastophyta;Streptophyta;Embryophyta;Tracheophyta;Spermatophyta;Magnoliophyta;Liliopsida;Asparagales;Yucca;";"0.0";"0";"1";"1";"0";"1";"0";"457182";"373894"
"V4mis1";"SILVA (only NR);Eukaryota;Archaeplastida;Chloroplastida;Charophyta;Phragmoplastophyta;Streptophyta;Embryophyta;Tracheophyta;Spermatophyta;Magnoliophyta;Liliopsida;Asparagales;Zephyra;";"0.0";"0";"1";"1";"0";"1";"0";"457182";"373894"
"V4mis1";"SILVA (only NR);Eukaryota;Archaeplastida;Chloroplastida;Charophyta;Phragmoplastophyta;Streptophyta;Embryophyta;Tracheophyta;Spermatophyta;Magnoliophyta;Liliopsida;Commelinales;";"0.0";"0";"8";"8";"0";"8";"0";"457175";"373894"
"V4mis1";"SILVA (only NR);Eukaryota;Archaeplastida;Chloroplastida;Charophyta;Phragmoplastophyta;Streptophyta;Embryophyta;Tracheophyta;Spermatophyta;Magnoliophyta;Liliopsida;Commelinales;Amischotolype;";"0.0";"0";"1";"1";"0";"1";"0";"457182";"373894"
"V4mis1";"SILVA (only NR);Eukaryota;Archaeplastida;Chloroplastida;Charophyta;Phragmoplastophyta;Streptophyta;Embryophyta;Tracheophyta;Spermatophyta;Magnoliophyta;Liliopsida;Commelinales;Anigozanthos;";"0.0";"0";"1";"1";"0";"1";"0";"457182";"373894"
"V4mis1";"SILVA (only NR);Eukaryota;Archaeplastida;Chloroplastida;Charophyta;Phragmoplastophyta;Streptophyta;Embryophyta;Tracheophyta;Spermatophyta;Magnoliophyta;Liliopsida;Commelinales;Eichhornia;";"0.0";"0";"1";"1";"0";"1";"0";"457182";"373894"
"V4mis1";"SILVA (only NR);Eukaryota;Archaeplastida;Chloroplastida;Charophyta;Phragmoplastophyta;Streptophyta;Embryophyta;Tracheophyta;Spermatophyta;Magnoliophyta;Liliopsida;Commelinales;Hanguana;";"0.0";"0";"1";"1";"0";"1";"0";"457182";"373894"
"V4mis1";"SILVA (only NR);Eukaryota;Archaeplastida;Chloroplastida;Charophyta;Phragmoplastophyta;Streptophyta;Embryophyta;Tracheophyta;Spermatophyta;Magnoliophyta;Liliopsida;Commelinales;Philydrella;";"0.0";"0";"1";"1";"0";"1";"0";"457182";"373894"
"V4mis1";"SILVA (only NR);Eukaryota;Archaeplastida;Chloroplastida;Charophyta;Phragmoplastophyta;Streptophyta;Embryophyta;Tracheophyta;Spermatophyta;Magnoliophyta;Liliopsida;Commelinales;Philydrum;";"0.0";"0";"1";"1";"0";"1";"0";"457182";"373894"
"V4mis1";"SILVA (only NR);Eukaryota;Archaeplastida;Chloroplastida;Charophyta;Phragmoplastophyta;Streptophyta;Embryophyta;Tracheophyta;Spermatophyta;Magnoliophyta;Liliopsida;Commelinales;Pontederia;";"0.0";"0";"2";"2";"0";"2";"0";"457181";"373894"
"V4mis1";"SILVA (only NR);Eukaryota;Archaeplastida;Chloroplastida;Charophyta;Phragmoplastophyta;Streptophyta;Embryophyta;Tracheophyta;Spermatophyta;Magnoliophyta;Liliopsida;Dasypogonales;";"0.0";"0";"2";"2";"0";"2";"0";"457181";"373894"
"V4mis1";"SILVA (only NR);Eukaryota;Archaeplastida;Chloroplastida;Charophyta;Phragmoplastophyta;Streptophyta;Embryophyta;Tracheophyta;Spermatophyta;Magnoliophyta;Liliopsida;Dasypogonales;Calectasia;";"0.0";"0";"1";"1";"0";"1";"0";"457182";"373894"
"V4mis1";"SILVA (only NR);Eukaryota;Archaeplastida;Chloroplastida;Charophyta;Phragmoplastophyta;Streptophyta;Embryophyta;Tracheophyta;Spermatophyta;Magnoliophyta;Liliopsida;Dasypogonales;Dasypogon;";"0.0";"0";"1";"1";"0";"1";"0";"457182";"373894"
"V4mis1";"SILVA (only NR);Eukaryota;Archaeplastida;Chloroplastida;Charophyta;Phragmoplastophyta;Streptophyta;Embryophyta;Tracheophyta;Spermatophyta;Magnoliophyta;Liliopsida;Dioscoreales;";"0.0";"0";"92";"92";"0";"92";"0";"457091";"373894"
"V4mis1";"SILVA (only NR);Eukaryota;Archaeplastida;Chloroplastida;Charophyta;Phragmoplastophyta;Streptophyta;Embryophyta;Tracheophyta;Spermatophyta;Magnoliophyta;Liliopsida;Dioscoreales;Afrothismia;";"0.0";"0";"3";"3";"0";"3";"0";"457180";"373894"
"V4mis1";"SILVA (only NR);Eukaryota;Archaeplastida;Chloroplastida;Charophyta;Phragmoplastophyta;Streptophyta;Embryophyta;Tracheophyta;Spermatophyta;Magnoliophyta;Liliopsida;Dioscoreales;Aletris;";"0.0";"0";"2";"2";"0";"2";"0";"457181";"373894"
"V4mis1";"SILVA (only NR);Eukaryota;Archaeplastida;Chloroplastida;Charophyta;Phragmoplastophyta;Streptophyta;Embryophyta;Tracheophyta;Spermatophyta;Magnoliophyta;Liliopsida;Dioscoreales;Apteria;";"0.0";"0";"1";"1";"0";"1";"0";"457182";"373894"
"V4mis1";"SILVA (only NR);Eukaryota;Archaeplastida;Chloroplastida;Charophyta;Phragmoplastophyta;Streptophyta;Embryophyta;Tracheophyta;Spermatophyta;Magnoliophyta;Liliopsida;Dioscoreales;Burmannia;";"0.0";"0";"18";"18";"0";"18";"0";"457165";"373894"
"V4mis1";"SILVA (only NR);Eukaryota;Archaeplastida;Chloroplastida;Charophyta;Phragmoplastophyta;Streptophyta;Embryophyta;Tracheophyta;Spermatophyta;Magnoliophyta;Liliopsida;Dioscoreales;Campylosiphon;";"0.0";"0";"1";"1";"0";"1";"0";"457182";"373894"
"V4mis1";"SILVA (only NR);Eukaryota;Archaeplastida;Chloroplastida;Charophyta;Phragmoplastophyta;Streptophyta;Embryophyta;Tracheophyta;Spermatophyta;Magnoliophyta;Liliopsida;Dioscoreales;Cymbocarpa;";"0.0";"0";"2";"2";"0";"2";"0";"457181";"373894"
"V4mis1";"SILVA (only NR);Eukaryota;Archaeplastida;Chloroplastida;Charophyta;Phragmoplastophyta;Streptophyta;Embryophyta;Tracheophyta;Spermatophyta;Magnoliophyta;Liliopsida;Dioscoreales;Dictyostega;";"0.0";"0";"1";"1";"0";"1";"0";"457182";"373894"
"V4mis1";"SILVA (only NR);Eukaryota;Archaeplastida;Chloroplastida;Charophyta;Phragmoplastophyta;Streptophyta;Embryophyta;Tracheophyta;Spermatophyta;Magnoliophyta;Liliopsida;Dioscoreales;Dioscorea;";"0.0";"0";"37";"37";"0";"37";"0";"457146";"373894"
"V4mis1";"SILVA (only NR);Eukaryota;Archaeplastida;Chloroplastida;Charophyta;Phragmoplastophyta;Streptophyta;Embryophyta;Tracheophyta;Spermatophyta;Magnoliophyta;Liliopsida;Dioscoreales;Gymnosiphon;";"0.0";"0";"6";"6";"0";"6";"0";"457177";"373894"
"V4mis1";"SILVA (only NR);Eukaryota;Archaeplastida;Chloroplastida;Charophyta;Phragmoplastophyta;Streptophyta;Embryophyta;Tracheophyta;Spermatophyta;Magnoliophyta;Liliopsida;Dioscoreales;Haplothismia;";"0.0";"0";"1";"1";"0";"1";"0";"457182";"373894"
"V4mis1";"SILVA (only NR);Eukaryota;Archaeplastida;Chloroplastida;Charophyta;Phragmoplastophyta;Streptophyta;Embryophyta;Tracheophyta;Spermatophyta;Magnoliophyta;Liliopsida;Dioscoreales;Hexapterella;";"0.0";"0";"1";"1";"0";"1";"0";"457182";"373894"
"V4mis1";"SILVA (only NR);Eukaryota;Archaeplastida;Chloroplastida;Charophyta;Phragmoplastophyta;Streptophyta;Embryophyta;Tracheophyta;Spermatophyta;Magnoliophyta;Liliopsida;Dioscoreales;Metanarthecium;";"0.0";"0";"1";"1";"0";"1";"0";"457182";"373894"
"V4mis1";"SILVA (only NR);Eukaryota;Archaeplastida;Chloroplastida;Charophyta;Phragmoplastophyta;Streptophyta;Embryophyta;Tracheophyta;Spermatophyta;Magnoliophyta;Liliopsida;Dioscoreales;Narthecium;";"0.0";"0";"1";"1";"0";"1";"0";"457182";"373894"
"V4mis1";"SILVA (only NR);Eukaryota;Archaeplastida;Chloroplastida;Charophyta;Phragmoplastophyta;Streptophyta;Embryophyta;Tracheophyta;Spermatophyta;Magnoliophyta;Liliopsida;Dioscoreales;Oxygyne;";"0.0";"0";"1";"1";"0";"1";"0";"457182";"373894"
"V4mis1";"SILVA (only NR);Eukaryota;Archaeplastida;Chloroplastida;Charophyta;Phragmoplastophyta;Streptophyta;Embryophyta;Tracheophyta;Spermatophyta;Magnoliophyta;Liliopsida;Dioscoreales;Tacca;";"0.0";"0";"3";"3";"0";"3";"0";"457180";"373894"
"V4mis1";"SILVA (only NR);Eukaryota;Archaeplastida;Chloroplastida;Charophyta;Phragmoplastophyta;Streptophyta;Embryophyta;Tracheophyta;Spermatophyta;Magnoliophyta;Liliopsida;Dioscoreales;Thismia;";"0.0";"0";"11";"11";"0";"11";"0";"457172";"373894"
"V4mis1";"SILVA (only NR);Eukaryota;Archaeplastida;Chloroplastida;Charophyta;Phragmoplastophyta;Streptophyta;Embryophyta;Tracheophyta;Spermatophyta;Magnoliophyta;Liliopsida;Dioscoreales;Tiputinia;";"0.0";"0";"1";"1";"0";"1";"0";"457182";"373894"
"V4mis1";"SILVA (only NR);Eukaryota;Archaeplastida;Chloroplastida;Charophyta;Phragmoplastophyta;Streptophyta;Embryophyta;Tracheophyta;Spermatophyta;Magnoliophyta;Liliopsida;Dioscoreales;Trichopus;";"0.0";"0";"1";"1";"0";"1";"0";"457182";"373894"
"V4mis1";"SILVA (only NR);Eukaryota;Archaeplastida;Chloroplastida;Charophyta;Phragmoplastophyta;Streptophyta;Embryophyta;Tracheophyta;Spermatophyta;Magnoliophyta;Liliopsida;Incertae Sedis;";"0.0";"0";"31";"31";"0";"31";"0";"457152";"373894"
"V4mis1";"SILVA (only NR);Eukaryota;Archaeplastida;Chloroplastida;Charophyta;Phragmoplastophyta;Streptophyta;Embryophyta;Tracheophyta;Spermatophyta;Magnoliophyta;Liliopsida;Incertae Sedis;Anthurium;";"0.0";"0";"1";"1";"0";"1";"0";"457182";"373894"
"V4mis1";"SILVA (only NR);Eukaryota;Archaeplastida;Chloroplastida;Charophyta;Phragmoplastophyta;Streptophyta;Embryophyta;Tracheophyta;Spermatophyta;Magnoliophyta;Liliopsida;Incertae Sedis;Astrocaryum;";"0.0";"0";"1";"1";"0";"1";"0";"457182";"373894"
"V4mis1";"SILVA (only NR);Eukaryota;Archaeplastida;Chloroplastida;Charophyta;Phragmoplastophyta;Streptophyta;Embryophyta;Tracheophyta;Spermatophyta;Magnoliophyta;Liliopsida;Incertae Sedis;Drymophloeus;";"0.0";"0";"1";"1";"0";"1";"0";"457182";"373894"
"V4mis1";"SILVA (only NR);Eukaryota;Archaeplastida;Chloroplastida;Charophyta;Phragmoplastophyta;Streptophyta;Embryophyta;Tracheophyta;Spermatophyta;Magnoliophyta;Liliopsida;Incertae Sedis;Elaeis;";"0.0";"0";"9";"9";"0";"9";"0";"457174";"373894"
"V4mis1";"SILVA (only NR);Eukaryota;Archaeplastida;Chloroplastida;Charophyta;Phragmoplastophyta;Streptophyta;Embryophyta;Tracheophyta;Spermatophyta;Magnoliophyta;Liliopsida;Incertae Sedis;Elodea;";"0.0";"0";"2";"2";"0";"2";"0";"457181";"373894"
"V4mis1";"SILVA (only NR);Eukaryota;Archaeplastida;Chloroplastida;Charophyta;Phragmoplastophyta;Streptophyta;Embryophyta;Tracheophyta;Spermatophyta;Magnoliophyta;Liliopsida;Incertae Sedis;Halodule;";"0.0";"0";"1";"1";"0";"1";"0";"457182";"373894"
"V4mis1";"SILVA (only NR);Eukaryota;Archaeplastida;Chloroplastida;Charophyta;Phragmoplastophyta;Streptophyta;Embryophyta;Tracheophyta;Spermatophyta;Magnoliophyta;Liliopsida;Incertae Sedis;Halophila;";"0.0";"0";"4";"4";"0";"4";"0";"457179";"373894"
"V4mis1";"SILVA (only NR);Eukaryota;Archaeplastida;Chloroplastida;Charophyta;Phragmoplastophyta;Streptophyta;Embryophyta;Tracheophyta;Spermatophyta;Magnoliophyta;Liliopsida;Incertae Sedis;Mauritia;";"0.0";"0";"1";"1";"0";"1";"0";"457182";"373894"
"V4mis1";"SILVA (only NR);Eukaryota;Archaeplastida;Chloroplastida;Charophyta;Phragmoplastophyta;Streptophyta;Embryophyta;Tracheophyta;Spermatophyta;Magnoliophyta;Liliopsida;Incertae Sedis;Nypa;";"0.0";"0";"1";"1";"0";"1";"0";"457182";"373894"
"V4mis1";"SILVA (only NR);Eukaryota;Archaeplastida;Chloroplastida;Charophyta;Phragmoplastophyta;Streptophyta;Embryophyta;Tracheophyta;Spermatophyta;Magnoliophyta;Liliopsida;Incertae Sedis;Podococcus;";"0.0";"0";"1";"1";"0";"1";"0";"457182";"373894"
"V4mis1";"SILVA (only NR);Eukaryota;Archaeplastida;Chloroplastida;Charophyta;Phragmoplastophyta;Streptophyta;Embryophyta;Tracheophyta;Spermatophyta;Magnoliophyta;Liliopsida;Incertae Sedis;Posidonia;";"0.0";"0";"3";"3";"0";"3";"0";"457180";"373894"
"V4mis1";"SILVA (only NR);Eukaryota;Archaeplastida;Chloroplastida;Charophyta;Phragmoplastophyta;Streptophyta;Embryophyta;Tracheophyta;Spermatophyta;Magnoliophyta;Liliopsida;Incertae Sedis;Potamogeton;";"0.0";"0";"2";"2";"0";"2";"0";"457181";"373894"
"V4mis1";"SILVA (only NR);Eukaryota;Archaeplastida;Chloroplastida;Charophyta;Phragmoplastophyta;Streptophyta;Embryophyta;Tracheophyta;Spermatophyta;Magnoliophyta;Liliopsida;Incertae Sedis;Pseudophoenix;";"0.0";"0";"1";"1";"0";"1";"0";"457182";"373894"
"V4mis1";"SILVA (only NR);Eukaryota;Archaeplastida;Chloroplastida;Charophyta;Phragmoplastophyta;Streptophyta;Embryophyta;Tracheophyta;Spermatophyta;Magnoliophyta;Liliopsida;Incertae Sedis;Vallisneria;";"0.0";"0";"2";"2";"0";"2";"0";"457181";"373894"
"V4mis1";"SILVA (only NR);Eukaryota;Archaeplastida;Chloroplastida;Charophyta;Phragmoplastophyta;Streptophyta;Embryophyta;Tracheophyta;Spermatophyta;Magnoliophyta;Liliopsida;Incertae Sedis;Zostera;";"0.0";"0";"1";"1";"0";"1";"0";"457182";"373894"
"V4mis1";"SILVA (only NR);Eukaryota;Archaeplastida;Chloroplastida;Charophyta;Phragmoplastophyta;Streptophyta;Embryophyta;Tracheophyta;Spermatophyta;Magnoliophyta;Liliopsida;Liliales;";"0.0";"0";"34";"34";"0";"34";"0";"457149";"373894"
"V4mis1";"SILVA (only NR);Eukaryota;Archaeplastida;Chloroplastida;Charophyta;Phragmoplastophyta;Streptophyta;Embryophyta;Tracheophyta;Spermatophyta;Magnoliophyta;Liliopsida;Liliales;Alstroemeria;";"0.0";"0";"1";"1";"0";"1";"0";"457182";"373894"
"V4mis1";"SILVA (only NR);Eukaryota;Archaeplastida;Chloroplastida;Charophyta;Phragmoplastophyta;Streptophyta;Embryophyta;Tracheophyta;Spermatophyta;Magnoliophyta;Liliopsida;Liliales;Arachnitis;";"0.0";"0";"1";"1";"0";"1";"0";"457182";"373894"
"V4mis1";"SILVA (only NR);Eukaryota;Archaeplastida;Chloroplastida;Charophyta;Phragmoplastophyta;Streptophyta;Embryophyta;Tracheophyta;Spermatophyta;Magnoliophyta;Liliopsida;Liliales;Bomarea;";"0.0";"0";"1";"1";"0";"1";"0";"457182";"373894"
"V4mis1";"SILVA (only NR);Eukaryota;Archaeplastida;Chloroplastida;Charophyta;Phragmoplastophyta;Streptophyta;Embryophyta;Tracheophyta;Spermatophyta;Magnoliophyta;Liliopsida;Liliales;Calochortus;";"0.0";"0";"2";"2";"0";"2";"0";"457181";"373894"
"V4mis1";"SILVA (only NR);Eukaryota;Archaeplastida;Chloroplastida;Charophyta;Phragmoplastophyta;Streptophyta;Embryophyta;Tracheophyta;Spermatophyta;Magnoliophyta;Liliopsida;Liliales;Campynema;";"0.0";"0";"2";"2";"0";"2";"0";"457181";"373894"
"V4mis1";"SILVA (only NR);Eukaryota;Archaeplastida;Chloroplastida;Charophyta;Phragmoplastophyta;Streptophyta;Embryophyta;Tracheophyta;Spermatophyta;Magnoliophyta;Liliopsida;Liliales;Campynemanthe;";"0.0";"0";"1";"1";"0";"1";"0";"457182";"373894"
"V4mis1";"SILVA (only NR);Eukaryota;Archaeplastida;Chloroplastida;Charophyta;Phragmoplastophyta;Streptophyta;Embryophyta;Tracheophyta;Spermatophyta;Magnoliophyta;Liliopsida;Liliales;Chamaelirium;";"0.0";"0";"1";"1";"0";"1";"0";"457182";"373894"
"V4mis1";"SILVA (only NR);Eukaryota;Archaeplastida;Chloroplastida;Charophyta;Phragmoplastophyta;Streptophyta;Embryophyta;Tracheophyta;Spermatophyta;Magnoliophyta;Liliopsida;Liliales;Clintonia;";"0.0";"0";"1";"1";"0";"1";"0";"457182";"373894"
"V4mis1";"SILVA (only NR);Eukaryota;Archaeplastida;Chloroplastida;Charophyta;Phragmoplastophyta;Streptophyta;Embryophyta;Tracheophyta;Spermatophyta;Magnoliophyta;Liliopsida;Liliales;Colchicum;";"0.0";"0";"2";"2";"0";"2";"0";"457181";"373894"
"V4mis1";"SILVA (only NR);Eukaryota;Archaeplastida;Chloroplastida;Charophyta;Phragmoplastophyta;Streptophyta;Embryophyta;Tracheophyta;Spermatophyta;Magnoliophyta;Liliopsida;Liliales;Corsia;";"0.0";"0";"1";"1";"0";"1";"0";"457182";"373894"
"V4mis1";"SILVA (only NR);Eukaryota;Archaeplastida;Chloroplastida;Charophyta;Phragmoplastophyta;Streptophyta;Embryophyta;Tracheophyta;Spermatophyta;Magnoliophyta;Liliopsida;Liliales;Gloriosa;";"0.0";"0";"3";"3";"0";"3";"0";"457180";"373894"
"V4mis1";"SILVA (only NR);Eukaryota;Archaeplastida;Chloroplastida;Charophyta;Phragmoplastophyta;Streptophyta;Embryophyta;Tracheophyta;Spermatophyta;Magnoliophyta;Liliopsida;Liliales;Lilium;";"0.0";"0";"2";"2";"0";"2";"0";"457181";"373894"
"V4mis1";"SILVA (only NR);Eukaryota;Archaeplastida;Chloroplastida;Charophyta;Phragmoplastophyta;Streptophyta;Embryophyta;Tracheophyta;Spermatophyta;Magnoliophyta;Liliopsida;Liliales;Luzuriaga;";"0.0";"0";"1";"1";"0";"1";"0";"457182";"373894"
"V4mis1";"SILVA (only NR);Eukaryota;Archaeplastida;Chloroplastida;Charophyta;Phragmoplastophyta;Streptophyta;Embryophyta;Tracheophyta;Spermatophyta;Magnoliophyta;Liliopsida;Liliales;Petermannia;";"0.0";"0";"1";"1";"0";"1";"0";"457182";"373894"
"V4mis1";"SILVA (only NR);Eukaryota;Archaeplastida;Chloroplastida;Charophyta;Phragmoplastophyta;Streptophyta;Embryophyta;Tracheophyta;Spermatophyta;Magnoliophyta;Liliopsida;Liliales;Philesia;";"0.0";"0";"2";"2";"0";"2";"0";"457181";"373894"
"V4mis1";"SILVA (only NR);Eukaryota;Archaeplastida;Chloroplastida;Charophyta;Phragmoplastophyta;Streptophyta;Embryophyta;Tracheophyta;Spermatophyta;Magnoliophyta;Liliopsida;Liliales;Ripogonum;";"0.0";"0";"3";"3";"0";"3";"0";"457180";"373894"
"V4mis1";"SILVA (only NR);Eukaryota;Archaeplastida;Chloroplastida;Charophyta;Phragmoplastophyta;Streptophyta;Embryophyta;Tracheophyta;Spermatophyta;Magnoliophyta;Liliopsida;Liliales;Scoliopus;";"0.0";"0";"1";"1";"0";"1";"0";"457182";"373894"
"V4mis1";"SILVA (only NR);Eukaryota;Archaeplastida;Chloroplastida;Charophyta;Phragmoplastophyta;Streptophyta;Embryophyta;Tracheophyta;Spermatophyta;Magnoliophyta;Liliopsida;Liliales;Smilax;";"0.0";"0";"2";"2";"0";"2";"0";"457181";"373894"
"V4mis1";"SILVA (only NR);Eukaryota;Archaeplastida;Chloroplastida;Charophyta;Phragmoplastophyta;Streptophyta;Embryophyta;Tracheophyta;Spermatophyta;Magnoliophyta;Liliopsida;Liliales;Tricyrtis;";"0.0";"0";"2";"2";"0";"2";"0";"457181";"373894"
"V4mis1";"SILVA (only NR);Eukaryota;Archaeplastida;Chloroplastida;Charophyta;Phragmoplastophyta;Streptophyta;Embryophyta;Tracheophyta;Spermatophyta;Magnoliophyta;Liliopsida;Liliales;Trillium;";"0.0";"0";"2";"2";"0";"2";"0";"457181";"373894"
"V4mis1";"SILVA (only NR);Eukaryota;Archaeplastida;Chloroplastida;Charophyta;Phragmoplastophyta;Streptophyta;Embryophyta;Tracheophyta;Spermatophyta;Magnoliophyta;Liliopsida;Liliales;Veratrum;";"0.0";"0";"2";"2";"0";"2";"0";"457181";"373894"
"V4mis1";"SILVA (only NR);Eukaryota;Archaeplastida;Chloroplastida;Charophyta;Phragmoplastophyta;Streptophyta;Embryophyta;Tracheophyta;Spermatophyta;Magnoliophyta;Liliopsida;Pandanales;";"0.0";"0";"18";"18";"0";"18";"0";"457165";"373894"
"V4mis1";"SILVA (only NR);Eukaryota;Archaeplastida;Chloroplastida;Charophyta;Phragmoplastophyta;Streptophyta;Embryophyta;Tracheophyta;Spermatophyta;Magnoliophyta;Liliopsida;Pandanales;Acanthochlamys;";"0.0";"0";"1";"1";"0";"1";"0";"457182";"373894"
"V4mis1";"SILVA (only NR);Eukaryota;Archaeplastida;Chloroplastida;Charophyta;Phragmoplastophyta;Streptophyta;Embryophyta;Tracheophyta;Spermatophyta;Magnoliophyta;Liliopsida;Pandanales;Andruris;";"0.0";"0";"1";"1";"0";"1";"0";"457182";"373894"
"V4mis1";"SILVA (only NR);Eukaryota;Archaeplastida;Chloroplastida;Charophyta;Phragmoplastophyta;Streptophyta;Embryophyta;Tracheophyta;Spermatophyta;Magnoliophyta;Liliopsida;Pandanales;Carludovica;";"0.0";"0";"1";"1";"0";"1";"0";"457182";"373894"
"V4mis1";"SILVA (only NR);Eukaryota;Archaeplastida;Chloroplastida;Charophyta;Phragmoplastophyta;Streptophyta;Embryophyta;Tracheophyta;Spermatophyta;Magnoliophyta;Liliopsida;Pandanales;Kupea;";"0.0";"0";"1";"1";"0";"1";"0";"457182";"373894"
"V4mis1";"SILVA (only NR);Eukaryota;Archaeplastida;Chloroplastida;Charophyta;Phragmoplastophyta;Streptophyta;Embryophyta;Tracheophyta;Spermatophyta;Magnoliophyta;Liliopsida;Pandanales;Pandanus;";"0.0";"0";"1";"1";"0";"1";"0";"457182";"373894"
"V4mis1";"SILVA (only NR);Eukaryota;Archaeplastida;Chloroplastida;Charophyta;Phragmoplastophyta;Streptophyta;Embryophyta;Tracheophyta;Spermatophyta;Magnoliophyta;Liliopsida;Pandanales;Pentastemona;";"0.0";"0";"1";"1";"0";"1";"0";"457182";"373894"
"V4mis1";"SILVA (only NR);Eukaryota;Archaeplastida;Chloroplastida;Charophyta;Phragmoplastophyta;Streptophyta;Embryophyta;Tracheophyta;Spermatophyta;Magnoliophyta;Liliopsida;Pandanales;Sciaphila;";"0.0";"0";"7";"7";"0";"7";"0";"457176";"373894"
"V4mis1";"SILVA (only NR);Eukaryota;Archaeplastida;Chloroplastida;Charophyta;Phragmoplastophyta;Streptophyta;Embryophyta;Tracheophyta;Spermatophyta;Magnoliophyta;Liliopsida;Pandanales;Seychellaria;";"0.0";"0";"2";"2";"0";"2";"0";"457181";"373894"
"V4mis1";"SILVA (only NR);Eukaryota;Archaeplastida;Chloroplastida;Charophyta;Phragmoplastophyta;Streptophyta;Embryophyta;Tracheophyta;Spermatophyta;Magnoliophyta;Liliopsida;Pandanales;Stemona;";"0.0";"0";"1";"1";"0";"1";"0";"457182";"373894"
"V4mis1";"SILVA (only NR);Eukaryota;Archaeplastida;Chloroplastida;Charophyta;Phragmoplastophyta;Streptophyta;Embryophyta;Tracheophyta;Spermatophyta;Magnoliophyta;Liliopsida;Pandanales;Triuris;";"0.0";"0";"1";"1";"0";"1";"0";"457182";"373894"
"V4mis1";"SILVA (only NR);Eukaryota;Archaeplastida;Chloroplastida;Charophyta;Phragmoplastophyta;Streptophyta;Embryophyta;Tracheophyta;Spermatophyta;Magnoliophyta;Liliopsida;Pandanales;Xerophyta;";"0.0";"0";"1";"1";"0";"1";"0";"457182";"373894"
"V4mis1";"SILVA (only NR);Eukaryota;Archaeplastida;Chloroplastida;Charophyta;Phragmoplastophyta;Streptophyta;Embryophyta;Tracheophyta;Spermatophyta;Magnoliophyta;Liliopsida;Petrosaviales;";"0.0";"0";"2";"2";"0";"2";"0";"457181";"373894"
"V4mis1";"SILVA (only NR);Eukaryota;Archaeplastida;Chloroplastida;Charophyta;Phragmoplastophyta;Streptophyta;Embryophyta;Tracheophyta;Spermatophyta;Magnoliophyta;Liliopsida;Petrosaviales;Japonolirion;";"0.0";"0";"1";"1";"0";"1";"0";"457182";"373894"
"V4mis1";"SILVA (only NR);Eukaryota;Archaeplastida;Chloroplastida;Charophyta;Phragmoplastophyta;Streptophyta;Embryophyta;Tracheophyta;Spermatophyta;Magnoliophyta;Liliopsida;Petrosaviales;Petrosavia;";"0.0";"0";"1";"1";"0";"1";"0";"457182";"373894"
"V4mis1";"SILVA (only NR);Eukaryota;Archaeplastida;Chloroplastida;Charophyta;Phragmoplastophyta;Streptophyta;Embryophyta;Tracheophyta;Spermatophyta;Magnoliophyta;Liliopsida;Poales;";"5.8";"18.2";"244";"243";"14";"229";"1";"456940";"373880"
"V4mis1";"SILVA (only NR);Eukaryota;Archaeplastida;Chloroplastida;Charophyta;Phragmoplastophyta;Streptophyta;Embryophyta;Tracheophyta;Spermatophyta;Magnoliophyta;Liliopsida;Poales;Abolboda;";"0.0";"0";"1";"1";"0";"1";"0";"457182";"373894"
"V4mis1";"SILVA (only NR);Eukaryota;Archaeplastida;Chloroplastida;Charophyta;Phragmoplastophyta;Streptophyta;Embryophyta;Tracheophyta;Spermatophyta;Magnoliophyta;Liliopsida;Poales;Agrostis;";"0.0";"0";"1";"1";"0";"1";"0";"457182";"373894"
"V4mis1";"SILVA (only NR);Eukaryota;Archaeplastida;Chloroplastida;Charophyta;Phragmoplastophyta;Streptophyta;Embryophyta;Tracheophyta;Spermatophyta;Magnoliophyta;Liliopsida;Poales;Ananas;";"0.0";"0";"5";"5";"0";"5";"0";"457178";"373894"
"V4mis1";"SILVA (only NR);Eukaryota;Archaeplastida;Chloroplastida;Charophyta;Phragmoplastophyta;Streptophyta;Embryophyta;Tracheophyta;Spermatophyta;Magnoliophyta;Liliopsida;Poales;Baloskion;";"0.0";"0";"1";"1";"0";"1";"0";"457182";"373894"
"V4mis1";"SILVA (only NR);Eukaryota;Archaeplastida;Chloroplastida;Charophyta;Phragmoplastophyta;Streptophyta;Embryophyta;Tracheophyta;Spermatophyta;Magnoliophyta;Liliopsida;Poales;Billbergia;";"0.0";"0";"1";"1";"0";"1";"0";"457182";"373894"
"V4mis1";"SILVA (only NR);Eukaryota;Archaeplastida;Chloroplastida;Charophyta;Phragmoplastophyta;Streptophyta;Embryophyta;Tracheophyta;Spermatophyta;Magnoliophyta;Liliopsida;Poales;Bromus;";"0.0";"0";"1";"1";"0";"1";"0";"457182";"373894"
"V4mis1";"SILVA (only NR);Eukaryota;Archaeplastida;Chloroplastida;Charophyta;Phragmoplastophyta;Streptophyta;Embryophyta;Tracheophyta;Spermatophyta;Magnoliophyta;Liliopsida;Poales;Carex;";"0.0";"0";"1";"1";"0";"1";"0";"457182";"373894"
"V4mis1";"SILVA (only NR);Eukaryota;Archaeplastida;Chloroplastida;Charophyta;Phragmoplastophyta;Streptophyta;Embryophyta;Tracheophyta;Spermatophyta;Magnoliophyta;Liliopsida;Poales;Cenchrus;";"0.0";"0";"7";"6";"0";"6";"1";"457177";"373894"
"V4mis1";"SILVA (only NR);Eukaryota;Archaeplastida;Chloroplastida;Charophyta;Phragmoplastophyta;Streptophyta;Embryophyta;Tracheophyta;Spermatophyta;Magnoliophyta;Liliopsida;Poales;Dendrocalamus;";"0.0";"0";"1";"1";"0";"1";"0";"457182";"373894"
"V4mis1";"SILVA (only NR);Eukaryota;Archaeplastida;Chloroplastida;Charophyta;Phragmoplastophyta;Streptophyta;Embryophyta;Tracheophyta;Spermatophyta;Magnoliophyta;Liliopsida;Poales;Dichanthelium;";"0.0";"0";"1";"1";"0";"1";"0";"457182";"373894"
"V4mis1";"SILVA (only NR);Eukaryota;Archaeplastida;Chloroplastida;Charophyta;Phragmoplastophyta;Streptophyta;Embryophyta;Tracheophyta;Spermatophyta;Magnoliophyta;Liliopsida;Poales;Ecdeiocolea;";"0.0";"0";"2";"2";"0";"2";"0";"457181";"373894"
"V4mis1";"SILVA (only NR);Eukaryota;Archaeplastida;Chloroplastida;Charophyta;Phragmoplastophyta;Streptophyta;Embryophyta;Tracheophyta;Spermatophyta;Magnoliophyta;Liliopsida;Poales;Echinochloa;";"0.0";"0";"1";"1";"0";"1";"0";"457182";"373894"
"V4mis1";"SILVA (only NR);Eukaryota;Archaeplastida;Chloroplastida;Charophyta;Phragmoplastophyta;Streptophyta;Embryophyta;Tracheophyta;Spermatophyta;Magnoliophyta;Liliopsida;Poales;Elegia;";"0.0";"0";"1";"1";"0";"1";"0";"457182";"373894"
"V4mis1";"SILVA (only NR);Eukaryota;Archaeplastida;Chloroplastida;Charophyta;Phragmoplastophyta;Streptophyta;Embryophyta;Tracheophyta;Spermatophyta;Magnoliophyta;Liliopsida;Poales;Eleocharis;";"0.0";"0";"1";"1";"0";"1";"0";"457182";"373894"
"V4mis1";"SILVA (only NR);Eukaryota;Archaeplastida;Chloroplastida;Charophyta;Phragmoplastophyta;Streptophyta;Embryophyta;Tracheophyta;Spermatophyta;Magnoliophyta;Liliopsida;Poales;Eleusine;";"0.0";"0";"1";"1";"0";"1";"0";"457182";"373894"
"V4mis1";"SILVA (only NR);Eukaryota;Archaeplastida;Chloroplastida;Charophyta;Phragmoplastophyta;Streptophyta;Embryophyta;Tracheophyta;Spermatophyta;Magnoliophyta;Liliopsida;Poales;Eragrostis;";"0.0";"0";"3";"3";"0";"3";"0";"457180";"373894"
"V4mis1";"SILVA (only NR);Eukaryota;Archaeplastida;Chloroplastida;Charophyta;Phragmoplastophyta;Streptophyta;Embryophyta;Tracheophyta;Spermatophyta;Magnoliophyta;Liliopsida;Poales;Eriocaulon;";"0.0";"0";"1";"1";"0";"1";"0";"457182";"373894"
"V4mis1";"SILVA (only NR);Eukaryota;Archaeplastida;Chloroplastida;Charophyta;Phragmoplastophyta;Streptophyta;Embryophyta;Tracheophyta;Spermatophyta;Magnoliophyta;Liliopsida;Poales;Festuca;";"0.0";"0";"1";"1";"0";"1";"0";"457182";"373894"
"V4mis1";"SILVA (only NR);Eukaryota;Archaeplastida;Chloroplastida;Charophyta;Phragmoplastophyta;Streptophyta;Embryophyta;Tracheophyta;Spermatophyta;Magnoliophyta;Liliopsida;Poales;Flagellaria;";"0.0";"0";"1";"1";"0";"1";"0";"457182";"373894"
"V4mis1";"SILVA (only NR);Eukaryota;Archaeplastida;Chloroplastida;Charophyta;Phragmoplastophyta;Streptophyta;Embryophyta;Tracheophyta;Spermatophyta;Magnoliophyta;Liliopsida;Poales;Hordeum;";"0.0";"0";"24";"24";"0";"24";"0";"457159";"373894"
"V4mis1";"SILVA (only NR);Eukaryota;Archaeplastida;Chloroplastida;Charophyta;Phragmoplastophyta;Streptophyta;Embryophyta;Tracheophyta;Spermatophyta;Magnoliophyta;Liliopsida;Poales;Joinvillea;";"0.0";"0";"1";"1";"0";"1";"0";"457182";"373894"
"V4mis1";"SILVA (only NR);Eukaryota;Archaeplastida;Chloroplastida;Charophyta;Phragmoplastophyta;Streptophyta;Embryophyta;Tracheophyta;Spermatophyta;Magnoliophyta;Liliopsida;Poales;Juncus;";"0.0";"0";"4";"4";"0";"4";"0";"457179";"373894"
"V4mis1";"SILVA (only NR);Eukaryota;Archaeplastida;Chloroplastida;Charophyta;Phragmoplastophyta;Streptophyta;Embryophyta;Tracheophyta;Spermatophyta;Magnoliophyta;Liliopsida;Poales;Loliinae;";"0.0";"0";"2";"2";"0";"2";"0";"457181";"373894"
"V4mis1";"SILVA (only NR);Eukaryota;Archaeplastida;Chloroplastida;Charophyta;Phragmoplastophyta;Streptophyta;Embryophyta;Tracheophyta;Spermatophyta;Magnoliophyta;Liliopsida;Poales;Mayaca;";"0.0";"0";"1";"1";"0";"1";"0";"457182";"373894"
"V4mis1";"SILVA (only NR);Eukaryota;Archaeplastida;Chloroplastida;Charophyta;Phragmoplastophyta;Streptophyta;Embryophyta;Tracheophyta;Spermatophyta;Magnoliophyta;Liliopsida;Poales;Oropetium;";"0.0";"0";"2";"2";"0";"2";"0";"457181";"373894"
"V4mis1";"SILVA (only NR);Eukaryota;Archaeplastida;Chloroplastida;Charophyta;Phragmoplastophyta;Streptophyta;Embryophyta;Tracheophyta;Spermatophyta;Magnoliophyta;Liliopsida;Poales;Oryza;";"3.2";"18.2";"31";"31";"1";"30";"0";"457152";"373893"
"V4mis1";"SILVA (only NR);Eukaryota;Archaeplastida;Chloroplastida;Charophyta;Phragmoplastophyta;Streptophyta;Embryophyta;Tracheophyta;Spermatophyta;Magnoliophyta;Liliopsida;Poales;Panicum;";"0.0";"0";"1";"1";"0";"1";"0";"457182";"373894"
"V4mis1";"SILVA (only NR);Eukaryota;Archaeplastida;Chloroplastida;Charophyta;Phragmoplastophyta;Streptophyta;Embryophyta;Tracheophyta;Spermatophyta;Magnoliophyta;Liliopsida;Poales;Rhynchospora;";"0.0";"0";"1";"1";"0";"1";"0";"457182";"373894"
"V4mis1";"SILVA (only NR);Eukaryota;Archaeplastida;Chloroplastida;Charophyta;Phragmoplastophyta;Streptophyta;Embryophyta;Tracheophyta;Spermatophyta;Magnoliophyta;Liliopsida;Poales;Setaria;";"0.0";"0";"1";"1";"0";"1";"0";"457182";"373894"
"V4mis1";"SILVA (only NR);Eukaryota;Archaeplastida;Chloroplastida;Charophyta;Phragmoplastophyta;Streptophyta;Embryophyta;Tracheophyta;Spermatophyta;Magnoliophyta;Liliopsida;Poales;Sorghum;";"0.0";"0";"6";"6";"0";"6";"0";"457177";"373894"
"V4mis1";"SILVA (only NR);Eukaryota;Archaeplastida;Chloroplastida;Charophyta;Phragmoplastophyta;Streptophyta;Embryophyta;Tracheophyta;Spermatophyta;Magnoliophyta;Liliopsida;Poales;Sparganium;";"0.0";"0";"1";"1";"0";"1";"0";"457182";"373894"
"V4mis1";"SILVA (only NR);Eukaryota;Archaeplastida;Chloroplastida;Charophyta;Phragmoplastophyta;Streptophyta;Embryophyta;Tracheophyta;Spermatophyta;Magnoliophyta;Liliopsida;Poales;Sporobolus;";"0.0";"0";"2";"2";"0";"2";"0";"457181";"373894"
"V4mis1";"SILVA (only NR);Eukaryota;Archaeplastida;Chloroplastida;Charophyta;Phragmoplastophyta;Streptophyta;Embryophyta;Tracheophyta;Spermatophyta;Magnoliophyta;Liliopsida;Poales;Triticum;";"16.2";"18.2";"74";"74";"12";"62";"0";"457109";"373882"
"V4mis1";"SILVA (only NR);Eukaryota;Archaeplastida;Chloroplastida;Charophyta;Phragmoplastophyta;Streptophyta;Embryophyta;Tracheophyta;Spermatophyta;Magnoliophyta;Liliopsida;Poales;Typha;";"0.0";"0";"2";"2";"0";"2";"0";"457181";"373894"
"V4mis1";"SILVA (only NR);Eukaryota;Archaeplastida;Chloroplastida;Charophyta;Phragmoplastophyta;Streptophyta;Embryophyta;Tracheophyta;Spermatophyta;Magnoliophyta;Liliopsida;Poales;Xyris;";"0.0";"0";"1";"1";"0";"1";"0";"457182";"373894"
"V4mis1";"SILVA (only NR);Eukaryota;Archaeplastida;Chloroplastida;Charophyta;Phragmoplastophyta;Streptophyta;Embryophyta;Tracheophyta;Spermatophyta;Magnoliophyta;Liliopsida;Poales;Zea;";"1.8";"18.2";"56";"56";"1";"55";"0";"457127";"373893"
"V4mis1";"SILVA (only NR);Eukaryota;Archaeplastida;Chloroplastida;Charophyta;Phragmoplastophyta;Streptophyta;Embryophyta;Tracheophyta;Spermatophyta;Magnoliophyta;Liliopsida;Poales;Zizania;";"0.0";"0";"2";"2";"0";"2";"0";"457181";"373894"
"V4mis1";"SILVA (only NR);Eukaryota;Archaeplastida;Chloroplastida;Charophyta;Phragmoplastophyta;Streptophyta;Embryophyta;Tracheophyta;Spermatophyta;Magnoliophyta;Liliopsida;Zingiberales;";"0.0";"0";"28";"27";"0";"27";"1";"457156";"373894"
"V4mis1";"SILVA (only NR);Eukaryota;Archaeplastida;Chloroplastida;Charophyta;Phragmoplastophyta;Streptophyta;Embryophyta;Tracheophyta;Spermatophyta;Magnoliophyta;Liliopsida;Zingiberales;Canna;";"0.0";"0";"2";"2";"0";"2";"0";"457181";"373894"
"V4mis1";"SILVA (only NR);Eukaryota;Archaeplastida;Chloroplastida;Charophyta;Phragmoplastophyta;Streptophyta;Embryophyta;Tracheophyta;Spermatophyta;Magnoliophyta;Liliopsida;Zingiberales;Dimerocostus;";"0.0";"0";"1";"1";"0";"1";"0";"457182";"373894"
"V4mis1";"SILVA (only NR);Eukaryota;Archaeplastida;Chloroplastida;Charophyta;Phragmoplastophyta;Streptophyta;Embryophyta;Tracheophyta;Spermatophyta;Magnoliophyta;Liliopsida;Zingiberales;Ensete;";"0.0";"0";"3";"3";"0";"3";"0";"457180";"373894"
"V4mis1";"SILVA (only NR);Eukaryota;Archaeplastida;Chloroplastida;Charophyta;Phragmoplastophyta;Streptophyta;Embryophyta;Tracheophyta;Spermatophyta;Magnoliophyta;Liliopsida;Zingiberales;Globba;";"0.0";"0";"1";"1";"0";"1";"0";"457182";"373894"
"V4mis1";"SILVA (only NR);Eukaryota;Archaeplastida;Chloroplastida;Charophyta;Phragmoplastophyta;Streptophyta;Embryophyta;Tracheophyta;Spermatophyta;Magnoliophyta;Liliopsida;Zingiberales;Goeppertia;";"0.0";"0";"1";"1";"0";"1";"0";"457182";"373894"
"V4mis1";"SILVA (only NR);Eukaryota;Archaeplastida;Chloroplastida;Charophyta;Phragmoplastophyta;Streptophyta;Embryophyta;Tracheophyta;Spermatophyta;Magnoliophyta;Liliopsida;Zingiberales;Hedychium;";"0.0";"0";"1";"1";"0";"1";"0";"457182";"373894"
"V4mis1";"SILVA (only NR);Eukaryota;Archaeplastida;Chloroplastida;Charophyta;Phragmoplastophyta;Streptophyta;Embryophyta;Tracheophyta;Spermatophyta;Magnoliophyta;Liliopsida;Zingiberales;Maranta;";"0.0";"0";"1";"1";"0";"1";"0";"457182";"373894"
"V4mis1";"SILVA (only NR);Eukaryota;Archaeplastida;Chloroplastida;Charophyta;Phragmoplastophyta;Streptophyta;Embryophyta;Tracheophyta;Spermatophyta;Magnoliophyta;Liliopsida;Zingiberales;Monocostus;";"0.0";"0";"1";"1";"0";"1";"0";"457182";"373894"
"V4mis1";"SILVA (only NR);Eukaryota;Archaeplastida;Chloroplastida;Charophyta;Phragmoplastophyta;Streptophyta;Embryophyta;Tracheophyta;Spermatophyta;Magnoliophyta;Liliopsida;Zingiberales;Musa;";"0.0";"0";"12";"11";"0";"11";"1";"457172";"373894"
"V4mis1";"SILVA (only NR);Eukaryota;Archaeplastida;Chloroplastida;Charophyta;Phragmoplastophyta;Streptophyta;Embryophyta;Tracheophyta;Spermatophyta;Magnoliophyta;Liliopsida;Zingiberales;Musella;";"0.0";"0";"1";"1";"0";"1";"0";"457182";"373894"
"V4mis1";"SILVA (only NR);Eukaryota;Archaeplastida;Chloroplastida;Charophyta;Phragmoplastophyta;Streptophyta;Embryophyta;Tracheophyta;Spermatophyta;Magnoliophyta;Liliopsida;Zingiberales;Orchidantha;";"0.0";"0";"1";"1";"0";"1";"0";"457182";"373894"
"V4mis1";"SILVA (only NR);Eukaryota;Archaeplastida;Chloroplastida;Charophyta;Phragmoplastophyta;Streptophyta;Embryophyta;Tracheophyta;Spermatophyta;Magnoliophyta;Liliopsida;Zingiberales;Phenakospermum;";"0.0";"0";"1";"1";"0";"1";"0";"457182";"373894"
"V4mis1";"SILVA (only NR);Eukaryota;Archaeplastida;Chloroplastida;Charophyta;Phragmoplastophyta;Streptophyta;Embryophyta;Tracheophyta;Spermatophyta;Magnoliophyta;Liliopsida;Zingiberales;Ravenala;";"0.0";"0";"1";"1";"0";"1";"0";"457182";"373894"
"V4mis1";"SILVA (only NR);Eukaryota;Archaeplastida;Chloroplastida;Charophyta;Phragmoplastophyta;Streptophyta;Embryophyta;Tracheophyta;Spermatophyta;Magnoliophyta;Liliopsida;Zingiberales;Tapeinochilos;";"0.0";"0";"1";"1";"0";"1";"0";"457182";"373894"
"V4mis1";"SILVA (only NR);Eukaryota;Archaeplastida;Chloroplastida;Charophyta;Phragmoplastophyta;Streptophyta;Embryophyta;Tracheophyta;Spermatophyta;Magnoliophyta;Magnoliales;";"0.0";"0";"20";"20";"0";"20";"0";"457163";"373894"
"V4mis1";"SILVA (only NR);Eukaryota;Archaeplastida;Chloroplastida;Charophyta;Phragmoplastophyta;Streptophyta;Embryophyta;Tracheophyta;Spermatophyta;Magnoliophyta;Magnoliales;Annona;";"0.0";"0";"1";"1";"0";"1";"0";"457182";"373894"
"V4mis1";"SILVA (only NR);Eukaryota;Archaeplastida;Chloroplastida;Charophyta;Phragmoplastophyta;Streptophyta;Embryophyta;Tracheophyta;Spermatophyta;Magnoliophyta;Magnoliales;Asimina;";"0.0";"0";"1";"1";"0";"1";"0";"457182";"373894"
"V4mis1";"SILVA (only NR);Eukaryota;Archaeplastida;Chloroplastida;Charophyta;Phragmoplastophyta;Streptophyta;Embryophyta;Tracheophyta;Spermatophyta;Magnoliophyta;Magnoliales;Cananga;";"0.0";"0";"1";"1";"0";"1";"0";"457182";"373894"
"V4mis1";"SILVA (only NR);Eukaryota;Archaeplastida;Chloroplastida;Charophyta;Phragmoplastophyta;Streptophyta;Embryophyta;Tracheophyta;Spermatophyta;Magnoliophyta;Magnoliales;Degeneria;";"0.0";"0";"1";"1";"0";"1";"0";"457182";"373894"
"V4mis1";"SILVA (only NR);Eukaryota;Archaeplastida;Chloroplastida;Charophyta;Phragmoplastophyta;Streptophyta;Embryophyta;Tracheophyta;Spermatophyta;Magnoliophyta;Magnoliales;Galbulimima;";"0.0";"0";"1";"1";"0";"1";"0";"457182";"373894"
"V4mis1";"SILVA (only NR);Eukaryota;Archaeplastida;Chloroplastida;Charophyta;Phragmoplastophyta;Streptophyta;Embryophyta;Tracheophyta;Spermatophyta;Magnoliophyta;Magnoliales;Gymnacranthera;";"0.0";"0";"2";"2";"0";"2";"0";"457181";"373894"
"V4mis1";"SILVA (only NR);Eukaryota;Archaeplastida;Chloroplastida;Charophyta;Phragmoplastophyta;Streptophyta;Embryophyta;Tracheophyta;Spermatophyta;Magnoliophyta;Magnoliales;Horsfieldia;";"0.0";"0";"3";"3";"0";"3";"0";"457180";"373894"
"V4mis1";"SILVA (only NR);Eukaryota;Archaeplastida;Chloroplastida;Charophyta;Phragmoplastophyta;Streptophyta;Embryophyta;Tracheophyta;Spermatophyta;Magnoliophyta;Magnoliales;Knema;";"0.0";"0";"2";"2";"0";"2";"0";"457181";"373894"
"V4mis1";"SILVA (only NR);Eukaryota;Archaeplastida;Chloroplastida;Charophyta;Phragmoplastophyta;Streptophyta;Embryophyta;Tracheophyta;Spermatophyta;Magnoliophyta;Magnoliales;Liriodendron;";"0.0";"0";"1";"1";"0";"1";"0";"457182";"373894"
"V4mis1";"SILVA (only NR);Eukaryota;Archaeplastida;Chloroplastida;Charophyta;Phragmoplastophyta;Streptophyta;Embryophyta;Tracheophyta;Spermatophyta;Magnoliophyta;Magnoliales;Magnolia;";"0.0";"0";"1";"1";"0";"1";"0";"457182";"373894"
"V4mis1";"SILVA (only NR);Eukaryota;Archaeplastida;Chloroplastida;Charophyta;Phragmoplastophyta;Streptophyta;Embryophyta;Tracheophyta;Spermatophyta;Magnoliophyta;Magnoliales;Mauloutchia;";"0.0";"0";"1";"1";"0";"1";"0";"457182";"373894"
"V4mis1";"SILVA (only NR);Eukaryota;Archaeplastida;Chloroplastida;Charophyta;Phragmoplastophyta;Streptophyta;Embryophyta;Tracheophyta;Spermatophyta;Magnoliophyta;Magnoliales;Myristica;";"0.0";"0";"4";"4";"0";"4";"0";"457179";"373894"
"V4mis1";"SILVA (only NR);Eukaryota;Archaeplastida;Chloroplastida;Charophyta;Phragmoplastophyta;Streptophyta;Embryophyta;Tracheophyta;Spermatophyta;Magnoliophyta;Magnoliales;Polyalthia;";"0.0";"0";"1";"1";"0";"1";"0";"457182";"373894"
"V4mis1";"SILVA (only NR);Eukaryota;Archaeplastida;Chloroplastida;Charophyta;Phragmoplastophyta;Streptophyta;Embryophyta;Tracheophyta;Spermatophyta;Magnoliophyta;Malpighiales;";"0.0";"0";"157";"157";"0";"157";"0";"457026";"373894"
"V4mis1";"SILVA (only NR);Eukaryota;Archaeplastida;Chloroplastida;Charophyta;Phragmoplastophyta;Streptophyta;Embryophyta;Tracheophyta;Spermatophyta;Magnoliophyta;Malpighiales;Acharia;";"0.0";"0";"1";"1";"0";"1";"0";"457182";"373894"
"V4mis1";"SILVA (only NR);Eukaryota;Archaeplastida;Chloroplastida;Charophyta;Phragmoplastophyta;Streptophyta;Embryophyta;Tracheophyta;Spermatophyta;Magnoliophyta;Malpighiales;Acidoton;";"0.0";"0";"1";"1";"0";"1";"0";"457182";"373894"
"V4mis1";"SILVA (only NR);Eukaryota;Archaeplastida;Chloroplastida;Charophyta;Phragmoplastophyta;Streptophyta;Embryophyta;Tracheophyta;Spermatophyta;Magnoliophyta;Malpighiales;Acridocarpus;";"0.0";"0";"1";"1";"0";"1";"0";"457182";"373894"
"V4mis1";"SILVA (only NR);Eukaryota;Archaeplastida;Chloroplastida;Charophyta;Phragmoplastophyta;Streptophyta;Embryophyta;Tracheophyta;Spermatophyta;Magnoliophyta;Malpighiales;Adriana;";"0.0";"0";"1";"1";"0";"1";"0";"457182";"373894"
"V4mis1";"SILVA (only NR);Eukaryota;Archaeplastida;Chloroplastida;Charophyta;Phragmoplastophyta;Streptophyta;Embryophyta;Tracheophyta;Spermatophyta;Magnoliophyta;Malpighiales;Agrostistachys;";"0.0";"0";"1";"1";"0";"1";"0";"457182";"373894"
"V4mis1";"SILVA (only NR);Eukaryota;Archaeplastida;Chloroplastida;Charophyta;Phragmoplastophyta;Streptophyta;Embryophyta;Tracheophyta;Spermatophyta;Magnoliophyta;Malpighiales;Allexis;";"0.0";"0";"1";"1";"0";"1";"0";"457182";"373894"
"V4mis1";"SILVA (only NR);Eukaryota;Archaeplastida;Chloroplastida;Charophyta;Phragmoplastophyta;Streptophyta;Embryophyta;Tracheophyta;Spermatophyta;Magnoliophyta;Malpighiales;Aneulophus;";"0.0";"0";"1";"1";"0";"1";"0";"457182";"373894"
"V4mis1";"SILVA (only NR);Eukaryota;Archaeplastida;Chloroplastida;Charophyta;Phragmoplastophyta;Streptophyta;Embryophyta;Tracheophyta;Spermatophyta;Magnoliophyta;Malpighiales;Aporosa;";"0.0";"0";"1";"1";"0";"1";"0";"457182";"373894"
"V4mis1";"SILVA (only NR);Eukaryota;Archaeplastida;Chloroplastida;Charophyta;Phragmoplastophyta;Streptophyta;Embryophyta;Tracheophyta;Spermatophyta;Magnoliophyta;Malpighiales;Aristogeitonia;";"0.0";"0";"1";"1";"0";"1";"0";"457182";"373894"
"V4mis1";"SILVA (only NR);Eukaryota;Archaeplastida;Chloroplastida;Charophyta;Phragmoplastophyta;Streptophyta;Embryophyta;Tracheophyta;Spermatophyta;Magnoliophyta;Malpighiales;Astrocasia;";"0.0";"0";"1";"1";"0";"1";"0";"457182";"373894"
"V4mis1";"SILVA (only NR);Eukaryota;Archaeplastida;Chloroplastida;Charophyta;Phragmoplastophyta;Streptophyta;Embryophyta;Tracheophyta;Spermatophyta;Magnoliophyta;Malpighiales;Balanops;";"0.0";"0";"1";"1";"0";"1";"0";"457182";"373894"
"V4mis1";"SILVA (only NR);Eukaryota;Archaeplastida;Chloroplastida;Charophyta;Phragmoplastophyta;Streptophyta;Embryophyta;Tracheophyta;Spermatophyta;Magnoliophyta;Malpighiales;Bhesa;";"0.0";"0";"1";"1";"0";"1";"0";"457182";"373894"
"V4mis1";"SILVA (only NR);Eukaryota;Archaeplastida;Chloroplastida;Charophyta;Phragmoplastophyta;Streptophyta;Embryophyta;Tracheophyta;Spermatophyta;Magnoliophyta;Malpighiales;Bonnetia;";"0.0";"0";"1";"1";"0";"1";"0";"457182";"373894"
"V4mis1";"SILVA (only NR);Eukaryota;Archaeplastida;Chloroplastida;Charophyta;Phragmoplastophyta;Streptophyta;Embryophyta;Tracheophyta;Spermatophyta;Magnoliophyta;Malpighiales;Bunchosia;";"0.0";"0";"1";"1";"0";"1";"0";"457182";"373894"
"V4mis1";"SILVA (only NR);Eukaryota;Archaeplastida;Chloroplastida;Charophyta;Phragmoplastophyta;Streptophyta;Embryophyta;Tracheophyta;Spermatophyta;Magnoliophyta;Malpighiales;Byrsonima;";"0.0";"0";"1";"1";"0";"1";"0";"457182";"373894"
"V4mis1";"SILVA (only NR);Eukaryota;Archaeplastida;Chloroplastida;Charophyta;Phragmoplastophyta;Streptophyta;Embryophyta;Tracheophyta;Spermatophyta;Magnoliophyta;Malpighiales;Camptostylus;";"0.0";"0";"1";"1";"0";"1";"0";"457182";"373894"
"V4mis1";"SILVA (only NR);Eukaryota;Archaeplastida;Chloroplastida;Charophyta;Phragmoplastophyta;Streptophyta;Embryophyta;Tracheophyta;Spermatophyta;Magnoliophyta;Malpighiales;Carallia;";"0.0";"0";"1";"1";"0";"1";"0";"457182";"373894"
"V4mis1";"SILVA (only NR);Eukaryota;Archaeplastida;Chloroplastida;Charophyta;Phragmoplastophyta;Streptophyta;Embryophyta;Tracheophyta;Spermatophyta;Magnoliophyta;Malpighiales;Caryocar;";"0.0";"0";"1";"1";"0";"1";"0";"457182";"373894"
"V4mis1";"SILVA (only NR);Eukaryota;Archaeplastida;Chloroplastida;Charophyta;Phragmoplastophyta;Streptophyta;Embryophyta;Tracheophyta;Spermatophyta;Magnoliophyta;Malpighiales;Chaetocarpus;";"0.0";"0";"1";"1";"0";"1";"0";"457182";"373894"
"V4mis1";"SILVA (only NR);Eukaryota;Archaeplastida;Chloroplastida;Charophyta;Phragmoplastophyta;Streptophyta;Embryophyta;Tracheophyta;Spermatophyta;Magnoliophyta;Malpighiales;Cladogynos;";"0.0";"0";"1";"1";"0";"1";"0";"457182";"373894"
"V4mis1";"SILVA (only NR);Eukaryota;Archaeplastida;Chloroplastida;Charophyta;Phragmoplastophyta;Streptophyta;Embryophyta;Tracheophyta;Spermatophyta;Magnoliophyta;Malpighiales;Clusia;";"0.0";"0";"1";"1";"0";"1";"0";"457182";"373894"
"V4mis1";"SILVA (only NR);Eukaryota;Archaeplastida;Chloroplastida;Charophyta;Phragmoplastophyta;Streptophyta;Embryophyta;Tracheophyta;Spermatophyta;Magnoliophyta;Malpighiales;Clutia;";"0.0";"0";"1";"1";"0";"1";"0";"457182";"373894"
"V4mis1";"SILVA (only NR);Eukaryota;Archaeplastida;Chloroplastida;Charophyta;Phragmoplastophyta;Streptophyta;Embryophyta;Tracheophyta;Spermatophyta;Magnoliophyta;Malpighiales;Cratoxylum;";"0.0";"0";"1";"1";"0";"1";"0";"457182";"373894"
"V4mis1";"SILVA (only NR);Eukaryota;Archaeplastida;Chloroplastida;Charophyta;Phragmoplastophyta;Streptophyta;Embryophyta;Tracheophyta;Spermatophyta;Magnoliophyta;Malpighiales;Croizatia;";"0.0";"0";"1";"1";"0";"1";"0";"457182";"373894"
"V4mis1";"SILVA (only NR);Eukaryota;Archaeplastida;Chloroplastida;Charophyta;Phragmoplastophyta;Streptophyta;Embryophyta;Tracheophyta;Spermatophyta;Magnoliophyta;Malpighiales;Croton;";"0.0";"0";"1";"1";"0";"1";"0";"457182";"373894"
"V4mis1";"SILVA (only NR);Eukaryota;Archaeplastida;Chloroplastida;Charophyta;Phragmoplastophyta;Streptophyta;Embryophyta;Tracheophyta;Spermatophyta;Magnoliophyta;Malpighiales;Dasylepis;";"0.0";"0";"1";"1";"0";"1";"0";"457182";"373894"
"V4mis1";"SILVA (only NR);Eukaryota;Archaeplastida;Chloroplastida;Charophyta;Phragmoplastophyta;Streptophyta;Embryophyta;Tracheophyta;Spermatophyta;Magnoliophyta;Malpighiales;Decorsella;";"0.0";"0";"1";"1";"0";"1";"0";"457182";"373894"
"V4mis1";"SILVA (only NR);Eukaryota;Archaeplastida;Chloroplastida;Charophyta;Phragmoplastophyta;Streptophyta;Embryophyta;Tracheophyta;Spermatophyta;Magnoliophyta;Malpighiales;Dicoelia;";"0.0";"0";"1";"1";"0";"1";"0";"457182";"373894"
"V4mis1";"SILVA (only NR);Eukaryota;Archaeplastida;Chloroplastida;Charophyta;Phragmoplastophyta;Streptophyta;Embryophyta;Tracheophyta;Spermatophyta;Magnoliophyta;Malpighiales;Diporidium;";"0.0";"0";"1";"1";"0";"1";"0";"457182";"373894"
"V4mis1";"SILVA (only NR);Eukaryota;Archaeplastida;Chloroplastida;Charophyta;Phragmoplastophyta;Streptophyta;Embryophyta;Tracheophyta;Spermatophyta;Magnoliophyta;Malpighiales;Durandea;";"0.0";"0";"1";"1";"0";"1";"0";"457182";"373894"
"V4mis1";"SILVA (only NR);Eukaryota;Archaeplastida;Chloroplastida;Charophyta;Phragmoplastophyta;Streptophyta;Embryophyta;Tracheophyta;Spermatophyta;Magnoliophyta;Malpighiales;Elatine;";"0.0";"0";"1";"1";"0";"1";"0";"457182";"373894"
"V4mis1";"SILVA (only NR);Eukaryota;Archaeplastida;Chloroplastida;Charophyta;Phragmoplastophyta;Streptophyta;Embryophyta;Tracheophyta;Spermatophyta;Magnoliophyta;Malpighiales;Endodesmia;";"0.0";"0";"1";"1";"0";"1";"0";"457182";"373894"
"V4mis1";"SILVA (only NR);Eukaryota;Archaeplastida;Chloroplastida;Charophyta;Phragmoplastophyta;Streptophyta;Embryophyta;Tracheophyta;Spermatophyta;Magnoliophyta;Malpighiales;Endospermum;";"0.0";"0";"1";"1";"0";"1";"0";"457182";"373894"
"V4mis1";"SILVA (only NR);Eukaryota;Archaeplastida;Chloroplastida;Charophyta;Phragmoplastophyta;Streptophyta;Embryophyta;Tracheophyta;Spermatophyta;Magnoliophyta;Malpighiales;Erythrococca;";"0.0";"0";"1";"1";"0";"1";"0";"457182";"373894"
"V4mis1";"SILVA (only NR);Eukaryota;Archaeplastida;Chloroplastida;Charophyta;Phragmoplastophyta;Streptophyta;Embryophyta;Tracheophyta;Spermatophyta;Magnoliophyta;Malpighiales;Erythroxylum;";"0.0";"0";"1";"1";"0";"1";"0";"457182";"373894"
"V4mis1";"SILVA (only NR);Eukaryota;Archaeplastida;Chloroplastida;Charophyta;Phragmoplastophyta;Streptophyta;Embryophyta;Tracheophyta;Spermatophyta;Magnoliophyta;Malpighiales;Euphorbia;";"0.0";"0";"18";"18";"0";"18";"0";"457165";"373894"
"V4mis1";"SILVA (only NR);Eukaryota;Archaeplastida;Chloroplastida;Charophyta;Phragmoplastophyta;Streptophyta;Embryophyta;Tracheophyta;Spermatophyta;Magnoliophyta;Malpighiales;Euphronia;";"0.0";"0";"1";"1";"0";"1";"0";"457182";"373894"
"V4mis1";"SILVA (only NR);Eukaryota;Archaeplastida;Chloroplastida;Charophyta;Phragmoplastophyta;Streptophyta;Embryophyta;Tracheophyta;Spermatophyta;Magnoliophyta;Malpighiales;Flacourtia;";"0.0";"0";"1";"1";"0";"1";"0";"457182";"373894"
"V4mis1";"SILVA (only NR);Eukaryota;Archaeplastida;Chloroplastida;Charophyta;Phragmoplastophyta;Streptophyta;Embryophyta;Tracheophyta;Spermatophyta;Magnoliophyta;Malpighiales;Flueggea;";"0.0";"0";"1";"1";"0";"1";"0";"457182";"373894"
"V4mis1";"SILVA (only NR);Eukaryota;Archaeplastida;Chloroplastida;Charophyta;Phragmoplastophyta;Streptophyta;Embryophyta;Tracheophyta;Spermatophyta;Magnoliophyta;Malpighiales;Fusispermum;";"0.0";"0";"1";"1";"0";"1";"0";"457182";"373894"
"V4mis1";"SILVA (only NR);Eukaryota;Archaeplastida;Chloroplastida;Charophyta;Phragmoplastophyta;Streptophyta;Embryophyta;Tracheophyta;Spermatophyta;Magnoliophyta;Malpighiales;Galearia;";"0.0";"0";"1";"1";"0";"1";"0";"457182";"373894"
"V4mis1";"SILVA (only NR);Eukaryota;Archaeplastida;Chloroplastida;Charophyta;Phragmoplastophyta;Streptophyta;Embryophyta;Tracheophyta;Spermatophyta;Magnoliophyta;Malpighiales;Galphimia;";"0.0";"0";"1";"1";"0";"1";"0";"457182";"373894"
"V4mis1";"SILVA (only NR);Eukaryota;Archaeplastida;Chloroplastida;Charophyta;Phragmoplastophyta;Streptophyta;Embryophyta;Tracheophyta;Spermatophyta;Magnoliophyta;Malpighiales;Garcinia;";"0.0";"0";"1";"1";"0";"1";"0";"457182";"373894"
"V4mis1";"SILVA (only NR);Eukaryota;Archaeplastida;Chloroplastida;Charophyta;Phragmoplastophyta;Streptophyta;Embryophyta;Tracheophyta;Spermatophyta;Magnoliophyta;Malpighiales;Hevea;";"0.0";"0";"10";"10";"0";"10";"0";"457173";"373894"
"V4mis1";"SILVA (only NR);Eukaryota;Archaeplastida;Chloroplastida;Charophyta;Phragmoplastophyta;Streptophyta;Embryophyta;Tracheophyta;Spermatophyta;Magnoliophyta;Malpighiales;Heywoodia;";"0.0";"0";"1";"1";"0";"1";"0";"457182";"373894"
"V4mis1";"SILVA (only NR);Eukaryota;Archaeplastida;Chloroplastida;Charophyta;Phragmoplastophyta;Streptophyta;Embryophyta;Tracheophyta;Spermatophyta;Magnoliophyta;Malpighiales;Hirtella;";"0.0";"0";"1";"1";"0";"1";"0";"457182";"373894"
"V4mis1";"SILVA (only NR);Eukaryota;Archaeplastida;Chloroplastida;Charophyta;Phragmoplastophyta;Streptophyta;Embryophyta;Tracheophyta;Spermatophyta;Magnoliophyta;Malpighiales;Homalium;";"0.0";"0";"1";"1";"0";"1";"0";"457182";"373894"
"V4mis1";"SILVA (only NR);Eukaryota;Archaeplastida;Chloroplastida;Charophyta;Phragmoplastophyta;Streptophyta;Embryophyta;Tracheophyta;Spermatophyta;Magnoliophyta;Malpighiales;Hugonia;";"0.0";"0";"1";"1";"0";"1";"0";"457182";"373894"
"V4mis1";"SILVA (only NR);Eukaryota;Archaeplastida;Chloroplastida;Charophyta;Phragmoplastophyta;Streptophyta;Embryophyta;Tracheophyta;Spermatophyta;Magnoliophyta;Malpighiales;Hybanthus;";"0.0";"0";"1";"1";"0";"1";"0";"457182";"373894"
"V4mis1";"SILVA (only NR);Eukaryota;Archaeplastida;Chloroplastida;Charophyta;Phragmoplastophyta;Streptophyta;Embryophyta;Tracheophyta;Spermatophyta;Magnoliophyta;Malpighiales;Hymenanthera;";"0.0";"0";"1";"1";"0";"1";"0";"457182";"373894"
"V4mis1";"SILVA (only NR);Eukaryota;Archaeplastida;Chloroplastida;Charophyta;Phragmoplastophyta;Streptophyta;Embryophyta;Tracheophyta;Spermatophyta;Magnoliophyta;Malpighiales;Hypericum;";"0.0";"0";"1";"1";"0";"1";"0";"457182";"373894"
"V4mis1";"SILVA (only NR);Eukaryota;Archaeplastida;Chloroplastida;Charophyta;Phragmoplastophyta;Streptophyta;Embryophyta;Tracheophyta;Spermatophyta;Magnoliophyta;Malpighiales;Irvingia;";"0.0";"0";"1";"1";"0";"1";"0";"457182";"373894"
"V4mis1";"SILVA (only NR);Eukaryota;Archaeplastida;Chloroplastida;Charophyta;Phragmoplastophyta;Streptophyta;Embryophyta;Tracheophyta;Spermatophyta;Magnoliophyta;Malpighiales;Isodendrion;";"0.0";"0";"1";"1";"0";"1";"0";"457182";"373894"
"V4mis1";"SILVA (only NR);Eukaryota;Archaeplastida;Chloroplastida;Charophyta;Phragmoplastophyta;Streptophyta;Embryophyta;Tracheophyta;Spermatophyta;Magnoliophyta;Malpighiales;Ixonanthes;";"0.0";"0";"3";"3";"0";"3";"0";"457180";"373894"
"V4mis1";"SILVA (only NR);Eukaryota;Archaeplastida;Chloroplastida;Charophyta;Phragmoplastophyta;Streptophyta;Embryophyta;Tracheophyta;Spermatophyta;Magnoliophyta;Malpighiales;Jatropha;";"0.0";"0";"2";"2";"0";"2";"0";"457181";"373894"
"V4mis1";"SILVA (only NR);Eukaryota;Archaeplastida;Chloroplastida;Charophyta;Phragmoplastophyta;Streptophyta;Embryophyta;Tracheophyta;Spermatophyta;Magnoliophyta;Malpighiales;Lachnostylis;";"0.0";"0";"1";"1";"0";"1";"0";"457182";"373894"
"V4mis1";"SILVA (only NR);Eukaryota;Archaeplastida;Chloroplastida;Charophyta;Phragmoplastophyta;Streptophyta;Embryophyta;Tracheophyta;Spermatophyta;Magnoliophyta;Malpighiales;Lacistema;";"0.0";"0";"2";"2";"0";"2";"0";"457181";"373894"
"V4mis1";"SILVA (only NR);Eukaryota;Archaeplastida;Chloroplastida;Charophyta;Phragmoplastophyta;Streptophyta;Embryophyta;Tracheophyta;Spermatophyta;Magnoliophyta;Malpighiales;Lasiocroton;";"0.0";"0";"1";"1";"0";"1";"0";"457182";"373894"
"V4mis1";"SILVA (only NR);Eukaryota;Archaeplastida;Chloroplastida;Charophyta;Phragmoplastophyta;Streptophyta;Embryophyta;Tracheophyta;Spermatophyta;Magnoliophyta;Malpighiales;Linum;";"0.0";"0";"6";"6";"0";"6";"0";"457177";"373894"
"V4mis1";"SILVA (only NR);Eukaryota;Archaeplastida;Chloroplastida;Charophyta;Phragmoplastophyta;Streptophyta;Embryophyta;Tracheophyta;Spermatophyta;Magnoliophyta;Malpighiales;Lophopyxis;";"0.0";"0";"1";"1";"0";"1";"0";"457182";"373894"
"V4mis1";"SILVA (only NR);Eukaryota;Archaeplastida;Chloroplastida;Charophyta;Phragmoplastophyta;Streptophyta;Embryophyta;Tracheophyta;Spermatophyta;Magnoliophyta;Malpighiales;Luxemburgia;";"0.0";"0";"1";"1";"0";"1";"0";"457182";"373894"
"V4mis1";"SILVA (only NR);Eukaryota;Archaeplastida;Chloroplastida;Charophyta;Phragmoplastophyta;Streptophyta;Embryophyta;Tracheophyta;Spermatophyta;Magnoliophyta;Malpighiales;Malesherbia;";"0.0";"0";"1";"1";"0";"1";"0";"457182";"373894"
"V4mis1";"SILVA (only NR);Eukaryota;Archaeplastida;Chloroplastida;Charophyta;Phragmoplastophyta;Streptophyta;Embryophyta;Tracheophyta;Spermatophyta;Magnoliophyta;Malpighiales;Malpighia;";"0.0";"0";"1";"1";"0";"1";"0";"457182";"373894"
"V4mis1";"SILVA (only NR);Eukaryota;Archaeplastida;Chloroplastida;Charophyta;Phragmoplastophyta;Streptophyta;Embryophyta;Tracheophyta;Spermatophyta;Magnoliophyta;Malpighiales;Mammea;";"0.0";"0";"1";"1";"0";"1";"0";"457182";"373894"
"V4mis1";"SILVA (only NR);Eukaryota;Archaeplastida;Chloroplastida;Charophyta;Phragmoplastophyta;Streptophyta;Embryophyta;Tracheophyta;Spermatophyta;Magnoliophyta;Malpighiales;Manihot;";"0.0";"0";"4";"4";"0";"4";"0";"457179";"373894"
"V4mis1";"SILVA (only NR);Eukaryota;Archaeplastida;Chloroplastida;Charophyta;Phragmoplastophyta;Streptophyta;Embryophyta;Tracheophyta;Spermatophyta;Magnoliophyta;Malpighiales;Marathrum;";"0.0";"0";"1";"1";"0";"1";"0";"457182";"373894"
"V4mis1";"SILVA (only NR);Eukaryota;Archaeplastida;Chloroplastida;Charophyta;Phragmoplastophyta;Streptophyta;Embryophyta;Tracheophyta;Spermatophyta;Magnoliophyta;Malpighiales;Mareya;";"0.0";"0";"1";"1";"0";"1";"0";"457182";"373894"
"V4mis1";"SILVA (only NR);Eukaryota;Archaeplastida;Chloroplastida;Charophyta;Phragmoplastophyta;Streptophyta;Embryophyta;Tracheophyta;Spermatophyta;Magnoliophyta;Malpighiales;Mathurina;";"0.0";"0";"1";"1";"0";"1";"0";"457182";"373894"
"V4mis1";"SILVA (only NR);Eukaryota;Archaeplastida;Chloroplastida;Charophyta;Phragmoplastophyta;Streptophyta;Embryophyta;Tracheophyta;Spermatophyta;Magnoliophyta;Malpighiales;Mayanaea;";"0.0";"0";"1";"1";"0";"1";"0";"457182";"373894"
"V4mis1";"SILVA (only NR);Eukaryota;Archaeplastida;Chloroplastida;Charophyta;Phragmoplastophyta;Streptophyta;Embryophyta;Tracheophyta;Spermatophyta;Magnoliophyta;Malpighiales;Medusagyne;";"0.0";"0";"1";"1";"0";"1";"0";"457182";"373894"
"V4mis1";"SILVA (only NR);Eukaryota;Archaeplastida;Chloroplastida;Charophyta;Phragmoplastophyta;Streptophyta;Embryophyta;Tracheophyta;Spermatophyta;Magnoliophyta;Malpighiales;Meineckia;";"0.0";"0";"1";"1";"0";"1";"0";"457182";"373894"
"V4mis1";"SILVA (only NR);Eukaryota;Archaeplastida;Chloroplastida;Charophyta;Phragmoplastophyta;Streptophyta;Embryophyta;Tracheophyta;Spermatophyta;Magnoliophyta;Malpighiales;Mesua;";"0.0";"0";"1";"1";"0";"1";"0";"457182";"373894"
"V4mis1";"SILVA (only NR);Eukaryota;Archaeplastida;Chloroplastida;Charophyta;Phragmoplastophyta;Streptophyta;Embryophyta;Tracheophyta;Spermatophyta;Magnoliophyta;Malpighiales;Montrouziera;";"0.0";"0";"1";"1";"0";"1";"0";"457182";"373894"
"V4mis1";"SILVA (only NR);Eukaryota;Archaeplastida;Chloroplastida;Charophyta;Phragmoplastophyta;Streptophyta;Embryophyta;Tracheophyta;Spermatophyta;Magnoliophyta;Malpighiales;Ochthocosmus;";"0.0";"0";"1";"1";"0";"1";"0";"457182";"373894"
"V4mis1";"SILVA (only NR);Eukaryota;Archaeplastida;Chloroplastida;Charophyta;Phragmoplastophyta;Streptophyta;Embryophyta;Tracheophyta;Spermatophyta;Magnoliophyta;Malpighiales;Omphalea;";"0.0";"0";"1";"1";"0";"1";"0";"457182";"373894"
"V4mis1";"SILVA (only NR);Eukaryota;Archaeplastida;Chloroplastida;Charophyta;Phragmoplastophyta;Streptophyta;Embryophyta;Tracheophyta;Spermatophyta;Magnoliophyta;Malpighiales;Pangium;";"0.0";"0";"1";"1";"0";"1";"0";"457182";"373894"
"V4mis1";"SILVA (only NR);Eukaryota;Archaeplastida;Chloroplastida;Charophyta;Phragmoplastophyta;Streptophyta;Embryophyta;Tracheophyta;Spermatophyta;Magnoliophyta;Malpighiales;Paradrypetes;";"0.0";"0";"1";"1";"0";"1";"0";"457182";"373894"
"V4mis1";"SILVA (only NR);Eukaryota;Archaeplastida;Chloroplastida;Charophyta;Phragmoplastophyta;Streptophyta;Embryophyta;Tracheophyta;Spermatophyta;Magnoliophyta;Malpighiales;Passiflora;";"0.0";"0";"1";"1";"0";"1";"0";"457182";"373894"
"V4mis1";"SILVA (only NR);Eukaryota;Archaeplastida;Chloroplastida;Charophyta;Phragmoplastophyta;Streptophyta;Embryophyta;Tracheophyta;Spermatophyta;Magnoliophyta;Malpighiales;Pera;";"0.0";"0";"1";"1";"0";"1";"0";"457182";"373894"
"V4mis1";"SILVA (only NR);Eukaryota;Archaeplastida;Chloroplastida;Charophyta;Phragmoplastophyta;Streptophyta;Embryophyta;Tracheophyta;Spermatophyta;Magnoliophyta;Malpighiales;Philyra;";"0.0";"0";"1";"1";"0";"1";"0";"457182";"373894"
"V4mis1";"SILVA (only NR);Eukaryota;Archaeplastida;Chloroplastida;Charophyta;Phragmoplastophyta;Streptophyta;Embryophyta;Tracheophyta;Spermatophyta;Magnoliophyta;Malpighiales;Phyllanthus;";"0.0";"0";"2";"2";"0";"2";"0";"457181";"373894"
"V4mis1";"SILVA (only NR);Eukaryota;Archaeplastida;Chloroplastida;Charophyta;Phragmoplastophyta;Streptophyta;Embryophyta;Tracheophyta;Spermatophyta;Magnoliophyta;Malpighiales;Picrodendron;";"0.0";"0";"1";"1";"0";"1";"0";"457182";"373894"
"V4mis1";"SILVA (only NR);Eukaryota;Archaeplastida;Chloroplastida;Charophyta;Phragmoplastophyta;Streptophyta;Embryophyta;Tracheophyta;Spermatophyta;Magnoliophyta;Malpighiales;Piriqueta;";"0.0";"0";"1";"1";"0";"1";"0";"457182";"373894"
"V4mis1";"SILVA (only NR);Eukaryota;Archaeplastida;Chloroplastida;Charophyta;Phragmoplastophyta;Streptophyta;Embryophyta;Tracheophyta;Spermatophyta;Magnoliophyta;Malpighiales;Ploiarium;";"0.0";"0";"1";"1";"0";"1";"0";"457182";"373894"
"V4mis1";"SILVA (only NR);Eukaryota;Archaeplastida;Chloroplastida;Charophyta;Phragmoplastophyta;Streptophyta;Embryophyta;Tracheophyta;Spermatophyta;Magnoliophyta;Malpighiales;Plukenetia;";"0.0";"0";"1";"1";"0";"1";"0";"457182";"373894"
"V4mis1";"SILVA (only NR);Eukaryota;Archaeplastida;Chloroplastida;Charophyta;Phragmoplastophyta;Streptophyta;Embryophyta;Tracheophyta;Spermatophyta;Magnoliophyta;Malpighiales;Podostemum;";"0.0";"0";"1";"1";"0";"1";"0";"457182";"373894"
"V4mis1";"SILVA (only NR);Eukaryota;Archaeplastida;Chloroplastida;Charophyta;Phragmoplastophyta;Streptophyta;Embryophyta;Tracheophyta;Spermatophyta;Magnoliophyta;Malpighiales;Populus;";"0.0";"0";"12";"12";"0";"12";"0";"457171";"373894"
"V4mis1";"SILVA (only NR);Eukaryota;Archaeplastida;Chloroplastida;Charophyta;Phragmoplastophyta;Streptophyta;Embryophyta;Tracheophyta;Spermatophyta;Magnoliophyta;Malpighiales;Putranjiva;";"0.0";"0";"1";"1";"0";"1";"0";"457182";"373894"
"V4mis1";"SILVA (only NR);Eukaryota;Archaeplastida;Chloroplastida;Charophyta;Phragmoplastophyta;Streptophyta;Embryophyta;Tracheophyta;Spermatophyta;Magnoliophyta;Malpighiales;Quiina;";"0.0";"0";"1";"1";"0";"1";"0";"457182";"373894"
"V4mis1";"SILVA (only NR);Eukaryota;Archaeplastida;Chloroplastida;Charophyta;Phragmoplastophyta;Streptophyta;Embryophyta;Tracheophyta;Spermatophyta;Magnoliophyta;Malpighiales;Rafflesia;";"0.0";"0";"1";"1";"0";"1";"0";"457182";"373894"
"V4mis1";"SILVA (only NR);Eukaryota;Archaeplastida;Chloroplastida;Charophyta;Phragmoplastophyta;Streptophyta;Embryophyta;Tracheophyta;Spermatophyta;Magnoliophyta;Malpighiales;Reinwardtia;";"0.0";"0";"1";"1";"0";"1";"0";"457182";"373894"
"V4mis1";"SILVA (only NR);Eukaryota;Archaeplastida;Chloroplastida;Charophyta;Phragmoplastophyta;Streptophyta;Embryophyta;Tracheophyta;Spermatophyta;Magnoliophyta;Malpighiales;Rhizanthes;";"0.0";"0";"1";"1";"0";"1";"0";"457182";"373894"
"V4mis1";"SILVA (only NR);Eukaryota;Archaeplastida;Chloroplastida;Charophyta;Phragmoplastophyta;Streptophyta;Embryophyta;Tracheophyta;Spermatophyta;Magnoliophyta;Malpighiales;Ricinus;";"0.0";"0";"3";"3";"0";"3";"0";"457180";"373894"
"V4mis1";"SILVA (only NR);Eukaryota;Archaeplastida;Chloroplastida;Charophyta;Phragmoplastophyta;Streptophyta;Embryophyta;Tracheophyta;Spermatophyta;Magnoliophyta;Malpighiales;Rinorea;";"0.0";"0";"1";"1";"0";"1";"0";"457182";"373894"
"V4mis1";"SILVA (only NR);Eukaryota;Archaeplastida;Chloroplastida;Charophyta;Phragmoplastophyta;Streptophyta;Embryophyta;Tracheophyta;Spermatophyta;Magnoliophyta;Malpighiales;Rinoreocarpus;";"0.0";"0";"1";"1";"0";"1";"0";"457182";"373894"
"V4mis1";"SILVA (only NR);Eukaryota;Archaeplastida;Chloroplastida;Charophyta;Phragmoplastophyta;Streptophyta;Embryophyta;Tracheophyta;Spermatophyta;Magnoliophyta;Malpighiales;Sapria;";"0.0";"0";"2";"2";"0";"2";"0";"457181";"373894"
"V4mis1";"SILVA (only NR);Eukaryota;Archaeplastida;Chloroplastida;Charophyta;Phragmoplastophyta;Streptophyta;Embryophyta;Tracheophyta;Spermatophyta;Magnoliophyta;Malpighiales;Sauvagesia;";"0.0";"0";"1";"1";"0";"1";"0";"457182";"373894"
"V4mis1";"SILVA (only NR);Eukaryota;Archaeplastida;Chloroplastida;Charophyta;Phragmoplastophyta;Streptophyta;Embryophyta;Tracheophyta;Spermatophyta;Magnoliophyta;Malpighiales;Stapfiella;";"0.0";"0";"1";"1";"0";"1";"0";"457182";"373894"
"V4mis1";"SILVA (only NR);Eukaryota;Archaeplastida;Chloroplastida;Charophyta;Phragmoplastophyta;Streptophyta;Embryophyta;Tracheophyta;Spermatophyta;Magnoliophyta;Malpighiales;Tapura;";"0.0";"0";"1";"1";"0";"1";"0";"457182";"373894"
"V4mis1";"SILVA (only NR);Eukaryota;Archaeplastida;Chloroplastida;Charophyta;Phragmoplastophyta;Streptophyta;Embryophyta;Tracheophyta;Spermatophyta;Magnoliophyta;Malpighiales;Tetrapterys;";"0.0";"0";"1";"1";"0";"1";"0";"457182";"373894"
"V4mis1";"SILVA (only NR);Eukaryota;Archaeplastida;Chloroplastida;Charophyta;Phragmoplastophyta;Streptophyta;Embryophyta;Tracheophyta;Spermatophyta;Magnoliophyta;Malpighiales;Tetrorchidium;";"0.0";"0";"1";"1";"0";"1";"0";"457182";"373894"
"V4mis1";"SILVA (only NR);Eukaryota;Archaeplastida;Chloroplastida;Charophyta;Phragmoplastophyta;Streptophyta;Embryophyta;Tracheophyta;Spermatophyta;Magnoliophyta;Malpighiales;Trigonia;";"0.0";"0";"1";"1";"0";"1";"0";"457182";"373894"
"V4mis1";"SILVA (only NR);Eukaryota;Archaeplastida;Chloroplastida;Charophyta;Phragmoplastophyta;Streptophyta;Embryophyta;Tracheophyta;Spermatophyta;Magnoliophyta;Malpighiales;Vantanea;";"0.0";"0";"1";"1";"0";"1";"0";"457182";"373894"
"V4mis1";"SILVA (only NR);Eukaryota;Archaeplastida;Chloroplastida;Charophyta;Phragmoplastophyta;Streptophyta;Embryophyta;Tracheophyta;Spermatophyta;Magnoliophyta;Malpighiales;Viola;";"0.0";"0";"1";"1";"0";"1";"0";"457182";"373894"
"V4mis1";"SILVA (only NR);Eukaryota;Archaeplastida;Chloroplastida;Charophyta;Phragmoplastophyta;Streptophyta;Embryophyta;Tracheophyta;Spermatophyta;Magnoliophyta;Malvales;";"0.0";"0";"328";"327";"0";"327";"1";"456856";"373894"
"V4mis1";"SILVA (only NR);Eukaryota;Archaeplastida;Chloroplastida;Charophyta;Phragmoplastophyta;Streptophyta;Embryophyta;Tracheophyta;Spermatophyta;Magnoliophyta;Malvales;Anisoptera;";"0.0";"0";"1";"1";"0";"1";"0";"457182";"373894"
"V4mis1";"SILVA (only NR);Eukaryota;Archaeplastida;Chloroplastida;Charophyta;Phragmoplastophyta;Streptophyta;Embryophyta;Tracheophyta;Spermatophyta;Magnoliophyta;Malvales;Aquilaria;";"0.0";"0";"15";"15";"0";"15";"0";"457168";"373894"
"V4mis1";"SILVA (only NR);Eukaryota;Archaeplastida;Chloroplastida;Charophyta;Phragmoplastophyta;Streptophyta;Embryophyta;Tracheophyta;Spermatophyta;Magnoliophyta;Malvales;Bdallophytum;";"0.0";"0";"1";"1";"0";"1";"0";"457182";"373894"
"V4mis1";"SILVA (only NR);Eukaryota;Archaeplastida;Chloroplastida;Charophyta;Phragmoplastophyta;Streptophyta;Embryophyta;Tracheophyta;Spermatophyta;Magnoliophyta;Malvales;Bixa;";"0.0";"0";"1";"1";"0";"1";"0";"457182";"373894"
"V4mis1";"SILVA (only NR);Eukaryota;Archaeplastida;Chloroplastida;Charophyta;Phragmoplastophyta;Streptophyta;Embryophyta;Tracheophyta;Spermatophyta;Magnoliophyta;Malvales;Bombax;";"0.0";"0";"1";"1";"0";"1";"0";"457182";"373894"
"V4mis1";"SILVA (only NR);Eukaryota;Archaeplastida;Chloroplastida;Charophyta;Phragmoplastophyta;Streptophyta;Embryophyta;Tracheophyta;Spermatophyta;Magnoliophyta;Malvales;Callirhoe;";"0.0";"0";"1";"1";"0";"1";"0";"457182";"373894"
"V4mis1";"SILVA (only NR);Eukaryota;Archaeplastida;Chloroplastida;Charophyta;Phragmoplastophyta;Streptophyta;Embryophyta;Tracheophyta;Spermatophyta;Magnoliophyta;Malvales;Corchorus;";"0.0";"0";"2";"2";"0";"2";"0";"457181";"373894"
"V4mis1";"SILVA (only NR);Eukaryota;Archaeplastida;Chloroplastida;Charophyta;Phragmoplastophyta;Streptophyta;Embryophyta;Tracheophyta;Spermatophyta;Magnoliophyta;Malvales;Cytinus;";"0.0";"0";"3";"3";"0";"3";"0";"457180";"373894"
"V4mis1";"SILVA (only NR);Eukaryota;Archaeplastida;Chloroplastida;Charophyta;Phragmoplastophyta;Streptophyta;Embryophyta;Tracheophyta;Spermatophyta;Magnoliophyta;Malvales;Durio;";"0.0";"0";"1";"1";"0";"1";"0";"457182";"373894"
"V4mis1";"SILVA (only NR);Eukaryota;Archaeplastida;Chloroplastida;Charophyta;Phragmoplastophyta;Streptophyta;Embryophyta;Tracheophyta;Spermatophyta;Magnoliophyta;Malvales;Gossypium;";"0.0";"0";"284";"283";"0";"283";"1";"456900";"373894"
"V4mis1";"SILVA (only NR);Eukaryota;Archaeplastida;Chloroplastida;Charophyta;Phragmoplastophyta;Streptophyta;Embryophyta;Tracheophyta;Spermatophyta;Magnoliophyta;Malvales;Grewia;";"0.0";"0";"1";"1";"0";"1";"0";"457182";"373894"
"V4mis1";"SILVA (only NR);Eukaryota;Archaeplastida;Chloroplastida;Charophyta;Phragmoplastophyta;Streptophyta;Embryophyta;Tracheophyta;Spermatophyta;Magnoliophyta;Malvales;Helianthemum;";"0.0";"0";"1";"1";"0";"1";"0";"457182";"373894"
"V4mis1";"SILVA (only NR);Eukaryota;Archaeplastida;Chloroplastida;Charophyta;Phragmoplastophyta;Streptophyta;Embryophyta;Tracheophyta;Spermatophyta;Magnoliophyta;Malvales;Hibiscus;";"0.0";"0";"8";"8";"0";"8";"0";"457175";"373894"
"V4mis1";"SILVA (only NR);Eukaryota;Archaeplastida;Chloroplastida;Charophyta;Phragmoplastophyta;Streptophyta;Embryophyta;Tracheophyta;Spermatophyta;Magnoliophyta;Malvales;Malva;";"0.0";"0";"1";"1";"0";"1";"0";"457182";"373894"
"V4mis1";"SILVA (only NR);Eukaryota;Archaeplastida;Chloroplastida;Charophyta;Phragmoplastophyta;Streptophyta;Embryophyta;Tracheophyta;Spermatophyta;Magnoliophyta;Malvales;Muntingia;";"0.0";"0";"1";"1";"0";"1";"0";"457182";"373894"
"V4mis1";"SILVA (only NR);Eukaryota;Archaeplastida;Chloroplastida;Charophyta;Phragmoplastophyta;Streptophyta;Embryophyta;Tracheophyta;Spermatophyta;Magnoliophyta;Malvales;Neurada;";"0.0";"0";"1";"1";"0";"1";"0";"457182";"373894"
"V4mis1";"SILVA (only NR);Eukaryota;Archaeplastida;Chloroplastida;Charophyta;Phragmoplastophyta;Streptophyta;Embryophyta;Tracheophyta;Spermatophyta;Magnoliophyta;Malvales;Ochroma;";"0.0";"0";"1";"1";"0";"1";"0";"457182";"373894"
"V4mis1";"SILVA (only NR);Eukaryota;Archaeplastida;Chloroplastida;Charophyta;Phragmoplastophyta;Streptophyta;Embryophyta;Tracheophyta;Spermatophyta;Magnoliophyta;Malvales;Sphaeralcea;";"0.0";"0";"1";"1";"0";"1";"0";"457182";"373894"
"V4mis1";"SILVA (only NR);Eukaryota;Archaeplastida;Chloroplastida;Charophyta;Phragmoplastophyta;Streptophyta;Embryophyta;Tracheophyta;Spermatophyta;Magnoliophyta;Malvales;Sterculia;";"0.0";"0";"1";"1";"0";"1";"0";"457182";"373894"
"V4mis1";"SILVA (only NR);Eukaryota;Archaeplastida;Chloroplastida;Charophyta;Phragmoplastophyta;Streptophyta;Embryophyta;Tracheophyta;Spermatophyta;Magnoliophyta;Malvales;Theobroma;";"0.0";"0";"1";"1";"0";"1";"0";"457182";"373894"
"V4mis1";"SILVA (only NR);Eukaryota;Archaeplastida;Chloroplastida;Charophyta;Phragmoplastophyta;Streptophyta;Embryophyta;Tracheophyta;Spermatophyta;Magnoliophyta;Malvales;Thymelaea;";"0.0";"0";"1";"1";"0";"1";"0";"457182";"373894"
"V4mis1";"SILVA (only NR);Eukaryota;Archaeplastida;Chloroplastida;Charophyta;Phragmoplastophyta;Streptophyta;Embryophyta;Tracheophyta;Spermatophyta;Magnoliophyta;Myrtales;";"0.0";"0";"53";"53";"0";"53";"0";"457130";"373894"
"V4mis1";"SILVA (only NR);Eukaryota;Archaeplastida;Chloroplastida;Charophyta;Phragmoplastophyta;Streptophyta;Embryophyta;Tracheophyta;Spermatophyta;Magnoliophyta;Myrtales;Brachysiphon;";"0.0";"0";"1";"1";"0";"1";"0";"457182";"373894"
"V4mis1";"SILVA (only NR);Eukaryota;Archaeplastida;Chloroplastida;Charophyta;Phragmoplastophyta;Streptophyta;Embryophyta;Tracheophyta;Spermatophyta;Magnoliophyta;Myrtales;Combretum;";"0.0";"0";"1";"1";"0";"1";"0";"457182";"373894"
"V4mis1";"SILVA (only NR);Eukaryota;Archaeplastida;Chloroplastida;Charophyta;Phragmoplastophyta;Streptophyta;Embryophyta;Tracheophyta;Spermatophyta;Magnoliophyta;Myrtales;Crypteronia;";"0.0";"0";"1";"1";"0";"1";"0";"457182";"373894"
"V4mis1";"SILVA (only NR);Eukaryota;Archaeplastida;Chloroplastida;Charophyta;Phragmoplastophyta;Streptophyta;Embryophyta;Tracheophyta;Spermatophyta;Magnoliophyta;Myrtales;Cuphea;";"0.0";"0";"1";"1";"0";"1";"0";"457182";"373894"
"V4mis1";"SILVA (only NR);Eukaryota;Archaeplastida;Chloroplastida;Charophyta;Phragmoplastophyta;Streptophyta;Embryophyta;Tracheophyta;Spermatophyta;Magnoliophyta;Myrtales;Endonema;";"0.0";"0";"1";"1";"0";"1";"0";"457182";"373894"
"V4mis1";"SILVA (only NR);Eukaryota;Archaeplastida;Chloroplastida;Charophyta;Phragmoplastophyta;Streptophyta;Embryophyta;Tracheophyta;Spermatophyta;Magnoliophyta;Myrtales;Eucalyptus;";"0.0";"0";"8";"8";"0";"8";"0";"457175";"373894"
"V4mis1";"SILVA (only NR);Eukaryota;Archaeplastida;Chloroplastida;Charophyta;Phragmoplastophyta;Streptophyta;Embryophyta;Tracheophyta;Spermatophyta;Magnoliophyta;Myrtales;Laguncularia;";"0.0";"0";"1";"1";"0";"1";"0";"457182";"373894"
"V4mis1";"SILVA (only NR);Eukaryota;Archaeplastida;Chloroplastida;Charophyta;Phragmoplastophyta;Streptophyta;Embryophyta;Tracheophyta;Spermatophyta;Magnoliophyta;Myrtales;Lythrum;";"0.0";"0";"1";"1";"0";"1";"0";"457182";"373894"
"V4mis1";"SILVA (only NR);Eukaryota;Archaeplastida;Chloroplastida;Charophyta;Phragmoplastophyta;Streptophyta;Embryophyta;Tracheophyta;Spermatophyta;Magnoliophyta;Myrtales;Mouriri;";"0.0";"0";"1";"1";"0";"1";"0";"457182";"373894"
"V4mis1";"SILVA (only NR);Eukaryota;Archaeplastida;Chloroplastida;Charophyta;Phragmoplastophyta;Streptophyta;Embryophyta;Tracheophyta;Spermatophyta;Magnoliophyta;Myrtales;Oenothera;";"0.0";"0";"3";"3";"0";"3";"0";"457180";"373894"
"V4mis1";"SILVA (only NR);Eukaryota;Archaeplastida;Chloroplastida;Charophyta;Phragmoplastophyta;Streptophyta;Embryophyta;Tracheophyta;Spermatophyta;Magnoliophyta;Myrtales;Osbeckia;";"0.0";"0";"1";"1";"0";"1";"0";"457182";"373894"
"V4mis1";"SILVA (only NR);Eukaryota;Archaeplastida;Chloroplastida;Charophyta;Phragmoplastophyta;Streptophyta;Embryophyta;Tracheophyta;Spermatophyta;Magnoliophyta;Myrtales;Pemphis;";"0.0";"0";"1";"1";"0";"1";"0";"457182";"373894"
"V4mis1";"SILVA (only NR);Eukaryota;Archaeplastida;Chloroplastida;Charophyta;Phragmoplastophyta;Streptophyta;Embryophyta;Tracheophyta;Spermatophyta;Magnoliophyta;Myrtales;Punica;";"0.0";"0";"29";"29";"0";"29";"0";"457154";"373894"
"V4mis1";"SILVA (only NR);Eukaryota;Archaeplastida;Chloroplastida;Charophyta;Phragmoplastophyta;Streptophyta;Embryophyta;Tracheophyta;Spermatophyta;Magnoliophyta;Myrtales;Qualea;";"0.0";"0";"1";"1";"0";"1";"0";"457182";"373894"
"V4mis1";"SILVA (only NR);Eukaryota;Archaeplastida;Chloroplastida;Charophyta;Phragmoplastophyta;Streptophyta;Embryophyta;Tracheophyta;Spermatophyta;Magnoliophyta;Myrtales;Sonneratia;";"0.0";"0";"1";"1";"0";"1";"0";"457182";"373894"
"V4mis1";"SILVA (only NR);Eukaryota;Archaeplastida;Chloroplastida;Charophyta;Phragmoplastophyta;Streptophyta;Embryophyta;Tracheophyta;Spermatophyta;Magnoliophyta;Myrtales;Trapa;";"0.0";"0";"1";"1";"0";"1";"0";"457182";"373894"
"V4mis1";"SILVA (only NR);Eukaryota;Archaeplastida;Chloroplastida;Charophyta;Phragmoplastophyta;Streptophyta;Embryophyta;Tracheophyta;Spermatophyta;Magnoliophyta;Nymphaeales;";"0.0";"0";"4";"4";"0";"4";"0";"457179";"373894"
"V4mis1";"SILVA (only NR);Eukaryota;Archaeplastida;Chloroplastida;Charophyta;Phragmoplastophyta;Streptophyta;Embryophyta;Tracheophyta;Spermatophyta;Magnoliophyta;Nymphaeales;Brasenia;";"0.0";"0";"1";"1";"0";"1";"0";"457182";"373894"
"V4mis1";"SILVA (only NR);Eukaryota;Archaeplastida;Chloroplastida;Charophyta;Phragmoplastophyta;Streptophyta;Embryophyta;Tracheophyta;Spermatophyta;Magnoliophyta;Nymphaeales;Cabomba;";"0.0";"0";"1";"1";"0";"1";"0";"457182";"373894"
"V4mis1";"SILVA (only NR);Eukaryota;Archaeplastida;Chloroplastida;Charophyta;Phragmoplastophyta;Streptophyta;Embryophyta;Tracheophyta;Spermatophyta;Magnoliophyta;Nymphaeales;Nuphar;";"0.0";"0";"1";"1";"0";"1";"0";"457182";"373894"
"V4mis1";"SILVA (only NR);Eukaryota;Archaeplastida;Chloroplastida;Charophyta;Phragmoplastophyta;Streptophyta;Embryophyta;Tracheophyta;Spermatophyta;Magnoliophyta;Nymphaeales;Nymphaea;";"0.0";"0";"1";"1";"0";"1";"0";"457182";"373894"
"V4mis1";"SILVA (only NR);Eukaryota;Archaeplastida;Chloroplastida;Charophyta;Phragmoplastophyta;Streptophyta;Embryophyta;Tracheophyta;Spermatophyta;Magnoliophyta;Oxalidales;";"0.0";"0";"11";"11";"0";"11";"0";"457172";"373894"
"V4mis1";"SILVA (only NR);Eukaryota;Archaeplastida;Chloroplastida;Charophyta;Phragmoplastophyta;Streptophyta;Embryophyta;Tracheophyta;Spermatophyta;Magnoliophyta;Oxalidales;Averrhoa;";"0.0";"0";"1";"1";"0";"1";"0";"457182";"373894"
"V4mis1";"SILVA (only NR);Eukaryota;Archaeplastida;Chloroplastida;Charophyta;Phragmoplastophyta;Streptophyta;Embryophyta;Tracheophyta;Spermatophyta;Magnoliophyta;Oxalidales;Cephalotus;";"0.0";"0";"2";"2";"0";"2";"0";"457181";"373894"
"V4mis1";"SILVA (only NR);Eukaryota;Archaeplastida;Chloroplastida;Charophyta;Phragmoplastophyta;Streptophyta;Embryophyta;Tracheophyta;Spermatophyta;Magnoliophyta;Oxalidales;Connarus;";"0.0";"0";"1";"1";"0";"1";"0";"457182";"373894"
"V4mis1";"SILVA (only NR);Eukaryota;Archaeplastida;Chloroplastida;Charophyta;Phragmoplastophyta;Streptophyta;Embryophyta;Tracheophyta;Spermatophyta;Magnoliophyta;Oxalidales;Davidsonia;";"0.0";"0";"1";"1";"0";"1";"0";"457182";"373894"
"V4mis1";"SILVA (only NR);Eukaryota;Archaeplastida;Chloroplastida;Charophyta;Phragmoplastophyta;Streptophyta;Embryophyta;Tracheophyta;Spermatophyta;Magnoliophyta;Oxalidales;Hua;";"0.0";"0";"1";"1";"0";"1";"0";"457182";"373894"
"V4mis1";"SILVA (only NR);Eukaryota;Archaeplastida;Chloroplastida;Charophyta;Phragmoplastophyta;Streptophyta;Embryophyta;Tracheophyta;Spermatophyta;Magnoliophyta;Oxalidales;Oxalis;";"0.0";"0";"3";"3";"0";"3";"0";"457180";"373894"
"V4mis1";"SILVA (only NR);Eukaryota;Archaeplastida;Chloroplastida;Charophyta;Phragmoplastophyta;Streptophyta;Embryophyta;Tracheophyta;Spermatophyta;Magnoliophyta;Oxalidales;Platytheca;";"0.0";"0";"1";"1";"0";"1";"0";"457182";"373894"
"V4mis1";"SILVA (only NR);Eukaryota;Archaeplastida;Chloroplastida;Charophyta;Phragmoplastophyta;Streptophyta;Embryophyta;Tracheophyta;Spermatophyta;Magnoliophyta;Oxalidales;Rourea;";"0.0";"0";"1";"1";"0";"1";"0";"457182";"373894"
"V4mis1";"SILVA (only NR);Eukaryota;Archaeplastida;Chloroplastida;Charophyta;Phragmoplastophyta;Streptophyta;Embryophyta;Tracheophyta;Spermatophyta;Magnoliophyta;Paracryphiales;";"0.0";"0";"1";"1";"0";"1";"0";"457182";"373894"
"V4mis1";"SILVA (only NR);Eukaryota;Archaeplastida;Chloroplastida;Charophyta;Phragmoplastophyta;Streptophyta;Embryophyta;Tracheophyta;Spermatophyta;Magnoliophyta;Paracryphiales;Paracryphia;";"0.0";"0";"1";"1";"0";"1";"0";"457182";"373894"
"V4mis1";"SILVA (only NR);Eukaryota;Archaeplastida;Chloroplastida;Charophyta;Phragmoplastophyta;Streptophyta;Embryophyta;Tracheophyta;Spermatophyta;Magnoliophyta;Piperales;";"0.0";"0";"17";"17";"0";"17";"0";"457166";"373894"
"V4mis1";"SILVA (only NR);Eukaryota;Archaeplastida;Chloroplastida;Charophyta;Phragmoplastophyta;Streptophyta;Embryophyta;Tracheophyta;Spermatophyta;Magnoliophyta;Piperales;Anemopsis;";"0.0";"0";"1";"1";"0";"1";"0";"457182";"373894"
"V4mis1";"SILVA (only NR);Eukaryota;Archaeplastida;Chloroplastida;Charophyta;Phragmoplastophyta;Streptophyta;Embryophyta;Tracheophyta;Spermatophyta;Magnoliophyta;Piperales;Aristolochia;";"0.0";"0";"2";"2";"0";"2";"0";"457181";"373894"
"V4mis1";"SILVA (only NR);Eukaryota;Archaeplastida;Chloroplastida;Charophyta;Phragmoplastophyta;Streptophyta;Embryophyta;Tracheophyta;Spermatophyta;Magnoliophyta;Piperales;Houttuynia;";"0.0";"0";"1";"1";"0";"1";"0";"457182";"373894"
"V4mis1";"SILVA (only NR);Eukaryota;Archaeplastida;Chloroplastida;Charophyta;Phragmoplastophyta;Streptophyta;Embryophyta;Tracheophyta;Spermatophyta;Magnoliophyta;Piperales;Hydnora;";"0.0";"0";"1";"1";"0";"1";"0";"457182";"373894"
"V4mis1";"SILVA (only NR);Eukaryota;Archaeplastida;Chloroplastida;Charophyta;Phragmoplastophyta;Streptophyta;Embryophyta;Tracheophyta;Spermatophyta;Magnoliophyta;Piperales;Lactoris;";"0.0";"0";"1";"1";"0";"1";"0";"457182";"373894"
"V4mis1";"SILVA (only NR);Eukaryota;Archaeplastida;Chloroplastida;Charophyta;Phragmoplastophyta;Streptophyta;Embryophyta;Tracheophyta;Spermatophyta;Magnoliophyta;Piperales;Manekia;";"0.0";"0";"1";"1";"0";"1";"0";"457182";"373894"
"V4mis1";"SILVA (only NR);Eukaryota;Archaeplastida;Chloroplastida;Charophyta;Phragmoplastophyta;Streptophyta;Embryophyta;Tracheophyta;Spermatophyta;Magnoliophyta;Piperales;Peperomia;";"0.0";"0";"4";"4";"0";"4";"0";"457179";"373894"
"V4mis1";"SILVA (only NR);Eukaryota;Archaeplastida;Chloroplastida;Charophyta;Phragmoplastophyta;Streptophyta;Embryophyta;Tracheophyta;Spermatophyta;Magnoliophyta;Piperales;Piper;";"0.0";"0";"2";"2";"0";"2";"0";"457181";"373894"
"V4mis1";"SILVA (only NR);Eukaryota;Archaeplastida;Chloroplastida;Charophyta;Phragmoplastophyta;Streptophyta;Embryophyta;Tracheophyta;Spermatophyta;Magnoliophyta;Piperales;Prosopanche;";"0.0";"0";"1";"1";"0";"1";"0";"457182";"373894"
"V4mis1";"SILVA (only NR);Eukaryota;Archaeplastida;Chloroplastida;Charophyta;Phragmoplastophyta;Streptophyta;Embryophyta;Tracheophyta;Spermatophyta;Magnoliophyta;Piperales;Saruma;";"0.0";"0";"1";"1";"0";"1";"0";"457182";"373894"
"V4mis1";"SILVA (only NR);Eukaryota;Archaeplastida;Chloroplastida;Charophyta;Phragmoplastophyta;Streptophyta;Embryophyta;Tracheophyta;Spermatophyta;Magnoliophyta;Piperales;Saururus;";"0.0";"0";"1";"1";"0";"1";"0";"457182";"373894"
"V4mis1";"SILVA (only NR);Eukaryota;Archaeplastida;Chloroplastida;Charophyta;Phragmoplastophyta;Streptophyta;Embryophyta;Tracheophyta;Spermatophyta;Magnoliophyta;Piperales;Verhuellia;";"0.0";"0";"1";"1";"0";"1";"0";"457182";"373894"
"V4mis1";"SILVA (only NR);Eukaryota;Archaeplastida;Chloroplastida;Charophyta;Phragmoplastophyta;Streptophyta;Embryophyta;Tracheophyta;Spermatophyta;Magnoliophyta;Proteales;";"0.0";"0";"18";"18";"0";"18";"0";"457165";"373894"
"V4mis1";"SILVA (only NR);Eukaryota;Archaeplastida;Chloroplastida;Charophyta;Phragmoplastophyta;Streptophyta;Embryophyta;Tracheophyta;Spermatophyta;Magnoliophyta;Proteales;Grevillea;";"0.0";"0";"1";"1";"0";"1";"0";"457182";"373894"
"V4mis1";"SILVA (only NR);Eukaryota;Archaeplastida;Chloroplastida;Charophyta;Phragmoplastophyta;Streptophyta;Embryophyta;Tracheophyta;Spermatophyta;Magnoliophyta;Proteales;Knightia;";"0.0";"0";"1";"1";"0";"1";"0";"457182";"373894"
"V4mis1";"SILVA (only NR);Eukaryota;Archaeplastida;Chloroplastida;Charophyta;Phragmoplastophyta;Streptophyta;Embryophyta;Tracheophyta;Spermatophyta;Magnoliophyta;Proteales;Macadamia;";"0.0";"0";"1";"1";"0";"1";"0";"457182";"373894"
"V4mis1";"SILVA (only NR);Eukaryota;Archaeplastida;Chloroplastida;Charophyta;Phragmoplastophyta;Streptophyta;Embryophyta;Tracheophyta;Spermatophyta;Magnoliophyta;Proteales;Meliosma;";"0.0";"0";"1";"1";"0";"1";"0";"457182";"373894"
"V4mis1";"SILVA (only NR);Eukaryota;Archaeplastida;Chloroplastida;Charophyta;Phragmoplastophyta;Streptophyta;Embryophyta;Tracheophyta;Spermatophyta;Magnoliophyta;Proteales;Nelumbo;";"0.0";"0";"11";"11";"0";"11";"0";"457172";"373894"
"V4mis1";"SILVA (only NR);Eukaryota;Archaeplastida;Chloroplastida;Charophyta;Phragmoplastophyta;Streptophyta;Embryophyta;Tracheophyta;Spermatophyta;Magnoliophyta;Proteales;Persoonia;";"0.0";"0";"1";"1";"0";"1";"0";"457182";"373894"
"V4mis1";"SILVA (only NR);Eukaryota;Archaeplastida;Chloroplastida;Charophyta;Phragmoplastophyta;Streptophyta;Embryophyta;Tracheophyta;Spermatophyta;Magnoliophyta;Proteales;Platanus;";"0.0";"0";"1";"1";"0";"1";"0";"457182";"373894"
"V4mis1";"SILVA (only NR);Eukaryota;Archaeplastida;Chloroplastida;Charophyta;Phragmoplastophyta;Streptophyta;Embryophyta;Tracheophyta;Spermatophyta;Magnoliophyta;Proteales;Roupala;";"0.0";"0";"1";"1";"0";"1";"0";"457182";"373894"
"V4mis1";"SILVA (only NR);Eukaryota;Archaeplastida;Chloroplastida;Charophyta;Phragmoplastophyta;Streptophyta;Embryophyta;Tracheophyta;Spermatophyta;Magnoliophyta;Ranunculales;";"0.0";"0";"23";"23";"0";"23";"0";"457160";"373894"
"V4mis1";"SILVA (only NR);Eukaryota;Archaeplastida;Chloroplastida;Charophyta;Phragmoplastophyta;Streptophyta;Embryophyta;Tracheophyta;Spermatophyta;Magnoliophyta;Ranunculales;Aconitum;";"0.0";"0";"1";"1";"0";"1";"0";"457182";"373894"
"V4mis1";"SILVA (only NR);Eukaryota;Archaeplastida;Chloroplastida;Charophyta;Phragmoplastophyta;Streptophyta;Embryophyta;Tracheophyta;Spermatophyta;Magnoliophyta;Ranunculales;Actaea;";"0.0";"0";"1";"1";"0";"1";"0";"457182";"373894"
"V4mis1";"SILVA (only NR);Eukaryota;Archaeplastida;Chloroplastida;Charophyta;Phragmoplastophyta;Streptophyta;Embryophyta;Tracheophyta;Spermatophyta;Magnoliophyta;Ranunculales;Akebia;";"0.0";"0";"1";"1";"0";"1";"0";"457182";"373894"
"V4mis1";"SILVA (only NR);Eukaryota;Archaeplastida;Chloroplastida;Charophyta;Phragmoplastophyta;Streptophyta;Embryophyta;Tracheophyta;Spermatophyta;Magnoliophyta;Ranunculales;Anemone;";"0.0";"0";"1";"1";"0";"1";"0";"457182";"373894"
"V4mis1";"SILVA (only NR);Eukaryota;Archaeplastida;Chloroplastida;Charophyta;Phragmoplastophyta;Streptophyta;Embryophyta;Tracheophyta;Spermatophyta;Magnoliophyta;Ranunculales;Aquilegia;";"0.0";"0";"1";"1";"0";"1";"0";"457182";"373894"
"V4mis1";"SILVA (only NR);Eukaryota;Archaeplastida;Chloroplastida;Charophyta;Phragmoplastophyta;Streptophyta;Embryophyta;Tracheophyta;Spermatophyta;Magnoliophyta;Ranunculales;Arcangelisia;";"0.0";"0";"1";"1";"0";"1";"0";"457182";"373894"
"V4mis1";"SILVA (only NR);Eukaryota;Archaeplastida;Chloroplastida;Charophyta;Phragmoplastophyta;Streptophyta;Embryophyta;Tracheophyta;Spermatophyta;Magnoliophyta;Ranunculales;Argemone;";"0.0";"0";"1";"1";"0";"1";"0";"457182";"373894"
"V4mis1";"SILVA (only NR);Eukaryota;Archaeplastida;Chloroplastida;Charophyta;Phragmoplastophyta;Streptophyta;Embryophyta;Tracheophyta;Spermatophyta;Magnoliophyta;Ranunculales;Berberis;";"0.0";"0";"1";"1";"0";"1";"0";"457182";"373894"
"V4mis1";"SILVA (only NR);Eukaryota;Archaeplastida;Chloroplastida;Charophyta;Phragmoplastophyta;Streptophyta;Embryophyta;Tracheophyta;Spermatophyta;Magnoliophyta;Ranunculales;Cissampelos;";"0.0";"0";"1";"1";"0";"1";"0";"457182";"373894"
"V4mis1";"SILVA (only NR);Eukaryota;Archaeplastida;Chloroplastida;Charophyta;Phragmoplastophyta;Streptophyta;Embryophyta;Tracheophyta;Spermatophyta;Magnoliophyta;Ranunculales;Clematis;";"0.0";"0";"1";"1";"0";"1";"0";"457182";"373894"
"V4mis1";"SILVA (only NR);Eukaryota;Archaeplastida;Chloroplastida;Charophyta;Phragmoplastophyta;Streptophyta;Embryophyta;Tracheophyta;Spermatophyta;Magnoliophyta;Ranunculales;Coptis;";"0.0";"0";"1";"1";"0";"1";"0";"457182";"373894"
"V4mis1";"SILVA (only NR);Eukaryota;Archaeplastida;Chloroplastida;Charophyta;Phragmoplastophyta;Streptophyta;Embryophyta;Tracheophyta;Spermatophyta;Magnoliophyta;Ranunculales;Corydalis;";"0.0";"0";"2";"2";"0";"2";"0";"457181";"373894"
"V4mis1";"SILVA (only NR);Eukaryota;Archaeplastida;Chloroplastida;Charophyta;Phragmoplastophyta;Streptophyta;Embryophyta;Tracheophyta;Spermatophyta;Magnoliophyta;Ranunculales;Fibraurea;";"0.0";"0";"1";"1";"0";"1";"0";"457182";"373894"
"V4mis1";"SILVA (only NR);Eukaryota;Archaeplastida;Chloroplastida;Charophyta;Phragmoplastophyta;Streptophyta;Embryophyta;Tracheophyta;Spermatophyta;Magnoliophyta;Ranunculales;Papaver;";"0.0";"0";"1";"1";"0";"1";"0";"457182";"373894"
"V4mis1";"SILVA (only NR);Eukaryota;Archaeplastida;Chloroplastida;Charophyta;Phragmoplastophyta;Streptophyta;Embryophyta;Tracheophyta;Spermatophyta;Magnoliophyta;Ranunculales;Podophyllum;";"0.0";"0";"1";"1";"0";"1";"0";"457182";"373894"
"V4mis1";"SILVA (only NR);Eukaryota;Archaeplastida;Chloroplastida;Charophyta;Phragmoplastophyta;Streptophyta;Embryophyta;Tracheophyta;Spermatophyta;Magnoliophyta;Ranunculales;Ranunculus;";"0.0";"0";"2";"2";"0";"2";"0";"457181";"373894"
"V4mis1";"SILVA (only NR);Eukaryota;Archaeplastida;Chloroplastida;Charophyta;Phragmoplastophyta;Streptophyta;Embryophyta;Tracheophyta;Spermatophyta;Magnoliophyta;Ranunculales;Sanguinaria;";"0.0";"0";"1";"1";"0";"1";"0";"457182";"373894"
"V4mis1";"SILVA (only NR);Eukaryota;Archaeplastida;Chloroplastida;Charophyta;Phragmoplastophyta;Streptophyta;Embryophyta;Tracheophyta;Spermatophyta;Magnoliophyta;Ranunculales;Stephania;";"0.0";"0";"4";"4";"0";"4";"0";"457179";"373894"
"V4mis1";"SILVA (only NR);Eukaryota;Archaeplastida;Chloroplastida;Charophyta;Phragmoplastophyta;Streptophyta;Embryophyta;Tracheophyta;Spermatophyta;Magnoliophyta;Rosales;";"0.0";"0";"95";"95";"0";"95";"0";"457088";"373894"
"V4mis1";"SILVA (only NR);Eukaryota;Archaeplastida;Chloroplastida;Charophyta;Phragmoplastophyta;Streptophyta;Embryophyta;Tracheophyta;Spermatophyta;Magnoliophyta;Rosales;Adenostoma;";"0.0";"0";"1";"1";"0";"1";"0";"457182";"373894"
"V4mis1";"SILVA (only NR);Eukaryota;Archaeplastida;Chloroplastida;Charophyta;Phragmoplastophyta;Streptophyta;Embryophyta;Tracheophyta;Spermatophyta;Magnoliophyta;Rosales;Barbeya;";"0.0";"0";"1";"1";"0";"1";"0";"457182";"373894"
"V4mis1";"SILVA (only NR);Eukaryota;Archaeplastida;Chloroplastida;Charophyta;Phragmoplastophyta;Streptophyta;Embryophyta;Tracheophyta;Spermatophyta;Magnoliophyta;Rosales;Boehmeria;";"0.0";"0";"2";"2";"0";"2";"0";"457181";"373894"
"V4mis1";"SILVA (only NR);Eukaryota;Archaeplastida;Chloroplastida;Charophyta;Phragmoplastophyta;Streptophyta;Embryophyta;Tracheophyta;Spermatophyta;Magnoliophyta;Rosales;Broussonetia;";"0.0";"0";"1";"1";"0";"1";"0";"457182";"373894"
"V4mis1";"SILVA (only NR);Eukaryota;Archaeplastida;Chloroplastida;Charophyta;Phragmoplastophyta;Streptophyta;Embryophyta;Tracheophyta;Spermatophyta;Magnoliophyta;Rosales;Cannabis;";"0.0";"0";"11";"11";"0";"11";"0";"457172";"373894"
"V4mis1";"SILVA (only NR);Eukaryota;Archaeplastida;Chloroplastida;Charophyta;Phragmoplastophyta;Streptophyta;Embryophyta;Tracheophyta;Spermatophyta;Magnoliophyta;Rosales;Ceanothus;";"0.0";"0";"1";"1";"0";"1";"0";"457182";"373894"
"V4mis1";"SILVA (only NR);Eukaryota;Archaeplastida;Chloroplastida;Charophyta;Phragmoplastophyta;Streptophyta;Embryophyta;Tracheophyta;Spermatophyta;Magnoliophyta;Rosales;Cecropia;";"0.0";"0";"1";"1";"0";"1";"0";"457182";"373894"
"V4mis1";"SILVA (only NR);Eukaryota;Archaeplastida;Chloroplastida;Charophyta;Phragmoplastophyta;Streptophyta;Embryophyta;Tracheophyta;Spermatophyta;Magnoliophyta;Rosales;Didymodoxa;";"0.0";"0";"1";"1";"0";"1";"0";"457182";"373894"
"V4mis1";"SILVA (only NR);Eukaryota;Archaeplastida;Chloroplastida;Charophyta;Phragmoplastophyta;Streptophyta;Embryophyta;Tracheophyta;Spermatophyta;Magnoliophyta;Rosales;Dirachma;";"0.0";"0";"1";"1";"0";"1";"0";"457182";"373894"
"V4mis1";"SILVA (only NR);Eukaryota;Archaeplastida;Chloroplastida;Charophyta;Phragmoplastophyta;Streptophyta;Embryophyta;Tracheophyta;Spermatophyta;Magnoliophyta;Rosales;Elaeagnus;";"0.0";"0";"1";"1";"0";"1";"0";"457182";"373894"
"V4mis1";"SILVA (only NR);Eukaryota;Archaeplastida;Chloroplastida;Charophyta;Phragmoplastophyta;Streptophyta;Embryophyta;Tracheophyta;Spermatophyta;Magnoliophyta;Rosales;Exochorda;";"0.0";"0";"1";"1";"0";"1";"0";"457182";"373894"
"V4mis1";"SILVA (only NR);Eukaryota;Archaeplastida;Chloroplastida;Charophyta;Phragmoplastophyta;Streptophyta;Embryophyta;Tracheophyta;Spermatophyta;Magnoliophyta;Rosales;Ficus;";"0.0";"0";"1";"1";"0";"1";"0";"457182";"373894"
"V4mis1";"SILVA (only NR);Eukaryota;Archaeplastida;Chloroplastida;Charophyta;Phragmoplastophyta;Streptophyta;Embryophyta;Tracheophyta;Spermatophyta;Magnoliophyta;Rosales;Filipendula;";"0.0";"0";"1";"1";"0";"1";"0";"457182";"373894"
"V4mis1";"SILVA (only NR);Eukaryota;Archaeplastida;Chloroplastida;Charophyta;Phragmoplastophyta;Streptophyta;Embryophyta;Tracheophyta;Spermatophyta;Magnoliophyta;Rosales;Forsskaolea;";"0.0";"0";"1";"1";"0";"1";"0";"457182";"373894"
"V4mis1";"SILVA (only NR);Eukaryota;Archaeplastida;Chloroplastida;Charophyta;Phragmoplastophyta;Streptophyta;Embryophyta;Tracheophyta;Spermatophyta;Magnoliophyta;Rosales;Fragaria;";"0.0";"0";"5";"5";"0";"5";"0";"457178";"373894"
"V4mis1";"SILVA (only NR);Eukaryota;Archaeplastida;Chloroplastida;Charophyta;Phragmoplastophyta;Streptophyta;Embryophyta;Tracheophyta;Spermatophyta;Magnoliophyta;Rosales;Gonostegia;";"0.0";"0";"1";"1";"0";"1";"0";"457182";"373894"
"V4mis1";"SILVA (only NR);Eukaryota;Archaeplastida;Chloroplastida;Charophyta;Phragmoplastophyta;Streptophyta;Embryophyta;Tracheophyta;Spermatophyta;Magnoliophyta;Rosales;Gouania;";"0.0";"0";"1";"1";"0";"1";"0";"457182";"373894"
"V4mis1";"SILVA (only NR);Eukaryota;Archaeplastida;Chloroplastida;Charophyta;Phragmoplastophyta;Streptophyta;Embryophyta;Tracheophyta;Spermatophyta;Magnoliophyta;Rosales;Holoptelea;";"0.0";"0";"1";"1";"0";"1";"0";"457182";"373894"
"V4mis1";"SILVA (only NR);Eukaryota;Archaeplastida;Chloroplastida;Charophyta;Phragmoplastophyta;Streptophyta;Embryophyta;Tracheophyta;Spermatophyta;Magnoliophyta;Rosales;Humulus;";"0.0";"0";"7";"7";"0";"7";"0";"457176";"373894"
"V4mis1";"SILVA (only NR);Eukaryota;Archaeplastida;Chloroplastida;Charophyta;Phragmoplastophyta;Streptophyta;Embryophyta;Tracheophyta;Spermatophyta;Magnoliophyta;Rosales;Kerria;";"0.0";"0";"1";"1";"0";"1";"0";"457182";"373894"
"V4mis1";"SILVA (only NR);Eukaryota;Archaeplastida;Chloroplastida;Charophyta;Phragmoplastophyta;Streptophyta;Embryophyta;Tracheophyta;Spermatophyta;Magnoliophyta;Rosales;Malus;";"0.0";"0";"3";"3";"0";"3";"0";"457180";"373894"
"V4mis1";"SILVA (only NR);Eukaryota;Archaeplastida;Chloroplastida;Charophyta;Phragmoplastophyta;Streptophyta;Embryophyta;Tracheophyta;Spermatophyta;Magnoliophyta;Rosales;Morus;";"0.0";"0";"2";"2";"0";"2";"0";"457181";"373894"
"V4mis1";"SILVA (only NR);Eukaryota;Archaeplastida;Chloroplastida;Charophyta;Phragmoplastophyta;Streptophyta;Embryophyta;Tracheophyta;Spermatophyta;Magnoliophyta;Rosales;Myriocarpa;";"0.0";"0";"1";"1";"0";"1";"0";"457182";"373894"
"V4mis1";"SILVA (only NR);Eukaryota;Archaeplastida;Chloroplastida;Charophyta;Phragmoplastophyta;Streptophyta;Embryophyta;Tracheophyta;Spermatophyta;Magnoliophyta;Rosales;Nanocnide;";"0.0";"0";"1";"1";"0";"1";"0";"457182";"373894"
"V4mis1";"SILVA (only NR);Eukaryota;Archaeplastida;Chloroplastida;Charophyta;Phragmoplastophyta;Streptophyta;Embryophyta;Tracheophyta;Spermatophyta;Magnoliophyta;Rosales;Neodistemon;";"0.0";"0";"1";"1";"0";"1";"0";"457182";"373894"
"V4mis1";"SILVA (only NR);Eukaryota;Archaeplastida;Chloroplastida;Charophyta;Phragmoplastophyta;Streptophyta;Embryophyta;Tracheophyta;Spermatophyta;Magnoliophyta;Rosales;Neraudia;";"0.0";"0";"1";"1";"0";"1";"0";"457182";"373894"
"V4mis1";"SILVA (only NR);Eukaryota;Archaeplastida;Chloroplastida;Charophyta;Phragmoplastophyta;Streptophyta;Embryophyta;Tracheophyta;Spermatophyta;Magnoliophyta;Rosales;Obetia;";"0.0";"0";"1";"1";"0";"1";"0";"457182";"373894"
"V4mis1";"SILVA (only NR);Eukaryota;Archaeplastida;Chloroplastida;Charophyta;Phragmoplastophyta;Streptophyta;Embryophyta;Tracheophyta;Spermatophyta;Magnoliophyta;Rosales;Oreocnide;";"0.0";"0";"1";"1";"0";"1";"0";"457182";"373894"
"V4mis1";"SILVA (only NR);Eukaryota;Archaeplastida;Chloroplastida;Charophyta;Phragmoplastophyta;Streptophyta;Embryophyta;Tracheophyta;Spermatophyta;Magnoliophyta;Rosales;Parietaria;";"0.0";"0";"2";"2";"0";"2";"0";"457181";"373894"
"V4mis1";"SILVA (only NR);Eukaryota;Archaeplastida;Chloroplastida;Charophyta;Phragmoplastophyta;Streptophyta;Embryophyta;Tracheophyta;Spermatophyta;Magnoliophyta;Rosales;Pellionia;";"0.0";"0";"2";"2";"0";"2";"0";"457181";"373894"
"V4mis1";"SILVA (only NR);Eukaryota;Archaeplastida;Chloroplastida;Charophyta;Phragmoplastophyta;Streptophyta;Embryophyta;Tracheophyta;Spermatophyta;Magnoliophyta;Rosales;Phyllostylon;";"0.0";"0";"1";"1";"0";"1";"0";"457182";"373894"
"V4mis1";"SILVA (only NR);Eukaryota;Archaeplastida;Chloroplastida;Charophyta;Phragmoplastophyta;Streptophyta;Embryophyta;Tracheophyta;Spermatophyta;Magnoliophyta;Rosales;Pilea;";"0.0";"0";"1";"1";"0";"1";"0";"457182";"373894"
"V4mis1";"SILVA (only NR);Eukaryota;Archaeplastida;Chloroplastida;Charophyta;Phragmoplastophyta;Streptophyta;Embryophyta;Tracheophyta;Spermatophyta;Magnoliophyta;Rosales;Pipturus;";"0.0";"0";"1";"1";"0";"1";"0";"457182";"373894"
"V4mis1";"SILVA (only NR);Eukaryota;Archaeplastida;Chloroplastida;Charophyta;Phragmoplastophyta;Streptophyta;Embryophyta;Tracheophyta;Spermatophyta;Magnoliophyta;Rosales;Prinsepia;";"0.0";"0";"1";"1";"0";"1";"0";"457182";"373894"
"V4mis1";"SILVA (only NR);Eukaryota;Archaeplastida;Chloroplastida;Charophyta;Phragmoplastophyta;Streptophyta;Embryophyta;Tracheophyta;Spermatophyta;Magnoliophyta;Rosales;Procris;";"0.0";"0";"1";"1";"0";"1";"0";"457182";"373894"
"V4mis1";"SILVA (only NR);Eukaryota;Archaeplastida;Chloroplastida;Charophyta;Phragmoplastophyta;Streptophyta;Embryophyta;Tracheophyta;Spermatophyta;Magnoliophyta;Rosales;Prunus;";"0.0";"0";"4";"4";"0";"4";"0";"457179";"373894"
"V4mis1";"SILVA (only NR);Eukaryota;Archaeplastida;Chloroplastida;Charophyta;Phragmoplastophyta;Streptophyta;Embryophyta;Tracheophyta;Spermatophyta;Magnoliophyta;Rosales;Purshia;";"0.0";"0";"1";"1";"0";"1";"0";"457182";"373894"
"V4mis1";"SILVA (only NR);Eukaryota;Archaeplastida;Chloroplastida;Charophyta;Phragmoplastophyta;Streptophyta;Embryophyta;Tracheophyta;Spermatophyta;Magnoliophyta;Rosales;Pyrus;";"0.0";"0";"5";"5";"0";"5";"0";"457178";"373894"
"V4mis1";"SILVA (only NR);Eukaryota;Archaeplastida;Chloroplastida;Charophyta;Phragmoplastophyta;Streptophyta;Embryophyta;Tracheophyta;Spermatophyta;Magnoliophyta;Rosales;Retanilla;";"0.0";"0";"1";"1";"0";"1";"0";"457182";"373894"
"V4mis1";"SILVA (only NR);Eukaryota;Archaeplastida;Chloroplastida;Charophyta;Phragmoplastophyta;Streptophyta;Embryophyta;Tracheophyta;Spermatophyta;Magnoliophyta;Rosales;Rhamnus;";"0.0";"0";"1";"1";"0";"1";"0";"457182";"373894"
"V4mis1";"SILVA (only NR);Eukaryota;Archaeplastida;Chloroplastida;Charophyta;Phragmoplastophyta;Streptophyta;Embryophyta;Tracheophyta;Spermatophyta;Magnoliophyta;Rosales;Rousselia;";"0.0";"0";"1";"1";"0";"1";"0";"457182";"373894"
"V4mis1";"SILVA (only NR);Eukaryota;Archaeplastida;Chloroplastida;Charophyta;Phragmoplastophyta;Streptophyta;Embryophyta;Tracheophyta;Spermatophyta;Magnoliophyta;Rosales;Sarcomphalus;";"0.0";"0";"1";"1";"0";"1";"0";"457182";"373894"
"V4mis1";"SILVA (only NR);Eukaryota;Archaeplastida;Chloroplastida;Charophyta;Phragmoplastophyta;Streptophyta;Embryophyta;Tracheophyta;Spermatophyta;Magnoliophyta;Rosales;Sarcopilea;";"0.0";"0";"1";"1";"0";"1";"0";"457182";"373894"
"V4mis1";"SILVA (only NR);Eukaryota;Archaeplastida;Chloroplastida;Charophyta;Phragmoplastophyta;Streptophyta;Embryophyta;Tracheophyta;Spermatophyta;Magnoliophyta;Rosales;Shepherdia;";"0.0";"0";"1";"1";"0";"1";"0";"457182";"373894"
"V4mis1";"SILVA (only NR);Eukaryota;Archaeplastida;Chloroplastida;Charophyta;Phragmoplastophyta;Streptophyta;Embryophyta;Tracheophyta;Spermatophyta;Magnoliophyta;Rosales;Spiraea;";"0.0";"0";"1";"1";"0";"1";"0";"457182";"373894"
"V4mis1";"SILVA (only NR);Eukaryota;Archaeplastida;Chloroplastida;Charophyta;Phragmoplastophyta;Streptophyta;Embryophyta;Tracheophyta;Spermatophyta;Magnoliophyta;Rosales;Ulmus;";"0.0";"0";"1";"1";"0";"1";"0";"457182";"373894"
"V4mis1";"SILVA (only NR);Eukaryota;Archaeplastida;Chloroplastida;Charophyta;Phragmoplastophyta;Streptophyta;Embryophyta;Tracheophyta;Spermatophyta;Magnoliophyta;Rosales;Urera;";"0.0";"0";"1";"1";"0";"1";"0";"457182";"373894"
"V4mis1";"SILVA (only NR);Eukaryota;Archaeplastida;Chloroplastida;Charophyta;Phragmoplastophyta;Streptophyta;Embryophyta;Tracheophyta;Spermatophyta;Magnoliophyta;Rosales;Urtica;";"0.0";"0";"1";"1";"0";"1";"0";"457182";"373894"
"V4mis1";"SILVA (only NR);Eukaryota;Archaeplastida;Chloroplastida;Charophyta;Phragmoplastophyta;Streptophyta;Embryophyta;Tracheophyta;Spermatophyta;Magnoliophyta;Rosales;Ziziphus;";"0.0";"0";"14";"14";"0";"14";"0";"457169";"373894"
"V4mis1";"SILVA (only NR);Eukaryota;Archaeplastida;Chloroplastida;Charophyta;Phragmoplastophyta;Streptophyta;Embryophyta;Tracheophyta;Spermatophyta;Magnoliophyta;Santalales;";"0.0";"0";"124";"124";"0";"124";"0";"457059";"373894"
"V4mis1";"SILVA (only NR);Eukaryota;Archaeplastida;Chloroplastida;Charophyta;Phragmoplastophyta;Streptophyta;Embryophyta;Tracheophyta;Spermatophyta;Magnoliophyta;Santalales;Actinanthella;";"0.0";"0";"1";"1";"0";"1";"0";"457182";"373894"
"V4mis1";"SILVA (only NR);Eukaryota;Archaeplastida;Chloroplastida;Charophyta;Phragmoplastophyta;Streptophyta;Embryophyta;Tracheophyta;Spermatophyta;Magnoliophyta;Santalales;Agelanthus;";"0.0";"0";"2";"2";"0";"2";"0";"457181";"373894"
"V4mis1";"SILVA (only NR);Eukaryota;Archaeplastida;Chloroplastida;Charophyta;Phragmoplastophyta;Streptophyta;Embryophyta;Tracheophyta;Spermatophyta;Magnoliophyta;Santalales;Agonandra;";"0.0";"0";"1";"1";"0";"1";"0";"457182";"373894"
"V4mis1";"SILVA (only NR);Eukaryota;Archaeplastida;Chloroplastida;Charophyta;Phragmoplastophyta;Streptophyta;Embryophyta;Tracheophyta;Spermatophyta;Magnoliophyta;Santalales;Amyema;";"0.0";"0";"1";"1";"0";"1";"0";"457182";"373894"
"V4mis1";"SILVA (only NR);Eukaryota;Archaeplastida;Chloroplastida;Charophyta;Phragmoplastophyta;Streptophyta;Embryophyta;Tracheophyta;Spermatophyta;Magnoliophyta;Santalales;Anthobolus;";"0.0";"0";"1";"1";"0";"1";"0";"457182";"373894"
"V4mis1";"SILVA (only NR);Eukaryota;Archaeplastida;Chloroplastida;Charophyta;Phragmoplastophyta;Streptophyta;Embryophyta;Tracheophyta;Spermatophyta;Magnoliophyta;Santalales;Antidaphne;";"0.0";"0";"1";"1";"0";"1";"0";"457182";"373894"
"V4mis1";"SILVA (only NR);Eukaryota;Archaeplastida;Chloroplastida;Charophyta;Phragmoplastophyta;Streptophyta;Embryophyta;Tracheophyta;Spermatophyta;Magnoliophyta;Santalales;Arceuthobium;";"0.0";"0";"3";"3";"0";"3";"0";"457180";"373894"
"V4mis1";"SILVA (only NR);Eukaryota;Archaeplastida;Chloroplastida;Charophyta;Phragmoplastophyta;Streptophyta;Embryophyta;Tracheophyta;Spermatophyta;Magnoliophyta;Santalales;Arjona;";"0.0";"0";"1";"1";"0";"1";"0";"457182";"373894"
"V4mis1";"SILVA (only NR);Eukaryota;Archaeplastida;Chloroplastida;Charophyta;Phragmoplastophyta;Streptophyta;Embryophyta;Tracheophyta;Spermatophyta;Magnoliophyta;Santalales;Balanophora;";"0.0";"0";"7";"7";"0";"7";"0";"457176";"373894"
"V4mis1";"SILVA (only NR);Eukaryota;Archaeplastida;Chloroplastida;Charophyta;Phragmoplastophyta;Streptophyta;Embryophyta;Tracheophyta;Spermatophyta;Magnoliophyta;Santalales;Benthamina;";"0.0";"0";"1";"1";"0";"1";"0";"457182";"373894"
"V4mis1";"SILVA (only NR);Eukaryota;Archaeplastida;Chloroplastida;Charophyta;Phragmoplastophyta;Streptophyta;Embryophyta;Tracheophyta;Spermatophyta;Magnoliophyta;Santalales;Berhautia;";"0.0";"0";"1";"1";"0";"1";"0";"457182";"373894"
"V4mis1";"SILVA (only NR);Eukaryota;Archaeplastida;Chloroplastida;Charophyta;Phragmoplastophyta;Streptophyta;Embryophyta;Tracheophyta;Spermatophyta;Magnoliophyta;Santalales;Cansjera;";"0.0";"0";"1";"1";"0";"1";"0";"457182";"373894"
"V4mis1";"SILVA (only NR);Eukaryota;Archaeplastida;Chloroplastida;Charophyta;Phragmoplastophyta;Streptophyta;Embryophyta;Tracheophyta;Spermatophyta;Magnoliophyta;Santalales;Cathedra;";"0.0";"0";"1";"1";"0";"1";"0";"457182";"373894"
"V4mis1";"SILVA (only NR);Eukaryota;Archaeplastida;Chloroplastida;Charophyta;Phragmoplastophyta;Streptophyta;Embryophyta;Tracheophyta;Spermatophyta;Magnoliophyta;Santalales;Cecarria;";"0.0";"0";"1";"1";"0";"1";"0";"457182";"373894"
"V4mis1";"SILVA (only NR);Eukaryota;Archaeplastida;Chloroplastida;Charophyta;Phragmoplastophyta;Streptophyta;Embryophyta;Tracheophyta;Spermatophyta;Magnoliophyta;Santalales;Chaunochiton;";"0.0";"0";"1";"1";"0";"1";"0";"457182";"373894"
"V4mis1";"SILVA (only NR);Eukaryota;Archaeplastida;Chloroplastida;Charophyta;Phragmoplastophyta;Streptophyta;Embryophyta;Tracheophyta;Spermatophyta;Magnoliophyta;Santalales;Choretrum;";"0.0";"0";"1";"1";"0";"1";"0";"457182";"373894"
"V4mis1";"SILVA (only NR);Eukaryota;Archaeplastida;Chloroplastida;Charophyta;Phragmoplastophyta;Streptophyta;Embryophyta;Tracheophyta;Spermatophyta;Magnoliophyta;Santalales;Colpoon;";"0.0";"0";"1";"1";"0";"1";"0";"457182";"373894"
"V4mis1";"SILVA (only NR);Eukaryota;Archaeplastida;Chloroplastida;Charophyta;Phragmoplastophyta;Streptophyta;Embryophyta;Tracheophyta;Spermatophyta;Magnoliophyta;Santalales;Comandra;";"0.0";"0";"1";"1";"0";"1";"0";"457182";"373894"
"V4mis1";"SILVA (only NR);Eukaryota;Archaeplastida;Chloroplastida;Charophyta;Phragmoplastophyta;Streptophyta;Embryophyta;Tracheophyta;Spermatophyta;Magnoliophyta;Santalales;Corynaea;";"0.0";"0";"1";"1";"0";"1";"0";"457182";"373894"
"V4mis1";"SILVA (only NR);Eukaryota;Archaeplastida;Chloroplastida;Charophyta;Phragmoplastophyta;Streptophyta;Embryophyta;Tracheophyta;Spermatophyta;Magnoliophyta;Santalales;Dactylanthus;";"0.0";"0";"1";"1";"0";"1";"0";"457182";"373894"
"V4mis1";"SILVA (only NR);Eukaryota;Archaeplastida;Chloroplastida;Charophyta;Phragmoplastophyta;Streptophyta;Embryophyta;Tracheophyta;Spermatophyta;Magnoliophyta;Santalales;Daenikera;";"0.0";"0";"1";"1";"0";"1";"0";"457182";"373894"
"V4mis1";"SILVA (only NR);Eukaryota;Archaeplastida;Chloroplastida;Charophyta;Phragmoplastophyta;Streptophyta;Embryophyta;Tracheophyta;Spermatophyta;Magnoliophyta;Santalales;Decaisnina;";"0.0";"0";"2";"2";"0";"2";"0";"457181";"373894"
"V4mis1";"SILVA (only NR);Eukaryota;Archaeplastida;Chloroplastida;Charophyta;Phragmoplastophyta;Streptophyta;Embryophyta;Tracheophyta;Spermatophyta;Magnoliophyta;Santalales;Dendrophthora;";"0.0";"0";"1";"1";"0";"1";"0";"457182";"373894"
"V4mis1";"SILVA (only NR);Eukaryota;Archaeplastida;Chloroplastida;Charophyta;Phragmoplastophyta;Streptophyta;Embryophyta;Tracheophyta;Spermatophyta;Magnoliophyta;Santalales;Dendrotrophe;";"0.0";"0";"1";"1";"0";"1";"0";"457182";"373894"
"V4mis1";"SILVA (only NR);Eukaryota;Archaeplastida;Chloroplastida;Charophyta;Phragmoplastophyta;Streptophyta;Embryophyta;Tracheophyta;Spermatophyta;Magnoliophyta;Santalales;Diogoa;";"0.0";"0";"1";"1";"0";"1";"0";"457182";"373894"
"V4mis1";"SILVA (only NR);Eukaryota;Archaeplastida;Chloroplastida;Charophyta;Phragmoplastophyta;Streptophyta;Embryophyta;Tracheophyta;Spermatophyta;Magnoliophyta;Santalales;Diplatia;";"0.0";"0";"1";"1";"0";"1";"0";"457182";"373894"
"V4mis1";"SILVA (only NR);Eukaryota;Archaeplastida;Chloroplastida;Charophyta;Phragmoplastophyta;Streptophyta;Embryophyta;Tracheophyta;Spermatophyta;Magnoliophyta;Santalales;Dufrenoya;";"0.0";"0";"1";"1";"0";"1";"0";"457182";"373894"
"V4mis1";"SILVA (only NR);Eukaryota;Archaeplastida;Chloroplastida;Charophyta;Phragmoplastophyta;Streptophyta;Embryophyta;Tracheophyta;Spermatophyta;Magnoliophyta;Santalales;Dulacia;";"0.0";"0";"1";"1";"0";"1";"0";"457182";"373894"
"V4mis1";"SILVA (only NR);Eukaryota;Archaeplastida;Chloroplastida;Charophyta;Phragmoplastophyta;Streptophyta;Embryophyta;Tracheophyta;Spermatophyta;Magnoliophyta;Santalales;Englerina;";"0.0";"0";"1";"1";"0";"1";"0";"457182";"373894"
"V4mis1";"SILVA (only NR);Eukaryota;Archaeplastida;Chloroplastida;Charophyta;Phragmoplastophyta;Streptophyta;Embryophyta;Tracheophyta;Spermatophyta;Magnoliophyta;Santalales;Engomegoma;";"0.0";"0";"1";"1";"0";"1";"0";"457182";"373894"
"V4mis1";"SILVA (only NR);Eukaryota;Archaeplastida;Chloroplastida;Charophyta;Phragmoplastophyta;Streptophyta;Embryophyta;Tracheophyta;Spermatophyta;Magnoliophyta;Santalales;Erianthemum;";"0.0";"0";"1";"1";"0";"1";"0";"457182";"373894"
"V4mis1";"SILVA (only NR);Eukaryota;Archaeplastida;Chloroplastida;Charophyta;Phragmoplastophyta;Streptophyta;Embryophyta;Tracheophyta;Spermatophyta;Magnoliophyta;Santalales;Erythropalum;";"0.0";"0";"1";"1";"0";"1";"0";"457182";"373894"
"V4mis1";"SILVA (only NR);Eukaryota;Archaeplastida;Chloroplastida;Charophyta;Phragmoplastophyta;Streptophyta;Embryophyta;Tracheophyta;Spermatophyta;Magnoliophyta;Santalales;Eubrachion;";"0.0";"0";"1";"1";"0";"1";"0";"457182";"373894"
"V4mis1";"SILVA (only NR);Eukaryota;Archaeplastida;Chloroplastida;Charophyta;Phragmoplastophyta;Streptophyta;Embryophyta;Tracheophyta;Spermatophyta;Magnoliophyta;Santalales;Exocarpos;";"0.0";"0";"1";"1";"0";"1";"0";"457182";"373894"
"V4mis1";"SILVA (only NR);Eukaryota;Archaeplastida;Chloroplastida;Charophyta;Phragmoplastophyta;Streptophyta;Embryophyta;Tracheophyta;Spermatophyta;Magnoliophyta;Santalales;Geocaulon;";"0.0";"0";"1";"1";"0";"1";"0";"457182";"373894"
"V4mis1";"SILVA (only NR);Eukaryota;Archaeplastida;Chloroplastida;Charophyta;Phragmoplastophyta;Streptophyta;Embryophyta;Tracheophyta;Spermatophyta;Magnoliophyta;Santalales;Ginalloa;";"0.0";"0";"1";"1";"0";"1";"0";"457182";"373894"
"V4mis1";"SILVA (only NR);Eukaryota;Archaeplastida;Chloroplastida;Charophyta;Phragmoplastophyta;Streptophyta;Embryophyta;Tracheophyta;Spermatophyta;Magnoliophyta;Santalales;Hachettea;";"0.0";"0";"1";"1";"0";"1";"0";"457182";"373894"
"V4mis1";"SILVA (only NR);Eukaryota;Archaeplastida;Chloroplastida;Charophyta;Phragmoplastophyta;Streptophyta;Embryophyta;Tracheophyta;Spermatophyta;Magnoliophyta;Santalales;Harmandia;";"0.0";"0";"1";"1";"0";"1";"0";"457182";"373894"
"V4mis1";"SILVA (only NR);Eukaryota;Archaeplastida;Chloroplastida;Charophyta;Phragmoplastophyta;Streptophyta;Embryophyta;Tracheophyta;Spermatophyta;Magnoliophyta;Santalales;Heisteria;";"0.0";"0";"1";"1";"0";"1";"0";"457182";"373894"
"V4mis1";"SILVA (only NR);Eukaryota;Archaeplastida;Chloroplastida;Charophyta;Phragmoplastophyta;Streptophyta;Embryophyta;Tracheophyta;Spermatophyta;Magnoliophyta;Santalales;Helixanthera;";"0.0";"0";"1";"1";"0";"1";"0";"457182";"373894"
"V4mis1";"SILVA (only NR);Eukaryota;Archaeplastida;Chloroplastida;Charophyta;Phragmoplastophyta;Streptophyta;Embryophyta;Tracheophyta;Spermatophyta;Magnoliophyta;Santalales;Helosis;";"0.0";"0";"1";"1";"0";"1";"0";"457182";"373894"
"V4mis1";"SILVA (only NR);Eukaryota;Archaeplastida;Chloroplastida;Charophyta;Phragmoplastophyta;Streptophyta;Embryophyta;Tracheophyta;Spermatophyta;Magnoliophyta;Santalales;Hondurodendron;";"0.0";"0";"1";"1";"0";"1";"0";"457182";"373894"
"V4mis1";"SILVA (only NR);Eukaryota;Archaeplastida;Chloroplastida;Charophyta;Phragmoplastophyta;Streptophyta;Embryophyta;Tracheophyta;Spermatophyta;Magnoliophyta;Santalales;Ileostylus;";"0.0";"0";"1";"1";"0";"1";"0";"457182";"373894"
"V4mis1";"SILVA (only NR);Eukaryota;Archaeplastida;Chloroplastida;Charophyta;Phragmoplastophyta;Streptophyta;Embryophyta;Tracheophyta;Spermatophyta;Magnoliophyta;Santalales;Jodina;";"0.0";"0";"1";"1";"0";"1";"0";"457182";"373894"
"V4mis1";"SILVA (only NR);Eukaryota;Archaeplastida;Chloroplastida;Charophyta;Phragmoplastophyta;Streptophyta;Embryophyta;Tracheophyta;Spermatophyta;Magnoliophyta;Santalales;Korthalsella;";"0.0";"0";"2";"2";"0";"2";"0";"457181";"373894"
"V4mis1";"SILVA (only NR);Eukaryota;Archaeplastida;Chloroplastida;Charophyta;Phragmoplastophyta;Streptophyta;Embryophyta;Tracheophyta;Spermatophyta;Magnoliophyta;Santalales;Kunkeliella;";"0.0";"0";"1";"1";"0";"1";"0";"457182";"373894"
"V4mis1";"SILVA (only NR);Eukaryota;Archaeplastida;Chloroplastida;Charophyta;Phragmoplastophyta;Streptophyta;Embryophyta;Tracheophyta;Spermatophyta;Magnoliophyta;Santalales;Langsdorffia;";"0.0";"0";"1";"1";"0";"1";"0";"457182";"373894"
"V4mis1";"SILVA (only NR);Eukaryota;Archaeplastida;Chloroplastida;Charophyta;Phragmoplastophyta;Streptophyta;Embryophyta;Tracheophyta;Spermatophyta;Magnoliophyta;Santalales;Lepidoceras;";"0.0";"0";"1";"1";"0";"1";"0";"457182";"373894"
"V4mis1";"SILVA (only NR);Eukaryota;Archaeplastida;Chloroplastida;Charophyta;Phragmoplastophyta;Streptophyta;Embryophyta;Tracheophyta;Spermatophyta;Magnoliophyta;Santalales;Leptomeria;";"0.0";"0";"1";"1";"0";"1";"0";"457182";"373894"
"V4mis1";"SILVA (only NR);Eukaryota;Archaeplastida;Chloroplastida;Charophyta;Phragmoplastophyta;Streptophyta;Embryophyta;Tracheophyta;Spermatophyta;Magnoliophyta;Santalales;Ligaria;";"0.0";"0";"1";"1";"0";"1";"0";"457182";"373894"
"V4mis1";"SILVA (only NR);Eukaryota;Archaeplastida;Chloroplastida;Charophyta;Phragmoplastophyta;Streptophyta;Embryophyta;Tracheophyta;Spermatophyta;Magnoliophyta;Santalales;Lophophytum;";"0.0";"0";"1";"1";"0";"1";"0";"457182";"373894"
"V4mis1";"SILVA (only NR);Eukaryota;Archaeplastida;Chloroplastida;Charophyta;Phragmoplastophyta;Streptophyta;Embryophyta;Tracheophyta;Spermatophyta;Magnoliophyta;Santalales;Loranthus;";"0.0";"0";"2";"2";"0";"2";"0";"457181";"373894"
"V4mis1";"SILVA (only NR);Eukaryota;Archaeplastida;Chloroplastida;Charophyta;Phragmoplastophyta;Streptophyta;Embryophyta;Tracheophyta;Spermatophyta;Magnoliophyta;Santalales;Loxanthera;";"0.0";"0";"1";"1";"0";"1";"0";"457182";"373894"
"V4mis1";"SILVA (only NR);Eukaryota;Archaeplastida;Chloroplastida;Charophyta;Phragmoplastophyta;Streptophyta;Embryophyta;Tracheophyta;Spermatophyta;Magnoliophyta;Santalales;Lysiana;";"0.0";"0";"1";"1";"0";"1";"0";"457182";"373894"
"V4mis1";"SILVA (only NR);Eukaryota;Archaeplastida;Chloroplastida;Charophyta;Phragmoplastophyta;Streptophyta;Embryophyta;Tracheophyta;Spermatophyta;Magnoliophyta;Santalales;Macrosolen;";"0.0";"0";"1";"1";"0";"1";"0";"457182";"373894"
"V4mis1";"SILVA (only NR);Eukaryota;Archaeplastida;Chloroplastida;Charophyta;Phragmoplastophyta;Streptophyta;Embryophyta;Tracheophyta;Spermatophyta;Magnoliophyta;Santalales;Malania;";"0.0";"0";"1";"1";"0";"1";"0";"457182";"373894"
"V4mis1";"SILVA (only NR);Eukaryota;Archaeplastida;Chloroplastida;Charophyta;Phragmoplastophyta;Streptophyta;Embryophyta;Tracheophyta;Spermatophyta;Magnoliophyta;Santalales;Mida;";"0.0";"0";"1";"1";"0";"1";"0";"457182";"373894"
"V4mis1";"SILVA (only NR);Eukaryota;Archaeplastida;Chloroplastida;Charophyta;Phragmoplastophyta;Streptophyta;Embryophyta;Tracheophyta;Spermatophyta;Magnoliophyta;Santalales;Misodendrum;";"0.0";"0";"2";"2";"0";"2";"0";"457181";"373894"
"V4mis1";"SILVA (only NR);Eukaryota;Archaeplastida;Chloroplastida;Charophyta;Phragmoplastophyta;Streptophyta;Embryophyta;Tracheophyta;Spermatophyta;Magnoliophyta;Santalales;Moquiniella;";"0.0";"0";"1";"1";"0";"1";"0";"457182";"373894"
"V4mis1";"SILVA (only NR);Eukaryota;Archaeplastida;Chloroplastida;Charophyta;Phragmoplastophyta;Streptophyta;Embryophyta;Tracheophyta;Spermatophyta;Magnoliophyta;Santalales;Myoschilos;";"0.0";"0";"1";"1";"0";"1";"0";"457182";"373894"
"V4mis1";"SILVA (only NR);Eukaryota;Archaeplastida;Chloroplastida;Charophyta;Phragmoplastophyta;Streptophyta;Embryophyta;Tracheophyta;Spermatophyta;Magnoliophyta;Santalales;Mystropetalon;";"0.0";"0";"1";"1";"0";"1";"0";"457182";"373894"
"V4mis1";"SILVA (only NR);Eukaryota;Archaeplastida;Chloroplastida;Charophyta;Phragmoplastophyta;Streptophyta;Embryophyta;Tracheophyta;Spermatophyta;Magnoliophyta;Santalales;Nestronia;";"0.0";"0";"1";"1";"0";"1";"0";"457182";"373894"
"V4mis1";"SILVA (only NR);Eukaryota;Archaeplastida;Chloroplastida;Charophyta;Phragmoplastophyta;Streptophyta;Embryophyta;Tracheophyta;Spermatophyta;Magnoliophyta;Santalales;Notanthera;";"0.0";"0";"1";"1";"0";"1";"0";"457182";"373894"
"V4mis1";"SILVA (only NR);Eukaryota;Archaeplastida;Chloroplastida;Charophyta;Phragmoplastophyta;Streptophyta;Embryophyta;Tracheophyta;Spermatophyta;Magnoliophyta;Santalales;Notothixos;";"0.0";"0";"2";"2";"0";"2";"0";"457181";"373894"
"V4mis1";"SILVA (only NR);Eukaryota;Archaeplastida;Chloroplastida;Charophyta;Phragmoplastophyta;Streptophyta;Embryophyta;Tracheophyta;Spermatophyta;Magnoliophyta;Santalales;Nuytsia;";"0.0";"0";"1";"1";"0";"1";"0";"457182";"373894"
"V4mis1";"SILVA (only NR);Eukaryota;Archaeplastida;Chloroplastida;Charophyta;Phragmoplastophyta;Streptophyta;Embryophyta;Tracheophyta;Spermatophyta;Magnoliophyta;Santalales;Olax;";"0.0";"0";"3";"3";"0";"3";"0";"457180";"373894"
"V4mis1";"SILVA (only NR);Eukaryota;Archaeplastida;Chloroplastida;Charophyta;Phragmoplastophyta;Streptophyta;Embryophyta;Tracheophyta;Spermatophyta;Magnoliophyta;Santalales;Oliverella;";"0.0";"0";"1";"1";"0";"1";"0";"457182";"373894"
"V4mis1";"SILVA (only NR);Eukaryota;Archaeplastida;Chloroplastida;Charophyta;Phragmoplastophyta;Streptophyta;Embryophyta;Tracheophyta;Spermatophyta;Magnoliophyta;Santalales;Ombrophytum;";"0.0";"0";"1";"1";"0";"1";"0";"457182";"373894"
"V4mis1";"SILVA (only NR);Eukaryota;Archaeplastida;Chloroplastida;Charophyta;Phragmoplastophyta;Streptophyta;Embryophyta;Tracheophyta;Spermatophyta;Magnoliophyta;Santalales;Omphacomeria;";"0.0";"0";"1";"1";"0";"1";"0";"457182";"373894"
"V4mis1";"SILVA (only NR);Eukaryota;Archaeplastida;Chloroplastida;Charophyta;Phragmoplastophyta;Streptophyta;Embryophyta;Tracheophyta;Spermatophyta;Magnoliophyta;Santalales;Oncella;";"0.0";"0";"1";"1";"0";"1";"0";"457182";"373894"
"V4mis1";"SILVA (only NR);Eukaryota;Archaeplastida;Chloroplastida;Charophyta;Phragmoplastophyta;Streptophyta;Embryophyta;Tracheophyta;Spermatophyta;Magnoliophyta;Santalales;Ongokea;";"0.0";"0";"1";"1";"0";"1";"0";"457182";"373894"
"V4mis1";"SILVA (only NR);Eukaryota;Archaeplastida;Chloroplastida;Charophyta;Phragmoplastophyta;Streptophyta;Embryophyta;Tracheophyta;Spermatophyta;Magnoliophyta;Santalales;Oryctanthus;";"0.0";"0";"1";"1";"0";"1";"0";"457182";"373894"
"V4mis1";"SILVA (only NR);Eukaryota;Archaeplastida;Chloroplastida;Charophyta;Phragmoplastophyta;Streptophyta;Embryophyta;Tracheophyta;Spermatophyta;Magnoliophyta;Santalales;Osyridicarpos;";"0.0";"0";"1";"1";"0";"1";"0";"457182";"373894"
"V4mis1";"SILVA (only NR);Eukaryota;Archaeplastida;Chloroplastida;Charophyta;Phragmoplastophyta;Streptophyta;Embryophyta;Tracheophyta;Spermatophyta;Magnoliophyta;Santalales;Osyris;";"0.0";"0";"2";"2";"0";"2";"0";"457181";"373894"
"V4mis1";"SILVA (only NR);Eukaryota;Archaeplastida;Chloroplastida;Charophyta;Phragmoplastophyta;Streptophyta;Embryophyta;Tracheophyta;Spermatophyta;Magnoliophyta;Santalales;Pentarhopalopilia;";"0.0";"0";"1";"1";"0";"1";"0";"457182";"373894"
"V4mis1";"SILVA (only NR);Eukaryota;Archaeplastida;Chloroplastida;Charophyta;Phragmoplastophyta;Streptophyta;Embryophyta;Tracheophyta;Spermatophyta;Magnoliophyta;Santalales;Phacellaria;";"0.0";"0";"1";"1";"0";"1";"0";"457182";"373894"
"V4mis1";"SILVA (only NR);Eukaryota;Archaeplastida;Chloroplastida;Charophyta;Phragmoplastophyta;Streptophyta;Embryophyta;Tracheophyta;Spermatophyta;Magnoliophyta;Santalales;Phoradendron;";"0.0";"0";"1";"1";"0";"1";"0";"457182";"373894"
"V4mis1";"SILVA (only NR);Eukaryota;Archaeplastida;Chloroplastida;Charophyta;Phragmoplastophyta;Streptophyta;Embryophyta;Tracheophyta;Spermatophyta;Magnoliophyta;Santalales;Phthirusa;";"0.0";"0";"1";"1";"0";"1";"0";"457182";"373894"
"V4mis1";"SILVA (only NR);Eukaryota;Archaeplastida;Chloroplastida;Charophyta;Phragmoplastophyta;Streptophyta;Embryophyta;Tracheophyta;Spermatophyta;Magnoliophyta;Santalales;Plicosepalus;";"0.0";"0";"1";"1";"0";"1";"0";"457182";"373894"
"V4mis1";"SILVA (only NR);Eukaryota;Archaeplastida;Chloroplastida;Charophyta;Phragmoplastophyta;Streptophyta;Embryophyta;Tracheophyta;Spermatophyta;Magnoliophyta;Santalales;Psittacanthus;";"0.0";"0";"1";"1";"0";"1";"0";"457182";"373894"
"V4mis1";"SILVA (only NR);Eukaryota;Archaeplastida;Chloroplastida;Charophyta;Phragmoplastophyta;Streptophyta;Embryophyta;Tracheophyta;Spermatophyta;Magnoliophyta;Santalales;Ptychopetalum;";"0.0";"0";"1";"1";"0";"1";"0";"457182";"373894"
"V4mis1";"SILVA (only NR);Eukaryota;Archaeplastida;Chloroplastida;Charophyta;Phragmoplastophyta;Streptophyta;Embryophyta;Tracheophyta;Spermatophyta;Magnoliophyta;Santalales;Quinchamalium;";"0.0";"0";"1";"1";"0";"1";"0";"457182";"373894"
"V4mis1";"SILVA (only NR);Eukaryota;Archaeplastida;Chloroplastida;Charophyta;Phragmoplastophyta;Streptophyta;Embryophyta;Tracheophyta;Spermatophyta;Magnoliophyta;Santalales;Rhoiacarpos;";"0.0";"0";"1";"1";"0";"1";"0";"457182";"373894"
"V4mis1";"SILVA (only NR);Eukaryota;Archaeplastida;Chloroplastida;Charophyta;Phragmoplastophyta;Streptophyta;Embryophyta;Tracheophyta;Spermatophyta;Magnoliophyta;Santalales;Santalum;";"0.0";"0";"1";"1";"0";"1";"0";"457182";"373894"
"V4mis1";"SILVA (only NR);Eukaryota;Archaeplastida;Chloroplastida;Charophyta;Phragmoplastophyta;Streptophyta;Embryophyta;Tracheophyta;Spermatophyta;Magnoliophyta;Santalales;Sarcophyte;";"0.0";"0";"1";"1";"0";"1";"0";"457182";"373894"
"V4mis1";"SILVA (only NR);Eukaryota;Archaeplastida;Chloroplastida;Charophyta;Phragmoplastophyta;Streptophyta;Embryophyta;Tracheophyta;Spermatophyta;Magnoliophyta;Santalales;Schoepfia;";"0.0";"0";"2";"2";"0";"2";"0";"457181";"373894"
"V4mis1";"SILVA (only NR);Eukaryota;Archaeplastida;Chloroplastida;Charophyta;Phragmoplastophyta;Streptophyta;Embryophyta;Tracheophyta;Spermatophyta;Magnoliophyta;Santalales;Scleropyrum;";"0.0";"0";"1";"1";"0";"1";"0";"457182";"373894"
"V4mis1";"SILVA (only NR);Eukaryota;Archaeplastida;Chloroplastida;Charophyta;Phragmoplastophyta;Streptophyta;Embryophyta;Tracheophyta;Spermatophyta;Magnoliophyta;Santalales;Scorodocarpus;";"0.0";"0";"1";"1";"0";"1";"0";"457182";"373894"
"V4mis1";"SILVA (only NR);Eukaryota;Archaeplastida;Chloroplastida;Charophyta;Phragmoplastophyta;Streptophyta;Embryophyta;Tracheophyta;Spermatophyta;Magnoliophyta;Santalales;Scybalium;";"0.0";"0";"1";"1";"0";"1";"0";"457182";"373894"
"V4mis1";"SILVA (only NR);Eukaryota;Archaeplastida;Chloroplastida;Charophyta;Phragmoplastophyta;Streptophyta;Embryophyta;Tracheophyta;Spermatophyta;Magnoliophyta;Santalales;Sogerianthe;";"0.0";"0";"1";"1";"0";"1";"0";"457182";"373894"
"V4mis1";"SILVA (only NR);Eukaryota;Archaeplastida;Chloroplastida;Charophyta;Phragmoplastophyta;Streptophyta;Embryophyta;Tracheophyta;Spermatophyta;Magnoliophyta;Santalales;Strombosia;";"0.0";"0";"1";"1";"0";"1";"0";"457182";"373894"
"V4mis1";"SILVA (only NR);Eukaryota;Archaeplastida;Chloroplastida;Charophyta;Phragmoplastophyta;Streptophyta;Embryophyta;Tracheophyta;Spermatophyta;Magnoliophyta;Santalales;Strombosiopsis;";"0.0";"0";"1";"1";"0";"1";"0";"457182";"373894"
"V4mis1";"SILVA (only NR);Eukaryota;Archaeplastida;Chloroplastida;Charophyta;Phragmoplastophyta;Streptophyta;Embryophyta;Tracheophyta;Spermatophyta;Magnoliophyta;Santalales;Struthanthus;";"0.0";"0";"2";"2";"0";"2";"0";"457181";"373894"
"V4mis1";"SILVA (only NR);Eukaryota;Archaeplastida;Chloroplastida;Charophyta;Phragmoplastophyta;Streptophyta;Embryophyta;Tracheophyta;Spermatophyta;Magnoliophyta;Santalales;Taxillus;";"0.0";"0";"2";"2";"0";"2";"0";"457181";"373894"
"V4mis1";"SILVA (only NR);Eukaryota;Archaeplastida;Chloroplastida;Charophyta;Phragmoplastophyta;Streptophyta;Embryophyta;Tracheophyta;Spermatophyta;Magnoliophyta;Santalales;Thesidium;";"0.0";"0";"1";"1";"0";"1";"0";"457182";"373894"
"V4mis1";"SILVA (only NR);Eukaryota;Archaeplastida;Chloroplastida;Charophyta;Phragmoplastophyta;Streptophyta;Embryophyta;Tracheophyta;Spermatophyta;Magnoliophyta;Santalales;Thesium;";"0.0";"0";"2";"2";"0";"2";"0";"457181";"373894"
"V4mis1";"SILVA (only NR);Eukaryota;Archaeplastida;Chloroplastida;Charophyta;Phragmoplastophyta;Streptophyta;Embryophyta;Tracheophyta;Spermatophyta;Magnoliophyta;Santalales;Thonningia;";"0.0";"0";"1";"1";"0";"1";"0";"457182";"373894"
"V4mis1";"SILVA (only NR);Eukaryota;Archaeplastida;Chloroplastida;Charophyta;Phragmoplastophyta;Streptophyta;Embryophyta;Tracheophyta;Spermatophyta;Magnoliophyta;Santalales;Tristerix;";"0.0";"0";"1";"1";"0";"1";"0";"457182";"373894"
"V4mis1";"SILVA (only NR);Eukaryota;Archaeplastida;Chloroplastida;Charophyta;Phragmoplastophyta;Streptophyta;Embryophyta;Tracheophyta;Spermatophyta;Magnoliophyta;Santalales;Vanwykia;";"0.0";"0";"1";"1";"0";"1";"0";"457182";"373894"
"V4mis1";"SILVA (only NR);Eukaryota;Archaeplastida;Chloroplastida;Charophyta;Phragmoplastophyta;Streptophyta;Embryophyta;Tracheophyta;Spermatophyta;Magnoliophyta;Santalales;Viscum;";"0.0";"0";"3";"3";"0";"3";"0";"457180";"373894"
"V4mis1";"SILVA (only NR);Eukaryota;Archaeplastida;Chloroplastida;Charophyta;Phragmoplastophyta;Streptophyta;Embryophyta;Tracheophyta;Spermatophyta;Magnoliophyta;Santalales;Ximenia;";"0.0";"0";"1";"1";"0";"1";"0";"457182";"373894"
"V4mis1";"SILVA (only NR);Eukaryota;Archaeplastida;Chloroplastida;Charophyta;Phragmoplastophyta;Streptophyta;Embryophyta;Tracheophyta;Spermatophyta;Magnoliophyta;Santales;";"0.0";"0";"1";"1";"0";"1";"0";"457182";"373894"
"V4mis1";"SILVA (only NR);Eukaryota;Archaeplastida;Chloroplastida;Charophyta;Phragmoplastophyta;Streptophyta;Embryophyta;Tracheophyta;Spermatophyta;Magnoliophyta;Santales;Minquartia;";"0.0";"0";"1";"1";"0";"1";"0";"457182";"373894"
"V4mis1";"SILVA (only NR);Eukaryota;Archaeplastida;Chloroplastida;Charophyta;Phragmoplastophyta;Streptophyta;Embryophyta;Tracheophyta;Spermatophyta;Magnoliophyta;Sapindales;";"2.3";"18.2";"44";"44";"1";"43";"0";"457139";"373893"
"V4mis1";"SILVA (only NR);Eukaryota;Archaeplastida;Chloroplastida;Charophyta;Phragmoplastophyta;Streptophyta;Embryophyta;Tracheophyta;Spermatophyta;Magnoliophyta;Sapindales;Anacardium;";"0.0";"0";"1";"1";"0";"1";"0";"457182";"373894"
"V4mis1";"SILVA (only NR);Eukaryota;Archaeplastida;Chloroplastida;Charophyta;Phragmoplastophyta;Streptophyta;Embryophyta;Tracheophyta;Spermatophyta;Magnoliophyta;Sapindales;Atalantia;";"0.0";"0";"1";"1";"0";"1";"0";"457182";"373894"
"V4mis1";"SILVA (only NR);Eukaryota;Archaeplastida;Chloroplastida;Charophyta;Phragmoplastophyta;Streptophyta;Embryophyta;Tracheophyta;Spermatophyta;Magnoliophyta;Sapindales;Azadirachta;";"0.0";"0";"1";"1";"0";"1";"0";"457182";"373894"
"V4mis1";"SILVA (only NR);Eukaryota;Archaeplastida;Chloroplastida;Charophyta;Phragmoplastophyta;Streptophyta;Embryophyta;Tracheophyta;Spermatophyta;Magnoliophyta;Sapindales;Biebersteinia;";"0.0";"0";"1";"1";"0";"1";"0";"457182";"373894"
"V4mis1";"SILVA (only NR);Eukaryota;Archaeplastida;Chloroplastida;Charophyta;Phragmoplastophyta;Streptophyta;Embryophyta;Tracheophyta;Spermatophyta;Magnoliophyta;Sapindales;Bursera;";"0.0";"0";"1";"1";"0";"1";"0";"457182";"373894"
"V4mis1";"SILVA (only NR);Eukaryota;Archaeplastida;Chloroplastida;Charophyta;Phragmoplastophyta;Streptophyta;Embryophyta;Tracheophyta;Spermatophyta;Magnoliophyta;Sapindales;Citrus;";"4.2";"18.2";"24";"24";"1";"23";"0";"457159";"373893"
"V4mis1";"SILVA (only NR);Eukaryota;Archaeplastida;Chloroplastida;Charophyta;Phragmoplastophyta;Streptophyta;Embryophyta;Tracheophyta;Spermatophyta;Magnoliophyta;Sapindales;Dodonaea;";"0.0";"0";"1";"1";"0";"1";"0";"457182";"373894"
"V4mis1";"SILVA (only NR);Eukaryota;Archaeplastida;Chloroplastida;Charophyta;Phragmoplastophyta;Streptophyta;Embryophyta;Tracheophyta;Spermatophyta;Magnoliophyta;Sapindales;Guarea;";"0.0";"0";"1";"1";"0";"1";"0";"457182";"373894"
"V4mis1";"SILVA (only NR);Eukaryota;Archaeplastida;Chloroplastida;Charophyta;Phragmoplastophyta;Streptophyta;Embryophyta;Tracheophyta;Spermatophyta;Magnoliophyta;Sapindales;Koelreuteria;";"0.0";"0";"2";"2";"0";"2";"0";"457181";"373894"
"V4mis1";"SILVA (only NR);Eukaryota;Archaeplastida;Chloroplastida;Charophyta;Phragmoplastophyta;Streptophyta;Embryophyta;Tracheophyta;Spermatophyta;Magnoliophyta;Sapindales;Litchi;";"0.0";"0";"1";"1";"0";"1";"0";"457182";"373894"
"V4mis1";"SILVA (only NR);Eukaryota;Archaeplastida;Chloroplastida;Charophyta;Phragmoplastophyta;Streptophyta;Embryophyta;Tracheophyta;Spermatophyta;Magnoliophyta;Sapindales;Mangifera;";"0.0";"0";"7";"7";"0";"7";"0";"457176";"373894"
"V4mis1";"SILVA (only NR);Eukaryota;Archaeplastida;Chloroplastida;Charophyta;Phragmoplastophyta;Streptophyta;Embryophyta;Tracheophyta;Spermatophyta;Magnoliophyta;Sapindales;Nitraria;";"0.0";"0";"2";"2";"0";"2";"0";"457181";"373894"
"V4mis1";"SILVA (only NR);Eukaryota;Archaeplastida;Chloroplastida;Charophyta;Phragmoplastophyta;Streptophyta;Embryophyta;Tracheophyta;Spermatophyta;Magnoliophyta;Sapindales;Xylocarpus;";"0.0";"0";"1";"1";"0";"1";"0";"457182";"373894"
"V4mis1";"SILVA (only NR);Eukaryota;Archaeplastida;Chloroplastida;Charophyta;Phragmoplastophyta;Streptophyta;Embryophyta;Tracheophyta;Spermatophyta;Magnoliophyta;Saxifragales;";"0.0";"0";"17";"17";"0";"17";"0";"457166";"373894"
"V4mis1";"SILVA (only NR);Eukaryota;Archaeplastida;Chloroplastida;Charophyta;Phragmoplastophyta;Streptophyta;Embryophyta;Tracheophyta;Spermatophyta;Magnoliophyta;Saxifragales;Chrysosplenium;";"0.0";"0";"1";"1";"0";"1";"0";"457182";"373894"
"V4mis1";"SILVA (only NR);Eukaryota;Archaeplastida;Chloroplastida;Charophyta;Phragmoplastophyta;Streptophyta;Embryophyta;Tracheophyta;Spermatophyta;Magnoliophyta;Saxifragales;Crassula;";"0.0";"0";"1";"1";"0";"1";"0";"457182";"373894"
"V4mis1";"SILVA (only NR);Eukaryota;Archaeplastida;Chloroplastida;Charophyta;Phragmoplastophyta;Streptophyta;Embryophyta;Tracheophyta;Spermatophyta;Magnoliophyta;Saxifragales;Cynomorium;";"0.0";"0";"3";"3";"0";"3";"0";"457180";"373894"
"V4mis1";"SILVA (only NR);Eukaryota;Archaeplastida;Chloroplastida;Charophyta;Phragmoplastophyta;Streptophyta;Embryophyta;Tracheophyta;Spermatophyta;Magnoliophyta;Saxifragales;Fendlera;";"0.0";"0";"1";"1";"0";"1";"0";"457182";"373894"
"V4mis1";"SILVA (only NR);Eukaryota;Archaeplastida;Chloroplastida;Charophyta;Phragmoplastophyta;Streptophyta;Embryophyta;Tracheophyta;Spermatophyta;Magnoliophyta;Saxifragales;Kalanchoe;";"0.0";"0";"1";"1";"0";"1";"0";"457182";"373894"
"V4mis1";"SILVA (only NR);Eukaryota;Archaeplastida;Chloroplastida;Charophyta;Phragmoplastophyta;Streptophyta;Embryophyta;Tracheophyta;Spermatophyta;Magnoliophyta;Saxifragales;Micranthes;";"0.0";"0";"1";"1";"0";"1";"0";"457182";"373894"
"V4mis1";"SILVA (only NR);Eukaryota;Archaeplastida;Chloroplastida;Charophyta;Phragmoplastophyta;Streptophyta;Embryophyta;Tracheophyta;Spermatophyta;Magnoliophyta;Saxifragales;Myriophyllum;";"0.0";"0";"1";"1";"0";"1";"0";"457182";"373894"
"V4mis1";"SILVA (only NR);Eukaryota;Archaeplastida;Chloroplastida;Charophyta;Phragmoplastophyta;Streptophyta;Embryophyta;Tracheophyta;Spermatophyta;Magnoliophyta;Saxifragales;Mytilaria;";"0.0";"0";"1";"1";"0";"1";"0";"457182";"373894"
"V4mis1";"SILVA (only NR);Eukaryota;Archaeplastida;Chloroplastida;Charophyta;Phragmoplastophyta;Streptophyta;Embryophyta;Tracheophyta;Spermatophyta;Magnoliophyta;Saxifragales;Paeonia;";"0.0";"0";"1";"1";"0";"1";"0";"457182";"373894"
"V4mis1";"SILVA (only NR);Eukaryota;Archaeplastida;Chloroplastida;Charophyta;Phragmoplastophyta;Streptophyta;Embryophyta;Tracheophyta;Spermatophyta;Magnoliophyta;Saxifragales;Peltoboykinia;";"0.0";"0";"1";"1";"0";"1";"0";"457182";"373894"
"V4mis1";"SILVA (only NR);Eukaryota;Archaeplastida;Chloroplastida;Charophyta;Phragmoplastophyta;Streptophyta;Embryophyta;Tracheophyta;Spermatophyta;Magnoliophyta;Saxifragales;Penthorum;";"0.0";"0";"1";"1";"0";"1";"0";"457182";"373894"
"V4mis1";"SILVA (only NR);Eukaryota;Archaeplastida;Chloroplastida;Charophyta;Phragmoplastophyta;Streptophyta;Embryophyta;Tracheophyta;Spermatophyta;Magnoliophyta;Saxifragales;Peridiscus;";"0.0";"0";"1";"1";"0";"1";"0";"457182";"373894"
"V4mis1";"SILVA (only NR);Eukaryota;Archaeplastida;Chloroplastida;Charophyta;Phragmoplastophyta;Streptophyta;Embryophyta;Tracheophyta;Spermatophyta;Magnoliophyta;Saxifragales;Ribes;";"0.0";"0";"1";"1";"0";"1";"0";"457182";"373894"
"V4mis1";"SILVA (only NR);Eukaryota;Archaeplastida;Chloroplastida;Charophyta;Phragmoplastophyta;Streptophyta;Embryophyta;Tracheophyta;Spermatophyta;Magnoliophyta;Saxifragales;Saxifraga;";"0.0";"0";"1";"1";"0";"1";"0";"457182";"373894"
"V4mis1";"SILVA (only NR);Eukaryota;Archaeplastida;Chloroplastida;Charophyta;Phragmoplastophyta;Streptophyta;Embryophyta;Tracheophyta;Spermatophyta;Magnoliophyta;Saxifragales;Tetracarpaea;";"0.0";"0";"1";"1";"0";"1";"0";"457182";"373894"
"V4mis1";"SILVA (only NR);Eukaryota;Archaeplastida;Chloroplastida;Charophyta;Phragmoplastophyta;Streptophyta;Embryophyta;Tracheophyta;Spermatophyta;Magnoliophyta;Solanales;";"1.3";"18.1";"633";"632";"8";"624";"1";"456551";"373886"
"V4mis1";"SILVA (only NR);Eukaryota;Archaeplastida;Chloroplastida;Charophyta;Phragmoplastophyta;Streptophyta;Embryophyta;Tracheophyta;Spermatophyta;Magnoliophyta;Solanales;Atropa;";"0.0";"0";"1";"1";"0";"1";"0";"457182";"373894"
"V4mis1";"SILVA (only NR);Eukaryota;Archaeplastida;Chloroplastida;Charophyta;Phragmoplastophyta;Streptophyta;Embryophyta;Tracheophyta;Spermatophyta;Magnoliophyta;Solanales;Capsicum;";"0.0";"0";"83";"83";"0";"83";"0";"457100";"373894"
"V4mis1";"SILVA (only NR);Eukaryota;Archaeplastida;Chloroplastida;Charophyta;Phragmoplastophyta;Streptophyta;Embryophyta;Tracheophyta;Spermatophyta;Magnoliophyta;Solanales;Cuscuta;";"0.0";"0";"2";"2";"0";"2";"0";"457181";"373894"
"V4mis1";"SILVA (only NR);Eukaryota;Archaeplastida;Chloroplastida;Charophyta;Phragmoplastophyta;Streptophyta;Embryophyta;Tracheophyta;Spermatophyta;Magnoliophyta;Solanales;Evolvulus;";"0.0";"0";"1";"1";"0";"1";"0";"457182";"373894"
"V4mis1";"SILVA (only NR);Eukaryota;Archaeplastida;Chloroplastida;Charophyta;Phragmoplastophyta;Streptophyta;Embryophyta;Tracheophyta;Spermatophyta;Magnoliophyta;Solanales;Hydroleaceae;";"0.0";"0";"1";"1";"0";"1";"0";"457182";"373894"
"V4mis1";"SILVA (only NR);Eukaryota;Archaeplastida;Chloroplastida;Charophyta;Phragmoplastophyta;Streptophyta;Embryophyta;Tracheophyta;Spermatophyta;Magnoliophyta;Solanales;Hydroleaceae;Hydrolea;";"0.0";"0";"1";"1";"0";"1";"0";"457182";"373894"
"V4mis1";"SILVA (only NR);Eukaryota;Archaeplastida;Chloroplastida;Charophyta;Phragmoplastophyta;Streptophyta;Embryophyta;Tracheophyta;Spermatophyta;Magnoliophyta;Solanales;Ipomoea;";"0.0";"0";"324";"323";"0";"323";"1";"456860";"373894"
"V4mis1";"SILVA (only NR);Eukaryota;Archaeplastida;Chloroplastida;Charophyta;Phragmoplastophyta;Streptophyta;Embryophyta;Tracheophyta;Spermatophyta;Magnoliophyta;Solanales;Montinia;";"0.0";"0";"2";"2";"0";"2";"0";"457181";"373894"
"V4mis1";"SILVA (only NR);Eukaryota;Archaeplastida;Chloroplastida;Charophyta;Phragmoplastophyta;Streptophyta;Embryophyta;Tracheophyta;Spermatophyta;Magnoliophyta;Solanales;Nicotiana;";"2.1";"18.2";"142";"142";"3";"139";"0";"457041";"373891"
"V4mis1";"SILVA (only NR);Eukaryota;Archaeplastida;Chloroplastida;Charophyta;Phragmoplastophyta;Streptophyta;Embryophyta;Tracheophyta;Spermatophyta;Magnoliophyta;Solanales;Petunia;";"0.0";"0";"6";"6";"0";"6";"0";"457177";"373894"
"V4mis1";"SILVA (only NR);Eukaryota;Archaeplastida;Chloroplastida;Charophyta;Phragmoplastophyta;Streptophyta;Embryophyta;Tracheophyta;Spermatophyta;Magnoliophyta;Solanales;Phacelia;";"0.0";"0";"1";"1";"0";"1";"0";"457182";"373894"
"V4mis1";"SILVA (only NR);Eukaryota;Archaeplastida;Chloroplastida;Charophyta;Phragmoplastophyta;Streptophyta;Embryophyta;Tracheophyta;Spermatophyta;Magnoliophyta;Solanales;Schizanthus;";"0.0";"0";"1";"1";"0";"1";"0";"457182";"373894"
"V4mis1";"SILVA (only NR);Eukaryota;Archaeplastida;Chloroplastida;Charophyta;Phragmoplastophyta;Streptophyta;Embryophyta;Tracheophyta;Spermatophyta;Magnoliophyta;Solanales;Solanum;";"7.9";"18.2";"63";"63";"5";"58";"0";"457120";"373889"
"V4mis1";"SILVA (only NR);Eukaryota;Archaeplastida;Chloroplastida;Charophyta;Phragmoplastophyta;Streptophyta;Embryophyta;Tracheophyta;Spermatophyta;Magnoliophyta;Solanales;Sphenoclea;";"0.0";"0";"1";"1";"0";"1";"0";"457182";"373894"
"V4mis1";"SILVA (only NR);Eukaryota;Archaeplastida;Chloroplastida;Charophyta;Phragmoplastophyta;Streptophyta;Embryophyta;Tracheophyta;Spermatophyta;Magnoliophyta;Solanales;Withania;";"0.0";"0";"5";"5";"0";"5";"0";"457178";"373894"
"V4mis1";"SILVA (only NR);Eukaryota;Archaeplastida;Chloroplastida;Charophyta;Phragmoplastophyta;Streptophyta;Embryophyta;Tracheophyta;Spermatophyta;Magnoliophyta;Trochodendrales;";"0.0";"0";"1";"1";"0";"1";"0";"457182";"373894"
"V4mis1";"SILVA (only NR);Eukaryota;Archaeplastida;Chloroplastida;Charophyta;Phragmoplastophyta;Streptophyta;Embryophyta;Tracheophyta;Spermatophyta;Magnoliophyta;Trochodendrales;Trochodendron;";"0.0";"0";"1";"1";"0";"1";"0";"457182";"373894"
"V4mis1";"SILVA (only NR);Eukaryota;Archaeplastida;Chloroplastida;Charophyta;Phragmoplastophyta;Streptophyta;Embryophyta;Tracheophyta;Spermatophyta;Magnoliophyta;Vitales;";"0.0";"0";"6";"6";"0";"6";"0";"457177";"373894"
"V4mis1";"SILVA (only NR);Eukaryota;Archaeplastida;Chloroplastida;Charophyta;Phragmoplastophyta;Streptophyta;Embryophyta;Tracheophyta;Spermatophyta;Magnoliophyta;Vitales;Leea;";"0.0";"0";"1";"1";"0";"1";"0";"457182";"373894"
"V4mis1";"SILVA (only NR);Eukaryota;Archaeplastida;Chloroplastida;Charophyta;Phragmoplastophyta;Streptophyta;Embryophyta;Tracheophyta;Spermatophyta;Magnoliophyta;Vitales;Tetrastigma;";"0.0";"0";"1";"1";"0";"1";"0";"457182";"373894"
"V4mis1";"SILVA (only NR);Eukaryota;Archaeplastida;Chloroplastida;Charophyta;Phragmoplastophyta;Streptophyta;Embryophyta;Tracheophyta;Spermatophyta;Magnoliophyta;Vitales;Vitis;";"0.0";"0";"4";"4";"0";"4";"0";"457179";"373894"
"V4mis1";"SILVA (only NR);Eukaryota;Archaeplastida;Chloroplastida;Charophyta;Phragmoplastophyta;Streptophyta;Embryophyta;Tracheophyta;Spermatophyta;Magnoliophyta;Zygophyllales;";"0.0";"0";"2";"2";"0";"2";"0";"457181";"373894"
"V4mis1";"SILVA (only NR);Eukaryota;Archaeplastida;Chloroplastida;Charophyta;Phragmoplastophyta;Streptophyta;Embryophyta;Tracheophyta;Spermatophyta;Magnoliophyta;Zygophyllales;Krameria;";"0.0";"0";"1";"1";"0";"1";"0";"457182";"373894"
"V4mis1";"SILVA (only NR);Eukaryota;Archaeplastida;Chloroplastida;Charophyta;Phragmoplastophyta;Streptophyta;Embryophyta;Tracheophyta;Spermatophyta;Magnoliophyta;Zygophyllales;Larrea;";"0.0";"0";"1";"1";"0";"1";"0";"457182";"373894"
"V4mis1";"SILVA (only NR);Eukaryota;Archaeplastida;Chloroplastida;Charophyta;Phragmoplastophyta;Streptophyta;Embryophyta;Tracheophyta;Spermatophyta;Pinophyta;";"0.3";"18.1";"686";"679";"2";"677";"7";"456504";"373892"
"V4mis1";"SILVA (only NR);Eukaryota;Archaeplastida;Chloroplastida;Charophyta;Phragmoplastophyta;Streptophyta;Embryophyta;Tracheophyta;Spermatophyta;Pinophyta;Araucariales;";"0.0";"0";"19";"18";"0";"18";"1";"457165";"373894"
"V4mis1";"SILVA (only NR);Eukaryota;Archaeplastida;Chloroplastida;Charophyta;Phragmoplastophyta;Streptophyta;Embryophyta;Tracheophyta;Spermatophyta;Pinophyta;Araucariales;Afrocarpus;";"0.0";"0";"1";"1";"0";"1";"0";"457182";"373894"
"V4mis1";"SILVA (only NR);Eukaryota;Archaeplastida;Chloroplastida;Charophyta;Phragmoplastophyta;Streptophyta;Embryophyta;Tracheophyta;Spermatophyta;Pinophyta;Araucariales;Agathis;";"0.0";"0";"1";"1";"0";"1";"0";"457182";"373894"
"V4mis1";"SILVA (only NR);Eukaryota;Archaeplastida;Chloroplastida;Charophyta;Phragmoplastophyta;Streptophyta;Embryophyta;Tracheophyta;Spermatophyta;Pinophyta;Araucariales;Araucaria;";"0.0";"0";"6";"5";"0";"5";"1";"457178";"373894"
"V4mis1";"SILVA (only NR);Eukaryota;Archaeplastida;Chloroplastida;Charophyta;Phragmoplastophyta;Streptophyta;Embryophyta;Tracheophyta;Spermatophyta;Pinophyta;Araucariales;Dacrydium;";"0.0";"0";"1";"1";"0";"1";"0";"457182";"373894"
"V4mis1";"SILVA (only NR);Eukaryota;Archaeplastida;Chloroplastida;Charophyta;Phragmoplastophyta;Streptophyta;Embryophyta;Tracheophyta;Spermatophyta;Pinophyta;Araucariales;Halocarpus;";"0.0";"0";"1";"1";"0";"1";"0";"457182";"373894"
"V4mis1";"SILVA (only NR);Eukaryota;Archaeplastida;Chloroplastida;Charophyta;Phragmoplastophyta;Streptophyta;Embryophyta;Tracheophyta;Spermatophyta;Pinophyta;Araucariales;Lagarostrobos;";"0.0";"0";"1";"1";"0";"1";"0";"457182";"373894"
"V4mis1";"SILVA (only NR);Eukaryota;Archaeplastida;Chloroplastida;Charophyta;Phragmoplastophyta;Streptophyta;Embryophyta;Tracheophyta;Spermatophyta;Pinophyta;Araucariales;Manoao;";"0.0";"0";"1";"1";"0";"1";"0";"457182";"373894"
"V4mis1";"SILVA (only NR);Eukaryota;Archaeplastida;Chloroplastida;Charophyta;Phragmoplastophyta;Streptophyta;Embryophyta;Tracheophyta;Spermatophyta;Pinophyta;Araucariales;Microcachrys;";"0.0";"0";"1";"1";"0";"1";"0";"457182";"373894"
"V4mis1";"SILVA (only NR);Eukaryota;Archaeplastida;Chloroplastida;Charophyta;Phragmoplastophyta;Streptophyta;Embryophyta;Tracheophyta;Spermatophyta;Pinophyta;Araucariales;Parasitaxus;";"0.0";"0";"1";"1";"0";"1";"0";"457182";"373894"
"V4mis1";"SILVA (only NR);Eukaryota;Archaeplastida;Chloroplastida;Charophyta;Phragmoplastophyta;Streptophyta;Embryophyta;Tracheophyta;Spermatophyta;Pinophyta;Araucariales;Pherosphaera;";"0.0";"0";"1";"1";"0";"1";"0";"457182";"373894"
"V4mis1";"SILVA (only NR);Eukaryota;Archaeplastida;Chloroplastida;Charophyta;Phragmoplastophyta;Streptophyta;Embryophyta;Tracheophyta;Spermatophyta;Pinophyta;Araucariales;Phyllocladus;";"0.0";"0";"1";"1";"0";"1";"0";"457182";"373894"
"V4mis1";"SILVA (only NR);Eukaryota;Archaeplastida;Chloroplastida;Charophyta;Phragmoplastophyta;Streptophyta;Embryophyta;Tracheophyta;Spermatophyta;Pinophyta;Araucariales;Podocarpus;";"0.0";"0";"1";"1";"0";"1";"0";"457182";"373894"
"V4mis1";"SILVA (only NR);Eukaryota;Archaeplastida;Chloroplastida;Charophyta;Phragmoplastophyta;Streptophyta;Embryophyta;Tracheophyta;Spermatophyta;Pinophyta;Araucariales;Prumnopitys;";"0.0";"0";"1";"1";"0";"1";"0";"457182";"373894"
"V4mis1";"SILVA (only NR);Eukaryota;Archaeplastida;Chloroplastida;Charophyta;Phragmoplastophyta;Streptophyta;Embryophyta;Tracheophyta;Spermatophyta;Pinophyta;Araucariales;Saxegothaea;";"0.0";"0";"1";"1";"0";"1";"0";"457182";"373894"
"V4mis1";"SILVA (only NR);Eukaryota;Archaeplastida;Chloroplastida;Charophyta;Phragmoplastophyta;Streptophyta;Embryophyta;Tracheophyta;Spermatophyta;Pinophyta;Cupressales;";"0.0";"0";"23";"23";"0";"23";"0";"457160";"373894"
"V4mis1";"SILVA (only NR);Eukaryota;Archaeplastida;Chloroplastida;Charophyta;Phragmoplastophyta;Streptophyta;Embryophyta;Tracheophyta;Spermatophyta;Pinophyta;Cupressales;Actinostrobus;";"0.0";"0";"1";"1";"0";"1";"0";"457182";"373894"
"V4mis1";"SILVA (only NR);Eukaryota;Archaeplastida;Chloroplastida;Charophyta;Phragmoplastophyta;Streptophyta;Embryophyta;Tracheophyta;Spermatophyta;Pinophyta;Cupressales;Amentotaxus;";"0.0";"0";"1";"1";"0";"1";"0";"457182";"373894"
"V4mis1";"SILVA (only NR);Eukaryota;Archaeplastida;Chloroplastida;Charophyta;Phragmoplastophyta;Streptophyta;Embryophyta;Tracheophyta;Spermatophyta;Pinophyta;Cupressales;Austrocedrus;";"0.0";"0";"1";"1";"0";"1";"0";"457182";"373894"
"V4mis1";"SILVA (only NR);Eukaryota;Archaeplastida;Chloroplastida;Charophyta;Phragmoplastophyta;Streptophyta;Embryophyta;Tracheophyta;Spermatophyta;Pinophyta;Cupressales;Austrotaxus;";"0.0";"0";"1";"1";"0";"1";"0";"457182";"373894"
"V4mis1";"SILVA (only NR);Eukaryota;Archaeplastida;Chloroplastida;Charophyta;Phragmoplastophyta;Streptophyta;Embryophyta;Tracheophyta;Spermatophyta;Pinophyta;Cupressales;Callitropsis;";"0.0";"0";"1";"1";"0";"1";"0";"457182";"373894"
"V4mis1";"SILVA (only NR);Eukaryota;Archaeplastida;Chloroplastida;Charophyta;Phragmoplastophyta;Streptophyta;Embryophyta;Tracheophyta;Spermatophyta;Pinophyta;Cupressales;Calocedrus;";"0.0";"0";"1";"1";"0";"1";"0";"457182";"373894"
"V4mis1";"SILVA (only NR);Eukaryota;Archaeplastida;Chloroplastida;Charophyta;Phragmoplastophyta;Streptophyta;Embryophyta;Tracheophyta;Spermatophyta;Pinophyta;Cupressales;Chamaecyparis;";"0.0";"0";"2";"2";"0";"2";"0";"457181";"373894"
"V4mis1";"SILVA (only NR);Eukaryota;Archaeplastida;Chloroplastida;Charophyta;Phragmoplastophyta;Streptophyta;Embryophyta;Tracheophyta;Spermatophyta;Pinophyta;Cupressales;Cunninghamia;";"0.0";"0";"1";"1";"0";"1";"0";"457182";"373894"
"V4mis1";"SILVA (only NR);Eukaryota;Archaeplastida;Chloroplastida;Charophyta;Phragmoplastophyta;Streptophyta;Embryophyta;Tracheophyta;Spermatophyta;Pinophyta;Cupressales;Cupressus;";"0.0";"0";"1";"1";"0";"1";"0";"457182";"373894"
"V4mis1";"SILVA (only NR);Eukaryota;Archaeplastida;Chloroplastida;Charophyta;Phragmoplastophyta;Streptophyta;Embryophyta;Tracheophyta;Spermatophyta;Pinophyta;Cupressales;Hesperocyparis;";"0.0";"0";"1";"1";"0";"1";"0";"457182";"373894"
"V4mis1";"SILVA (only NR);Eukaryota;Archaeplastida;Chloroplastida;Charophyta;Phragmoplastophyta;Streptophyta;Embryophyta;Tracheophyta;Spermatophyta;Pinophyta;Cupressales;Juniperus;";"0.0";"0";"2";"2";"0";"2";"0";"457181";"373894"
"V4mis1";"SILVA (only NR);Eukaryota;Archaeplastida;Chloroplastida;Charophyta;Phragmoplastophyta;Streptophyta;Embryophyta;Tracheophyta;Spermatophyta;Pinophyta;Cupressales;Metasequoia;";"0.0";"0";"1";"1";"0";"1";"0";"457182";"373894"
"V4mis1";"SILVA (only NR);Eukaryota;Archaeplastida;Chloroplastida;Charophyta;Phragmoplastophyta;Streptophyta;Embryophyta;Tracheophyta;Spermatophyta;Pinophyta;Cupressales;Sciadopitys;";"0.0";"0";"1";"1";"0";"1";"0";"457182";"373894"
"V4mis1";"SILVA (only NR);Eukaryota;Archaeplastida;Chloroplastida;Charophyta;Phragmoplastophyta;Streptophyta;Embryophyta;Tracheophyta;Spermatophyta;Pinophyta;Cupressales;Sequoia;";"0.0";"0";"1";"1";"0";"1";"0";"457182";"373894"
"V4mis1";"SILVA (only NR);Eukaryota;Archaeplastida;Chloroplastida;Charophyta;Phragmoplastophyta;Streptophyta;Embryophyta;Tracheophyta;Spermatophyta;Pinophyta;Cupressales;Taiwania;";"0.0";"0";"1";"1";"0";"1";"0";"457182";"373894"
"V4mis1";"SILVA (only NR);Eukaryota;Archaeplastida;Chloroplastida;Charophyta;Phragmoplastophyta;Streptophyta;Embryophyta;Tracheophyta;Spermatophyta;Pinophyta;Cupressales;Taxus;";"0.0";"0";"6";"6";"0";"6";"0";"457177";"373894"
"V4mis1";"SILVA (only NR);Eukaryota;Archaeplastida;Chloroplastida;Charophyta;Phragmoplastophyta;Streptophyta;Embryophyta;Tracheophyta;Spermatophyta;Pinophyta;Pinales;";"0.0";"0";"634";"628";"0";"628";"6";"456555";"373894"
"V4mis1";"SILVA (only NR);Eukaryota;Archaeplastida;Chloroplastida;Charophyta;Phragmoplastophyta;Streptophyta;Embryophyta;Tracheophyta;Spermatophyta;Pinophyta;Pinales;Abies;";"0.0";"0";"1";"1";"0";"1";"0";"457182";"373894"
"V4mis1";"SILVA (only NR);Eukaryota;Archaeplastida;Chloroplastida;Charophyta;Phragmoplastophyta;Streptophyta;Embryophyta;Tracheophyta;Spermatophyta;Pinophyta;Pinales;Cathaya;";"0.0";"0";"1";"1";"0";"1";"0";"457182";"373894"
"V4mis1";"SILVA (only NR);Eukaryota;Archaeplastida;Chloroplastida;Charophyta;Phragmoplastophyta;Streptophyta;Embryophyta;Tracheophyta;Spermatophyta;Pinophyta;Pinales;Cedrus;";"0.0";"0";"2";"2";"0";"2";"0";"457181";"373894"
"V4mis1";"SILVA (only NR);Eukaryota;Archaeplastida;Chloroplastida;Charophyta;Phragmoplastophyta;Streptophyta;Embryophyta;Tracheophyta;Spermatophyta;Pinophyta;Pinales;Nothotsuga;";"0.0";"0";"2";"2";"0";"2";"0";"457181";"373894"
"V4mis1";"SILVA (only NR);Eukaryota;Archaeplastida;Chloroplastida;Charophyta;Phragmoplastophyta;Streptophyta;Embryophyta;Tracheophyta;Spermatophyta;Pinophyta;Pinales;Picea;";"0.0";"0";"79";"79";"0";"79";"0";"457104";"373894"
"V4mis1";"SILVA (only NR);Eukaryota;Archaeplastida;Chloroplastida;Charophyta;Phragmoplastophyta;Streptophyta;Embryophyta;Tracheophyta;Spermatophyta;Pinophyta;Pinales;Pinus;";"0.0";"0";"548";"542";"0";"542";"6";"456641";"373894"
"V4mis1";"SILVA (only NR);Eukaryota;Archaeplastida;Chloroplastida;Charophyta;Phragmoplastophyta;Streptophyta;Embryophyta;Tracheophyta;Spermatophyta;Pinophyta;Pinales;Pseudolarix;";"0.0";"0";"1";"1";"0";"1";"0";"457182";"373894"
"V4mis1";"SILVA (only NR);Eukaryota;Archaeplastida;Chloroplastida;Charophyta;Phragmoplastophyta;Streptophyta;Embryophyta;uncultured;";"0.0";"0";"5";"5";"0";"5";"0";"457178";"373894"
"V4mis1";"SILVA (only NR);Eukaryota;Archaeplastida;Chloroplastida;Charophyta;Phragmoplastophyta;Zygnematophyceae;";"0.0";"0";"170";"170";"0";"170";"0";"457013";"373894"
"V4mis1";"SILVA (only NR);Eukaryota;Archaeplastida;Chloroplastida;Charophyta;Phragmoplastophyta;Zygnematophyceae;Desmidiales;";"0.0";"0";"107";"107";"0";"107";"0";"457076";"373894"
"V4mis1";"SILVA (only NR);Eukaryota;Archaeplastida;Chloroplastida;Charophyta;Phragmoplastophyta;Zygnematophyceae;Desmidiales;Actinotaenium;";"0.0";"0";"5";"5";"0";"5";"0";"457178";"373894"
"V4mis1";"SILVA (only NR);Eukaryota;Archaeplastida;Chloroplastida;Charophyta;Phragmoplastophyta;Zygnematophyceae;Desmidiales;Closterium;";"0.0";"0";"15";"15";"0";"15";"0";"457168";"373894"
"V4mis1";"SILVA (only NR);Eukaryota;Archaeplastida;Chloroplastida;Charophyta;Phragmoplastophyta;Zygnematophyceae;Desmidiales;Cosmarium;";"0.0";"0";"29";"29";"0";"29";"0";"457154";"373894"
"V4mis1";"SILVA (only NR);Eukaryota;Archaeplastida;Chloroplastida;Charophyta;Phragmoplastophyta;Zygnematophyceae;Desmidiales;Cosmocladium;";"0.0";"0";"1";"1";"0";"1";"0";"457182";"373894"
"V4mis1";"SILVA (only NR);Eukaryota;Archaeplastida;Chloroplastida;Charophyta;Phragmoplastophyta;Zygnematophyceae;Desmidiales;Desmidium;";"0.0";"0";"1";"1";"0";"1";"0";"457182";"373894"
"V4mis1";"SILVA (only NR);Eukaryota;Archaeplastida;Chloroplastida;Charophyta;Phragmoplastophyta;Zygnematophyceae;Desmidiales;Euastrum;";"0.0";"0";"6";"6";"0";"6";"0";"457177";"373894"
"V4mis1";"SILVA (only NR);Eukaryota;Archaeplastida;Chloroplastida;Charophyta;Phragmoplastophyta;Zygnematophyceae;Desmidiales;Genicularia;";"0.0";"0";"1";"1";"0";"1";"0";"457182";"373894"
"V4mis1";"SILVA (only NR);Eukaryota;Archaeplastida;Chloroplastida;Charophyta;Phragmoplastophyta;Zygnematophyceae;Desmidiales;Gonatozygon;";"0.0";"0";"5";"5";"0";"5";"0";"457178";"373894"
"V4mis1";"SILVA (only NR);Eukaryota;Archaeplastida;Chloroplastida;Charophyta;Phragmoplastophyta;Zygnematophyceae;Desmidiales;Groenbladia;";"0.0";"0";"1";"1";"0";"1";"0";"457182";"373894"
"V4mis1";"SILVA (only NR);Eukaryota;Archaeplastida;Chloroplastida;Charophyta;Phragmoplastophyta;Zygnematophyceae;Desmidiales;Haplotaenium;";"0.0";"0";"1";"1";"0";"1";"0";"457182";"373894"
"V4mis1";"SILVA (only NR);Eukaryota;Archaeplastida;Chloroplastida;Charophyta;Phragmoplastophyta;Zygnematophyceae;Desmidiales;Hyalotheca;";"0.0";"0";"3";"3";"0";"3";"0";"457180";"373894"
"V4mis1";"SILVA (only NR);Eukaryota;Archaeplastida;Chloroplastida;Charophyta;Phragmoplastophyta;Zygnematophyceae;Desmidiales;Micrasterias;";"0.0";"0";"11";"11";"0";"11";"0";"457172";"373894"
"V4mis1";"SILVA (only NR);Eukaryota;Archaeplastida;Chloroplastida;Charophyta;Phragmoplastophyta;Zygnematophyceae;Desmidiales;Penium;";"0.0";"0";"6";"6";"0";"6";"0";"457177";"373894"
"V4mis1";"SILVA (only NR);Eukaryota;Archaeplastida;Chloroplastida;Charophyta;Phragmoplastophyta;Zygnematophyceae;Desmidiales;Phymatodocis;";"0.0";"0";"1";"1";"0";"1";"0";"457182";"373894"
"V4mis1";"SILVA (only NR);Eukaryota;Archaeplastida;Chloroplastida;Charophyta;Phragmoplastophyta;Zygnematophyceae;Desmidiales;Pleurotaenium;";"0.0";"0";"1";"1";"0";"1";"0";"457182";"373894"
"V4mis1";"SILVA (only NR);Eukaryota;Archaeplastida;Chloroplastida;Charophyta;Phragmoplastophyta;Zygnematophyceae;Desmidiales;Sphaerozosma;";"0.0";"0";"1";"1";"0";"1";"0";"457182";"373894"
"V4mis1";"SILVA (only NR);Eukaryota;Archaeplastida;Chloroplastida;Charophyta;Phragmoplastophyta;Zygnematophyceae;Desmidiales;Spinoclosterium;";"0.0";"0";"1";"1";"0";"1";"0";"457182";"373894"
"V4mis1";"SILVA (only NR);Eukaryota;Archaeplastida;Chloroplastida;Charophyta;Phragmoplastophyta;Zygnematophyceae;Desmidiales;Spondylosium;";"0.0";"0";"3";"3";"0";"3";"0";"457180";"373894"
"V4mis1";"SILVA (only NR);Eukaryota;Archaeplastida;Chloroplastida;Charophyta;Phragmoplastophyta;Zygnematophyceae;Desmidiales;Staurastrum;";"0.0";"0";"6";"6";"0";"6";"0";"457177";"373894"
"V4mis1";"SILVA (only NR);Eukaryota;Archaeplastida;Chloroplastida;Charophyta;Phragmoplastophyta;Zygnematophyceae;Desmidiales;Staurodesmus;";"0.0";"0";"7";"7";"0";"7";"0";"457176";"373894"
"V4mis1";"SILVA (only NR);Eukaryota;Archaeplastida;Chloroplastida;Charophyta;Phragmoplastophyta;Zygnematophyceae;Desmidiales;Tetmemorus;";"0.0";"0";"1";"1";"0";"1";"0";"457182";"373894"
"V4mis1";"SILVA (only NR);Eukaryota;Archaeplastida;Chloroplastida;Charophyta;Phragmoplastophyta;Zygnematophyceae;Desmidiales;Xanthidium;";"0.0";"0";"1";"1";"0";"1";"0";"457182";"373894"
"V4mis1";"SILVA (only NR);Eukaryota;Archaeplastida;Chloroplastida;Charophyta;Phragmoplastophyta;Zygnematophyceae;Mesotaeniaceae;";"0.0";"0";"1";"1";"0";"1";"0";"457182";"373894"
"V4mis1";"SILVA (only NR);Eukaryota;Archaeplastida;Chloroplastida;Charophyta;Phragmoplastophyta;Zygnematophyceae;Zygnematales;";"0.0";"0";"56";"56";"0";"56";"0";"457127";"373894"
"V4mis1";"SILVA (only NR);Eukaryota;Archaeplastida;Chloroplastida;Charophyta;Phragmoplastophyta;Zygnematophyceae;Zygnematales;Ancylonema;";"0.0";"0";"1";"1";"0";"1";"0";"457182";"373894"
"V4mis1";"SILVA (only NR);Eukaryota;Archaeplastida;Chloroplastida;Charophyta;Phragmoplastophyta;Zygnematophyceae;Zygnematales;Cylindrocystis;";"0.0";"0";"5";"5";"0";"5";"0";"457178";"373894"
"V4mis1";"SILVA (only NR);Eukaryota;Archaeplastida;Chloroplastida;Charophyta;Phragmoplastophyta;Zygnematophyceae;Zygnematales;Fottea;";"0.0";"0";"1";"1";"0";"1";"0";"457182";"373894"
"V4mis1";"SILVA (only NR);Eukaryota;Archaeplastida;Chloroplastida;Charophyta;Phragmoplastophyta;Zygnematophyceae;Zygnematales;Mesotaenium;";"0.0";"0";"5";"5";"0";"5";"0";"457178";"373894"
"V4mis1";"SILVA (only NR);Eukaryota;Archaeplastida;Chloroplastida;Charophyta;Phragmoplastophyta;Zygnematophyceae;Zygnematales;Mougeotia;";"0.0";"0";"2";"2";"0";"2";"0";"457181";"373894"
"V4mis1";"SILVA (only NR);Eukaryota;Archaeplastida;Chloroplastida;Charophyta;Phragmoplastophyta;Zygnematophyceae;Zygnematales;Netrium;";"0.0";"0";"3";"3";"0";"3";"0";"457180";"373894"
"V4mis1";"SILVA (only NR);Eukaryota;Archaeplastida;Chloroplastida;Charophyta;Phragmoplastophyta;Zygnematophyceae;Zygnematales;Nucleotaenium;";"0.0";"0";"2";"2";"0";"2";"0";"457181";"373894"
"V4mis1";"SILVA (only NR);Eukaryota;Archaeplastida;Chloroplastida;Charophyta;Phragmoplastophyta;Zygnematophyceae;Zygnematales;Planotaenium;";"0.0";"0";"2";"2";"0";"2";"0";"457181";"373894"
"V4mis1";"SILVA (only NR);Eukaryota;Archaeplastida;Chloroplastida;Charophyta;Phragmoplastophyta;Zygnematophyceae;Zygnematales;Roya;";"0.0";"0";"1";"1";"0";"1";"0";"457182";"373894"
"V4mis1";"SILVA (only NR);Eukaryota;Archaeplastida;Chloroplastida;Charophyta;Phragmoplastophyta;Zygnematophyceae;Zygnematales;Sirogonium;";"0.0";"0";"1";"1";"0";"1";"0";"457182";"373894"
"V4mis1";"SILVA (only NR);Eukaryota;Archaeplastida;Chloroplastida;Charophyta;Phragmoplastophyta;Zygnematophyceae;Zygnematales;Spirogyra;";"0.0";"0";"24";"24";"0";"24";"0";"457159";"373894"
"V4mis1";"SILVA (only NR);Eukaryota;Archaeplastida;Chloroplastida;Charophyta;Phragmoplastophyta;Zygnematophyceae;Zygnematales;Spirotaenia;";"0.0";"0";"1";"1";"0";"1";"0";"457182";"373894"
"V4mis1";"SILVA (only NR);Eukaryota;Archaeplastida;Chloroplastida;Charophyta;Phragmoplastophyta;Zygnematophyceae;Zygnematales;Tortitaenia;";"0.0";"0";"2";"2";"0";"2";"0";"457181";"373894"
"V4mis1";"SILVA (only NR);Eukaryota;Archaeplastida;Chloroplastida;Charophyta;Phragmoplastophyta;Zygnematophyceae;Zygnematales;Zygnema;";"0.0";"0";"4";"4";"0";"4";"0";"457179";"373894"
"V4mis1";"SILVA (only NR);Eukaryota;Archaeplastida;Chloroplastida;Charophyta;Phragmoplastophyta;Zygnematophyceae;Zygnematales;Zygnemopsis;";"0.0";"0";"1";"1";"0";"1";"0";"457182";"373894"
"V4mis1";"SILVA (only NR);Eukaryota;Archaeplastida;Chloroplastida;Charophyta;Phragmoplastophyta;Zygnematophyceae;Zygnematales;Zygogonium;";"0.0";"0";"1";"1";"0";"1";"0";"457182";"373894"
"V4mis1";"SILVA (only NR);Eukaryota;Archaeplastida;Chloroplastida;Chlorophyta;";"0.2";"17.9";"1908";"1874";"4";"1870";"34";"455309";"373890"
"V4mis1";"SILVA (only NR);Eukaryota;Archaeplastida;Chloroplastida;Chlorophyta;Chlorodendrophyceae;";"0.0";"0";"28";"28";"0";"28";"0";"457155";"373894"
"V4mis1";"SILVA (only NR);Eukaryota;Archaeplastida;Chloroplastida;Chlorophyta;Chlorodendrophyceae;Chlorodendrales;";"0.0";"0";"26";"26";"0";"26";"0";"457157";"373894"
"V4mis1";"SILVA (only NR);Eukaryota;Archaeplastida;Chloroplastida;Chlorophyta;Chlorodendrophyceae;Chlorodendrales;Scherffelia;";"0.0";"0";"1";"1";"0";"1";"0";"457182";"373894"
"V4mis1";"SILVA (only NR);Eukaryota;Archaeplastida;Chloroplastida;Chlorophyta;Chlorodendrophyceae;Chlorodendrales;Tetraselmis;";"0.0";"0";"25";"25";"0";"25";"0";"457158";"373894"
"V4mis1";"SILVA (only NR);Eukaryota;Archaeplastida;Chloroplastida;Chlorophyta;Chlorophyceae;";"0.3";"18.1";"783";"781";"2";"779";"2";"456402";"373892"
"V4mis1";"SILVA (only NR);Eukaryota;Archaeplastida;Chloroplastida;Chlorophyta;Chlorophyceae;Chaetopeltidales;";"0.0";"0";"5";"5";"0";"5";"0";"457178";"373894"
"V4mis1";"SILVA (only NR);Eukaryota;Archaeplastida;Chloroplastida;Chlorophyta;Chlorophyceae;Chaetopeltidales;Chaetopeltis;";"0.0";"0";"1";"1";"0";"1";"0";"457182";"373894"
"V4mis1";"SILVA (only NR);Eukaryota;Archaeplastida;Chloroplastida;Chlorophyta;Chlorophyceae;Chaetopeltidales;Dicranochaete;";"0.0";"0";"1";"1";"0";"1";"0";"457182";"373894"
"V4mis1";"SILVA (only NR);Eukaryota;Archaeplastida;Chloroplastida;Chlorophyta;Chlorophyceae;Chaetopeltidales;Floydiella;";"0.0";"0";"1";"1";"0";"1";"0";"457182";"373894"
"V4mis1";"SILVA (only NR);Eukaryota;Archaeplastida;Chloroplastida;Chlorophyta;Chlorophyceae;Chaetopeltidales;Hormotilopsis;";"0.0";"0";"1";"1";"0";"1";"0";"457182";"373894"
"V4mis1";"SILVA (only NR);Eukaryota;Archaeplastida;Chloroplastida;Chlorophyta;Chlorophyceae;Chaetopeltidales;Koshicola;";"0.0";"0";"1";"1";"0";"1";"0";"457182";"373894"
"V4mis1";"SILVA (only NR);Eukaryota;Archaeplastida;Chloroplastida;Chlorophyta;Chlorophyceae;Chaetophorales;";"0.0";"0";"13";"13";"0";"13";"0";"457170";"373894"
"V4mis1";"SILVA (only NR);Eukaryota;Archaeplastida;Chloroplastida;Chlorophyta;Chlorophyceae;Chaetophorales;Aphanochaete;";"0.0";"0";"4";"4";"0";"4";"0";"457179";"373894"
"V4mis1";"SILVA (only NR);Eukaryota;Archaeplastida;Chloroplastida;Chlorophyta;Chlorophyceae;Chaetophorales;Barranca;";"0.0";"0";"1";"1";"0";"1";"0";"457182";"373894"
"V4mis1";"SILVA (only NR);Eukaryota;Archaeplastida;Chloroplastida;Chlorophyta;Chlorophyceae;Chaetophorales;Chaetophora;";"0.0";"0";"3";"3";"0";"3";"0";"457180";"373894"
"V4mis1";"SILVA (only NR);Eukaryota;Archaeplastida;Chloroplastida;Chlorophyta;Chlorophyceae;Chaetophorales;Gloeococcus;";"0.0";"0";"1";"1";"0";"1";"0";"457182";"373894"
"V4mis1";"SILVA (only NR);Eukaryota;Archaeplastida;Chloroplastida;Chlorophyta;Chlorophyceae;Chaetophorales;Schizomeris;";"0.0";"0";"1";"1";"0";"1";"0";"457182";"373894"
"V4mis1";"SILVA (only NR);Eukaryota;Archaeplastida;Chloroplastida;Chlorophyta;Chlorophyceae;Chaetophorales;Stigeoclonium;";"0.0";"0";"3";"3";"0";"3";"0";"457180";"373894"
"V4mis1";"SILVA (only NR);Eukaryota;Archaeplastida;Chloroplastida;Chlorophyta;Chlorophyceae;Chlamydomonadales;";"0.4";"18.2";"275";"275";"1";"274";"0";"456908";"373893"
"V4mis1";"SILVA (only NR);Eukaryota;Archaeplastida;Chloroplastida;Chlorophyta;Chlorophyceae;Chlamydomonadales;Actinochloris;";"0.0";"0";"2";"2";"0";"2";"0";"457181";"373894"
"V4mis1";"SILVA (only NR);Eukaryota;Archaeplastida;Chloroplastida;Chlorophyta;Chlorophyceae;Chlamydomonadales;Ascochloris;";"0.0";"0";"1";"1";"0";"1";"0";"457182";"373894"
"V4mis1";"SILVA (only NR);Eukaryota;Archaeplastida;Chloroplastida;Chlorophyta;Chlorophyceae;Chlamydomonadales;Asteromonas;";"0.0";"0";"1";"1";"0";"1";"0";"457182";"373894"
"V4mis1";"SILVA (only NR);Eukaryota;Archaeplastida;Chloroplastida;Chlorophyta;Chlorophyceae;Chlamydomonadales;Astrephomene;";"0.0";"0";"2";"2";"0";"2";"0";"457181";"373894"
"V4mis1";"SILVA (only NR);Eukaryota;Archaeplastida;Chloroplastida;Chlorophyta;Chlorophyceae;Chlamydomonadales;Axilosphaera;";"0.0";"0";"1";"1";"0";"1";"0";"457182";"373894"
"V4mis1";"SILVA (only NR);Eukaryota;Archaeplastida;Chloroplastida;Chlorophyta;Chlorophyceae;Chlamydomonadales;Basichlamys;";"0.0";"0";"1";"1";"0";"1";"0";"457182";"373894"
"V4mis1";"SILVA (only NR);Eukaryota;Archaeplastida;Chloroplastida;Chlorophyta;Chlorophyceae;Chlamydomonadales;Brachiomonas;";"0.0";"0";"1";"1";"0";"1";"0";"457182";"373894"
"V4mis1";"SILVA (only NR);Eukaryota;Archaeplastida;Chloroplastida;Chlorophyta;Chlorophyceae;Chlamydomonadales;Cephalomonas;";"0.0";"0";"1";"1";"0";"1";"0";"457182";"373894"
"V4mis1";"SILVA (only NR);Eukaryota;Archaeplastida;Chloroplastida;Chlorophyta;Chlorophyceae;Chlamydomonadales;Characiochloris;";"0.0";"0";"2";"2";"0";"2";"0";"457181";"373894"
"V4mis1";"SILVA (only NR);Eukaryota;Archaeplastida;Chloroplastida;Chlorophyta;Chlorophyceae;Chlamydomonadales;Characium;";"0.0";"0";"3";"3";"0";"3";"0";"457180";"373894"
"V4mis1";"SILVA (only NR);Eukaryota;Archaeplastida;Chloroplastida;Chlorophyta;Chlorophyceae;Chlamydomonadales;Chlamydomonas;";"0.0";"0";"84";"84";"0";"84";"0";"457099";"373894"
"V4mis1";"SILVA (only NR);Eukaryota;Archaeplastida;Chloroplastida;Chlorophyta;Chlorophyceae;Chlamydomonadales;Chlorococcum;";"0.0";"0";"20";"20";"0";"20";"0";"457163";"373894"
"V4mis1";"SILVA (only NR);Eukaryota;Archaeplastida;Chloroplastida;Chlorophyta;Chlorophyceae;Chlamydomonadales;Chlorogonium;";"0.0";"0";"1";"1";"0";"1";"0";"457182";"373894"
"V4mis1";"SILVA (only NR);Eukaryota;Archaeplastida;Chloroplastida;Chlorophyta;Chlorophyceae;Chlamydomonadales;Chloromonas;";"0.0";"0";"26";"26";"0";"26";"0";"457157";"373894"
"V4mis1";"SILVA (only NR);Eukaryota;Archaeplastida;Chloroplastida;Chlorophyta;Chlorophyceae;Chlamydomonadales;Colemanosphaera;";"0.0";"0";"1";"1";"0";"1";"0";"457182";"373894"
"V4mis1";"SILVA (only NR);Eukaryota;Archaeplastida;Chloroplastida;Chlorophyta;Chlorophyceae;Chlamydomonadales;Cylindrocapsa;";"0.0";"0";"2";"2";"0";"2";"0";"457181";"373894"
"V4mis1";"SILVA (only NR);Eukaryota;Archaeplastida;Chloroplastida;Chlorophyta;Chlorophyceae;Chlamydomonadales;Deasonia;";"0.0";"0";"2";"2";"0";"2";"0";"457181";"373894"
"V4mis1";"SILVA (only NR);Eukaryota;Archaeplastida;Chloroplastida;Chlorophyta;Chlorophyceae;Chlamydomonadales;Dunaliella;";"0.0";"0";"21";"21";"0";"21";"0";"457162";"373894"
"V4mis1";"SILVA (only NR);Eukaryota;Archaeplastida;Chloroplastida;Chlorophyta;Chlorophyceae;Chlamydomonadales;Dysmorphococcus;";"50.0";"18.2";"2";"2";"1";"1";"0";"457181";"373893"
"V4mis1";"SILVA (only NR);Eukaryota;Archaeplastida;Chloroplastida;Chlorophyta;Chlorophyceae;Chlamydomonadales;Ettlia;";"0.0";"0";"2";"2";"0";"2";"0";"457181";"373894"
"V4mis1";"SILVA (only NR);Eukaryota;Archaeplastida;Chloroplastida;Chlorophyta;Chlorophyceae;Chlamydomonadales;Eudorina;";"0.0";"0";"3";"3";"0";"3";"0";"457180";"373894"
"V4mis1";"SILVA (only NR);Eukaryota;Archaeplastida;Chloroplastida;Chlorophyta;Chlorophyceae;Chlamydomonadales;Gloeomonas;";"0.0";"0";"2";"2";"0";"2";"0";"457181";"373894"
"V4mis1";"SILVA (only NR);Eukaryota;Archaeplastida;Chloroplastida;Chlorophyta;Chlorophyceae;Chlamydomonadales;Golenkinia;";"0.0";"0";"3";"3";"0";"3";"0";"457180";"373894"
"V4mis1";"SILVA (only NR);Eukaryota;Archaeplastida;Chloroplastida;Chlorophyta;Chlorophyceae;Chlamydomonadales;Gonium;";"0.0";"0";"4";"4";"0";"4";"0";"457179";"373894"
"V4mis1";"SILVA (only NR);Eukaryota;Archaeplastida;Chloroplastida;Chlorophyta;Chlorophyceae;Chlamydomonadales;Gungnir;";"0.0";"0";"2";"2";"0";"2";"0";"457181";"373894"
"V4mis1";"SILVA (only NR);Eukaryota;Archaeplastida;Chloroplastida;Chlorophyta;Chlorophyceae;Chlamydomonadales;Haematococcus;";"0.0";"0";"1";"1";"0";"1";"0";"457182";"373894"
"V4mis1";"SILVA (only NR);Eukaryota;Archaeplastida;Chloroplastida;Chlorophyta;Chlorophyceae;Chlamydomonadales;Hafniomonas;";"0.0";"0";"3";"3";"0";"3";"0";"457180";"373894"
"V4mis1";"SILVA (only NR);Eukaryota;Archaeplastida;Chloroplastida;Chlorophyta;Chlorophyceae;Chlamydomonadales;Halosarcinochlamys;";"0.0";"0";"1";"1";"0";"1";"0";"457182";"373894"
"V4mis1";"SILVA (only NR);Eukaryota;Archaeplastida;Chloroplastida;Chlorophyta;Chlorophyceae;Chlamydomonadales;Hapalochloris;";"0.0";"0";"1";"1";"0";"1";"0";"457182";"373894"
"V4mis1";"SILVA (only NR);Eukaryota;Archaeplastida;Chloroplastida;Chlorophyta;Chlorophyceae;Chlamydomonadales;Hemiflagellochloris;";"0.0";"0";"1";"1";"0";"1";"0";"457182";"373894"
"V4mis1";"SILVA (only NR);Eukaryota;Archaeplastida;Chloroplastida;Chlorophyta;Chlorophyceae;Chlamydomonadales;Heterochlamydomonas;";"0.0";"0";"1";"1";"0";"1";"0";"457182";"373894"
"V4mis1";"SILVA (only NR);Eukaryota;Archaeplastida;Chloroplastida;Chlorophyta;Chlorophyceae;Chlamydomonadales;Heterotetracystis;";"0.0";"0";"1";"1";"0";"1";"0";"457182";"373894"
"V4mis1";"SILVA (only NR);Eukaryota;Archaeplastida;Chloroplastida;Chlorophyta;Chlorophyceae;Chlamydomonadales;Lobochlamys;";"0.0";"0";"6";"6";"0";"6";"0";"457177";"373894"
"V4mis1";"SILVA (only NR);Eukaryota;Archaeplastida;Chloroplastida;Chlorophyta;Chlorophyceae;Chlamydomonadales;Lobomonas;";"0.0";"0";"2";"2";"0";"2";"0";"457181";"373894"
"V4mis1";"SILVA (only NR);Eukaryota;Archaeplastida;Chloroplastida;Chlorophyta;Chlorophyceae;Chlamydomonadales;Microglena;";"0.0";"0";"6";"6";"0";"6";"0";"457177";"373894"
"V4mis1";"SILVA (only NR);Eukaryota;Archaeplastida;Chloroplastida;Chlorophyta;Chlorophyceae;Chlamydomonadales;Neospongiococcum;";"0.0";"0";"2";"2";"0";"2";"0";"457181";"373894"
"V4mis1";"SILVA (only NR);Eukaryota;Archaeplastida;Chloroplastida;Chlorophyta;Chlorophyceae;Chlamydomonadales;Oogamochlamys;";"0.0";"0";"3";"3";"0";"3";"0";"457180";"373894"
"V4mis1";"SILVA (only NR);Eukaryota;Archaeplastida;Chloroplastida;Chlorophyta;Chlorophyceae;Chlamydomonadales;Oophila;";"0.0";"0";"5";"5";"0";"5";"0";"457178";"373894"
"V4mis1";"SILVA (only NR);Eukaryota;Archaeplastida;Chloroplastida;Chlorophyta;Chlorophyceae;Chlamydomonadales;Pachycladella;";"0.0";"0";"1";"1";"0";"1";"0";"457182";"373894"
"V4mis1";"SILVA (only NR);Eukaryota;Archaeplastida;Chloroplastida;Chlorophyta;Chlorophyceae;Chlamydomonadales;Pandorina;";"0.0";"0";"4";"4";"0";"4";"0";"457179";"373894"
"V4mis1";"SILVA (only NR);Eukaryota;Archaeplastida;Chloroplastida;Chlorophyta;Chlorophyceae;Chlamydomonadales;Pascherina;";"0.0";"0";"1";"1";"0";"1";"0";"457182";"373894"
"V4mis1";"SILVA (only NR);Eukaryota;Archaeplastida;Chloroplastida;Chlorophyta;Chlorophyceae;Chlamydomonadales;Phacotus;";"0.0";"0";"2";"2";"0";"2";"0";"457181";"373894"
"V4mis1";"SILVA (only NR);Eukaryota;Archaeplastida;Chloroplastida;Chlorophyta;Chlorophyceae;Chlamydomonadales;Pleodorina;";"0.0";"0";"1";"1";"0";"1";"0";"457182";"373894"
"V4mis1";"SILVA (only NR);Eukaryota;Archaeplastida;Chloroplastida;Chlorophyta;Chlorophyceae;Chlamydomonadales;Polytoma;";"0.0";"0";"2";"2";"0";"2";"0";"457181";"373894"
"V4mis1";"SILVA (only NR);Eukaryota;Archaeplastida;Chloroplastida;Chlorophyta;Chlorophyceae;Chlamydomonadales;Polytomella;";"0.0";"0";"4";"4";"0";"4";"0";"457179";"373894"
"V4mis1";"SILVA (only NR);Eukaryota;Archaeplastida;Chloroplastida;Chlorophyta;Chlorophyceae;Chlamydomonadales;Protosiphon;";"0.0";"0";"2";"2";"0";"2";"0";"457181";"373894"
"V4mis1";"SILVA (only NR);Eukaryota;Archaeplastida;Chloroplastida;Chlorophyta;Chlorophyceae;Chlamydomonadales;Pteromonas;";"0.0";"0";"1";"1";"0";"1";"0";"457182";"373894"
"V4mis1";"SILVA (only NR);Eukaryota;Archaeplastida;Chloroplastida;Chlorophyta;Chlorophyceae;Chlamydomonadales;Pyrobotrys;";"0.0";"0";"2";"2";"0";"2";"0";"457181";"373894"
"V4mis1";"SILVA (only NR);Eukaryota;Archaeplastida;Chloroplastida;Chlorophyta;Chlorophyceae;Chlamydomonadales;Radiosphaera;";"0.0";"0";"1";"1";"0";"1";"0";"457182";"373894"
"V4mis1";"SILVA (only NR);Eukaryota;Archaeplastida;Chloroplastida;Chlorophyta;Chlorophyceae;Chlamydomonadales;Rhysamphichloris;";"0.0";"0";"1";"1";"0";"1";"0";"457182";"373894"
"V4mis1";"SILVA (only NR);Eukaryota;Archaeplastida;Chloroplastida;Chlorophyta;Chlorophyceae;Chlamydomonadales;Rusalka;";"0.0";"0";"1";"1";"0";"1";"0";"457182";"373894"
"V4mis1";"SILVA (only NR);Eukaryota;Archaeplastida;Chloroplastida;Chlorophyta;Chlorophyceae;Chlamydomonadales;Spongiochloris;";"0.0";"0";"2";"2";"0";"2";"0";"457181";"373894"
"V4mis1";"SILVA (only NR);Eukaryota;Archaeplastida;Chloroplastida;Chlorophyta;Chlorophyceae;Chlamydomonadales;Stephanosphaera;";"0.0";"0";"1";"1";"0";"1";"0";"457182";"373894"
"V4mis1";"SILVA (only NR);Eukaryota;Archaeplastida;Chloroplastida;Chlorophyta;Chlorophyceae;Chlamydomonadales;Tetrabaena;";"0.0";"0";"1";"1";"0";"1";"0";"457182";"373894"
"V4mis1";"SILVA (only NR);Eukaryota;Archaeplastida;Chloroplastida;Chlorophyta;Chlorophyceae;Chlamydomonadales;Tetracystis;";"0.0";"0";"11";"11";"0";"11";"0";"457172";"373894"
"V4mis1";"SILVA (only NR);Eukaryota;Archaeplastida;Chloroplastida;Chlorophyta;Chlorophyceae;Chlamydomonadales;Vitreochlamys;";"0.0";"0";"6";"6";"0";"6";"0";"457177";"373894"
"V4mis1";"SILVA (only NR);Eukaryota;Archaeplastida;Chloroplastida;Chlorophyta;Chlorophyceae;Chlamydomonadales;Volvox;";"0.0";"0";"5";"5";"0";"5";"0";"457178";"373894"
"V4mis1";"SILVA (only NR);Eukaryota;Archaeplastida;Chloroplastida;Chlorophyta;Chlorophyceae;Chlamydomonadales;Volvulina;";"0.0";"0";"3";"3";"0";"3";"0";"457180";"373894"
"V4mis1";"SILVA (only NR);Eukaryota;Archaeplastida;Chloroplastida;Chlorophyta;Chlorophyceae;Chlorosarcinales;";"0.0";"0";"18";"18";"0";"18";"0";"457165";"373894"
"V4mis1";"SILVA (only NR);Eukaryota;Archaeplastida;Chloroplastida;Chlorophyta;Chlorophyceae;Chlorosarcinales;Chlorosarcina;";"0.0";"0";"3";"3";"0";"3";"0";"457180";"373894"
"V4mis1";"SILVA (only NR);Eukaryota;Archaeplastida;Chloroplastida;Chlorophyta;Chlorophyceae;Chlorosarcinales;Chlorosarcinopsis;";"0.0";"0";"9";"9";"0";"9";"0";"457174";"373894"
"V4mis1";"SILVA (only NR);Eukaryota;Archaeplastida;Chloroplastida;Chlorophyta;Chlorophyceae;Chlorosarcinales;Neochlorosarcina;";"0.0";"0";"6";"6";"0";"6";"0";"457177";"373894"
"V4mis1";"SILVA (only NR);Eukaryota;Archaeplastida;Chloroplastida;Chlorophyta;Chlorophyceae;Incertae Sedis;";"0.0";"0";"26";"26";"0";"26";"0";"457157";"373894"
"V4mis1";"SILVA (only NR);Eukaryota;Archaeplastida;Chloroplastida;Chlorophyta;Chlorophyceae;Incertae Sedis;Botryococcus;";"0.0";"0";"1";"1";"0";"1";"0";"457182";"373894"
"V4mis1";"SILVA (only NR);Eukaryota;Archaeplastida;Chloroplastida;Chlorophyta;Chlorophyceae;Incertae Sedis;Carteria;";"0.0";"0";"8";"8";"0";"8";"0";"457175";"373894"
"V4mis1";"SILVA (only NR);Eukaryota;Archaeplastida;Chloroplastida;Chlorophyta;Chlorophyceae;Incertae Sedis;Chlamydopodium;";"0.0";"0";"3";"3";"0";"3";"0";"457180";"373894"
"V4mis1";"SILVA (only NR);Eukaryota;Archaeplastida;Chloroplastida;Chlorophyta;Chlorophyceae;Incertae Sedis;Chlorochytrium;";"0.0";"0";"2";"2";"0";"2";"0";"457181";"373894"
"V4mis1";"SILVA (only NR);Eukaryota;Archaeplastida;Chloroplastida;Chlorophyta;Chlorophyceae;Incertae Sedis;Jenufa;";"0.0";"0";"3";"3";"0";"3";"0";"457180";"373894"
"V4mis1";"SILVA (only NR);Eukaryota;Archaeplastida;Chloroplastida;Chlorophyta;Chlorophyceae;Incertae Sedis;Nautococcus;";"0.0";"0";"1";"1";"0";"1";"0";"457182";"373894"
"V4mis1";"SILVA (only NR);Eukaryota;Archaeplastida;Chloroplastida;Chlorophyta;Chlorophyceae;Incertae Sedis;Pleurastrum;";"0.0";"0";"1";"1";"0";"1";"0";"457182";"373894"
"V4mis1";"SILVA (only NR);Eukaryota;Archaeplastida;Chloroplastida;Chlorophyta;Chlorophyceae;Incertae Sedis;Spermatozopsis;";"0.0";"0";"1";"1";"0";"1";"0";"457182";"373894"
"V4mis1";"SILVA (only NR);Eukaryota;Archaeplastida;Chloroplastida;Chlorophyta;Chlorophyceae;Incertae Sedis;Tetraflagellochloris;";"0.0";"0";"1";"1";"0";"1";"0";"457182";"373894"
"V4mis1";"SILVA (only NR);Eukaryota;Archaeplastida;Chloroplastida;Chlorophyta;Chlorophyceae;Oedogoniales;";"0.0";"0";"16";"16";"0";"16";"0";"457167";"373894"
"V4mis1";"SILVA (only NR);Eukaryota;Archaeplastida;Chloroplastida;Chlorophyta;Chlorophyceae;Oedogoniales;Bulbochaete;";"0.0";"0";"1";"1";"0";"1";"0";"457182";"373894"
"V4mis1";"SILVA (only NR);Eukaryota;Archaeplastida;Chloroplastida;Chlorophyta;Chlorophyceae;Oedogoniales;Oedocladium;";"0.0";"0";"2";"2";"0";"2";"0";"457181";"373894"
"V4mis1";"SILVA (only NR);Eukaryota;Archaeplastida;Chloroplastida;Chlorophyta;Chlorophyceae;Oedogoniales;Oedogonium;";"0.0";"0";"13";"13";"0";"13";"0";"457170";"373894"
"V4mis1";"SILVA (only NR);Eukaryota;Archaeplastida;Chloroplastida;Chlorophyta;Chlorophyceae;Sphaeropleales;";"0.6";"18.2";"180";"179";"1";"178";"1";"457004";"373893"
"V4mis1";"SILVA (only NR);Eukaryota;Archaeplastida;Chloroplastida;Chlorophyta;Chlorophyceae;Sphaeropleales;Acutodesmus;";"0.0";"0";"2";"2";"0";"2";"0";"457181";"373894"
"V4mis1";"SILVA (only NR);Eukaryota;Archaeplastida;Chloroplastida;Chlorophyta;Chlorophyceae;Sphaeropleales;Ankistrodesmus;";"0.0";"0";"7";"7";"0";"7";"0";"457176";"373894"
"V4mis1";"SILVA (only NR);Eukaryota;Archaeplastida;Chloroplastida;Chlorophyta;Chlorophyceae;Sphaeropleales;Ankyra;";"0.0";"0";"1";"1";"0";"1";"0";"457182";"373894"
"V4mis1";"SILVA (only NR);Eukaryota;Archaeplastida;Chloroplastida;Chlorophyta;Chlorophyceae;Sphaeropleales;Asterarcys;";"0.0";"0";"1";"1";"0";"1";"0";"457182";"373894"
"V4mis1";"SILVA (only NR);Eukaryota;Archaeplastida;Chloroplastida;Chlorophyta;Chlorophyceae;Sphaeropleales;Auctodesmus;";"0.0";"0";"1";"1";"0";"1";"0";"457182";"373894"
"V4mis1";"SILVA (only NR);Eukaryota;Archaeplastida;Chloroplastida;Chlorophyta;Chlorophyceae;Sphaeropleales;Bracteacoccus;";"0.0";"0";"15";"15";"0";"15";"0";"457168";"373894"
"V4mis1";"SILVA (only NR);Eukaryota;Archaeplastida;Chloroplastida;Chlorophyta;Chlorophyceae;Sphaeropleales;Characiopodium;";"0.0";"0";"2";"2";"0";"2";"0";"457181";"373894"
"V4mis1";"SILVA (only NR);Eukaryota;Archaeplastida;Chloroplastida;Chlorophyta;Chlorophyceae;Sphaeropleales;Chlorolobion;";"0.0";"0";"2";"2";"0";"2";"0";"457181";"373894"
"V4mis1";"SILVA (only NR);Eukaryota;Archaeplastida;Chloroplastida;Chlorophyta;Chlorophyceae;Sphaeropleales;Chlorotetraedron;";"0.0";"0";"1";"1";"0";"1";"0";"457182";"373894"
"V4mis1";"SILVA (only NR);Eukaryota;Archaeplastida;Chloroplastida;Chlorophyta;Chlorophyceae;Sphaeropleales;Chromochloris;";"0.0";"0";"1";"1";"0";"1";"0";"457182";"373894"
"V4mis1";"SILVA (only NR);Eukaryota;Archaeplastida;Chloroplastida;Chlorophyta;Chlorophyceae;Sphaeropleales;Coelastrella;";"0.0";"0";"11";"11";"0";"11";"0";"457172";"373894"
"V4mis1";"SILVA (only NR);Eukaryota;Archaeplastida;Chloroplastida;Chlorophyta;Chlorophyceae;Sphaeropleales;Coelastrum;";"0.0";"0";"2";"2";"0";"2";"0";"457181";"373894"
"V4mis1";"SILVA (only NR);Eukaryota;Archaeplastida;Chloroplastida;Chlorophyta;Chlorophyceae;Sphaeropleales;Crucigenia;";"0.0";"0";"1";"1";"0";"1";"0";"457182";"373894"
"V4mis1";"SILVA (only NR);Eukaryota;Archaeplastida;Chloroplastida;Chlorophyta;Chlorophyceae;Sphaeropleales;Desmodesmus;";"0.0";"0";"17";"16";"0";"16";"1";"457167";"373894"
"V4mis1";"SILVA (only NR);Eukaryota;Archaeplastida;Chloroplastida;Chlorophyta;Chlorophyceae;Sphaeropleales;Dictyochloris;";"0.0";"0";"1";"1";"0";"1";"0";"457182";"373894"
"V4mis1";"SILVA (only NR);Eukaryota;Archaeplastida;Chloroplastida;Chlorophyta;Chlorophyceae;Sphaeropleales;Dictyococcus;";"0.0";"0";"7";"7";"0";"7";"0";"457176";"373894"
"V4mis1";"SILVA (only NR);Eukaryota;Archaeplastida;Chloroplastida;Chlorophyta;Chlorophyceae;Sphaeropleales;Dimorphococcus;";"0.0";"0";"1";"1";"0";"1";"0";"457182";"373894"
"V4mis1";"SILVA (only NR);Eukaryota;Archaeplastida;Chloroplastida;Chlorophyta;Chlorophyceae;Sphaeropleales;Hylodesmus;";"0.0";"0";"1";"1";"0";"1";"0";"457182";"373894"
"V4mis1";"SILVA (only NR);Eukaryota;Archaeplastida;Chloroplastida;Chlorophyta;Chlorophyceae;Sphaeropleales;Kirchneriella;";"0.0";"0";"1";"1";"0";"1";"0";"457182";"373894"
"V4mis1";"SILVA (only NR);Eukaryota;Archaeplastida;Chloroplastida;Chlorophyta;Chlorophyceae;Sphaeropleales;Lacunastrum;";"0.0";"0";"1";"1";"0";"1";"0";"457182";"373894"
"V4mis1";"SILVA (only NR);Eukaryota;Archaeplastida;Chloroplastida;Chlorophyta;Chlorophyceae;Sphaeropleales;Messastrum;";"0.0";"0";"2";"2";"0";"2";"0";"457181";"373894"
"V4mis1";"SILVA (only NR);Eukaryota;Archaeplastida;Chloroplastida;Chlorophyta;Chlorophyceae;Sphaeropleales;Monactinus;";"0.0";"0";"2";"2";"0";"2";"0";"457181";"373894"
"V4mis1";"SILVA (only NR);Eukaryota;Archaeplastida;Chloroplastida;Chlorophyta;Chlorophyceae;Sphaeropleales;Monoraphidium;";"4.3";"18.2";"23";"23";"1";"22";"0";"457160";"373893"
"V4mis1";"SILVA (only NR);Eukaryota;Archaeplastida;Chloroplastida;Chlorophyta;Chlorophyceae;Sphaeropleales;Mychonastes;";"0.0";"0";"9";"9";"0";"9";"0";"457174";"373894"
"V4mis1";"SILVA (only NR);Eukaryota;Archaeplastida;Chloroplastida;Chlorophyta;Chlorophyceae;Sphaeropleales;Neochloris;";"0.0";"0";"3";"3";"0";"3";"0";"457180";"373894"
"V4mis1";"SILVA (only NR);Eukaryota;Archaeplastida;Chloroplastida;Chlorophyta;Chlorophyceae;Sphaeropleales;Neodesmus;";"0.0";"0";"1";"1";"0";"1";"0";"457182";"373894"
"V4mis1";"SILVA (only NR);Eukaryota;Archaeplastida;Chloroplastida;Chlorophyta;Chlorophyceae;Sphaeropleales;Ourococcus;";"0.0";"0";"1";"1";"0";"1";"0";"457182";"373894"
"V4mis1";"SILVA (only NR);Eukaryota;Archaeplastida;Chloroplastida;Chlorophyta;Chlorophyceae;Sphaeropleales;Parapediastrum;";"0.0";"0";"1";"1";"0";"1";"0";"457182";"373894"
"V4mis1";"SILVA (only NR);Eukaryota;Archaeplastida;Chloroplastida;Chlorophyta;Chlorophyceae;Sphaeropleales;Pectinodesmus;";"0.0";"0";"2";"2";"0";"2";"0";"457181";"373894"
"V4mis1";"SILVA (only NR);Eukaryota;Archaeplastida;Chloroplastida;Chlorophyta;Chlorophyceae;Sphaeropleales;Pectodictyon;";"0.0";"0";"1";"1";"0";"1";"0";"457182";"373894"
"V4mis1";"SILVA (only NR);Eukaryota;Archaeplastida;Chloroplastida;Chlorophyta;Chlorophyceae;Sphaeropleales;Pediastrum;";"0.0";"0";"2";"2";"0";"2";"0";"457181";"373894"
"V4mis1";"SILVA (only NR);Eukaryota;Archaeplastida;Chloroplastida;Chlorophyta;Chlorophyceae;Sphaeropleales;Planktosphaeria;";"0.0";"0";"1";"1";"0";"1";"0";"457182";"373894"
"V4mis1";"SILVA (only NR);Eukaryota;Archaeplastida;Chloroplastida;Chlorophyta;Chlorophyceae;Sphaeropleales;Polyedriopsis;";"0.0";"0";"2";"2";"0";"2";"0";"457181";"373894"
"V4mis1";"SILVA (only NR);Eukaryota;Archaeplastida;Chloroplastida;Chlorophyta;Chlorophyceae;Sphaeropleales;Protodesmus;";"0.0";"0";"1";"1";"0";"1";"0";"457182";"373894"
"V4mis1";"SILVA (only NR);Eukaryota;Archaeplastida;Chloroplastida;Chlorophyta;Chlorophyceae;Sphaeropleales;Pseudomuriella;";"0.0";"0";"4";"4";"0";"4";"0";"457179";"373894"
"V4mis1";"SILVA (only NR);Eukaryota;Archaeplastida;Chloroplastida;Chlorophyta;Chlorophyceae;Sphaeropleales;Pseudopediastrum;";"0.0";"0";"5";"5";"0";"5";"0";"457178";"373894"
"V4mis1";"SILVA (only NR);Eukaryota;Archaeplastida;Chloroplastida;Chlorophyta;Chlorophyceae;Sphaeropleales;Pseudoschroederia;";"0.0";"0";"1";"1";"0";"1";"0";"457182";"373894"
"V4mis1";"SILVA (only NR);Eukaryota;Archaeplastida;Chloroplastida;Chlorophyta;Chlorophyceae;Sphaeropleales;Quadrigula;";"0.0";"0";"1";"1";"0";"1";"0";"457182";"373894"
"V4mis1";"SILVA (only NR);Eukaryota;Archaeplastida;Chloroplastida;Chlorophyta;Chlorophyceae;Sphaeropleales;Radiococcus;";"0.0";"0";"3";"3";"0";"3";"0";"457180";"373894"
"V4mis1";"SILVA (only NR);Eukaryota;Archaeplastida;Chloroplastida;Chlorophyta;Chlorophyceae;Sphaeropleales;Raphidocelis;";"0.0";"0";"1";"1";"0";"1";"0";"457182";"373894"
"V4mis1";"SILVA (only NR);Eukaryota;Archaeplastida;Chloroplastida;Chlorophyta;Chlorophyceae;Sphaeropleales;Rhombocystis;";"0.0";"0";"1";"1";"0";"1";"0";"457182";"373894"
"V4mis1";"SILVA (only NR);Eukaryota;Archaeplastida;Chloroplastida;Chlorophyta;Chlorophyceae;Sphaeropleales;Rotundella;";"0.0";"0";"1";"1";"0";"1";"0";"457182";"373894"
"V4mis1";"SILVA (only NR);Eukaryota;Archaeplastida;Chloroplastida;Chlorophyta;Chlorophyceae;Sphaeropleales;Scenedesmus;";"0.0";"0";"22";"22";"0";"22";"0";"457161";"373894"
"V4mis1";"SILVA (only NR);Eukaryota;Archaeplastida;Chloroplastida;Chlorophyta;Chlorophyceae;Sphaeropleales;Selenastrum;";"0.0";"0";"2";"2";"0";"2";"0";"457181";"373894"
"V4mis1";"SILVA (only NR);Eukaryota;Archaeplastida;Chloroplastida;Chlorophyta;Chlorophyceae;Sphaeropleales;Stauridium;";"0.0";"0";"1";"1";"0";"1";"0";"457182";"373894"
"V4mis1";"SILVA (only NR);Eukaryota;Archaeplastida;Chloroplastida;Chlorophyta;Chlorophyceae;Sphaeropleales;Tetradesmus;";"0.0";"0";"3";"3";"0";"3";"0";"457180";"373894"
"V4mis1";"SILVA (only NR);Eukaryota;Archaeplastida;Chloroplastida;Chlorophyta;Chlorophyceae;Sphaeropleales;Tetraedron;";"0.0";"0";"2";"2";"0";"2";"0";"457181";"373894"
"V4mis1";"SILVA (only NR);Eukaryota;Archaeplastida;Chloroplastida;Chlorophyta;Chlorophyceae;Sphaeropleales;Tetranephris;";"0.0";"0";"3";"3";"0";"3";"0";"457180";"373894"
"V4mis1";"SILVA (only NR);Eukaryota;Archaeplastida;Chloroplastida;Chlorophyta;Chlorophyceae;Sphaeropleales;Tumidella;";"0.0";"0";"1";"1";"0";"1";"0";"457182";"373894"
"V4mis1";"SILVA (only NR);Eukaryota;Archaeplastida;Chloroplastida;Chlorophyta;Chlorophyceae;Sphaeropleales;Verrucodesmus;";"0.0";"0";"1";"1";"0";"1";"0";"457182";"373894"
"V4mis1";"SILVA (only NR);Eukaryota;Archaeplastida;Chloroplastida;Chlorophyta;Chlorophyceae;Sphaeropleales;Westella;";"0.0";"0";"1";"1";"0";"1";"0";"457182";"373894"
"V4mis1";"SILVA (only NR);Eukaryota;Archaeplastida;Chloroplastida;Chlorophyta;Chlorophyceae;Tetrasporales;";"0.0";"0";"3";"3";"0";"3";"0";"457180";"373894"
"V4mis1";"SILVA (only NR);Eukaryota;Archaeplastida;Chloroplastida;Chlorophyta;Chlorophyceae;Tetrasporales;Asterococcus;";"0.0";"0";"1";"1";"0";"1";"0";"457182";"373894"
"V4mis1";"SILVA (only NR);Eukaryota;Archaeplastida;Chloroplastida;Chlorophyta;Chlorophyceae;Tetrasporales;Fritschiella;";"0.0";"0";"1";"1";"0";"1";"0";"457182";"373894"
"V4mis1";"SILVA (only NR);Eukaryota;Archaeplastida;Chloroplastida;Chlorophyta;Chlorophyceae;Tetrasporales;Paulschulzia;";"0.0";"0";"1";"1";"0";"1";"0";"457182";"373894"
"V4mis1";"SILVA (only NR);Eukaryota;Archaeplastida;Chloroplastida;Chlorophyta;Clade IX;";"0.0";"0";"31";"31";"0";"31";"0";"457152";"373894"
"V4mis1";"SILVA (only NR);Eukaryota;Archaeplastida;Chloroplastida;Chlorophyta;Clade VII;";"0.0";"0";"38";"37";"0";"37";"1";"457146";"373894"
"V4mis1";"SILVA (only NR);Eukaryota;Archaeplastida;Chloroplastida;Chlorophyta;Clade VII;Subclade A;";"0.0";"0";"26";"25";"0";"25";"1";"457158";"373894"
"V4mis1";"SILVA (only NR);Eukaryota;Archaeplastida;Chloroplastida;Chlorophyta;Clade VII;Subclade B;";"0.0";"0";"12";"12";"0";"12";"0";"457171";"373894"
"V4mis1";"SILVA (only NR);Eukaryota;Archaeplastida;Chloroplastida;Chlorophyta;Incertae Sedis;";"0.0";"0";"2";"2";"0";"2";"0";"457181";"373894"
"V4mis1";"SILVA (only NR);Eukaryota;Archaeplastida;Chloroplastida;Chlorophyta;Incertae Sedis;Picocystis;";"0.0";"0";"2";"2";"0";"2";"0";"457181";"373894"
"V4mis1";"SILVA (only NR);Eukaryota;Archaeplastida;Chloroplastida;Chlorophyta;Mamiellophyceae;";"0.0";"0";"140";"139";"0";"139";"1";"457044";"373894"
"V4mis1";"SILVA (only NR);Eukaryota;Archaeplastida;Chloroplastida;Chlorophyta;Mamiellophyceae;DSGM-81;";"0.0";"0";"4";"4";"0";"4";"0";"457179";"373894"
"V4mis1";"SILVA (only NR);Eukaryota;Archaeplastida;Chloroplastida;Chlorophyta;Mamiellophyceae;Dolichomastigales;";"0.0";"0";"7";"7";"0";"7";"0";"457176";"373894"
"V4mis1";"SILVA (only NR);Eukaryota;Archaeplastida;Chloroplastida;Chlorophyta;Mamiellophyceae;Dolichomastigales;Crustomastix;";"0.0";"0";"7";"7";"0";"7";"0";"457176";"373894"
"V4mis1";"SILVA (only NR);Eukaryota;Archaeplastida;Chloroplastida;Chlorophyta;Mamiellophyceae;Dolichomastix;";"0.0";"0";"3";"3";"0";"3";"0";"457180";"373894"
"V4mis1";"SILVA (only NR);Eukaryota;Archaeplastida;Chloroplastida;Chlorophyta;Mamiellophyceae;Mamiellales;";"0.0";"0";"109";"108";"0";"108";"1";"457075";"373894"
"V4mis1";"SILVA (only NR);Eukaryota;Archaeplastida;Chloroplastida;Chlorophyta;Mamiellophyceae;Mamiellales;Bathycoccus;";"0.0";"0";"24";"24";"0";"24";"0";"457159";"373894"
"V4mis1";"SILVA (only NR);Eukaryota;Archaeplastida;Chloroplastida;Chlorophyta;Mamiellophyceae;Mamiellales;Mamiella;";"0.0";"0";"4";"4";"0";"4";"0";"457179";"373894"
"V4mis1";"SILVA (only NR);Eukaryota;Archaeplastida;Chloroplastida;Chlorophyta;Mamiellophyceae;Mamiellales;Mantoniella;";"0.0";"0";"1";"1";"0";"1";"0";"457182";"373894"
"V4mis1";"SILVA (only NR);Eukaryota;Archaeplastida;Chloroplastida;Chlorophyta;Mamiellophyceae;Mamiellales;Micromonas;";"0.0";"0";"62";"62";"0";"62";"0";"457121";"373894"
"V4mis1";"SILVA (only NR);Eukaryota;Archaeplastida;Chloroplastida;Chlorophyta;Mamiellophyceae;Mamiellales;Ostreococcus;";"0.0";"0";"18";"17";"0";"17";"1";"457166";"373894"
"V4mis1";"SILVA (only NR);Eukaryota;Archaeplastida;Chloroplastida;Chlorophyta;Mamiellophyceae;Monomastigales;";"0.0";"0";"3";"3";"0";"3";"0";"457180";"373894"
"V4mis1";"SILVA (only NR);Eukaryota;Archaeplastida;Chloroplastida;Chlorophyta;Mamiellophyceae;Monomastigales;Monomastix;";"0.0";"0";"3";"3";"0";"3";"0";"457180";"373894"
"V4mis1";"SILVA (only NR);Eukaryota;Archaeplastida;Chloroplastida;Chlorophyta;Mamiellophyceae;uncultured;";"0.0";"0";"3";"3";"0";"3";"0";"457180";"373894"
"V4mis1";"SILVA (only NR);Eukaryota;Archaeplastida;Chloroplastida;Chlorophyta;Nephroselmidophyceae;";"0.0";"0";"16";"16";"0";"16";"0";"457167";"373894"
"V4mis1";"SILVA (only NR);Eukaryota;Archaeplastida;Chloroplastida;Chlorophyta;Nephroselmidophyceae;Nephroselmidales;";"0.0";"0";"16";"16";"0";"16";"0";"457167";"373894"
"V4mis1";"SILVA (only NR);Eukaryota;Archaeplastida;Chloroplastida;Chlorophyta;Nephroselmidophyceae;Nephroselmidales;Nephroselmis;";"0.0";"0";"16";"16";"0";"16";"0";"457167";"373894"
"V4mis1";"SILVA (only NR);Eukaryota;Archaeplastida;Chloroplastida;Chlorophyta;Palmophyllophyceae;";"0.0";"0";"2";"2";"0";"2";"0";"457181";"373894"
"V4mis1";"SILVA (only NR);Eukaryota;Archaeplastida;Chloroplastida;Chlorophyta;Palmophyllophyceae;Palmophyllales;";"0.0";"0";"2";"2";"0";"2";"0";"457181";"373894"
"V4mis1";"SILVA (only NR);Eukaryota;Archaeplastida;Chloroplastida;Chlorophyta;Palmophyllophyceae;Palmophyllales;Palmophyllum;";"0.0";"0";"1";"1";"0";"1";"0";"457182";"373894"
"V4mis1";"SILVA (only NR);Eukaryota;Archaeplastida;Chloroplastida;Chlorophyta;Palmophyllophyceae;Palmophyllales;Verdigellas;";"0.0";"0";"1";"1";"0";"1";"0";"457182";"373894"
"V4mis1";"SILVA (only NR);Eukaryota;Archaeplastida;Chloroplastida;Chlorophyta;Pedinophyceae;";"0.0";"0";"9";"9";"0";"9";"0";"457174";"373894"
"V4mis1";"SILVA (only NR);Eukaryota;Archaeplastida;Chloroplastida;Chlorophyta;Pedinophyceae;Pedinomonadales;";"0.0";"0";"9";"9";"0";"9";"0";"457174";"373894"
"V4mis1";"SILVA (only NR);Eukaryota;Archaeplastida;Chloroplastida;Chlorophyta;Pedinophyceae;Pedinomonadales;Pedinomonas;";"0.0";"0";"9";"9";"0";"9";"0";"457174";"373894"
"V4mis1";"SILVA (only NR);Eukaryota;Archaeplastida;Chloroplastida;Chlorophyta;Prasinophytae;";"0.0";"0";"56";"56";"0";"56";"0";"457127";"373894"
"V4mis1";"SILVA (only NR);Eukaryota;Archaeplastida;Chloroplastida;Chlorophyta;Prasinophytae;Prasinococcales;";"0.0";"0";"5";"5";"0";"5";"0";"457178";"373894"
"V4mis1";"SILVA (only NR);Eukaryota;Archaeplastida;Chloroplastida;Chlorophyta;Prasinophytae;Prasinococcales;Prasinococcus;";"0.0";"0";"5";"5";"0";"5";"0";"457178";"373894"
"V4mis1";"SILVA (only NR);Eukaryota;Archaeplastida;Chloroplastida;Chlorophyta;Prasinophytae;Pseudoscourfieldiales;";"0.0";"0";"11";"11";"0";"11";"0";"457172";"373894"
"V4mis1";"SILVA (only NR);Eukaryota;Archaeplastida;Chloroplastida;Chlorophyta;Prasinophytae;Pseudoscourfieldiales;Prasinoderma;";"0.0";"0";"9";"9";"0";"9";"0";"457174";"373894"
"V4mis1";"SILVA (only NR);Eukaryota;Archaeplastida;Chloroplastida;Chlorophyta;Prasinophytae;Pseudoscourfieldiales;Pycnococcus;";"0.0";"0";"2";"2";"0";"2";"0";"457181";"373894"
"V4mis1";"SILVA (only NR);Eukaryota;Archaeplastida;Chloroplastida;Chlorophyta;Prasinophytae;Pyramimonadales;";"0.0";"0";"26";"26";"0";"26";"0";"457157";"373894"
"V4mis1";"SILVA (only NR);Eukaryota;Archaeplastida;Chloroplastida;Chlorophyta;Prasinophytae;Pyramimonadales;Cymbomonas;";"0.0";"0";"1";"1";"0";"1";"0";"457182";"373894"
"V4mis1";"SILVA (only NR);Eukaryota;Archaeplastida;Chloroplastida;Chlorophyta;Prasinophytae;Pyramimonadales;Prasinopapilla;";"0.0";"0";"1";"1";"0";"1";"0";"457182";"373894"
"V4mis1";"SILVA (only NR);Eukaryota;Archaeplastida;Chloroplastida;Chlorophyta;Prasinophytae;Pyramimonadales;Pterosperma;";"0.0";"0";"5";"5";"0";"5";"0";"457178";"373894"
"V4mis1";"SILVA (only NR);Eukaryota;Archaeplastida;Chloroplastida;Chlorophyta;Prasinophytae;Pyramimonadales;Pyramimonas;";"0.0";"0";"19";"19";"0";"19";"0";"457164";"373894"
"V4mis1";"SILVA (only NR);Eukaryota;Archaeplastida;Chloroplastida;Chlorophyta;Prasinophytae;shizugawa;";"0.0";"0";"3";"3";"0";"3";"0";"457180";"373894"
"V4mis1";"SILVA (only NR);Eukaryota;Archaeplastida;Chloroplastida;Chlorophyta;Trebouxiophyceae;";"0.0";"0";"440";"435";"0";"435";"5";"456748";"373894"
"V4mis1";"SILVA (only NR);Eukaryota;Archaeplastida;Chloroplastida;Chlorophyta;Trebouxiophyceae;Chlorellales;";"0.0";"0";"131";"130";"0";"130";"1";"457053";"373894"
"V4mis1";"SILVA (only NR);Eukaryota;Archaeplastida;Chloroplastida;Chlorophyta;Trebouxiophyceae;Chlorellales;Auxenochlorella;";"0.0";"0";"2";"2";"0";"2";"0";"457181";"373894"
"V4mis1";"SILVA (only NR);Eukaryota;Archaeplastida;Chloroplastida;Chlorophyta;Trebouxiophyceae;Chlorellales;Chlorella;";"0.0";"0";"47";"47";"0";"47";"0";"457136";"373894"
"V4mis1";"SILVA (only NR);Eukaryota;Archaeplastida;Chloroplastida;Chlorophyta;Trebouxiophyceae;Chlorellales;Chloroidium;";"0.0";"0";"10";"9";"0";"9";"1";"457174";"373894"
"V4mis1";"SILVA (only NR);Eukaryota;Archaeplastida;Chloroplastida;Chlorophyta;Trebouxiophyceae;Chlorellales;Didymogenes;";"0.0";"0";"2";"2";"0";"2";"0";"457181";"373894"
"V4mis1";"SILVA (only NR);Eukaryota;Archaeplastida;Chloroplastida;Chlorophyta;Trebouxiophyceae;Chlorellales;Echinocoleum;";"0.0";"0";"1";"1";"0";"1";"0";"457182";"373894"
"V4mis1";"SILVA (only NR);Eukaryota;Archaeplastida;Chloroplastida;Chlorophyta;Trebouxiophyceae;Chlorellales;Elongatocystis;";"0.0";"0";"1";"1";"0";"1";"0";"457182";"373894"
"V4mis1";"SILVA (only NR);Eukaryota;Archaeplastida;Chloroplastida;Chlorophyta;Trebouxiophyceae;Chlorellales;Eremosphaera;";"0.0";"0";"2";"2";"0";"2";"0";"457181";"373894"
"V4mis1";"SILVA (only NR);Eukaryota;Archaeplastida;Chloroplastida;Chlorophyta;Trebouxiophyceae;Chlorellales;Franceia;";"0.0";"0";"2";"2";"0";"2";"0";"457181";"373894"
"V4mis1";"SILVA (only NR);Eukaryota;Archaeplastida;Chloroplastida;Chlorophyta;Trebouxiophyceae;Chlorellales;Hemichloris;";"0.0";"0";"2";"2";"0";"2";"0";"457181";"373894"
"V4mis1";"SILVA (only NR);Eukaryota;Archaeplastida;Chloroplastida;Chlorophyta;Trebouxiophyceae;Chlorellales;Heveochlorella;";"0.0";"0";"1";"1";"0";"1";"0";"457182";"373894"
"V4mis1";"SILVA (only NR);Eukaryota;Archaeplastida;Chloroplastida;Chlorophyta;Trebouxiophyceae;Chlorellales;Lagerheimia;";"0.0";"0";"6";"6";"0";"6";"0";"457177";"373894"
"V4mis1";"SILVA (only NR);Eukaryota;Archaeplastida;Chloroplastida;Chlorophyta;Trebouxiophyceae;Chlorellales;Makinoella;";"0.0";"0";"2";"2";"0";"2";"0";"457181";"373894"
"V4mis1";"SILVA (only NR);Eukaryota;Archaeplastida;Chloroplastida;Chlorophyta;Trebouxiophyceae;Chlorellales;Marvania;";"0.0";"0";"1";"1";"0";"1";"0";"457182";"373894"
"V4mis1";"SILVA (only NR);Eukaryota;Archaeplastida;Chloroplastida;Chlorophyta;Trebouxiophyceae;Chlorellales;Micractinium;";"0.0";"0";"10";"10";"0";"10";"0";"457173";"373894"
"V4mis1";"SILVA (only NR);Eukaryota;Archaeplastida;Chloroplastida;Chlorophyta;Trebouxiophyceae;Chlorellales;Nannochloris;";"0.0";"0";"6";"6";"0";"6";"0";"457177";"373894"
"V4mis1";"SILVA (only NR);Eukaryota;Archaeplastida;Chloroplastida;Chlorophyta;Trebouxiophyceae;Chlorellales;Neglectella;";"0.0";"0";"2";"2";"0";"2";"0";"457181";"373894"
"V4mis1";"SILVA (only NR);Eukaryota;Archaeplastida;Chloroplastida;Chlorophyta;Trebouxiophyceae;Chlorellales;Oocystella;";"0.0";"0";"5";"5";"0";"5";"0";"457178";"373894"
"V4mis1";"SILVA (only NR);Eukaryota;Archaeplastida;Chloroplastida;Chlorophyta;Trebouxiophyceae;Chlorellales;Oocystis;";"0.0";"0";"8";"8";"0";"8";"0";"457175";"373894"
"V4mis1";"SILVA (only NR);Eukaryota;Archaeplastida;Chloroplastida;Chlorophyta;Trebouxiophyceae;Chlorellales;Parachlorella;";"0.0";"0";"4";"4";"0";"4";"0";"457179";"373894"
"V4mis1";"SILVA (only NR);Eukaryota;Archaeplastida;Chloroplastida;Chlorophyta;Trebouxiophyceae;Chlorellales;Prototheca;";"0.0";"0";"10";"10";"0";"10";"0";"457173";"373894"
"V4mis1";"SILVA (only NR);Eukaryota;Archaeplastida;Chloroplastida;Chlorophyta;Trebouxiophyceae;Chlorellales;Quadricoccus;";"0.0";"0";"1";"1";"0";"1";"0";"457182";"373894"
"V4mis1";"SILVA (only NR);Eukaryota;Archaeplastida;Chloroplastida;Chlorophyta;Trebouxiophyceae;Chlorellales;Tetrachlorella;";"0.0";"0";"1";"1";"0";"1";"0";"457182";"373894"
"V4mis1";"SILVA (only NR);Eukaryota;Archaeplastida;Chloroplastida;Chlorophyta;Trebouxiophyceae;Chlorellales;Tetrastrum;";"0.0";"0";"3";"3";"0";"3";"0";"457180";"373894"
"V4mis1";"SILVA (only NR);Eukaryota;Archaeplastida;Chloroplastida;Chlorophyta;Trebouxiophyceae;Chlorellales;Viridiella;";"0.0";"0";"1";"1";"0";"1";"0";"457182";"373894"
"V4mis1";"SILVA (only NR);Eukaryota;Archaeplastida;Chloroplastida;Chlorophyta;Trebouxiophyceae;Ctenocladales;";"0.0";"0";"1";"1";"0";"1";"0";"457182";"373894"
"V4mis1";"SILVA (only NR);Eukaryota;Archaeplastida;Chloroplastida;Chlorophyta;Trebouxiophyceae;Ctenocladales;Leptosira;";"0.0";"0";"1";"1";"0";"1";"0";"457182";"373894"
"V4mis1";"SILVA (only NR);Eukaryota;Archaeplastida;Chloroplastida;Chlorophyta;Trebouxiophyceae;Incertae Sedis;";"0.0";"0";"94";"94";"0";"94";"0";"457089";"373894"
"V4mis1";"SILVA (only NR);Eukaryota;Archaeplastida;Chloroplastida;Chlorophyta;Trebouxiophyceae;Incertae Sedis;Actinastrum;";"0.0";"0";"2";"2";"0";"2";"0";"457181";"373894"
"V4mis1";"SILVA (only NR);Eukaryota;Archaeplastida;Chloroplastida;Chlorophyta;Trebouxiophyceae;Incertae Sedis;Botryococcus;";"0.0";"0";"16";"16";"0";"16";"0";"457167";"373894"
"V4mis1";"SILVA (only NR);Eukaryota;Archaeplastida;Chloroplastida;Chlorophyta;Trebouxiophyceae;Incertae Sedis;Chloroparva;";"0.0";"0";"2";"2";"0";"2";"0";"457181";"373894"
"V4mis1";"SILVA (only NR);Eukaryota;Archaeplastida;Chloroplastida;Chlorophyta;Trebouxiophyceae;Incertae Sedis;Chloropyrula;";"0.0";"0";"1";"1";"0";"1";"0";"457182";"373894"
"V4mis1";"SILVA (only NR);Eukaryota;Archaeplastida;Chloroplastida;Chlorophyta;Trebouxiophyceae;Incertae Sedis;Chlorosphaera;";"0.0";"0";"1";"1";"0";"1";"0";"457182";"373894"
"V4mis1";"SILVA (only NR);Eukaryota;Archaeplastida;Chloroplastida;Chlorophyta;Trebouxiophyceae;Incertae Sedis;Choricystis;";"0.0";"0";"2";"2";"0";"2";"0";"457181";"373894"
"V4mis1";"SILVA (only NR);Eukaryota;Archaeplastida;Chloroplastida;Chlorophyta;Trebouxiophyceae;Incertae Sedis;Coccomyxa;";"0.0";"0";"20";"20";"0";"20";"0";"457163";"373894"
"V4mis1";"SILVA (only NR);Eukaryota;Archaeplastida;Chloroplastida;Chlorophyta;Trebouxiophyceae;Incertae Sedis;Coenocystis;";"0.0";"0";"1";"1";"0";"1";"0";"457182";"373894"
"V4mis1";"SILVA (only NR);Eukaryota;Archaeplastida;Chloroplastida;Chlorophyta;Trebouxiophyceae;Incertae Sedis;Dictyosphaerium;";"0.0";"0";"8";"8";"0";"8";"0";"457175";"373894"
"V4mis1";"SILVA (only NR);Eukaryota;Archaeplastida;Chloroplastida;Chlorophyta;Trebouxiophyceae;Incertae Sedis;Gloeotila;";"0.0";"0";"2";"2";"0";"2";"0";"457181";"373894"
"V4mis1";"SILVA (only NR);Eukaryota;Archaeplastida;Chloroplastida;Chlorophyta;Trebouxiophyceae;Incertae Sedis;Heterochlorella;";"0.0";"0";"6";"6";"0";"6";"0";"457177";"373894"
"V4mis1";"SILVA (only NR);Eukaryota;Archaeplastida;Chloroplastida;Chlorophyta;Trebouxiophyceae;Incertae Sedis;Hindakia;";"0.0";"0";"1";"1";"0";"1";"0";"457182";"373894"
"V4mis1";"SILVA (only NR);Eukaryota;Archaeplastida;Chloroplastida;Chlorophyta;Trebouxiophyceae;Incertae Sedis;Kalinella;";"0.0";"0";"2";"2";"0";"2";"0";"457181";"373894"
"V4mis1";"SILVA (only NR);Eukaryota;Archaeplastida;Chloroplastida;Chlorophyta;Trebouxiophyceae;Incertae Sedis;Lemmermannia;";"0.0";"0";"4";"4";"0";"4";"0";"457179";"373894"
"V4mis1";"SILVA (only NR);Eukaryota;Archaeplastida;Chloroplastida;Chlorophyta;Trebouxiophyceae;Incertae Sedis;Leptochlorella;";"0.0";"0";"2";"2";"0";"2";"0";"457181";"373894"
"V4mis1";"SILVA (only NR);Eukaryota;Archaeplastida;Chloroplastida;Chlorophyta;Trebouxiophyceae;Incertae Sedis;Mucidosphaerium;";"0.0";"0";"2";"2";"0";"2";"0";"457181";"373894"
"V4mis1";"SILVA (only NR);Eukaryota;Archaeplastida;Chloroplastida;Chlorophyta;Trebouxiophyceae;Incertae Sedis;Muriella;";"0.0";"0";"1";"1";"0";"1";"0";"457182";"373894"
"V4mis1";"SILVA (only NR);Eukaryota;Archaeplastida;Chloroplastida;Chlorophyta;Trebouxiophyceae;Incertae Sedis;Mysteriochloris;";"0.0";"0";"1";"1";"0";"1";"0";"457182";"373894"
"V4mis1";"SILVA (only NR);Eukaryota;Archaeplastida;Chloroplastida;Chlorophyta;Trebouxiophyceae;Incertae Sedis;Neocystis;";"0.0";"0";"1";"1";"0";"1";"0";"457182";"373894"
"V4mis1";"SILVA (only NR);Eukaryota;Archaeplastida;Chloroplastida;Chlorophyta;Trebouxiophyceae;Incertae Sedis;Parachloroidium;";"0.0";"0";"1";"1";"0";"1";"0";"457182";"373894"
"V4mis1";"SILVA (only NR);Eukaryota;Archaeplastida;Chloroplastida;Chlorophyta;Trebouxiophyceae;Incertae Sedis;Parietochloris;";"0.0";"0";"1";"1";"0";"1";"0";"457182";"373894"
"V4mis1";"SILVA (only NR);Eukaryota;Archaeplastida;Chloroplastida;Chlorophyta;Trebouxiophyceae;Incertae Sedis;Picochlorum;";"0.0";"0";"13";"13";"0";"13";"0";"457170";"373894"
"V4mis1";"SILVA (only NR);Eukaryota;Archaeplastida;Chloroplastida;Chlorophyta;Trebouxiophyceae;Incertae Sedis;Pseudostichococcus;";"0.0";"0";"1";"1";"0";"1";"0";"457182";"373894"
"V4mis1";"SILVA (only NR);Eukaryota;Archaeplastida;Chloroplastida;Chlorophyta;Trebouxiophyceae;Incertae Sedis;Watanabea;";"0.0";"0";"1";"1";"0";"1";"0";"457182";"373894"
"V4mis1";"SILVA (only NR);Eukaryota;Archaeplastida;Chloroplastida;Chlorophyta;Trebouxiophyceae;Incertae Sedis;Xylochloris;";"0.0";"0";"2";"2";"0";"2";"0";"457181";"373894"
"V4mis1";"SILVA (only NR);Eukaryota;Archaeplastida;Chloroplastida;Chlorophyta;Trebouxiophyceae;Microthamniales;";"0.0";"0";"12";"12";"0";"12";"0";"457171";"373894"
"V4mis1";"SILVA (only NR);Eukaryota;Archaeplastida;Chloroplastida;Chlorophyta;Trebouxiophyceae;Microthamniales;Asterochloris;";"0.0";"0";"1";"1";"0";"1";"0";"457182";"373894"
"V4mis1";"SILVA (only NR);Eukaryota;Archaeplastida;Chloroplastida;Chlorophyta;Trebouxiophyceae;Microthamniales;Dictyochloropsis;";"0.0";"0";"3";"3";"0";"3";"0";"457180";"373894"
"V4mis1";"SILVA (only NR);Eukaryota;Archaeplastida;Chloroplastida;Chlorophyta;Trebouxiophyceae;Microthamniales;Elliptochloris;";"0.0";"0";"4";"4";"0";"4";"0";"457179";"373894"
"V4mis1";"SILVA (only NR);Eukaryota;Archaeplastida;Chloroplastida;Chlorophyta;Trebouxiophyceae;Microthamniales;Microthamnion;";"0.0";"0";"2";"2";"0";"2";"0";"457181";"373894"
"V4mis1";"SILVA (only NR);Eukaryota;Archaeplastida;Chloroplastida;Chlorophyta;Trebouxiophyceae;Microthamniales;Pseudomarvania;";"0.0";"0";"2";"2";"0";"2";"0";"457181";"373894"
"V4mis1";"SILVA (only NR);Eukaryota;Archaeplastida;Chloroplastida;Chlorophyta;Trebouxiophyceae;Prasiolales;";"0.0";"0";"26";"26";"0";"26";"0";"457157";"373894"
"V4mis1";"SILVA (only NR);Eukaryota;Archaeplastida;Chloroplastida;Chlorophyta;Trebouxiophyceae;Prasiolales;Desmococcus;";"0.0";"0";"1";"1";"0";"1";"0";"457182";"373894"
"V4mis1";"SILVA (only NR);Eukaryota;Archaeplastida;Chloroplastida;Chlorophyta;Trebouxiophyceae;Prasiolales;Koliella;";"0.0";"0";"4";"4";"0";"4";"0";"457179";"373894"
"V4mis1";"SILVA (only NR);Eukaryota;Archaeplastida;Chloroplastida;Chlorophyta;Trebouxiophyceae;Prasiolales;Pabia;";"0.0";"0";"1";"1";"0";"1";"0";"457182";"373894"
"V4mis1";"SILVA (only NR);Eukaryota;Archaeplastida;Chloroplastida;Chlorophyta;Trebouxiophyceae;Prasiolales;Prasiola;";"0.0";"0";"7";"7";"0";"7";"0";"457176";"373894"
"V4mis1";"SILVA (only NR);Eukaryota;Archaeplastida;Chloroplastida;Chlorophyta;Trebouxiophyceae;Prasiolales;Prasiolopsis;";"0.0";"0";"1";"1";"0";"1";"0";"457182";"373894"
"V4mis1";"SILVA (only NR);Eukaryota;Archaeplastida;Chloroplastida;Chlorophyta;Trebouxiophyceae;Prasiolales;Stichococcus;";"0.0";"0";"12";"12";"0";"12";"0";"457171";"373894"
"V4mis1";"SILVA (only NR);Eukaryota;Archaeplastida;Chloroplastida;Chlorophyta;Trebouxiophyceae;Trebouxiales;";"0.0";"0";"7";"7";"0";"7";"0";"457176";"373894"
"V4mis1";"SILVA (only NR);Eukaryota;Archaeplastida;Chloroplastida;Chlorophyta;Trebouxiophyceae;Trebouxiales;Myrmecia;";"0.0";"0";"3";"3";"0";"3";"0";"457180";"373894"
"V4mis1";"SILVA (only NR);Eukaryota;Archaeplastida;Chloroplastida;Chlorophyta;Trebouxiophyceae;Trebouxiales;Trebouxia;";"0.0";"0";"4";"4";"0";"4";"0";"457179";"373894"
"V4mis1";"SILVA (only NR);Eukaryota;Archaeplastida;Chloroplastida;Chlorophyta;Ulvophyceae;";"0.6";"18.2";"356";"331";"2";"329";"25";"456852";"373892"
"V4mis1";"SILVA (only NR);Eukaryota;Archaeplastida;Chloroplastida;Chlorophyta;Ulvophyceae;Bryopsidales;";"0.0";"0";"30";"7";"0";"7";"23";"457176";"373894"
"V4mis1";"SILVA (only NR);Eukaryota;Archaeplastida;Chloroplastida;Chlorophyta;Ulvophyceae;Bryopsidales;Bryopsis;";"0.0";"0";"1";"1";"0";"1";"0";"457182";"373894"
"V4mis1";"SILVA (only NR);Eukaryota;Archaeplastida;Chloroplastida;Chlorophyta;Ulvophyceae;Bryopsidales;Caulerpa;";"0.0";"0";"6";"6";"0";"6";"0";"457177";"373894"
"V4mis1";"SILVA (only NR);Eukaryota;Archaeplastida;Chloroplastida;Chlorophyta;Ulvophyceae;Bryopsidales;Chlorodesmis;";"0.0";"0";"2";"0";"0";"0";"2";"457183";"373894"
"V4mis1";"SILVA (only NR);Eukaryota;Archaeplastida;Chloroplastida;Chlorophyta;Ulvophyceae;Bryopsidales;Flabellia;";"0.0";"0";"1";"0";"0";"0";"1";"457183";"373894"
"V4mis1";"SILVA (only NR);Eukaryota;Archaeplastida;Chloroplastida;Chlorophyta;Ulvophyceae;Bryopsidales;Halimeda;";"0.0";"0";"12";"0";"0";"0";"12";"457183";"373894"
"V4mis1";"SILVA (only NR);Eukaryota;Archaeplastida;Chloroplastida;Chlorophyta;Ulvophyceae;Bryopsidales;Penicillus;";"0.0";"0";"2";"0";"0";"0";"2";"457183";"373894"
"V4mis1";"SILVA (only NR);Eukaryota;Archaeplastida;Chloroplastida;Chlorophyta;Ulvophyceae;Bryopsidales;Udotea;";"0.0";"0";"6";"0";"0";"0";"6";"457183";"373894"
"V4mis1";"SILVA (only NR);Eukaryota;Archaeplastida;Chloroplastida;Chlorophyta;Ulvophyceae;Chlorocystidales;";"0.0";"0";"2";"2";"0";"2";"0";"457181";"373894"
"V4mis1";"SILVA (only NR);Eukaryota;Archaeplastida;Chloroplastida;Chlorophyta;Ulvophyceae;Chlorocystidales;Desmochloris;";"0.0";"0";"2";"2";"0";"2";"0";"457181";"373894"
"V4mis1";"SILVA (only NR);Eukaryota;Archaeplastida;Chloroplastida;Chlorophyta;Ulvophyceae;Cladophorales;";"0.0";"0";"73";"73";"0";"73";"0";"457110";"373894"
"V4mis1";"SILVA (only NR);Eukaryota;Archaeplastida;Chloroplastida;Chlorophyta;Ulvophyceae;Cladophorales;Aegagropila;";"0.0";"0";"1";"1";"0";"1";"0";"457182";"373894"
"V4mis1";"SILVA (only NR);Eukaryota;Archaeplastida;Chloroplastida;Chlorophyta;Ulvophyceae;Cladophorales;Aegagropilopsis;";"0.0";"0";"4";"4";"0";"4";"0";"457179";"373894"
"V4mis1";"SILVA (only NR);Eukaryota;Archaeplastida;Chloroplastida;Chlorophyta;Ulvophyceae;Cladophorales;Arnoldiella;";"0.0";"0";"2";"2";"0";"2";"0";"457181";"373894"
"V4mis1";"SILVA (only NR);Eukaryota;Archaeplastida;Chloroplastida;Chlorophyta;Ulvophyceae;Cladophorales;Boergesenia;";"0.0";"0";"3";"3";"0";"3";"0";"457180";"373894"
"V4mis1";"SILVA (only NR);Eukaryota;Archaeplastida;Chloroplastida;Chlorophyta;Ulvophyceae;Cladophorales;Chaetomorpha;";"0.0";"0";"14";"14";"0";"14";"0";"457169";"373894"
"V4mis1";"SILVA (only NR);Eukaryota;Archaeplastida;Chloroplastida;Chlorophyta;Ulvophyceae;Cladophorales;Chamaedoris;";"0.0";"0";"1";"1";"0";"1";"0";"457182";"373894"
"V4mis1";"SILVA (only NR);Eukaryota;Archaeplastida;Chloroplastida;Chlorophyta;Ulvophyceae;Cladophorales;Cladophora;";"0.0";"0";"17";"17";"0";"17";"0";"457166";"373894"
"V4mis1";"SILVA (only NR);Eukaryota;Archaeplastida;Chloroplastida;Chlorophyta;Ulvophyceae;Cladophorales;Cladophoropsis;";"0.0";"0";"2";"2";"0";"2";"0";"457181";"373894"
"V4mis1";"SILVA (only NR);Eukaryota;Archaeplastida;Chloroplastida;Chlorophyta;Ulvophyceae;Cladophorales;Dictyosphaeria;";"0.0";"0";"1";"1";"0";"1";"0";"457182";"373894"
"V4mis1";"SILVA (only NR);Eukaryota;Archaeplastida;Chloroplastida;Chlorophyta;Ulvophyceae;Cladophorales;Ernodesmis;";"0.0";"0";"2";"2";"0";"2";"0";"457181";"373894"
"V4mis1";"SILVA (only NR);Eukaryota;Archaeplastida;Chloroplastida;Chlorophyta;Ulvophyceae;Cladophorales;Phyllodictyon;";"0.0";"0";"1";"1";"0";"1";"0";"457182";"373894"
"V4mis1";"SILVA (only NR);Eukaryota;Archaeplastida;Chloroplastida;Chlorophyta;Ulvophyceae;Cladophorales;Pseudocladophora;";"0.0";"0";"1";"1";"0";"1";"0";"457182";"373894"
"V4mis1";"SILVA (only NR);Eukaryota;Archaeplastida;Chloroplastida;Chlorophyta;Ulvophyceae;Cladophorales;Rhizoclonium;";"0.0";"0";"10";"10";"0";"10";"0";"457173";"373894"
"V4mis1";"SILVA (only NR);Eukaryota;Archaeplastida;Chloroplastida;Chlorophyta;Ulvophyceae;Cladophorales;Siphonocladus;";"0.0";"0";"1";"1";"0";"1";"0";"457182";"373894"
"V4mis1";"SILVA (only NR);Eukaryota;Archaeplastida;Chloroplastida;Chlorophyta;Ulvophyceae;Cladophorales;Spongiochrysis;";"0.0";"0";"1";"1";"0";"1";"0";"457182";"373894"
"V4mis1";"SILVA (only NR);Eukaryota;Archaeplastida;Chloroplastida;Chlorophyta;Ulvophyceae;Cladophorales;Valonia;";"0.0";"0";"8";"8";"0";"8";"0";"457175";"373894"
"V4mis1";"SILVA (only NR);Eukaryota;Archaeplastida;Chloroplastida;Chlorophyta;Ulvophyceae;Cladophorales;Valoniopsis;";"0.0";"0";"1";"1";"0";"1";"0";"457182";"373894"
"V4mis1";"SILVA (only NR);Eukaryota;Archaeplastida;Chloroplastida;Chlorophyta;Ulvophyceae;Cladophorales;Ventricaria;";"0.0";"0";"1";"1";"0";"1";"0";"457182";"373894"
"V4mis1";"SILVA (only NR);Eukaryota;Archaeplastida;Chloroplastida;Chlorophyta;Ulvophyceae;Cladophorales;Wittrockiella;";"0.0";"0";"2";"2";"0";"2";"0";"457181";"373894"
"V4mis1";"SILVA (only NR);Eukaryota;Archaeplastida;Chloroplastida;Chlorophyta;Ulvophyceae;Dasycladales;";"0.0";"0";"20";"20";"0";"20";"0";"457163";"373894"
"V4mis1";"SILVA (only NR);Eukaryota;Archaeplastida;Chloroplastida;Chlorophyta;Ulvophyceae;Dasycladales;Acetabularia;";"0.0";"0";"10";"10";"0";"10";"0";"457173";"373894"
"V4mis1";"SILVA (only NR);Eukaryota;Archaeplastida;Chloroplastida;Chlorophyta;Ulvophyceae;Dasycladales;Batophora;";"0.0";"0";"1";"1";"0";"1";"0";"457182";"373894"
"V4mis1";"SILVA (only NR);Eukaryota;Archaeplastida;Chloroplastida;Chlorophyta;Ulvophyceae;Dasycladales;Bornetella;";"0.0";"0";"1";"1";"0";"1";"0";"457182";"373894"
"V4mis1";"SILVA (only NR);Eukaryota;Archaeplastida;Chloroplastida;Chlorophyta;Ulvophyceae;Dasycladales;Chalmasia;";"0.0";"0";"1";"1";"0";"1";"0";"457182";"373894"
"V4mis1";"SILVA (only NR);Eukaryota;Archaeplastida;Chloroplastida;Chlorophyta;Ulvophyceae;Dasycladales;Cymopolia;";"0.0";"0";"1";"1";"0";"1";"0";"457182";"373894"
"V4mis1";"SILVA (only NR);Eukaryota;Archaeplastida;Chloroplastida;Chlorophyta;Ulvophyceae;Dasycladales;Neomeris;";"0.0";"0";"1";"1";"0";"1";"0";"457182";"373894"
"V4mis1";"SILVA (only NR);Eukaryota;Archaeplastida;Chloroplastida;Chlorophyta;Ulvophyceae;Dasycladales;Parvocaulis;";"0.0";"0";"5";"5";"0";"5";"0";"457178";"373894"
"V4mis1";"SILVA (only NR);Eukaryota;Archaeplastida;Chloroplastida;Chlorophyta;Ulvophyceae;Incertae Sedis;";"0.0";"0";"2";"2";"0";"2";"0";"457181";"373894"
"V4mis1";"SILVA (only NR);Eukaryota;Archaeplastida;Chloroplastida;Chlorophyta;Ulvophyceae;Incertae Sedis;Dilabifilum;";"0.0";"0";"2";"2";"0";"2";"0";"457181";"373894"
"V4mis1";"SILVA (only NR);Eukaryota;Archaeplastida;Chloroplastida;Chlorophyta;Ulvophyceae;Oltmansiellopsidales;";"0.0";"0";"3";"3";"0";"3";"0";"457180";"373894"
"V4mis1";"SILVA (only NR);Eukaryota;Archaeplastida;Chloroplastida;Chlorophyta;Ulvophyceae;Oltmansiellopsidales;Oltmannsiellopsis;";"0.0";"0";"3";"3";"0";"3";"0";"457180";"373894"
"V4mis1";"SILVA (only NR);Eukaryota;Archaeplastida;Chloroplastida;Chlorophyta;Ulvophyceae;Scotinosphaerales;";"0.0";"0";"4";"4";"0";"4";"0";"457179";"373894"
"V4mis1";"SILVA (only NR);Eukaryota;Archaeplastida;Chloroplastida;Chlorophyta;Ulvophyceae;Scotinosphaerales;Scotinosphaera;";"0.0";"0";"4";"4";"0";"4";"0";"457179";"373894"
"V4mis1";"SILVA (only NR);Eukaryota;Archaeplastida;Chloroplastida;Chlorophyta;Ulvophyceae;Trentepohliales;";"0.0";"0";"88";"88";"0";"88";"0";"457095";"373894"
"V4mis1";"SILVA (only NR);Eukaryota;Archaeplastida;Chloroplastida;Chlorophyta;Ulvophyceae;Trentepohliales;Cephaleuros;";"0.0";"0";"16";"16";"0";"16";"0";"457167";"373894"
"V4mis1";"SILVA (only NR);Eukaryota;Archaeplastida;Chloroplastida;Chlorophyta;Ulvophyceae;Trentepohliales;Phycopeltis;";"0.0";"0";"6";"6";"0";"6";"0";"457177";"373894"
"V4mis1";"SILVA (only NR);Eukaryota;Archaeplastida;Chloroplastida;Chlorophyta;Ulvophyceae;Trentepohliales;Printzina;";"0.0";"0";"7";"7";"0";"7";"0";"457176";"373894"
"V4mis1";"SILVA (only NR);Eukaryota;Archaeplastida;Chloroplastida;Chlorophyta;Ulvophyceae;Trentepohliales;Stomatochroon;";"0.0";"0";"1";"1";"0";"1";"0";"457182";"373894"
"V4mis1";"SILVA (only NR);Eukaryota;Archaeplastida;Chloroplastida;Chlorophyta;Ulvophyceae;Trentepohliales;Trentepohlia;";"0.0";"0";"58";"58";"0";"58";"0";"457125";"373894"
"V4mis1";"SILVA (only NR);Eukaryota;Archaeplastida;Chloroplastida;Chlorophyta;Ulvophyceae;Ulotrichales;";"0.0";"0";"10";"10";"0";"10";"0";"457173";"373894"
"V4mis1";"SILVA (only NR);Eukaryota;Archaeplastida;Chloroplastida;Chlorophyta;Ulvophyceae;Ulotrichales;Acrosiphonia;";"0.0";"0";"2";"2";"0";"2";"0";"457181";"373894"
"V4mis1";"SILVA (only NR);Eukaryota;Archaeplastida;Chloroplastida;Chlorophyta;Ulvophyceae;Ulotrichales;Gloeotilopsis;";"0.0";"0";"1";"1";"0";"1";"0";"457182";"373894"
"V4mis1";"SILVA (only NR);Eukaryota;Archaeplastida;Chloroplastida;Chlorophyta;Ulvophyceae;Ulotrichales;Halochlorococcum;";"0.0";"0";"1";"1";"0";"1";"0";"457182";"373894"
"V4mis1";"SILVA (only NR);Eukaryota;Archaeplastida;Chloroplastida;Chlorophyta;Ulvophyceae;Ulotrichales;Hazenia;";"0.0";"0";"2";"2";"0";"2";"0";"457181";"373894"
"V4mis1";"SILVA (only NR);Eukaryota;Archaeplastida;Chloroplastida;Chlorophyta;Ulvophyceae;Ulotrichales;Kraftionema;";"0.0";"0";"1";"1";"0";"1";"0";"457182";"373894"
"V4mis1";"SILVA (only NR);Eukaryota;Archaeplastida;Chloroplastida;Chlorophyta;Ulvophyceae;Ulotrichales;Pseudoneochloris;";"0.0";"0";"1";"1";"0";"1";"0";"457182";"373894"
"V4mis1";"SILVA (only NR);Eukaryota;Archaeplastida;Chloroplastida;Chlorophyta;Ulvophyceae;Ulotrichales;Ulothrix;";"0.0";"0";"1";"1";"0";"1";"0";"457182";"373894"
"V4mis1";"SILVA (only NR);Eukaryota;Archaeplastida;Chloroplastida;Chlorophyta;Ulvophyceae;Ulotrichales;Urospora;";"0.0";"0";"1";"1";"0";"1";"0";"457182";"373894"
"V4mis1";"SILVA (only NR);Eukaryota;Archaeplastida;Chloroplastida;Chlorophyta;Ulvophyceae;Ulvales;";"0.0";"0";"36";"36";"0";"36";"0";"457147";"373894"
"V4mis1";"SILVA (only NR);Eukaryota;Archaeplastida;Chloroplastida;Chlorophyta;Ulvophyceae;Ulvales;Blidingia;";"0.0";"0";"2";"2";"0";"2";"0";"457181";"373894"
"V4mis1";"SILVA (only NR);Eukaryota;Archaeplastida;Chloroplastida;Chlorophyta;Ulvophyceae;Ulvales;Bolbocoleon;";"0.0";"0";"1";"1";"0";"1";"0";"457182";"373894"
"V4mis1";"SILVA (only NR);Eukaryota;Archaeplastida;Chloroplastida;Chlorophyta;Ulvophyceae;Ulvales;Cloniophora;";"0.0";"0";"1";"1";"0";"1";"0";"457182";"373894"
"V4mis1";"SILVA (only NR);Eukaryota;Archaeplastida;Chloroplastida;Chlorophyta;Ulvophyceae;Ulvales;Jaoa;";"0.0";"0";"1";"1";"0";"1";"0";"457182";"373894"
"V4mis1";"SILVA (only NR);Eukaryota;Archaeplastida;Chloroplastida;Chlorophyta;Ulvophyceae;Ulvales;Monostroma;";"0.0";"0";"2";"2";"0";"2";"0";"457181";"373894"
"V4mis1";"SILVA (only NR);Eukaryota;Archaeplastida;Chloroplastida;Chlorophyta;Ulvophyceae;Ulvales;Ochlochaete;";"0.0";"0";"3";"3";"0";"3";"0";"457180";"373894"
"V4mis1";"SILVA (only NR);Eukaryota;Archaeplastida;Chloroplastida;Chlorophyta;Ulvophyceae;Ulvales;Phaeophila;";"0.0";"0";"3";"3";"0";"3";"0";"457180";"373894"
"V4mis1";"SILVA (only NR);Eukaryota;Archaeplastida;Chloroplastida;Chlorophyta;Ulvophyceae;Ulvales;Pseudendoclonium;";"0.0";"0";"4";"4";"0";"4";"0";"457179";"373894"
"V4mis1";"SILVA (only NR);Eukaryota;Archaeplastida;Chloroplastida;Chlorophyta;Ulvophyceae;Ulvales;Ruthnielsenia;";"0.0";"0";"1";"1";"0";"1";"0";"457182";"373894"
"V4mis1";"SILVA (only NR);Eukaryota;Archaeplastida;Chloroplastida;Chlorophyta;Ulvophyceae;Ulvales;Ulva;";"0.0";"0";"10";"10";"0";"10";"0";"457173";"373894"
"V4mis1";"SILVA (only NR);Eukaryota;Archaeplastida;Chloroplastida;Chlorophyta;Ulvophyceae;Ulvales;Ulvaria;";"0.0";"0";"1";"1";"0";"1";"0";"457182";"373894"
"V4mis1";"SILVA (only NR);Eukaryota;Archaeplastida;Chloroplastida;Chlorophyta;Ulvophyceae;Ulvales;Ulvella;";"0.0";"0";"6";"6";"0";"6";"0";"457177";"373894"
"V4mis1";"SILVA (only NR);Eukaryota;Archaeplastida;Chloroplastida;Chlorophyta;Ulvophyceae;Ulvales;Umbraulva;";"0.0";"0";"1";"1";"0";"1";"0";"457182";"373894"
"V4mis1";"SILVA (only NR);Eukaryota;Archaeplastida;Glaucophyta;";"0.0";"0";"8";"8";"0";"8";"0";"457175";"373894"
"V4mis1";"SILVA (only NR);Eukaryota;Archaeplastida;Glaucophyta;Cyanophora;";"0.0";"0";"2";"2";"0";"2";"0";"457181";"373894"
"V4mis1";"SILVA (only NR);Eukaryota;Archaeplastida;Glaucophyta;Cyanoptyche;";"0.0";"0";"1";"1";"0";"1";"0";"457182";"373894"
"V4mis1";"SILVA (only NR);Eukaryota;Archaeplastida;Glaucophyta;Glaucocystis;";"0.0";"0";"3";"3";"0";"3";"0";"457180";"373894"
"V4mis1";"SILVA (only NR);Eukaryota;Archaeplastida;Glaucophyta;Gloeochaete;";"0.0";"0";"1";"1";"0";"1";"0";"457182";"373894"
"V4mis1";"SILVA (only NR);Eukaryota;Archaeplastida;Rhodophyceae;";"0.0";"0";"881";"877";"0";"877";"4";"456306";"373894"
"V4mis1";"SILVA (only NR);Eukaryota;Archaeplastida;Rhodophyceae;Bangiales;";"0.0";"0";"147";"143";"0";"143";"4";"457040";"373894"
"V4mis1";"SILVA (only NR);Eukaryota;Archaeplastida;Rhodophyceae;Bangiales;Bangia;";"0.0";"0";"13";"12";"0";"12";"1";"457171";"373894"
"V4mis1";"SILVA (only NR);Eukaryota;Archaeplastida;Rhodophyceae;Bangiales;Dione;";"0.0";"0";"1";"1";"0";"1";"0";"457182";"373894"
"V4mis1";"SILVA (only NR);Eukaryota;Archaeplastida;Rhodophyceae;Bangiales;Fuscifolium;";"0.0";"0";"1";"1";"0";"1";"0";"457182";"373894"
"V4mis1";"SILVA (only NR);Eukaryota;Archaeplastida;Rhodophyceae;Bangiales;Lysithea;";"0.0";"0";"1";"1";"0";"1";"0";"457182";"373894"
"V4mis1";"SILVA (only NR);Eukaryota;Archaeplastida;Rhodophyceae;Bangiales;Minerva;";"0.0";"0";"1";"1";"0";"1";"0";"457182";"373894"
"V4mis1";"SILVA (only NR);Eukaryota;Archaeplastida;Rhodophyceae;Bangiales;Porphyra-Clymene;";"0.0";"0";"20";"20";"0";"20";"0";"457163";"373894"
"V4mis1";"SILVA (only NR);Eukaryota;Archaeplastida;Rhodophyceae;Bangiales;Porphyra-Clymene;Clymene;";"0.0";"0";"1";"1";"0";"1";"0";"457182";"373894"
"V4mis1";"SILVA (only NR);Eukaryota;Archaeplastida;Rhodophyceae;Bangiales;Porphyra-Pyropia;";"0.0";"0";"104";"101";"0";"101";"3";"457082";"373894"
"V4mis1";"SILVA (only NR);Eukaryota;Archaeplastida;Rhodophyceae;Bangiales;Porphyra-Pyropia;Boreophyllum;";"0.0";"0";"2";"2";"0";"2";"0";"457181";"373894"
"V4mis1";"SILVA (only NR);Eukaryota;Archaeplastida;Rhodophyceae;Bangiales;Porphyra-Pyropia;Pyropia;";"0.0";"0";"5";"5";"0";"5";"0";"457178";"373894"
"V4mis1";"SILVA (only NR);Eukaryota;Archaeplastida;Rhodophyceae;Bangiales;Porphyra-Pyropia;Wildemania;";"0.0";"0";"8";"8";"0";"8";"0";"457175";"373894"
"V4mis1";"SILVA (only NR);Eukaryota;Archaeplastida;Rhodophyceae;Bangiales;Porphyra;";"0.0";"0";"1";"1";"0";"1";"0";"457182";"373894"
"V4mis1";"SILVA (only NR);Eukaryota;Archaeplastida;Rhodophyceae;Bangiales;Pseudobangia;";"0.0";"0";"1";"1";"0";"1";"0";"457182";"373894"
"V4mis1";"SILVA (only NR);Eukaryota;Archaeplastida;Rhodophyceae;Compsopogonales;";"0.0";"0";"14";"14";"0";"14";"0";"457169";"373894"
"V4mis1";"SILVA (only NR);Eukaryota;Archaeplastida;Rhodophyceae;Compsopogonales;Chlidophyllon;";"0.0";"0";"1";"1";"0";"1";"0";"457182";"373894"
"V4mis1";"SILVA (only NR);Eukaryota;Archaeplastida;Rhodophyceae;Compsopogonales;Compsopogon;";"0.0";"0";"2";"2";"0";"2";"0";"457181";"373894"
"V4mis1";"SILVA (only NR);Eukaryota;Archaeplastida;Rhodophyceae;Compsopogonales;Compsopogonopsis;";"0.0";"0";"1";"1";"0";"1";"0";"457182";"373894"
"V4mis1";"SILVA (only NR);Eukaryota;Archaeplastida;Rhodophyceae;Compsopogonales;Erythrotrichia;";"0.0";"0";"1";"1";"0";"1";"0";"457182";"373894"
"V4mis1";"SILVA (only NR);Eukaryota;Archaeplastida;Rhodophyceae;Compsopogonales;Madagascaria;";"0.0";"0";"1";"1";"0";"1";"0";"457182";"373894"
"V4mis1";"SILVA (only NR);Eukaryota;Archaeplastida;Rhodophyceae;Compsopogonales;Pyrophyllon;";"0.0";"0";"2";"2";"0";"2";"0";"457181";"373894"
"V4mis1";"SILVA (only NR);Eukaryota;Archaeplastida;Rhodophyceae;Compsopogonales;Rhodochaete;";"0.0";"0";"1";"1";"0";"1";"0";"457182";"373894"
"V4mis1";"SILVA (only NR);Eukaryota;Archaeplastida;Rhodophyceae;Compsopogonales;Sahlingia;";"0.0";"0";"1";"1";"0";"1";"0";"457182";"373894"
"V4mis1";"SILVA (only NR);Eukaryota;Archaeplastida;Rhodophyceae;Compsopogonales;Smithora;";"0.0";"0";"1";"1";"0";"1";"0";"457182";"373894"
"V4mis1";"SILVA (only NR);Eukaryota;Archaeplastida;Rhodophyceae;Cyanidiales;";"0.0";"0";"15";"15";"0";"15";"0";"457168";"373894"
"V4mis1";"SILVA (only NR);Eukaryota;Archaeplastida;Rhodophyceae;Cyanidiales;Cyanidioschyzon;";"0.0";"0";"2";"2";"0";"2";"0";"457181";"373894"
"V4mis1";"SILVA (only NR);Eukaryota;Archaeplastida;Rhodophyceae;Cyanidiales;Cyanidium;";"0.0";"0";"2";"2";"0";"2";"0";"457181";"373894"
"V4mis1";"SILVA (only NR);Eukaryota;Archaeplastida;Rhodophyceae;Cyanidiales;Galdieria;";"0.0";"0";"8";"8";"0";"8";"0";"457175";"373894"
"V4mis1";"SILVA (only NR);Eukaryota;Archaeplastida;Rhodophyceae;Cyanidiales;uncultured;";"0.0";"0";"2";"2";"0";"2";"0";"457181";"373894"
"V4mis1";"SILVA (only NR);Eukaryota;Archaeplastida;Rhodophyceae;Florideophycidae;";"0.0";"0";"671";"671";"0";"671";"0";"456512";"373894"
"V4mis1";"SILVA (only NR);Eukaryota;Archaeplastida;Rhodophyceae;Florideophycidae;Ahnfeltiophycidae;";"0.0";"0";"2";"2";"0";"2";"0";"457181";"373894"
"V4mis1";"SILVA (only NR);Eukaryota;Archaeplastida;Rhodophyceae;Florideophycidae;Ahnfeltiophycidae;Ahnfeltia;";"0.0";"0";"1";"1";"0";"1";"0";"457182";"373894"
"V4mis1";"SILVA (only NR);Eukaryota;Archaeplastida;Rhodophyceae;Florideophycidae;Ahnfeltiophycidae;Pihiella;";"0.0";"0";"1";"1";"0";"1";"0";"457182";"373894"
"V4mis1";"SILVA (only NR);Eukaryota;Archaeplastida;Rhodophyceae;Florideophycidae;Corallinophycidae;";"0.0";"0";"162";"162";"0";"162";"0";"457021";"373894"
"V4mis1";"SILVA (only NR);Eukaryota;Archaeplastida;Rhodophyceae;Florideophycidae;Corallinophycidae;Amphiroa;";"0.0";"0";"7";"7";"0";"7";"0";"457176";"373894"
"V4mis1";"SILVA (only NR);Eukaryota;Archaeplastida;Rhodophyceae;Florideophycidae;Corallinophycidae;Arthrocardia;";"0.0";"0";"3";"3";"0";"3";"0";"457180";"373894"
"V4mis1";"SILVA (only NR);Eukaryota;Archaeplastida;Rhodophyceae;Florideophycidae;Corallinophycidae;Bossiella;";"0.0";"0";"1";"1";"0";"1";"0";"457182";"373894"
"V4mis1";"SILVA (only NR);Eukaryota;Archaeplastida;Rhodophyceae;Florideophycidae;Corallinophycidae;Callilithophytum;";"0.0";"0";"1";"1";"0";"1";"0";"457182";"373894"
"V4mis1";"SILVA (only NR);Eukaryota;Archaeplastida;Rhodophyceae;Florideophycidae;Corallinophycidae;Cheilosporum;";"0.0";"0";"1";"1";"0";"1";"0";"457182";"373894"
"V4mis1";"SILVA (only NR);Eukaryota;Archaeplastida;Rhodophyceae;Florideophycidae;Corallinophycidae;Clathromorphum;";"0.0";"0";"1";"1";"0";"1";"0";"457182";"373894"
"V4mis1";"SILVA (only NR);Eukaryota;Archaeplastida;Rhodophyceae;Florideophycidae;Corallinophycidae;Corallina;";"0.0";"0";"3";"3";"0";"3";"0";"457180";"373894"
"V4mis1";"SILVA (only NR);Eukaryota;Archaeplastida;Rhodophyceae;Florideophycidae;Corallinophycidae;Ellisolandia;";"0.0";"0";"1";"1";"0";"1";"0";"457182";"373894"
"V4mis1";"SILVA (only NR);Eukaryota;Archaeplastida;Rhodophyceae;Florideophycidae;Corallinophycidae;Haliptilon;";"0.0";"0";"1";"1";"0";"1";"0";"457182";"373894"
"V4mis1";"SILVA (only NR);Eukaryota;Archaeplastida;Rhodophyceae;Florideophycidae;Corallinophycidae;Heydrichia;";"0.0";"0";"3";"3";"0";"3";"0";"457180";"373894"
"V4mis1";"SILVA (only NR);Eukaryota;Archaeplastida;Rhodophyceae;Florideophycidae;Corallinophycidae;Hydrolithon;";"0.0";"0";"20";"20";"0";"20";"0";"457163";"373894"
"V4mis1";"SILVA (only NR);Eukaryota;Archaeplastida;Rhodophyceae;Florideophycidae;Corallinophycidae;Jania;";"0.0";"0";"6";"6";"0";"6";"0";"457177";"373894"
"V4mis1";"SILVA (only NR);Eukaryota;Archaeplastida;Rhodophyceae;Florideophycidae;Corallinophycidae;Leptophytum;";"0.0";"0";"3";"3";"0";"3";"0";"457180";"373894"
"V4mis1";"SILVA (only NR);Eukaryota;Archaeplastida;Rhodophyceae;Florideophycidae;Corallinophycidae;Lithophyllum;";"0.0";"0";"11";"11";"0";"11";"0";"457172";"373894"
"V4mis1";"SILVA (only NR);Eukaryota;Archaeplastida;Rhodophyceae;Florideophycidae;Corallinophycidae;Lithothamnion;";"0.0";"0";"4";"4";"0";"4";"0";"457179";"373894"
"V4mis1";"SILVA (only NR);Eukaryota;Archaeplastida;Rhodophyceae;Florideophycidae;Corallinophycidae;Lithothrix;";"0.0";"0";"1";"1";"0";"1";"0";"457182";"373894"
"V4mis1";"SILVA (only NR);Eukaryota;Archaeplastida;Rhodophyceae;Florideophycidae;Corallinophycidae;Mastophora;";"0.0";"0";"3";"3";"0";"3";"0";"457180";"373894"
"V4mis1";"SILVA (only NR);Eukaryota;Archaeplastida;Rhodophyceae;Florideophycidae;Corallinophycidae;Mastophoropsis;";"0.0";"0";"1";"1";"0";"1";"0";"457182";"373894"
"V4mis1";"SILVA (only NR);Eukaryota;Archaeplastida;Rhodophyceae;Florideophycidae;Corallinophycidae;Mesophyllum;";"0.0";"0";"8";"8";"0";"8";"0";"457175";"373894"
"V4mis1";"SILVA (only NR);Eukaryota;Archaeplastida;Rhodophyceae;Florideophycidae;Corallinophycidae;Metagoniolithon;";"0.0";"0";"1";"1";"0";"1";"0";"457182";"373894"
"V4mis1";"SILVA (only NR);Eukaryota;Archaeplastida;Rhodophyceae;Florideophycidae;Corallinophycidae;Metamastophora;";"0.0";"0";"1";"1";"0";"1";"0";"457182";"373894"
"V4mis1";"SILVA (only NR);Eukaryota;Archaeplastida;Rhodophyceae;Florideophycidae;Corallinophycidae;Neogoniolithon;";"0.0";"0";"13";"13";"0";"13";"0";"457170";"373894"
"V4mis1";"SILVA (only NR);Eukaryota;Archaeplastida;Rhodophyceae;Florideophycidae;Corallinophycidae;Neopolyporolithon;";"0.0";"0";"1";"1";"0";"1";"0";"457182";"373894"
"V4mis1";"SILVA (only NR);Eukaryota;Archaeplastida;Rhodophyceae;Florideophycidae;Corallinophycidae;Phymatolithon;";"0.0";"0";"2";"2";"0";"2";"0";"457181";"373894"
"V4mis1";"SILVA (only NR);Eukaryota;Archaeplastida;Rhodophyceae;Florideophycidae;Corallinophycidae;Rhodogorgon;";"0.0";"0";"2";"2";"0";"2";"0";"457181";"373894"
"V4mis1";"SILVA (only NR);Eukaryota;Archaeplastida;Rhodophyceae;Florideophycidae;Corallinophycidae;Spongites;";"0.0";"0";"9";"9";"0";"9";"0";"457174";"373894"
"V4mis1";"SILVA (only NR);Eukaryota;Archaeplastida;Rhodophyceae;Florideophycidae;Corallinophycidae;Sporolithon;";"0.0";"0";"11";"11";"0";"11";"0";"457172";"373894"
"V4mis1";"SILVA (only NR);Eukaryota;Archaeplastida;Rhodophyceae;Florideophycidae;Corallinophycidae;Synarthrophyton;";"0.0";"0";"3";"3";"0";"3";"0";"457180";"373894"
"V4mis1";"SILVA (only NR);Eukaryota;Archaeplastida;Rhodophyceae;Florideophycidae;Corallinophycidae;Titanoderma;";"0.0";"0";"1";"1";"0";"1";"0";"457182";"373894"
"V4mis1";"SILVA (only NR);Eukaryota;Archaeplastida;Rhodophyceae;Florideophycidae;Hildenbrandiophycidae;";"0.0";"0";"29";"29";"0";"29";"0";"457154";"373894"
"V4mis1";"SILVA (only NR);Eukaryota;Archaeplastida;Rhodophyceae;Florideophycidae;Hildenbrandiophycidae;Apophlaea;";"0.0";"0";"2";"2";"0";"2";"0";"457181";"373894"
"V4mis1";"SILVA (only NR);Eukaryota;Archaeplastida;Rhodophyceae;Florideophycidae;Hildenbrandiophycidae;Hildenbrandia;";"0.0";"0";"25";"25";"0";"25";"0";"457158";"373894"
"V4mis1";"SILVA (only NR);Eukaryota;Archaeplastida;Rhodophyceae;Florideophycidae;Nemaliophycidae;";"0.0";"0";"43";"43";"0";"43";"0";"457140";"373894"
"V4mis1";"SILVA (only NR);Eukaryota;Archaeplastida;Rhodophyceae;Florideophycidae;Nemaliophycidae;Audouinella;";"0.0";"0";"2";"2";"0";"2";"0";"457181";"373894"
"V4mis1";"SILVA (only NR);Eukaryota;Archaeplastida;Rhodophyceae;Florideophycidae;Nemaliophycidae;Ballia;";"0.0";"0";"2";"2";"0";"2";"0";"457181";"373894"
"V4mis1";"SILVA (only NR);Eukaryota;Archaeplastida;Rhodophyceae;Florideophycidae;Nemaliophycidae;Balliopsis;";"0.0";"0";"1";"1";"0";"1";"0";"457182";"373894"
"V4mis1";"SILVA (only NR);Eukaryota;Archaeplastida;Rhodophyceae;Florideophycidae;Nemaliophycidae;Batrachospermum;";"0.0";"0";"6";"6";"0";"6";"0";"457177";"373894"
"V4mis1";"SILVA (only NR);Eukaryota;Archaeplastida;Rhodophyceae;Florideophycidae;Nemaliophycidae;Camontagnea;";"0.0";"0";"1";"1";"0";"1";"0";"457182";"373894"
"V4mis1";"SILVA (only NR);Eukaryota;Archaeplastida;Rhodophyceae;Florideophycidae;Nemaliophycidae;Chantransia;";"0.0";"0";"2";"2";"0";"2";"0";"457181";"373894"
"V4mis1";"SILVA (only NR);Eukaryota;Archaeplastida;Rhodophyceae;Florideophycidae;Nemaliophycidae;Colaconema;";"0.0";"0";"1";"1";"0";"1";"0";"457182";"373894"
"V4mis1";"SILVA (only NR);Eukaryota;Archaeplastida;Rhodophyceae;Florideophycidae;Nemaliophycidae;Cumagloia;";"0.0";"0";"1";"1";"0";"1";"0";"457182";"373894"
"V4mis1";"SILVA (only NR);Eukaryota;Archaeplastida;Rhodophyceae;Florideophycidae;Nemaliophycidae;Dichotomaria;";"0.0";"0";"1";"1";"0";"1";"0";"457182";"373894"
"V4mis1";"SILVA (only NR);Eukaryota;Archaeplastida;Rhodophyceae;Florideophycidae;Nemaliophycidae;Kumanoa;";"0.0";"0";"3";"3";"0";"3";"0";"457180";"373894"
"V4mis1";"SILVA (only NR);Eukaryota;Archaeplastida;Rhodophyceae;Florideophycidae;Nemaliophycidae;Nemalion;";"0.0";"0";"1";"1";"0";"1";"0";"457182";"373894"
"V4mis1";"SILVA (only NR);Eukaryota;Archaeplastida;Rhodophyceae;Florideophycidae;Nemaliophycidae;Nemalionopsis;";"0.0";"0";"1";"1";"0";"1";"0";"457182";"373894"
"V4mis1";"SILVA (only NR);Eukaryota;Archaeplastida;Rhodophyceae;Florideophycidae;Nemaliophycidae;Nothocladus;";"0.0";"0";"1";"1";"0";"1";"0";"457182";"373894"
"V4mis1";"SILVA (only NR);Eukaryota;Archaeplastida;Rhodophyceae;Florideophycidae;Nemaliophycidae;Nothogenia;";"0.0";"0";"1";"1";"0";"1";"0";"457182";"373894"
"V4mis1";"SILVA (only NR);Eukaryota;Archaeplastida;Rhodophyceae;Florideophycidae;Nemaliophycidae;Rhodachlya;";"0.0";"0";"1";"1";"0";"1";"0";"457182";"373894"
"V4mis1";"SILVA (only NR);Eukaryota;Archaeplastida;Rhodophyceae;Florideophycidae;Nemaliophycidae;Rhododraparnaldia;";"0.0";"0";"1";"1";"0";"1";"0";"457182";"373894"
"V4mis1";"SILVA (only NR);Eukaryota;Archaeplastida;Rhodophyceae;Florideophycidae;Nemaliophycidae;Rhodophysema;";"0.0";"0";"1";"1";"0";"1";"0";"457182";"373894"
"V4mis1";"SILVA (only NR);Eukaryota;Archaeplastida;Rhodophyceae;Florideophycidae;Nemaliophycidae;Sheathia;";"0.0";"0";"1";"1";"0";"1";"0";"457182";"373894"
"V4mis1";"SILVA (only NR);Eukaryota;Archaeplastida;Rhodophyceae;Florideophycidae;Nemaliophycidae;Stenopeltis;";"0.0";"0";"1";"1";"0";"1";"0";"457182";"373894"
"V4mis1";"SILVA (only NR);Eukaryota;Archaeplastida;Rhodophyceae;Florideophycidae;Nemaliophycidae;Thorea;";"0.0";"0";"8";"8";"0";"8";"0";"457175";"373894"
"V4mis1";"SILVA (only NR);Eukaryota;Archaeplastida;Rhodophyceae;Florideophycidae;Rhodymeniophycidae;";"0.0";"0";"435";"435";"0";"435";"0";"456748";"373894"
"V4mis1";"SILVA (only NR);Eukaryota;Archaeplastida;Rhodophyceae;Florideophycidae;Rhodymeniophycidae;Acrosymphyton;";"0.0";"0";"1";"1";"0";"1";"0";"457182";"373894"
"V4mis1";"SILVA (only NR);Eukaryota;Archaeplastida;Rhodophyceae;Florideophycidae;Rhodymeniophycidae;Acrotylus;";"0.0";"0";"1";"1";"0";"1";"0";"457182";"373894"
"V4mis1";"SILVA (only NR);Eukaryota;Archaeplastida;Rhodophyceae;Florideophycidae;Rhodymeniophycidae;Aglaothamnion;";"0.0";"0";"3";"3";"0";"3";"0";"457180";"373894"
"V4mis1";"SILVA (only NR);Eukaryota;Archaeplastida;Rhodophyceae;Florideophycidae;Rhodymeniophycidae;Amansia;";"0.0";"0";"2";"2";"0";"2";"0";"457181";"373894"
"V4mis1";"SILVA (only NR);Eukaryota;Archaeplastida;Rhodophyceae;Florideophycidae;Rhodymeniophycidae;Amphiplexia;";"0.0";"0";"1";"1";"0";"1";"0";"457182";"373894"
"V4mis1";"SILVA (only NR);Eukaryota;Archaeplastida;Rhodophyceae;Florideophycidae;Rhodymeniophycidae;Aneurianna;";"0.0";"0";"1";"1";"0";"1";"0";"457182";"373894"
"V4mis1";"SILVA (only NR);Eukaryota;Archaeplastida;Rhodophyceae;Florideophycidae;Rhodymeniophycidae;Anglaothamnion;";"0.0";"0";"1";"1";"0";"1";"0";"457182";"373894"
"V4mis1";"SILVA (only NR);Eukaryota;Archaeplastida;Rhodophyceae;Florideophycidae;Rhodymeniophycidae;Anotrichium;";"0.0";"0";"2";"2";"0";"2";"0";"457181";"373894"
"V4mis1";"SILVA (only NR);Eukaryota;Archaeplastida;Rhodophyceae;Florideophycidae;Rhodymeniophycidae;Antithamnion;";"0.0";"0";"1";"1";"0";"1";"0";"457182";"373894"
"V4mis1";"SILVA (only NR);Eukaryota;Archaeplastida;Rhodophyceae;Florideophycidae;Rhodymeniophycidae;Antithamnionella;";"0.0";"0";"1";"1";"0";"1";"0";"457182";"373894"
"V4mis1";"SILVA (only NR);Eukaryota;Archaeplastida;Rhodophyceae;Florideophycidae;Rhodymeniophycidae;Antrocentrum;";"0.0";"0";"1";"1";"0";"1";"0";"457182";"373894"
"V4mis1";"SILVA (only NR);Eukaryota;Archaeplastida;Rhodophyceae;Florideophycidae;Rhodymeniophycidae;Aphanta;";"0.0";"0";"1";"1";"0";"1";"0";"457182";"373894"
"V4mis1";"SILVA (only NR);Eukaryota;Archaeplastida;Rhodophyceae;Florideophycidae;Rhodymeniophycidae;Asparagopsis;";"0.0";"0";"2";"2";"0";"2";"0";"457181";"373894"
"V4mis1";"SILVA (only NR);Eukaryota;Archaeplastida;Rhodophyceae;Florideophycidae;Rhodymeniophycidae;Asteromenia;";"0.0";"0";"1";"1";"0";"1";"0";"457182";"373894"
"V4mis1";"SILVA (only NR);Eukaryota;Archaeplastida;Rhodophyceae;Florideophycidae;Rhodymeniophycidae;Atractophora;";"0.0";"0";"1";"1";"0";"1";"0";"457182";"373894"
"V4mis1";"SILVA (only NR);Eukaryota;Archaeplastida;Rhodophyceae;Florideophycidae;Rhodymeniophycidae;Austroclonium;";"0.0";"0";"1";"1";"0";"1";"0";"457182";"373894"
"V4mis1";"SILVA (only NR);Eukaryota;Archaeplastida;Rhodophyceae;Florideophycidae;Rhodymeniophycidae;Betaphycus;";"0.0";"0";"1";"1";"0";"1";"0";"457182";"373894"
"V4mis1";"SILVA (only NR);Eukaryota;Archaeplastida;Rhodophyceae;Florideophycidae;Rhodymeniophycidae;Boergeseniella;";"0.0";"0";"1";"1";"0";"1";"0";"457182";"373894"
"V4mis1";"SILVA (only NR);Eukaryota;Archaeplastida;Rhodophyceae;Florideophycidae;Rhodymeniophycidae;Bonnemaisonia;";"0.0";"0";"3";"3";"0";"3";"0";"457180";"373894"
"V4mis1";"SILVA (only NR);Eukaryota;Archaeplastida;Rhodophyceae;Florideophycidae;Rhodymeniophycidae;Bostrychia;";"0.0";"0";"4";"4";"0";"4";"0";"457179";"373894"
"V4mis1";"SILVA (only NR);Eukaryota;Archaeplastida;Rhodophyceae;Florideophycidae;Rhodymeniophycidae;Bostrychiocolax;";"0.0";"0";"1";"1";"0";"1";"0";"457182";"373894"
"V4mis1";"SILVA (only NR);Eukaryota;Archaeplastida;Rhodophyceae;Florideophycidae;Rhodymeniophycidae;Botryocladia;";"0.0";"0";"2";"2";"0";"2";"0";"457181";"373894"
"V4mis1";"SILVA (only NR);Eukaryota;Archaeplastida;Rhodophyceae;Florideophycidae;Rhodymeniophycidae;Calliblepharis;";"0.0";"0";"6";"6";"0";"6";"0";"457177";"373894"
"V4mis1";"SILVA (only NR);Eukaryota;Archaeplastida;Rhodophyceae;Florideophycidae;Rhodymeniophycidae;Callithamnion;";"0.0";"0";"2";"2";"0";"2";"0";"457181";"373894"
"V4mis1";"SILVA (only NR);Eukaryota;Archaeplastida;Rhodophyceae;Florideophycidae;Rhodymeniophycidae;Callophycus;";"0.0";"0";"1";"1";"0";"1";"0";"457182";"373894"
"V4mis1";"SILVA (only NR);Eukaryota;Archaeplastida;Rhodophyceae;Florideophycidae;Rhodymeniophycidae;Callophyllis;";"0.0";"0";"1";"1";"0";"1";"0";"457182";"373894"
"V4mis1";"SILVA (only NR);Eukaryota;Archaeplastida;Rhodophyceae;Florideophycidae;Rhodymeniophycidae;Caloglossa;";"0.0";"0";"5";"5";"0";"5";"0";"457178";"373894"
"V4mis1";"SILVA (only NR);Eukaryota;Archaeplastida;Rhodophyceae;Florideophycidae;Rhodymeniophycidae;Carpothamnion;";"0.0";"0";"1";"1";"0";"1";"0";"457182";"373894"
"V4mis1";"SILVA (only NR);Eukaryota;Archaeplastida;Rhodophyceae;Florideophycidae;Rhodymeniophycidae;Catenella;";"0.0";"0";"1";"1";"0";"1";"0";"457182";"373894"
"V4mis1";"SILVA (only NR);Eukaryota;Archaeplastida;Rhodophyceae;Florideophycidae;Rhodymeniophycidae;Caulacanthus;";"0.0";"0";"1";"1";"0";"1";"0";"457182";"373894"
"V4mis1";"SILVA (only NR);Eukaryota;Archaeplastida;Rhodophyceae;Florideophycidae;Rhodymeniophycidae;Centroceras;";"0.0";"0";"4";"4";"0";"4";"0";"457179";"373894"
"V4mis1";"SILVA (only NR);Eukaryota;Archaeplastida;Rhodophyceae;Florideophycidae;Rhodymeniophycidae;Cephalocystis;";"0.0";"0";"1";"1";"0";"1";"0";"457182";"373894"
"V4mis1";"SILVA (only NR);Eukaryota;Archaeplastida;Rhodophyceae;Florideophycidae;Rhodymeniophycidae;Ceramium;";"0.0";"0";"9";"9";"0";"9";"0";"457174";"373894"
"V4mis1";"SILVA (only NR);Eukaryota;Archaeplastida;Rhodophyceae;Florideophycidae;Rhodymeniophycidae;Ceratodictyon;";"0.0";"0";"1";"1";"0";"1";"0";"457182";"373894"
"V4mis1";"SILVA (only NR);Eukaryota;Archaeplastida;Rhodophyceae;Florideophycidae;Rhodymeniophycidae;Champia;";"0.0";"0";"9";"9";"0";"9";"0";"457174";"373894"
"V4mis1";"SILVA (only NR);Eukaryota;Archaeplastida;Rhodophyceae;Florideophycidae;Rhodymeniophycidae;Chondrus;";"0.0";"0";"2";"2";"0";"2";"0";"457181";"373894"
"V4mis1";"SILVA (only NR);Eukaryota;Archaeplastida;Rhodophyceae;Florideophycidae;Rhodymeniophycidae;Choreocolax;";"0.0";"0";"1";"1";"0";"1";"0";"457182";"373894"
"V4mis1";"SILVA (only NR);Eukaryota;Archaeplastida;Rhodophyceae;Florideophycidae;Rhodymeniophycidae;Chrysymenia;";"0.0";"0";"2";"2";"0";"2";"0";"457181";"373894"
"V4mis1";"SILVA (only NR);Eukaryota;Archaeplastida;Rhodophyceae;Florideophycidae;Rhodymeniophycidae;Chylocladia;";"0.0";"0";"2";"2";"0";"2";"0";"457181";"373894"
"V4mis1";"SILVA (only NR);Eukaryota;Archaeplastida;Rhodophyceae;Florideophycidae;Rhodymeniophycidae;Coelarthrum;";"0.0";"0";"1";"1";"0";"1";"0";"457182";"373894"
"V4mis1";"SILVA (only NR);Eukaryota;Archaeplastida;Rhodophyceae;Florideophycidae;Rhodymeniophycidae;Coelothrix;";"0.0";"0";"2";"2";"0";"2";"0";"457181";"373894"
"V4mis1";"SILVA (only NR);Eukaryota;Archaeplastida;Rhodophyceae;Florideophycidae;Rhodymeniophycidae;Compsothamnion;";"0.0";"0";"1";"1";"0";"1";"0";"457182";"373894"
"V4mis1";"SILVA (only NR);Eukaryota;Archaeplastida;Rhodophyceae;Florideophycidae;Rhodymeniophycidae;Constantinea;";"0.0";"0";"1";"1";"0";"1";"0";"457182";"373894"
"V4mis1";"SILVA (only NR);Eukaryota;Archaeplastida;Rhodophyceae;Florideophycidae;Rhodymeniophycidae;Cordylecladia;";"0.0";"0";"1";"1";"0";"1";"0";"457182";"373894"
"V4mis1";"SILVA (only NR);Eukaryota;Archaeplastida;Rhodophyceae;Florideophycidae;Rhodymeniophycidae;Corynocystis;";"0.0";"0";"1";"1";"0";"1";"0";"457182";"373894"
"V4mis1";"SILVA (only NR);Eukaryota;Archaeplastida;Rhodophyceae;Florideophycidae;Rhodymeniophycidae;Crassitegula;";"0.0";"0";"1";"1";"0";"1";"0";"457182";"373894"
"V4mis1";"SILVA (only NR);Eukaryota;Archaeplastida;Rhodophyceae;Florideophycidae;Rhodymeniophycidae;Cresia;";"0.0";"0";"1";"1";"0";"1";"0";"457182";"373894"
"V4mis1";"SILVA (only NR);Eukaryota;Archaeplastida;Rhodophyceae;Florideophycidae;Rhodymeniophycidae;Crouania;";"0.0";"0";"2";"2";"0";"2";"0";"457181";"373894"
"V4mis1";"SILVA (only NR);Eukaryota;Archaeplastida;Rhodophyceae;Florideophycidae;Rhodymeniophycidae;Cryptopleura;";"0.0";"0";"2";"2";"0";"2";"0";"457181";"373894"
"V4mis1";"SILVA (only NR);Eukaryota;Archaeplastida;Rhodophyceae;Florideophycidae;Rhodymeniophycidae;Cubiculosporum;";"0.0";"0";"1";"1";"0";"1";"0";"457182";"373894"
"V4mis1";"SILVA (only NR);Eukaryota;Archaeplastida;Rhodophyceae;Florideophycidae;Rhodymeniophycidae;Curdiea;";"0.0";"0";"2";"2";"0";"2";"0";"457181";"373894"
"V4mis1";"SILVA (only NR);Eukaryota;Archaeplastida;Rhodophyceae;Florideophycidae;Rhodymeniophycidae;Cystoclonium;";"0.0";"0";"1";"1";"0";"1";"0";"457182";"373894"
"V4mis1";"SILVA (only NR);Eukaryota;Archaeplastida;Rhodophyceae;Florideophycidae;Rhodymeniophycidae;Dasya;";"0.0";"0";"1";"1";"0";"1";"0";"457182";"373894"
"V4mis1";"SILVA (only NR);Eukaryota;Archaeplastida;Rhodophyceae;Florideophycidae;Rhodymeniophycidae;Dasyphloea;";"0.0";"0";"1";"1";"0";"1";"0";"457182";"373894"
"V4mis1";"SILVA (only NR);Eukaryota;Archaeplastida;Rhodophyceae;Florideophycidae;Rhodymeniophycidae;Dasysiphonia;";"0.0";"0";"1";"1";"0";"1";"0";"457182";"373894"
"V4mis1";"SILVA (only NR);Eukaryota;Archaeplastida;Rhodophyceae;Florideophycidae;Rhodymeniophycidae;Dasythamniella;";"0.0";"0";"1";"1";"0";"1";"0";"457182";"373894"
"V4mis1";"SILVA (only NR);Eukaryota;Archaeplastida;Rhodophyceae;Florideophycidae;Rhodymeniophycidae;Dawsoniocolax;";"0.0";"0";"1";"1";"0";"1";"0";"457182";"373894"
"V4mis1";"SILVA (only NR);Eukaryota;Archaeplastida;Rhodophyceae;Florideophycidae;Rhodymeniophycidae;Delisea;";"0.0";"0";"1";"1";"0";"1";"0";"457182";"373894"
"V4mis1";"SILVA (only NR);Eukaryota;Archaeplastida;Rhodophyceae;Florideophycidae;Rhodymeniophycidae;Diapse;";"0.0";"0";"1";"1";"0";"1";"0";"457182";"373894"
"V4mis1";"SILVA (only NR);Eukaryota;Archaeplastida;Rhodophyceae;Florideophycidae;Rhodymeniophycidae;Dicranema;";"0.0";"0";"1";"1";"0";"1";"0";"457182";"373894"
"V4mis1";"SILVA (only NR);Eukaryota;Archaeplastida;Rhodophyceae;Florideophycidae;Rhodymeniophycidae;Dictyothamnion;";"0.0";"0";"1";"1";"0";"1";"0";"457182";"373894"
"V4mis1";"SILVA (only NR);Eukaryota;Archaeplastida;Rhodophyceae;Florideophycidae;Rhodymeniophycidae;Dictyurus;";"0.0";"0";"1";"1";"0";"1";"0";"457182";"373894"
"V4mis1";"SILVA (only NR);Eukaryota;Archaeplastida;Rhodophyceae;Florideophycidae;Rhodymeniophycidae;Drouetia;";"0.0";"0";"1";"1";"0";"1";"0";"457182";"373894"
"V4mis1";"SILVA (only NR);Eukaryota;Archaeplastida;Rhodophyceae;Florideophycidae;Rhodymeniophycidae;Dudresnaya;";"0.0";"0";"1";"1";"0";"1";"0";"457182";"373894"
"V4mis1";"SILVA (only NR);Eukaryota;Archaeplastida;Rhodophyceae;Florideophycidae;Rhodymeniophycidae;Dumontia;";"0.0";"0";"1";"1";"0";"1";"0";"457182";"373894"
"V4mis1";"SILVA (only NR);Eukaryota;Archaeplastida;Rhodophyceae;Florideophycidae;Rhodymeniophycidae;Epiphloea;";"0.0";"0";"1";"1";"0";"1";"0";"457182";"373894"
"V4mis1";"SILVA (only NR);Eukaryota;Archaeplastida;Rhodophyceae;Florideophycidae;Rhodymeniophycidae;Erythrocolon;";"0.0";"0";"1";"1";"0";"1";"0";"457182";"373894"
"V4mis1";"SILVA (only NR);Eukaryota;Archaeplastida;Rhodophyceae;Florideophycidae;Rhodymeniophycidae;Erythronaema;";"0.0";"0";"1";"1";"0";"1";"0";"457182";"373894"
"V4mis1";"SILVA (only NR);Eukaryota;Archaeplastida;Rhodophyceae;Florideophycidae;Rhodymeniophycidae;Erythrophyllum;";"0.0";"0";"1";"1";"0";"1";"0";"457182";"373894"
"V4mis1";"SILVA (only NR);Eukaryota;Archaeplastida;Rhodophyceae;Florideophycidae;Rhodymeniophycidae;Erythrymenia;";"0.0";"0";"1";"1";"0";"1";"0";"457182";"373894"
"V4mis1";"SILVA (only NR);Eukaryota;Archaeplastida;Rhodophyceae;Florideophycidae;Rhodymeniophycidae;Eucheuma;";"0.0";"0";"1";"1";"0";"1";"0";"457182";"373894"
"V4mis1";"SILVA (only NR);Eukaryota;Archaeplastida;Rhodophyceae;Florideophycidae;Rhodymeniophycidae;Euptilocladia;";"0.0";"0";"1";"1";"0";"1";"0";"457182";"373894"
"V4mis1";"SILVA (only NR);Eukaryota;Archaeplastida;Rhodophyceae;Florideophycidae;Rhodymeniophycidae;Euptilota;";"0.0";"0";"3";"3";"0";"3";"0";"457180";"373894"
"V4mis1";"SILVA (only NR);Eukaryota;Archaeplastida;Rhodophyceae;Florideophycidae;Rhodymeniophycidae;Euthora;";"0.0";"0";"1";"1";"0";"1";"0";"457182";"373894"
"V4mis1";"SILVA (only NR);Eukaryota;Archaeplastida;Rhodophyceae;Florideophycidae;Rhodymeniophycidae;Fimbrifolium;";"0.0";"0";"1";"1";"0";"1";"0";"457182";"373894"
"V4mis1";"SILVA (only NR);Eukaryota;Archaeplastida;Rhodophyceae;Florideophycidae;Rhodymeniophycidae;Fryeella;";"0.0";"0";"1";"1";"0";"1";"0";"457182";"373894"
"V4mis1";"SILVA (only NR);Eukaryota;Archaeplastida;Rhodophyceae;Florideophycidae;Rhodymeniophycidae;Furcellaria;";"0.0";"0";"1";"1";"0";"1";"0";"457182";"373894"
"V4mis1";"SILVA (only NR);Eukaryota;Archaeplastida;Rhodophyceae;Florideophycidae;Rhodymeniophycidae;Gardneriella;";"0.0";"0";"1";"1";"0";"1";"0";"457182";"373894"
"V4mis1";"SILVA (only NR);Eukaryota;Archaeplastida;Rhodophyceae;Florideophycidae;Rhodymeniophycidae;Gastroclonium;";"0.0";"0";"1";"1";"0";"1";"0";"457182";"373894"
"V4mis1";"SILVA (only NR);Eukaryota;Archaeplastida;Rhodophyceae;Florideophycidae;Rhodymeniophycidae;Gelidiella;";"0.0";"0";"2";"2";"0";"2";"0";"457181";"373894"
"V4mis1";"SILVA (only NR);Eukaryota;Archaeplastida;Rhodophyceae;Florideophycidae;Rhodymeniophycidae;Gelidiopsis;";"0.0";"0";"1";"1";"0";"1";"0";"457182";"373894"
"V4mis1";"SILVA (only NR);Eukaryota;Archaeplastida;Rhodophyceae;Florideophycidae;Rhodymeniophycidae;Gelidium;";"0.0";"0";"3";"3";"0";"3";"0";"457180";"373894"
"V4mis1";"SILVA (only NR);Eukaryota;Archaeplastida;Rhodophyceae;Florideophycidae;Rhodymeniophycidae;Georgiella;";"0.0";"0";"1";"1";"0";"1";"0";"457182";"373894"
"V4mis1";"SILVA (only NR);Eukaryota;Archaeplastida;Rhodophyceae;Florideophycidae;Rhodymeniophycidae;Gibsmithia;";"0.0";"0";"1";"1";"0";"1";"0";"457182";"373894"
"V4mis1";"SILVA (only NR);Eukaryota;Archaeplastida;Rhodophyceae;Florideophycidae;Rhodymeniophycidae;Gloiocladia;";"0.0";"0";"6";"6";"0";"6";"0";"457177";"373894"
"V4mis1";"SILVA (only NR);Eukaryota;Archaeplastida;Rhodophyceae;Florideophycidae;Rhodymeniophycidae;Gloiopeltis;";"0.0";"0";"1";"1";"0";"1";"0";"457182";"373894"
"V4mis1";"SILVA (only NR);Eukaryota;Archaeplastida;Rhodophyceae;Florideophycidae;Rhodymeniophycidae;Gracilaria;";"0.0";"0";"11";"11";"0";"11";"0";"457172";"373894"
"V4mis1";"SILVA (only NR);Eukaryota;Archaeplastida;Rhodophyceae;Florideophycidae;Rhodymeniophycidae;Gracilariopsis;";"0.0";"0";"7";"7";"0";"7";"0";"457176";"373894"
"V4mis1";"SILVA (only NR);Eukaryota;Archaeplastida;Rhodophyceae;Florideophycidae;Rhodymeniophycidae;Grateloupia;";"0.0";"0";"2";"2";"0";"2";"0";"457181";"373894"
"V4mis1";"SILVA (only NR);Eukaryota;Archaeplastida;Rhodophyceae;Florideophycidae;Rhodymeniophycidae;Griffithsia;";"0.0";"0";"2";"2";"0";"2";"0";"457181";"373894"
"V4mis1";"SILVA (only NR);Eukaryota;Archaeplastida;Rhodophyceae;Florideophycidae;Rhodymeniophycidae;Grinnellia;";"0.0";"0";"1";"1";"0";"1";"0";"457182";"373894"
"V4mis1";"SILVA (only NR);Eukaryota;Archaeplastida;Rhodophyceae;Florideophycidae;Rhodymeniophycidae;Gulsonia;";"0.0";"0";"1";"1";"0";"1";"0";"457182";"373894"
"V4mis1";"SILVA (only NR);Eukaryota;Archaeplastida;Rhodophyceae;Florideophycidae;Rhodymeniophycidae;Halichrysis;";"0.0";"0";"1";"1";"0";"1";"0";"457182";"373894"
"V4mis1";"SILVA (only NR);Eukaryota;Archaeplastida;Rhodophyceae;Florideophycidae;Rhodymeniophycidae;Halopithys;";"0.0";"0";"1";"1";"0";"1";"0";"457182";"373894"
"V4mis1";"SILVA (only NR);Eukaryota;Archaeplastida;Rhodophyceae;Florideophycidae;Rhodymeniophycidae;Halurus;";"0.0";"0";"1";"1";"0";"1";"0";"457182";"373894"
"V4mis1";"SILVA (only NR);Eukaryota;Archaeplastida;Rhodophyceae;Florideophycidae;Rhodymeniophycidae;Halydictyon;";"0.0";"0";"1";"1";"0";"1";"0";"457182";"373894"
"V4mis1";"SILVA (only NR);Eukaryota;Archaeplastida;Rhodophyceae;Florideophycidae;Rhodymeniophycidae;Harveyella;";"0.0";"0";"2";"2";"0";"2";"0";"457181";"373894"
"V4mis1";"SILVA (only NR);Eukaryota;Archaeplastida;Rhodophyceae;Florideophycidae;Rhodymeniophycidae;Hemineura;";"0.0";"0";"1";"1";"0";"1";"0";"457182";"373894"
"V4mis1";"SILVA (only NR);Eukaryota;Archaeplastida;Rhodophyceae;Florideophycidae;Rhodymeniophycidae;Herposiphonia;";"0.0";"0";"3";"3";"0";"3";"0";"457180";"373894"
"V4mis1";"SILVA (only NR);Eukaryota;Archaeplastida;Rhodophyceae;Florideophycidae;Rhodymeniophycidae;Heterocladia;";"0.0";"0";"1";"1";"0";"1";"0";"457182";"373894"
"V4mis1";"SILVA (only NR);Eukaryota;Archaeplastida;Rhodophyceae;Florideophycidae;Rhodymeniophycidae;Heteroptilon;";"0.0";"0";"1";"1";"0";"1";"0";"457182";"373894"
"V4mis1";"SILVA (only NR);Eukaryota;Archaeplastida;Rhodophyceae;Florideophycidae;Rhodymeniophycidae;Heterosiphonia;";"0.0";"0";"3";"3";"0";"3";"0";"457180";"373894"
"V4mis1";"SILVA (only NR);Eukaryota;Archaeplastida;Rhodophyceae;Florideophycidae;Rhodymeniophycidae;Hummbrella;";"0.0";"0";"1";"1";"0";"1";"0";"457182";"373894"
"V4mis1";"SILVA (only NR);Eukaryota;Archaeplastida;Rhodophyceae;Florideophycidae;Rhodymeniophycidae;Hymenocladia;";"0.0";"0";"1";"1";"0";"1";"0";"457182";"373894"
"V4mis1";"SILVA (only NR);Eukaryota;Archaeplastida;Rhodophyceae;Florideophycidae;Rhodymeniophycidae;Hymenocladiopsis;";"0.0";"0";"1";"1";"0";"1";"0";"457182";"373894"
"V4mis1";"SILVA (only NR);Eukaryota;Archaeplastida;Rhodophyceae;Florideophycidae;Rhodymeniophycidae;Hypnea;";"0.0";"0";"2";"2";"0";"2";"0";"457181";"373894"
"V4mis1";"SILVA (only NR);Eukaryota;Archaeplastida;Rhodophyceae;Florideophycidae;Rhodymeniophycidae;Hypoglossum;";"0.0";"0";"1";"1";"0";"1";"0";"457182";"373894"
"V4mis1";"SILVA (only NR);Eukaryota;Archaeplastida;Rhodophyceae;Florideophycidae;Rhodymeniophycidae;Inkyuleea;";"0.0";"0";"1";"1";"0";"1";"0";"457182";"373894"
"V4mis1";"SILVA (only NR);Eukaryota;Archaeplastida;Rhodophyceae;Florideophycidae;Rhodymeniophycidae;Involucrana;";"0.0";"0";"1";"1";"0";"1";"0";"457182";"373894"
"V4mis1";"SILVA (only NR);Eukaryota;Archaeplastida;Rhodophyceae;Florideophycidae;Rhodymeniophycidae;Irvinea;";"0.0";"0";"1";"1";"0";"1";"0";"457182";"373894"
"V4mis1";"SILVA (only NR);Eukaryota;Archaeplastida;Rhodophyceae;Florideophycidae;Rhodymeniophycidae;Isabbottia;";"0.0";"0";"1";"1";"0";"1";"0";"457182";"373894"
"V4mis1";"SILVA (only NR);Eukaryota;Archaeplastida;Rhodophyceae;Florideophycidae;Rhodymeniophycidae;Kappaphycus;";"0.0";"0";"2";"2";"0";"2";"0";"457181";"373894"
"V4mis1";"SILVA (only NR);Eukaryota;Archaeplastida;Rhodophyceae;Florideophycidae;Rhodymeniophycidae;Kraftia;";"0.0";"0";"1";"1";"0";"1";"0";"457182";"373894"
"V4mis1";"SILVA (only NR);Eukaryota;Archaeplastida;Rhodophyceae;Florideophycidae;Rhodymeniophycidae;Kuetzingia;";"0.0";"0";"1";"1";"0";"1";"0";"457182";"373894"
"V4mis1";"SILVA (only NR);Eukaryota;Archaeplastida;Rhodophyceae;Florideophycidae;Rhodymeniophycidae;Laurencia;";"0.0";"0";"1";"1";"0";"1";"0";"457182";"373894"
"V4mis1";"SILVA (only NR);Eukaryota;Archaeplastida;Rhodophyceae;Florideophycidae;Rhodymeniophycidae;Leachiella;";"0.0";"0";"1";"1";"0";"1";"0";"457182";"373894"
"V4mis1";"SILVA (only NR);Eukaryota;Archaeplastida;Rhodophyceae;Florideophycidae;Rhodymeniophycidae;Lejolisia;";"0.0";"0";"1";"1";"0";"1";"0";"457182";"373894"
"V4mis1";"SILVA (only NR);Eukaryota;Archaeplastida;Rhodophyceae;Florideophycidae;Rhodymeniophycidae;Lembergia;";"0.0";"0";"1";"1";"0";"1";"0";"457182";"373894"
"V4mis1";"SILVA (only NR);Eukaryota;Archaeplastida;Rhodophyceae;Florideophycidae;Rhodymeniophycidae;Lenormandia;";"0.0";"0";"4";"4";"0";"4";"0";"457179";"373894"
"V4mis1";"SILVA (only NR);Eukaryota;Archaeplastida;Rhodophyceae;Florideophycidae;Rhodymeniophycidae;Leptosomia;";"0.0";"0";"1";"1";"0";"1";"0";"457182";"373894"
"V4mis1";"SILVA (only NR);Eukaryota;Archaeplastida;Rhodophyceae;Florideophycidae;Rhodymeniophycidae;Lesleigha;";"0.0";"0";"2";"2";"0";"2";"0";"457181";"373894"
"V4mis1";"SILVA (only NR);Eukaryota;Archaeplastida;Rhodophyceae;Florideophycidae;Rhodymeniophycidae;Lomentaria;";"0.0";"0";"2";"2";"0";"2";"0";"457181";"373894"
"V4mis1";"SILVA (only NR);Eukaryota;Archaeplastida;Rhodophyceae;Florideophycidae;Rhodymeniophycidae;Lophocladia;";"0.0";"0";"2";"2";"0";"2";"0";"457181";"373894"
"V4mis1";"SILVA (only NR);Eukaryota;Archaeplastida;Rhodophyceae;Florideophycidae;Rhodymeniophycidae;Lophothalia;";"0.0";"0";"1";"1";"0";"1";"0";"457182";"373894"
"V4mis1";"SILVA (only NR);Eukaryota;Archaeplastida;Rhodophyceae;Florideophycidae;Rhodymeniophycidae;Maripelta;";"0.0";"0";"1";"1";"0";"1";"0";"457182";"373894"
"V4mis1";"SILVA (only NR);Eukaryota;Archaeplastida;Rhodophyceae;Florideophycidae;Rhodymeniophycidae;Mastocarpus;";"0.0";"0";"1";"1";"0";"1";"0";"457182";"373894"
"V4mis1";"SILVA (only NR);Eukaryota;Archaeplastida;Rhodophyceae;Florideophycidae;Rhodymeniophycidae;Melanthalia;";"0.0";"0";"1";"1";"0";"1";"0";"457182";"373894"
"V4mis1";"SILVA (only NR);Eukaryota;Archaeplastida;Rhodophyceae;Florideophycidae;Rhodymeniophycidae;Micropeuce;";"0.0";"0";"1";"1";"0";"1";"0";"457182";"373894"
"V4mis1";"SILVA (only NR);Eukaryota;Archaeplastida;Rhodophyceae;Florideophycidae;Rhodymeniophycidae;Monosporus;";"0.0";"0";"1";"1";"0";"1";"0";"457182";"373894"
"V4mis1";"SILVA (only NR);Eukaryota;Archaeplastida;Rhodophyceae;Florideophycidae;Rhodymeniophycidae;Muellerena;";"0.0";"0";"1";"1";"0";"1";"0";"457182";"373894"
"V4mis1";"SILVA (only NR);Eukaryota;Archaeplastida;Rhodophyceae;Florideophycidae;Rhodymeniophycidae;Murrayella;";"0.0";"0";"1";"1";"0";"1";"0";"457182";"373894"
"V4mis1";"SILVA (only NR);Eukaryota;Archaeplastida;Rhodophyceae;Florideophycidae;Rhodymeniophycidae;Naccaria;";"0.0";"0";"1";"1";"0";"1";"0";"457182";"373894"
"V4mis1";"SILVA (only NR);Eukaryota;Archaeplastida;Rhodophyceae;Florideophycidae;Rhodymeniophycidae;Nemastoma;";"0.0";"0";"1";"1";"0";"1";"0";"457182";"373894"
"V4mis1";"SILVA (only NR);Eukaryota;Archaeplastida;Rhodophyceae;Florideophycidae;Rhodymeniophycidae;Neodilsea;";"0.0";"0";"1";"1";"0";"1";"0";"457182";"373894"
"V4mis1";"SILVA (only NR);Eukaryota;Archaeplastida;Rhodophyceae;Florideophycidae;Rhodymeniophycidae;Neorhodomela;";"0.0";"0";"1";"1";"0";"1";"0";"457182";"373894"
"V4mis1";"SILVA (only NR);Eukaryota;Archaeplastida;Rhodophyceae;Florideophycidae;Rhodymeniophycidae;Neosiphonia;";"0.0";"0";"6";"6";"0";"6";"0";"457177";"373894"
"V4mis1";"SILVA (only NR);Eukaryota;Archaeplastida;Rhodophyceae;Florideophycidae;Rhodymeniophycidae;Neurymenia;";"0.0";"0";"1";"1";"0";"1";"0";"457182";"373894"
"V4mis1";"SILVA (only NR);Eukaryota;Archaeplastida;Rhodophyceae;Florideophycidae;Rhodymeniophycidae;Nizymenia;";"0.0";"0";"1";"1";"0";"1";"0";"457182";"373894"
"V4mis1";"SILVA (only NR);Eukaryota;Archaeplastida;Rhodophyceae;Florideophycidae;Rhodymeniophycidae;Norrissia;";"0.0";"0";"1";"1";"0";"1";"0";"457182";"373894"
"V4mis1";"SILVA (only NR);Eukaryota;Archaeplastida;Rhodophyceae;Florideophycidae;Rhodymeniophycidae;Odonthalia;";"0.0";"0";"1";"1";"0";"1";"0";"457182";"373894"
"V4mis1";"SILVA (only NR);Eukaryota;Archaeplastida;Rhodophyceae;Florideophycidae;Rhodymeniophycidae;Ophidocladus;";"0.0";"0";"1";"1";"0";"1";"0";"457182";"373894"
"V4mis1";"SILVA (only NR);Eukaryota;Archaeplastida;Rhodophyceae;Florideophycidae;Rhodymeniophycidae;Osmundaria;";"0.0";"0";"1";"1";"0";"1";"0";"457182";"373894"
"V4mis1";"SILVA (only NR);Eukaryota;Archaeplastida;Rhodophyceae;Florideophycidae;Rhodymeniophycidae;Osmundea;";"0.0";"0";"1";"1";"0";"1";"0";"457182";"373894"
"V4mis1";"SILVA (only NR);Eukaryota;Archaeplastida;Rhodophyceae;Florideophycidae;Rhodymeniophycidae;Pachymenia;";"0.0";"0";"2";"2";"0";"2";"0";"457181";"373894"
"V4mis1";"SILVA (only NR);Eukaryota;Archaeplastida;Rhodophyceae;Florideophycidae;Rhodymeniophycidae;Parviphycus;";"0.0";"0";"1";"1";"0";"1";"0";"457182";"373894"
"V4mis1";"SILVA (only NR);Eukaryota;Archaeplastida;Rhodophyceae;Florideophycidae;Rhodymeniophycidae;Peyssonnelia;";"0.0";"0";"16";"16";"0";"16";"0";"457167";"373894"
"V4mis1";"SILVA (only NR);Eukaryota;Archaeplastida;Rhodophyceae;Florideophycidae;Rhodymeniophycidae;Phycodrys;";"0.0";"0";"1";"1";"0";"1";"0";"457182";"373894"
"V4mis1";"SILVA (only NR);Eukaryota;Archaeplastida;Rhodophyceae;Florideophycidae;Rhodymeniophycidae;Platoma;";"0.0";"0";"1";"1";"0";"1";"0";"457182";"373894"
"V4mis1";"SILVA (only NR);Eukaryota;Archaeplastida;Rhodophyceae;Florideophycidae;Rhodymeniophycidae;Platysiphonia;";"0.0";"0";"2";"2";"0";"2";"0";"457181";"373894"
"V4mis1";"SILVA (only NR);Eukaryota;Archaeplastida;Rhodophyceae;Florideophycidae;Rhodymeniophycidae;Pleonosporium;";"0.0";"0";"1";"1";"0";"1";"0";"457182";"373894"
"V4mis1";"SILVA (only NR);Eukaryota;Archaeplastida;Rhodophyceae;Florideophycidae;Rhodymeniophycidae;Plocamium;";"0.0";"0";"2";"2";"0";"2";"0";"457181";"373894"
"V4mis1";"SILVA (only NR);Eukaryota;Archaeplastida;Rhodophyceae;Florideophycidae;Rhodymeniophycidae;Polsiphonia;";"0.0";"0";"1";"1";"0";"1";"0";"457182";"373894"
"V4mis1";"SILVA (only NR);Eukaryota;Archaeplastida;Rhodophyceae;Florideophycidae;Rhodymeniophycidae;Polyides;";"0.0";"0";"1";"1";"0";"1";"0";"457182";"373894"
"V4mis1";"SILVA (only NR);Eukaryota;Archaeplastida;Rhodophyceae;Florideophycidae;Rhodymeniophycidae;Polyopes;";"0.0";"0";"1";"1";"0";"1";"0";"457182";"373894"
"V4mis1";"SILVA (only NR);Eukaryota;Archaeplastida;Rhodophyceae;Florideophycidae;Rhodymeniophycidae;Polysiphonia;";"0.0";"0";"28";"28";"0";"28";"0";"457155";"373894"
"V4mis1";"SILVA (only NR);Eukaryota;Archaeplastida;Rhodophyceae;Florideophycidae;Rhodymeniophycidae;Polystrata;";"0.0";"0";"1";"1";"0";"1";"0";"457182";"373894"
"V4mis1";"SILVA (only NR);Eukaryota;Archaeplastida;Rhodophyceae;Florideophycidae;Rhodymeniophycidae;Portieria;";"0.0";"0";"2";"2";"0";"2";"0";"457181";"373894"
"V4mis1";"SILVA (only NR);Eukaryota;Archaeplastida;Rhodophyceae;Florideophycidae;Rhodymeniophycidae;Predaea;";"0.0";"0";"2";"2";"0";"2";"0";"457181";"373894"
"V4mis1";"SILVA (only NR);Eukaryota;Archaeplastida;Rhodophyceae;Florideophycidae;Rhodymeniophycidae;Prionitis;";"0.0";"0";"1";"1";"0";"1";"0";"457182";"373894"
"V4mis1";"SILVA (only NR);Eukaryota;Archaeplastida;Rhodophyceae;Florideophycidae;Rhodymeniophycidae;Pterothamnion;";"0.0";"0";"1";"1";"0";"1";"0";"457182";"373894"
"V4mis1";"SILVA (only NR);Eukaryota;Archaeplastida;Rhodophyceae;Florideophycidae;Rhodymeniophycidae;Ptilocladiopsis;";"0.0";"0";"1";"1";"0";"1";"0";"457182";"373894"
"V4mis1";"SILVA (only NR);Eukaryota;Archaeplastida;Rhodophyceae;Florideophycidae;Rhodymeniophycidae;Ptilonia;";"0.0";"0";"1";"1";"0";"1";"0";"457182";"373894"
"V4mis1";"SILVA (only NR);Eukaryota;Archaeplastida;Rhodophyceae;Florideophycidae;Rhodymeniophycidae;Ptilophora;";"0.0";"0";"1";"1";"0";"1";"0";"457182";"373894"
"V4mis1";"SILVA (only NR);Eukaryota;Archaeplastida;Rhodophyceae;Florideophycidae;Rhodymeniophycidae;Ptilota;";"0.0";"0";"2";"2";"0";"2";"0";"457181";"373894"
"V4mis1";"SILVA (only NR);Eukaryota;Archaeplastida;Rhodophyceae;Florideophycidae;Rhodymeniophycidae;Pugetia;";"0.0";"0";"1";"1";"0";"1";"0";"457182";"373894"
"V4mis1";"SILVA (only NR);Eukaryota;Archaeplastida;Rhodophyceae;Florideophycidae;Rhodymeniophycidae;Rhodocallis;";"0.0";"0";"1";"1";"0";"1";"0";"457182";"373894"
"V4mis1";"SILVA (only NR);Eukaryota;Archaeplastida;Rhodophyceae;Florideophycidae;Rhodymeniophycidae;Rhodoglossum;";"0.0";"0";"1";"1";"0";"1";"0";"457182";"373894"
"V4mis1";"SILVA (only NR);Eukaryota;Archaeplastida;Rhodophyceae;Florideophycidae;Rhodymeniophycidae;Rhodomela;";"0.0";"0";"1";"1";"0";"1";"0";"457182";"373894"
"V4mis1";"SILVA (only NR);Eukaryota;Archaeplastida;Rhodophyceae;Florideophycidae;Rhodymeniophycidae;Rhodopeltis;";"0.0";"0";"1";"1";"0";"1";"0";"457182";"373894"
"V4mis1";"SILVA (only NR);Eukaryota;Archaeplastida;Rhodophyceae;Florideophycidae;Rhodymeniophycidae;Rhodophyllis;";"0.0";"0";"1";"1";"0";"1";"0";"457182";"373894"
"V4mis1";"SILVA (only NR);Eukaryota;Archaeplastida;Rhodophyceae;Florideophycidae;Rhodymeniophycidae;Rhodoptilum;";"0.0";"0";"1";"1";"0";"1";"0";"457182";"373894"
"V4mis1";"SILVA (only NR);Eukaryota;Archaeplastida;Rhodophyceae;Florideophycidae;Rhodymeniophycidae;Rissoella;";"0.0";"0";"1";"1";"0";"1";"0";"457182";"373894"
"V4mis1";"SILVA (only NR);Eukaryota;Archaeplastida;Rhodophyceae;Florideophycidae;Rhodymeniophycidae;Sarcodia;";"0.0";"0";"1";"1";"0";"1";"0";"457182";"373894"
"V4mis1";"SILVA (only NR);Eukaryota;Archaeplastida;Rhodophyceae;Florideophycidae;Rhodymeniophycidae;Sarcodiotheca;";"0.0";"0";"2";"2";"0";"2";"0";"457181";"373894"
"V4mis1";"SILVA (only NR);Eukaryota;Archaeplastida;Rhodophyceae;Florideophycidae;Rhodymeniophycidae;Schimmelmannia;";"0.0";"0";"1";"1";"0";"1";"0";"457182";"373894"
"V4mis1";"SILVA (only NR);Eukaryota;Archaeplastida;Rhodophyceae;Florideophycidae;Rhodymeniophycidae;Schmitziella;";"0.0";"0";"1";"1";"0";"1";"0";"457182";"373894"
"V4mis1";"SILVA (only NR);Eukaryota;Archaeplastida;Rhodophyceae;Florideophycidae;Rhodymeniophycidae;Sciurothamnion;";"0.0";"0";"2";"2";"0";"2";"0";"457181";"373894"
"V4mis1";"SILVA (only NR);Eukaryota;Archaeplastida;Rhodophyceae;Florideophycidae;Rhodymeniophycidae;Sebdenia;";"0.0";"0";"2";"2";"0";"2";"0";"457181";"373894"
"V4mis1";"SILVA (only NR);Eukaryota;Archaeplastida;Rhodophyceae;Florideophycidae;Rhodymeniophycidae;Seirospora;";"0.0";"0";"3";"3";"0";"3";"0";"457180";"373894"
"V4mis1";"SILVA (only NR);Eukaryota;Archaeplastida;Rhodophyceae;Florideophycidae;Rhodymeniophycidae;Semnocarpa;";"0.0";"0";"1";"1";"0";"1";"0";"457182";"373894"
"V4mis1";"SILVA (only NR);Eukaryota;Archaeplastida;Rhodophyceae;Florideophycidae;Rhodymeniophycidae;Shepleya;";"0.0";"0";"1";"1";"0";"1";"0";"457182";"373894"
"V4mis1";"SILVA (only NR);Eukaryota;Archaeplastida;Rhodophyceae;Florideophycidae;Rhodymeniophycidae;Sonderella;";"0.0";"0";"1";"1";"0";"1";"0";"457182";"373894"
"V4mis1";"SILVA (only NR);Eukaryota;Archaeplastida;Rhodophyceae;Florideophycidae;Rhodymeniophycidae;Sorella;";"0.0";"0";"1";"1";"0";"1";"0";"457182";"373894"
"V4mis1";"SILVA (only NR);Eukaryota;Archaeplastida;Rhodophyceae;Florideophycidae;Rhodymeniophycidae;Sparlingia;";"0.0";"0";"1";"1";"0";"1";"0";"457182";"373894"
"V4mis1";"SILVA (only NR);Eukaryota;Archaeplastida;Rhodophyceae;Florideophycidae;Rhodymeniophycidae;Spermothamnion;";"0.0";"0";"1";"1";"0";"1";"0";"457182";"373894"
"V4mis1";"SILVA (only NR);Eukaryota;Archaeplastida;Rhodophyceae;Florideophycidae;Rhodymeniophycidae;Sphaerococcus;";"0.0";"0";"1";"1";"0";"1";"0";"457182";"373894"
"V4mis1";"SILVA (only NR);Eukaryota;Archaeplastida;Rhodophyceae;Florideophycidae;Rhodymeniophycidae;Spongoclonium;";"0.0";"0";"1";"1";"0";"1";"0";"457182";"373894"
"V4mis1";"SILVA (only NR);Eukaryota;Archaeplastida;Rhodophyceae;Florideophycidae;Rhodymeniophycidae;Spyridia;";"0.0";"0";"3";"3";"0";"3";"0";"457180";"373894"
"V4mis1";"SILVA (only NR);Eukaryota;Archaeplastida;Rhodophyceae;Florideophycidae;Rhodymeniophycidae;Sterrocladia;";"0.0";"0";"1";"1";"0";"1";"0";"457182";"373894"
"V4mis1";"SILVA (only NR);Eukaryota;Archaeplastida;Rhodophyceae;Florideophycidae;Rhodymeniophycidae;Stictosporum;";"0.0";"0";"1";"1";"0";"1";"0";"457182";"373894"
"V4mis1";"SILVA (only NR);Eukaryota;Archaeplastida;Rhodophyceae;Florideophycidae;Rhodymeniophycidae;Symphyocladia;";"0.0";"0";"2";"2";"0";"2";"0";"457181";"373894"
"V4mis1";"SILVA (only NR);Eukaryota;Archaeplastida;Rhodophyceae;Florideophycidae;Rhodymeniophycidae;Thuretia;";"0.0";"0";"1";"1";"0";"1";"0";"457182";"373894"
"V4mis1";"SILVA (only NR);Eukaryota;Archaeplastida;Rhodophyceae;Florideophycidae;Rhodymeniophycidae;Titanophora;";"0.0";"0";"1";"1";"0";"1";"0";"457182";"373894"
"V4mis1";"SILVA (only NR);Eukaryota;Archaeplastida;Rhodophyceae;Florideophycidae;Rhodymeniophycidae;Trematocarpus;";"0.0";"0";"1";"1";"0";"1";"0";"457182";"373894"
"V4mis1";"SILVA (only NR);Eukaryota;Archaeplastida;Rhodophyceae;Florideophycidae;Rhodymeniophycidae;Tsengia;";"0.0";"0";"1";"1";"0";"1";"0";"457182";"373894"
"V4mis1";"SILVA (only NR);Eukaryota;Archaeplastida;Rhodophyceae;Florideophycidae;Rhodymeniophycidae;Warrenia;";"0.0";"0";"1";"1";"0";"1";"0";"457182";"373894"
"V4mis1";"SILVA (only NR);Eukaryota;Archaeplastida;Rhodophyceae;Florideophycidae;Rhodymeniophycidae;Webervanbossea;";"0.0";"0";"1";"1";"0";"1";"0";"457182";"373894"
"V4mis1";"SILVA (only NR);Eukaryota;Archaeplastida;Rhodophyceae;Florideophycidae;Rhodymeniophycidae;Weeksia;";"0.0";"0";"1";"1";"0";"1";"0";"457182";"373894"
"V4mis1";"SILVA (only NR);Eukaryota;Archaeplastida;Rhodophyceae;Florideophycidae;Rhodymeniophycidae;Wetherbeella;";"0.0";"0";"1";"1";"0";"1";"0";"457182";"373894"
"V4mis1";"SILVA (only NR);Eukaryota;Archaeplastida;Rhodophyceae;Florideophycidae;Rhodymeniophycidae;Womersleyella;";"0.0";"0";"1";"1";"0";"1";"0";"457182";"373894"
"V4mis1";"SILVA (only NR);Eukaryota;Archaeplastida;Rhodophyceae;Florideophycidae;Rhodymeniophycidae;Wrangelia;";"0.0";"0";"6";"6";"0";"6";"0";"457177";"373894"
"V4mis1";"SILVA (only NR);Eukaryota;Archaeplastida;Rhodophyceae;Florideophycidae;Rhodymeniophycidae;Zymurgia;";"0.0";"0";"1";"1";"0";"1";"0";"457182";"373894"
"V4mis1";"SILVA (only NR);Eukaryota;Archaeplastida;Rhodophyceae;Porphyridiophyceae;";"0.0";"0";"8";"8";"0";"8";"0";"457175";"373894"
"V4mis1";"SILVA (only NR);Eukaryota;Archaeplastida;Rhodophyceae;Porphyridiophyceae;Flintiella;";"0.0";"0";"1";"1";"0";"1";"0";"457182";"373894"
"V4mis1";"SILVA (only NR);Eukaryota;Archaeplastida;Rhodophyceae;Porphyridiophyceae;Porphyridium;";"0.0";"0";"6";"6";"0";"6";"0";"457177";"373894"
"V4mis1";"SILVA (only NR);Eukaryota;Archaeplastida;Rhodophyceae;Porphyridiophyceae;Timspurckia;";"0.0";"0";"1";"1";"0";"1";"0";"457182";"373894"
"V4mis1";"SILVA (only NR);Eukaryota;Archaeplastida;Rhodophyceae;Rhodellophyceae;";"0.0";"0";"14";"14";"0";"14";"0";"457169";"373894"
"V4mis1";"SILVA (only NR);Eukaryota;Archaeplastida;Rhodophyceae;Rhodellophyceae;Bulboplastis;";"0.0";"0";"1";"1";"0";"1";"0";"457182";"373894"
"V4mis1";"SILVA (only NR);Eukaryota;Archaeplastida;Rhodophyceae;Rhodellophyceae;Corynoplastis;";"0.0";"0";"1";"1";"0";"1";"0";"457182";"373894"
"V4mis1";"SILVA (only NR);Eukaryota;Archaeplastida;Rhodophyceae;Rhodellophyceae;Dixoniella;";"0.0";"0";"4";"4";"0";"4";"0";"457179";"373894"
"V4mis1";"SILVA (only NR);Eukaryota;Archaeplastida;Rhodophyceae;Rhodellophyceae;Glaucosphaera;";"0.0";"0";"1";"1";"0";"1";"0";"457182";"373894"
"V4mis1";"SILVA (only NR);Eukaryota;Archaeplastida;Rhodophyceae;Rhodellophyceae;Neorhodella;";"0.0";"0";"2";"2";"0";"2";"0";"457181";"373894"
"V4mis1";"SILVA (only NR);Eukaryota;Archaeplastida;Rhodophyceae;Rhodellophyceae;Rhodella;";"0.0";"0";"5";"5";"0";"5";"0";"457178";"373894"
"V4mis1";"SILVA (only NR);Eukaryota;Archaeplastida;Rhodophyceae;Stylonematales;";"0.0";"0";"12";"12";"0";"12";"0";"457171";"373894"
"V4mis1";"SILVA (only NR);Eukaryota;Archaeplastida;Rhodophyceae;Stylonematales;Bangiopsis;";"0.0";"0";"1";"1";"0";"1";"0";"457182";"373894"
"V4mis1";"SILVA (only NR);Eukaryota;Archaeplastida;Rhodophyceae;Stylonematales;Chroodactylon;";"0.0";"0";"2";"2";"0";"2";"0";"457181";"373894"
"V4mis1";"SILVA (only NR);Eukaryota;Archaeplastida;Rhodophyceae;Stylonematales;Purpureofilum;";"0.0";"0";"1";"1";"0";"1";"0";"457182";"373894"
"V4mis1";"SILVA (only NR);Eukaryota;Archaeplastida;Rhodophyceae;Stylonematales;Rhodosorus;";"0.0";"0";"3";"3";"0";"3";"0";"457180";"373894"
"V4mis1";"SILVA (only NR);Eukaryota;Archaeplastida;Rhodophyceae;Stylonematales;Rhodospora;";"0.0";"0";"1";"1";"0";"1";"0";"457182";"373894"
"V4mis1";"SILVA (only NR);Eukaryota;Archaeplastida;Rhodophyceae;Stylonematales;Stylonema;";"0.0";"0";"3";"3";"0";"3";"0";"457180";"373894"
"V4mis1";"SILVA (only NR);Eukaryota;Archaeplastida;Rhodophyceae;Stylonematales;Tsunamia;";"0.0";"0";"1";"1";"0";"1";"0";"457182";"373894"
"V4mis1";"SILVA (only NR);Eukaryota;Cryptophyceae;";"6.3";"18.2";"289";"288";"18";"270";"1";"456895";"373876"
"V4mis1";"SILVA (only NR);Eukaryota;Cryptophyceae;Cryptomonadales;";"8.1";"18.2";"211";"211";"17";"194";"0";"456972";"373877"
"V4mis1";"SILVA (only NR);Eukaryota;Cryptophyceae;Cryptomonadales;Chroomonas;";"0.0";"0";"14";"14";"0";"14";"0";"457169";"373894"
"V4mis1";"SILVA (only NR);Eukaryota;Cryptophyceae;Cryptomonadales;Cryptomonas;";"0.0";"0";"81";"81";"0";"81";"0";"457102";"373894"
"V4mis1";"SILVA (only NR);Eukaryota;Cryptophyceae;Cryptomonadales;Falcomonas;";"0.0";"0";"1";"1";"0";"1";"0";"457182";"373894"
"V4mis1";"SILVA (only NR);Eukaryota;Cryptophyceae;Cryptomonadales;Geminigera;";"0.0";"0";"6";"6";"0";"6";"0";"457177";"373894"
"V4mis1";"SILVA (only NR);Eukaryota;Cryptophyceae;Cryptomonadales;Guillardia;";"0.0";"0";"6";"6";"0";"6";"0";"457177";"373894"
"V4mis1";"SILVA (only NR);Eukaryota;Cryptophyceae;Cryptomonadales;Hanusia;";"0.0";"0";"1";"1";"0";"1";"0";"457182";"373894"
"V4mis1";"SILVA (only NR);Eukaryota;Cryptophyceae;Cryptomonadales;Hemiselmis;";"0.0";"0";"14";"14";"0";"14";"0";"457169";"373894"
"V4mis1";"SILVA (only NR);Eukaryota;Cryptophyceae;Cryptomonadales;Komma;";"0.0";"0";"1";"1";"0";"1";"0";"457182";"373894"
"V4mis1";"SILVA (only NR);Eukaryota;Cryptophyceae;Cryptomonadales;Plagioselmis;";"0.0";"0";"4";"4";"0";"4";"0";"457179";"373894"
"V4mis1";"SILVA (only NR);Eukaryota;Cryptophyceae;Cryptomonadales;Proteomonas;";"0.0";"0";"2";"2";"0";"2";"0";"457181";"373894"
"V4mis1";"SILVA (only NR);Eukaryota;Cryptophyceae;Cryptomonadales;Rhodomonas;";"0.0";"0";"27";"27";"0";"27";"0";"457156";"373894"
"V4mis1";"SILVA (only NR);Eukaryota;Cryptophyceae;Cryptomonadales;Teleaulax;";"39.1";"18.2";"23";"23";"9";"14";"0";"457160";"373885"
"V4mis1";"SILVA (only NR);Eukaryota;Cryptophyceae;Cryptomonadales;uncultured;";"0.0";"0";"6";"6";"0";"6";"0";"457177";"373894"
"V4mis1";"SILVA (only NR);Eukaryota;Cryptophyceae;Goniomonas;";"0.0";"0";"13";"12";"0";"12";"1";"457171";"373894"
"V4mis1";"SILVA (only NR);Eukaryota;Cryptophyceae;Kathablepharidae;";"0.0";"0";"39";"39";"0";"39";"0";"457144";"373894"
"V4mis1";"SILVA (only NR);Eukaryota;Cryptophyceae;Kathablepharidae;Hatena;";"0.0";"0";"2";"2";"0";"2";"0";"457181";"373894"
"V4mis1";"SILVA (only NR);Eukaryota;Cryptophyceae;Kathablepharidae;Katablepharis;";"0.0";"0";"6";"6";"0";"6";"0";"457177";"373894"
"V4mis1";"SILVA (only NR);Eukaryota;Cryptophyceae;Kathablepharidae;Leucocryptos;";"0.0";"0";"13";"13";"0";"13";"0";"457170";"373894"
"V4mis1";"SILVA (only NR);Eukaryota;Cryptophyceae;Kathablepharidae;Roombia;";"0.0";"0";"1";"1";"0";"1";"0";"457182";"373894"
"V4mis1";"SILVA (only NR);Eukaryota;Cryptophyceae;Kathablepharidae;uncultured;";"0.0";"0";"14";"14";"0";"14";"0";"457169";"373894"
"V4mis1";"SILVA (only NR);Eukaryota;Cryptophyceae;uncultured;";"3.8";"18.2";"26";"26";"1";"25";"0";"457157";"373893"
"V4mis1";"SILVA (only NR);Eukaryota;Discoba;";"8.9";"18.1";"1032";"988";"88";"900";"44";"456195";"373806"
"V4mis1";"SILVA (only NR);Eukaryota;Discoba;Discicristata;";"8.1";"18.1";"963";"933";"76";"857";"30";"456250";"373818"
"V4mis1";"SILVA (only NR);Eukaryota;Discoba;Discicristata;Euglenozoa;";"6.4";"18.1";"911";"885";"57";"828";"26";"456298";"373837"
"V4mis1";"SILVA (only NR);Eukaryota;Discoba;Discicristata;Euglenozoa;Diplonemea;";"0.0";"0";"155";"138";"0";"138";"17";"457045";"373894"
"V4mis1";"SILVA (only NR);Eukaryota;Discoba;Discicristata;Euglenozoa;Diplonemea;Diplonema;";"0.0";"0";"9";"9";"0";"9";"0";"457174";"373894"
"V4mis1";"SILVA (only NR);Eukaryota;Discoba;Discicristata;Euglenozoa;Diplonemea;Rhynchopus;";"0.0";"0";"9";"9";"0";"9";"0";"457174";"373894"
"V4mis1";"SILVA (only NR);Eukaryota;Discoba;Discicristata;Euglenozoa;Diplonemea;SCM38C39 marine group;";"0.0";"0";"132";"115";"0";"115";"17";"457068";"373894"
"V4mis1";"SILVA (only NR);Eukaryota;Discoba;Discicristata;Euglenozoa;Euglenida;";"6.1";"18.2";"244";"244";"15";"229";"0";"456939";"373879"
"V4mis1";"SILVA (only NR);Eukaryota;Discoba;Discicristata;Euglenozoa;Euglenida;Aphagea;";"80.0";"18.2";"5";"5";"4";"1";"0";"457178";"373890"
"V4mis1";"SILVA (only NR);Eukaryota;Discoba;Discicristata;Euglenozoa;Euglenida;Aphagea;Distigma;";"0.0";"0";"1";"1";"0";"1";"0";"457182";"373894"
"V4mis1";"SILVA (only NR);Eukaryota;Discoba;Discicristata;Euglenozoa;Euglenida;Aphagea;Gyropaigne;";"100.0";"18.2";"1";"1";"1";"0";"0";"457182";"373893"
"V4mis1";"SILVA (only NR);Eukaryota;Discoba;Discicristata;Euglenozoa;Euglenida;Aphagea;Menoidium;";"100.0";"18.2";"1";"1";"1";"0";"0";"457182";"373893"
"V4mis1";"SILVA (only NR);Eukaryota;Discoba;Discicristata;Euglenozoa;Euglenida;Aphagea;Rhabdomonas;";"100.0";"18.2";"2";"2";"2";"0";"0";"457181";"373892"
"V4mis1";"SILVA (only NR);Eukaryota;Discoba;Discicristata;Euglenozoa;Euglenida;Euglenophyceae;";"0.0";"0";"218";"218";"0";"218";"0";"456965";"373894"
"V4mis1";"SILVA (only NR);Eukaryota;Discoba;Discicristata;Euglenozoa;Euglenida;Euglenophyceae;Euglenea;";"0.0";"0";"218";"218";"0";"218";"0";"456965";"373894"
"V4mis1";"SILVA (only NR);Eukaryota;Discoba;Discicristata;Euglenozoa;Euglenida;Euglenophyceae;Euglenea;Euglenaceae;";"0.0";"0";"97";"97";"0";"97";"0";"457086";"373894"
"V4mis1";"SILVA (only NR);Eukaryota;Discoba;Discicristata;Euglenozoa;Euglenida;Euglenophyceae;Euglenea;Euglenaceae;Colacium;";"0.0";"0";"7";"7";"0";"7";"0";"457176";"373894"
"V4mis1";"SILVA (only NR);Eukaryota;Discoba;Discicristata;Euglenozoa;Euglenida;Euglenophyceae;Euglenea;Euglenaceae;Cryptoglena;";"0.0";"0";"11";"11";"0";"11";"0";"457172";"373894"
"V4mis1";"SILVA (only NR);Eukaryota;Discoba;Discicristata;Euglenozoa;Euglenida;Euglenophyceae;Euglenea;Euglenaceae;Euglena;";"0.0";"0";"29";"29";"0";"29";"0";"457154";"373894"
"V4mis1";"SILVA (only NR);Eukaryota;Discoba;Discicristata;Euglenozoa;Euglenida;Euglenophyceae;Euglenea;Euglenaceae;Euglenaria;";"0.0";"0";"3";"3";"0";"3";"0";"457180";"373894"
"V4mis1";"SILVA (only NR);Eukaryota;Discoba;Discicristata;Euglenozoa;Euglenida;Euglenophyceae;Euglenea;Euglenaceae;Monomorphina;";"0.0";"0";"8";"8";"0";"8";"0";"457175";"373894"
"V4mis1";"SILVA (only NR);Eukaryota;Discoba;Discicristata;Euglenozoa;Euglenida;Euglenophyceae;Euglenea;Euglenaceae;Trachelomonas;";"0.0";"0";"39";"39";"0";"39";"0";"457144";"373894"
"V4mis1";"SILVA (only NR);Eukaryota;Discoba;Discicristata;Euglenozoa;Euglenida;Euglenophyceae;Euglenea;Phacaceae;";"0.0";"0";"110";"110";"0";"110";"0";"457073";"373894"
"V4mis1";"SILVA (only NR);Eukaryota;Discoba;Discicristata;Euglenozoa;Euglenida;Euglenophyceae;Euglenea;Phacaceae;Lepocinclis;";"0.0";"0";"28";"28";"0";"28";"0";"457155";"373894"
"V4mis1";"SILVA (only NR);Eukaryota;Discoba;Discicristata;Euglenozoa;Euglenida;Euglenophyceae;Euglenea;Phacaceae;Phacus;";"0.0";"0";"82";"82";"0";"82";"0";"457101";"373894"
"V4mis1";"SILVA (only NR);Eukaryota;Discoba;Discicristata;Euglenozoa;Euglenida;Euglenophyceae;Euglenea;Strombomonas;";"0.0";"0";"10";"10";"0";"10";"0";"457173";"373894"
"V4mis1";"SILVA (only NR);Eukaryota;Discoba;Discicristata;Euglenozoa;Euglenida;Heteronematina;";"52.4";"18.2";"21";"21";"11";"10";"0";"457162";"373883"
"V4mis1";"SILVA (only NR);Eukaryota;Discoba;Discicristata;Euglenozoa;Euglenida;Heteronematina;Notosolenus;";"100.0";"18.2";"2";"2";"2";"0";"0";"457181";"373892"
"V4mis1";"SILVA (only NR);Eukaryota;Discoba;Discicristata;Euglenozoa;Euglenida;Heteronematina;Petalomonas;";"47.4";"18.2";"19";"19";"9";"10";"0";"457164";"373885"
"V4mis1";"SILVA (only NR);Eukaryota;Discoba;Discicristata;Euglenozoa;Kinetoplastea;";"8.4";"18.1";"510";"501";"42";"459";"9";"456682";"373852"
"V4mis1";"SILVA (only NR);Eukaryota;Discoba;Discicristata;Euglenozoa;Kinetoplastea;Incertae Sedis;";"100.0";"18.2";"2";"2";"2";"0";"0";"457181";"373892"
"V4mis1";"SILVA (only NR);Eukaryota;Discoba;Discicristata;Euglenozoa;Kinetoplastea;Incertae Sedis;Hemistasia;";"100.0";"18.2";"2";"2";"2";"0";"0";"457181";"373892"
"V4mis1";"SILVA (only NR);Eukaryota;Discoba;Discicristata;Euglenozoa;Kinetoplastea;Metakinetoplastina;";"0.2";"18.1";"467";"458";"1";"457";"9";"456725";"373893"
"V4mis1";"SILVA (only NR);Eukaryota;Discoba;Discicristata;Euglenozoa;Kinetoplastea;Metakinetoplastina;Eubodonida;";"0.0";"0";"29";"29";"0";"29";"0";"457154";"373894"
"V4mis1";"SILVA (only NR);Eukaryota;Discoba;Discicristata;Euglenozoa;Kinetoplastea;Metakinetoplastina;Eubodonida;Bodo;";"0.0";"0";"29";"29";"0";"29";"0";"457154";"373894"
"V4mis1";"SILVA (only NR);Eukaryota;Discoba;Discicristata;Euglenozoa;Kinetoplastea;Metakinetoplastina;Neobodonida;";"0.0";"0";"125";"121";"0";"121";"4";"457062";"373894"
"V4mis1";"SILVA (only NR);Eukaryota;Discoba;Discicristata;Euglenozoa;Kinetoplastea;Metakinetoplastina;Neobodonida;Cruzella;";"0.0";"0";"1";"1";"0";"1";"0";"457182";"373894"
"V4mis1";"SILVA (only NR);Eukaryota;Discoba;Discicristata;Euglenozoa;Kinetoplastea;Metakinetoplastina;Neobodonida;Dimastigella;";"0.0";"0";"5";"5";"0";"5";"0";"457178";"373894"
"V4mis1";"SILVA (only NR);Eukaryota;Discoba;Discicristata;Euglenozoa;Kinetoplastea;Metakinetoplastina;Neobodonida;Lake Biwa clade;";"0.0";"0";"2";"0";"0";"0";"2";"457183";"373894"
"V4mis1";"SILVA (only NR);Eukaryota;Discoba;Discicristata;Euglenozoa;Kinetoplastea;Metakinetoplastina;Neobodonida;Neobodo;";"0.0";"0";"83";"81";"0";"81";"2";"457102";"373894"
"V4mis1";"SILVA (only NR);Eukaryota;Discoba;Discicristata;Euglenozoa;Kinetoplastea;Metakinetoplastina;Neobodonida;Rhynchobodo;";"0.0";"0";"12";"12";"0";"12";"0";"457171";"373894"
"V4mis1";"SILVA (only NR);Eukaryota;Discoba;Discicristata;Euglenozoa;Kinetoplastea;Metakinetoplastina;Neobodonida;Rhynchomonas;";"0.0";"0";"19";"19";"0";"19";"0";"457164";"373894"
"V4mis1";"SILVA (only NR);Eukaryota;Discoba;Discicristata;Euglenozoa;Kinetoplastea;Metakinetoplastina;Parabodonida;";"0.0";"0";"24";"24";"0";"24";"0";"457159";"373894"
"V4mis1";"SILVA (only NR);Eukaryota;Discoba;Discicristata;Euglenozoa;Kinetoplastea;Metakinetoplastina;Parabodonida;Cryptobia;";"0.0";"0";"5";"5";"0";"5";"0";"457178";"373894"
"V4mis1";"SILVA (only NR);Eukaryota;Discoba;Discicristata;Euglenozoa;Kinetoplastea;Metakinetoplastina;Parabodonida;Parabodo;";"0.0";"0";"12";"12";"0";"12";"0";"457171";"373894"
"V4mis1";"SILVA (only NR);Eukaryota;Discoba;Discicristata;Euglenozoa;Kinetoplastea;Metakinetoplastina;Trypanosomatida;";"0.4";"18.2";"288";"283";"1";"282";"5";"456900";"373893"
"V4mis1";"SILVA (only NR);Eukaryota;Discoba;Discicristata;Euglenozoa;Kinetoplastea;Metakinetoplastina;Trypanosomatida;Angomonas;";"0.0";"0";"4";"4";"0";"4";"0";"457179";"373894"
"V4mis1";"SILVA (only NR);Eukaryota;Discoba;Discicristata;Euglenozoa;Kinetoplastea;Metakinetoplastina;Trypanosomatida;Blastocrithidia;";"0.0";"0";"10";"10";"0";"10";"0";"457173";"373894"
"V4mis1";"SILVA (only NR);Eukaryota;Discoba;Discicristata;Euglenozoa;Kinetoplastea;Metakinetoplastina;Trypanosomatida;Blechomonas;";"0.0";"0";"6";"6";"0";"6";"0";"457177";"373894"
"V4mis1";"SILVA (only NR);Eukaryota;Discoba;Discicristata;Euglenozoa;Kinetoplastea;Metakinetoplastina;Trypanosomatida;Crithidia;";"0.0";"0";"11";"11";"0";"11";"0";"457172";"373894"
"V4mis1";"SILVA (only NR);Eukaryota;Discoba;Discicristata;Euglenozoa;Kinetoplastea;Metakinetoplastina;Trypanosomatida;Endotrypanum;";"0.0";"0";"11";"11";"0";"11";"0";"457172";"373894"
"V4mis1";"SILVA (only NR);Eukaryota;Discoba;Discicristata;Euglenozoa;Kinetoplastea;Metakinetoplastina;Trypanosomatida;Herpetomonas;";"0.0";"0";"27";"27";"0";"27";"0";"457156";"373894"
"V4mis1";"SILVA (only NR);Eukaryota;Discoba;Discicristata;Euglenozoa;Kinetoplastea;Metakinetoplastina;Trypanosomatida;Jaenimonas;";"0.0";"0";"2";"2";"0";"2";"0";"457181";"373894"
"V4mis1";"SILVA (only NR);Eukaryota;Discoba;Discicristata;Euglenozoa;Kinetoplastea;Metakinetoplastina;Trypanosomatida;Leishmania;";"0.0";"0";"3";"2";"0";"2";"1";"457181";"373894"
"V4mis1";"SILVA (only NR);Eukaryota;Discoba;Discicristata;Euglenozoa;Kinetoplastea;Metakinetoplastina;Trypanosomatida;Leptomonas;";"0.0";"0";"26";"25";"0";"25";"1";"457158";"373894"
"V4mis1";"SILVA (only NR);Eukaryota;Discoba;Discicristata;Euglenozoa;Kinetoplastea;Metakinetoplastina;Trypanosomatida;Paratrypanosoma;";"0.0";"0";"1";"1";"0";"1";"0";"457182";"373894"
"V4mis1";"SILVA (only NR);Eukaryota;Discoba;Discicristata;Euglenozoa;Kinetoplastea;Metakinetoplastina;Trypanosomatida;Phytomonas;";"0.0";"0";"7";"7";"0";"7";"0";"457176";"373894"
"V4mis1";"SILVA (only NR);Eukaryota;Discoba;Discicristata;Euglenozoa;Kinetoplastea;Metakinetoplastina;Trypanosomatida;Sergeia;";"0.0";"0";"2";"2";"0";"2";"0";"457181";"373894"
"V4mis1";"SILVA (only NR);Eukaryota;Discoba;Discicristata;Euglenozoa;Kinetoplastea;Metakinetoplastina;Trypanosomatida;Strigomonas;";"0.0";"0";"5";"5";"0";"5";"0";"457178";"373894"
"V4mis1";"SILVA (only NR);Eukaryota;Discoba;Discicristata;Euglenozoa;Kinetoplastea;Metakinetoplastina;Trypanosomatida;Trypanosoma;";"0.7";"18.2";"139";"136";"1";"135";"3";"457047";"373893"
"V4mis1";"SILVA (only NR);Eukaryota;Discoba;Discicristata;Euglenozoa;Kinetoplastea;Metakinetoplastina;Trypanosomatida;Wallaceina;";"0.0";"0";"1";"1";"0";"1";"0";"457182";"373894"
"V4mis1";"SILVA (only NR);Eukaryota;Discoba;Discicristata;Euglenozoa;Kinetoplastea;Metakinetoplastina;Trypanosomatida;Zelonia;";"0.0";"0";"1";"1";"0";"1";"0";"457182";"373894"
"V4mis1";"SILVA (only NR);Eukaryota;Discoba;Discicristata;Euglenozoa;Kinetoplastea;Prokinetoplastina;";"97.5";"18.2";"40";"40";"39";"1";"0";"457143";"373855"
"V4mis1";"SILVA (only NR);Eukaryota;Discoba;Discicristata;Euglenozoa;Kinetoplastea;Prokinetoplastina;Ichthyobodo;";"97.5";"18.2";"40";"40";"39";"1";"0";"457143";"373855"
"V4mis1";"SILVA (only NR);Eukaryota;Discoba;Discicristata;Heterolobosea;";"39.6";"18.2";"52";"48";"19";"29";"4";"457135";"373875"
"V4mis1";"SILVA (only NR);Eukaryota;Discoba;Discicristata;Heterolobosea;Tetramitia;";"39.6";"18.2";"52";"48";"19";"29";"4";"457135";"373875"
"V4mis1";"SILVA (only NR);Eukaryota;Discoba;Discicristata;Heterolobosea;Tetramitia;Allovahlkampfia;";"75.0";"18.2";"4";"4";"3";"1";"0";"457179";"373891"
"V4mis1";"SILVA (only NR);Eukaryota;Discoba;Discicristata;Heterolobosea;Tetramitia;Learamoeba;";"0.0";"0";"1";"1";"0";"1";"0";"457182";"373894"
"V4mis1";"SILVA (only NR);Eukaryota;Discoba;Discicristata;Heterolobosea;Tetramitia;Naegleria;";"70.0";"18.2";"21";"20";"14";"6";"1";"457163";"373880"
"V4mis1";"SILVA (only NR);Eukaryota;Discoba;Discicristata;Heterolobosea;Tetramitia;Neovahlkampfia;";"100.0";"18.2";"2";"2";"2";"0";"0";"457181";"373892"
"V4mis1";"SILVA (only NR);Eukaryota;Discoba;Discicristata;Heterolobosea;Tetramitia;Psalteriomonas;";"0.0";"0";"4";"4";"0";"4";"0";"457179";"373894"
"V4mis1";"SILVA (only NR);Eukaryota;Discoba;Discicristata;Heterolobosea;Tetramitia;Sawyeria;";"0.0";"0";"1";"1";"0";"1";"0";"457182";"373894"
"V4mis1";"SILVA (only NR);Eukaryota;Discoba;Discicristata;Heterolobosea;Tetramitia;Singhamoeba;";"0.0";"0";"2";"2";"0";"2";"0";"457181";"373894"
"V4mis1";"SILVA (only NR);Eukaryota;Discoba;Discicristata;Heterolobosea;Tetramitia;Tetramitus;";"0.0";"0";"8";"7";"0";"7";"1";"457176";"373894"
"V4mis1";"SILVA (only NR);Eukaryota;Discoba;Discicristata;Heterolobosea;Tetramitia;Vahlkampfia;";"0.0";"0";"4";"4";"0";"4";"0";"457179";"373894"
"V4mis1";"SILVA (only NR);Eukaryota;Discoba;Jakobida;";"24.0";"18.2";"64";"50";"12";"38";"14";"457133";"373882"
"V4mis1";"SILVA (only NR);Eukaryota;Discoba;Jakobida;Andalucia;";"44.4";"18.2";"38";"27";"12";"15";"11";"457156";"373882"
"V4mis1";"SILVA (only NR);Eukaryota;Discoba;Jakobida;Jakoba;";"0.0";"0";"2";"2";"0";"2";"0";"457181";"373894"
"V4mis1";"SILVA (only NR);Eukaryota;Discoba;Jakobida;Moramonas;";"0.0";"0";"1";"1";"0";"1";"0";"457182";"373894"
"V4mis1";"SILVA (only NR);Eukaryota;Discoba;Jakobida;RM1-SGM49;";"0.0";"0";"5";"4";"0";"4";"1";"457179";"373894"
"V4mis1";"SILVA (only NR);Eukaryota;Discoba;Jakobida;Reclinomonas;";"0.0";"0";"3";"3";"0";"3";"0";"457180";"373894"
"V4mis1";"SILVA (only NR);Eukaryota;Discoba;Jakobida;Seculamonas;";"0.0";"0";"1";"1";"0";"1";"0";"457182";"373894"
"V4mis1";"SILVA (only NR);Eukaryota;Discoba;Jakobida;uncultured;";"0.0";"0";"4";"4";"0";"4";"0";"457179";"373894"
"V4mis1";"SILVA (only NR);Eukaryota;Discoba;Malawimonas;";"0.0";"0";"1";"1";"0";"1";"0";"457182";"373894"
"V4mis1";"SILVA (only NR);Eukaryota;Excavata;";"13.8";"18.2";"389";"383";"53";"330";"6";"456800";"373841"
"V4mis1";"SILVA (only NR);Eukaryota;Excavata;Metamonada;";"13.8";"18.2";"389";"383";"53";"330";"6";"456800";"373841"
"V4mis1";"SILVA (only NR);Eukaryota;Excavata;Metamonada;Fornicata;";"0.0";"0";"21";"21";"0";"21";"0";"457162";"373894"
"V4mis1";"SILVA (only NR);Eukaryota;Excavata;Metamonada;Fornicata;Carpediomonas-like organisms;";"0.0";"0";"10";"10";"0";"10";"0";"457173";"373894"
"V4mis1";"SILVA (only NR);Eukaryota;Excavata;Metamonada;Fornicata;Carpediomonas-like organisms;Carpediemonas;";"0.0";"0";"3";"3";"0";"3";"0";"457180";"373894"
"V4mis1";"SILVA (only NR);Eukaryota;Excavata;Metamonada;Fornicata;Carpediomonas-like organisms;Dysnectes;";"0.0";"0";"2";"2";"0";"2";"0";"457181";"373894"
"V4mis1";"SILVA (only NR);Eukaryota;Excavata;Metamonada;Fornicata;Carpediomonas-like organisms;Ergobibamus;";"0.0";"0";"2";"2";"0";"2";"0";"457181";"373894"
"V4mis1";"SILVA (only NR);Eukaryota;Excavata;Metamonada;Fornicata;Diplomonadida;";"0.0";"0";"11";"11";"0";"11";"0";"457172";"373894"
"V4mis1";"SILVA (only NR);Eukaryota;Excavata;Metamonada;Fornicata;Diplomonadida;Giardiinae;";"0.0";"0";"11";"11";"0";"11";"0";"457172";"373894"
"V4mis1";"SILVA (only NR);Eukaryota;Excavata;Metamonada;Fornicata;Diplomonadida;Giardiinae;Giardia;";"0.0";"0";"11";"11";"0";"11";"0";"457172";"373894"
"V4mis1";"SILVA (only NR);Eukaryota;Excavata;Metamonada;Parabasalia;";"15.5";"18.2";"342";"342";"53";"289";"0";"456841";"373841"
"V4mis1";"SILVA (only NR);Eukaryota;Excavata;Metamonada;Parabasalia;Cristamonadea;";"3.3";"18.2";"60";"60";"2";"58";"0";"457123";"373892"
"V4mis1";"SILVA (only NR);Eukaryota;Excavata;Metamonada;Parabasalia;Cristamonadea;Calonympha;";"0.0";"0";"4";"4";"0";"4";"0";"457179";"373894"
"V4mis1";"SILVA (only NR);Eukaryota;Excavata;Metamonada;Parabasalia;Cristamonadea;Coronympha;";"0.0";"0";"4";"4";"0";"4";"0";"457179";"373894"
"V4mis1";"SILVA (only NR);Eukaryota;Excavata;Metamonada;Parabasalia;Cristamonadea;Deltotrichonympha;";"0.0";"0";"1";"1";"0";"1";"0";"457182";"373894"
"V4mis1";"SILVA (only NR);Eukaryota;Excavata;Metamonada;Parabasalia;Cristamonadea;Devescovina;";"0.0";"0";"15";"15";"0";"15";"0";"457168";"373894"
"V4mis1";"SILVA (only NR);Eukaryota;Excavata;Metamonada;Parabasalia;Cristamonadea;Foaina;";"0.0";"0";"4";"4";"0";"4";"0";"457179";"373894"
"V4mis1";"SILVA (only NR);Eukaryota;Excavata;Metamonada;Parabasalia;Cristamonadea;Gigantomonas;";"0.0";"0";"1";"1";"0";"1";"0";"457182";"373894"
"V4mis1";"SILVA (only NR);Eukaryota;Excavata;Metamonada;Parabasalia;Cristamonadea;Joenia;";"0.0";"0";"3";"3";"0";"3";"0";"457180";"373894"
"V4mis1";"SILVA (only NR);Eukaryota;Excavata;Metamonada;Parabasalia;Cristamonadea;Joenoides;";"0.0";"0";"1";"1";"0";"1";"0";"457182";"373894"
"V4mis1";"SILVA (only NR);Eukaryota;Excavata;Metamonada;Parabasalia;Cristamonadea;Kofoidia;";"0.0";"0";"2";"2";"0";"2";"0";"457181";"373894"
"V4mis1";"SILVA (only NR);Eukaryota;Excavata;Metamonada;Parabasalia;Cristamonadea;Koruga;";"0.0";"0";"1";"1";"0";"1";"0";"457182";"373894"
"V4mis1";"SILVA (only NR);Eukaryota;Excavata;Metamonada;Parabasalia;Cristamonadea;Lophomonas;";"0.0";"0";"1";"1";"0";"1";"0";"457182";"373894"
"V4mis1";"SILVA (only NR);Eukaryota;Excavata;Metamonada;Parabasalia;Cristamonadea;Metadevescovina;";"0.0";"0";"9";"9";"0";"9";"0";"457174";"373894"
"V4mis1";"SILVA (only NR);Eukaryota;Excavata;Metamonada;Parabasalia;Cristamonadea;Mixotricha;";"0.0";"0";"1";"1";"0";"1";"0";"457182";"373894"
"V4mis1";"SILVA (only NR);Eukaryota;Excavata;Metamonada;Parabasalia;Cristamonadea;Nk3 symbiont group;";"100.0";"18.2";"2";"2";"2";"0";"0";"457181";"373892"
"V4mis1";"SILVA (only NR);Eukaryota;Excavata;Metamonada;Parabasalia;Cristamonadea;Snyderella;";"0.0";"0";"4";"4";"0";"4";"0";"457179";"373894"
"V4mis1";"SILVA (only NR);Eukaryota;Excavata;Metamonada;Parabasalia;Cristamonadea;Stephanonympha;";"0.0";"0";"2";"2";"0";"2";"0";"457181";"373894"
"V4mis1";"SILVA (only NR);Eukaryota;Excavata;Metamonada;Parabasalia;Cryptotermes symbiont group;";"0.0";"0";"22";"22";"0";"22";"0";"457161";"373894"
"V4mis1";"SILVA (only NR);Eukaryota;Excavata;Metamonada;Parabasalia;Gf10 symbiont group;";"0.0";"0";"4";"4";"0";"4";"0";"457179";"373894"
"V4mis1";"SILVA (only NR);Eukaryota;Excavata;Metamonada;Parabasalia;Hypotrichomonadea;";"0.0";"0";"17";"17";"0";"17";"0";"457166";"373894"
"V4mis1";"SILVA (only NR);Eukaryota;Excavata;Metamonada;Parabasalia;Hypotrichomonadea;Hypotrichomonas;";"0.0";"0";"13";"13";"0";"13";"0";"457170";"373894"
"V4mis1";"SILVA (only NR);Eukaryota;Excavata;Metamonada;Parabasalia;Hypotrichomonadea;Trichomitus;";"0.0";"0";"4";"4";"0";"4";"0";"457179";"373894"
"V4mis1";"SILVA (only NR);Eukaryota;Excavata;Metamonada;Parabasalia;Spirotrichonymphea;";"0.0";"0";"36";"36";"0";"36";"0";"457147";"373894"
"V4mis1";"SILVA (only NR);Eukaryota;Excavata;Metamonada;Parabasalia;Spirotrichonymphea;Holomastigotoides;";"0.0";"0";"12";"12";"0";"12";"0";"457171";"373894"
"V4mis1";"SILVA (only NR);Eukaryota;Excavata;Metamonada;Parabasalia;Spirotrichonymphea;Spirotrichonympha;";"0.0";"0";"3";"3";"0";"3";"0";"457180";"373894"
"V4mis1";"SILVA (only NR);Eukaryota;Excavata;Metamonada;Parabasalia;Spirotrichonymphea;pool A symbiont group;";"0.0";"0";"18";"18";"0";"18";"0";"457165";"373894"
"V4mis1";"SILVA (only NR);Eukaryota;Excavata;Metamonada;Parabasalia;Trichomonadea;";"0.0";"0";"74";"74";"0";"74";"0";"457109";"373894"
"V4mis1";"SILVA (only NR);Eukaryota;Excavata;Metamonada;Parabasalia;Trichomonadea;Cochlosoma;";"0.0";"0";"1";"1";"0";"1";"0";"457182";"373894"
"V4mis1";"SILVA (only NR);Eukaryota;Excavata;Metamonada;Parabasalia;Trichomonadea;Ditrichomonas;";"0.0";"0";"2";"2";"0";"2";"0";"457181";"373894"
"V4mis1";"SILVA (only NR);Eukaryota;Excavata;Metamonada;Parabasalia;Trichomonadea;Hexamastix;";"0.0";"0";"5";"5";"0";"5";"0";"457178";"373894"
"V4mis1";"SILVA (only NR);Eukaryota;Excavata;Metamonada;Parabasalia;Trichomonadea;Honigbergiella;";"0.0";"0";"1";"1";"0";"1";"0";"457182";"373894"
"V4mis1";"SILVA (only NR);Eukaryota;Excavata;Metamonada;Parabasalia;Trichomonadea;Lacusteria;";"0.0";"0";"1";"1";"0";"1";"0";"457182";"373894"
"V4mis1";"SILVA (only NR);Eukaryota;Excavata;Metamonada;Parabasalia;Trichomonadea;Pentatrichomonas;";"0.0";"0";"2";"2";"0";"2";"0";"457181";"373894"
"V4mis1";"SILVA (only NR);Eukaryota;Excavata;Metamonada;Parabasalia;Trichomonadea;Pentatrichomonoides;";"0.0";"0";"1";"1";"0";"1";"0";"457182";"373894"
"V4mis1";"SILVA (only NR);Eukaryota;Excavata;Metamonada;Parabasalia;Trichomonadea;Pseudotrichomonas;";"0.0";"0";"2";"2";"0";"2";"0";"457181";"373894"
"V4mis1";"SILVA (only NR);Eukaryota;Excavata;Metamonada;Parabasalia;Trichomonadea;Pseudotrypanosoma;";"0.0";"0";"1";"1";"0";"1";"0";"457182";"373894"
"V4mis1";"SILVA (only NR);Eukaryota;Excavata;Metamonada;Parabasalia;Trichomonadea;Simplicimonas;";"0.0";"0";"6";"6";"0";"6";"0";"457177";"373894"
"V4mis1";"SILVA (only NR);Eukaryota;Excavata;Metamonada;Parabasalia;Trichomonadea;Tetratrichomonas;";"0.0";"0";"28";"28";"0";"28";"0";"457155";"373894"
"V4mis1";"SILVA (only NR);Eukaryota;Excavata;Metamonada;Parabasalia;Trichomonadea;Trichomitopsis;";"0.0";"0";"5";"5";"0";"5";"0";"457178";"373894"
"V4mis1";"SILVA (only NR);Eukaryota;Excavata;Metamonada;Parabasalia;Trichomonadea;Trichomonas;";"0.0";"0";"14";"14";"0";"14";"0";"457169";"373894"
"V4mis1";"SILVA (only NR);Eukaryota;Excavata;Metamonada;Parabasalia;Trichonymphea;";"38.1";"18.2";"97";"97";"37";"60";"0";"457086";"373857"
"V4mis1";"SILVA (only NR);Eukaryota;Excavata;Metamonada;Parabasalia;Trichonymphea;Barbulanympha;";"0.0";"0";"5";"5";"0";"5";"0";"457178";"373894"
"V4mis1";"SILVA (only NR);Eukaryota;Excavata;Metamonada;Parabasalia;Trichonymphea;Eucomonympha;";"100.0";"18.2";"4";"4";"4";"0";"0";"457179";"373890"
"V4mis1";"SILVA (only NR);Eukaryota;Excavata;Metamonada;Parabasalia;Trichonymphea;Pseudotrichonympha;";"100.0";"18.2";"23";"23";"23";"0";"0";"457160";"373871"
"V4mis1";"SILVA (only NR);Eukaryota;Excavata;Metamonada;Parabasalia;Trichonymphea;Staurojoenia;";"66.7";"18.2";"3";"3";"2";"1";"0";"457180";"373892"
"V4mis1";"SILVA (only NR);Eukaryota;Excavata;Metamonada;Parabasalia;Trichonymphea;Teranympha;";"58.3";"18.2";"12";"12";"7";"5";"0";"457171";"373887"
"V4mis1";"SILVA (only NR);Eukaryota;Excavata;Metamonada;Parabasalia;Trichonymphea;Trichonympha;";"0.0";"0";"47";"47";"0";"47";"0";"457136";"373894"
"V4mis1";"SILVA (only NR);Eukaryota;Excavata;Metamonada;Parabasalia;Tritrichomonadea;";"0.0";"0";"15";"15";"0";"15";"0";"457168";"373894"
"V4mis1";"SILVA (only NR);Eukaryota;Excavata;Metamonada;Parabasalia;Tritrichomonadea;Dientamoeba;";"0.0";"0";"1";"1";"0";"1";"0";"457182";"373894"
"V4mis1";"SILVA (only NR);Eukaryota;Excavata;Metamonada;Parabasalia;Tritrichomonadea;Histomonas;";"0.0";"0";"1";"1";"0";"1";"0";"457182";"373894"
"V4mis1";"SILVA (only NR);Eukaryota;Excavata;Metamonada;Parabasalia;Tritrichomonadea;Monocercomonas;";"0.0";"0";"5";"5";"0";"5";"0";"457178";"373894"
"V4mis1";"SILVA (only NR);Eukaryota;Excavata;Metamonada;Parabasalia;Tritrichomonadea;Parahistomonas;";"0.0";"0";"2";"2";"0";"2";"0";"457181";"373894"
"V4mis1";"SILVA (only NR);Eukaryota;Excavata;Metamonada;Parabasalia;Tritrichomonadea;Tritrichomonas;";"0.0";"0";"6";"6";"0";"6";"0";"457177";"373894"
"V4mis1";"SILVA (only NR);Eukaryota;Excavata;Metamonada;Parabasalia;uncultured;";"80.0";"18.2";"5";"5";"4";"1";"0";"457178";"373890"
"V4mis1";"SILVA (only NR);Eukaryota;Excavata;Metamonada;Preaxostyla;";"0.0";"0";"26";"20";"0";"20";"6";"457163";"373894"
"V4mis1";"SILVA (only NR);Eukaryota;Excavata;Metamonada;Preaxostyla;Oxymonadida;";"0.0";"0";"18";"12";"0";"12";"6";"457171";"373894"
"V4mis1";"SILVA (only NR);Eukaryota;Excavata;Metamonada;Preaxostyla;Oxymonadida;Blattamonas;";"0.0";"0";"4";"4";"0";"4";"0";"457179";"373894"
"V4mis1";"SILVA (only NR);Eukaryota;Excavata;Metamonada;Preaxostyla;Oxymonadida;Dinenympha;";"0.0";"0";"5";"3";"0";"3";"2";"457180";"373894"
"V4mis1";"SILVA (only NR);Eukaryota;Excavata;Metamonada;Preaxostyla;Oxymonadida;Pyrsonympha;";"0.0";"0";"2";"0";"0";"0";"2";"457183";"373894"
"V4mis1";"SILVA (only NR);Eukaryota;Excavata;Metamonada;Preaxostyla;Oxymonadida;Saccinobaculus;";"0.0";"0";"2";"2";"0";"2";"0";"457181";"373894"
"V4mis1";"SILVA (only NR);Eukaryota;Excavata;Metamonada;Preaxostyla;Paratrimastix;";"0.0";"0";"5";"5";"0";"5";"0";"457178";"373894"
"V4mis1";"SILVA (only NR);Eukaryota;Excavata;Metamonada;Preaxostyla;Trimastix;";"0.0";"0";"3";"3";"0";"3";"0";"457180";"373894"
"V4mis1";"SILVA (only NR);Eukaryota;Haptophyta;";"0.0";"0";"228";"221";"0";"221";"7";"456962";"373894"
"V4mis1";"SILVA (only NR);Eukaryota;Haptophyta;Pav3;";"0.0";"0";"2";"2";"0";"2";"0";"457181";"373894"
"V4mis1";"SILVA (only NR);Eukaryota;Haptophyta;Pavlovophyceae;";"0.0";"0";"38";"37";"0";"37";"1";"457146";"373894"
"V4mis1";"SILVA (only NR);Eukaryota;Haptophyta;Pavlovophyceae;AA5F1;";"0.0";"0";"4";"3";"0";"3";"1";"457180";"373894"
"V4mis1";"SILVA (only NR);Eukaryota;Haptophyta;Pavlovophyceae;Diacronema;";"0.0";"0";"9";"9";"0";"9";"0";"457174";"373894"
"V4mis1";"SILVA (only NR);Eukaryota;Haptophyta;Pavlovophyceae;Exanthemachrysis;";"0.0";"0";"5";"5";"0";"5";"0";"457178";"373894"
"V4mis1";"SILVA (only NR);Eukaryota;Haptophyta;Pavlovophyceae;Pavlova;";"0.0";"0";"12";"12";"0";"12";"0";"457171";"373894"
"V4mis1";"SILVA (only NR);Eukaryota;Haptophyta;Pavlovophyceae;Rebecca;";"0.0";"0";"6";"6";"0";"6";"0";"457177";"373894"
"V4mis1";"SILVA (only NR);Eukaryota;Haptophyta;Prymnesiophyceae;";"0.0";"0";"173";"169";"0";"169";"4";"457014";"373894"
"V4mis1";"SILVA (only NR);Eukaryota;Haptophyta;Prymnesiophyceae;Coccolithales;";"0.0";"0";"22";"22";"0";"22";"0";"457161";"373894"
"V4mis1";"SILVA (only NR);Eukaryota;Haptophyta;Prymnesiophyceae;Coccolithales;Algirosphaera;";"0.0";"0";"1";"1";"0";"1";"0";"457182";"373894"
"V4mis1";"SILVA (only NR);Eukaryota;Haptophyta;Prymnesiophyceae;Coccolithales;Coccolithus;";"0.0";"0";"1";"1";"0";"1";"0";"457182";"373894"
"V4mis1";"SILVA (only NR);Eukaryota;Haptophyta;Prymnesiophyceae;Coccolithales;Coronosphaera;";"0.0";"0";"2";"2";"0";"2";"0";"457181";"373894"
"V4mis1";"SILVA (only NR);Eukaryota;Haptophyta;Prymnesiophyceae;Coccolithales;Cruciplacolithus;";"0.0";"0";"1";"1";"0";"1";"0";"457182";"373894"
"V4mis1";"SILVA (only NR);Eukaryota;Haptophyta;Prymnesiophyceae;Coccolithales;Hymenomonas;";"0.0";"0";"1";"1";"0";"1";"0";"457182";"373894"
"V4mis1";"SILVA (only NR);Eukaryota;Haptophyta;Prymnesiophyceae;Coccolithales;Jomonlithus;";"0.0";"0";"1";"1";"0";"1";"0";"457182";"373894"
"V4mis1";"SILVA (only NR);Eukaryota;Haptophyta;Prymnesiophyceae;Coccolithales;Pleurochrysis;";"0.0";"0";"4";"4";"0";"4";"0";"457179";"373894"
"V4mis1";"SILVA (only NR);Eukaryota;Haptophyta;Prymnesiophyceae;Coccolithales;Reticulosphaera;";"0.0";"0";"2";"2";"0";"2";"0";"457181";"373894"
"V4mis1";"SILVA (only NR);Eukaryota;Haptophyta;Prymnesiophyceae;Coccolithales;Tergestiella;";"0.0";"0";"1";"1";"0";"1";"0";"457182";"373894"
"V4mis1";"SILVA (only NR);Eukaryota;Haptophyta;Prymnesiophyceae;Coccolithales;Umbilicosphaera;";"0.0";"0";"2";"2";"0";"2";"0";"457181";"373894"
"V4mis1";"SILVA (only NR);Eukaryota;Haptophyta;Prymnesiophyceae;Isochrysidales;";"0.0";"0";"14";"14";"0";"14";"0";"457169";"373894"
"V4mis1";"SILVA (only NR);Eukaryota;Haptophyta;Prymnesiophyceae;Isochrysidales;ESS2202;";"0.0";"0";"2";"2";"0";"2";"0";"457181";"373894"
"V4mis1";"SILVA (only NR);Eukaryota;Haptophyta;Prymnesiophyceae;Isochrysidales;Emiliania;";"0.0";"0";"2";"2";"0";"2";"0";"457181";"373894"
"V4mis1";"SILVA (only NR);Eukaryota;Haptophyta;Prymnesiophyceae;Isochrysidales;Isochrysis;";"0.0";"0";"10";"10";"0";"10";"0";"457173";"373894"
"V4mis1";"SILVA (only NR);Eukaryota;Haptophyta;Prymnesiophyceae;Phaeocystis;";"0.0";"0";"14";"14";"0";"14";"0";"457169";"373894"
"V4mis1";"SILVA (only NR);Eukaryota;Haptophyta;Prymnesiophyceae;Prymnesiales;";"0.0";"0";"116";"112";"0";"112";"4";"457071";"373894"
"V4mis1";"SILVA (only NR);Eukaryota;Haptophyta;Prymnesiophyceae;Prymnesiales;AI5F14RJ2A07;";"0.0";"0";"3";"1";"0";"1";"2";"457182";"373894"
"V4mis1";"SILVA (only NR);Eukaryota;Haptophyta;Prymnesiophyceae;Prymnesiales;Chrysocampanula;";"0.0";"0";"3";"3";"0";"3";"0";"457180";"373894"
"V4mis1";"SILVA (only NR);Eukaryota;Haptophyta;Prymnesiophyceae;Prymnesiales;Chrysochromulina;";"0.0";"0";"33";"33";"0";"33";"0";"457150";"373894"
"V4mis1";"SILVA (only NR);Eukaryota;Haptophyta;Prymnesiophyceae;Prymnesiales;Chrysoculter;";"0.0";"0";"6";"5";"0";"5";"1";"457178";"373894"
"V4mis1";"SILVA (only NR);Eukaryota;Haptophyta;Prymnesiophyceae;Prymnesiales;Haptolina;";"0.0";"0";"5";"5";"0";"5";"0";"457178";"373894"
"V4mis1";"SILVA (only NR);Eukaryota;Haptophyta;Prymnesiophyceae;Prymnesiales;Helicosphaera;";"0.0";"0";"1";"1";"0";"1";"0";"457182";"373894"
"V4mis1";"SILVA (only NR);Eukaryota;Haptophyta;Prymnesiophyceae;Prymnesiales;Imantonia;";"0.0";"0";"2";"2";"0";"2";"0";"457181";"373894"
"V4mis1";"SILVA (only NR);Eukaryota;Haptophyta;Prymnesiophyceae;Prymnesiales;OLI16029;";"0.0";"0";"21";"21";"0";"21";"0";"457162";"373894"
"V4mis1";"SILVA (only NR);Eukaryota;Haptophyta;Prymnesiophyceae;Prymnesiales;OLI51059;";"0.0";"0";"5";"5";"0";"5";"0";"457178";"373894"
"V4mis1";"SILVA (only NR);Eukaryota;Haptophyta;Prymnesiophyceae;Prymnesiales;Prymnesium;";"0.0";"0";"18";"18";"0";"18";"0";"457165";"373894"
"V4mis1";"SILVA (only NR);Eukaryota;Haptophyta;Prymnesiophyceae;Prymnesiales;Pseudohaptolina;";"0.0";"0";"2";"2";"0";"2";"0";"457181";"373894"
"V4mis1";"SILVA (only NR);Eukaryota;Haptophyta;Prymnesiophyceae;Prymnesiales;Scyphosphaera;";"0.0";"0";"1";"1";"0";"1";"0";"457182";"373894"
"V4mis1";"SILVA (only NR);Eukaryota;Haptophyta;Prymnesiophyceae;Prymnesiales;uncultured;";"0.0";"0";"3";"2";"0";"2";"1";"457181";"373894"
"V4mis1";"SILVA (only NR);Eukaryota;Haptophyta;Prymnesiophyceae;SGUH624;";"0.0";"0";"3";"3";"0";"3";"0";"457180";"373894"
"V4mis1";"SILVA (only NR);Eukaryota;Haptophyta;Prymnesiophyceae;uncultured;";"0.0";"0";"2";"2";"0";"2";"0";"457181";"373894"
"V4mis1";"SILVA (only NR);Eukaryota;Haptophyta;T58;";"0.0";"0";"3";"2";"0";"2";"1";"457181";"373894"
"V4mis1";"SILVA (only NR);Eukaryota;Haptophyta;uncultured;";"0.0";"0";"2";"2";"0";"2";"0";"457181";"373894"
"V4mis1";"SILVA (only NR);Eukaryota;Incertae Sedis;";"0.9";"18.2";"117";"114";"1";"113";"3";"457069";"373893"
"V4mis1";"SILVA (only NR);Eukaryota;Incertae Sedis;Ancyromonadida;";"9.1";"18.2";"11";"11";"1";"10";"0";"457172";"373893"
"V4mis1";"SILVA (only NR);Eukaryota;Incertae Sedis;Ancyromonadida;Ancyromonas;";"0.0";"0";"4";"4";"0";"4";"0";"457179";"373894"
"V4mis1";"SILVA (only NR);Eukaryota;Incertae Sedis;Ancyromonadida;Nutomonas;";"0.0";"0";"1";"1";"0";"1";"0";"457182";"373894"
"V4mis1";"SILVA (only NR);Eukaryota;Incertae Sedis;Apusomonadidae;";"0.0";"0";"8";"8";"0";"8";"0";"457175";"373894"
"V4mis1";"SILVA (only NR);Eukaryota;Incertae Sedis;Apusomonadidae;Amastigomonas;";"0.0";"0";"6";"6";"0";"6";"0";"457177";"373894"
"V4mis1";"SILVA (only NR);Eukaryota;Incertae Sedis;Apusomonadidae;Chelonemonas;";"0.0";"0";"2";"2";"0";"2";"0";"457181";"373894"
"V4mis1";"SILVA (only NR);Eukaryota;Incertae Sedis;Mantamonas;";"0.0";"0";"4";"4";"0";"4";"0";"457179";"373894"
"V4mis1";"SILVA (only NR);Eukaryota;Incertae Sedis;Palpitomonas;";"0.0";"0";"13";"13";"0";"13";"0";"457170";"373894"
"V4mis1";"SILVA (only NR);Eukaryota;Incertae Sedis;Palustrimonas;";"0.0";"0";"1";"1";"0";"1";"0";"457182";"373894"
"V4mis1";"SILVA (only NR);Eukaryota;Incertae Sedis;Telonema;";"0.0";"0";"78";"75";"0";"75";"3";"457108";"373894"
"V4mis1";"SILVA (only NR);Eukaryota;NAMAKO-1;";"0.0";"0";"3";"3";"0";"3";"0";"457180";"373894"
"V4mis1";"SILVA (only NR);Eukaryota;Picozoa;";"0.0";"0";"34";"34";"0";"34";"0";"457149";"373894"
"V4mis1";"SILVA (only NR);Eukaryota;Picozoa;Picomonadida;";"0.0";"0";"17";"17";"0";"17";"0";"457166";"373894"
"V4mis1";"SILVA (only NR);Eukaryota;Picozoa;Picomonadida;Picomonadidae;";"0.0";"0";"6";"6";"0";"6";"0";"457177";"373894"
"V4mis1";"SILVA (only NR);Eukaryota;Picozoa;Picomonadida;Picomonadidae;Picomonas;";"0.0";"0";"6";"6";"0";"6";"0";"457177";"373894"
"V4mis1";"SILVA (only NR);Eukaryota;SA1-3C06;";"0.0";"0";"4";"4";"0";"4";"0";"457179";"373894"
"V4mis1";"SILVA (only NR);Eukaryota;SAR;";"5.0";"15.7";"15220";"14610";"724";"13886";"610";"442573";"373170"
"V4mis1";"SILVA (only NR);Eukaryota;SAR;Alveolata;";"3.2";"16.7";"9140";"8922";"288";"8634";"218";"448261";"373606"
"V4mis1";"SILVA (only NR);Eukaryota;SAR;Alveolata;Acavomonidia;";"0.0";"0";"1";"1";"0";"1";"0";"457182";"373894"
"V4mis1";"SILVA (only NR);Eukaryota;SAR;Alveolata;Acavomonidia;Acavomonas;";"0.0";"0";"1";"1";"0";"1";"0";"457182";"373894"
"V4mis1";"SILVA (only NR);Eukaryota;SAR;Alveolata;Apicomplexa;";"5.4";"18";"1206";"1197";"65";"1132";"9";"455986";"373829"
"V4mis1";"SILVA (only NR);Eukaryota;SAR;Alveolata;Apicomplexa;Aconoidasida;";"0.0";"0";"487";"483";"0";"483";"4";"456700";"373894"
"V4mis1";"SILVA (only NR);Eukaryota;SAR;Alveolata;Apicomplexa;Aconoidasida;Haemosporoidia;";"0.0";"0";"198";"194";"0";"194";"4";"456989";"373894"
"V4mis1";"SILVA (only NR);Eukaryota;SAR;Alveolata;Apicomplexa;Aconoidasida;Haemosporoidia;Plasmodium;";"0.0";"0";"198";"194";"0";"194";"4";"456989";"373894"
"V4mis1";"SILVA (only NR);Eukaryota;SAR;Alveolata;Apicomplexa;Aconoidasida;Piroplasmorida;";"0.0";"0";"289";"289";"0";"289";"0";"456894";"373894"
"V4mis1";"SILVA (only NR);Eukaryota;SAR;Alveolata;Apicomplexa;Aconoidasida;Piroplasmorida;Babesia;";"0.0";"0";"141";"141";"0";"141";"0";"457042";"373894"
"V4mis1";"SILVA (only NR);Eukaryota;SAR;Alveolata;Apicomplexa;Aconoidasida;Piroplasmorida;Cardiosporidium;";"0.0";"0";"2";"2";"0";"2";"0";"457181";"373894"
"V4mis1";"SILVA (only NR);Eukaryota;SAR;Alveolata;Apicomplexa;Aconoidasida;Piroplasmorida;Cytauxzoon;";"0.0";"0";"4";"4";"0";"4";"0";"457179";"373894"
"V4mis1";"SILVA (only NR);Eukaryota;SAR;Alveolata;Apicomplexa;Aconoidasida;Piroplasmorida;Nephromyces;";"0.0";"0";"9";"9";"0";"9";"0";"457174";"373894"
"V4mis1";"SILVA (only NR);Eukaryota;SAR;Alveolata;Apicomplexa;Aconoidasida;Piroplasmorida;Theileria;";"0.0";"0";"120";"120";"0";"120";"0";"457063";"373894"
"V4mis1";"SILVA (only NR);Eukaryota;SAR;Alveolata;Apicomplexa;Aconoidasida;Piroplasmorida;uncultured;";"0.0";"0";"4";"4";"0";"4";"0";"457179";"373894"
"V4mis1";"SILVA (only NR);Eukaryota;SAR;Alveolata;Apicomplexa;Conoidasida;";"9.6";"18.1";"682";"677";"65";"612";"5";"456506";"373829"
"V4mis1";"SILVA (only NR);Eukaryota;SAR;Alveolata;Apicomplexa;Conoidasida;Coccidia;";"0.0";"0";"458";"457";"0";"457";"1";"456726";"373894"
"V4mis1";"SILVA (only NR);Eukaryota;SAR;Alveolata;Apicomplexa;Conoidasida;Coccidia;Adeleorina;";"0.0";"0";"69";"69";"0";"69";"0";"457114";"373894"
"V4mis1";"SILVA (only NR);Eukaryota;SAR;Alveolata;Apicomplexa;Conoidasida;Coccidia;Adeleorina;Adelina;";"0.0";"0";"2";"2";"0";"2";"0";"457181";"373894"
"V4mis1";"SILVA (only NR);Eukaryota;SAR;Alveolata;Apicomplexa;Conoidasida;Coccidia;Adeleorina;Dactylosoma;";"0.0";"0";"1";"1";"0";"1";"0";"457182";"373894"
"V4mis1";"SILVA (only NR);Eukaryota;SAR;Alveolata;Apicomplexa;Conoidasida;Coccidia;Adeleorina;Haemogregarina;";"0.0";"0";"5";"5";"0";"5";"0";"457178";"373894"
"V4mis1";"SILVA (only NR);Eukaryota;SAR;Alveolata;Apicomplexa;Conoidasida;Coccidia;Adeleorina;Hemolivia;";"0.0";"0";"7";"7";"0";"7";"0";"457176";"373894"
"V4mis1";"SILVA (only NR);Eukaryota;SAR;Alveolata;Apicomplexa;Conoidasida;Coccidia;Adeleorina;Hepatozoon;";"0.0";"0";"51";"51";"0";"51";"0";"457132";"373894"
"V4mis1";"SILVA (only NR);Eukaryota;SAR;Alveolata;Apicomplexa;Conoidasida;Coccidia;Adeleorina;Klossia;";"0.0";"0";"1";"1";"0";"1";"0";"457182";"373894"
"V4mis1";"SILVA (only NR);Eukaryota;SAR;Alveolata;Apicomplexa;Conoidasida;Coccidia;Eimeriorina;";"0.0";"0";"389";"388";"0";"388";"1";"456795";"373894"
"V4mis1";"SILVA (only NR);Eukaryota;SAR;Alveolata;Apicomplexa;Conoidasida;Coccidia;Eimeriorina;Acroeimeria;";"0.0";"0";"4";"4";"0";"4";"0";"457179";"373894"
"V4mis1";"SILVA (only NR);Eukaryota;SAR;Alveolata;Apicomplexa;Conoidasida;Coccidia;Eimeriorina;Aggregata;";"0.0";"0";"3";"3";"0";"3";"0";"457180";"373894"
"V4mis1";"SILVA (only NR);Eukaryota;SAR;Alveolata;Apicomplexa;Conoidasida;Coccidia;Eimeriorina;Besnoitia;";"0.0";"0";"3";"3";"0";"3";"0";"457180";"373894"
"V4mis1";"SILVA (only NR);Eukaryota;SAR;Alveolata;Apicomplexa;Conoidasida;Coccidia;Eimeriorina;Calyptosporidae;";"0.0";"0";"6";"6";"0";"6";"0";"457177";"373894"
"V4mis1";"SILVA (only NR);Eukaryota;SAR;Alveolata;Apicomplexa;Conoidasida;Coccidia;Eimeriorina;Caryospora;";"0.0";"0";"2";"2";"0";"2";"0";"457181";"373894"
"V4mis1";"SILVA (only NR);Eukaryota;SAR;Alveolata;Apicomplexa;Conoidasida;Coccidia;Eimeriorina;Choleoeimeria;";"0.0";"0";"2";"1";"0";"1";"1";"457182";"373894"
"V4mis1";"SILVA (only NR);Eukaryota;SAR;Alveolata;Apicomplexa;Conoidasida;Coccidia;Eimeriorina;Cyclospora;";"0.0";"0";"1";"1";"0";"1";"0";"457182";"373894"
"V4mis1";"SILVA (only NR);Eukaryota;SAR;Alveolata;Apicomplexa;Conoidasida;Coccidia;Eimeriorina;Cystoisospora;";"0.0";"0";"3";"3";"0";"3";"0";"457180";"373894"
"V4mis1";"SILVA (only NR);Eukaryota;SAR;Alveolata;Apicomplexa;Conoidasida;Coccidia;Eimeriorina;Eimeria;";"0.0";"0";"148";"148";"0";"148";"0";"457035";"373894"
"V4mis1";"SILVA (only NR);Eukaryota;SAR;Alveolata;Apicomplexa;Conoidasida;Coccidia;Eimeriorina;Goussia;";"0.0";"0";"25";"25";"0";"25";"0";"457158";"373894"
"V4mis1";"SILVA (only NR);Eukaryota;SAR;Alveolata;Apicomplexa;Conoidasida;Coccidia;Eimeriorina;Hyaloklossia;";"0.0";"0";"1";"1";"0";"1";"0";"457182";"373894"
"V4mis1";"SILVA (only NR);Eukaryota;SAR;Alveolata;Apicomplexa;Conoidasida;Coccidia;Eimeriorina;Isospora;";"0.0";"0";"2";"2";"0";"2";"0";"457181";"373894"
"V4mis1";"SILVA (only NR);Eukaryota;SAR;Alveolata;Apicomplexa;Conoidasida;Coccidia;Eimeriorina;Lankesterella;";"0.0";"0";"7";"7";"0";"7";"0";"457176";"373894"
"V4mis1";"SILVA (only NR);Eukaryota;SAR;Alveolata;Apicomplexa;Conoidasida;Coccidia;Eimeriorina;Margolisiella;";"0.0";"0";"5";"5";"0";"5";"0";"457178";"373894"
"V4mis1";"SILVA (only NR);Eukaryota;SAR;Alveolata;Apicomplexa;Conoidasida;Coccidia;Eimeriorina;Rhytidocystis;";"0.0";"0";"3";"3";"0";"3";"0";"457180";"373894"
"V4mis1";"SILVA (only NR);Eukaryota;SAR;Alveolata;Apicomplexa;Conoidasida;Coccidia;Eimeriorina;Sarcocystis;";"0.0";"0";"129";"129";"0";"129";"0";"457054";"373894"
"V4mis1";"SILVA (only NR);Eukaryota;SAR;Alveolata;Apicomplexa;Conoidasida;Coccidia;Eimeriorina;Toxoplasma;";"0.0";"0";"4";"4";"0";"4";"0";"457179";"373894"
"V4mis1";"SILVA (only NR);Eukaryota;SAR;Alveolata;Apicomplexa;Conoidasida;Coccidia;Eimeriorina;uncultured;";"0.0";"0";"8";"8";"0";"8";"0";"457175";"373894"
"V4mis1";"SILVA (only NR);Eukaryota;SAR;Alveolata;Apicomplexa;Conoidasida;Cryptosporida;";"0.0";"0";"43";"43";"0";"43";"0";"457140";"373894"
"V4mis1";"SILVA (only NR);Eukaryota;SAR;Alveolata;Apicomplexa;Conoidasida;Cryptosporida;Cryptosporidium;";"0.0";"0";"43";"43";"0";"43";"0";"457140";"373894"
"V4mis1";"SILVA (only NR);Eukaryota;SAR;Alveolata;Apicomplexa;Conoidasida;Gregarinasina;";"37.1";"18.2";"178";"175";"65";"110";"3";"457008";"373829"
"V4mis1";"SILVA (only NR);Eukaryota;SAR;Alveolata;Apicomplexa;Conoidasida;Gregarinasina;Archigregarinorida;";"0.0";"0";"33";"33";"0";"33";"0";"457150";"373894"
"V4mis1";"SILVA (only NR);Eukaryota;SAR;Alveolata;Apicomplexa;Conoidasida;Gregarinasina;Archigregarinorida;Filipodium;";"0.0";"0";"1";"1";"0";"1";"0";"457182";"373894"
"V4mis1";"SILVA (only NR);Eukaryota;SAR;Alveolata;Apicomplexa;Conoidasida;Gregarinasina;Archigregarinorida;Selenidium;";"0.0";"0";"32";"32";"0";"32";"0";"457151";"373894"
"V4mis1";"SILVA (only NR);Eukaryota;SAR;Alveolata;Apicomplexa;Conoidasida;Gregarinasina;BAQA40;";"0.0";"0";"4";"4";"0";"4";"0";"457179";"373894"
"V4mis1";"SILVA (only NR);Eukaryota;SAR;Alveolata;Apicomplexa;Conoidasida;Gregarinasina;Eugregarinorida;";"51.2";"18.2";"130";"127";"65";"62";"3";"457056";"373829"
"V4mis1";"SILVA (only NR);Eukaryota;SAR;Alveolata;Apicomplexa;Conoidasida;Gregarinasina;Eugregarinorida;Amoebogregarina;";"100.0";"18.2";"1";"1";"1";"0";"0";"457182";"373893"
"V4mis1";"SILVA (only NR);Eukaryota;SAR;Alveolata;Apicomplexa;Conoidasida;Gregarinasina;Eugregarinorida;Ascogregarina;";"0.0";"0";"4";"4";"0";"4";"0";"457179";"373894"
"V4mis1";"SILVA (only NR);Eukaryota;SAR;Alveolata;Apicomplexa;Conoidasida;Gregarinasina;Eugregarinorida;Colepismatophila;";"0.0";"0";"1";"1";"0";"1";"0";"457182";"373894"
"V4mis1";"SILVA (only NR);Eukaryota;SAR;Alveolata;Apicomplexa;Conoidasida;Gregarinasina;Eugregarinorida;D3P05A02;";"0.0";"0";"4";"3";"0";"3";"1";"457180";"373894"
"V4mis1";"SILVA (only NR);Eukaryota;SAR;Alveolata;Apicomplexa;Conoidasida;Gregarinasina;Eugregarinorida;D4P07G01;";"100.0";"18.2";"3";"3";"3";"0";"0";"457180";"373891"
"V4mis1";"SILVA (only NR);Eukaryota;SAR;Alveolata;Apicomplexa;Conoidasida;Gregarinasina;Eugregarinorida;Elev-18S-1089;";"0.0";"0";"4";"4";"0";"4";"0";"457179";"373894"
"V4mis1";"SILVA (only NR);Eukaryota;SAR;Alveolata;Apicomplexa;Conoidasida;Gregarinasina;Eugregarinorida;Geneiorhynchus;";"0.0";"0";"1";"1";"0";"1";"0";"457182";"373894"
"V4mis1";"SILVA (only NR);Eukaryota;SAR;Alveolata;Apicomplexa;Conoidasida;Gregarinasina;Eugregarinorida;Gregarina;";"100.0";"18.2";"13";"11";"11";"0";"2";"457172";"373883"
"V4mis1";"SILVA (only NR);Eukaryota;SAR;Alveolata;Apicomplexa;Conoidasida;Gregarinasina;Eugregarinorida;Hoplorhynchus;";"0.0";"0";"2";"2";"0";"2";"0";"457181";"373894"
"V4mis1";"SILVA (only NR);Eukaryota;SAR;Alveolata;Apicomplexa;Conoidasida;Gregarinasina;Eugregarinorida;LEMD098;";"66.7";"18.2";"9";"9";"6";"3";"0";"457174";"373888"
"V4mis1";"SILVA (only NR);Eukaryota;SAR;Alveolata;Apicomplexa;Conoidasida;Gregarinasina;Eugregarinorida;Lankesteria;";"86.7";"18.2";"15";"15";"13";"2";"0";"457168";"373881"
"V4mis1";"SILVA (only NR);Eukaryota;SAR;Alveolata;Apicomplexa;Conoidasida;Gregarinasina;Eugregarinorida;Lecudina;";"57.1";"18.2";"21";"21";"12";"9";"0";"457162";"373882"
"V4mis1";"SILVA (only NR);Eukaryota;SAR;Alveolata;Apicomplexa;Conoidasida;Gregarinasina;Eugregarinorida;Leidyana;";"100.0";"18.2";"3";"3";"3";"0";"0";"457180";"373891"
"V4mis1";"SILVA (only NR);Eukaryota;SAR;Alveolata;Apicomplexa;Conoidasida;Gregarinasina;Eugregarinorida;Monocystis;";"0.0";"0";"3";"3";"0";"3";"0";"457180";"373894"
"V4mis1";"SILVA (only NR);Eukaryota;SAR;Alveolata;Apicomplexa;Conoidasida;Gregarinasina;Eugregarinorida;Nematopsis;";"0.0";"0";"6";"6";"0";"6";"0";"457177";"373894"
"V4mis1";"SILVA (only NR);Eukaryota;SAR;Alveolata;Apicomplexa;Conoidasida;Gregarinasina;Eugregarinorida;Paraschneideria;";"0.0";"0";"2";"2";"0";"2";"0";"457181";"373894"
"V4mis1";"SILVA (only NR);Eukaryota;SAR;Alveolata;Apicomplexa;Conoidasida;Gregarinasina;Eugregarinorida;Prismatospora;";"0.0";"0";"1";"1";"0";"1";"0";"457182";"373894"
"V4mis1";"SILVA (only NR);Eukaryota;SAR;Alveolata;Apicomplexa;Conoidasida;Gregarinasina;Eugregarinorida;Protomagalhaensia;";"100.0";"18.2";"1";"1";"1";"0";"0";"457182";"373893"
"V4mis1";"SILVA (only NR);Eukaryota;SAR;Alveolata;Apicomplexa;Conoidasida;Gregarinasina;Eugregarinorida;Psychodiella;";"0.0";"0";"2";"2";"0";"2";"0";"457181";"373894"
"V4mis1";"SILVA (only NR);Eukaryota;SAR;Alveolata;Apicomplexa;Conoidasida;Gregarinasina;Eugregarinorida;Pterospora;";"100.0";"18.2";"2";"2";"2";"0";"0";"457181";"373892"
"V4mis1";"SILVA (only NR);Eukaryota;SAR;Alveolata;Apicomplexa;Conoidasida;Gregarinasina;Eugregarinorida;Stenophora;";"0.0";"0";"1";"1";"0";"1";"0";"457182";"373894"
"V4mis1";"SILVA (only NR);Eukaryota;SAR;Alveolata;Apicomplexa;Conoidasida;Gregarinasina;Eugregarinorida;Stylocephalus;";"0.0";"0";"2";"2";"0";"2";"0";"457181";"373894"
"V4mis1";"SILVA (only NR);Eukaryota;SAR;Alveolata;Apicomplexa;Conoidasida;Gregarinasina;Eugregarinorida;Syncystis;";"0.0";"0";"1";"1";"0";"1";"0";"457182";"373894"
"V4mis1";"SILVA (only NR);Eukaryota;SAR;Alveolata;Apicomplexa;Conoidasida;Gregarinasina;Eugregarinorida;Urospora;";"100.0";"18.2";"6";"6";"6";"0";"0";"457177";"373888"
"V4mis1";"SILVA (only NR);Eukaryota;SAR;Alveolata;Apicomplexa;Conoidasida;Gregarinasina;Eugregarinorida;Xiphocephalus;";"0.0";"0";"1";"1";"0";"1";"0";"457182";"373894"
"V4mis1";"SILVA (only NR);Eukaryota;SAR;Alveolata;Apicomplexa;Conoidasida;Gregarinasina;Eugregarinorida;uncultured;";"0.0";"0";"7";"7";"0";"7";"0";"457176";"373894"
"V4mis1";"SILVA (only NR);Eukaryota;SAR;Alveolata;Apicomplexa;Conoidasida;Gregarinasina;Neogregarinorida;";"0.0";"0";"8";"8";"0";"8";"0";"457175";"373894"
"V4mis1";"SILVA (only NR);Eukaryota;SAR;Alveolata;Apicomplexa;Conoidasida;Gregarinasina;Neogregarinorida;Apicystis;";"0.0";"0";"2";"2";"0";"2";"0";"457181";"373894"
"V4mis1";"SILVA (only NR);Eukaryota;SAR;Alveolata;Apicomplexa;Conoidasida;Gregarinasina;Neogregarinorida;Aranciocystis;";"0.0";"0";"1";"1";"0";"1";"0";"457182";"373894"
"V4mis1";"SILVA (only NR);Eukaryota;SAR;Alveolata;Apicomplexa;Conoidasida;Gregarinasina;Neogregarinorida;Mattesia;";"0.0";"0";"2";"2";"0";"2";"0";"457181";"373894"
"V4mis1";"SILVA (only NR);Eukaryota;SAR;Alveolata;Apicomplexa;Conoidasida;Gregarinasina;Neogregarinorida;Ophryocystis;";"0.0";"0";"1";"1";"0";"1";"0";"457182";"373894"
"V4mis1";"SILVA (only NR);Eukaryota;SAR;Alveolata;Apicomplexa;Novel Apicomplexa Class 1;";"0.0";"0";"17";"17";"0";"17";"0";"457166";"373894"
"V4mis1";"SILVA (only NR);Eukaryota;SAR;Alveolata;Apicomplexa;Novel Apicomplexa Class 2;";"0.0";"0";"18";"18";"0";"18";"0";"457165";"373894"
"V4mis1";"SILVA (only NR);Eukaryota;SAR;Alveolata;Ciliophora;";"5.2";"17.7";"2935";"2931";"152";"2779";"4";"454252";"373742"
"V4mis1";"SILVA (only NR);Eukaryota;SAR;Alveolata;Ciliophora;Intramacronucleata;";"5.4";"17.8";"2783";"2779";"151";"2628";"4";"454404";"373743"
"V4mis1";"SILVA (only NR);Eukaryota;SAR;Alveolata;Ciliophora;Intramacronucleata;Armophorea;";"0.0";"0";"83";"83";"0";"83";"0";"457100";"373894"
"V4mis1";"SILVA (only NR);Eukaryota;SAR;Alveolata;Ciliophora;Intramacronucleata;Armophorea;Armophorida;";"0.0";"0";"39";"39";"0";"39";"0";"457144";"373894"
"V4mis1";"SILVA (only NR);Eukaryota;SAR;Alveolata;Ciliophora;Intramacronucleata;Armophorea;Armophorida;Brachonella;";"0.0";"0";"10";"10";"0";"10";"0";"457173";"373894"
"V4mis1";"SILVA (only NR);Eukaryota;SAR;Alveolata;Ciliophora;Intramacronucleata;Armophorea;Armophorida;Caenomorpha;";"0.0";"0";"5";"5";"0";"5";"0";"457178";"373894"
"V4mis1";"SILVA (only NR);Eukaryota;SAR;Alveolata;Ciliophora;Intramacronucleata;Armophorea;Armophorida;Metopus;";"0.0";"0";"14";"14";"0";"14";"0";"457169";"373894"
"V4mis1";"SILVA (only NR);Eukaryota;SAR;Alveolata;Ciliophora;Intramacronucleata;Armophorea;Armophorida;Parametopidium;";"0.0";"0";"1";"1";"0";"1";"0";"457182";"373894"
"V4mis1";"SILVA (only NR);Eukaryota;SAR;Alveolata;Ciliophora;Intramacronucleata;Armophorea;Cariaco Basin group 1;";"0.0";"0";"9";"9";"0";"9";"0";"457174";"373894"
"V4mis1";"SILVA (only NR);Eukaryota;SAR;Alveolata;Ciliophora;Intramacronucleata;Armophorea;Cariaco Basin group 2;";"0.0";"0";"7";"7";"0";"7";"0";"457176";"373894"
"V4mis1";"SILVA (only NR);Eukaryota;SAR;Alveolata;Ciliophora;Intramacronucleata;Armophorea;Clevelandellida;";"0.0";"0";"15";"15";"0";"15";"0";"457168";"373894"
"V4mis1";"SILVA (only NR);Eukaryota;SAR;Alveolata;Ciliophora;Intramacronucleata;Armophorea;Clevelandellida;Clevelandella;";"0.0";"0";"5";"5";"0";"5";"0";"457178";"373894"
"V4mis1";"SILVA (only NR);Eukaryota;SAR;Alveolata;Ciliophora;Intramacronucleata;Armophorea;Clevelandellida;Nyctotheroides;";"0.0";"0";"4";"4";"0";"4";"0";"457179";"373894"
"V4mis1";"SILVA (only NR);Eukaryota;SAR;Alveolata;Ciliophora;Intramacronucleata;Armophorea;Clevelandellida;Nyctotherus;";"0.0";"0";"5";"5";"0";"5";"0";"457178";"373894"
"V4mis1";"SILVA (only NR);Eukaryota;SAR;Alveolata;Ciliophora;Intramacronucleata;Armophorea;uncultured;";"0.0";"0";"10";"10";"0";"10";"0";"457173";"373894"
"V4mis1";"SILVA (only NR);Eukaryota;SAR;Alveolata;Ciliophora;Intramacronucleata;Conthreep;";"9.7";"18";"1076";"1074";"104";"970";"2";"456109";"373790"
"V4mis1";"SILVA (only NR);Eukaryota;SAR;Alveolata;Ciliophora;Intramacronucleata;Conthreep;Colpodea;";"0.0";"0";"117";"117";"0";"117";"0";"457066";"373894"
"V4mis1";"SILVA (only NR);Eukaryota;SAR;Alveolata;Ciliophora;Intramacronucleata;Conthreep;Colpodea;Bursariomorphida;";"0.0";"0";"12";"12";"0";"12";"0";"457171";"373894"
"V4mis1";"SILVA (only NR);Eukaryota;SAR;Alveolata;Ciliophora;Intramacronucleata;Conthreep;Colpodea;Bursariomorphida;Bryometopus;";"0.0";"0";"9";"9";"0";"9";"0";"457174";"373894"
"V4mis1";"SILVA (only NR);Eukaryota;SAR;Alveolata;Ciliophora;Intramacronucleata;Conthreep;Colpodea;Bursariomorphida;Bursaria;";"0.0";"0";"3";"3";"0";"3";"0";"457180";"373894"
"V4mis1";"SILVA (only NR);Eukaryota;SAR;Alveolata;Ciliophora;Intramacronucleata;Conthreep;Colpodea;Colpodida;";"0.0";"0";"68";"68";"0";"68";"0";"457115";"373894"
"V4mis1";"SILVA (only NR);Eukaryota;SAR;Alveolata;Ciliophora;Intramacronucleata;Conthreep;Colpodea;Colpodida;Bardeliella;";"0.0";"0";"1";"1";"0";"1";"0";"457182";"373894"
"V4mis1";"SILVA (only NR);Eukaryota;SAR;Alveolata;Ciliophora;Intramacronucleata;Conthreep;Colpodea;Colpodida;Bresslaua;";"0.0";"0";"1";"1";"0";"1";"0";"457182";"373894"
"V4mis1";"SILVA (only NR);Eukaryota;SAR;Alveolata;Ciliophora;Intramacronucleata;Conthreep;Colpodea;Colpodida;Bresslauides;";"0.0";"0";"2";"2";"0";"2";"0";"457181";"373894"
"V4mis1";"SILVA (only NR);Eukaryota;SAR;Alveolata;Ciliophora;Intramacronucleata;Conthreep;Colpodea;Colpodida;Bromeliothrix;";"0.0";"0";"3";"3";"0";"3";"0";"457180";"373894"
"V4mis1";"SILVA (only NR);Eukaryota;SAR;Alveolata;Ciliophora;Intramacronucleata;Conthreep;Colpodea;Colpodida;Bryophrya;";"0.0";"0";"1";"1";"0";"1";"0";"457182";"373894"
"V4mis1";"SILVA (only NR);Eukaryota;SAR;Alveolata;Ciliophora;Intramacronucleata;Conthreep;Colpodea;Colpodida;Bryophryoides;";"0.0";"0";"1";"1";"0";"1";"0";"457182";"373894"
"V4mis1";"SILVA (only NR);Eukaryota;SAR;Alveolata;Ciliophora;Intramacronucleata;Conthreep;Colpodea;Colpodida;Colpoda;";"0.0";"0";"17";"17";"0";"17";"0";"457166";"373894"
"V4mis1";"SILVA (only NR);Eukaryota;SAR;Alveolata;Ciliophora;Intramacronucleata;Conthreep;Colpodea;Colpodida;Exocolpoda;";"0.0";"0";"1";"1";"0";"1";"0";"457182";"373894"
"V4mis1";"SILVA (only NR);Eukaryota;SAR;Alveolata;Ciliophora;Intramacronucleata;Conthreep;Colpodea;Colpodida;Hausmanniella;";"0.0";"0";"1";"1";"0";"1";"0";"457182";"373894"
"V4mis1";"SILVA (only NR);Eukaryota;SAR;Alveolata;Ciliophora;Intramacronucleata;Conthreep;Colpodea;Colpodida;Ilsiella;";"0.0";"0";"1";"1";"0";"1";"0";"457182";"373894"
"V4mis1";"SILVA (only NR);Eukaryota;SAR;Alveolata;Ciliophora;Intramacronucleata;Conthreep;Colpodea;Colpodida;Jaroschia;";"0.0";"0";"1";"1";"0";"1";"0";"457182";"373894"
"V4mis1";"SILVA (only NR);Eukaryota;SAR;Alveolata;Ciliophora;Intramacronucleata;Conthreep;Colpodea;Colpodida;Kalometopia;";"0.0";"0";"1";"1";"0";"1";"0";"457182";"373894"
"V4mis1";"SILVA (only NR);Eukaryota;SAR;Alveolata;Ciliophora;Intramacronucleata;Conthreep;Colpodea;Colpodida;Maryna;";"0.0";"0";"3";"3";"0";"3";"0";"457180";"373894"
"V4mis1";"SILVA (only NR);Eukaryota;SAR;Alveolata;Ciliophora;Intramacronucleata;Conthreep;Colpodea;Colpodida;Mykophagophrys;";"0.0";"0";"1";"1";"0";"1";"0";"457182";"373894"
"V4mis1";"SILVA (only NR);Eukaryota;SAR;Alveolata;Ciliophora;Intramacronucleata;Conthreep;Colpodea;Colpodida;Notoxoma;";"0.0";"0";"2";"2";"0";"2";"0";"457181";"373894"
"V4mis1";"SILVA (only NR);Eukaryota;SAR;Alveolata;Ciliophora;Intramacronucleata;Conthreep;Colpodea;Colpodida;Pseudoplatyophrya;";"0.0";"0";"2";"2";"0";"2";"0";"457181";"373894"
"V4mis1";"SILVA (only NR);Eukaryota;SAR;Alveolata;Ciliophora;Intramacronucleata;Conthreep;Colpodea;Colpodida;Repoma;";"0.0";"0";"1";"1";"0";"1";"0";"457182";"373894"
"V4mis1";"SILVA (only NR);Eukaryota;SAR;Alveolata;Ciliophora;Intramacronucleata;Conthreep;Colpodea;Colpodida;uncultured;";"0.0";"0";"7";"7";"0";"7";"0";"457176";"373894"
"V4mis1";"SILVA (only NR);Eukaryota;SAR;Alveolata;Ciliophora;Intramacronucleata;Conthreep;Colpodea;Cyrtolophosidida;";"0.0";"0";"15";"15";"0";"15";"0";"457168";"373894"
"V4mis1";"SILVA (only NR);Eukaryota;SAR;Alveolata;Ciliophora;Intramacronucleata;Conthreep;Colpodea;Cyrtolophosidida;Aristerostoma;";"0.0";"0";"3";"3";"0";"3";"0";"457180";"373894"
"V4mis1";"SILVA (only NR);Eukaryota;SAR;Alveolata;Ciliophora;Intramacronucleata;Conthreep;Colpodea;Cyrtolophosidida;Cyrtolophosis;";"0.0";"0";"4";"4";"0";"4";"0";"457179";"373894"
"V4mis1";"SILVA (only NR);Eukaryota;SAR;Alveolata;Ciliophora;Intramacronucleata;Conthreep;Colpodea;Cyrtolophosidida;Microdiaphanosoma;";"0.0";"0";"3";"3";"0";"3";"0";"457180";"373894"
"V4mis1";"SILVA (only NR);Eukaryota;SAR;Alveolata;Ciliophora;Intramacronucleata;Conthreep;Colpodea;Platyophryida;";"0.0";"0";"18";"18";"0";"18";"0";"457165";"373894"
"V4mis1";"SILVA (only NR);Eukaryota;SAR;Alveolata;Ciliophora;Intramacronucleata;Conthreep;Colpodea;Platyophryida;Etoschophrya;";"0.0";"0";"1";"1";"0";"1";"0";"457182";"373894"
"V4mis1";"SILVA (only NR);Eukaryota;SAR;Alveolata;Ciliophora;Intramacronucleata;Conthreep;Colpodea;Platyophryida;Platyophrya;";"0.0";"0";"8";"8";"0";"8";"0";"457175";"373894"
"V4mis1";"SILVA (only NR);Eukaryota;SAR;Alveolata;Ciliophora;Intramacronucleata;Conthreep;Colpodea;Platyophryida;Platyophryides;";"0.0";"0";"2";"2";"0";"2";"0";"457181";"373894"
"V4mis1";"SILVA (only NR);Eukaryota;SAR;Alveolata;Ciliophora;Intramacronucleata;Conthreep;Colpodea;Platyophryida;Sorogena;";"0.0";"0";"1";"1";"0";"1";"0";"457182";"373894"
"V4mis1";"SILVA (only NR);Eukaryota;SAR;Alveolata;Ciliophora;Intramacronucleata;Conthreep;Colpodea;Platyophryida;Woodruffides;";"0.0";"0";"4";"4";"0";"4";"0";"457179";"373894"
"V4mis1";"SILVA (only NR);Eukaryota;SAR;Alveolata;Ciliophora;Intramacronucleata;Conthreep;Colpodea;uncultured;";"0.0";"0";"4";"4";"0";"4";"0";"457179";"373894"
"V4mis1";"SILVA (only NR);Eukaryota;SAR;Alveolata;Ciliophora;Intramacronucleata;Conthreep;IN2411;";"0.0";"0";"6";"6";"0";"6";"0";"457177";"373894"
"V4mis1";"SILVA (only NR);Eukaryota;SAR;Alveolata;Ciliophora;Intramacronucleata;Conthreep;Nassophorea;";"0.0";"0";"74";"73";"0";"73";"1";"457110";"373894"
"V4mis1";"SILVA (only NR);Eukaryota;SAR;Alveolata;Ciliophora;Intramacronucleata;Conthreep;Nassophorea;Colpodidium;";"0.0";"0";"3";"3";"0";"3";"0";"457180";"373894"
"V4mis1";"SILVA (only NR);Eukaryota;SAR;Alveolata;Ciliophora;Intramacronucleata;Conthreep;Nassophorea;Discotricha;";"0.0";"0";"8";"8";"0";"8";"0";"457175";"373894"
"V4mis1";"SILVA (only NR);Eukaryota;SAR;Alveolata;Ciliophora;Intramacronucleata;Conthreep;Nassophorea;Furgasonia;";"0.0";"0";"1";"1";"0";"1";"0";"457182";"373894"
"V4mis1";"SILVA (only NR);Eukaryota;SAR;Alveolata;Ciliophora;Intramacronucleata;Conthreep;Nassophorea;Leptopharynx;";"0.0";"0";"2";"2";"0";"2";"0";"457181";"373894"
"V4mis1";"SILVA (only NR);Eukaryota;SAR;Alveolata;Ciliophora;Intramacronucleata;Conthreep;Nassophorea;Obertrumia;";"0.0";"0";"4";"4";"0";"4";"0";"457179";"373894"
"V4mis1";"SILVA (only NR);Eukaryota;SAR;Alveolata;Ciliophora;Intramacronucleata;Conthreep;Nassophorea;Pseudomicrothorax;";"0.0";"0";"1";"1";"0";"1";"0";"457182";"373894"
"V4mis1";"SILVA (only NR);Eukaryota;SAR;Alveolata;Ciliophora;Intramacronucleata;Conthreep;Nassophorea;Trochiliopsis;";"0.0";"0";"1";"1";"0";"1";"0";"457182";"373894"
"V4mis1";"SILVA (only NR);Eukaryota;SAR;Alveolata;Ciliophora;Intramacronucleata;Conthreep;Nassophorea;Zosterodasys;";"0.0";"0";"10";"10";"0";"10";"0";"457173";"373894"
"V4mis1";"SILVA (only NR);Eukaryota;SAR;Alveolata;Ciliophora;Intramacronucleata;Conthreep;Nassophorea;uncultured;";"0.0";"0";"35";"34";"0";"34";"1";"457149";"373894"
"V4mis1";"SILVA (only NR);Eukaryota;SAR;Alveolata;Ciliophora;Intramacronucleata;Conthreep;Oligohymenophorea;";"0.0";"0";"587";"586";"0";"586";"1";"456597";"373894"
"V4mis1";"SILVA (only NR);Eukaryota;SAR;Alveolata;Ciliophora;Intramacronucleata;Conthreep;Oligohymenophorea;Apostomatia;";"0.0";"0";"31";"31";"0";"31";"0";"457152";"373894"
"V4mis1";"SILVA (only NR);Eukaryota;SAR;Alveolata;Ciliophora;Intramacronucleata;Conthreep;Oligohymenophorea;Apostomatia;Cinetochilum;";"0.0";"0";"2";"2";"0";"2";"0";"457181";"373894"
"V4mis1";"SILVA (only NR);Eukaryota;SAR;Alveolata;Ciliophora;Intramacronucleata;Conthreep;Oligohymenophorea;Apostomatia;Fusiforma;";"0.0";"0";"1";"1";"0";"1";"0";"457182";"373894"
"V4mis1";"SILVA (only NR);Eukaryota;SAR;Alveolata;Ciliophora;Intramacronucleata;Conthreep;Oligohymenophorea;Apostomatia;Gymnodinioides;";"0.0";"0";"2";"2";"0";"2";"0";"457181";"373894"
"V4mis1";"SILVA (only NR);Eukaryota;SAR;Alveolata;Ciliophora;Intramacronucleata;Conthreep;Oligohymenophorea;Apostomatia;Hyalophysa;";"0.0";"0";"6";"6";"0";"6";"0";"457177";"373894"
"V4mis1";"SILVA (only NR);Eukaryota;SAR;Alveolata;Ciliophora;Intramacronucleata;Conthreep;Oligohymenophorea;Apostomatia;Platynematum;";"0.0";"0";"1";"1";"0";"1";"0";"457182";"373894"
"V4mis1";"SILVA (only NR);Eukaryota;SAR;Alveolata;Ciliophora;Intramacronucleata;Conthreep;Oligohymenophorea;Apostomatia;Pseudocollinia;";"0.0";"0";"3";"3";"0";"3";"0";"457180";"373894"
"V4mis1";"SILVA (only NR);Eukaryota;SAR;Alveolata;Ciliophora;Intramacronucleata;Conthreep;Oligohymenophorea;Apostomatia;Vampyrophrya;";"0.0";"0";"1";"1";"0";"1";"0";"457182";"373894"
"V4mis1";"SILVA (only NR);Eukaryota;SAR;Alveolata;Ciliophora;Intramacronucleata;Conthreep;Oligohymenophorea;Apostomatia;uncultured;";"0.0";"0";"7";"7";"0";"7";"0";"457176";"373894"
"V4mis1";"SILVA (only NR);Eukaryota;SAR;Alveolata;Ciliophora;Intramacronucleata;Conthreep;Oligohymenophorea;Astomatia;";"0.0";"0";"6";"6";"0";"6";"0";"457177";"373894"
"V4mis1";"SILVA (only NR);Eukaryota;SAR;Alveolata;Ciliophora;Intramacronucleata;Conthreep;Oligohymenophorea;Astomatia;Anoplophrya;";"0.0";"0";"1";"1";"0";"1";"0";"457182";"373894"
"V4mis1";"SILVA (only NR);Eukaryota;SAR;Alveolata;Ciliophora;Intramacronucleata;Conthreep;Oligohymenophorea;Astomatia;Metaracoelophrya;";"0.0";"0";"2";"2";"0";"2";"0";"457181";"373894"
"V4mis1";"SILVA (only NR);Eukaryota;SAR;Alveolata;Ciliophora;Intramacronucleata;Conthreep;Oligohymenophorea;Astomatia;Metaradiophrya;";"0.0";"0";"1";"1";"0";"1";"0";"457182";"373894"
"V4mis1";"SILVA (only NR);Eukaryota;SAR;Alveolata;Ciliophora;Intramacronucleata;Conthreep;Oligohymenophorea;Astomatia;Njinella;";"0.0";"0";"1";"1";"0";"1";"0";"457182";"373894"
"V4mis1";"SILVA (only NR);Eukaryota;SAR;Alveolata;Ciliophora;Intramacronucleata;Conthreep;Oligohymenophorea;Astomatia;Paraclausilocola;";"0.0";"0";"1";"1";"0";"1";"0";"457182";"373894"
"V4mis1";"SILVA (only NR);Eukaryota;SAR;Alveolata;Ciliophora;Intramacronucleata;Conthreep;Oligohymenophorea;CV1-2A-17;";"0.0";"0";"6";"6";"0";"6";"0";"457177";"373894"
"V4mis1";"SILVA (only NR);Eukaryota;SAR;Alveolata;Ciliophora;Intramacronucleata;Conthreep;Oligohymenophorea;Hymenostomatia;";"0.0";"0";"31";"31";"0";"31";"0";"457152";"373894"
"V4mis1";"SILVA (only NR);Eukaryota;SAR;Alveolata;Ciliophora;Intramacronucleata;Conthreep;Oligohymenophorea;Hymenostomatia;Agolohymena;";"0.0";"0";"1";"1";"0";"1";"0";"457182";"373894"
"V4mis1";"SILVA (only NR);Eukaryota;SAR;Alveolata;Ciliophora;Intramacronucleata;Conthreep;Oligohymenophorea;Hymenostomatia;Bromeliophrya;";"0.0";"0";"4";"4";"0";"4";"0";"457179";"373894"
"V4mis1";"SILVA (only NR);Eukaryota;SAR;Alveolata;Ciliophora;Intramacronucleata;Conthreep;Oligohymenophorea;Hymenostomatia;Colpidium;";"0.0";"0";"1";"1";"0";"1";"0";"457182";"373894"
"V4mis1";"SILVA (only NR);Eukaryota;SAR;Alveolata;Ciliophora;Intramacronucleata;Conthreep;Oligohymenophorea;Hymenostomatia;Glaucoma;";"0.0";"0";"2";"2";"0";"2";"0";"457181";"373894"
"V4mis1";"SILVA (only NR);Eukaryota;SAR;Alveolata;Ciliophora;Intramacronucleata;Conthreep;Oligohymenophorea;Hymenostomatia;Ichthyophthirius;";"0.0";"0";"1";"1";"0";"1";"0";"457182";"373894"
"V4mis1";"SILVA (only NR);Eukaryota;SAR;Alveolata;Ciliophora;Intramacronucleata;Conthreep;Oligohymenophorea;Hymenostomatia;Ophryoglena;";"0.0";"0";"1";"1";"0";"1";"0";"457182";"373894"
"V4mis1";"SILVA (only NR);Eukaryota;SAR;Alveolata;Ciliophora;Intramacronucleata;Conthreep;Oligohymenophorea;Hymenostomatia;Tetrahymena;";"0.0";"0";"13";"13";"0";"13";"0";"457170";"373894"
"V4mis1";"SILVA (only NR);Eukaryota;SAR;Alveolata;Ciliophora;Intramacronucleata;Conthreep;Oligohymenophorea;Hymenostomatia;uncultured;";"0.0";"0";"2";"2";"0";"2";"0";"457181";"373894"
"V4mis1";"SILVA (only NR);Eukaryota;SAR;Alveolata;Ciliophora;Intramacronucleata;Conthreep;Oligohymenophorea;Peniculia;";"0.0";"0";"79";"79";"0";"79";"0";"457104";"373894"
"V4mis1";"SILVA (only NR);Eukaryota;SAR;Alveolata;Ciliophora;Intramacronucleata;Conthreep;Oligohymenophorea;Peniculia;Frontonia;";"0.0";"0";"25";"25";"0";"25";"0";"457158";"373894"
"V4mis1";"SILVA (only NR);Eukaryota;SAR;Alveolata;Ciliophora;Intramacronucleata;Conthreep;Oligohymenophorea;Peniculia;Lembadion;";"0.0";"0";"1";"1";"0";"1";"0";"457182";"373894"
"V4mis1";"SILVA (only NR);Eukaryota;SAR;Alveolata;Ciliophora;Intramacronucleata;Conthreep;Oligohymenophorea;Peniculia;Paramecium;";"0.0";"0";"29";"29";"0";"29";"0";"457154";"373894"
"V4mis1";"SILVA (only NR);Eukaryota;SAR;Alveolata;Ciliophora;Intramacronucleata;Conthreep;Oligohymenophorea;Peniculia;Stokesia;";"0.0";"0";"16";"16";"0";"16";"0";"457167";"373894"
"V4mis1";"SILVA (only NR);Eukaryota;SAR;Alveolata;Ciliophora;Intramacronucleata;Conthreep;Oligohymenophorea;Peniculia;uncultured;";"0.0";"0";"2";"2";"0";"2";"0";"457181";"373894"
"V4mis1";"SILVA (only NR);Eukaryota;SAR;Alveolata;Ciliophora;Intramacronucleata;Conthreep;Oligohymenophorea;Peritrichia;";"0.0";"0";"235";"235";"0";"235";"0";"456948";"373894"
"V4mis1";"SILVA (only NR);Eukaryota;SAR;Alveolata;Ciliophora;Intramacronucleata;Conthreep;Oligohymenophorea;Peritrichia;Apocarchesium;";"0.0";"0";"2";"2";"0";"2";"0";"457181";"373894"
"V4mis1";"SILVA (only NR);Eukaryota;SAR;Alveolata;Ciliophora;Intramacronucleata;Conthreep;Oligohymenophorea;Peritrichia;Astylozoon;";"0.0";"0";"1";"1";"0";"1";"0";"457182";"373894"
"V4mis1";"SILVA (only NR);Eukaryota;SAR;Alveolata;Ciliophora;Intramacronucleata;Conthreep;Oligohymenophorea;Peritrichia;Carchesium;";"0.0";"0";"2";"2";"0";"2";"0";"457181";"373894"
"V4mis1";"SILVA (only NR);Eukaryota;SAR;Alveolata;Ciliophora;Intramacronucleata;Conthreep;Oligohymenophorea;Peritrichia;Cothurnia;";"0.0";"0";"4";"4";"0";"4";"0";"457179";"373894"
"V4mis1";"SILVA (only NR);Eukaryota;SAR;Alveolata;Ciliophora;Intramacronucleata;Conthreep;Oligohymenophorea;Peritrichia;Epicarchesium;";"0.0";"0";"6";"6";"0";"6";"0";"457177";"373894"
"V4mis1";"SILVA (only NR);Eukaryota;SAR;Alveolata;Ciliophora;Intramacronucleata;Conthreep;Oligohymenophorea;Peritrichia;Epistylis;";"0.0";"0";"12";"12";"0";"12";"0";"457171";"373894"
"V4mis1";"SILVA (only NR);Eukaryota;SAR;Alveolata;Ciliophora;Intramacronucleata;Conthreep;Oligohymenophorea;Peritrichia;Opercularia;";"0.0";"0";"1";"1";"0";"1";"0";"457182";"373894"
"V4mis1";"SILVA (only NR);Eukaryota;SAR;Alveolata;Ciliophora;Intramacronucleata;Conthreep;Oligohymenophorea;Peritrichia;Ophrydium;";"0.0";"0";"1";"1";"0";"1";"0";"457182";"373894"
"V4mis1";"SILVA (only NR);Eukaryota;SAR;Alveolata;Ciliophora;Intramacronucleata;Conthreep;Oligohymenophorea;Peritrichia;Opisthonecta;";"0.0";"0";"3";"3";"0";"3";"0";"457180";"373894"
"V4mis1";"SILVA (only NR);Eukaryota;SAR;Alveolata;Ciliophora;Intramacronucleata;Conthreep;Oligohymenophorea;Peritrichia;Pseudepistylis;";"0.0";"0";"1";"1";"0";"1";"0";"457182";"373894"
"V4mis1";"SILVA (only NR);Eukaryota;SAR;Alveolata;Ciliophora;Intramacronucleata;Conthreep;Oligohymenophorea;Peritrichia;Pseudovorticella;";"0.0";"0";"19";"19";"0";"19";"0";"457164";"373894"
"V4mis1";"SILVA (only NR);Eukaryota;SAR;Alveolata;Ciliophora;Intramacronucleata;Conthreep;Oligohymenophorea;Peritrichia;Telotrochidium;";"0.0";"0";"25";"25";"0";"25";"0";"457158";"373894"
"V4mis1";"SILVA (only NR);Eukaryota;SAR;Alveolata;Ciliophora;Intramacronucleata;Conthreep;Oligohymenophorea;Peritrichia;Trichodina;";"0.0";"0";"22";"22";"0";"22";"0";"457161";"373894"
"V4mis1";"SILVA (only NR);Eukaryota;SAR;Alveolata;Ciliophora;Intramacronucleata;Conthreep;Oligohymenophorea;Peritrichia;Trichodinella;";"0.0";"0";"4";"4";"0";"4";"0";"457179";"373894"
"V4mis1";"SILVA (only NR);Eukaryota;SAR;Alveolata;Ciliophora;Intramacronucleata;Conthreep;Oligohymenophorea;Peritrichia;Urceolaria;";"0.0";"0";"5";"5";"0";"5";"0";"457178";"373894"
"V4mis1";"SILVA (only NR);Eukaryota;SAR;Alveolata;Ciliophora;Intramacronucleata;Conthreep;Oligohymenophorea;Peritrichia;Vaginicola;";"0.0";"0";"4";"4";"0";"4";"0";"457179";"373894"
"V4mis1";"SILVA (only NR);Eukaryota;SAR;Alveolata;Ciliophora;Intramacronucleata;Conthreep;Oligohymenophorea;Peritrichia;Vorticella;";"0.0";"0";"19";"19";"0";"19";"0";"457164";"373894"
"V4mis1";"SILVA (only NR);Eukaryota;SAR;Alveolata;Ciliophora;Intramacronucleata;Conthreep;Oligohymenophorea;Peritrichia;Zoothamnium;";"0.0";"0";"40";"40";"0";"40";"0";"457143";"373894"
"V4mis1";"SILVA (only NR);Eukaryota;SAR;Alveolata;Ciliophora;Intramacronucleata;Conthreep;Oligohymenophorea;Peritrichia;Zoothamnopsis;";"0.0";"0";"4";"4";"0";"4";"0";"457179";"373894"
"V4mis1";"SILVA (only NR);Eukaryota;SAR;Alveolata;Ciliophora;Intramacronucleata;Conthreep;Oligohymenophorea;Peritrichia;uncultured;";"0.0";"0";"17";"17";"0";"17";"0";"457166";"373894"
"V4mis1";"SILVA (only NR);Eukaryota;SAR;Alveolata;Ciliophora;Intramacronucleata;Conthreep;Oligohymenophorea;Scuticociliatia;";"0.0";"0";"190";"189";"0";"189";"1";"456994";"373894"
"V4mis1";"SILVA (only NR);Eukaryota;SAR;Alveolata;Ciliophora;Intramacronucleata;Conthreep;Oligohymenophorea;Scuticociliatia;Ancistrum;";"0.0";"0";"2";"2";"0";"2";"0";"457181";"373894"
"V4mis1";"SILVA (only NR);Eukaryota;SAR;Alveolata;Ciliophora;Intramacronucleata;Conthreep;Oligohymenophorea;Scuticociliatia;Anophryoides;";"0.0";"0";"1";"1";"0";"1";"0";"457182";"373894"
"V4mis1";"SILVA (only NR);Eukaryota;SAR;Alveolata;Ciliophora;Intramacronucleata;Conthreep;Oligohymenophorea;Scuticociliatia;Boveria;";"0.0";"0";"2";"2";"0";"2";"0";"457181";"373894"
"V4mis1";"SILVA (only NR);Eukaryota;SAR;Alveolata;Ciliophora;Intramacronucleata;Conthreep;Oligohymenophorea;Scuticociliatia;Cardiostomatella;";"0.0";"0";"5";"5";"0";"5";"0";"457178";"373894"
"V4mis1";"SILVA (only NR);Eukaryota;SAR;Alveolata;Ciliophora;Intramacronucleata;Conthreep;Oligohymenophorea;Scuticociliatia;Cohnilembus;";"0.0";"0";"1";"1";"0";"1";"0";"457182";"373894"
"V4mis1";"SILVA (only NR);Eukaryota;SAR;Alveolata;Ciliophora;Intramacronucleata;Conthreep;Oligohymenophorea;Scuticociliatia;Cristigera;";"0.0";"0";"4";"4";"0";"4";"0";"457179";"373894"
"V4mis1";"SILVA (only NR);Eukaryota;SAR;Alveolata;Ciliophora;Intramacronucleata;Conthreep;Oligohymenophorea;Scuticociliatia;Cyclidium;";"0.0";"0";"12";"12";"0";"12";"0";"457171";"373894"
"V4mis1";"SILVA (only NR);Eukaryota;SAR;Alveolata;Ciliophora;Intramacronucleata;Conthreep;Oligohymenophorea;Scuticociliatia;Dexiotricha;";"0.0";"0";"3";"3";"0";"3";"0";"457180";"373894"
"V4mis1";"SILVA (only NR);Eukaryota;SAR;Alveolata;Ciliophora;Intramacronucleata;Conthreep;Oligohymenophorea;Scuticociliatia;Dexitrichides;";"0.0";"0";"1";"1";"0";"1";"0";"457182";"373894"
"V4mis1";"SILVA (only NR);Eukaryota;SAR;Alveolata;Ciliophora;Intramacronucleata;Conthreep;Oligohymenophorea;Scuticociliatia;Entodiscus;";"0.0";"0";"1";"1";"0";"1";"0";"457182";"373894"
"V4mis1";"SILVA (only NR);Eukaryota;SAR;Alveolata;Ciliophora;Intramacronucleata;Conthreep;Oligohymenophorea;Scuticociliatia;Entorhipidium;";"0.0";"0";"1";"1";"0";"1";"0";"457182";"373894"
"V4mis1";"SILVA (only NR);Eukaryota;SAR;Alveolata;Ciliophora;Intramacronucleata;Conthreep;Oligohymenophorea;Scuticociliatia;Eurystomatella;";"0.0";"0";"1";"1";"0";"1";"0";"457182";"373894"
"V4mis1";"SILVA (only NR);Eukaryota;SAR;Alveolata;Ciliophora;Intramacronucleata;Conthreep;Oligohymenophorea;Scuticociliatia;Falcicyclidium;";"0.0";"0";"2";"2";"0";"2";"0";"457181";"373894"
"V4mis1";"SILVA (only NR);Eukaryota;SAR;Alveolata;Ciliophora;Intramacronucleata;Conthreep;Oligohymenophorea;Scuticociliatia;Hippocomos;";"0.0";"0";"1";"1";"0";"1";"0";"457182";"373894"
"V4mis1";"SILVA (only NR);Eukaryota;SAR;Alveolata;Ciliophora;Intramacronucleata;Conthreep;Oligohymenophorea;Scuticociliatia;Histiobalantium;";"0.0";"0";"3";"3";"0";"3";"0";"457180";"373894"
"V4mis1";"SILVA (only NR);Eukaryota;SAR;Alveolata;Ciliophora;Intramacronucleata;Conthreep;Oligohymenophorea;Scuticociliatia;Homalogastra;";"0.0";"0";"13";"13";"0";"13";"0";"457170";"373894"
"V4mis1";"SILVA (only NR);Eukaryota;SAR;Alveolata;Ciliophora;Intramacronucleata;Conthreep;Oligohymenophorea;Scuticociliatia;Mesanophrys;";"0.0";"0";"2";"2";"0";"2";"0";"457181";"373894"
"V4mis1";"SILVA (only NR);Eukaryota;SAR;Alveolata;Ciliophora;Intramacronucleata;Conthreep;Oligohymenophorea;Scuticociliatia;Metanophrys;";"0.0";"0";"3";"3";"0";"3";"0";"457180";"373894"
"V4mis1";"SILVA (only NR);Eukaryota;SAR;Alveolata;Ciliophora;Intramacronucleata;Conthreep;Oligohymenophorea;Scuticociliatia;Miamiensis;";"0.0";"0";"3";"3";"0";"3";"0";"457180";"373894"
"V4mis1";"SILVA (only NR);Eukaryota;SAR;Alveolata;Ciliophora;Intramacronucleata;Conthreep;Oligohymenophorea;Scuticociliatia;Paranophrys;";"0.0";"0";"2";"2";"0";"2";"0";"457181";"373894"
"V4mis1";"SILVA (only NR);Eukaryota;SAR;Alveolata;Ciliophora;Intramacronucleata;Conthreep;Oligohymenophorea;Scuticociliatia;Paratetrahymena;";"0.0";"0";"2";"2";"0";"2";"0";"457181";"373894"
"V4mis1";"SILVA (only NR);Eukaryota;SAR;Alveolata;Ciliophora;Intramacronucleata;Conthreep;Oligohymenophorea;Scuticociliatia;Parauronema;";"0.0";"0";"2";"2";"0";"2";"0";"457181";"373894"
"V4mis1";"SILVA (only NR);Eukaryota;SAR;Alveolata;Ciliophora;Intramacronucleata;Conthreep;Oligohymenophorea;Scuticociliatia;Philaster;";"0.0";"0";"4";"4";"0";"4";"0";"457179";"373894"
"V4mis1";"SILVA (only NR);Eukaryota;SAR;Alveolata;Ciliophora;Intramacronucleata;Conthreep;Oligohymenophorea;Scuticociliatia;Philasterides;";"0.0";"0";"1";"1";"0";"1";"0";"457182";"373894"
"V4mis1";"SILVA (only NR);Eukaryota;SAR;Alveolata;Ciliophora;Intramacronucleata;Conthreep;Oligohymenophorea;Scuticociliatia;Pleuronema;";"0.0";"0";"26";"26";"0";"26";"0";"457157";"373894"
"V4mis1";"SILVA (only NR);Eukaryota;SAR;Alveolata;Ciliophora;Intramacronucleata;Conthreep;Oligohymenophorea;Scuticociliatia;Porpostoma;";"0.0";"0";"1";"1";"0";"1";"0";"457182";"373894"
"V4mis1";"SILVA (only NR);Eukaryota;SAR;Alveolata;Ciliophora;Intramacronucleata;Conthreep;Oligohymenophorea;Scuticociliatia;Protocyclidium;";"0.0";"0";"7";"7";"0";"7";"0";"457176";"373894"
"V4mis1";"SILVA (only NR);Eukaryota;SAR;Alveolata;Ciliophora;Intramacronucleata;Conthreep;Oligohymenophorea;Scuticociliatia;Pseudocohnilembus;";"0.0";"0";"6";"6";"0";"6";"0";"457177";"373894"
"V4mis1";"SILVA (only NR);Eukaryota;SAR;Alveolata;Ciliophora;Intramacronucleata;Conthreep;Oligohymenophorea;Scuticociliatia;Pseudoplatynematum;";"0.0";"0";"1";"1";"0";"1";"0";"457182";"373894"
"V4mis1";"SILVA (only NR);Eukaryota;SAR;Alveolata;Ciliophora;Intramacronucleata;Conthreep;Oligohymenophorea;Scuticociliatia;Sathrophilus;";"0.0";"0";"2";"2";"0";"2";"0";"457181";"373894"
"V4mis1";"SILVA (only NR);Eukaryota;SAR;Alveolata;Ciliophora;Intramacronucleata;Conthreep;Oligohymenophorea;Scuticociliatia;Schizocalyptra;";"0.0";"0";"3";"3";"0";"3";"0";"457180";"373894"
"V4mis1";"SILVA (only NR);Eukaryota;SAR;Alveolata;Ciliophora;Intramacronucleata;Conthreep;Oligohymenophorea;Scuticociliatia;Schizocaryum;";"0.0";"0";"1";"1";"0";"1";"0";"457182";"373894"
"V4mis1";"SILVA (only NR);Eukaryota;SAR;Alveolata;Ciliophora;Intramacronucleata;Conthreep;Oligohymenophorea;Scuticociliatia;Thyrophylax;";"0.0";"0";"1";"1";"0";"1";"0";"457182";"373894"
"V4mis1";"SILVA (only NR);Eukaryota;SAR;Alveolata;Ciliophora;Intramacronucleata;Conthreep;Oligohymenophorea;Scuticociliatia;Uronema;";"0.0";"0";"4";"4";"0";"4";"0";"457179";"373894"
"V4mis1";"SILVA (only NR);Eukaryota;SAR;Alveolata;Ciliophora;Intramacronucleata;Conthreep;Oligohymenophorea;Scuticociliatia;Uronemella;";"0.0";"0";"2";"2";"0";"2";"0";"457181";"373894"
"V4mis1";"SILVA (only NR);Eukaryota;SAR;Alveolata;Ciliophora;Intramacronucleata;Conthreep;Oligohymenophorea;Scuticociliatia;Wilbertia;";"0.0";"0";"1";"1";"0";"1";"0";"457182";"373894"
"V4mis1";"SILVA (only NR);Eukaryota;SAR;Alveolata;Ciliophora;Intramacronucleata;Conthreep;Oligohymenophorea;Scuticociliatia;uncultured;";"0.0";"0";"44";"43";"0";"43";"1";"457140";"373894"
"V4mis1";"SILVA (only NR);Eukaryota;SAR;Alveolata;Ciliophora;Intramacronucleata;Conthreep;Oligohymenophorea;uncultured;";"0.0";"0";"2";"2";"0";"2";"0";"457181";"373894"
"V4mis1";"SILVA (only NR);Eukaryota;SAR;Alveolata;Ciliophora;Intramacronucleata;Conthreep;Phyllopharyngea;";"72.2";"18.2";"144";"144";"104";"40";"0";"457039";"373790"
"V4mis1";"SILVA (only NR);Eukaryota;SAR;Alveolata;Ciliophora;Intramacronucleata;Conthreep;Phyllopharyngea;Cyrtophoria;";"86.9";"18.2";"99";"99";"86";"13";"0";"457084";"373808"
"V4mis1";"SILVA (only NR);Eukaryota;SAR;Alveolata;Ciliophora;Intramacronucleata;Conthreep;Phyllopharyngea;Cyrtophoria;Aegyriana;";"100.0";"18.2";"2";"2";"2";"0";"0";"457181";"373892"
"V4mis1";"SILVA (only NR);Eukaryota;SAR;Alveolata;Ciliophora;Intramacronucleata;Conthreep;Phyllopharyngea;Cyrtophoria;Agnathodysteria;";"100.0";"18.2";"1";"1";"1";"0";"0";"457182";"373893"
"V4mis1";"SILVA (only NR);Eukaryota;SAR;Alveolata;Ciliophora;Intramacronucleata;Conthreep;Phyllopharyngea;Cyrtophoria;Brooklynella;";"100.0";"18.2";"1";"1";"1";"0";"0";"457182";"373893"
"V4mis1";"SILVA (only NR);Eukaryota;SAR;Alveolata;Ciliophora;Intramacronucleata;Conthreep;Phyllopharyngea;Cyrtophoria;Chilodochona;";"100.0";"18.2";"3";"3";"3";"0";"0";"457180";"373891"
"V4mis1";"SILVA (only NR);Eukaryota;SAR;Alveolata;Ciliophora;Intramacronucleata;Conthreep;Phyllopharyngea;Cyrtophoria;Chilodonella;";"100.0";"18.2";"5";"5";"5";"0";"0";"457178";"373889"
"V4mis1";"SILVA (only NR);Eukaryota;SAR;Alveolata;Ciliophora;Intramacronucleata;Conthreep;Phyllopharyngea;Cyrtophoria;Chlamydodon;";"100.0";"18.2";"9";"9";"9";"0";"0";"457174";"373885"
"V4mis1";"SILVA (only NR);Eukaryota;SAR;Alveolata;Ciliophora;Intramacronucleata;Conthreep;Phyllopharyngea;Cyrtophoria;Chlamydonella;";"0.0";"0";"2";"2";"0";"2";"0";"457181";"373894"
"V4mis1";"SILVA (only NR);Eukaryota;SAR;Alveolata;Ciliophora;Intramacronucleata;Conthreep;Phyllopharyngea;Cyrtophoria;Chlamydonellopsis;";"0.0";"0";"2";"2";"0";"2";"0";"457181";"373894"
"V4mis1";"SILVA (only NR);Eukaryota;SAR;Alveolata;Ciliophora;Intramacronucleata;Conthreep;Phyllopharyngea;Cyrtophoria;Coeloperix;";"100.0";"18.2";"4";"4";"4";"0";"0";"457179";"373890"
"V4mis1";"SILVA (only NR);Eukaryota;SAR;Alveolata;Ciliophora;Intramacronucleata;Conthreep;Phyllopharyngea;Cyrtophoria;Dysteria;";"76.5";"18.2";"17";"17";"13";"4";"0";"457166";"373881"
"V4mis1";"SILVA (only NR);Eukaryota;SAR;Alveolata;Ciliophora;Intramacronucleata;Conthreep;Phyllopharyngea;Cyrtophoria;Hartmannula;";"100.0";"18.2";"2";"2";"2";"0";"0";"457181";"373892"
"V4mis1";"SILVA (only NR);Eukaryota;SAR;Alveolata;Ciliophora;Intramacronucleata;Conthreep;Phyllopharyngea;Cyrtophoria;Heterohartmannula;";"100.0";"18.2";"1";"1";"1";"0";"0";"457182";"373893"
"V4mis1";"SILVA (only NR);Eukaryota;SAR;Alveolata;Ciliophora;Intramacronucleata;Conthreep;Phyllopharyngea;Cyrtophoria;Microxysma;";"100.0";"18.2";"1";"1";"1";"0";"0";"457182";"373893"
"V4mis1";"SILVA (only NR);Eukaryota;SAR;Alveolata;Ciliophora;Intramacronucleata;Conthreep;Phyllopharyngea;Cyrtophoria;Odontochlamys;";"100.0";"18.2";"1";"1";"1";"0";"0";"457182";"373893"
"V4mis1";"SILVA (only NR);Eukaryota;SAR;Alveolata;Ciliophora;Intramacronucleata;Conthreep;Phyllopharyngea;Cyrtophoria;Paracyrtophoron;";"100.0";"18.2";"1";"1";"1";"0";"0";"457182";"373893"
"V4mis1";"SILVA (only NR);Eukaryota;SAR;Alveolata;Ciliophora;Intramacronucleata;Conthreep;Phyllopharyngea;Cyrtophoria;Phascolodon;";"85.7";"18.2";"7";"7";"6";"1";"0";"457176";"373888"
"V4mis1";"SILVA (only NR);Eukaryota;SAR;Alveolata;Ciliophora;Intramacronucleata;Conthreep;Phyllopharyngea;Cyrtophoria;Pithites;";"91.7";"18.2";"12";"12";"11";"1";"0";"457171";"373883"
"V4mis1";"SILVA (only NR);Eukaryota;SAR;Alveolata;Ciliophora;Intramacronucleata;Conthreep;Phyllopharyngea;Cyrtophoria;Pseudochilodonopsis;";"100.0";"18.2";"5";"5";"5";"0";"0";"457178";"373889"
"V4mis1";"SILVA (only NR);Eukaryota;SAR;Alveolata;Ciliophora;Intramacronucleata;Conthreep;Phyllopharyngea;Cyrtophoria;Trichopodiella;";"100.0";"18.2";"1";"1";"1";"0";"0";"457182";"373893"
"V4mis1";"SILVA (only NR);Eukaryota;SAR;Alveolata;Ciliophora;Intramacronucleata;Conthreep;Phyllopharyngea;Cyrtophoria;Trithigmostoma;";"100.0";"18.2";"1";"1";"1";"0";"0";"457182";"373893"
"V4mis1";"SILVA (only NR);Eukaryota;SAR;Alveolata;Ciliophora;Intramacronucleata;Conthreep;Phyllopharyngea;Cyrtophoria;Trochilia;";"100.0";"18.2";"1";"1";"1";"0";"0";"457182";"373893"
"V4mis1";"SILVA (only NR);Eukaryota;SAR;Alveolata;Ciliophora;Intramacronucleata;Conthreep;Phyllopharyngea;Cyrtophoria;Trochilioides;";"100.0";"18.2";"1";"1";"1";"0";"0";"457182";"373893"
"V4mis1";"SILVA (only NR);Eukaryota;SAR;Alveolata;Ciliophora;Intramacronucleata;Conthreep;Phyllopharyngea;Cyrtophoria;Trochochilodon;";"100.0";"18.2";"1";"1";"1";"0";"0";"457182";"373893"
"V4mis1";"SILVA (only NR);Eukaryota;SAR;Alveolata;Ciliophora;Intramacronucleata;Conthreep;Phyllopharyngea;Hypocomatida;";"0.0";"0";"1";"1";"0";"1";"0";"457182";"373894"
"V4mis1";"SILVA (only NR);Eukaryota;SAR;Alveolata;Ciliophora;Intramacronucleata;Conthreep;Phyllopharyngea;Hypocomatida;Hypocoma;";"0.0";"0";"1";"1";"0";"1";"0";"457182";"373894"
"V4mis1";"SILVA (only NR);Eukaryota;SAR;Alveolata;Ciliophora;Intramacronucleata;Conthreep;Phyllopharyngea;Suctoria;";"41.9";"18.2";"43";"43";"18";"25";"0";"457140";"373876"
"V4mis1";"SILVA (only NR);Eukaryota;SAR;Alveolata;Ciliophora;Intramacronucleata;Conthreep;Phyllopharyngea;Suctoria;Acineta;";"57.1";"18.2";"7";"7";"4";"3";"0";"457176";"373890"
"V4mis1";"SILVA (only NR);Eukaryota;SAR;Alveolata;Ciliophora;Intramacronucleata;Conthreep;Phyllopharyngea;Suctoria;BOLA439;";"0.0";"0";"4";"4";"0";"4";"0";"457179";"373894"
"V4mis1";"SILVA (only NR);Eukaryota;SAR;Alveolata;Ciliophora;Intramacronucleata;Conthreep;Phyllopharyngea;Suctoria;Discophrya;";"100.0";"18.2";"1";"1";"1";"0";"0";"457182";"373893"
"V4mis1";"SILVA (only NR);Eukaryota;SAR;Alveolata;Ciliophora;Intramacronucleata;Conthreep;Phyllopharyngea;Suctoria;Ephelota;";"87.5";"18.2";"8";"8";"7";"1";"0";"457175";"373887"
"V4mis1";"SILVA (only NR);Eukaryota;SAR;Alveolata;Ciliophora;Intramacronucleata;Conthreep;Phyllopharyngea;Suctoria;Heliophrya;";"66.7";"18.2";"3";"3";"2";"1";"0";"457180";"373892"
"V4mis1";"SILVA (only NR);Eukaryota;SAR;Alveolata;Ciliophora;Intramacronucleata;Conthreep;Phyllopharyngea;Suctoria;Paracineta;";"0.0";"0";"5";"5";"0";"5";"0";"457178";"373894"
"V4mis1";"SILVA (only NR);Eukaryota;SAR;Alveolata;Ciliophora;Intramacronucleata;Conthreep;Phyllopharyngea;Suctoria;Tokophrya;";"0.0";"0";"8";"8";"0";"8";"0";"457175";"373894"
"V4mis1";"SILVA (only NR);Eukaryota;SAR;Alveolata;Ciliophora;Intramacronucleata;Conthreep;Plagiopylea;";"0.0";"0";"47";"47";"0";"47";"0";"457136";"373894"
"V4mis1";"SILVA (only NR);Eukaryota;SAR;Alveolata;Ciliophora;Intramacronucleata;Conthreep;Plagiopylea;Odontostomatida;";"0.0";"0";"12";"12";"0";"12";"0";"457171";"373894"
"V4mis1";"SILVA (only NR);Eukaryota;SAR;Alveolata;Ciliophora;Intramacronucleata;Conthreep;Plagiopylea;Odontostomatida;Epalxella;";"0.0";"0";"12";"12";"0";"12";"0";"457171";"373894"
"V4mis1";"SILVA (only NR);Eukaryota;SAR;Alveolata;Ciliophora;Intramacronucleata;Conthreep;Plagiopylea;Plagiopylida;";"0.0";"0";"34";"34";"0";"34";"0";"457149";"373894"
"V4mis1";"SILVA (only NR);Eukaryota;SAR;Alveolata;Ciliophora;Intramacronucleata;Conthreep;Plagiopylea;Plagiopylida;FV36-2C12;";"0.0";"0";"3";"3";"0";"3";"0";"457180";"373894"
"V4mis1";"SILVA (only NR);Eukaryota;SAR;Alveolata;Ciliophora;Intramacronucleata;Conthreep;Plagiopylea;Plagiopylida;Lechriopyla;";"0.0";"0";"6";"6";"0";"6";"0";"457177";"373894"
"V4mis1";"SILVA (only NR);Eukaryota;SAR;Alveolata;Ciliophora;Intramacronucleata;Conthreep;Plagiopylea;Plagiopylida;Parasonderia;";"0.0";"0";"3";"3";"0";"3";"0";"457180";"373894"
"V4mis1";"SILVA (only NR);Eukaryota;SAR;Alveolata;Ciliophora;Intramacronucleata;Conthreep;Plagiopylea;Plagiopylida;Plagiopyla;";"0.0";"0";"4";"4";"0";"4";"0";"457179";"373894"
"V4mis1";"SILVA (only NR);Eukaryota;SAR;Alveolata;Ciliophora;Intramacronucleata;Conthreep;Plagiopylea;Plagiopylida;RM1-SG02;";"0.0";"0";"2";"2";"0";"2";"0";"457181";"373894"
"V4mis1";"SILVA (only NR);Eukaryota;SAR;Alveolata;Ciliophora;Intramacronucleata;Conthreep;Plagiopylea;Plagiopylida;Trimyema;";"0.0";"0";"13";"13";"0";"13";"0";"457170";"373894"
"V4mis1";"SILVA (only NR);Eukaryota;SAR;Alveolata;Ciliophora;Intramacronucleata;Conthreep;Prostomatea;";"0.0";"0";"99";"99";"0";"99";"0";"457084";"373894"
"V4mis1";"SILVA (only NR);Eukaryota;SAR;Alveolata;Ciliophora;Intramacronucleata;Conthreep;Prostomatea;Coleps;";"0.0";"0";"6";"6";"0";"6";"0";"457177";"373894"
"V4mis1";"SILVA (only NR);Eukaryota;SAR;Alveolata;Ciliophora;Intramacronucleata;Conthreep;Prostomatea;Cryptocaryon;";"0.0";"0";"68";"68";"0";"68";"0";"457115";"373894"
"V4mis1";"SILVA (only NR);Eukaryota;SAR;Alveolata;Ciliophora;Intramacronucleata;Conthreep;Prostomatea;Levicoleps;";"0.0";"0";"2";"2";"0";"2";"0";"457181";"373894"
"V4mis1";"SILVA (only NR);Eukaryota;SAR;Alveolata;Ciliophora;Intramacronucleata;Conthreep;Prostomatea;Nolandia;";"0.0";"0";"2";"2";"0";"2";"0";"457181";"373894"
"V4mis1";"SILVA (only NR);Eukaryota;SAR;Alveolata;Ciliophora;Intramacronucleata;Conthreep;Prostomatea;Pinacocoleps;";"0.0";"0";"1";"1";"0";"1";"0";"457182";"373894"
"V4mis1";"SILVA (only NR);Eukaryota;SAR;Alveolata;Ciliophora;Intramacronucleata;Conthreep;Prostomatea;Placus;";"0.0";"0";"3";"3";"0";"3";"0";"457180";"373894"
"V4mis1";"SILVA (only NR);Eukaryota;SAR;Alveolata;Ciliophora;Intramacronucleata;Conthreep;Prostomatea;Plagiopogon;";"0.0";"0";"1";"1";"0";"1";"0";"457182";"373894"
"V4mis1";"SILVA (only NR);Eukaryota;SAR;Alveolata;Ciliophora;Intramacronucleata;Conthreep;Prostomatea;Prorodon;";"0.0";"0";"10";"10";"0";"10";"0";"457173";"373894"
"V4mis1";"SILVA (only NR);Eukaryota;SAR;Alveolata;Ciliophora;Intramacronucleata;Conthreep;Prostomatea;Spathidiopsis;";"0.0";"0";"1";"1";"0";"1";"0";"457182";"373894"
"V4mis1";"SILVA (only NR);Eukaryota;SAR;Alveolata;Ciliophora;Intramacronucleata;Conthreep;Prostomatea;Tiarina;";"0.0";"0";"2";"2";"0";"2";"0";"457181";"373894"
"V4mis1";"SILVA (only NR);Eukaryota;SAR;Alveolata;Ciliophora;Intramacronucleata;Litostomatea;";"10.2";"18.1";"450";"450";"46";"404";"0";"456733";"373848"
"V4mis1";"SILVA (only NR);Eukaryota;SAR;Alveolata;Ciliophora;Intramacronucleata;Litostomatea;Haptoria;";"1.8";"18.2";"169";"169";"3";"166";"0";"457014";"373891"
"V4mis1";"SILVA (only NR);Eukaryota;SAR;Alveolata;Ciliophora;Intramacronucleata;Litostomatea;Haptoria;Acineria;";"0.0";"0";"2";"2";"0";"2";"0";"457181";"373894"
"V4mis1";"SILVA (only NR);Eukaryota;SAR;Alveolata;Ciliophora;Intramacronucleata;Litostomatea;Haptoria;Amphileptus;";"0.0";"0";"5";"5";"0";"5";"0";"457178";"373894"
"V4mis1";"SILVA (only NR);Eukaryota;SAR;Alveolata;Ciliophora;Intramacronucleata;Litostomatea;Haptoria;Apobryophyllum;";"0.0";"0";"3";"3";"0";"3";"0";"457180";"373894"
"V4mis1";"SILVA (only NR);Eukaryota;SAR;Alveolata;Ciliophora;Intramacronucleata;Litostomatea;Haptoria;Arcuospathidium;";"0.0";"0";"9";"9";"0";"9";"0";"457174";"373894"
"V4mis1";"SILVA (only NR);Eukaryota;SAR;Alveolata;Ciliophora;Intramacronucleata;Litostomatea;Haptoria;Balantidion;";"0.0";"0";"1";"1";"0";"1";"0";"457182";"373894"
"V4mis1";"SILVA (only NR);Eukaryota;SAR;Alveolata;Ciliophora;Intramacronucleata;Litostomatea;Haptoria;Chaenea;";"0.0";"0";"6";"6";"0";"6";"0";"457177";"373894"
"V4mis1";"SILVA (only NR);Eukaryota;SAR;Alveolata;Ciliophora;Intramacronucleata;Litostomatea;Haptoria;Didinium;";"0.0";"0";"17";"17";"0";"17";"0";"457166";"373894"
"V4mis1";"SILVA (only NR);Eukaryota;SAR;Alveolata;Ciliophora;Intramacronucleata;Litostomatea;Haptoria;Dileptus;";"0.0";"0";"6";"6";"0";"6";"0";"457177";"373894"
"V4mis1";"SILVA (only NR);Eukaryota;SAR;Alveolata;Ciliophora;Intramacronucleata;Litostomatea;Haptoria;Dimacrocaryon;";"0.0";"0";"1";"1";"0";"1";"0";"457182";"373894"
"V4mis1";"SILVA (only NR);Eukaryota;SAR;Alveolata;Ciliophora;Intramacronucleata;Litostomatea;Haptoria;Enchelys;";"0.0";"0";"2";"2";"0";"2";"0";"457181";"373894"
"V4mis1";"SILVA (only NR);Eukaryota;SAR;Alveolata;Ciliophora;Intramacronucleata;Litostomatea;Haptoria;Epiphyllum;";"0.0";"0";"4";"4";"0";"4";"0";"457179";"373894"
"V4mis1";"SILVA (only NR);Eukaryota;SAR;Alveolata;Ciliophora;Intramacronucleata;Litostomatea;Haptoria;Epispathidium;";"0.0";"0";"2";"2";"0";"2";"0";"457181";"373894"
"V4mis1";"SILVA (only NR);Eukaryota;SAR;Alveolata;Ciliophora;Intramacronucleata;Litostomatea;Haptoria;Helicoprorodon;";"0.0";"0";"2";"2";"0";"2";"0";"457181";"373894"
"V4mis1";"SILVA (only NR);Eukaryota;SAR;Alveolata;Ciliophora;Intramacronucleata;Litostomatea;Haptoria;Hemiophrys;";"0.0";"0";"6";"6";"0";"6";"0";"457177";"373894"
"V4mis1";"SILVA (only NR);Eukaryota;SAR;Alveolata;Ciliophora;Intramacronucleata;Litostomatea;Haptoria;Homalozoon;";"0.0";"0";"2";"2";"0";"2";"0";"457181";"373894"
"V4mis1";"SILVA (only NR);Eukaryota;SAR;Alveolata;Ciliophora;Intramacronucleata;Litostomatea;Haptoria;Lacrymaria;";"0.0";"0";"2";"2";"0";"2";"0";"457181";"373894"
"V4mis1";"SILVA (only NR);Eukaryota;SAR;Alveolata;Ciliophora;Intramacronucleata;Litostomatea;Haptoria;Lagynophrya;";"0.0";"0";"1";"1";"0";"1";"0";"457182";"373894"
"V4mis1";"SILVA (only NR);Eukaryota;SAR;Alveolata;Ciliophora;Intramacronucleata;Litostomatea;Haptoria;Litonotus;";"0.0";"0";"6";"6";"0";"6";"0";"457177";"373894"
"V4mis1";"SILVA (only NR);Eukaryota;SAR;Alveolata;Ciliophora;Intramacronucleata;Litostomatea;Haptoria;Loxophyllum;";"0.0";"0";"9";"9";"0";"9";"0";"457174";"373894"
"V4mis1";"SILVA (only NR);Eukaryota;SAR;Alveolata;Ciliophora;Intramacronucleata;Litostomatea;Haptoria;Microdileptus;";"0.0";"0";"1";"1";"0";"1";"0";"457182";"373894"
"V4mis1";"SILVA (only NR);Eukaryota;SAR;Alveolata;Ciliophora;Intramacronucleata;Litostomatea;Haptoria;Monilicaryon;";"0.0";"0";"1";"1";"0";"1";"0";"457182";"373894"
"V4mis1";"SILVA (only NR);Eukaryota;SAR;Alveolata;Ciliophora;Intramacronucleata;Litostomatea;Haptoria;Phialina;";"0.0";"0";"3";"3";"0";"3";"0";"457180";"373894"
"V4mis1";"SILVA (only NR);Eukaryota;SAR;Alveolata;Ciliophora;Intramacronucleata;Litostomatea;Haptoria;Protospathidium;";"0.0";"0";"1";"1";"0";"1";"0";"457182";"373894"
"V4mis1";"SILVA (only NR);Eukaryota;SAR;Alveolata;Ciliophora;Intramacronucleata;Litostomatea;Haptoria;Pseudoholophrya;";"0.0";"0";"1";"1";"0";"1";"0";"457182";"373894"
"V4mis1";"SILVA (only NR);Eukaryota;SAR;Alveolata;Ciliophora;Intramacronucleata;Litostomatea;Haptoria;Pseudomonilicaryon;";"0.0";"0";"3";"3";"0";"3";"0";"457180";"373894"
"V4mis1";"SILVA (only NR);Eukaryota;SAR;Alveolata;Ciliophora;Intramacronucleata;Litostomatea;Haptoria;Rurikoplites;";"0.0";"0";"4";"4";"0";"4";"0";"457179";"373894"
"V4mis1";"SILVA (only NR);Eukaryota;SAR;Alveolata;Ciliophora;Intramacronucleata;Litostomatea;Haptoria;Spathidium;";"0.0";"0";"8";"8";"0";"8";"0";"457175";"373894"
"V4mis1";"SILVA (only NR);Eukaryota;SAR;Alveolata;Ciliophora;Intramacronucleata;Litostomatea;Haptoria;Teuthophrys;";"0.0";"0";"1";"1";"0";"1";"0";"457182";"373894"
"V4mis1";"SILVA (only NR);Eukaryota;SAR;Alveolata;Ciliophora;Intramacronucleata;Litostomatea;Haptoria;Trachelius;";"0.0";"0";"1";"1";"0";"1";"0";"457182";"373894"
"V4mis1";"SILVA (only NR);Eukaryota;SAR;Alveolata;Ciliophora;Intramacronucleata;Litostomatea;Haptoria;Trachelotractus;";"0.0";"0";"4";"4";"0";"4";"0";"457179";"373894"
"V4mis1";"SILVA (only NR);Eukaryota;SAR;Alveolata;Ciliophora;Intramacronucleata;Litostomatea;Haptoria;uncultured;";"42.9";"18.2";"7";"7";"3";"4";"0";"457176";"373891"
"V4mis1";"SILVA (only NR);Eukaryota;SAR;Alveolata;Ciliophora;Intramacronucleata;Litostomatea;Mesodiniidae;";"67.2";"18.2";"64";"64";"43";"21";"0";"457119";"373851"
"V4mis1";"SILVA (only NR);Eukaryota;SAR;Alveolata;Ciliophora;Intramacronucleata;Litostomatea;Mesodiniidae;FV18-2A2;";"100.0";"18.2";"5";"5";"5";"0";"0";"457178";"373889"
"V4mis1";"SILVA (only NR);Eukaryota;SAR;Alveolata;Ciliophora;Intramacronucleata;Litostomatea;Mesodiniidae;Mesodinium;";"75.0";"18.2";"4";"4";"3";"1";"0";"457179";"373891"
"V4mis1";"SILVA (only NR);Eukaryota;SAR;Alveolata;Ciliophora;Intramacronucleata;Litostomatea;Mesodiniidae;Myrionecta;";"85.7";"18.2";"21";"21";"18";"3";"0";"457162";"373876"
"V4mis1";"SILVA (only NR);Eukaryota;SAR;Alveolata;Ciliophora;Intramacronucleata;Litostomatea;Mesodiniidae;uncultured;";"21.1";"18.2";"19";"19";"4";"15";"0";"457164";"373890"
"V4mis1";"SILVA (only NR);Eukaryota;SAR;Alveolata;Ciliophora;Intramacronucleata;Litostomatea;Trichostomatia;";"0.0";"0";"215";"215";"0";"215";"0";"456968";"373894"
"V4mis1";"SILVA (only NR);Eukaryota;SAR;Alveolata;Ciliophora;Intramacronucleata;Litostomatea;Trichostomatia;Alloiozona;";"0.0";"0";"1";"1";"0";"1";"0";"457182";"373894"
"V4mis1";"SILVA (only NR);Eukaryota;SAR;Alveolata;Ciliophora;Intramacronucleata;Litostomatea;Trichostomatia;Amylovorax;";"0.0";"0";"2";"2";"0";"2";"0";"457181";"373894"
"V4mis1";"SILVA (only NR);Eukaryota;SAR;Alveolata;Ciliophora;Intramacronucleata;Litostomatea;Trichostomatia;Balantidium;";"0.0";"0";"7";"7";"0";"7";"0";"457176";"373894"
"V4mis1";"SILVA (only NR);Eukaryota;SAR;Alveolata;Ciliophora;Intramacronucleata;Litostomatea;Trichostomatia;Bandia;";"0.0";"0";"3";"3";"0";"3";"0";"457180";"373894"
"V4mis1";"SILVA (only NR);Eukaryota;SAR;Alveolata;Ciliophora;Intramacronucleata;Litostomatea;Trichostomatia;Bitricha;";"0.0";"0";"2";"2";"0";"2";"0";"457181";"373894"
"V4mis1";"SILVA (only NR);Eukaryota;SAR;Alveolata;Ciliophora;Intramacronucleata;Litostomatea;Trichostomatia;Blepharocorys;";"0.0";"0";"8";"8";"0";"8";"0";"457175";"373894"
"V4mis1";"SILVA (only NR);Eukaryota;SAR;Alveolata;Ciliophora;Intramacronucleata;Litostomatea;Trichostomatia;Bundleia;";"0.0";"0";"5";"5";"0";"5";"0";"457178";"373894"
"V4mis1";"SILVA (only NR);Eukaryota;SAR;Alveolata;Ciliophora;Intramacronucleata;Litostomatea;Trichostomatia;Buxtonella;";"0.0";"0";"1";"1";"0";"1";"0";"457182";"373894"
"V4mis1";"SILVA (only NR);Eukaryota;SAR;Alveolata;Ciliophora;Intramacronucleata;Litostomatea;Trichostomatia;Charonina;";"0.0";"0";"1";"1";"0";"1";"0";"457182";"373894"
"V4mis1";"SILVA (only NR);Eukaryota;SAR;Alveolata;Ciliophora;Intramacronucleata;Litostomatea;Trichostomatia;Cochliatoxum;";"0.0";"0";"1";"1";"0";"1";"0";"457182";"373894"
"V4mis1";"SILVA (only NR);Eukaryota;SAR;Alveolata;Ciliophora;Intramacronucleata;Litostomatea;Trichostomatia;Cycloposthium;";"0.0";"0";"2";"2";"0";"2";"0";"457181";"373894"
"V4mis1";"SILVA (only NR);Eukaryota;SAR;Alveolata;Ciliophora;Intramacronucleata;Litostomatea;Trichostomatia;Dasytricha;";"0.0";"0";"22";"22";"0";"22";"0";"457161";"373894"
"V4mis1";"SILVA (only NR);Eukaryota;SAR;Alveolata;Ciliophora;Intramacronucleata;Litostomatea;Trichostomatia;Diplodinium;";"0.0";"0";"11";"11";"0";"11";"0";"457172";"373894"
"V4mis1";"SILVA (only NR);Eukaryota;SAR;Alveolata;Ciliophora;Intramacronucleata;Litostomatea;Trichostomatia;Diploplastron;";"0.0";"0";"1";"1";"0";"1";"0";"457182";"373894"
"V4mis1";"SILVA (only NR);Eukaryota;SAR;Alveolata;Ciliophora;Intramacronucleata;Litostomatea;Trichostomatia;Ditoxum;";"0.0";"0";"1";"1";"0";"1";"0";"457182";"373894"
"V4mis1";"SILVA (only NR);Eukaryota;SAR;Alveolata;Ciliophora;Intramacronucleata;Litostomatea;Trichostomatia;Enoploplastron;";"0.0";"0";"1";"1";"0";"1";"0";"457182";"373894"
"V4mis1";"SILVA (only NR);Eukaryota;SAR;Alveolata;Ciliophora;Intramacronucleata;Litostomatea;Trichostomatia;Entodinium;";"0.0";"0";"63";"63";"0";"63";"0";"457120";"373894"
"V4mis1";"SILVA (only NR);Eukaryota;SAR;Alveolata;Ciliophora;Intramacronucleata;Litostomatea;Trichostomatia;Eremoplastron;";"0.0";"0";"2";"2";"0";"2";"0";"457181";"373894"
"V4mis1";"SILVA (only NR);Eukaryota;SAR;Alveolata;Ciliophora;Intramacronucleata;Litostomatea;Trichostomatia;Eudiplodinium;";"0.0";"0";"2";"2";"0";"2";"0";"457181";"373894"
"V4mis1";"SILVA (only NR);Eukaryota;SAR;Alveolata;Ciliophora;Intramacronucleata;Litostomatea;Trichostomatia;Gassovskiella;";"0.0";"0";"1";"1";"0";"1";"0";"457182";"373894"
"V4mis1";"SILVA (only NR);Eukaryota;SAR;Alveolata;Ciliophora;Intramacronucleata;Litostomatea;Trichostomatia;Helicozoster;";"0.0";"0";"1";"1";"0";"1";"0";"457182";"373894"
"V4mis1";"SILVA (only NR);Eukaryota;SAR;Alveolata;Ciliophora;Intramacronucleata;Litostomatea;Trichostomatia;Hemiprorodon;";"0.0";"0";"1";"1";"0";"1";"0";"457182";"373894"
"V4mis1";"SILVA (only NR);Eukaryota;SAR;Alveolata;Ciliophora;Intramacronucleata;Litostomatea;Trichostomatia;Isotricha;";"0.0";"0";"8";"8";"0";"8";"0";"457175";"373894"
"V4mis1";"SILVA (only NR);Eukaryota;SAR;Alveolata;Ciliophora;Intramacronucleata;Litostomatea;Trichostomatia;Latteuria;";"0.0";"0";"2";"2";"0";"2";"0";"457181";"373894"
"V4mis1";"SILVA (only NR);Eukaryota;SAR;Alveolata;Ciliophora;Intramacronucleata;Litostomatea;Trichostomatia;Macropodinium;";"0.0";"0";"4";"4";"0";"4";"0";"457179";"373894"
"V4mis1";"SILVA (only NR);Eukaryota;SAR;Alveolata;Ciliophora;Intramacronucleata;Litostomatea;Trichostomatia;Metadinium;";"0.0";"0";"4";"4";"0";"4";"0";"457179";"373894"
"V4mis1";"SILVA (only NR);Eukaryota;SAR;Alveolata;Ciliophora;Intramacronucleata;Litostomatea;Trichostomatia;Neobalantidium;";"0.0";"0";"2";"2";"0";"2";"0";"457181";"373894"
"V4mis1";"SILVA (only NR);Eukaryota;SAR;Alveolata;Ciliophora;Intramacronucleata;Litostomatea;Trichostomatia;Ophryoscolex;";"0.0";"0";"14";"14";"0";"14";"0";"457169";"373894"
"V4mis1";"SILVA (only NR);Eukaryota;SAR;Alveolata;Ciliophora;Intramacronucleata;Litostomatea;Trichostomatia;Polycosta;";"0.0";"0";"1";"1";"0";"1";"0";"457182";"373894"
"V4mis1";"SILVA (only NR);Eukaryota;SAR;Alveolata;Ciliophora;Intramacronucleata;Litostomatea;Trichostomatia;Polydiniella;";"0.0";"0";"1";"1";"0";"1";"0";"457182";"373894"
"V4mis1";"SILVA (only NR);Eukaryota;SAR;Alveolata;Ciliophora;Intramacronucleata;Litostomatea;Trichostomatia;Polyplastron;";"0.0";"0";"11";"11";"0";"11";"0";"457172";"373894"
"V4mis1";"SILVA (only NR);Eukaryota;SAR;Alveolata;Ciliophora;Intramacronucleata;Litostomatea;Trichostomatia;Raabena;";"0.0";"0";"1";"1";"0";"1";"0";"457182";"373894"
"V4mis1";"SILVA (only NR);Eukaryota;SAR;Alveolata;Ciliophora;Intramacronucleata;Litostomatea;Trichostomatia;Spirodinium;";"0.0";"0";"1";"1";"0";"1";"0";"457182";"373894"
"V4mis1";"SILVA (only NR);Eukaryota;SAR;Alveolata;Ciliophora;Intramacronucleata;Litostomatea;Trichostomatia;Tetratoxum;";"0.0";"0";"1";"1";"0";"1";"0";"457182";"373894"
"V4mis1";"SILVA (only NR);Eukaryota;SAR;Alveolata;Ciliophora;Intramacronucleata;Litostomatea;Trichostomatia;Triadinium;";"0.0";"0";"2";"2";"0";"2";"0";"457181";"373894"
"V4mis1";"SILVA (only NR);Eukaryota;SAR;Alveolata;Ciliophora;Intramacronucleata;Litostomatea;Trichostomatia;Tripalmaria;";"0.0";"0";"1";"1";"0";"1";"0";"457182";"373894"
"V4mis1";"SILVA (only NR);Eukaryota;SAR;Alveolata;Ciliophora;Intramacronucleata;Litostomatea;Trichostomatia;Triplumaria;";"0.0";"0";"3";"3";"0";"3";"0";"457180";"373894"
"V4mis1";"SILVA (only NR);Eukaryota;SAR;Alveolata;Ciliophora;Intramacronucleata;Litostomatea;Trichostomatia;Troglodytella;";"0.0";"0";"1";"1";"0";"1";"0";"457182";"373894"
"V4mis1";"SILVA (only NR);Eukaryota;SAR;Alveolata;Ciliophora;Intramacronucleata;Litostomatea;Trichostomatia;uncultured;";"0.0";"0";"2";"2";"0";"2";"0";"457181";"373894"
"V4mis1";"SILVA (only NR);Eukaryota;SAR;Alveolata;Ciliophora;Intramacronucleata;Spirotrichea;";"0.1";"18";"1174";"1172";"1";"1171";"2";"456011";"373893"
"V4mis1";"SILVA (only NR);Eukaryota;SAR;Alveolata;Ciliophora;Intramacronucleata;Spirotrichea;Choreotrichia;";"0.0";"0";"249";"249";"0";"249";"0";"456934";"373894"
"V4mis1";"SILVA (only NR);Eukaryota;SAR;Alveolata;Ciliophora;Intramacronucleata;Spirotrichea;Choreotrichia;Amphorellopsis;";"0.0";"0";"4";"4";"0";"4";"0";"457179";"373894"
"V4mis1";"SILVA (only NR);Eukaryota;SAR;Alveolata;Ciliophora;Intramacronucleata;Spirotrichea;Choreotrichia;Ascampbelliella;";"0.0";"0";"1";"1";"0";"1";"0";"457182";"373894"
"V4mis1";"SILVA (only NR);Eukaryota;SAR;Alveolata;Ciliophora;Intramacronucleata;Spirotrichea;Choreotrichia;Codonella;";"0.0";"0";"2";"2";"0";"2";"0";"457181";"373894"
"V4mis1";"SILVA (only NR);Eukaryota;SAR;Alveolata;Ciliophora;Intramacronucleata;Spirotrichea;Choreotrichia;Codonellopsis;";"0.0";"0";"5";"5";"0";"5";"0";"457178";"373894"
"V4mis1";"SILVA (only NR);Eukaryota;SAR;Alveolata;Ciliophora;Intramacronucleata;Spirotrichea;Choreotrichia;Cyttarocylis;";"0.0";"0";"1";"1";"0";"1";"0";"457182";"373894"
"V4mis1";"SILVA (only NR);Eukaryota;SAR;Alveolata;Ciliophora;Intramacronucleata;Spirotrichea;Choreotrichia;Epiplocylis;";"0.0";"0";"1";"1";"0";"1";"0";"457182";"373894"
"V4mis1";"SILVA (only NR);Eukaryota;SAR;Alveolata;Ciliophora;Intramacronucleata;Spirotrichea;Choreotrichia;Epiplocyloides;";"0.0";"0";"1";"1";"0";"1";"0";"457182";"373894"
"V4mis1";"SILVA (only NR);Eukaryota;SAR;Alveolata;Ciliophora;Intramacronucleata;Spirotrichea;Choreotrichia;Eutintinnus;";"0.0";"0";"10";"10";"0";"10";"0";"457173";"373894"
"V4mis1";"SILVA (only NR);Eukaryota;SAR;Alveolata;Ciliophora;Intramacronucleata;Spirotrichea;Choreotrichia;Favella;";"0.0";"0";"3";"3";"0";"3";"0";"457180";"373894"
"V4mis1";"SILVA (only NR);Eukaryota;SAR;Alveolata;Ciliophora;Intramacronucleata;Spirotrichea;Choreotrichia;Helicostomella;";"0.0";"0";"3";"3";"0";"3";"0";"457180";"373894"
"V4mis1";"SILVA (only NR);Eukaryota;SAR;Alveolata;Ciliophora;Intramacronucleata;Spirotrichea;Choreotrichia;Leprotintinnus;";"0.0";"0";"1";"1";"0";"1";"0";"457182";"373894"
"V4mis1";"SILVA (only NR);Eukaryota;SAR;Alveolata;Ciliophora;Intramacronucleata;Spirotrichea;Choreotrichia;Metacylis;";"0.0";"0";"6";"6";"0";"6";"0";"457177";"373894"
"V4mis1";"SILVA (only NR);Eukaryota;SAR;Alveolata;Ciliophora;Intramacronucleata;Spirotrichea;Choreotrichia;Parastrombidinopsis;";"0.0";"0";"4";"4";"0";"4";"0";"457179";"373894"
"V4mis1";"SILVA (only NR);Eukaryota;SAR;Alveolata;Ciliophora;Intramacronucleata;Spirotrichea;Choreotrichia;Pelagostrobilidium;";"0.0";"0";"12";"12";"0";"12";"0";"457171";"373894"
"V4mis1";"SILVA (only NR);Eukaryota;SAR;Alveolata;Ciliophora;Intramacronucleata;Spirotrichea;Choreotrichia;Rimostrombidium;";"0.0";"0";"8";"8";"0";"8";"0";"457175";"373894"
"V4mis1";"SILVA (only NR);Eukaryota;SAR;Alveolata;Ciliophora;Intramacronucleata;Spirotrichea;Choreotrichia;Salpingacantha;";"0.0";"0";"1";"1";"0";"1";"0";"457182";"373894"
"V4mis1";"SILVA (only NR);Eukaryota;SAR;Alveolata;Ciliophora;Intramacronucleata;Spirotrichea;Choreotrichia;Salpingella;";"0.0";"0";"3";"3";"0";"3";"0";"457180";"373894"
"V4mis1";"SILVA (only NR);Eukaryota;SAR;Alveolata;Ciliophora;Intramacronucleata;Spirotrichea;Choreotrichia;Steenstrupiella;";"0.0";"0";"7";"7";"0";"7";"0";"457176";"373894"
"V4mis1";"SILVA (only NR);Eukaryota;SAR;Alveolata;Ciliophora;Intramacronucleata;Spirotrichea;Choreotrichia;Stenosemella;";"0.0";"0";"2";"2";"0";"2";"0";"457181";"373894"
"V4mis1";"SILVA (only NR);Eukaryota;SAR;Alveolata;Ciliophora;Intramacronucleata;Spirotrichea;Choreotrichia;Strobilidium;";"0.0";"0";"1";"1";"0";"1";"0";"457182";"373894"
"V4mis1";"SILVA (only NR);Eukaryota;SAR;Alveolata;Ciliophora;Intramacronucleata;Spirotrichea;Choreotrichia;Strombidinopsis;";"0.0";"0";"3";"3";"0";"3";"0";"457180";"373894"
"V4mis1";"SILVA (only NR);Eukaryota;SAR;Alveolata;Ciliophora;Intramacronucleata;Spirotrichea;Choreotrichia;Tintinnidium;";"0.0";"0";"9";"9";"0";"9";"0";"457174";"373894"
"V4mis1";"SILVA (only NR);Eukaryota;SAR;Alveolata;Ciliophora;Intramacronucleata;Spirotrichea;Choreotrichia;Tintinnopsis;";"0.0";"0";"30";"30";"0";"30";"0";"457153";"373894"
"V4mis1";"SILVA (only NR);Eukaryota;SAR;Alveolata;Ciliophora;Intramacronucleata;Spirotrichea;Choreotrichia;Undella;";"0.0";"0";"1";"1";"0";"1";"0";"457182";"373894"
"V4mis1";"SILVA (only NR);Eukaryota;SAR;Alveolata;Ciliophora;Intramacronucleata;Spirotrichea;Choreotrichia;Xystonella;";"0.0";"0";"3";"3";"0";"3";"0";"457180";"373894"
"V4mis1";"SILVA (only NR);Eukaryota;SAR;Alveolata;Ciliophora;Intramacronucleata;Spirotrichea;Choreotrichia;uncultured;";"0.0";"0";"97";"97";"0";"97";"0";"457086";"373894"
"V4mis1";"SILVA (only NR);Eukaryota;SAR;Alveolata;Ciliophora;Intramacronucleata;Spirotrichea;Euplotia;";"0.0";"0";"130";"129";"0";"129";"1";"457054";"373894"
"V4mis1";"SILVA (only NR);Eukaryota;SAR;Alveolata;Ciliophora;Intramacronucleata;Spirotrichea;Euplotia;Apodiophrys;";"0.0";"0";"1";"1";"0";"1";"0";"457182";"373894"
"V4mis1";"SILVA (only NR);Eukaryota;SAR;Alveolata;Ciliophora;Intramacronucleata;Spirotrichea;Euplotia;Aspidisca;";"0.0";"0";"35";"35";"0";"35";"0";"457148";"373894"
"V4mis1";"SILVA (only NR);Eukaryota;SAR;Alveolata;Ciliophora;Intramacronucleata;Spirotrichea;Euplotia;Certesia;";"0.0";"0";"1";"1";"0";"1";"0";"457182";"373894"
"V4mis1";"SILVA (only NR);Eukaryota;SAR;Alveolata;Ciliophora;Intramacronucleata;Spirotrichea;Euplotia;Diophrys;";"0.0";"0";"9";"9";"0";"9";"0";"457174";"373894"
"V4mis1";"SILVA (only NR);Eukaryota;SAR;Alveolata;Ciliophora;Intramacronucleata;Spirotrichea;Euplotia;Discocephalus;";"0.0";"0";"4";"4";"0";"4";"0";"457179";"373894"
"V4mis1";"SILVA (only NR);Eukaryota;SAR;Alveolata;Ciliophora;Intramacronucleata;Spirotrichea;Euplotia;Euplotes;";"0.0";"0";"73";"72";"0";"72";"1";"457111";"373894"
"V4mis1";"SILVA (only NR);Eukaryota;SAR;Alveolata;Ciliophora;Intramacronucleata;Spirotrichea;Euplotia;Euplotidium;";"0.0";"0";"2";"2";"0";"2";"0";"457181";"373894"
"V4mis1";"SILVA (only NR);Eukaryota;SAR;Alveolata;Ciliophora;Intramacronucleata;Spirotrichea;Euplotia;Gastrocirrhus;";"0.0";"0";"1";"1";"0";"1";"0";"457182";"373894"
"V4mis1";"SILVA (only NR);Eukaryota;SAR;Alveolata;Ciliophora;Intramacronucleata;Spirotrichea;Euplotia;Paradiophrys;";"0.0";"0";"2";"2";"0";"2";"0";"457181";"373894"
"V4mis1";"SILVA (only NR);Eukaryota;SAR;Alveolata;Ciliophora;Intramacronucleata;Spirotrichea;Euplotia;Prodiscocephalus;";"0.0";"0";"1";"1";"0";"1";"0";"457182";"373894"
"V4mis1";"SILVA (only NR);Eukaryota;SAR;Alveolata;Ciliophora;Intramacronucleata;Spirotrichea;Hypotrichia;";"0.0";"0";"308";"307";"0";"307";"1";"456876";"373894"
"V4mis1";"SILVA (only NR);Eukaryota;SAR;Alveolata;Ciliophora;Intramacronucleata;Spirotrichea;Hypotrichia;Amphisiella;";"0.0";"0";"5";"5";"0";"5";"0";"457178";"373894"
"V4mis1";"SILVA (only NR);Eukaryota;SAR;Alveolata;Ciliophora;Intramacronucleata;Spirotrichea;Hypotrichia;Anteholosticha;";"0.0";"0";"2";"2";"0";"2";"0";"457181";"373894"
"V4mis1";"SILVA (only NR);Eukaryota;SAR;Alveolata;Ciliophora;Intramacronucleata;Spirotrichea;Hypotrichia;Apogastrostyla;";"0.0";"0";"1";"1";"0";"1";"0";"457182";"373894"
"V4mis1";"SILVA (only NR);Eukaryota;SAR;Alveolata;Ciliophora;Intramacronucleata;Spirotrichea;Hypotrichia;Apoholosticha;";"0.0";"0";"1";"1";"0";"1";"0";"457182";"373894"
"V4mis1";"SILVA (only NR);Eukaryota;SAR;Alveolata;Ciliophora;Intramacronucleata;Spirotrichea;Hypotrichia;Apokeronopsis;";"0.0";"0";"5";"5";"0";"5";"0";"457178";"373894"
"V4mis1";"SILVA (only NR);Eukaryota;SAR;Alveolata;Ciliophora;Intramacronucleata;Spirotrichea;Hypotrichia;Arcuseries;";"0.0";"0";"1";"1";"0";"1";"0";"457182";"373894"
"V4mis1";"SILVA (only NR);Eukaryota;SAR;Alveolata;Ciliophora;Intramacronucleata;Spirotrichea;Hypotrichia;Atractos;";"0.0";"0";"1";"1";"0";"1";"0";"457182";"373894"
"V4mis1";"SILVA (only NR);Eukaryota;SAR;Alveolata;Ciliophora;Intramacronucleata;Spirotrichea;Hypotrichia;Birojimia;";"0.0";"0";"1";"1";"0";"1";"0";"457182";"373894"
"V4mis1";"SILVA (only NR);Eukaryota;SAR;Alveolata;Ciliophora;Intramacronucleata;Spirotrichea;Hypotrichia;Cyrtohymena;";"0.0";"0";"1";"1";"0";"1";"0";"457182";"373894"
"V4mis1";"SILVA (only NR);Eukaryota;SAR;Alveolata;Ciliophora;Intramacronucleata;Spirotrichea;Hypotrichia;Deviata;";"0.0";"0";"2";"2";"0";"2";"0";"457181";"373894"
"V4mis1";"SILVA (only NR);Eukaryota;SAR;Alveolata;Ciliophora;Intramacronucleata;Spirotrichea;Hypotrichia;Diaxonella;";"0.0";"0";"1";"1";"0";"1";"0";"457182";"373894"
"V4mis1";"SILVA (only NR);Eukaryota;SAR;Alveolata;Ciliophora;Intramacronucleata;Spirotrichea;Hypotrichia;Engelmanniella;";"0.0";"0";"1";"1";"0";"1";"0";"457182";"373894"
"V4mis1";"SILVA (only NR);Eukaryota;SAR;Alveolata;Ciliophora;Intramacronucleata;Spirotrichea;Hypotrichia;Epiclintes;";"0.0";"0";"3";"3";"0";"3";"0";"457180";"373894"
"V4mis1";"SILVA (only NR);Eukaryota;SAR;Alveolata;Ciliophora;Intramacronucleata;Spirotrichea;Hypotrichia;Gonostomum;";"0.0";"0";"13";"13";"0";"13";"0";"457170";"373894"
"V4mis1";"SILVA (only NR);Eukaryota;SAR;Alveolata;Ciliophora;Intramacronucleata;Spirotrichea;Hypotrichia;Halteria;";"0.0";"0";"14";"14";"0";"14";"0";"457169";"373894"
"V4mis1";"SILVA (only NR);Eukaryota;SAR;Alveolata;Ciliophora;Intramacronucleata;Spirotrichea;Hypotrichia;Hemicycliostyla;";"0.0";"0";"1";"1";"0";"1";"0";"457182";"373894"
"V4mis1";"SILVA (only NR);Eukaryota;SAR;Alveolata;Ciliophora;Intramacronucleata;Spirotrichea;Hypotrichia;Hemigastrostyla;";"0.0";"0";"3";"3";"0";"3";"0";"457180";"373894"
"V4mis1";"SILVA (only NR);Eukaryota;SAR;Alveolata;Ciliophora;Intramacronucleata;Spirotrichea;Hypotrichia;Hemiurosoma;";"0.0";"0";"1";"1";"0";"1";"0";"457182";"373894"
"V4mis1";"SILVA (only NR);Eukaryota;SAR;Alveolata;Ciliophora;Intramacronucleata;Spirotrichea;Hypotrichia;Hemiurosomoida;";"0.0";"0";"4";"4";"0";"4";"0";"457179";"373894"
"V4mis1";"SILVA (only NR);Eukaryota;SAR;Alveolata;Ciliophora;Intramacronucleata;Spirotrichea;Hypotrichia;Heterokeronopsis;";"0.0";"0";"1";"1";"0";"1";"0";"457182";"373894"
"V4mis1";"SILVA (only NR);Eukaryota;SAR;Alveolata;Ciliophora;Intramacronucleata;Spirotrichea;Hypotrichia;Histriculus;";"0.0";"0";"1";"1";"0";"1";"0";"457182";"373894"
"V4mis1";"SILVA (only NR);Eukaryota;SAR;Alveolata;Ciliophora;Intramacronucleata;Spirotrichea;Hypotrichia;Holosticha;";"0.0";"0";"16";"16";"0";"16";"0";"457167";"373894"
"V4mis1";"SILVA (only NR);Eukaryota;SAR;Alveolata;Ciliophora;Intramacronucleata;Spirotrichea;Hypotrichia;Holostichides;";"0.0";"0";"1";"1";"0";"1";"0";"457182";"373894"
"V4mis1";"SILVA (only NR);Eukaryota;SAR;Alveolata;Ciliophora;Intramacronucleata;Spirotrichea;Hypotrichia;Hypotrichidium;";"0.0";"0";"1";"1";"0";"1";"0";"457182";"373894"
"V4mis1";"SILVA (only NR);Eukaryota;SAR;Alveolata;Ciliophora;Intramacronucleata;Spirotrichea;Hypotrichia;Kahliella;";"0.0";"0";"1";"1";"0";"1";"0";"457182";"373894"
"V4mis1";"SILVA (only NR);Eukaryota;SAR;Alveolata;Ciliophora;Intramacronucleata;Spirotrichea;Hypotrichia;Kleinstyla;";"0.0";"0";"1";"1";"0";"1";"0";"457182";"373894"
"V4mis1";"SILVA (only NR);Eukaryota;SAR;Alveolata;Ciliophora;Intramacronucleata;Spirotrichea;Hypotrichia;Laurentiella;";"0.0";"0";"1";"1";"0";"1";"0";"457182";"373894"
"V4mis1";"SILVA (only NR);Eukaryota;SAR;Alveolata;Ciliophora;Intramacronucleata;Spirotrichea;Hypotrichia;Meseres;";"0.0";"0";"1";"1";"0";"1";"0";"457182";"373894"
"V4mis1";"SILVA (only NR);Eukaryota;SAR;Alveolata;Ciliophora;Intramacronucleata;Spirotrichea;Hypotrichia;Metaurostylopsis;";"0.0";"0";"4";"4";"0";"4";"0";"457179";"373894"
"V4mis1";"SILVA (only NR);Eukaryota;SAR;Alveolata;Ciliophora;Intramacronucleata;Spirotrichea;Hypotrichia;Monocoronella;";"0.0";"0";"1";"1";"0";"1";"0";"457182";"373894"
"V4mis1";"SILVA (only NR);Eukaryota;SAR;Alveolata;Ciliophora;Intramacronucleata;Spirotrichea;Hypotrichia;Neobakuella;";"0.0";"0";"1";"1";"0";"1";"0";"457182";"373894"
"V4mis1";"SILVA (only NR);Eukaryota;SAR;Alveolata;Ciliophora;Intramacronucleata;Spirotrichea;Hypotrichia;Neokeronopsis;";"0.0";"0";"1";"1";"0";"1";"0";"457182";"373894"
"V4mis1";"SILVA (only NR);Eukaryota;SAR;Alveolata;Ciliophora;Intramacronucleata;Spirotrichea;Hypotrichia;Neourostylopsis;";"0.0";"0";"1";"1";"0";"1";"0";"457182";"373894"
"V4mis1";"SILVA (only NR);Eukaryota;SAR;Alveolata;Ciliophora;Intramacronucleata;Spirotrichea;Hypotrichia;Nothoholosticha;";"0.0";"0";"1";"1";"0";"1";"0";"457182";"373894"
"V4mis1";"SILVA (only NR);Eukaryota;SAR;Alveolata;Ciliophora;Intramacronucleata;Spirotrichea;Hypotrichia;Notohymena;";"0.0";"0";"3";"3";"0";"3";"0";"457180";"373894"
"V4mis1";"SILVA (only NR);Eukaryota;SAR;Alveolata;Ciliophora;Intramacronucleata;Spirotrichea;Hypotrichia;Onychodromopsis;";"0.0";"0";"1";"1";"0";"1";"0";"457182";"373894"
"V4mis1";"SILVA (only NR);Eukaryota;SAR;Alveolata;Ciliophora;Intramacronucleata;Spirotrichea;Hypotrichia;Onychodromus;";"0.0";"0";"2";"2";"0";"2";"0";"457181";"373894"
"V4mis1";"SILVA (only NR);Eukaryota;SAR;Alveolata;Ciliophora;Intramacronucleata;Spirotrichea;Hypotrichia;Oxytricha;";"0.0";"0";"10";"10";"0";"10";"0";"457173";"373894"
"V4mis1";"SILVA (only NR);Eukaryota;SAR;Alveolata;Ciliophora;Intramacronucleata;Spirotrichea;Hypotrichia;Parabirojimia;";"0.0";"0";"2";"2";"0";"2";"0";"457181";"373894"
"V4mis1";"SILVA (only NR);Eukaryota;SAR;Alveolata;Ciliophora;Intramacronucleata;Spirotrichea;Hypotrichia;Parasterkiella;";"0.0";"0";"3";"3";"0";"3";"0";"457180";"373894"
"V4mis1";"SILVA (only NR);Eukaryota;SAR;Alveolata;Ciliophora;Intramacronucleata;Spirotrichea;Hypotrichia;Paraurosomoida;";"0.0";"0";"1";"1";"0";"1";"0";"457182";"373894"
"V4mis1";"SILVA (only NR);Eukaryota;SAR;Alveolata;Ciliophora;Intramacronucleata;Spirotrichea;Hypotrichia;Paraurostyla;";"0.0";"0";"3";"3";"0";"3";"0";"457180";"373894"
"V4mis1";"SILVA (only NR);Eukaryota;SAR;Alveolata;Ciliophora;Intramacronucleata;Spirotrichea;Hypotrichia;Paruroleptus;";"0.0";"0";"3";"3";"0";"3";"0";"457180";"373894"
"V4mis1";"SILVA (only NR);Eukaryota;SAR;Alveolata;Ciliophora;Intramacronucleata;Spirotrichea;Hypotrichia;Perisincirra;";"0.0";"0";"1";"1";"0";"1";"0";"457182";"373894"
"V4mis1";"SILVA (only NR);Eukaryota;SAR;Alveolata;Ciliophora;Intramacronucleata;Spirotrichea;Hypotrichia;Plagiotoma;";"0.0";"0";"1";"1";"0";"1";"0";"457182";"373894"
"V4mis1";"SILVA (only NR);Eukaryota;SAR;Alveolata;Ciliophora;Intramacronucleata;Spirotrichea;Hypotrichia;Ponturostyla;";"0.0";"0";"1";"1";"0";"1";"0";"457182";"373894"
"V4mis1";"SILVA (only NR);Eukaryota;SAR;Alveolata;Ciliophora;Intramacronucleata;Spirotrichea;Hypotrichia;Protogastrostyla;";"0.0";"0";"2";"2";"0";"2";"0";"457181";"373894"
"V4mis1";"SILVA (only NR);Eukaryota;SAR;Alveolata;Ciliophora;Intramacronucleata;Spirotrichea;Hypotrichia;Psammomitra;";"0.0";"0";"1";"1";"0";"1";"0";"457182";"373894"
"V4mis1";"SILVA (only NR);Eukaryota;SAR;Alveolata;Ciliophora;Intramacronucleata;Spirotrichea;Hypotrichia;Pseudoamphisiella;";"0.0";"0";"4";"4";"0";"4";"0";"457179";"373894"
"V4mis1";"SILVA (only NR);Eukaryota;SAR;Alveolata;Ciliophora;Intramacronucleata;Spirotrichea;Hypotrichia;Pseudogastrostyla;";"0.0";"0";"1";"1";"0";"1";"0";"457182";"373894"
"V4mis1";"SILVA (only NR);Eukaryota;SAR;Alveolata;Ciliophora;Intramacronucleata;Spirotrichea;Hypotrichia;Pseudokahliella;";"0.0";"0";"1";"1";"0";"1";"0";"457182";"373894"
"V4mis1";"SILVA (only NR);Eukaryota;SAR;Alveolata;Ciliophora;Intramacronucleata;Spirotrichea;Hypotrichia;Pseudokeronopsis;";"0.0";"0";"4";"4";"0";"4";"0";"457179";"373894"
"V4mis1";"SILVA (only NR);Eukaryota;SAR;Alveolata;Ciliophora;Intramacronucleata;Spirotrichea;Hypotrichia;Pseudouroleptus;";"0.0";"0";"6";"6";"0";"6";"0";"457177";"373894"
"V4mis1";"SILVA (only NR);Eukaryota;SAR;Alveolata;Ciliophora;Intramacronucleata;Spirotrichea;Hypotrichia;Pseudourostyla;";"0.0";"0";"8";"8";"0";"8";"0";"457175";"373894"
"V4mis1";"SILVA (only NR);Eukaryota;SAR;Alveolata;Ciliophora;Intramacronucleata;Spirotrichea;Hypotrichia;Rigidothrix;";"0.0";"0";"1";"1";"0";"1";"0";"457182";"373894"
"V4mis1";"SILVA (only NR);Eukaryota;SAR;Alveolata;Ciliophora;Intramacronucleata;Spirotrichea;Hypotrichia;Rubrioxytricha;";"0.0";"0";"1";"1";"0";"1";"0";"457182";"373894"
"V4mis1";"SILVA (only NR);Eukaryota;SAR;Alveolata;Ciliophora;Intramacronucleata;Spirotrichea;Hypotrichia;Spirotrachelostyla;";"0.0";"0";"3";"3";"0";"3";"0";"457180";"373894"
"V4mis1";"SILVA (only NR);Eukaryota;SAR;Alveolata;Ciliophora;Intramacronucleata;Spirotrichea;Hypotrichia;Steinia;";"0.0";"0";"1";"1";"0";"1";"0";"457182";"373894"
"V4mis1";"SILVA (only NR);Eukaryota;SAR;Alveolata;Ciliophora;Intramacronucleata;Spirotrichea;Hypotrichia;Sterkiella;";"0.0";"0";"6";"6";"0";"6";"0";"457177";"373894"
"V4mis1";"SILVA (only NR);Eukaryota;SAR;Alveolata;Ciliophora;Intramacronucleata;Spirotrichea;Hypotrichia;Stichotricha;";"0.0";"0";"2";"2";"0";"2";"0";"457181";"373894"
"V4mis1";"SILVA (only NR);Eukaryota;SAR;Alveolata;Ciliophora;Intramacronucleata;Spirotrichea;Hypotrichia;Strongylidium;";"0.0";"0";"2";"2";"0";"2";"0";"457181";"373894"
"V4mis1";"SILVA (only NR);Eukaryota;SAR;Alveolata;Ciliophora;Intramacronucleata;Spirotrichea;Hypotrichia;Stylonychia;";"0.0";"0";"14";"14";"0";"14";"0";"457169";"373894"
"V4mis1";"SILVA (only NR);Eukaryota;SAR;Alveolata;Ciliophora;Intramacronucleata;Spirotrichea;Hypotrichia;Tachysoma;";"0.0";"0";"1";"1";"0";"1";"0";"457182";"373894"
"V4mis1";"SILVA (only NR);Eukaryota;SAR;Alveolata;Ciliophora;Intramacronucleata;Spirotrichea;Hypotrichia;Tetmemena;";"0.0";"0";"1";"1";"0";"1";"0";"457182";"373894"
"V4mis1";"SILVA (only NR);Eukaryota;SAR;Alveolata;Ciliophora;Intramacronucleata;Spirotrichea;Hypotrichia;Thigmokeronopsis;";"0.0";"0";"2";"2";"0";"2";"0";"457181";"373894"
"V4mis1";"SILVA (only NR);Eukaryota;SAR;Alveolata;Ciliophora;Intramacronucleata;Spirotrichea;Hypotrichia;Trachelostyla;";"0.0";"0";"2";"2";"0";"2";"0";"457181";"373894"
"V4mis1";"SILVA (only NR);Eukaryota;SAR;Alveolata;Ciliophora;Intramacronucleata;Spirotrichea;Hypotrichia;Trichototaxis;";"0.0";"0";"1";"1";"0";"1";"0";"457182";"373894"
"V4mis1";"SILVA (only NR);Eukaryota;SAR;Alveolata;Ciliophora;Intramacronucleata;Spirotrichea;Hypotrichia;Tunicothrix;";"0.0";"0";"2";"2";"0";"2";"0";"457181";"373894"
"V4mis1";"SILVA (only NR);Eukaryota;SAR;Alveolata;Ciliophora;Intramacronucleata;Spirotrichea;Hypotrichia;Uroleptopsis;";"0.0";"0";"1";"1";"0";"1";"0";"457182";"373894"
"V4mis1";"SILVA (only NR);Eukaryota;SAR;Alveolata;Ciliophora;Intramacronucleata;Spirotrichea;Hypotrichia;Uroleptus;";"0.0";"0";"4";"4";"0";"4";"0";"457179";"373894"
"V4mis1";"SILVA (only NR);Eukaryota;SAR;Alveolata;Ciliophora;Intramacronucleata;Spirotrichea;Hypotrichia;Uronychia;";"0.0";"0";"6";"6";"0";"6";"0";"457177";"373894"
"V4mis1";"SILVA (only NR);Eukaryota;SAR;Alveolata;Ciliophora;Intramacronucleata;Spirotrichea;Hypotrichia;Urosoma;";"0.0";"0";"4";"4";"0";"4";"0";"457179";"373894"
"V4mis1";"SILVA (only NR);Eukaryota;SAR;Alveolata;Ciliophora;Intramacronucleata;Spirotrichea;Hypotrichia;Urosomoida;";"0.0";"0";"1";"1";"0";"1";"0";"457182";"373894"
"V4mis1";"SILVA (only NR);Eukaryota;SAR;Alveolata;Ciliophora;Intramacronucleata;Spirotrichea;Hypotrichia;Urospinula;";"0.0";"0";"1";"1";"0";"1";"0";"457182";"373894"
"V4mis1";"SILVA (only NR);Eukaryota;SAR;Alveolata;Ciliophora;Intramacronucleata;Spirotrichea;Hypotrichia;Urostyla;";"0.0";"0";"2";"2";"0";"2";"0";"457181";"373894"
"V4mis1";"SILVA (only NR);Eukaryota;SAR;Alveolata;Ciliophora;Intramacronucleata;Spirotrichea;Hypotrichia;uncultured;";"0.0";"0";"15";"14";"0";"14";"1";"457169";"373894"
"V4mis1";"SILVA (only NR);Eukaryota;SAR;Alveolata;Ciliophora;Intramacronucleata;Spirotrichea;Licnophoria;";"0.0";"0";"3";"3";"0";"3";"0";"457180";"373894"
"V4mis1";"SILVA (only NR);Eukaryota;SAR;Alveolata;Ciliophora;Intramacronucleata;Spirotrichea;Licnophoria;Licnophora;";"0.0";"0";"3";"3";"0";"3";"0";"457180";"373894"
"V4mis1";"SILVA (only NR);Eukaryota;SAR;Alveolata;Ciliophora;Intramacronucleata;Spirotrichea;Oligotrichia;";"0.0";"0";"432";"432";"0";"432";"0";"456751";"373894"
"V4mis1";"SILVA (only NR);Eukaryota;SAR;Alveolata;Ciliophora;Intramacronucleata;Spirotrichea;Oligotrichia;Antestrombidium;";"0.0";"0";"1";"1";"0";"1";"0";"457182";"373894"
"V4mis1";"SILVA (only NR);Eukaryota;SAR;Alveolata;Ciliophora;Intramacronucleata;Spirotrichea;Oligotrichia;Apostrombidium;";"0.0";"0";"1";"1";"0";"1";"0";"457182";"373894"
"V4mis1";"SILVA (only NR);Eukaryota;SAR;Alveolata;Ciliophora;Intramacronucleata;Spirotrichea;Oligotrichia;Novistrombidium;";"0.0";"0";"2";"2";"0";"2";"0";"457181";"373894"
"V4mis1";"SILVA (only NR);Eukaryota;SAR;Alveolata;Ciliophora;Intramacronucleata;Spirotrichea;Oligotrichia;Omegastrombidium;";"0.0";"0";"1";"1";"0";"1";"0";"457182";"373894"
"V4mis1";"SILVA (only NR);Eukaryota;SAR;Alveolata;Ciliophora;Intramacronucleata;Spirotrichea;Oligotrichia;Parallelostrombidium;";"0.0";"0";"6";"6";"0";"6";"0";"457177";"373894"
"V4mis1";"SILVA (only NR);Eukaryota;SAR;Alveolata;Ciliophora;Intramacronucleata;Spirotrichea;Oligotrichia;Pseudotontonia;";"0.0";"0";"38";"38";"0";"38";"0";"457145";"373894"
"V4mis1";"SILVA (only NR);Eukaryota;SAR;Alveolata;Ciliophora;Intramacronucleata;Spirotrichea;Oligotrichia;Sinistrostrombidium;";"0.0";"0";"5";"5";"0";"5";"0";"457178";"373894"
"V4mis1";"SILVA (only NR);Eukaryota;SAR;Alveolata;Ciliophora;Intramacronucleata;Spirotrichea;Oligotrichia;Spirostrombidium;";"0.0";"0";"22";"22";"0";"22";"0";"457161";"373894"
"V4mis1";"SILVA (only NR);Eukaryota;SAR;Alveolata;Ciliophora;Intramacronucleata;Spirotrichea;Oligotrichia;Spirotontonia;";"0.0";"0";"68";"68";"0";"68";"0";"457115";"373894"
"V4mis1";"SILVA (only NR);Eukaryota;SAR;Alveolata;Ciliophora;Intramacronucleata;Spirotrichea;Oligotrichia;Strombidium;";"0.0";"0";"210";"210";"0";"210";"0";"456973";"373894"
"V4mis1";"SILVA (only NR);Eukaryota;SAR;Alveolata;Ciliophora;Intramacronucleata;Spirotrichea;Oligotrichia;Varistrombidium;";"0.0";"0";"3";"3";"0";"3";"0";"457180";"373894"
"V4mis1";"SILVA (only NR);Eukaryota;SAR;Alveolata;Ciliophora;Intramacronucleata;Spirotrichea;Oligotrichia;uncultured;";"0.0";"0";"51";"51";"0";"51";"0";"457132";"373894"
"V4mis1";"SILVA (only NR);Eukaryota;SAR;Alveolata;Ciliophora;Intramacronucleata;Spirotrichea;Oxytrichidae;";"2.6";"18.2";"38";"38";"1";"37";"0";"457145";"373893"
"V4mis1";"SILVA (only NR);Eukaryota;SAR;Alveolata;Ciliophora;Intramacronucleata;Spirotrichea;Phacodinium;";"0.0";"0";"1";"1";"0";"1";"0";"457182";"373894"
"V4mis1";"SILVA (only NR);Eukaryota;SAR;Alveolata;Ciliophora;Intramacronucleata;Spirotrichea;Protocruzia;";"0.0";"0";"7";"7";"0";"7";"0";"457176";"373894"
"V4mis1";"SILVA (only NR);Eukaryota;SAR;Alveolata;Ciliophora;Intramacronucleata;Spirotrichea;Protohypotrichia;";"0.0";"0";"3";"3";"0";"3";"0";"457180";"373894"
"V4mis1";"SILVA (only NR);Eukaryota;SAR;Alveolata;Ciliophora;Intramacronucleata;Spirotrichea;Protohypotrichia;Caryotricha;";"0.0";"0";"2";"2";"0";"2";"0";"457181";"373894"
"V4mis1";"SILVA (only NR);Eukaryota;SAR;Alveolata;Ciliophora;Intramacronucleata;Spirotrichea;Protohypotrichia;Kiitricha;";"0.0";"0";"1";"1";"0";"1";"0";"457182";"373894"
"V4mis1";"SILVA (only NR);Eukaryota;SAR;Alveolata;Ciliophora;Postciliodesmatophora;";"0.0";"0";"149";"149";"0";"149";"0";"457034";"373894"
"V4mis1";"SILVA (only NR);Eukaryota;SAR;Alveolata;Ciliophora;Postciliodesmatophora;Heterotrichea;";"0.0";"0";"90";"90";"0";"90";"0";"457093";"373894"
"V4mis1";"SILVA (only NR);Eukaryota;SAR;Alveolata;Ciliophora;Postciliodesmatophora;Heterotrichea;Anigsteinia;";"0.0";"0";"3";"3";"0";"3";"0";"457180";"373894"
"V4mis1";"SILVA (only NR);Eukaryota;SAR;Alveolata;Ciliophora;Postciliodesmatophora;Heterotrichea;Blepharisma;";"0.0";"0";"15";"15";"0";"15";"0";"457168";"373894"
"V4mis1";"SILVA (only NR);Eukaryota;SAR;Alveolata;Ciliophora;Postciliodesmatophora;Heterotrichea;Chattonidium;";"0.0";"0";"1";"1";"0";"1";"0";"457182";"373894"
"V4mis1";"SILVA (only NR);Eukaryota;SAR;Alveolata;Ciliophora;Postciliodesmatophora;Heterotrichea;Climacostomum;";"0.0";"0";"3";"3";"0";"3";"0";"457180";"373894"
"V4mis1";"SILVA (only NR);Eukaryota;SAR;Alveolata;Ciliophora;Postciliodesmatophora;Heterotrichea;Condylostentor;";"0.0";"0";"2";"2";"0";"2";"0";"457181";"373894"
"V4mis1";"SILVA (only NR);Eukaryota;SAR;Alveolata;Ciliophora;Postciliodesmatophora;Heterotrichea;Condylostoma;";"0.0";"0";"9";"9";"0";"9";"0";"457174";"373894"
"V4mis1";"SILVA (only NR);Eukaryota;SAR;Alveolata;Ciliophora;Postciliodesmatophora;Heterotrichea;Eufolliculina;";"0.0";"0";"6";"6";"0";"6";"0";"457177";"373894"
"V4mis1";"SILVA (only NR);Eukaryota;SAR;Alveolata;Ciliophora;Postciliodesmatophora;Heterotrichea;Fabrea;";"0.0";"0";"2";"2";"0";"2";"0";"457181";"373894"
"V4mis1";"SILVA (only NR);Eukaryota;SAR;Alveolata;Ciliophora;Postciliodesmatophora;Heterotrichea;Maristentor;";"0.0";"0";"1";"1";"0";"1";"0";"457182";"373894"
"V4mis1";"SILVA (only NR);Eukaryota;SAR;Alveolata;Ciliophora;Postciliodesmatophora;Heterotrichea;Peritromus;";"0.0";"0";"7";"7";"0";"7";"0";"457176";"373894"
"V4mis1";"SILVA (only NR);Eukaryota;SAR;Alveolata;Ciliophora;Postciliodesmatophora;Heterotrichea;Spirostomum;";"0.0";"0";"13";"13";"0";"13";"0";"457170";"373894"
"V4mis1";"SILVA (only NR);Eukaryota;SAR;Alveolata;Ciliophora;Postciliodesmatophora;Heterotrichea;Stentor;";"0.0";"0";"18";"18";"0";"18";"0";"457165";"373894"
"V4mis1";"SILVA (only NR);Eukaryota;SAR;Alveolata;Ciliophora;Postciliodesmatophora;Heterotrichea;uncultured;";"0.0";"0";"4";"4";"0";"4";"0";"457179";"373894"
"V4mis1";"SILVA (only NR);Eukaryota;SAR;Alveolata;Ciliophora;Postciliodesmatophora;Karyorelictea;";"0.0";"0";"58";"58";"0";"58";"0";"457125";"373894"
"V4mis1";"SILVA (only NR);Eukaryota;SAR;Alveolata;Ciliophora;Postciliodesmatophora;Karyorelictea;Apotrachelocerca;";"0.0";"0";"1";"1";"0";"1";"0";"457182";"373894"
"V4mis1";"SILVA (only NR);Eukaryota;SAR;Alveolata;Ciliophora;Postciliodesmatophora;Karyorelictea;Corlissina;";"0.0";"0";"1";"1";"0";"1";"0";"457182";"373894"
"V4mis1";"SILVA (only NR);Eukaryota;SAR;Alveolata;Ciliophora;Postciliodesmatophora;Karyorelictea;Geleia;";"0.0";"0";"3";"3";"0";"3";"0";"457180";"373894"
"V4mis1";"SILVA (only NR);Eukaryota;SAR;Alveolata;Ciliophora;Postciliodesmatophora;Karyorelictea;Kentrophoros;";"0.0";"0";"22";"22";"0";"22";"0";"457161";"373894"
"V4mis1";"SILVA (only NR);Eukaryota;SAR;Alveolata;Ciliophora;Postciliodesmatophora;Karyorelictea;Kovalevaia;";"0.0";"0";"2";"2";"0";"2";"0";"457181";"373894"
"V4mis1";"SILVA (only NR);Eukaryota;SAR;Alveolata;Ciliophora;Postciliodesmatophora;Karyorelictea;Loxodes;";"0.0";"0";"2";"2";"0";"2";"0";"457181";"373894"
"V4mis1";"SILVA (only NR);Eukaryota;SAR;Alveolata;Ciliophora;Postciliodesmatophora;Karyorelictea;Parduczia;";"0.0";"0";"2";"2";"0";"2";"0";"457181";"373894"
"V4mis1";"SILVA (only NR);Eukaryota;SAR;Alveolata;Ciliophora;Postciliodesmatophora;Karyorelictea;Remanella;";"0.0";"0";"8";"8";"0";"8";"0";"457175";"373894"
"V4mis1";"SILVA (only NR);Eukaryota;SAR;Alveolata;Ciliophora;Postciliodesmatophora;Karyorelictea;Trachelocerca;";"0.0";"0";"1";"1";"0";"1";"0";"457182";"373894"
"V4mis1";"SILVA (only NR);Eukaryota;SAR;Alveolata;Ciliophora;Postciliodesmatophora;Karyorelictea;Tracheloraphis;";"0.0";"0";"10";"10";"0";"10";"0";"457173";"373894"
"V4mis1";"SILVA (only NR);Eukaryota;SAR;Alveolata;Ciliophora;Postciliodesmatophora;Karyorelictea;Wilbertomorpha;";"0.0";"0";"1";"1";"0";"1";"0";"457182";"373894"
"V4mis1";"SILVA (only NR);Eukaryota;SAR;Alveolata;Dinoflagellata;";"0.1";"17.9";"1815";"1764";"1";"1763";"51";"455419";"373893"
"V4mis1";"SILVA (only NR);Eukaryota;SAR;Alveolata;Dinoflagellata;Dinophyceae;";"0.1";"17.9";"1747";"1699";"1";"1698";"48";"455484";"373893"
"V4mis1";"SILVA (only NR);Eukaryota;SAR;Alveolata;Dinoflagellata;Dinophyceae;Dinophysiales;";"0.0";"0";"40";"37";"0";"37";"3";"457146";"373894"
"V4mis1";"SILVA (only NR);Eukaryota;SAR;Alveolata;Dinoflagellata;Dinophyceae;Dinophysiales;Amphisolenia;";"0.0";"0";"2";"2";"0";"2";"0";"457181";"373894"
"V4mis1";"SILVA (only NR);Eukaryota;SAR;Alveolata;Dinoflagellata;Dinophyceae;Dinophysiales;Dinophysis;";"0.0";"0";"7";"7";"0";"7";"0";"457176";"373894"
"V4mis1";"SILVA (only NR);Eukaryota;SAR;Alveolata;Dinoflagellata;Dinophyceae;Dinophysiales;Ornithocercus;";"0.0";"0";"2";"2";"0";"2";"0";"457181";"373894"
"V4mis1";"SILVA (only NR);Eukaryota;SAR;Alveolata;Dinoflagellata;Dinophyceae;Dinophysiales;Phalacroma;";"0.0";"0";"6";"6";"0";"6";"0";"457177";"373894"
"V4mis1";"SILVA (only NR);Eukaryota;SAR;Alveolata;Dinoflagellata;Dinophyceae;Dinophysiales;Pseudophalacroma;";"0.0";"0";"1";"1";"0";"1";"0";"457182";"373894"
"V4mis1";"SILVA (only NR);Eukaryota;SAR;Alveolata;Dinoflagellata;Dinophyceae;Dinophysiales;Sinophysis;";"0.0";"0";"19";"16";"0";"16";"3";"457167";"373894"
"V4mis1";"SILVA (only NR);Eukaryota;SAR;Alveolata;Dinoflagellata;Dinophyceae;Dinophysiales;Triposolenia;";"0.0";"0";"1";"1";"0";"1";"0";"457182";"373894"
"V4mis1";"SILVA (only NR);Eukaryota;SAR;Alveolata;Dinoflagellata;Dinophyceae;Gymnodiniphycidae;";"0.1";"18.1";"844";"813";"1";"812";"31";"456370";"373893"
"V4mis1";"SILVA (only NR);Eukaryota;SAR;Alveolata;Dinoflagellata;Dinophyceae;Gymnodiniphycidae;Amphidinium;";"0.0";"0";"51";"51";"0";"51";"0";"457132";"373894"
"V4mis1";"SILVA (only NR);Eukaryota;SAR;Alveolata;Dinoflagellata;Dinophyceae;Gymnodiniphycidae;Ankistrodinium;";"0.0";"0";"1";"1";"0";"1";"0";"457182";"373894"
"V4mis1";"SILVA (only NR);Eukaryota;SAR;Alveolata;Dinoflagellata;Dinophyceae;Gymnodiniphycidae;Gymnodinium clade;";"0.0";"0";"212";"201";"0";"201";"11";"456982";"373894"
"V4mis1";"SILVA (only NR);Eukaryota;SAR;Alveolata;Dinoflagellata;Dinophyceae;Gymnodiniphycidae;Gymnodinium clade;Chytriodinium;";"0.0";"0";"7";"7";"0";"7";"0";"457176";"373894"
"V4mis1";"SILVA (only NR);Eukaryota;SAR;Alveolata;Dinoflagellata;Dinophyceae;Gymnodiniphycidae;Gymnodinium clade;Erythropsidinium;";"0.0";"0";"37";"37";"0";"37";"0";"457146";"373894"
"V4mis1";"SILVA (only NR);Eukaryota;SAR;Alveolata;Dinoflagellata;Dinophyceae;Gymnodiniphycidae;Gymnodinium clade;Gymnodinium;";"0.0";"0";"59";"58";"0";"58";"1";"457125";"373894"
"V4mis1";"SILVA (only NR);Eukaryota;SAR;Alveolata;Dinoflagellata;Dinophyceae;Gymnodiniphycidae;Gymnodinium clade;Gymnoxanthella;";"0.0";"0";"3";"3";"0";"3";"0";"457180";"373894"
"V4mis1";"SILVA (only NR);Eukaryota;SAR;Alveolata;Dinoflagellata;Dinophyceae;Gymnodiniphycidae;Gymnodinium clade;Gyrodiniellum;";"0.0";"0";"18";"8";"0";"8";"10";"457175";"373894"
"V4mis1";"SILVA (only NR);Eukaryota;SAR;Alveolata;Dinoflagellata;Dinophyceae;Gymnodiniphycidae;Gymnodinium clade;Lepidodinium;";"0.0";"0";"8";"8";"0";"8";"0";"457175";"373894"
"V4mis1";"SILVA (only NR);Eukaryota;SAR;Alveolata;Dinoflagellata;Dinophyceae;Gymnodiniphycidae;Gymnodinium clade;Nematodinium;";"0.0";"0";"2";"2";"0";"2";"0";"457181";"373894"
"V4mis1";"SILVA (only NR);Eukaryota;SAR;Alveolata;Dinoflagellata;Dinophyceae;Gymnodiniphycidae;Gymnodinium clade;Nusuttodinium;";"0.0";"0";"8";"8";"0";"8";"0";"457175";"373894"
"V4mis1";"SILVA (only NR);Eukaryota;SAR;Alveolata;Dinoflagellata;Dinophyceae;Gymnodiniphycidae;Gymnodinium clade;Paragymnodinium;";"0.0";"0";"7";"7";"0";"7";"0";"457176";"373894"
"V4mis1";"SILVA (only NR);Eukaryota;SAR;Alveolata;Dinoflagellata;Dinophyceae;Gymnodiniphycidae;Gymnodinium clade;Pellucidodinium;";"0.0";"0";"2";"2";"0";"2";"0";"457181";"373894"
"V4mis1";"SILVA (only NR);Eukaryota;SAR;Alveolata;Dinoflagellata;Dinophyceae;Gymnodiniphycidae;Gymnodinium clade;Pheopolykrikos;";"0.0";"0";"2";"2";"0";"2";"0";"457181";"373894"
"V4mis1";"SILVA (only NR);Eukaryota;SAR;Alveolata;Dinoflagellata;Dinophyceae;Gymnodiniphycidae;Gymnodinium clade;Polykrikos;";"0.0";"0";"7";"7";"0";"7";"0";"457176";"373894"
"V4mis1";"SILVA (only NR);Eukaryota;SAR;Alveolata;Dinoflagellata;Dinophyceae;Gymnodiniphycidae;Gymnodinium clade;Proterythropsis;";"0.0";"0";"1";"1";"0";"1";"0";"457182";"373894"
"V4mis1";"SILVA (only NR);Eukaryota;SAR;Alveolata;Dinoflagellata;Dinophyceae;Gymnodiniphycidae;Gymnodinium clade;Spiniferodinium;";"0.0";"0";"2";"2";"0";"2";"0";"457181";"373894"
"V4mis1";"SILVA (only NR);Eukaryota;SAR;Alveolata;Dinoflagellata;Dinophyceae;Gymnodiniphycidae;Gymnodinium clade;Warnowia;";"0.0";"0";"3";"3";"0";"3";"0";"457180";"373894"
"V4mis1";"SILVA (only NR);Eukaryota;SAR;Alveolata;Dinoflagellata;Dinophyceae;Gymnodiniphycidae;Gymnodinium clade;Woloszynskia;";"0.0";"0";"11";"11";"0";"11";"0";"457172";"373894"
"V4mis1";"SILVA (only NR);Eukaryota;SAR;Alveolata;Dinoflagellata;Dinophyceae;Gymnodiniphycidae;Gymnodinium clade;uncultured;";"0.0";"0";"22";"22";"0";"22";"0";"457161";"373894"
"V4mis1";"SILVA (only NR);Eukaryota;SAR;Alveolata;Dinoflagellata;Dinophyceae;Gymnodiniphycidae;Gyrodinium;";"0.0";"0";"217";"206";"0";"206";"11";"456977";"373894"
"V4mis1";"SILVA (only NR);Eukaryota;SAR;Alveolata;Dinoflagellata;Dinophyceae;Gymnodiniphycidae;Incertae Sedis;";"2.4";"18.2";"42";"41";"1";"40";"1";"457142";"373893"
"V4mis1";"SILVA (only NR);Eukaryota;SAR;Alveolata;Dinoflagellata;Dinophyceae;Gymnodiniphycidae;Incertae Sedis;Akashiwo;";"0.0";"0";"19";"19";"0";"19";"0";"457164";"373894"
"V4mis1";"SILVA (only NR);Eukaryota;SAR;Alveolata;Dinoflagellata;Dinophyceae;Gymnodiniphycidae;Incertae Sedis;Apicoporus;";"0.0";"0";"5";"4";"0";"4";"1";"457179";"373894"
"V4mis1";"SILVA (only NR);Eukaryota;SAR;Alveolata;Dinoflagellata;Dinophyceae;Gymnodiniphycidae;Incertae Sedis;Cochlodinium;";"5.6";"18.2";"18";"18";"1";"17";"0";"457165";"373893"
"V4mis1";"SILVA (only NR);Eukaryota;SAR;Alveolata;Dinoflagellata;Dinophyceae;Gymnodiniphycidae;Kareniaceae;";"0.0";"0";"122";"116";"0";"116";"6";"457067";"373894"
"V4mis1";"SILVA (only NR);Eukaryota;SAR;Alveolata;Dinoflagellata;Dinophyceae;Gymnodiniphycidae;Kareniaceae;Karenia;";"0.0";"0";"4";"4";"0";"4";"0";"457179";"373894"
"V4mis1";"SILVA (only NR);Eukaryota;SAR;Alveolata;Dinoflagellata;Dinophyceae;Gymnodiniphycidae;Kareniaceae;Karlodinium;";"0.0";"0";"112";"106";"0";"106";"6";"457077";"373894"
"V4mis1";"SILVA (only NR);Eukaryota;SAR;Alveolata;Dinoflagellata;Dinophyceae;Gymnodiniphycidae;Kareniaceae;Takayama;";"0.0";"0";"4";"4";"0";"4";"0";"457179";"373894"
"V4mis1";"SILVA (only NR);Eukaryota;SAR;Alveolata;Dinoflagellata;Dinophyceae;Gymnodiniphycidae;Katodinium;";"0.0";"0";"9";"9";"0";"9";"0";"457174";"373894"
"V4mis1";"SILVA (only NR);Eukaryota;SAR;Alveolata;Dinoflagellata;Dinophyceae;Gymnodiniphycidae;Moestrupia;";"0.0";"0";"3";"3";"0";"3";"0";"457180";"373894"
"V4mis1";"SILVA (only NR);Eukaryota;SAR;Alveolata;Dinoflagellata;Dinophyceae;Gymnodiniphycidae;Ptychodiscus;";"0.0";"0";"9";"9";"0";"9";"0";"457174";"373894"
"V4mis1";"SILVA (only NR);Eukaryota;SAR;Alveolata;Dinoflagellata;Dinophyceae;Gymnodiniphycidae;Suessiaceae;";"0.0";"0";"146";"146";"0";"146";"0";"457037";"373894"
"V4mis1";"SILVA (only NR);Eukaryota;SAR;Alveolata;Dinoflagellata;Dinophyceae;Gymnodiniphycidae;Suessiaceae;Ansanella;";"0.0";"0";"1";"1";"0";"1";"0";"457182";"373894"
"V4mis1";"SILVA (only NR);Eukaryota;SAR;Alveolata;Dinoflagellata;Dinophyceae;Gymnodiniphycidae;Suessiaceae;Biecheleria;";"0.0";"0";"16";"16";"0";"16";"0";"457167";"373894"
"V4mis1";"SILVA (only NR);Eukaryota;SAR;Alveolata;Dinoflagellata;Dinophyceae;Gymnodiniphycidae;Suessiaceae;Pelagodinium;";"0.0";"0";"13";"13";"0";"13";"0";"457170";"373894"
"V4mis1";"SILVA (only NR);Eukaryota;SAR;Alveolata;Dinoflagellata;Dinophyceae;Gymnodiniphycidae;Suessiaceae;Polarella;";"0.0";"0";"4";"4";"0";"4";"0";"457179";"373894"
"V4mis1";"SILVA (only NR);Eukaryota;SAR;Alveolata;Dinoflagellata;Dinophyceae;Gymnodiniphycidae;Suessiaceae;Protodinium;";"0.0";"0";"2";"2";"0";"2";"0";"457181";"373894"
"V4mis1";"SILVA (only NR);Eukaryota;SAR;Alveolata;Dinoflagellata;Dinophyceae;Gymnodiniphycidae;Suessiaceae;Symbiodinium;";"0.0";"0";"103";"103";"0";"103";"0";"457080";"373894"
"V4mis1";"SILVA (only NR);Eukaryota;SAR;Alveolata;Dinoflagellata;Dinophyceae;Gymnodiniphycidae;Suessiaceae;uncultured;";"0.0";"0";"5";"5";"0";"5";"0";"457178";"373894"
"V4mis1";"SILVA (only NR);Eukaryota;SAR;Alveolata;Dinoflagellata;Dinophyceae;Gymnodiniphycidae;Tovelliaceae;";"0.0";"0";"5";"5";"0";"5";"0";"457178";"373894"
"V4mis1";"SILVA (only NR);Eukaryota;SAR;Alveolata;Dinoflagellata;Dinophyceae;Gymnodiniphycidae;Tovelliaceae;Esoptrodinium;";"0.0";"0";"2";"2";"0";"2";"0";"457181";"373894"
"V4mis1";"SILVA (only NR);Eukaryota;SAR;Alveolata;Dinoflagellata;Dinophyceae;Gymnodiniphycidae;Tovelliaceae;Jadwigia;";"0.0";"0";"3";"3";"0";"3";"0";"457180";"373894"
"V4mis1";"SILVA (only NR);Eukaryota;SAR;Alveolata;Dinoflagellata;Dinophyceae;Gymnodiniphycidae;uncultured;";"0.0";"0";"17";"16";"0";"16";"1";"457167";"373894"
"V4mis1";"SILVA (only NR);Eukaryota;SAR;Alveolata;Dinoflagellata;Dinophyceae;Incertae Sedis;";"0.0";"0";"8";"8";"0";"8";"0";"457175";"373894"
"V4mis1";"SILVA (only NR);Eukaryota;SAR;Alveolata;Dinoflagellata;Dinophyceae;Incertae Sedis;Ailadinium;";"0.0";"0";"1";"1";"0";"1";"0";"457182";"373894"
"V4mis1";"SILVA (only NR);Eukaryota;SAR;Alveolata;Dinoflagellata;Dinophyceae;Incertae Sedis;Halostylodinium;";"0.0";"0";"2";"2";"0";"2";"0";"457181";"373894"
"V4mis1";"SILVA (only NR);Eukaryota;SAR;Alveolata;Dinoflagellata;Dinophyceae;Incertae Sedis;Madanidinium;";"0.0";"0";"2";"2";"0";"2";"0";"457181";"373894"
"V4mis1";"SILVA (only NR);Eukaryota;SAR;Alveolata;Dinoflagellata;Dinophyceae;Incertae Sedis;Pileidinium;";"0.0";"0";"1";"1";"0";"1";"0";"457182";"373894"
"V4mis1";"SILVA (only NR);Eukaryota;SAR;Alveolata;Dinoflagellata;Dinophyceae;Incertae Sedis;Sabulodinium;";"0.0";"0";"2";"2";"0";"2";"0";"457181";"373894"
"V4mis1";"SILVA (only NR);Eukaryota;SAR;Alveolata;Dinoflagellata;Dinophyceae;Peridiniphycidae;";"0.0";"0";"584";"573";"0";"573";"11";"456610";"373894"
"V4mis1";"SILVA (only NR);Eukaryota;SAR;Alveolata;Dinoflagellata;Dinophyceae;Peridiniphycidae;Gonyaulacales;";"0.0";"0";"312";"305";"0";"305";"7";"456878";"373894"
"V4mis1";"SILVA (only NR);Eukaryota;SAR;Alveolata;Dinoflagellata;Dinophyceae;Peridiniphycidae;Gonyaulacales;Adenoides;";"0.0";"0";"2";"2";"0";"2";"0";"457181";"373894"
"V4mis1";"SILVA (only NR);Eukaryota;SAR;Alveolata;Dinoflagellata;Dinophyceae;Peridiniphycidae;Gonyaulacales;Alexandrium;";"0.0";"0";"42";"42";"0";"42";"0";"457141";"373894"
"V4mis1";"SILVA (only NR);Eukaryota;SAR;Alveolata;Dinoflagellata;Dinophyceae;Peridiniphycidae;Gonyaulacales;Amphidoma;";"0.0";"0";"1";"1";"0";"1";"0";"457182";"373894"
"V4mis1";"SILVA (only NR);Eukaryota;SAR;Alveolata;Dinoflagellata;Dinophyceae;Peridiniphycidae;Gonyaulacales;Amylax;";"0.0";"0";"1";"1";"0";"1";"0";"457182";"373894"
"V4mis1";"SILVA (only NR);Eukaryota;SAR;Alveolata;Dinoflagellata;Dinophyceae;Peridiniphycidae;Gonyaulacales;Azadinium;";"0.0";"0";"114";"113";"0";"113";"1";"457070";"373894"
"V4mis1";"SILVA (only NR);Eukaryota;SAR;Alveolata;Dinoflagellata;Dinophyceae;Peridiniphycidae;Gonyaulacales;Ceratium;";"0.0";"0";"11";"11";"0";"11";"0";"457172";"373894"
"V4mis1";"SILVA (only NR);Eukaryota;SAR;Alveolata;Dinoflagellata;Dinophyceae;Peridiniphycidae;Gonyaulacales;Ceratocorys;";"0.0";"0";"2";"2";"0";"2";"0";"457181";"373894"
"V4mis1";"SILVA (only NR);Eukaryota;SAR;Alveolata;Dinoflagellata;Dinophyceae;Peridiniphycidae;Gonyaulacales;Coolia;";"0.0";"0";"5";"5";"0";"5";"0";"457178";"373894"
"V4mis1";"SILVA (only NR);Eukaryota;SAR;Alveolata;Dinoflagellata;Dinophyceae;Peridiniphycidae;Gonyaulacales;Dapsilidinium;";"0.0";"0";"1";"1";"0";"1";"0";"457182";"373894"
"V4mis1";"SILVA (only NR);Eukaryota;SAR;Alveolata;Dinoflagellata;Dinophyceae;Peridiniphycidae;Gonyaulacales;Fragilidium;";"0.0";"0";"3";"3";"0";"3";"0";"457180";"373894"
"V4mis1";"SILVA (only NR);Eukaryota;SAR;Alveolata;Dinoflagellata;Dinophyceae;Peridiniphycidae;Gonyaulacales;Gambierdiscus;";"0.0";"0";"64";"64";"0";"64";"0";"457119";"373894"
"V4mis1";"SILVA (only NR);Eukaryota;SAR;Alveolata;Dinoflagellata;Dinophyceae;Peridiniphycidae;Gonyaulacales;Goniodoma;";"0.0";"0";"1";"1";"0";"1";"0";"457182";"373894"
"V4mis1";"SILVA (only NR);Eukaryota;SAR;Alveolata;Dinoflagellata;Dinophyceae;Peridiniphycidae;Gonyaulacales;Gonyaulax;";"0.0";"0";"24";"21";"0";"21";"3";"457162";"373894"
"V4mis1";"SILVA (only NR);Eukaryota;SAR;Alveolata;Dinoflagellata;Dinophyceae;Peridiniphycidae;Gonyaulacales;Grammatodinium;";"0.0";"0";"1";"1";"0";"1";"0";"457182";"373894"
"V4mis1";"SILVA (only NR);Eukaryota;SAR;Alveolata;Dinoflagellata;Dinophyceae;Peridiniphycidae;Gonyaulacales;Heterodinium;";"0.0";"0";"8";"6";"0";"6";"2";"457177";"373894"
"V4mis1";"SILVA (only NR);Eukaryota;SAR;Alveolata;Dinoflagellata;Dinophyceae;Peridiniphycidae;Gonyaulacales;Lingulodinium;";"0.0";"0";"6";"5";"0";"5";"1";"457178";"373894"
"V4mis1";"SILVA (only NR);Eukaryota;SAR;Alveolata;Dinoflagellata;Dinophyceae;Peridiniphycidae;Gonyaulacales;Neoceratium;";"0.0";"0";"7";"7";"0";"7";"0";"457176";"373894"
"V4mis1";"SILVA (only NR);Eukaryota;SAR;Alveolata;Dinoflagellata;Dinophyceae;Peridiniphycidae;Gonyaulacales;Ostreopsis;";"0.0";"0";"7";"7";"0";"7";"0";"457176";"373894"
"V4mis1";"SILVA (only NR);Eukaryota;SAR;Alveolata;Dinoflagellata;Dinophyceae;Peridiniphycidae;Gonyaulacales;Posoniella;";"0.0";"0";"1";"1";"0";"1";"0";"457182";"373894"
"V4mis1";"SILVA (only NR);Eukaryota;SAR;Alveolata;Dinoflagellata;Dinophyceae;Peridiniphycidae;Gonyaulacales;Protoceratium;";"0.0";"0";"2";"2";"0";"2";"0";"457181";"373894"
"V4mis1";"SILVA (only NR);Eukaryota;SAR;Alveolata;Dinoflagellata;Dinophyceae;Peridiniphycidae;Gonyaulacales;Pyrocystis;";"0.0";"0";"2";"2";"0";"2";"0";"457181";"373894"
"V4mis1";"SILVA (only NR);Eukaryota;SAR;Alveolata;Dinoflagellata;Dinophyceae;Peridiniphycidae;Gonyaulacales;Pyrodinium;";"0.0";"0";"2";"2";"0";"2";"0";"457181";"373894"
"V4mis1";"SILVA (only NR);Eukaryota;SAR;Alveolata;Dinoflagellata;Dinophyceae;Peridiniphycidae;Gonyaulacales;Pyrophacus;";"0.0";"0";"1";"1";"0";"1";"0";"457182";"373894"
"V4mis1";"SILVA (only NR);Eukaryota;SAR;Alveolata;Dinoflagellata;Dinophyceae;Peridiniphycidae;Gonyaulacales;Pyxidinopsis;";"0.0";"0";"1";"1";"0";"1";"0";"457182";"373894"
"V4mis1";"SILVA (only NR);Eukaryota;SAR;Alveolata;Dinoflagellata;Dinophyceae;Peridiniphycidae;Gonyaulacales;Thecadinium;";"0.0";"0";"1";"1";"0";"1";"0";"457182";"373894"
"V4mis1";"SILVA (only NR);Eukaryota;SAR;Alveolata;Dinoflagellata;Dinophyceae;Peridiniphycidae;Gonyaulacales;uncultured;";"0.0";"0";"2";"2";"0";"2";"0";"457181";"373894"
"V4mis1";"SILVA (only NR);Eukaryota;SAR;Alveolata;Dinoflagellata;Dinophyceae;Peridiniphycidae;Peridiniales;";"0.0";"0";"204";"202";"0";"202";"2";"456981";"373894"
"V4mis1";"SILVA (only NR);Eukaryota;SAR;Alveolata;Dinoflagellata;Dinophyceae;Peridiniphycidae;Peridiniales;Aduncodinium;";"0.0";"0";"3";"3";"0";"3";"0";"457180";"373894"
"V4mis1";"SILVA (only NR);Eukaryota;SAR;Alveolata;Dinoflagellata;Dinophyceae;Peridiniphycidae;Peridiniales;Amphidiniella;";"0.0";"0";"1";"1";"0";"1";"0";"457182";"373894"
"V4mis1";"SILVA (only NR);Eukaryota;SAR;Alveolata;Dinoflagellata;Dinophyceae;Peridiniphycidae;Peridiniales;Amphidiniopsis;";"0.0";"0";"17";"17";"0";"17";"0";"457166";"373894"
"V4mis1";"SILVA (only NR);Eukaryota;SAR;Alveolata;Dinoflagellata;Dinophyceae;Peridiniphycidae;Peridiniales;Archaeperidinium;";"0.0";"0";"1";"1";"0";"1";"0";"457182";"373894"
"V4mis1";"SILVA (only NR);Eukaryota;SAR;Alveolata;Dinoflagellata;Dinophyceae;Peridiniphycidae;Peridiniales;Balechina;";"0.0";"0";"3";"3";"0";"3";"0";"457180";"373894"
"V4mis1";"SILVA (only NR);Eukaryota;SAR;Alveolata;Dinoflagellata;Dinophyceae;Peridiniphycidae;Peridiniales;Blixaea;";"0.0";"0";"1";"1";"0";"1";"0";"457182";"373894"
"V4mis1";"SILVA (only NR);Eukaryota;SAR;Alveolata;Dinoflagellata;Dinophyceae;Peridiniphycidae;Peridiniales;Crypthecodinium;";"0.0";"0";"4";"4";"0";"4";"0";"457179";"373894"
"V4mis1";"SILVA (only NR);Eukaryota;SAR;Alveolata;Dinoflagellata;Dinophyceae;Peridiniphycidae;Peridiniales;Cystodinium;";"0.0";"0";"1";"1";"0";"1";"0";"457182";"373894"
"V4mis1";"SILVA (only NR);Eukaryota;SAR;Alveolata;Dinoflagellata;Dinophyceae;Peridiniphycidae;Peridiniales;Diplopsalis;";"0.0";"0";"1";"1";"0";"1";"0";"457182";"373894"
"V4mis1";"SILVA (only NR);Eukaryota;SAR;Alveolata;Dinoflagellata;Dinophyceae;Peridiniphycidae;Peridiniales;Diplosalopsis;";"0.0";"0";"1";"1";"0";"1";"0";"457182";"373894"
"V4mis1";"SILVA (only NR);Eukaryota;SAR;Alveolata;Dinoflagellata;Dinophyceae;Peridiniphycidae;Peridiniales;Durinskia;";"0.0";"0";"6";"6";"0";"6";"0";"457177";"373894"
"V4mis1";"SILVA (only NR);Eukaryota;SAR;Alveolata;Dinoflagellata;Dinophyceae;Peridiniphycidae;Peridiniales;Galeidinium;";"0.0";"0";"1";"1";"0";"1";"0";"457182";"373894"
"V4mis1";"SILVA (only NR);Eukaryota;SAR;Alveolata;Dinoflagellata;Dinophyceae;Peridiniphycidae;Peridiniales;Glenodiniopsis;";"0.0";"0";"2";"2";"0";"2";"0";"457181";"373894"
"V4mis1";"SILVA (only NR);Eukaryota;SAR;Alveolata;Dinoflagellata;Dinophyceae;Peridiniphycidae;Peridiniales;Glenodinium;";"0.0";"0";"3";"3";"0";"3";"0";"457180";"373894"
"V4mis1";"SILVA (only NR);Eukaryota;SAR;Alveolata;Dinoflagellata;Dinophyceae;Peridiniphycidae;Peridiniales;Gotoius;";"0.0";"0";"1";"1";"0";"1";"0";"457182";"373894"
"V4mis1";"SILVA (only NR);Eukaryota;SAR;Alveolata;Dinoflagellata;Dinophyceae;Peridiniphycidae;Peridiniales;Hemidinium;";"0.0";"0";"1";"1";"0";"1";"0";"457182";"373894"
"V4mis1";"SILVA (only NR);Eukaryota;SAR;Alveolata;Dinoflagellata;Dinophyceae;Peridiniphycidae;Peridiniales;Herdmania;";"0.0";"0";"2";"2";"0";"2";"0";"457181";"373894"
"V4mis1";"SILVA (only NR);Eukaryota;SAR;Alveolata;Dinoflagellata;Dinophyceae;Peridiniphycidae;Peridiniales;Heterocapsa;";"0.0";"0";"29";"29";"0";"29";"0";"457154";"373894"
"V4mis1";"SILVA (only NR);Eukaryota;SAR;Alveolata;Dinoflagellata;Dinophyceae;Peridiniphycidae;Peridiniales;Islandinium;";"0.0";"0";"5";"4";"0";"4";"1";"457179";"373894"
"V4mis1";"SILVA (only NR);Eukaryota;SAR;Alveolata;Dinoflagellata;Dinophyceae;Peridiniphycidae;Peridiniales;Kryptoperidinium;";"0.0";"0";"2";"2";"0";"2";"0";"457181";"373894"
"V4mis1";"SILVA (only NR);Eukaryota;SAR;Alveolata;Dinoflagellata;Dinophyceae;Peridiniphycidae;Peridiniales;Niea;";"0.0";"0";"2";"2";"0";"2";"0";"457181";"373894"
"V4mis1";"SILVA (only NR);Eukaryota;SAR;Alveolata;Dinoflagellata;Dinophyceae;Peridiniphycidae;Peridiniales;Peridiniopsis;";"0.0";"0";"3";"3";"0";"3";"0";"457180";"373894"
"V4mis1";"SILVA (only NR);Eukaryota;SAR;Alveolata;Dinoflagellata;Dinophyceae;Peridiniphycidae;Peridiniales;Peridinium;";"0.0";"0";"32";"31";"0";"31";"1";"457152";"373894"
"V4mis1";"SILVA (only NR);Eukaryota;SAR;Alveolata;Dinoflagellata;Dinophyceae;Peridiniphycidae;Peridiniales;Preperidinium;";"0.0";"0";"1";"1";"0";"1";"0";"457182";"373894"
"V4mis1";"SILVA (only NR);Eukaryota;SAR;Alveolata;Dinoflagellata;Dinophyceae;Peridiniphycidae;Peridiniales;Protoperidinium;";"0.0";"0";"62";"62";"0";"62";"0";"457121";"373894"
"V4mis1";"SILVA (only NR);Eukaryota;SAR;Alveolata;Dinoflagellata;Dinophyceae;Peridiniphycidae;Peridiniales;Pyramidodinium;";"0.0";"0";"2";"2";"0";"2";"0";"457181";"373894"
"V4mis1";"SILVA (only NR);Eukaryota;SAR;Alveolata;Dinoflagellata;Dinophyceae;Peridiniphycidae;Peridiniales;Qia;";"0.0";"0";"1";"1";"0";"1";"0";"457182";"373894"
"V4mis1";"SILVA (only NR);Eukaryota;SAR;Alveolata;Dinoflagellata;Dinophyceae;Peridiniphycidae;Peridiniales;Stylodinium;";"0.0";"0";"1";"1";"0";"1";"0";"457182";"373894"
"V4mis1";"SILVA (only NR);Eukaryota;SAR;Alveolata;Dinoflagellata;Dinophyceae;Peridiniphycidae;Peridiniales;Thecate;";"0.0";"0";"1";"1";"0";"1";"0";"457182";"373894"
"V4mis1";"SILVA (only NR);Eukaryota;SAR;Alveolata;Dinoflagellata;Dinophyceae;Peridiniphycidae;Peridiniales;uncultured;";"0.0";"0";"7";"7";"0";"7";"0";"457176";"373894"
"V4mis1";"SILVA (only NR);Eukaryota;SAR;Alveolata;Dinoflagellata;Dinophyceae;Peridiniphycidae;Podolampadaceae;";"0.0";"0";"10";"10";"0";"10";"0";"457173";"373894"
"V4mis1";"SILVA (only NR);Eukaryota;SAR;Alveolata;Dinoflagellata;Dinophyceae;Peridiniphycidae;Podolampadaceae;Lessardia;";"0.0";"0";"6";"6";"0";"6";"0";"457177";"373894"
"V4mis1";"SILVA (only NR);Eukaryota;SAR;Alveolata;Dinoflagellata;Dinophyceae;Peridiniphycidae;Podolampadaceae;Podolampas;";"0.0";"0";"1";"1";"0";"1";"0";"457182";"373894"
"V4mis1";"SILVA (only NR);Eukaryota;SAR;Alveolata;Dinoflagellata;Dinophyceae;Peridiniphycidae;Podolampadaceae;Roscoffia;";"0.0";"0";"2";"2";"0";"2";"0";"457181";"373894"
"V4mis1";"SILVA (only NR);Eukaryota;SAR;Alveolata;Dinoflagellata;Dinophyceae;Peridiniphycidae;Thoracosphaeraceae;";"0.0";"0";"58";"56";"0";"56";"2";"457127";"373894"
"V4mis1";"SILVA (only NR);Eukaryota;SAR;Alveolata;Dinoflagellata;Dinophyceae;Peridiniphycidae;Thoracosphaeraceae;Cryptoperidiniopsis;";"0.0";"0";"5";"5";"0";"5";"0";"457178";"373894"
"V4mis1";"SILVA (only NR);Eukaryota;SAR;Alveolata;Dinoflagellata;Dinophyceae;Peridiniphycidae;Thoracosphaeraceae;Gloeodinium;";"0.0";"0";"2";"2";"0";"2";"0";"457181";"373894"
"V4mis1";"SILVA (only NR);Eukaryota;SAR;Alveolata;Dinoflagellata;Dinophyceae;Peridiniphycidae;Thoracosphaeraceae;Oodinium;";"0.0";"0";"8";"6";"0";"6";"2";"457177";"373894"
"V4mis1";"SILVA (only NR);Eukaryota;SAR;Alveolata;Dinoflagellata;Dinophyceae;Peridiniphycidae;Thoracosphaeraceae;Pentapharsodinium;";"0.0";"0";"6";"6";"0";"6";"0";"457177";"373894"
"V4mis1";"SILVA (only NR);Eukaryota;SAR;Alveolata;Dinoflagellata;Dinophyceae;Peridiniphycidae;Thoracosphaeraceae;Pfiesteria;";"0.0";"0";"9";"9";"0";"9";"0";"457174";"373894"
"V4mis1";"SILVA (only NR);Eukaryota;SAR;Alveolata;Dinoflagellata;Dinophyceae;Peridiniphycidae;Thoracosphaeraceae;Scrippsiella;";"0.0";"0";"14";"14";"0";"14";"0";"457169";"373894"
"V4mis1";"SILVA (only NR);Eukaryota;SAR;Alveolata;Dinoflagellata;Dinophyceae;Peridiniphycidae;Thoracosphaeraceae;Stoeckeria;";"0.0";"0";"1";"1";"0";"1";"0";"457182";"373894"
"V4mis1";"SILVA (only NR);Eukaryota;SAR;Alveolata;Dinoflagellata;Dinophyceae;Peridiniphycidae;Thoracosphaeraceae;Thoracosphaera;";"0.0";"0";"2";"2";"0";"2";"0";"457181";"373894"
"V4mis1";"SILVA (only NR);Eukaryota;SAR;Alveolata;Dinoflagellata;Dinophyceae;Peridiniphycidae;Thoracosphaeraceae;Tintinnophagus;";"0.0";"0";"1";"1";"0";"1";"0";"457182";"373894"
"V4mis1";"SILVA (only NR);Eukaryota;SAR;Alveolata;Dinoflagellata;Dinophyceae;Peridiniphycidae;Thoracosphaeraceae;uncultured;";"0.0";"0";"5";"5";"0";"5";"0";"457178";"373894"
"V4mis1";"SILVA (only NR);Eukaryota;SAR;Alveolata;Dinoflagellata;Dinophyceae;Prorocentrales;";"0.0";"0";"44";"44";"0";"44";"0";"457139";"373894"
"V4mis1";"SILVA (only NR);Eukaryota;SAR;Alveolata;Dinoflagellata;Dinophyceae;Prorocentrales;Plagiodinium;";"0.0";"0";"3";"3";"0";"3";"0";"457180";"373894"
"V4mis1";"SILVA (only NR);Eukaryota;SAR;Alveolata;Dinoflagellata;Dinophyceae;Prorocentrales;Prorocentrum;";"0.0";"0";"41";"41";"0";"41";"0";"457142";"373894"
"V4mis1";"SILVA (only NR);Eukaryota;SAR;Alveolata;Dinoflagellata;Dinophyceae;uncultured;";"0.0";"0";"194";"191";"0";"191";"3";"456992";"373894"
"V4mis1";"SILVA (only NR);Eukaryota;SAR;Alveolata;Dinoflagellata;Incertae Sedis;";"0.0";"0";"39";"36";"0";"36";"3";"457147";"373894"
"V4mis1";"SILVA (only NR);Eukaryota;SAR;Alveolata;Dinoflagellata;Incertae Sedis;Blastodinium;";"0.0";"0";"24";"21";"0";"21";"3";"457162";"373894"
"V4mis1";"SILVA (only NR);Eukaryota;SAR;Alveolata;Dinoflagellata;Incertae Sedis;Haplozoon;";"0.0";"0";"7";"7";"0";"7";"0";"457176";"373894"
"V4mis1";"SILVA (only NR);Eukaryota;SAR;Alveolata;Dinoflagellata;Incertae Sedis;Paulsenella;";"0.0";"0";"1";"1";"0";"1";"0";"457182";"373894"
"V4mis1";"SILVA (only NR);Eukaryota;SAR;Alveolata;Dinoflagellata;Noctilucales;";"0.0";"0";"11";"11";"0";"11";"0";"457172";"373894"
"V4mis1";"SILVA (only NR);Eukaryota;SAR;Alveolata;Dinoflagellata;Noctilucales;Abedinium;";"0.0";"0";"4";"4";"0";"4";"0";"457179";"373894"
"V4mis1";"SILVA (only NR);Eukaryota;SAR;Alveolata;Dinoflagellata;Noctilucales;Kofoidinium;";"0.0";"0";"1";"1";"0";"1";"0";"457182";"373894"
"V4mis1";"SILVA (only NR);Eukaryota;SAR;Alveolata;Dinoflagellata;Noctilucales;Noctiluca;";"0.0";"0";"2";"2";"0";"2";"0";"457181";"373894"
"V4mis1";"SILVA (only NR);Eukaryota;SAR;Alveolata;Dinoflagellata;Noctilucales;Spatulodinium;";"0.0";"0";"1";"1";"0";"1";"0";"457182";"373894"
"V4mis1";"SILVA (only NR);Eukaryota;SAR;Alveolata;Dinoflagellata;uncultured;";"0.0";"0";"11";"11";"0";"11";"0";"457172";"373894"
"V4mis1";"SILVA (only NR);Eukaryota;SAR;Alveolata;Incertae Sedis;";"0.0";"0";"7";"7";"0";"7";"0";"457176";"373894"
"V4mis1";"SILVA (only NR);Eukaryota;SAR;Alveolata;Incertae Sedis;Colponema;";"0.0";"0";"7";"7";"0";"7";"0";"457176";"373894"
"V4mis1";"SILVA (only NR);Eukaryota;SAR;Alveolata;Protalveolata;";"2.4";"17.7";"3050";"2912";"70";"2842";"138";"454271";"373824"
"V4mis1";"SILVA (only NR);Eukaryota;SAR;Alveolata;Protalveolata;Chromerida;";"0.0";"0";"3";"3";"0";"3";"0";"457180";"373894"
"V4mis1";"SILVA (only NR);Eukaryota;SAR;Alveolata;Protalveolata;Chromerida;Chromera;";"0.0";"0";"3";"3";"0";"3";"0";"457180";"373894"
"V4mis1";"SILVA (only NR);Eukaryota;SAR;Alveolata;Protalveolata;Colpodellida;";"0.0";"0";"228";"228";"0";"228";"0";"456955";"373894"
"V4mis1";"SILVA (only NR);Eukaryota;SAR;Alveolata;Protalveolata;Colpodellida;Colpodella;";"0.0";"0";"222";"222";"0";"222";"0";"456961";"373894"
"V4mis1";"SILVA (only NR);Eukaryota;SAR;Alveolata;Protalveolata;Colpodellida;Voromonas;";"0.0";"0";"2";"2";"0";"2";"0";"457181";"373894"
"V4mis1";"SILVA (only NR);Eukaryota;SAR;Alveolata;Protalveolata;Incertae Sedis;";"0.0";"0";"10";"10";"0";"10";"0";"457173";"373894"
"V4mis1";"SILVA (only NR);Eukaryota;SAR;Alveolata;Protalveolata;Incertae Sedis;Ellobiopsidae;";"0.0";"0";"10";"10";"0";"10";"0";"457173";"373894"
"V4mis1";"SILVA (only NR);Eukaryota;SAR;Alveolata;Protalveolata;Incertae Sedis;Ellobiopsidae;Ellobiopsis;";"0.0";"0";"5";"5";"0";"5";"0";"457178";"373894"
"V4mis1";"SILVA (only NR);Eukaryota;SAR;Alveolata;Protalveolata;Incertae Sedis;Ellobiopsidae;Thalassomyces;";"0.0";"0";"3";"3";"0";"3";"0";"457180";"373894"
"V4mis1";"SILVA (only NR);Eukaryota;SAR;Alveolata;Protalveolata;Incertae Sedis;Ellobiopsidae;uncultured;";"0.0";"0";"2";"2";"0";"2";"0";"457181";"373894"
"V4mis1";"SILVA (only NR);Eukaryota;SAR;Alveolata;Protalveolata;Oxyrrhis;";"0.0";"0";"12";"11";"0";"11";"1";"457172";"373894"
"V4mis1";"SILVA (only NR);Eukaryota;SAR;Alveolata;Protalveolata;Perkinsidae;";"0.0";"0";"75";"72";"0";"72";"3";"457111";"373894"
"V4mis1";"SILVA (only NR);Eukaryota;SAR;Alveolata;Protalveolata;Perkinsidae;A31;";"0.0";"0";"41";"41";"0";"41";"0";"457142";"373894"
"V4mis1";"SILVA (only NR);Eukaryota;SAR;Alveolata;Protalveolata;Perkinsidae;Parvilucifera;";"0.0";"0";"26";"23";"0";"23";"3";"457160";"373894"
"V4mis1";"SILVA (only NR);Eukaryota;SAR;Alveolata;Protalveolata;Perkinsidae;Perkinsus;";"0.0";"0";"6";"6";"0";"6";"0";"457177";"373894"
"V4mis1";"SILVA (only NR);Eukaryota;SAR;Alveolata;Protalveolata;Syndiniales;";"2.7";"17.8";"2722";"2588";"70";"2518";"134";"454595";"373824"
"V4mis1";"SILVA (only NR);Eukaryota;SAR;Alveolata;Protalveolata;Syndiniales;Amoebophrya;";"0.5";"18.2";"222";"201";"1";"200";"21";"456982";"373893"
"V4mis1";"SILVA (only NR);Eukaryota;SAR;Alveolata;Protalveolata;Syndiniales;Duboscquella;";"0.0";"0";"47";"40";"0";"40";"7";"457143";"373894"
"V4mis1";"SILVA (only NR);Eukaryota;SAR;Alveolata;Protalveolata;Syndiniales;Hematodinium;";"0.0";"0";"10";"10";"0";"10";"0";"457173";"373894"
"V4mis1";"SILVA (only NR);Eukaryota;SAR;Alveolata;Protalveolata;Syndiniales;Syndiniales Group I;";"0.1";"18.1";"757";"702";"1";"701";"55";"456481";"373893"
"V4mis1";"SILVA (only NR);Eukaryota;SAR;Alveolata;Protalveolata;Syndiniales;Syndiniales Group II;";"4.8";"18";"1469";"1428";"68";"1360";"41";"455755";"373826"
"V4mis1";"SILVA (only NR);Eukaryota;SAR;Alveolata;Protalveolata;Syndiniales;Syndiniales Group III;";"0.0";"0";"52";"49";"0";"49";"3";"457134";"373894"
"V4mis1";"SILVA (only NR);Eukaryota;SAR;Alveolata;Protalveolata;Syndiniales;Syndiniales Group V;";"0.0";"0";"36";"36";"0";"36";"0";"457147";"373894"
"V4mis1";"SILVA (only NR);Eukaryota;SAR;Alveolata;Protalveolata;Syndiniales;Syndinium;";"0.0";"0";"6";"6";"0";"6";"0";"457177";"373894"
"V4mis1";"SILVA (only NR);Eukaryota;SAR;Alveolata;Protalveolata;Syndiniales;uncultured;";"0.0";"0";"50";"48";"0";"48";"2";"457135";"373894"
"V4mis1";"SILVA (only NR);Eukaryota;SAR;Alveolata;uncultured;";"0.0";"0";"116";"100";"0";"100";"16";"457083";"373894"
"V4mis1";"SILVA (only NR);Eukaryota;SAR;Rhizaria;";"1.1";"17.8";"2522";"2300";"25";"2275";"222";"454883";"373869"
"V4mis1";"SILVA (only NR);Eukaryota;SAR;Rhizaria;Cercozoa;";"0.0";"0";"1374";"1339";"0";"1339";"35";"455844";"373894"
"V4mis1";"SILVA (only NR);Eukaryota;SAR;Rhizaria;Cercozoa;Ascetosporea;";"0.0";"0";"49";"49";"0";"49";"0";"457134";"373894"
"V4mis1";"SILVA (only NR);Eukaryota;SAR;Rhizaria;Cercozoa;Ascetosporea;Haplosporida;";"0.0";"0";"38";"38";"0";"38";"0";"457145";"373894"
"V4mis1";"SILVA (only NR);Eukaryota;SAR;Rhizaria;Cercozoa;Ascetosporea;Haplosporida;Bonamia;";"0.0";"0";"5";"5";"0";"5";"0";"457178";"373894"
"V4mis1";"SILVA (only NR);Eukaryota;SAR;Rhizaria;Cercozoa;Ascetosporea;Haplosporida;Haplosporidium;";"0.0";"0";"14";"14";"0";"14";"0";"457169";"373894"
"V4mis1";"SILVA (only NR);Eukaryota;SAR;Rhizaria;Cercozoa;Ascetosporea;Haplosporida;Minchinia;";"0.0";"0";"10";"10";"0";"10";"0";"457173";"373894"
"V4mis1";"SILVA (only NR);Eukaryota;SAR;Rhizaria;Cercozoa;Ascetosporea;Haplosporida;Urosporidium;";"0.0";"0";"4";"4";"0";"4";"0";"457179";"373894"
"V4mis1";"SILVA (only NR);Eukaryota;SAR;Rhizaria;Cercozoa;Ascetosporea;Paradiniidae;";"0.0";"0";"5";"5";"0";"5";"0";"457178";"373894"
"V4mis1";"SILVA (only NR);Eukaryota;SAR;Rhizaria;Cercozoa;Ascetosporea;Paradiniidae;Paradinium;";"0.0";"0";"5";"5";"0";"5";"0";"457178";"373894"
"V4mis1";"SILVA (only NR);Eukaryota;SAR;Rhizaria;Cercozoa;Basal Group T;";"0.0";"0";"14";"8";"0";"8";"6";"457175";"373894"
"V4mis1";"SILVA (only NR);Eukaryota;SAR;Rhizaria;Cercozoa;Cercomonadidae;";"0.0";"0";"184";"181";"0";"181";"3";"457002";"373894"
"V4mis1";"SILVA (only NR);Eukaryota;SAR;Rhizaria;Cercozoa;Cercomonadidae;Cavernomonas;";"0.0";"0";"2";"2";"0";"2";"0";"457181";"373894"
"V4mis1";"SILVA (only NR);Eukaryota;SAR;Rhizaria;Cercozoa;Cercomonadidae;Cercomonas;";"0.0";"0";"89";"89";"0";"89";"0";"457094";"373894"
"V4mis1";"SILVA (only NR);Eukaryota;SAR;Rhizaria;Cercozoa;Cercomonadidae;Eocercomonas;";"0.0";"0";"2";"2";"0";"2";"0";"457181";"373894"
"V4mis1";"SILVA (only NR);Eukaryota;SAR;Rhizaria;Cercozoa;Cercomonadidae;Metabolomonas;";"0.0";"0";"2";"2";"0";"2";"0";"457181";"373894"
"V4mis1";"SILVA (only NR);Eukaryota;SAR;Rhizaria;Cercozoa;Cercomonadidae;Paracercomonas;";"0.0";"0";"15";"15";"0";"15";"0";"457168";"373894"
"V4mis1";"SILVA (only NR);Eukaryota;SAR;Rhizaria;Cercozoa;Cercomonadidae;uncultured;";"0.0";"0";"52";"49";"0";"49";"3";"457134";"373894"
"V4mis1";"SILVA (only NR);Eukaryota;SAR;Rhizaria;Cercozoa;Chlorarachniophyta;";"0.0";"0";"60";"60";"0";"60";"0";"457123";"373894"
"V4mis1";"SILVA (only NR);Eukaryota;SAR;Rhizaria;Cercozoa;Chlorarachniophyta;Amorphochlora;";"0.0";"0";"2";"2";"0";"2";"0";"457181";"373894"
"V4mis1";"SILVA (only NR);Eukaryota;SAR;Rhizaria;Cercozoa;Chlorarachniophyta;Bigelowiella;";"0.0";"0";"9";"9";"0";"9";"0";"457174";"373894"
"V4mis1";"SILVA (only NR);Eukaryota;SAR;Rhizaria;Cercozoa;Chlorarachniophyta;Chlorarachnion;";"0.0";"0";"5";"5";"0";"5";"0";"457178";"373894"
"V4mis1";"SILVA (only NR);Eukaryota;SAR;Rhizaria;Cercozoa;Chlorarachniophyta;Gymnochlora;";"0.0";"0";"6";"6";"0";"6";"0";"457177";"373894"
"V4mis1";"SILVA (only NR);Eukaryota;SAR;Rhizaria;Cercozoa;Chlorarachniophyta;Lotharella;";"0.0";"0";"13";"13";"0";"13";"0";"457170";"373894"
"V4mis1";"SILVA (only NR);Eukaryota;SAR;Rhizaria;Cercozoa;Chlorarachniophyta;Minorisa;";"0.0";"0";"6";"6";"0";"6";"0";"457177";"373894"
"V4mis1";"SILVA (only NR);Eukaryota;SAR;Rhizaria;Cercozoa;Chlorarachniophyta;NOR26;";"0.0";"0";"7";"7";"0";"7";"0";"457176";"373894"
"V4mis1";"SILVA (only NR);Eukaryota;SAR;Rhizaria;Cercozoa;Chlorarachniophyta;uncultured;";"0.0";"0";"9";"9";"0";"9";"0";"457174";"373894"
"V4mis1";"SILVA (only NR);Eukaryota;SAR;Rhizaria;Cercozoa;Clathrulinidae;";"0.0";"0";"3";"3";"0";"3";"0";"457180";"373894"
"V4mis1";"SILVA (only NR);Eukaryota;SAR;Rhizaria;Cercozoa;Clathrulinidae;Hedriocystis;";"0.0";"0";"3";"3";"0";"3";"0";"457180";"373894"
"V4mis1";"SILVA (only NR);Eukaryota;SAR;Rhizaria;Cercozoa;Cyranomonas;";"0.0";"0";"5";"4";"0";"4";"1";"457179";"373894"
"V4mis1";"SILVA (only NR);Eukaryota;SAR;Rhizaria;Cercozoa;Glissomonadida;";"0.0";"0";"138";"138";"0";"138";"0";"457045";"373894"
"V4mis1";"SILVA (only NR);Eukaryota;SAR;Rhizaria;Cercozoa;Glissomonadida;Allantion;";"0.0";"0";"6";"6";"0";"6";"0";"457177";"373894"
"V4mis1";"SILVA (only NR);Eukaryota;SAR;Rhizaria;Cercozoa;Glissomonadida;Bodomorpha;";"0.0";"0";"10";"10";"0";"10";"0";"457173";"373894"
"V4mis1";"SILVA (only NR);Eukaryota;SAR;Rhizaria;Cercozoa;Glissomonadida;Heteromita;";"0.0";"0";"95";"95";"0";"95";"0";"457088";"373894"
"V4mis1";"SILVA (only NR);Eukaryota;SAR;Rhizaria;Cercozoa;Glissomonadida;Orciraptor;";"0.0";"0";"2";"2";"0";"2";"0";"457181";"373894"
"V4mis1";"SILVA (only NR);Eukaryota;SAR;Rhizaria;Cercozoa;Glissomonadida;Proleptomonas;";"0.0";"0";"4";"4";"0";"4";"0";"457179";"373894"
"V4mis1";"SILVA (only NR);Eukaryota;SAR;Rhizaria;Cercozoa;Glissomonadida;Viridiraptor;";"0.0";"0";"2";"2";"0";"2";"0";"457181";"373894"
"V4mis1";"SILVA (only NR);Eukaryota;SAR;Rhizaria;Cercozoa;Glissomonadida;uncultured;";"0.0";"0";"8";"8";"0";"8";"0";"457175";"373894"
"V4mis1";"SILVA (only NR);Eukaryota;SAR;Rhizaria;Cercozoa;Granofilosea;";"0.0";"0";"10";"10";"0";"10";"0";"457173";"373894"
"V4mis1";"SILVA (only NR);Eukaryota;SAR;Rhizaria;Cercozoa;Granofilosea;Massisteria;";"0.0";"0";"10";"10";"0";"10";"0";"457173";"373894"
"V4mis1";"SILVA (only NR);Eukaryota;SAR;Rhizaria;Cercozoa;Gromia;";"0.0";"0";"9";"9";"0";"9";"0";"457174";"373894"
"V4mis1";"SILVA (only NR);Eukaryota;SAR;Rhizaria;Cercozoa;Imbricatea;";"0.0";"0";"187";"184";"0";"184";"3";"456999";"373894"
"V4mis1";"SILVA (only NR);Eukaryota;SAR;Rhizaria;Cercozoa;Imbricatea;Auranticordis;";"0.0";"0";"1";"1";"0";"1";"0";"457182";"373894"
"V4mis1";"SILVA (only NR);Eukaryota;SAR;Rhizaria;Cercozoa;Imbricatea;Marimonadida;";"0.0";"0";"18";"17";"0";"17";"1";"457166";"373894"
"V4mis1";"SILVA (only NR);Eukaryota;SAR;Rhizaria;Cercozoa;Imbricatea;Marimonadida;BB01-173;";"0.0";"0";"3";"3";"0";"3";"0";"457180";"373894"
"V4mis1";"SILVA (only NR);Eukaryota;SAR;Rhizaria;Cercozoa;Imbricatea;Marimonadida;NAMAKO-15;";"0.0";"0";"4";"4";"0";"4";"0";"457179";"373894"
"V4mis1";"SILVA (only NR);Eukaryota;SAR;Rhizaria;Cercozoa;Imbricatea;Marimonadida;Pseudopirsonia;";"0.0";"0";"8";"8";"0";"8";"0";"457175";"373894"
"V4mis1";"SILVA (only NR);Eukaryota;SAR;Rhizaria;Cercozoa;Imbricatea;Novel Clade 3;";"0.0";"0";"4";"4";"0";"4";"0";"457179";"373894"
"V4mis1";"SILVA (only NR);Eukaryota;SAR;Rhizaria;Cercozoa;Imbricatea;Nudifila;";"0.0";"0";"7";"7";"0";"7";"0";"457176";"373894"
"V4mis1";"SILVA (only NR);Eukaryota;SAR;Rhizaria;Cercozoa;Imbricatea;Silicofilosea;";"0.0";"0";"151";"149";"0";"149";"2";"457034";"373894"
"V4mis1";"SILVA (only NR);Eukaryota;SAR;Rhizaria;Cercozoa;Imbricatea;Silicofilosea;Euglyphida;";"0.0";"0";"99";"98";"0";"98";"1";"457085";"373894"
"V4mis1";"SILVA (only NR);Eukaryota;SAR;Rhizaria;Cercozoa;Imbricatea;Silicofilosea;Euglyphida;Assulinidae;";"0.0";"0";"3";"3";"0";"3";"0";"457180";"373894"
"V4mis1";"SILVA (only NR);Eukaryota;SAR;Rhizaria;Cercozoa;Imbricatea;Silicofilosea;Euglyphida;Assulinidae;Assulina;";"0.0";"0";"1";"1";"0";"1";"0";"457182";"373894"
"V4mis1";"SILVA (only NR);Eukaryota;SAR;Rhizaria;Cercozoa;Imbricatea;Silicofilosea;Euglyphida;Assulinidae;Placocista;";"0.0";"0";"2";"2";"0";"2";"0";"457181";"373894"
"V4mis1";"SILVA (only NR);Eukaryota;SAR;Rhizaria;Cercozoa;Imbricatea;Silicofilosea;Euglyphida;Cyphoderiidae;";"0.0";"0";"15";"15";"0";"15";"0";"457168";"373894"
"V4mis1";"SILVA (only NR);Eukaryota;SAR;Rhizaria;Cercozoa;Imbricatea;Silicofilosea;Euglyphida;Cyphoderiidae;Corythionella;";"0.0";"0";"1";"1";"0";"1";"0";"457182";"373894"
"V4mis1";"SILVA (only NR);Eukaryota;SAR;Rhizaria;Cercozoa;Imbricatea;Silicofilosea;Euglyphida;Cyphoderiidae;Cyphoderia;";"0.0";"0";"10";"10";"0";"10";"0";"457173";"373894"
"V4mis1";"SILVA (only NR);Eukaryota;SAR;Rhizaria;Cercozoa;Imbricatea;Silicofilosea;Euglyphida;Euglyphidae;";"0.0";"0";"12";"12";"0";"12";"0";"457171";"373894"
"V4mis1";"SILVA (only NR);Eukaryota;SAR;Rhizaria;Cercozoa;Imbricatea;Silicofilosea;Euglyphida;Euglyphidae;Euglypha;";"0.0";"0";"12";"12";"0";"12";"0";"457171";"373894"
"V4mis1";"SILVA (only NR);Eukaryota;SAR;Rhizaria;Cercozoa;Imbricatea;Silicofilosea;Euglyphida;Incertae Sedis;";"0.0";"0";"7";"7";"0";"7";"0";"457176";"373894"
"V4mis1";"SILVA (only NR);Eukaryota;SAR;Rhizaria;Cercozoa;Imbricatea;Silicofilosea;Euglyphida;Incertae Sedis;Sphenoderia;";"0.0";"0";"4";"4";"0";"4";"0";"457179";"373894"
"V4mis1";"SILVA (only NR);Eukaryota;SAR;Rhizaria;Cercozoa;Imbricatea;Silicofilosea;Euglyphida;Incertae Sedis;Tracheleuglypha;";"0.0";"0";"2";"2";"0";"2";"0";"457181";"373894"
"V4mis1";"SILVA (only NR);Eukaryota;SAR;Rhizaria;Cercozoa;Imbricatea;Silicofilosea;Euglyphida;Incertae Sedis;Trachelocorythion;";"0.0";"0";"1";"1";"0";"1";"0";"457182";"373894"
"V4mis1";"SILVA (only NR);Eukaryota;SAR;Rhizaria;Cercozoa;Imbricatea;Silicofilosea;Euglyphida;Paulinellidae;";"0.0";"0";"15";"14";"0";"14";"1";"457169";"373894"
"V4mis1";"SILVA (only NR);Eukaryota;SAR;Rhizaria;Cercozoa;Imbricatea;Silicofilosea;Euglyphida;Paulinellidae;Paulinella;";"0.0";"0";"15";"14";"0";"14";"1";"457169";"373894"
"V4mis1";"SILVA (only NR);Eukaryota;SAR;Rhizaria;Cercozoa;Imbricatea;Silicofilosea;Euglyphida;Trinematidae;";"0.0";"0";"33";"33";"0";"33";"0";"457150";"373894"
"V4mis1";"SILVA (only NR);Eukaryota;SAR;Rhizaria;Cercozoa;Imbricatea;Silicofilosea;Euglyphida;Trinematidae;Corythion;";"0.0";"0";"1";"1";"0";"1";"0";"457182";"373894"
"V4mis1";"SILVA (only NR);Eukaryota;SAR;Rhizaria;Cercozoa;Imbricatea;Silicofilosea;Euglyphida;Trinematidae;Trinema;";"0.0";"0";"23";"23";"0";"23";"0";"457160";"373894"
"V4mis1";"SILVA (only NR);Eukaryota;SAR;Rhizaria;Cercozoa;Imbricatea;Silicofilosea;Euglyphida;Trinematidae;uncultured;";"0.0";"0";"5";"5";"0";"5";"0";"457178";"373894"
"V4mis1";"SILVA (only NR);Eukaryota;SAR;Rhizaria;Cercozoa;Imbricatea;Silicofilosea;Euglyphida;uncultured;";"0.0";"0";"8";"8";"0";"8";"0";"457175";"373894"
"V4mis1";"SILVA (only NR);Eukaryota;SAR;Rhizaria;Cercozoa;Imbricatea;Silicofilosea;Thaumatomonadida;";"0.0";"0";"52";"51";"0";"51";"1";"457132";"373894"
"V4mis1";"SILVA (only NR);Eukaryota;SAR;Rhizaria;Cercozoa;Imbricatea;Silicofilosea;Thaumatomonadida;Peregriniidae;";"0.0";"0";"18";"18";"0";"18";"0";"457165";"373894"
"V4mis1";"SILVA (only NR);Eukaryota;SAR;Rhizaria;Cercozoa;Imbricatea;Silicofilosea;Thaumatomonadida;Peregriniidae;CCe;";"0.0";"0";"2";"2";"0";"2";"0";"457181";"373894"
"V4mis1";"SILVA (only NR);Eukaryota;SAR;Rhizaria;Cercozoa;Imbricatea;Silicofilosea;Thaumatomonadida;Peregriniidae;D2P04A09;";"0.0";"0";"6";"6";"0";"6";"0";"457177";"373894"
"V4mis1";"SILVA (only NR);Eukaryota;SAR;Rhizaria;Cercozoa;Imbricatea;Silicofilosea;Thaumatomonadida;Peregriniidae;Esquamula;";"0.0";"0";"1";"1";"0";"1";"0";"457182";"373894"
"V4mis1";"SILVA (only NR);Eukaryota;SAR;Rhizaria;Cercozoa;Imbricatea;Silicofilosea;Thaumatomonadida;Peregriniidae;Gyromitus;";"0.0";"0";"5";"5";"0";"5";"0";"457178";"373894"
"V4mis1";"SILVA (only NR);Eukaryota;SAR;Rhizaria;Cercozoa;Imbricatea;Silicofilosea;Thaumatomonadida;Thaumatomonadidae;";"0.0";"0";"34";"33";"0";"33";"1";"457150";"373894"
"V4mis1";"SILVA (only NR);Eukaryota;SAR;Rhizaria;Cercozoa;Imbricatea;Silicofilosea;Thaumatomonadida;Thaumatomonadidae;Allas;";"0.0";"0";"5";"4";"0";"4";"1";"457179";"373894"
"V4mis1";"SILVA (only NR);Eukaryota;SAR;Rhizaria;Cercozoa;Imbricatea;Silicofilosea;Thaumatomonadida;Thaumatomonadidae;Thaumatomastix;";"0.0";"0";"7";"7";"0";"7";"0";"457176";"373894"
"V4mis1";"SILVA (only NR);Eukaryota;SAR;Rhizaria;Cercozoa;Imbricatea;Silicofilosea;Thaumatomonadida;Thaumatomonadidae;Thaumatomonas;";"0.0";"0";"5";"5";"0";"5";"0";"457178";"373894"
"V4mis1";"SILVA (only NR);Eukaryota;SAR;Rhizaria;Cercozoa;Imbricatea;Silicofilosea;Thaumatomonadida;Thaumatomonadidae;uncultured;";"0.0";"0";"10";"10";"0";"10";"0";"457173";"373894"
"V4mis1";"SILVA (only NR);Eukaryota;SAR;Rhizaria;Cercozoa;Imbricatea;Spongomonadida;";"0.0";"0";"6";"6";"0";"6";"0";"457177";"373894"
"V4mis1";"SILVA (only NR);Eukaryota;SAR;Rhizaria;Cercozoa;Imbricatea;Spongomonadida;Spongomonas;";"0.0";"0";"6";"6";"0";"6";"0";"457177";"373894"
"V4mis1";"SILVA (only NR);Eukaryota;SAR;Rhizaria;Cercozoa;Incertae Sedis;";"0.0";"0";"49";"49";"0";"49";"0";"457134";"373894"
"V4mis1";"SILVA (only NR);Eukaryota;SAR;Rhizaria;Cercozoa;Incertae Sedis;Cholamonas;";"0.0";"0";"1";"1";"0";"1";"0";"457182";"373894"
"V4mis1";"SILVA (only NR);Eukaryota;SAR;Rhizaria;Cercozoa;Incertae Sedis;Gymnophrys;";"0.0";"0";"24";"24";"0";"24";"0";"457159";"373894"
"V4mis1";"SILVA (only NR);Eukaryota;SAR;Rhizaria;Cercozoa;Incertae Sedis;Kraken;";"0.0";"0";"11";"11";"0";"11";"0";"457172";"373894"
"V4mis1";"SILVA (only NR);Eukaryota;SAR;Rhizaria;Cercozoa;Incertae Sedis;Metromonas;";"0.0";"0";"1";"1";"0";"1";"0";"457182";"373894"
"V4mis1";"SILVA (only NR);Eukaryota;SAR;Rhizaria;Cercozoa;Incertae Sedis;Reticulamoeba;";"0.0";"0";"7";"7";"0";"7";"0";"457176";"373894"
"V4mis1";"SILVA (only NR);Eukaryota;SAR;Rhizaria;Cercozoa;Incertae Sedis;Sainouron;";"0.0";"0";"1";"1";"0";"1";"0";"457182";"373894"
"V4mis1";"SILVA (only NR);Eukaryota;SAR;Rhizaria;Cercozoa;Incertae Sedis;Trachyrhizium;";"0.0";"0";"1";"1";"0";"1";"0";"457182";"373894"
"V4mis1";"SILVA (only NR);Eukaryota;SAR;Rhizaria;Cercozoa;Metromonadea;";"0.0";"0";"6";"3";"0";"3";"3";"457180";"373894"
"V4mis1";"SILVA (only NR);Eukaryota;SAR;Rhizaria;Cercozoa;Metromonadea;Metopion;";"0.0";"0";"2";"1";"0";"1";"1";"457182";"373894"
"V4mis1";"SILVA (only NR);Eukaryota;SAR;Rhizaria;Cercozoa;Metromonadea;Micrometopion;";"0.0";"0";"4";"2";"0";"2";"2";"457181";"373894"
"V4mis1";"SILVA (only NR);Eukaryota;SAR;Rhizaria;Cercozoa;Novel Clade 10;";"0.0";"0";"29";"29";"0";"29";"0";"457154";"373894"
"V4mis1";"SILVA (only NR);Eukaryota;SAR;Rhizaria;Cercozoa;Novel Clade 12;";"0.0";"0";"13";"12";"0";"12";"1";"457171";"373894"
"V4mis1";"SILVA (only NR);Eukaryota;SAR;Rhizaria;Cercozoa;Novel Clade 2;";"0.0";"0";"31";"31";"0";"31";"0";"457152";"373894"
"V4mis1";"SILVA (only NR);Eukaryota;SAR;Rhizaria;Cercozoa;Novel Clade 4;";"0.0";"0";"2";"2";"0";"2";"0";"457181";"373894"
"V4mis1";"SILVA (only NR);Eukaryota;SAR;Rhizaria;Cercozoa;Novel Clade Gran-1;";"0.0";"0";"4";"4";"0";"4";"0";"457179";"373894"
"V4mis1";"SILVA (only NR);Eukaryota;SAR;Rhizaria;Cercozoa;Novel Clade Gran-3;";"0.0";"0";"18";"16";"0";"16";"2";"457167";"373894"
"V4mis1";"SILVA (only NR);Eukaryota;SAR;Rhizaria;Cercozoa;Novel Clade Gran-4;";"0.0";"0";"8";"7";"0";"7";"1";"457176";"373894"
"V4mis1";"SILVA (only NR);Eukaryota;SAR;Rhizaria;Cercozoa;Novel Clade Gran-5;";"0.0";"0";"3";"3";"0";"3";"0";"457180";"373894"
"V4mis1";"SILVA (only NR);Eukaryota;SAR;Rhizaria;Cercozoa;Novel Clade Gran-6;";"0.0";"0";"2";"2";"0";"2";"0";"457181";"373894"
"V4mis1";"SILVA (only NR);Eukaryota;SAR;Rhizaria;Cercozoa;Pansomonadida;";"0.0";"0";"1";"1";"0";"1";"0";"457182";"373894"
"V4mis1";"SILVA (only NR);Eukaryota;SAR;Rhizaria;Cercozoa;Pansomonadida;Aurigamonas;";"0.0";"0";"1";"1";"0";"1";"0";"457182";"373894"
"V4mis1";"SILVA (only NR);Eukaryota;SAR;Rhizaria;Cercozoa;Phaeocalpida;";"0.0";"0";"2";"2";"0";"2";"0";"457181";"373894"
"V4mis1";"SILVA (only NR);Eukaryota;SAR;Rhizaria;Cercozoa;Phaeocalpida;Porospathis;";"0.0";"0";"1";"1";"0";"1";"0";"457182";"373894"
"V4mis1";"SILVA (only NR);Eukaryota;SAR;Rhizaria;Cercozoa;Phaeocalpida;Tuscaretta;";"0.0";"0";"1";"1";"0";"1";"0";"457182";"373894"
"V4mis1";"SILVA (only NR);Eukaryota;SAR;Rhizaria;Cercozoa;Phaeoconchia;";"0.0";"0";"4";"4";"0";"4";"0";"457179";"373894"
"V4mis1";"SILVA (only NR);Eukaryota;SAR;Rhizaria;Cercozoa;Phaeoconchia;Coelodendrum;";"0.0";"0";"2";"2";"0";"2";"0";"457181";"373894"
"V4mis1";"SILVA (only NR);Eukaryota;SAR;Rhizaria;Cercozoa;Phaeocystina;";"0.0";"0";"3";"3";"0";"3";"0";"457180";"373894"
"V4mis1";"SILVA (only NR);Eukaryota;SAR;Rhizaria;Cercozoa;Phaeocystina;Aulacantha;";"0.0";"0";"2";"2";"0";"2";"0";"457181";"373894"
"V4mis1";"SILVA (only NR);Eukaryota;SAR;Rhizaria;Cercozoa;Phaeocystina;Auloceros;";"0.0";"0";"1";"1";"0";"1";"0";"457182";"373894"
"V4mis1";"SILVA (only NR);Eukaryota;SAR;Rhizaria;Cercozoa;Phaeogromia;";"0.0";"0";"6";"6";"0";"6";"0";"457177";"373894"
"V4mis1";"SILVA (only NR);Eukaryota;SAR;Rhizaria;Cercozoa;Phaeogromia;Challengeron;";"0.0";"0";"2";"2";"0";"2";"0";"457181";"373894"
"V4mis1";"SILVA (only NR);Eukaryota;SAR;Rhizaria;Cercozoa;Phaeogromia;Medusetta;";"0.0";"0";"1";"1";"0";"1";"0";"457182";"373894"
"V4mis1";"SILVA (only NR);Eukaryota;SAR;Rhizaria;Cercozoa;Phaeogromia;Protocystis;";"0.0";"0";"2";"2";"0";"2";"0";"457181";"373894"
"V4mis1";"SILVA (only NR);Eukaryota;SAR;Rhizaria;Cercozoa;Phytomyxea;";"0.0";"0";"49";"49";"0";"49";"0";"457134";"373894"
"V4mis1";"SILVA (only NR);Eukaryota;SAR;Rhizaria;Cercozoa;Phytomyxea;Ligniera;";"0.0";"0";"1";"1";"0";"1";"0";"457182";"373894"
"V4mis1";"SILVA (only NR);Eukaryota;SAR;Rhizaria;Cercozoa;Phytomyxea;Maullinia;";"0.0";"0";"4";"4";"0";"4";"0";"457179";"373894"
"V4mis1";"SILVA (only NR);Eukaryota;SAR;Rhizaria;Cercozoa;Phytomyxea;Phagomyxa;";"0.0";"0";"2";"2";"0";"2";"0";"457181";"373894"
"V4mis1";"SILVA (only NR);Eukaryota;SAR;Rhizaria;Cercozoa;Phytomyxea;Plasmodiophora;";"0.0";"0";"4";"4";"0";"4";"0";"457179";"373894"
"V4mis1";"SILVA (only NR);Eukaryota;SAR;Rhizaria;Cercozoa;Phytomyxea;Polymyxa;";"0.0";"0";"15";"15";"0";"15";"0";"457168";"373894"
"V4mis1";"SILVA (only NR);Eukaryota;SAR;Rhizaria;Cercozoa;Phytomyxea;Sorosphaerula;";"0.0";"0";"2";"2";"0";"2";"0";"457181";"373894"
"V4mis1";"SILVA (only NR);Eukaryota;SAR;Rhizaria;Cercozoa;Phytomyxea;Spongospora;";"0.0";"0";"3";"3";"0";"3";"0";"457180";"373894"
"V4mis1";"SILVA (only NR);Eukaryota;SAR;Rhizaria;Cercozoa;Phytomyxea;Woronina;";"0.0";"0";"2";"2";"0";"2";"0";"457181";"373894"
"V4mis1";"SILVA (only NR);Eukaryota;SAR;Rhizaria;Cercozoa;Phytomyxea;uncultured;";"0.0";"0";"9";"9";"0";"9";"0";"457174";"373894"
"V4mis1";"SILVA (only NR);Eukaryota;SAR;Rhizaria;Cercozoa;Thecofilosea;";"0.0";"0";"246";"244";"0";"244";"2";"456939";"373894"
"V4mis1";"SILVA (only NR);Eukaryota;SAR;Rhizaria;Cercozoa;Thecofilosea;Cryomonadida;";"0.0";"0";"83";"83";"0";"83";"0";"457100";"373894"
"V4mis1";"SILVA (only NR);Eukaryota;SAR;Rhizaria;Cercozoa;Thecofilosea;Cryomonadida;Protaspidae;";"0.0";"0";"41";"41";"0";"41";"0";"457142";"373894"
"V4mis1";"SILVA (only NR);Eukaryota;SAR;Rhizaria;Cercozoa;Thecofilosea;Cryomonadida;Protaspidae;Cryothecomonas;";"0.0";"0";"15";"15";"0";"15";"0";"457168";"373894"
"V4mis1";"SILVA (only NR);Eukaryota;SAR;Rhizaria;Cercozoa;Thecofilosea;Cryomonadida;Protaspidae;Protaspis;";"0.0";"0";"26";"26";"0";"26";"0";"457157";"373894"
"V4mis1";"SILVA (only NR);Eukaryota;SAR;Rhizaria;Cercozoa;Thecofilosea;Cryomonadida;Rhizaspididae;";"0.0";"0";"32";"32";"0";"32";"0";"457151";"373894"
"V4mis1";"SILVA (only NR);Eukaryota;SAR;Rhizaria;Cercozoa;Thecofilosea;Cryomonadida;Rhizaspididae;Rhogostoma;";"0.0";"0";"32";"32";"0";"32";"0";"457151";"373894"
"V4mis1";"SILVA (only NR);Eukaryota;SAR;Rhizaria;Cercozoa;Thecofilosea;Cryomonadida;Ventrifissuridae;";"0.0";"0";"10";"10";"0";"10";"0";"457173";"373894"
"V4mis1";"SILVA (only NR);Eukaryota;SAR;Rhizaria;Cercozoa;Thecofilosea;Cryomonadida;Ventrifissuridae;Ventrifissura;";"0.0";"0";"3";"3";"0";"3";"0";"457180";"373894"
"V4mis1";"SILVA (only NR);Eukaryota;SAR;Rhizaria;Cercozoa;Thecofilosea;Ebriacea;";"0.0";"0";"21";"21";"0";"21";"0";"457162";"373894"
"V4mis1";"SILVA (only NR);Eukaryota;SAR;Rhizaria;Cercozoa;Thecofilosea;Ebriacea;Ebria;";"0.0";"0";"21";"21";"0";"21";"0";"457162";"373894"
"V4mis1";"SILVA (only NR);Eukaryota;SAR;Rhizaria;Cercozoa;Thecofilosea;Incertae Sedis;";"0.0";"0";"12";"12";"0";"12";"0";"457171";"373894"
"V4mis1";"SILVA (only NR);Eukaryota;SAR;Rhizaria;Cercozoa;Thecofilosea;Incertae Sedis;Lecythium;";"0.0";"0";"10";"10";"0";"10";"0";"457173";"373894"
"V4mis1";"SILVA (only NR);Eukaryota;SAR;Rhizaria;Cercozoa;Thecofilosea;Incertae Sedis;Pseudodifflugia;";"0.0";"0";"2";"2";"0";"2";"0";"457181";"373894"
"V4mis1";"SILVA (only NR);Eukaryota;SAR;Rhizaria;Cercozoa;Thecofilosea;Phaeosphaerida;";"0.0";"0";"3";"3";"0";"3";"0";"457180";"373894"
"V4mis1";"SILVA (only NR);Eukaryota;SAR;Rhizaria;Cercozoa;Thecofilosea;Phaeosphaerida;Aulosphaera;";"0.0";"0";"3";"3";"0";"3";"0";"457180";"373894"
"V4mis1";"SILVA (only NR);Eukaryota;SAR;Rhizaria;Cercozoa;Thecofilosea;uncultured;";"0.0";"0";"116";"114";"0";"114";"2";"457069";"373894"
"V4mis1";"SILVA (only NR);Eukaryota;SAR;Rhizaria;Cercozoa;Vampyrellidae;";"0.0";"0";"87";"87";"0";"87";"0";"457096";"373894"
"V4mis1";"SILVA (only NR);Eukaryota;SAR;Rhizaria;Cercozoa;Vampyrellidae;Arachnula;";"0.0";"0";"1";"1";"0";"1";"0";"457182";"373894"
"V4mis1";"SILVA (only NR);Eukaryota;SAR;Rhizaria;Cercozoa;Vampyrellidae;Leptophrys;";"0.0";"0";"3";"3";"0";"3";"0";"457180";"373894"
"V4mis1";"SILVA (only NR);Eukaryota;SAR;Rhizaria;Cercozoa;Vampyrellidae;Vampyrella;";"0.0";"0";"3";"3";"0";"3";"0";"457180";"373894"
"V4mis1";"SILVA (only NR);Eukaryota;SAR;Rhizaria;Cercozoa;Vampyrellidae;uncultured;";"0.0";"0";"31";"31";"0";"31";"0";"457152";"373894"
"V4mis1";"SILVA (only NR);Eukaryota;SAR;Rhizaria;Cercozoa;uncultured;";"0.0";"0";"127";"114";"0";"114";"13";"457069";"373894"
"V4mis1";"SILVA (only NR);Eukaryota;SAR;Rhizaria;Retaria;";"2.6";"18.1";"1148";"961";"25";"936";"187";"456222";"373869"
"V4mis1";"SILVA (only NR);Eukaryota;SAR;Rhizaria;Retaria;Acantharia;";"0.0";"0";"120";"116";"0";"116";"4";"457067";"373894"
"V4mis1";"SILVA (only NR);Eukaryota;SAR;Rhizaria;Retaria;Acantharia;Acantharea Group I;";"0.0";"0";"36";"36";"0";"36";"0";"457147";"373894"
"V4mis1";"SILVA (only NR);Eukaryota;SAR;Rhizaria;Retaria;Acantharia;Acantharea Group II;";"0.0";"0";"11";"11";"0";"11";"0";"457172";"373894"
"V4mis1";"SILVA (only NR);Eukaryota;SAR;Rhizaria;Retaria;Acantharia;Acantharea Group VI;";"0.0";"0";"7";"7";"0";"7";"0";"457176";"373894"
"V4mis1";"SILVA (only NR);Eukaryota;SAR;Rhizaria;Retaria;Acantharia;Arthracanthida;";"0.0";"0";"21";"20";"0";"20";"1";"457163";"373894"
"V4mis1";"SILVA (only NR);Eukaryota;SAR;Rhizaria;Retaria;Acantharia;Arthracanthida;Acanthostaurus;";"0.0";"0";"1";"1";"0";"1";"0";"457182";"373894"
"V4mis1";"SILVA (only NR);Eukaryota;SAR;Rhizaria;Retaria;Acantharia;Arthracanthida;Amphilonche;";"0.0";"0";"1";"1";"0";"1";"0";"457182";"373894"
"V4mis1";"SILVA (only NR);Eukaryota;SAR;Rhizaria;Retaria;Acantharia;Arthracanthida;Hexaconus;";"0.0";"0";"3";"3";"0";"3";"0";"457180";"373894"
"V4mis1";"SILVA (only NR);Eukaryota;SAR;Rhizaria;Retaria;Acantharia;Arthracanthida;Phyllostaurus;";"0.0";"0";"6";"5";"0";"5";"1";"457178";"373894"
"V4mis1";"SILVA (only NR);Eukaryota;SAR;Rhizaria;Retaria;Acantharia;Arthracanthida;uncultured;";"0.0";"0";"4";"4";"0";"4";"0";"457179";"373894"
"V4mis1";"SILVA (only NR);Eukaryota;SAR;Rhizaria;Retaria;Acantharia;Chaunocanthida;";"0.0";"0";"22";"20";"0";"20";"2";"457163";"373894"
"V4mis1";"SILVA (only NR);Eukaryota;SAR;Rhizaria;Retaria;Acantharia;Chaunocanthida;Acanthocyrta;";"0.0";"0";"1";"1";"0";"1";"0";"457182";"373894"
"V4mis1";"SILVA (only NR);Eukaryota;SAR;Rhizaria;Retaria;Acantharia;Chaunocanthida;Amphiacon;";"0.0";"0";"3";"3";"0";"3";"0";"457180";"373894"
"V4mis1";"SILVA (only NR);Eukaryota;SAR;Rhizaria;Retaria;Acantharia;Chaunocanthida;Heteracon;";"0.0";"0";"1";"1";"0";"1";"0";"457182";"373894"
"V4mis1";"SILVA (only NR);Eukaryota;SAR;Rhizaria;Retaria;Acantharia;Holocanthida;";"0.0";"0";"4";"4";"0";"4";"0";"457179";"373894"
"V4mis1";"SILVA (only NR);Eukaryota;SAR;Rhizaria;Retaria;Acantharia;Holocanthida;Acanthocolla;";"0.0";"0";"1";"1";"0";"1";"0";"457182";"373894"
"V4mis1";"SILVA (only NR);Eukaryota;SAR;Rhizaria;Retaria;Acantharia;Holocanthida;Trizona;";"0.0";"0";"1";"1";"0";"1";"0";"457182";"373894"
"V4mis1";"SILVA (only NR);Eukaryota;SAR;Rhizaria;Retaria;Acantharia;SSRPB68;";"0.0";"0";"7";"6";"0";"6";"1";"457177";"373894"
"V4mis1";"SILVA (only NR);Eukaryota;SAR;Rhizaria;Retaria;Acantharia;Symphyacanthida;";"0.0";"0";"2";"2";"0";"2";"0";"457181";"373894"
"V4mis1";"SILVA (only NR);Eukaryota;SAR;Rhizaria;Retaria;Acantharia;Symphyacanthida;Amphibelone;";"0.0";"0";"2";"2";"0";"2";"0";"457181";"373894"
"V4mis1";"SILVA (only NR);Eukaryota;SAR;Rhizaria;Retaria;Acantharia;uncultured;";"0.0";"0";"4";"4";"0";"4";"0";"457179";"373894"
"V4mis1";"SILVA (only NR);Eukaryota;SAR;Rhizaria;Retaria;Foraminifera;";"39.1";"18.2";"67";"64";"25";"39";"3";"457119";"373869"
"V4mis1";"SILVA (only NR);Eukaryota;SAR;Rhizaria;Retaria;Foraminifera;Globothalamea;";"0.0";"0";"37";"34";"0";"34";"3";"457149";"373894"
"V4mis1";"SILVA (only NR);Eukaryota;SAR;Rhizaria;Retaria;Foraminifera;Globothalamea;Rotaliida;";"0.0";"0";"37";"34";"0";"34";"3";"457149";"373894"
"V4mis1";"SILVA (only NR);Eukaryota;SAR;Rhizaria;Retaria;Foraminifera;Globothalamea;Rotaliida;Alabaminidae;";"0.0";"0";"1";"1";"0";"1";"0";"457182";"373894"
"V4mis1";"SILVA (only NR);Eukaryota;SAR;Rhizaria;Retaria;Foraminifera;Globothalamea;Rotaliida;Alabaminidae;Oridorsalis;";"0.0";"0";"1";"1";"0";"1";"0";"457182";"373894"
"V4mis1";"SILVA (only NR);Eukaryota;SAR;Rhizaria;Retaria;Foraminifera;Globothalamea;Rotaliida;Buliminidae;";"0.0";"0";"2";"1";"0";"1";"1";"457182";"373894"
"V4mis1";"SILVA (only NR);Eukaryota;SAR;Rhizaria;Retaria;Foraminifera;Globothalamea;Rotaliida;Buliminidae;Bulimina;";"0.0";"0";"1";"1";"0";"1";"0";"457182";"373894"
"V4mis1";"SILVA (only NR);Eukaryota;SAR;Rhizaria;Retaria;Foraminifera;Globothalamea;Rotaliida;Buliminidae;Globobulimina;";"0.0";"0";"1";"0";"0";"0";"1";"457183";"373894"
"V4mis1";"SILVA (only NR);Eukaryota;SAR;Rhizaria;Retaria;Foraminifera;Globothalamea;Rotaliida;Calcarinidae;";"0.0";"0";"3";"3";"0";"3";"0";"457180";"373894"
"V4mis1";"SILVA (only NR);Eukaryota;SAR;Rhizaria;Retaria;Foraminifera;Globothalamea;Rotaliida;Calcarinidae;Calcarina;";"0.0";"0";"2";"2";"0";"2";"0";"457181";"373894"
"V4mis1";"SILVA (only NR);Eukaryota;SAR;Rhizaria;Retaria;Foraminifera;Globothalamea;Rotaliida;Calcarinidae;Schlumbergerella;";"0.0";"0";"1";"1";"0";"1";"0";"457182";"373894"
"V4mis1";"SILVA (only NR);Eukaryota;SAR;Rhizaria;Retaria;Foraminifera;Globothalamea;Rotaliida;Cibicididae;";"0.0";"0";"5";"4";"0";"4";"1";"457179";"373894"
"V4mis1";"SILVA (only NR);Eukaryota;SAR;Rhizaria;Retaria;Foraminifera;Globothalamea;Rotaliida;Cibicididae;Cibicides;";"0.0";"0";"2";"1";"0";"1";"1";"457182";"373894"
"V4mis1";"SILVA (only NR);Eukaryota;SAR;Rhizaria;Retaria;Foraminifera;Globothalamea;Rotaliida;Cibicididae;Cibicidoides;";"0.0";"0";"3";"3";"0";"3";"0";"457180";"373894"
"V4mis1";"SILVA (only NR);Eukaryota;SAR;Rhizaria;Retaria;Foraminifera;Globothalamea;Rotaliida;Elphidiidae;";"0.0";"0";"4";"3";"0";"3";"1";"457180";"373894"
"V4mis1";"SILVA (only NR);Eukaryota;SAR;Rhizaria;Retaria;Foraminifera;Globothalamea;Rotaliida;Elphidiidae;Elphidium;";"0.0";"0";"4";"3";"0";"3";"1";"457180";"373894"
"V4mis1";"SILVA (only NR);Eukaryota;SAR;Rhizaria;Retaria;Foraminifera;Globothalamea;Rotaliida;Nonionidae;";"0.0";"0";"3";"3";"0";"3";"0";"457180";"373894"
"V4mis1";"SILVA (only NR);Eukaryota;SAR;Rhizaria;Retaria;Foraminifera;Globothalamea;Rotaliida;Nonionidae;Haynesina;";"0.0";"0";"1";"1";"0";"1";"0";"457182";"373894"
"V4mis1";"SILVA (only NR);Eukaryota;SAR;Rhizaria;Retaria;Foraminifera;Globothalamea;Rotaliida;Nonionidae;Pullenia;";"0.0";"0";"2";"2";"0";"2";"0";"457181";"373894"
"V4mis1";"SILVA (only NR);Eukaryota;SAR;Rhizaria;Retaria;Foraminifera;Globothalamea;Rotaliida;Nummulitidae;";"0.0";"0";"9";"9";"0";"9";"0";"457174";"373894"
"V4mis1";"SILVA (only NR);Eukaryota;SAR;Rhizaria;Retaria;Foraminifera;Globothalamea;Rotaliida;Nummulitidae;Cycloclypeus;";"0.0";"0";"1";"1";"0";"1";"0";"457182";"373894"
"V4mis1";"SILVA (only NR);Eukaryota;SAR;Rhizaria;Retaria;Foraminifera;Globothalamea;Rotaliida;Nummulitidae;Heterostegina;";"0.0";"0";"1";"1";"0";"1";"0";"457182";"373894"
"V4mis1";"SILVA (only NR);Eukaryota;SAR;Rhizaria;Retaria;Foraminifera;Globothalamea;Rotaliida;Nummulitidae;Nummulites;";"0.0";"0";"1";"1";"0";"1";"0";"457182";"373894"
"V4mis1";"SILVA (only NR);Eukaryota;SAR;Rhizaria;Retaria;Foraminifera;Globothalamea;Rotaliida;Nummulitidae;Operculina;";"0.0";"0";"5";"5";"0";"5";"0";"457178";"373894"
"V4mis1";"SILVA (only NR);Eukaryota;SAR;Rhizaria;Retaria;Foraminifera;Globothalamea;Rotaliida;Nummulitidae;Planoperculina;";"0.0";"0";"1";"1";"0";"1";"0";"457182";"373894"
"V4mis1";"SILVA (only NR);Eukaryota;SAR;Rhizaria;Retaria;Foraminifera;Globothalamea;Rotaliida;Pseudoparrellidae;";"0.0";"0";"2";"2";"0";"2";"0";"457181";"373894"
"V4mis1";"SILVA (only NR);Eukaryota;SAR;Rhizaria;Retaria;Foraminifera;Globothalamea;Rotaliida;Pseudoparrellidae;Epistominella;";"0.0";"0";"2";"2";"0";"2";"0";"457181";"373894"
"V4mis1";"SILVA (only NR);Eukaryota;SAR;Rhizaria;Retaria;Foraminifera;Globothalamea;Rotaliida;Rotaliidae;";"0.0";"0";"3";"3";"0";"3";"0";"457180";"373894"
"V4mis1";"SILVA (only NR);Eukaryota;SAR;Rhizaria;Retaria;Foraminifera;Globothalamea;Rotaliida;Rotaliidae;Ammonia;";"0.0";"0";"2";"2";"0";"2";"0";"457181";"373894"
"V4mis1";"SILVA (only NR);Eukaryota;SAR;Rhizaria;Retaria;Foraminifera;Globothalamea;Rotaliida;Rotaliidae;Pararotalia;";"0.0";"0";"1";"1";"0";"1";"0";"457182";"373894"
"V4mis1";"SILVA (only NR);Eukaryota;SAR;Rhizaria;Retaria;Foraminifera;Globothalamea;Rotaliida;Stainforthiidae;";"0.0";"0";"2";"2";"0";"2";"0";"457181";"373894"
"V4mis1";"SILVA (only NR);Eukaryota;SAR;Rhizaria;Retaria;Foraminifera;Globothalamea;Rotaliida;Stainforthiidae;Stainforthia;";"0.0";"0";"2";"2";"0";"2";"0";"457181";"373894"
"V4mis1";"SILVA (only NR);Eukaryota;SAR;Rhizaria;Retaria;Foraminifera;Tubothalamea;";"83.3";"18.2";"30";"30";"25";"5";"0";"457153";"373869"
"V4mis1";"SILVA (only NR);Eukaryota;SAR;Rhizaria;Retaria;Foraminifera;Tubothalamea;Miliolida;";"83.3";"18.2";"30";"30";"25";"5";"0";"457153";"373869"
"V4mis1";"SILVA (only NR);Eukaryota;SAR;Rhizaria;Retaria;Foraminifera;Tubothalamea;Miliolida;Amphisorus;";"100.0";"18.2";"6";"6";"6";"0";"0";"457177";"373888"
"V4mis1";"SILVA (only NR);Eukaryota;SAR;Rhizaria;Retaria;Foraminifera;Tubothalamea;Miliolida;Androsina;";"0.0";"0";"1";"1";"0";"1";"0";"457182";"373894"
"V4mis1";"SILVA (only NR);Eukaryota;SAR;Rhizaria;Retaria;Foraminifera;Tubothalamea;Miliolida;Archaias;";"50.0";"18.2";"2";"2";"1";"1";"0";"457181";"373893"
"V4mis1";"SILVA (only NR);Eukaryota;SAR;Rhizaria;Retaria;Foraminifera;Tubothalamea;Miliolida;Cyclorbiculina;";"100.0";"18.2";"1";"1";"1";"0";"0";"457182";"373893"
"V4mis1";"SILVA (only NR);Eukaryota;SAR;Rhizaria;Retaria;Foraminifera;Tubothalamea;Miliolida;Dendritina;";"100.0";"18.2";"1";"1";"1";"0";"0";"457182";"373893"
"V4mis1";"SILVA (only NR);Eukaryota;SAR;Rhizaria;Retaria;Foraminifera;Tubothalamea;Miliolida;Laevipeneroplis;";"66.7";"18.2";"3";"3";"2";"1";"0";"457180";"373892"
"V4mis1";"SILVA (only NR);Eukaryota;SAR;Rhizaria;Retaria;Foraminifera;Tubothalamea;Miliolida;Marginopora;";"100.0";"18.2";"4";"4";"4";"0";"0";"457179";"373890"
"V4mis1";"SILVA (only NR);Eukaryota;SAR;Rhizaria;Retaria;Foraminifera;Tubothalamea;Miliolida;Sorites;";"87.5";"18.2";"8";"8";"7";"1";"0";"457175";"373887"
"V4mis1";"SILVA (only NR);Eukaryota;SAR;Rhizaria;Retaria;Polycystinea;";"0.0";"0";"713";"551";"0";"551";"162";"456632";"373894"
"V4mis1";"SILVA (only NR);Eukaryota;SAR;Rhizaria;Retaria;Polycystinea;Collodaria;";"0.0";"0";"71";"55";"0";"55";"16";"457128";"373894"
"V4mis1";"SILVA (only NR);Eukaryota;SAR;Rhizaria;Retaria;Polycystinea;Collodaria;AT8-54;";"0.0";"0";"15";"7";"0";"7";"8";"457176";"373894"
"V4mis1";"SILVA (only NR);Eukaryota;SAR;Rhizaria;Retaria;Polycystinea;Collodaria;Collophidium;";"0.0";"0";"8";"5";"0";"5";"3";"457178";"373894"
"V4mis1";"SILVA (only NR);Eukaryota;SAR;Rhizaria;Retaria;Polycystinea;Collodaria;Collosphaera;";"0.0";"0";"6";"6";"0";"6";"0";"457177";"373894"
"V4mis1";"SILVA (only NR);Eukaryota;SAR;Rhizaria;Retaria;Polycystinea;Collodaria;Collozoum;";"0.0";"0";"9";"9";"0";"9";"0";"457174";"373894"
"V4mis1";"SILVA (only NR);Eukaryota;SAR;Rhizaria;Retaria;Polycystinea;Collodaria;Disolenia;";"0.0";"0";"3";"3";"0";"3";"0";"457180";"373894"
"V4mis1";"SILVA (only NR);Eukaryota;SAR;Rhizaria;Retaria;Polycystinea;Collodaria;E84;";"0.0";"0";"4";"1";"0";"1";"3";"457182";"373894"
"V4mis1";"SILVA (only NR);Eukaryota;SAR;Rhizaria;Retaria;Polycystinea;Collodaria;Rhaphidozoum;";"0.0";"0";"2";"2";"0";"2";"0";"457181";"373894"
"V4mis1";"SILVA (only NR);Eukaryota;SAR;Rhizaria;Retaria;Polycystinea;Collodaria;Siphonosphaera;";"0.0";"0";"6";"5";"0";"5";"1";"457178";"373894"
"V4mis1";"SILVA (only NR);Eukaryota;SAR;Rhizaria;Retaria;Polycystinea;Collodaria;Sphaerozoum;";"0.0";"0";"3";"3";"0";"3";"0";"457180";"373894"
"V4mis1";"SILVA (only NR);Eukaryota;SAR;Rhizaria;Retaria;Polycystinea;Collodaria;Thalassicolla;";"0.0";"0";"4";"4";"0";"4";"0";"457179";"373894"
"V4mis1";"SILVA (only NR);Eukaryota;SAR;Rhizaria;Retaria;Polycystinea;Nassellaria;";"0.0";"0";"40";"38";"0";"38";"2";"457145";"373894"
"V4mis1";"SILVA (only NR);Eukaryota;SAR;Rhizaria;Retaria;Polycystinea;Nassellaria;Asp-05;";"0.0";"0";"2";"2";"0";"2";"0";"457181";"373894"
"V4mis1";"SILVA (only NR);Eukaryota;SAR;Rhizaria;Retaria;Polycystinea;Nassellaria;Ceratospyris;";"0.0";"0";"10";"9";"0";"9";"1";"457174";"373894"
"V4mis1";"SILVA (only NR);Eukaryota;SAR;Rhizaria;Retaria;Polycystinea;Nassellaria;Eucyrtidium;";"0.0";"0";"3";"3";"0";"3";"0";"457180";"373894"
"V4mis1";"SILVA (only NR);Eukaryota;SAR;Rhizaria;Retaria;Polycystinea;Nassellaria;Pseudocubus;";"0.0";"0";"15";"14";"0";"14";"1";"457169";"373894"
"V4mis1";"SILVA (only NR);Eukaryota;SAR;Rhizaria;Retaria;Polycystinea;Nassellaria;Pterocanium;";"0.0";"0";"1";"1";"0";"1";"0";"457182";"373894"
"V4mis1";"SILVA (only NR);Eukaryota;SAR;Rhizaria;Retaria;Polycystinea;Nassellaria;Pterocorys;";"0.0";"0";"4";"4";"0";"4";"0";"457179";"373894"
"V4mis1";"SILVA (only NR);Eukaryota;SAR;Rhizaria;Retaria;Polycystinea;Spumellaria;";"0.0";"0";"598";"454";"0";"454";"144";"456729";"373894"
"V4mis1";"SILVA (only NR);Eukaryota;SAR;Rhizaria;Retaria;Polycystinea;Spumellaria;Actinomma;";"0.0";"0";"8";"7";"0";"7";"1";"457176";"373894"
"V4mis1";"SILVA (only NR);Eukaryota;SAR;Rhizaria;Retaria;Polycystinea;Spumellaria;Astrosphaera;";"0.0";"0";"17";"17";"0";"17";"0";"457166";"373894"
"V4mis1";"SILVA (only NR);Eukaryota;SAR;Rhizaria;Retaria;Polycystinea;Spumellaria;Cladococcus;";"0.0";"0";"111";"110";"0";"110";"1";"457073";"373894"
"V4mis1";"SILVA (only NR);Eukaryota;SAR;Rhizaria;Retaria;Polycystinea;Spumellaria;Dictyocoryne;";"0.0";"0";"2";"2";"0";"2";"0";"457181";"373894"
"V4mis1";"SILVA (only NR);Eukaryota;SAR;Rhizaria;Retaria;Polycystinea;Spumellaria;Didymocyrtis;";"0.0";"0";"1";"1";"0";"1";"0";"457182";"373894"
"V4mis1";"SILVA (only NR);Eukaryota;SAR;Rhizaria;Retaria;Polycystinea;Spumellaria;Hexacontium;";"0.0";"0";"10";"4";"0";"4";"6";"457179";"373894"
"V4mis1";"SILVA (only NR);Eukaryota;SAR;Rhizaria;Retaria;Polycystinea;Spumellaria;Larcopyle;";"0.0";"0";"2";"2";"0";"2";"0";"457181";"373894"
"V4mis1";"SILVA (only NR);Eukaryota;SAR;Rhizaria;Retaria;Polycystinea;Spumellaria;Phorticium;";"0.0";"0";"1";"1";"0";"1";"0";"457182";"373894"
"V4mis1";"SILVA (only NR);Eukaryota;SAR;Rhizaria;Retaria;Polycystinea;Spumellaria;Rhizosphaera;";"0.0";"0";"11";"10";"0";"10";"1";"457173";"373894"
"V4mis1";"SILVA (only NR);Eukaryota;SAR;Rhizaria;Retaria;Polycystinea;Spumellaria;Spongocore;";"0.0";"0";"1";"1";"0";"1";"0";"457182";"373894"
"V4mis1";"SILVA (only NR);Eukaryota;SAR;Rhizaria;Retaria;Polycystinea;Spumellaria;Spongodiscus;";"0.0";"0";"2";"2";"0";"2";"0";"457181";"373894"
"V4mis1";"SILVA (only NR);Eukaryota;SAR;Rhizaria;Retaria;Polycystinea;Spumellaria;Spongopyle;";"0.0";"0";"1";"1";"0";"1";"0";"457182";"373894"
"V4mis1";"SILVA (only NR);Eukaryota;SAR;Rhizaria;Retaria;Polycystinea;Spumellaria;Spongotrochus;";"0.0";"0";"3";"3";"0";"3";"0";"457180";"373894"
"V4mis1";"SILVA (only NR);Eukaryota;SAR;Rhizaria;Retaria;Polycystinea;Spumellaria;Streblacantha;";"0.0";"0";"1";"1";"0";"1";"0";"457182";"373894"
"V4mis1";"SILVA (only NR);Eukaryota;SAR;Rhizaria;Retaria;Polycystinea;Spumellaria;Stylochlamydium;";"0.0";"0";"2";"2";"0";"2";"0";"457181";"373894"
"V4mis1";"SILVA (only NR);Eukaryota;SAR;Rhizaria;Retaria;Polycystinea;Spumellaria;Stylodictya;";"0.0";"0";"1";"1";"0";"1";"0";"457182";"373894"
"V4mis1";"SILVA (only NR);Eukaryota;SAR;Rhizaria;Retaria;Polycystinea;Spumellaria;Tetrapyle;";"0.0";"0";"2";"2";"0";"2";"0";"457181";"373894"
"V4mis1";"SILVA (only NR);Eukaryota;SAR;Rhizaria;Retaria;Polycystinea;Spumellaria;Triastrum;";"0.0";"0";"14";"13";"0";"13";"1";"457170";"373894"
"V4mis1";"SILVA (only NR);Eukaryota;SAR;Rhizaria;Retaria;Polycystinea;Spumellaria;uncultured;";"0.0";"0";"385";"255";"0";"255";"130";"456928";"373894"
"V4mis1";"SILVA (only NR);Eukaryota;SAR;Rhizaria;Retaria;RAD A;";"0.0";"0";"47";"40";"0";"40";"7";"457143";"373894"
"V4mis1";"SILVA (only NR);Eukaryota;SAR;Rhizaria;Retaria;RAD B;";"0.0";"0";"177";"167";"0";"167";"10";"457016";"373894"
"V4mis1";"SILVA (only NR);Eukaryota;SAR;Rhizaria;Retaria;RAD C;";"0.0";"0";"19";"18";"0";"18";"1";"457165";"373894"
"V4mis1";"SILVA (only NR);Eukaryota;SAR;Rhizaria;Retaria;uncultured;";"0.0";"0";"4";"4";"0";"4";"0";"457179";"373894"
"V4mis1";"SILVA (only NR);Eukaryota;SAR;Stramenopiles;";"12.1";"17.7";"3556";"3386";"411";"2975";"170";"453797";"373483"
"V4mis1";"SILVA (only NR);Eukaryota;SAR;Stramenopiles;Bicosoecida;";"89.0";"18.2";"143";"136";"121";"15";"7";"457047";"373773"
"V4mis1";"SILVA (only NR);Eukaryota;SAR;Stramenopiles;Bicosoecida;Adriamonas;";"100.0";"18.2";"1";"1";"1";"0";"0";"457182";"373893"
"V4mis1";"SILVA (only NR);Eukaryota;SAR;Stramenopiles;Bicosoecida;Bicosoeca;";"88.9";"18.2";"27";"27";"24";"3";"0";"457156";"373870"
"V4mis1";"SILVA (only NR);Eukaryota;SAR;Stramenopiles;Bicosoecida;CH1-2B-3;";"93.8";"18.2";"16";"16";"15";"1";"0";"457167";"373879"
"V4mis1";"SILVA (only NR);Eukaryota;SAR;Stramenopiles;Bicosoecida;Caecitellus;";"100.0";"18.2";"10";"10";"10";"0";"0";"457173";"373884"
"V4mis1";"SILVA (only NR);Eukaryota;SAR;Stramenopiles;Bicosoecida;Cafeteria;";"50.0";"18.2";"13";"12";"6";"6";"1";"457171";"373888"
"V4mis1";"SILVA (only NR);Eukaryota;SAR;Stramenopiles;Bicosoecida;Halocafeteria;";"92.3";"18.2";"13";"13";"12";"1";"0";"457170";"373882"
"V4mis1";"SILVA (only NR);Eukaryota;SAR;Stramenopiles;Bicosoecida;K4;";"100.0";"18.2";"3";"3";"3";"0";"0";"457180";"373891"
"V4mis1";"SILVA (only NR);Eukaryota;SAR;Stramenopiles;Bicosoecida;LG08-10;";"94.7";"18.2";"19";"19";"18";"1";"0";"457164";"373876"
"V4mis1";"SILVA (only NR);Eukaryota;SAR;Stramenopiles;Bicosoecida;P34.6;";"100.0";"18.2";"3";"3";"3";"0";"0";"457180";"373891"
"V4mis1";"SILVA (only NR);Eukaryota;SAR;Stramenopiles;Bicosoecida;Paramonas;";"100.0";"18.2";"2";"2";"2";"0";"0";"457181";"373892"
"V4mis1";"SILVA (only NR);Eukaryota;SAR;Stramenopiles;Bicosoecida;Pseudobodo;";"100.0";"18.2";"5";"5";"5";"0";"0";"457178";"373889"
"V4mis1";"SILVA (only NR);Eukaryota;SAR;Stramenopiles;Bicosoecida;Rictus;";"50.0";"18.2";"2";"2";"1";"1";"0";"457181";"373893"
"V4mis1";"SILVA (only NR);Eukaryota;SAR;Stramenopiles;Bicosoecida;Siluania;";"100.0";"18.2";"1";"1";"1";"0";"0";"457182";"373893"
"V4mis1";"SILVA (only NR);Eukaryota;SAR;Stramenopiles;Bicosoecida;uncultured;";"75.0";"18.2";"13";"8";"6";"2";"5";"457175";"373888"
"V4mis1";"SILVA (only NR);Eukaryota;SAR;Stramenopiles;Hyphochytriomycetes;";"0.0";"0";"7";"7";"0";"7";"0";"457176";"373894"
"V4mis1";"SILVA (only NR);Eukaryota;SAR;Stramenopiles;Hyphochytriomycetes;Hyphochytriales;";"0.0";"0";"7";"7";"0";"7";"0";"457176";"373894"
"V4mis1";"SILVA (only NR);Eukaryota;SAR;Stramenopiles;Hyphochytriomycetes;Hyphochytriales;Hyphochytrium;";"0.0";"0";"1";"1";"0";"1";"0";"457182";"373894"
"V4mis1";"SILVA (only NR);Eukaryota;SAR;Stramenopiles;Hyphochytriomycetes;Hyphochytriales;Rhizidiomyces;";"0.0";"0";"1";"1";"0";"1";"0";"457182";"373894"
"V4mis1";"SILVA (only NR);Eukaryota;SAR;Stramenopiles;Incertae Sedis;";"51.5";"18.2";"101";"99";"51";"48";"2";"457084";"373843"
"V4mis1";"SILVA (only NR);Eukaryota;SAR;Stramenopiles;Incertae Sedis;Blastocystis;";"65.4";"18.2";"80";"78";"51";"27";"2";"457105";"373843"
"V4mis1";"SILVA (only NR);Eukaryota;SAR;Stramenopiles;Incertae Sedis;Cantina;";"0.0";"0";"1";"1";"0";"1";"0";"457182";"373894"
"V4mis1";"SILVA (only NR);Eukaryota;SAR;Stramenopiles;Incertae Sedis;Developayella;";"0.0";"0";"2";"2";"0";"2";"0";"457181";"373894"
"V4mis1";"SILVA (only NR);Eukaryota;SAR;Stramenopiles;Incertae Sedis;Develorapax;";"0.0";"0";"1";"1";"0";"1";"0";"457182";"373894"
"V4mis1";"SILVA (only NR);Eukaryota;SAR;Stramenopiles;Incertae Sedis;Pirsonia;";"0.0";"0";"16";"16";"0";"16";"0";"457167";"373894"
"V4mis1";"SILVA (only NR);Eukaryota;SAR;Stramenopiles;Labyrinthulomycetes;";"5.9";"18.2";"392";"371";"22";"349";"21";"456812";"373872"
"V4mis1";"SILVA (only NR);Eukaryota;SAR;Stramenopiles;Labyrinthulomycetes;Amphitraemidae;";"0.0";"0";"9";"9";"0";"9";"0";"457174";"373894"
"V4mis1";"SILVA (only NR);Eukaryota;SAR;Stramenopiles;Labyrinthulomycetes;Amphitraemidae;Amphitrema;";"0.0";"0";"1";"1";"0";"1";"0";"457182";"373894"
"V4mis1";"SILVA (only NR);Eukaryota;SAR;Stramenopiles;Labyrinthulomycetes;Amphitraemidae;Archerella;";"0.0";"0";"1";"1";"0";"1";"0";"457182";"373894"
"V4mis1";"SILVA (only NR);Eukaryota;SAR;Stramenopiles;Labyrinthulomycetes;Incertae Sedis;";"0.0";"0";"1";"1";"0";"1";"0";"457182";"373894"
"V4mis1";"SILVA (only NR);Eukaryota;SAR;Stramenopiles;Labyrinthulomycetes;Incertae Sedis;Stellarchytrium;";"0.0";"0";"1";"1";"0";"1";"0";"457182";"373894"
"V4mis1";"SILVA (only NR);Eukaryota;SAR;Stramenopiles;Labyrinthulomycetes;Labyrinthulaceae;";"0.0";"0";"21";"21";"0";"21";"0";"457162";"373894"
"V4mis1";"SILVA (only NR);Eukaryota;SAR;Stramenopiles;Labyrinthulomycetes;Labyrinthulaceae;Labyrinthula;";"0.0";"0";"21";"21";"0";"21";"0";"457162";"373894"
"V4mis1";"SILVA (only NR);Eukaryota;SAR;Stramenopiles;Labyrinthulomycetes;Thraustochytriaceae;";"6.9";"18.2";"268";"260";"18";"242";"8";"456923";"373876"
"V4mis1";"SILVA (only NR);Eukaryota;SAR;Stramenopiles;Labyrinthulomycetes;Thraustochytriaceae;Aplanochytrium;";"0.0";"0";"44";"38";"0";"38";"6";"457145";"373894"
"V4mis1";"SILVA (only NR);Eukaryota;SAR;Stramenopiles;Labyrinthulomycetes;Thraustochytriaceae;Aurantiochytrium;";"2.8";"18.2";"36";"36";"1";"35";"0";"457147";"373893"
"V4mis1";"SILVA (only NR);Eukaryota;SAR;Stramenopiles;Labyrinthulomycetes;Thraustochytriaceae;Labyrinthuloides;";"0.0";"0";"7";"7";"0";"7";"0";"457176";"373894"
"V4mis1";"SILVA (only NR);Eukaryota;SAR;Stramenopiles;Labyrinthulomycetes;Thraustochytriaceae;Monorhizochytrium;";"0.0";"0";"1";"1";"0";"1";"0";"457182";"373894"
"V4mis1";"SILVA (only NR);Eukaryota;SAR;Stramenopiles;Labyrinthulomycetes;Thraustochytriaceae;Oblongichytrium;";"0.0";"0";"1";"1";"0";"1";"0";"457182";"373894"
"V4mis1";"SILVA (only NR);Eukaryota;SAR;Stramenopiles;Labyrinthulomycetes;Thraustochytriaceae;Parietichytrium;";"0.0";"0";"14";"14";"0";"14";"0";"457169";"373894"
"V4mis1";"SILVA (only NR);Eukaryota;SAR;Stramenopiles;Labyrinthulomycetes;Thraustochytriaceae;Schizochytrium;";"76.9";"18.2";"13";"13";"10";"3";"0";"457170";"373884"
"V4mis1";"SILVA (only NR);Eukaryota;SAR;Stramenopiles;Labyrinthulomycetes;Thraustochytriaceae;Sicyoidochytrium;";"100.0";"18.2";"6";"6";"6";"0";"0";"457177";"373888"
"V4mis1";"SILVA (only NR);Eukaryota;SAR;Stramenopiles;Labyrinthulomycetes;Thraustochytriaceae;Thraustochytrium;";"0.0";"0";"90";"90";"0";"90";"0";"457093";"373894"
"V4mis1";"SILVA (only NR);Eukaryota;SAR;Stramenopiles;Labyrinthulomycetes;Thraustochytriaceae;Ulkenia;";"0.0";"0";"13";"13";"0";"13";"0";"457170";"373894"
"V4mis1";"SILVA (only NR);Eukaryota;SAR;Stramenopiles;Labyrinthulomycetes;Thraustochytriaceae;uncultured;";"4.0";"18.2";"27";"25";"1";"24";"2";"457158";"373893"
"V4mis1";"SILVA (only NR);Eukaryota;SAR;Stramenopiles;Labyrinthulomycetes;uncultured;";"5.5";"18.2";"85";"73";"4";"69";"12";"457110";"373890"
"V4mis1";"SILVA (only NR);Eukaryota;SAR;Stramenopiles;MAST-11;";"0.0";"0";"5";"5";"0";"5";"0";"457178";"373894"
"V4mis1";"SILVA (only NR);Eukaryota;SAR;Stramenopiles;MAST-12;";"89.5";"18.2";"40";"38";"34";"4";"2";"457145";"373860"
"V4mis1";"SILVA (only NR);Eukaryota;SAR;Stramenopiles;MAST-12;MAST-12A;";"90.9";"18.2";"11";"11";"10";"1";"0";"457172";"373884"
"V4mis1";"SILVA (only NR);Eukaryota;SAR;Stramenopiles;MAST-12;MAST-12B;";"66.7";"18.2";"3";"3";"2";"1";"0";"457180";"373892"
"V4mis1";"SILVA (only NR);Eukaryota;SAR;Stramenopiles;MAST-12;MAST-12C;";"100.0";"18.2";"11";"11";"11";"0";"0";"457172";"373883"
"V4mis1";"SILVA (only NR);Eukaryota;SAR;Stramenopiles;MAST-12;MAST-12D;";"100.0";"18.2";"3";"2";"2";"0";"1";"457181";"373892"
"V4mis1";"SILVA (only NR);Eukaryota;SAR;Stramenopiles;MAST-16;";"0.0";"0";"2";"1";"0";"1";"1";"457182";"373894"
"V4mis1";"SILVA (only NR);Eukaryota;SAR;Stramenopiles;MAST-1;";"0.0";"0";"30";"25";"0";"25";"5";"457158";"373894"
"V4mis1";"SILVA (only NR);Eukaryota;SAR;Stramenopiles;MAST-1;MAST-1A;";"0.0";"0";"8";"7";"0";"7";"1";"457176";"373894"
"V4mis1";"SILVA (only NR);Eukaryota;SAR;Stramenopiles;MAST-1;MAST-1B;";"0.0";"0";"2";"2";"0";"2";"0";"457181";"373894"
"V4mis1";"SILVA (only NR);Eukaryota;SAR;Stramenopiles;MAST-1;MAST-1C;";"0.0";"0";"12";"10";"0";"10";"2";"457173";"373894"
"V4mis1";"SILVA (only NR);Eukaryota;SAR;Stramenopiles;MAST-1;MAST-1D;";"0.0";"0";"5";"3";"0";"3";"2";"457180";"373894"
"V4mis1";"SILVA (only NR);Eukaryota;SAR;Stramenopiles;MAST-22;";"87.5";"18.2";"10";"8";"7";"1";"2";"457175";"373887"
"V4mis1";"SILVA (only NR);Eukaryota;SAR;Stramenopiles;MAST-22;MAST-22A;";"100.0";"18.2";"2";"1";"1";"0";"1";"457182";"373893"
"V4mis1";"SILVA (only NR);Eukaryota;SAR;Stramenopiles;MAST-22;MAST-22B;";"66.7";"18.2";"3";"3";"2";"1";"0";"457180";"373892"
"V4mis1";"SILVA (only NR);Eukaryota;SAR;Stramenopiles;MAST-22;MAST-22C;";"100.0";"18.2";"3";"3";"3";"0";"0";"457180";"373891"
"V4mis1";"SILVA (only NR);Eukaryota;SAR;Stramenopiles;MAST-23;";"0.0";"0";"2";"2";"0";"2";"0";"457181";"373894"
"V4mis1";"SILVA (only NR);Eukaryota;SAR;Stramenopiles;MAST-24;";"100.0";"18.2";"2";"2";"2";"0";"0";"457181";"373892"
"V4mis1";"SILVA (only NR);Eukaryota;SAR;Stramenopiles;MAST-2;";"0.0";"0";"6";"6";"0";"6";"0";"457177";"373894"
"V4mis1";"SILVA (only NR);Eukaryota;SAR;Stramenopiles;MAST-3;";"93.4";"18.2";"128";"106";"99";"7";"22";"457077";"373795"
"V4mis1";"SILVA (only NR);Eukaryota;SAR;Stramenopiles;MAST-3;MAST-3A;";"100.0";"18.2";"9";"8";"8";"0";"1";"457175";"373886"
"V4mis1";"SILVA (only NR);Eukaryota;SAR;Stramenopiles;MAST-3;MAST-3B;";"80.0";"18.2";"13";"10";"8";"2";"3";"457173";"373886"
"V4mis1";"SILVA (only NR);Eukaryota;SAR;Stramenopiles;MAST-3;MAST-3C;";"92.3";"18.2";"13";"13";"12";"1";"0";"457170";"373882"
"V4mis1";"SILVA (only NR);Eukaryota;SAR;Stramenopiles;MAST-3;MAST-3D;";"100.0";"18.2";"10";"7";"7";"0";"3";"457176";"373887"
"V4mis1";"SILVA (only NR);Eukaryota;SAR;Stramenopiles;MAST-3;MAST-3E;";"91.7";"18.2";"12";"12";"11";"1";"0";"457171";"373883"
"V4mis1";"SILVA (only NR);Eukaryota;SAR;Stramenopiles;MAST-3;MAST-3F;";"94.4";"18.2";"19";"18";"17";"1";"1";"457165";"373877"
"V4mis1";"SILVA (only NR);Eukaryota;SAR;Stramenopiles;MAST-3;MAST-3I;";"92.9";"18.2";"20";"14";"13";"1";"6";"457169";"373881"
"V4mis1";"SILVA (only NR);Eukaryota;SAR;Stramenopiles;MAST-3;MAST-3J;";"90.0";"18.2";"14";"10";"9";"1";"4";"457173";"373885"
"V4mis1";"SILVA (only NR);Eukaryota;SAR;Stramenopiles;MAST-3;MAST-3K;";"100.0";"18.2";"5";"2";"2";"0";"3";"457181";"373892"
"V4mis1";"SILVA (only NR);Eukaryota;SAR;Stramenopiles;MAST-3;MAST-3L;";"100.0";"18.2";"3";"3";"3";"0";"0";"457180";"373891"
"V4mis1";"SILVA (only NR);Eukaryota;SAR;Stramenopiles;MAST-4;";"3.7";"18.2";"28";"27";"1";"26";"1";"457156";"373893"
"V4mis1";"SILVA (only NR);Eukaryota;SAR;Stramenopiles;MAST-4;MAST-4A;";"33.3";"18.2";"3";"3";"1";"2";"0";"457180";"373893"
"V4mis1";"SILVA (only NR);Eukaryota;SAR;Stramenopiles;MAST-4;MAST-4D;";"0.0";"0";"3";"2";"0";"2";"1";"457181";"373894"
"V4mis1";"SILVA (only NR);Eukaryota;SAR;Stramenopiles;MAST-4;MAST-4F;";"0.0";"0";"5";"5";"0";"5";"0";"457178";"373894"
"V4mis1";"SILVA (only NR);Eukaryota;SAR;Stramenopiles;MAST-6;";"0.0";"0";"5";"5";"0";"5";"0";"457178";"373894"
"V4mis1";"SILVA (only NR);Eukaryota;SAR;Stramenopiles;MAST-7;";"0.0";"0";"27";"27";"0";"27";"0";"457156";"373894"
"V4mis1";"SILVA (only NR);Eukaryota;SAR;Stramenopiles;MAST-7;MAST-7A;";"0.0";"0";"11";"11";"0";"11";"0";"457172";"373894"
"V4mis1";"SILVA (only NR);Eukaryota;SAR;Stramenopiles;MAST-7;MAST-7B;";"0.0";"0";"6";"6";"0";"6";"0";"457177";"373894"
"V4mis1";"SILVA (only NR);Eukaryota;SAR;Stramenopiles;MAST-7;MAST-7D;";"0.0";"0";"5";"5";"0";"5";"0";"457178";"373894"
"V4mis1";"SILVA (only NR);Eukaryota;SAR;Stramenopiles;MAST-8;";"0.0";"0";"17";"15";"0";"15";"2";"457168";"373894"
"V4mis1";"SILVA (only NR);Eukaryota;SAR;Stramenopiles;MAST-8;MAST-8D;";"0.0";"0";"6";"6";"0";"6";"0";"457177";"373894"
"V4mis1";"SILVA (only NR);Eukaryota;SAR;Stramenopiles;MAST-9;";"0.0";"0";"13";"12";"0";"12";"1";"457171";"373894"
"V4mis1";"SILVA (only NR);Eukaryota;SAR;Stramenopiles;MAST-9;MAST-9A;";"0.0";"0";"6";"6";"0";"6";"0";"457177";"373894"
"V4mis1";"SILVA (only NR);Eukaryota;SAR;Stramenopiles;Ochrophyta;";"2.4";"17.8";"2392";"2298";"55";"2243";"94";"454885";"373839"
"V4mis1";"SILVA (only NR);Eukaryota;SAR;Stramenopiles;Ochrophyta;ANT37-16;";"0.0";"0";"4";"4";"0";"4";"0";"457179";"373894"
"V4mis1";"SILVA (only NR);Eukaryota;SAR;Stramenopiles;Ochrophyta;Aurearenophyceae;";"0.0";"0";"1";"1";"0";"1";"0";"457182";"373894"
"V4mis1";"SILVA (only NR);Eukaryota;SAR;Stramenopiles;Ochrophyta;Aurearenophyceae;Aurearena;";"0.0";"0";"1";"1";"0";"1";"0";"457182";"373894"
"V4mis1";"SILVA (only NR);Eukaryota;SAR;Stramenopiles;Ochrophyta;Bolidomonas;";"0.0";"0";"25";"25";"0";"25";"0";"457158";"373894"
"V4mis1";"SILVA (only NR);Eukaryota;SAR;Stramenopiles;Ochrophyta;Chrysomerophyceae;";"0.0";"0";"3";"3";"0";"3";"0";"457180";"373894"
"V4mis1";"SILVA (only NR);Eukaryota;SAR;Stramenopiles;Ochrophyta;Chrysomerophyceae;Antarctosaccion;";"0.0";"0";"1";"1";"0";"1";"0";"457182";"373894"
"V4mis1";"SILVA (only NR);Eukaryota;SAR;Stramenopiles;Ochrophyta;Chrysomerophyceae;Chrysowaernella;";"0.0";"0";"1";"1";"0";"1";"0";"457182";"373894"
"V4mis1";"SILVA (only NR);Eukaryota;SAR;Stramenopiles;Ochrophyta;Chrysomerophyceae;Giraudyopsis;";"0.0";"0";"1";"1";"0";"1";"0";"457182";"373894"
"V4mis1";"SILVA (only NR);Eukaryota;SAR;Stramenopiles;Ochrophyta;Chrysophyceae;";"0.6";"18.1";"489";"470";"3";"467";"19";"456713";"373891"
"V4mis1";"SILVA (only NR);Eukaryota;SAR;Stramenopiles;Ochrophyta;Chrysophyceae;A-3-62;";"0.0";"0";"2";"2";"0";"2";"0";"457181";"373894"
"V4mis1";"SILVA (only NR);Eukaryota;SAR;Stramenopiles;Ochrophyta;Chrysophyceae;Chromulinales;";"0.0";"0";"97";"95";"0";"95";"2";"457088";"373894"
"V4mis1";"SILVA (only NR);Eukaryota;SAR;Stramenopiles;Ochrophyta;Chrysophyceae;Chromulinales;Chromulina;";"0.0";"0";"5";"5";"0";"5";"0";"457178";"373894"
"V4mis1";"SILVA (only NR);Eukaryota;SAR;Stramenopiles;Ochrophyta;Chrysophyceae;Chromulinales;Chrysamoeba;";"0.0";"0";"6";"6";"0";"6";"0";"457177";"373894"
"V4mis1";"SILVA (only NR);Eukaryota;SAR;Stramenopiles;Ochrophyta;Chrysophyceae;Chromulinales;Chrysochaete;";"0.0";"0";"2";"2";"0";"2";"0";"457181";"373894"
"V4mis1";"SILVA (only NR);Eukaryota;SAR;Stramenopiles;Ochrophyta;Chrysophyceae;Chromulinales;Chrysoxys;";"0.0";"0";"2";"2";"0";"2";"0";"457181";"373894"
"V4mis1";"SILVA (only NR);Eukaryota;SAR;Stramenopiles;Ochrophyta;Chrysophyceae;Chromulinales;Cyclonexis;";"0.0";"0";"1";"1";"0";"1";"0";"457182";"373894"
"V4mis1";"SILVA (only NR);Eukaryota;SAR;Stramenopiles;Ochrophyta;Chrysophyceae;Chromulinales;JBNA46;";"0.0";"0";"4";"4";"0";"4";"0";"457179";"373894"
"V4mis1";"SILVA (only NR);Eukaryota;SAR;Stramenopiles;Ochrophyta;Chrysophyceae;Chromulinales;Oikomonas;";"0.0";"0";"5";"5";"0";"5";"0";"457178";"373894"
"V4mis1";"SILVA (only NR);Eukaryota;SAR;Stramenopiles;Ochrophyta;Chrysophyceae;Chromulinales;Phaeoplaca;";"0.0";"0";"2";"2";"0";"2";"0";"457181";"373894"
"V4mis1";"SILVA (only NR);Eukaryota;SAR;Stramenopiles;Ochrophyta;Chrysophyceae;Chromulinales;Poterioochromonas;";"0.0";"0";"7";"7";"0";"7";"0";"457176";"373894"
"V4mis1";"SILVA (only NR);Eukaryota;SAR;Stramenopiles;Ochrophyta;Chrysophyceae;Chromulinales;Poteriospumella;";"0.0";"0";"2";"2";"0";"2";"0";"457181";"373894"
"V4mis1";"SILVA (only NR);Eukaryota;SAR;Stramenopiles;Ochrophyta;Chrysophyceae;Chromulinales;Spumella;";"0.0";"0";"29";"28";"0";"28";"1";"457155";"373894"
"V4mis1";"SILVA (only NR);Eukaryota;SAR;Stramenopiles;Ochrophyta;Chrysophyceae;Chromulinales;Uroglena;";"0.0";"0";"6";"6";"0";"6";"0";"457177";"373894"
"V4mis1";"SILVA (only NR);Eukaryota;SAR;Stramenopiles;Ochrophyta;Chrysophyceae;Chromulinales;eukaryotic;";"0.0";"0";"2";"2";"0";"2";"0";"457181";"373894"
"V4mis1";"SILVA (only NR);Eukaryota;SAR;Stramenopiles;Ochrophyta;Chrysophyceae;Chromulinales;uncultured;";"0.0";"0";"16";"15";"0";"15";"1";"457168";"373894"
"V4mis1";"SILVA (only NR);Eukaryota;SAR;Stramenopiles;Ochrophyta;Chrysophyceae;Chrysocapsales;";"0.0";"0";"8";"8";"0";"8";"0";"457175";"373894"
"V4mis1";"SILVA (only NR);Eukaryota;SAR;Stramenopiles;Ochrophyta;Chrysophyceae;Chrysocapsales;Chrysocapsa;";"0.0";"0";"2";"2";"0";"2";"0";"457181";"373894"
"V4mis1";"SILVA (only NR);Eukaryota;SAR;Stramenopiles;Ochrophyta;Chrysophyceae;Chrysocapsales;Chrysonebula;";"0.0";"0";"3";"3";"0";"3";"0";"457180";"373894"
"V4mis1";"SILVA (only NR);Eukaryota;SAR;Stramenopiles;Ochrophyta;Chrysophyceae;Chrysocapsales;Hydrurus;";"0.0";"0";"3";"3";"0";"3";"0";"457180";"373894"
"V4mis1";"SILVA (only NR);Eukaryota;SAR;Stramenopiles;Ochrophyta;Chrysophyceae;Chrysosphaerales;";"0.0";"0";"1";"1";"0";"1";"0";"457182";"373894"
"V4mis1";"SILVA (only NR);Eukaryota;SAR;Stramenopiles;Ochrophyta;Chrysophyceae;Chrysosphaerales;Chrysosphaera;";"0.0";"0";"1";"1";"0";"1";"0";"457182";"373894"
"V4mis1";"SILVA (only NR);Eukaryota;SAR;Stramenopiles;Ochrophyta;Chrysophyceae;Hibberdiales;";"16.7";"18.2";"6";"6";"1";"5";"0";"457177";"373893"
"V4mis1";"SILVA (only NR);Eukaryota;SAR;Stramenopiles;Ochrophyta;Chrysophyceae;Hibberdiales;Chromophyton;";"0.0";"0";"2";"2";"0";"2";"0";"457181";"373894"
"V4mis1";"SILVA (only NR);Eukaryota;SAR;Stramenopiles;Ochrophyta;Chrysophyceae;Hibberdiales;Chrysopodocystis;";"50.0";"18.2";"2";"2";"1";"1";"0";"457181";"373893"
"V4mis1";"SILVA (only NR);Eukaryota;SAR;Stramenopiles;Ochrophyta;Chrysophyceae;Hibberdiales;Hibberdia;";"0.0";"0";"1";"1";"0";"1";"0";"457182";"373894"
"V4mis1";"SILVA (only NR);Eukaryota;SAR;Stramenopiles;Ochrophyta;Chrysophyceae;Hibberdiales;Lagynion;";"0.0";"0";"1";"1";"0";"1";"0";"457182";"373894"
"V4mis1";"SILVA (only NR);Eukaryota;SAR;Stramenopiles;Ochrophyta;Chrysophyceae;Incertae Sedis;";"0.0";"0";"5";"4";"0";"4";"1";"457179";"373894"
"V4mis1";"SILVA (only NR);Eukaryota;SAR;Stramenopiles;Ochrophyta;Chrysophyceae;Incertae Sedis;Chlamydomyxa;";"0.0";"0";"5";"4";"0";"4";"1";"457179";"373894"
"V4mis1";"SILVA (only NR);Eukaryota;SAR;Stramenopiles;Ochrophyta;Chrysophyceae;Ochromonadales;";"0.0";"0";"124";"111";"0";"111";"13";"457072";"373894"
"V4mis1";"SILVA (only NR);Eukaryota;SAR;Stramenopiles;Ochrophyta;Chrysophyceae;Ochromonadales;Chrysolepidomonas;";"0.0";"0";"1";"1";"0";"1";"0";"457182";"373894"
"V4mis1";"SILVA (only NR);Eukaryota;SAR;Stramenopiles;Ochrophyta;Chrysophyceae;Ochromonadales;Chrysonephele;";"0.0";"0";"1";"1";"0";"1";"0";"457182";"373894"
"V4mis1";"SILVA (only NR);Eukaryota;SAR;Stramenopiles;Ochrophyta;Chrysophyceae;Ochromonadales;Dinobryon;";"0.0";"0";"9";"9";"0";"9";"0";"457174";"373894"
"V4mis1";"SILVA (only NR);Eukaryota;SAR;Stramenopiles;Ochrophyta;Chrysophyceae;Ochromonadales;Epipyxis;";"0.0";"0";"5";"5";"0";"5";"0";"457178";"373894"
"V4mis1";"SILVA (only NR);Eukaryota;SAR;Stramenopiles;Ochrophyta;Chrysophyceae;Ochromonadales;Ochromonas;";"0.0";"0";"37";"36";"0";"36";"1";"457147";"373894"
"V4mis1";"SILVA (only NR);Eukaryota;SAR;Stramenopiles;Ochrophyta;Chrysophyceae;Ochromonadales;Paraphysomonas;";"0.0";"0";"63";"51";"0";"51";"12";"457132";"373894"
"V4mis1";"SILVA (only NR);Eukaryota;SAR;Stramenopiles;Ochrophyta;Chrysophyceae;Ochromonadales;uncultured;";"0.0";"0";"7";"7";"0";"7";"0";"457176";"373894"
"V4mis1";"SILVA (only NR);Eukaryota;SAR;Stramenopiles;Ochrophyta;Chrysophyceae;P34.45;";"0.0";"0";"13";"12";"0";"12";"1";"457171";"373894"
"V4mis1";"SILVA (only NR);Eukaryota;SAR;Stramenopiles;Ochrophyta;Chrysophyceae;P34.48;";"0.0";"0";"12";"12";"0";"12";"0";"457171";"373894"
"V4mis1";"SILVA (only NR);Eukaryota;SAR;Stramenopiles;Ochrophyta;Chrysophyceae;Synurales;";"0.0";"0";"47";"47";"0";"47";"0";"457136";"373894"
"V4mis1";"SILVA (only NR);Eukaryota;SAR;Stramenopiles;Ochrophyta;Chrysophyceae;Synurales;Mallomonas;";"0.0";"0";"30";"30";"0";"30";"0";"457153";"373894"
"V4mis1";"SILVA (only NR);Eukaryota;SAR;Stramenopiles;Ochrophyta;Chrysophyceae;Synurales;Synura;";"0.0";"0";"15";"15";"0";"15";"0";"457168";"373894"
"V4mis1";"SILVA (only NR);Eukaryota;SAR;Stramenopiles;Ochrophyta;Chrysophyceae;Synurales;Tessellaria;";"0.0";"0";"2";"2";"0";"2";"0";"457181";"373894"
"V4mis1";"SILVA (only NR);Eukaryota;SAR;Stramenopiles;Ochrophyta;Chrysophyceae;uncultured;";"1.3";"18.2";"156";"154";"2";"152";"2";"457029";"373892"
"V4mis1";"SILVA (only NR);Eukaryota;SAR;Stramenopiles;Ochrophyta;Diatomea;";"1.3";"18";"1571";"1502";"20";"1482";"69";"455681";"373874"
"V4mis1";"SILVA (only NR);Eukaryota;SAR;Stramenopiles;Ochrophyta;Diatomea;Bacillariophytina;";"0.9";"18";"1283";"1218";"11";"1207";"65";"455965";"373883"
"V4mis1";"SILVA (only NR);Eukaryota;SAR;Stramenopiles;Ochrophyta;Diatomea;Bacillariophytina;Bacillariophyceae;";"0.7";"18.1";"900";"873";"6";"867";"27";"456310";"373888"
"V4mis1";"SILVA (only NR);Eukaryota;SAR;Stramenopiles;Ochrophyta;Diatomea;Bacillariophytina;Bacillariophyceae;Achnanthes;";"0.0";"0";"5";"5";"0";"5";"0";"457178";"373894"
"V4mis1";"SILVA (only NR);Eukaryota;SAR;Stramenopiles;Ochrophyta;Diatomea;Bacillariophytina;Bacillariophyceae;Achnanthidium;";"0.0";"0";"8";"8";"0";"8";"0";"457175";"373894"
"V4mis1";"SILVA (only NR);Eukaryota;SAR;Stramenopiles;Ochrophyta;Diatomea;Bacillariophytina;Bacillariophyceae;Amphipleura;";"0.0";"0";"1";"1";"0";"1";"0";"457182";"373894"
"V4mis1";"SILVA (only NR);Eukaryota;SAR;Stramenopiles;Ochrophyta;Diatomea;Bacillariophytina;Bacillariophyceae;Amphiprora;";"0.0";"0";"1";"1";"0";"1";"0";"457182";"373894"
"V4mis1";"SILVA (only NR);Eukaryota;SAR;Stramenopiles;Ochrophyta;Diatomea;Bacillariophytina;Bacillariophyceae;Amphora;";"0.0";"0";"114";"113";"0";"113";"1";"457070";"373894"
"V4mis1";"SILVA (only NR);Eukaryota;SAR;Stramenopiles;Ochrophyta;Diatomea;Bacillariophytina;Bacillariophyceae;Anomoeoneis;";"0.0";"0";"3";"3";"0";"3";"0";"457180";"373894"
"V4mis1";"SILVA (only NR);Eukaryota;SAR;Stramenopiles;Ochrophyta;Diatomea;Bacillariophytina;Bacillariophyceae;Asterionella;";"0.0";"0";"2";"2";"0";"2";"0";"457181";"373894"
"V4mis1";"SILVA (only NR);Eukaryota;SAR;Stramenopiles;Ochrophyta;Diatomea;Bacillariophytina;Bacillariophyceae;Asterionellopsis;";"0.0";"0";"1";"1";"0";"1";"0";"457182";"373894"
"V4mis1";"SILVA (only NR);Eukaryota;SAR;Stramenopiles;Ochrophyta;Diatomea;Bacillariophytina;Bacillariophyceae;Asteroplanus;";"0.0";"0";"1";"1";"0";"1";"0";"457182";"373894"
"V4mis1";"SILVA (only NR);Eukaryota;SAR;Stramenopiles;Ochrophyta;Diatomea;Bacillariophytina;Bacillariophyceae;Auricula;";"0.0";"0";"5";"5";"0";"5";"0";"457178";"373894"
"V4mis1";"SILVA (only NR);Eukaryota;SAR;Stramenopiles;Ochrophyta;Diatomea;Bacillariophytina;Bacillariophyceae;Bacillaria;";"0.0";"0";"5";"5";"0";"5";"0";"457178";"373894"
"V4mis1";"SILVA (only NR);Eukaryota;SAR;Stramenopiles;Ochrophyta;Diatomea;Bacillariophytina;Bacillariophyceae;Biremis;";"0.0";"0";"4";"4";"0";"4";"0";"457179";"373894"
"V4mis1";"SILVA (only NR);Eukaryota;SAR;Stramenopiles;Ochrophyta;Diatomea;Bacillariophytina;Bacillariophyceae;Campylodiscus;";"20.0";"18.2";"20";"20";"4";"16";"0";"457163";"373890"
"V4mis1";"SILVA (only NR);Eukaryota;SAR;Stramenopiles;Ochrophyta;Diatomea;Bacillariophytina;Bacillariophyceae;Carinasigma;";"0.0";"0";"1";"1";"0";"1";"0";"457182";"373894"
"V4mis1";"SILVA (only NR);Eukaryota;SAR;Stramenopiles;Ochrophyta;Diatomea;Bacillariophytina;Bacillariophyceae;Climaconeis;";"0.0";"0";"3";"3";"0";"3";"0";"457180";"373894"
"V4mis1";"SILVA (only NR);Eukaryota;SAR;Stramenopiles;Ochrophyta;Diatomea;Bacillariophytina;Bacillariophyceae;Cocconeis;";"0.0";"0";"9";"9";"0";"9";"0";"457174";"373894"
"V4mis1";"SILVA (only NR);Eukaryota;SAR;Stramenopiles;Ochrophyta;Diatomea;Bacillariophytina;Bacillariophyceae;Craspedostauros;";"0.0";"0";"2";"2";"0";"2";"0";"457181";"373894"
"V4mis1";"SILVA (only NR);Eukaryota;SAR;Stramenopiles;Ochrophyta;Diatomea;Bacillariophytina;Bacillariophyceae;Craticula;";"0.0";"0";"4";"4";"0";"4";"0";"457179";"373894"
"V4mis1";"SILVA (only NR);Eukaryota;SAR;Stramenopiles;Ochrophyta;Diatomea;Bacillariophytina;Bacillariophyceae;Cylindrotheca;";"0.0";"0";"16";"16";"0";"16";"0";"457167";"373894"
"V4mis1";"SILVA (only NR);Eukaryota;SAR;Stramenopiles;Ochrophyta;Diatomea;Bacillariophytina;Bacillariophyceae;Cymatopleura;";"0.0";"0";"3";"3";"0";"3";"0";"457180";"373894"
"V4mis1";"SILVA (only NR);Eukaryota;SAR;Stramenopiles;Ochrophyta;Diatomea;Bacillariophytina;Bacillariophyceae;Cymbella;";"0.0";"0";"17";"17";"0";"17";"0";"457166";"373894"
"V4mis1";"SILVA (only NR);Eukaryota;SAR;Stramenopiles;Ochrophyta;Diatomea;Bacillariophytina;Bacillariophyceae;Cymbellonitzschia;";"0.0";"0";"2";"2";"0";"2";"0";"457181";"373894"
"V4mis1";"SILVA (only NR);Eukaryota;SAR;Stramenopiles;Ochrophyta;Diatomea;Bacillariophytina;Bacillariophyceae;Cymbopleura;";"0.0";"0";"2";"2";"0";"2";"0";"457181";"373894"
"V4mis1";"SILVA (only NR);Eukaryota;SAR;Stramenopiles;Ochrophyta;Diatomea;Bacillariophytina;Bacillariophyceae;Diadesmis;";"0.0";"0";"1";"1";"0";"1";"0";"457182";"373894"
"V4mis1";"SILVA (only NR);Eukaryota;SAR;Stramenopiles;Ochrophyta;Diatomea;Bacillariophytina;Bacillariophyceae;Diatoma;";"0.0";"0";"5";"5";"0";"5";"0";"457178";"373894"
"V4mis1";"SILVA (only NR);Eukaryota;SAR;Stramenopiles;Ochrophyta;Diatomea;Bacillariophytina;Bacillariophyceae;Dickieia;";"0.0";"0";"3";"3";"0";"3";"0";"457180";"373894"
"V4mis1";"SILVA (only NR);Eukaryota;SAR;Stramenopiles;Ochrophyta;Diatomea;Bacillariophytina;Bacillariophyceae;Diploneis;";"0.0";"0";"8";"8";"0";"8";"0";"457175";"373894"
"V4mis1";"SILVA (only NR);Eukaryota;SAR;Stramenopiles;Ochrophyta;Diatomea;Bacillariophytina;Bacillariophyceae;Encyonema;";"0.0";"0";"6";"6";"0";"6";"0";"457177";"373894"
"V4mis1";"SILVA (only NR);Eukaryota;SAR;Stramenopiles;Ochrophyta;Diatomea;Bacillariophytina;Bacillariophyceae;Entomoneis;";"0.0";"0";"20";"20";"0";"20";"0";"457163";"373894"
"V4mis1";"SILVA (only NR);Eukaryota;SAR;Stramenopiles;Ochrophyta;Diatomea;Bacillariophytina;Bacillariophyceae;Epithemia;";"0.0";"0";"3";"3";"0";"3";"0";"457180";"373894"
"V4mis1";"SILVA (only NR);Eukaryota;SAR;Stramenopiles;Ochrophyta;Diatomea;Bacillariophytina;Bacillariophyceae;Eucocconeis;";"0.0";"0";"1";"1";"0";"1";"0";"457182";"373894"
"V4mis1";"SILVA (only NR);Eukaryota;SAR;Stramenopiles;Ochrophyta;Diatomea;Bacillariophytina;Bacillariophyceae;Eunotia;";"0.0";"0";"14";"14";"0";"14";"0";"457169";"373894"
"V4mis1";"SILVA (only NR);Eukaryota;SAR;Stramenopiles;Ochrophyta;Diatomea;Bacillariophytina;Bacillariophyceae;Fistulifera;";"0.0";"0";"7";"7";"0";"7";"0";"457176";"373894"
"V4mis1";"SILVA (only NR);Eukaryota;SAR;Stramenopiles;Ochrophyta;Diatomea;Bacillariophytina;Bacillariophyceae;Fragilariopsis;";"0.0";"0";"23";"22";"0";"22";"1";"457161";"373894"
"V4mis1";"SILVA (only NR);Eukaryota;SAR;Stramenopiles;Ochrophyta;Diatomea;Bacillariophytina;Bacillariophyceae;Frustulia;";"0.0";"0";"7";"7";"0";"7";"0";"457176";"373894"
"V4mis1";"SILVA (only NR);Eukaryota;SAR;Stramenopiles;Ochrophyta;Diatomea;Bacillariophytina;Bacillariophyceae;Geissleria;";"0.0";"0";"1";"1";"0";"1";"0";"457182";"373894"
"V4mis1";"SILVA (only NR);Eukaryota;SAR;Stramenopiles;Ochrophyta;Diatomea;Bacillariophytina;Bacillariophyceae;Gomphonema;";"0.0";"0";"12";"12";"0";"12";"0";"457171";"373894"
"V4mis1";"SILVA (only NR);Eukaryota;SAR;Stramenopiles;Ochrophyta;Diatomea;Bacillariophytina;Bacillariophyceae;Gyrosigma;";"0.0";"0";"4";"4";"0";"4";"0";"457179";"373894"
"V4mis1";"SILVA (only NR);Eukaryota;SAR;Stramenopiles;Ochrophyta;Diatomea;Bacillariophytina;Bacillariophyceae;Hantzschia;";"0.0";"0";"14";"14";"0";"14";"0";"457169";"373894"
"V4mis1";"SILVA (only NR);Eukaryota;SAR;Stramenopiles;Ochrophyta;Diatomea;Bacillariophytina;Bacillariophyceae;Haslea;";"0.0";"0";"6";"6";"0";"6";"0";"457177";"373894"
"V4mis1";"SILVA (only NR);Eukaryota;SAR;Stramenopiles;Ochrophyta;Diatomea;Bacillariophytina;Bacillariophyceae;Humidophila;";"0.0";"0";"2";"2";"0";"2";"0";"457181";"373894"
"V4mis1";"SILVA (only NR);Eukaryota;SAR;Stramenopiles;Ochrophyta;Diatomea;Bacillariophytina;Bacillariophyceae;Lemnicula;";"0.0";"0";"4";"4";"0";"4";"0";"457179";"373894"
"V4mis1";"SILVA (only NR);Eukaryota;SAR;Stramenopiles;Ochrophyta;Diatomea;Bacillariophytina;Bacillariophyceae;Luticola;";"0.0";"0";"6";"6";"0";"6";"0";"457177";"373894"
"V4mis1";"SILVA (only NR);Eukaryota;SAR;Stramenopiles;Ochrophyta;Diatomea;Bacillariophytina;Bacillariophyceae;Meuniera;";"0.0";"0";"1";"1";"0";"1";"0";"457182";"373894"
"V4mis1";"SILVA (only NR);Eukaryota;SAR;Stramenopiles;Ochrophyta;Diatomea;Bacillariophytina;Bacillariophyceae;Navicula;";"2.8";"18.2";"72";"72";"2";"70";"0";"457111";"373892"
"V4mis1";"SILVA (only NR);Eukaryota;SAR;Stramenopiles;Ochrophyta;Diatomea;Bacillariophytina;Bacillariophyceae;Neidium;";"0.0";"0";"2";"2";"0";"2";"0";"457181";"373894"
"V4mis1";"SILVA (only NR);Eukaryota;SAR;Stramenopiles;Ochrophyta;Diatomea;Bacillariophytina;Bacillariophyceae;Nitzschia;";"0.0";"0";"79";"79";"0";"79";"0";"457104";"373894"
"V4mis1";"SILVA (only NR);Eukaryota;SAR;Stramenopiles;Ochrophyta;Diatomea;Bacillariophytina;Bacillariophyceae;Parlibellus;";"0.0";"0";"4";"4";"0";"4";"0";"457179";"373894"
"V4mis1";"SILVA (only NR);Eukaryota;SAR;Stramenopiles;Ochrophyta;Diatomea;Bacillariophytina;Bacillariophyceae;Pauliella;";"0.0";"0";"4";"4";"0";"4";"0";"457179";"373894"
"V4mis1";"SILVA (only NR);Eukaryota;SAR;Stramenopiles;Ochrophyta;Diatomea;Bacillariophytina;Bacillariophyceae;Phaeodactylum;";"0.0";"0";"2";"2";"0";"2";"0";"457181";"373894"
"V4mis1";"SILVA (only NR);Eukaryota;SAR;Stramenopiles;Ochrophyta;Diatomea;Bacillariophytina;Bacillariophyceae;Pinnularia;";"0.0";"0";"55";"55";"0";"55";"0";"457128";"373894"
"V4mis1";"SILVA (only NR);Eukaryota;SAR;Stramenopiles;Ochrophyta;Diatomea;Bacillariophytina;Bacillariophyceae;Placoneis;";"0.0";"0";"7";"7";"0";"7";"0";"457176";"373894"
"V4mis1";"SILVA (only NR);Eukaryota;SAR;Stramenopiles;Ochrophyta;Diatomea;Bacillariophytina;Bacillariophyceae;Planothidium;";"0.0";"0";"12";"12";"0";"12";"0";"457171";"373894"
"V4mis1";"SILVA (only NR);Eukaryota;SAR;Stramenopiles;Ochrophyta;Diatomea;Bacillariophytina;Bacillariophyceae;Pleurosigma;";"0.0";"0";"14";"12";"0";"12";"2";"457171";"373894"
"V4mis1";"SILVA (only NR);Eukaryota;SAR;Stramenopiles;Ochrophyta;Diatomea;Bacillariophytina;Bacillariophyceae;Protokeelia;";"0.0";"0";"1";"1";"0";"1";"0";"457182";"373894"
"V4mis1";"SILVA (only NR);Eukaryota;SAR;Stramenopiles;Ochrophyta;Diatomea;Bacillariophytina;Bacillariophyceae;Psammodictyon;";"0.0";"0";"3";"3";"0";"3";"0";"457180";"373894"
"V4mis1";"SILVA (only NR);Eukaryota;SAR;Stramenopiles;Ochrophyta;Diatomea;Bacillariophytina;Bacillariophyceae;Pseudo-nitzschia;";"0.0";"0";"31";"12";"0";"12";"19";"457171";"373894"
"V4mis1";"SILVA (only NR);Eukaryota;SAR;Stramenopiles;Ochrophyta;Diatomea;Bacillariophytina;Bacillariophyceae;Reimeria;";"0.0";"0";"1";"1";"0";"1";"0";"457182";"373894"
"V4mis1";"SILVA (only NR);Eukaryota;SAR;Stramenopiles;Ochrophyta;Diatomea;Bacillariophytina;Bacillariophyceae;Rhaphoneis;";"0.0";"0";"16";"16";"0";"16";"0";"457167";"373894"
"V4mis1";"SILVA (only NR);Eukaryota;SAR;Stramenopiles;Ochrophyta;Diatomea;Bacillariophytina;Bacillariophyceae;Rhoicosphenia;";"0.0";"0";"4";"4";"0";"4";"0";"457179";"373894"
"V4mis1";"SILVA (only NR);Eukaryota;SAR;Stramenopiles;Ochrophyta;Diatomea;Bacillariophytina;Bacillariophyceae;Rhopalodia;";"0.0";"0";"3";"3";"0";"3";"0";"457180";"373894"
"V4mis1";"SILVA (only NR);Eukaryota;SAR;Stramenopiles;Ochrophyta;Diatomea;Bacillariophytina;Bacillariophyceae;Scoliopleura;";"0.0";"0";"1";"1";"0";"1";"0";"457182";"373894"
"V4mis1";"SILVA (only NR);Eukaryota;SAR;Stramenopiles;Ochrophyta;Diatomea;Bacillariophytina;Bacillariophyceae;Sellaphoraceae;";"0.0";"0";"33";"30";"0";"30";"3";"457153";"373894"
"V4mis1";"SILVA (only NR);Eukaryota;SAR;Stramenopiles;Ochrophyta;Diatomea;Bacillariophytina;Bacillariophyceae;Sellaphoraceae;Eolimna;";"0.0";"0";"3";"3";"0";"3";"0";"457180";"373894"
"V4mis1";"SILVA (only NR);Eukaryota;SAR;Stramenopiles;Ochrophyta;Diatomea;Bacillariophytina;Bacillariophyceae;Sellaphoraceae;Fallacia;";"0.0";"0";"4";"4";"0";"4";"0";"457179";"373894"
"V4mis1";"SILVA (only NR);Eukaryota;SAR;Stramenopiles;Ochrophyta;Diatomea;Bacillariophytina;Bacillariophyceae;Sellaphoraceae;Sellaphora;";"0.0";"0";"17";"17";"0";"17";"0";"457166";"373894"
"V4mis1";"SILVA (only NR);Eukaryota;SAR;Stramenopiles;Ochrophyta;Diatomea;Bacillariophytina;Bacillariophyceae;Stauroneis;";"0.0";"0";"4";"4";"0";"4";"0";"457179";"373894"
"V4mis1";"SILVA (only NR);Eukaryota;SAR;Stramenopiles;Ochrophyta;Diatomea;Bacillariophytina;Bacillariophyceae;Staurotropis;";"0.0";"0";"1";"1";"0";"1";"0";"457182";"373894"
"V4mis1";"SILVA (only NR);Eukaryota;SAR;Stramenopiles;Ochrophyta;Diatomea;Bacillariophytina;Bacillariophyceae;Stenopterobia;";"0.0";"0";"2";"2";"0";"2";"0";"457181";"373894"
"V4mis1";"SILVA (only NR);Eukaryota;SAR;Stramenopiles;Ochrophyta;Diatomea;Bacillariophytina;Bacillariophyceae;Surirella;";"0.0";"0";"18";"18";"0";"18";"0";"457165";"373894"
"V4mis1";"SILVA (only NR);Eukaryota;SAR;Stramenopiles;Ochrophyta;Diatomea;Bacillariophytina;Bacillariophyceae;Thalassiophysa;";"0.0";"0";"1";"1";"0";"1";"0";"457182";"373894"
"V4mis1";"SILVA (only NR);Eukaryota;SAR;Stramenopiles;Ochrophyta;Diatomea;Bacillariophytina;Bacillariophyceae;Tryblionella;";"0.0";"0";"2";"2";"0";"2";"0";"457181";"373894"
"V4mis1";"SILVA (only NR);Eukaryota;SAR;Stramenopiles;Ochrophyta;Diatomea;Bacillariophytina;Bacillariophyceae;Undatella;";"0.0";"0";"2";"2";"0";"2";"0";"457181";"373894"
"V4mis1";"SILVA (only NR);Eukaryota;SAR;Stramenopiles;Ochrophyta;Diatomea;Bacillariophytina;Bacillariophyceae;uncultured;";"0.0";"0";"9";"9";"0";"9";"0";"457174";"373894"
"V4mis1";"SILVA (only NR);Eukaryota;SAR;Stramenopiles;Ochrophyta;Diatomea;Bacillariophytina;Mediophyceae;";"1.4";"18.2";"383";"345";"5";"340";"38";"456838";"373889"
"V4mis1";"SILVA (only NR);Eukaryota;SAR;Stramenopiles;Ochrophyta;Diatomea;Bacillariophytina;Mediophyceae;Arcocellulus;";"0.0";"0";"12";"8";"0";"8";"4";"457175";"373894"
"V4mis1";"SILVA (only NR);Eukaryota;SAR;Stramenopiles;Ochrophyta;Diatomea;Bacillariophytina;Mediophyceae;Attheya;";"0.0";"0";"2";"2";"0";"2";"0";"457181";"373894"
"V4mis1";"SILVA (only NR);Eukaryota;SAR;Stramenopiles;Ochrophyta;Diatomea;Bacillariophytina;Mediophyceae;Bellerochea;";"0.0";"0";"5";"5";"0";"5";"0";"457178";"373894"
"V4mis1";"SILVA (only NR);Eukaryota;SAR;Stramenopiles;Ochrophyta;Diatomea;Bacillariophytina;Mediophyceae;Biddulphia;";"0.0";"0";"2";"2";"0";"2";"0";"457181";"373894"
"V4mis1";"SILVA (only NR);Eukaryota;SAR;Stramenopiles;Ochrophyta;Diatomea;Bacillariophytina;Mediophyceae;Biddulphiopsis;";"14.3";"18.2";"7";"7";"1";"6";"0";"457176";"373893"
"V4mis1";"SILVA (only NR);Eukaryota;SAR;Stramenopiles;Ochrophyta;Diatomea;Bacillariophytina;Mediophyceae;Brockmanniella;";"0.0";"0";"2";"2";"0";"2";"0";"457181";"373894"
"V4mis1";"SILVA (only NR);Eukaryota;SAR;Stramenopiles;Ochrophyta;Diatomea;Bacillariophytina;Mediophyceae;Campylosira;";"0.0";"0";"1";"1";"0";"1";"0";"457182";"373894"
"V4mis1";"SILVA (only NR);Eukaryota;SAR;Stramenopiles;Ochrophyta;Diatomea;Bacillariophytina;Mediophyceae;Cerataulina;";"0.0";"0";"2";"2";"0";"2";"0";"457181";"373894"
"V4mis1";"SILVA (only NR);Eukaryota;SAR;Stramenopiles;Ochrophyta;Diatomea;Bacillariophytina;Mediophyceae;Chaetoceros;";"0.0";"0";"86";"77";"0";"77";"9";"457106";"373894"
"V4mis1";"SILVA (only NR);Eukaryota;SAR;Stramenopiles;Ochrophyta;Diatomea;Bacillariophytina;Mediophyceae;Cyclotella;";"0.0";"0";"20";"20";"0";"20";"0";"457163";"373894"
"V4mis1";"SILVA (only NR);Eukaryota;SAR;Stramenopiles;Ochrophyta;Diatomea;Bacillariophytina;Mediophyceae;Cymatosira;";"0.0";"0";"2";"2";"0";"2";"0";"457181";"373894"
"V4mis1";"SILVA (only NR);Eukaryota;SAR;Stramenopiles;Ochrophyta;Diatomea;Bacillariophytina;Mediophyceae;Dimeregramma;";"0.0";"0";"4";"4";"0";"4";"0";"457179";"373894"
"V4mis1";"SILVA (only NR);Eukaryota;SAR;Stramenopiles;Ochrophyta;Diatomea;Bacillariophytina;Mediophyceae;Discostella;";"0.0";"0";"3";"3";"0";"3";"0";"457180";"373894"
"V4mis1";"SILVA (only NR);Eukaryota;SAR;Stramenopiles;Ochrophyta;Diatomea;Bacillariophytina;Mediophyceae;Ditylum;";"0.0";"0";"2";"2";"0";"2";"0";"457181";"373894"
"V4mis1";"SILVA (only NR);Eukaryota;SAR;Stramenopiles;Ochrophyta;Diatomea;Bacillariophytina;Mediophyceae;Eucampia;";"0.0";"0";"2";"1";"0";"1";"1";"457182";"373894"
"V4mis1";"SILVA (only NR);Eukaryota;SAR;Stramenopiles;Ochrophyta;Diatomea;Bacillariophytina;Mediophyceae;Eunotogramma;";"0.0";"0";"1";"1";"0";"1";"0";"457182";"373894"
"V4mis1";"SILVA (only NR);Eukaryota;SAR;Stramenopiles;Ochrophyta;Diatomea;Bacillariophytina;Mediophyceae;Extubocellulus;";"0.0";"0";"1";"1";"0";"1";"0";"457182";"373894"
"V4mis1";"SILVA (only NR);Eukaryota;SAR;Stramenopiles;Ochrophyta;Diatomea;Bacillariophytina;Mediophyceae;Helicotheca;";"0.0";"0";"2";"2";"0";"2";"0";"457181";"373894"
"V4mis1";"SILVA (only NR);Eukaryota;SAR;Stramenopiles;Ochrophyta;Diatomea;Bacillariophytina;Mediophyceae;Hemiaulus;";"0.0";"0";"1";"1";"0";"1";"0";"457182";"373894"
"V4mis1";"SILVA (only NR);Eukaryota;SAR;Stramenopiles;Ochrophyta;Diatomea;Bacillariophytina;Mediophyceae;Isthmia;";"0.0";"0";"1";"1";"0";"1";"0";"457182";"373894"
"V4mis1";"SILVA (only NR);Eukaryota;SAR;Stramenopiles;Ochrophyta;Diatomea;Bacillariophytina;Mediophyceae;Lambertocellus;";"0.0";"0";"1";"1";"0";"1";"0";"457182";"373894"
"V4mis1";"SILVA (only NR);Eukaryota;SAR;Stramenopiles;Ochrophyta;Diatomea;Bacillariophytina;Mediophyceae;Lampriscus;";"0.0";"0";"3";"3";"0";"3";"0";"457180";"373894"
"V4mis1";"SILVA (only NR);Eukaryota;SAR;Stramenopiles;Ochrophyta;Diatomea;Bacillariophytina;Mediophyceae;Lauderia;";"0.0";"0";"2";"2";"0";"2";"0";"457181";"373894"
"V4mis1";"SILVA (only NR);Eukaryota;SAR;Stramenopiles;Ochrophyta;Diatomea;Bacillariophytina;Mediophyceae;Leyanella;";"0.0";"0";"2";"2";"0";"2";"0";"457181";"373894"
"V4mis1";"SILVA (only NR);Eukaryota;SAR;Stramenopiles;Ochrophyta;Diatomea;Bacillariophytina;Mediophyceae;Lithodesmium;";"0.0";"0";"2";"2";"0";"2";"0";"457181";"373894"
"V4mis1";"SILVA (only NR);Eukaryota;SAR;Stramenopiles;Ochrophyta;Diatomea;Bacillariophytina;Mediophyceae;Mastodiscus;";"0.0";"0";"1";"1";"0";"1";"0";"457182";"373894"
"V4mis1";"SILVA (only NR);Eukaryota;SAR;Stramenopiles;Ochrophyta;Diatomea;Bacillariophytina;Mediophyceae;Mediopyxis;";"0.0";"0";"1";"1";"0";"1";"0";"457182";"373894"
"V4mis1";"SILVA (only NR);Eukaryota;SAR;Stramenopiles;Ochrophyta;Diatomea;Bacillariophytina;Mediophyceae;Minidiscus;";"0.0";"0";"1";"1";"0";"1";"0";"457182";"373894"
"V4mis1";"SILVA (only NR);Eukaryota;SAR;Stramenopiles;Ochrophyta;Diatomea;Bacillariophytina;Mediophyceae;Minutocellus;";"0.0";"0";"3";"3";"0";"3";"0";"457180";"373894"
"V4mis1";"SILVA (only NR);Eukaryota;SAR;Stramenopiles;Ochrophyta;Diatomea;Bacillariophytina;Mediophyceae;Odontella;";"0.0";"0";"8";"8";"0";"8";"0";"457175";"373894"
"V4mis1";"SILVA (only NR);Eukaryota;SAR;Stramenopiles;Ochrophyta;Diatomea;Bacillariophytina;Mediophyceae;Papiliocellulus;";"0.0";"0";"3";"3";"0";"3";"0";"457180";"373894"
"V4mis1";"SILVA (only NR);Eukaryota;SAR;Stramenopiles;Ochrophyta;Diatomea;Bacillariophytina;Mediophyceae;Plagiogramma;";"0.0";"0";"2";"2";"0";"2";"0";"457181";"373894"
"V4mis1";"SILVA (only NR);Eukaryota;SAR;Stramenopiles;Ochrophyta;Diatomea;Bacillariophytina;Mediophyceae;Plagiogrammopsis;";"0.0";"0";"1";"1";"0";"1";"0";"457182";"373894"
"V4mis1";"SILVA (only NR);Eukaryota;SAR;Stramenopiles;Ochrophyta;Diatomea;Bacillariophytina;Mediophyceae;Planktoniella;";"0.0";"0";"1";"1";"0";"1";"0";"457182";"373894"
"V4mis1";"SILVA (only NR);Eukaryota;SAR;Stramenopiles;Ochrophyta;Diatomea;Bacillariophytina;Mediophyceae;Pleurosira;";"0.0";"0";"2";"2";"0";"2";"0";"457181";"373894"
"V4mis1";"SILVA (only NR);Eukaryota;SAR;Stramenopiles;Ochrophyta;Diatomea;Bacillariophytina;Mediophyceae;Porosira;";"0.0";"0";"4";"4";"0";"4";"0";"457179";"373894"
"V4mis1";"SILVA (only NR);Eukaryota;SAR;Stramenopiles;Ochrophyta;Diatomea;Bacillariophytina;Mediophyceae;Psammogramma;";"0.0";"0";"1";"1";"0";"1";"0";"457182";"373894"
"V4mis1";"SILVA (only NR);Eukaryota;SAR;Stramenopiles;Ochrophyta;Diatomea;Bacillariophytina;Mediophyceae;Psammoneis;";"0.0";"0";"1";"1";"0";"1";"0";"457182";"373894"
"V4mis1";"SILVA (only NR);Eukaryota;SAR;Stramenopiles;Ochrophyta;Diatomea;Bacillariophytina;Mediophyceae;Roundia;";"0.0";"0";"2";"2";"0";"2";"0";"457181";"373894"
"V4mis1";"SILVA (only NR);Eukaryota;SAR;Stramenopiles;Ochrophyta;Diatomea;Bacillariophytina;Mediophyceae;Skeletonema;";"3.4";"18.2";"40";"29";"1";"28";"11";"457154";"373893"
"V4mis1";"SILVA (only NR);Eukaryota;SAR;Stramenopiles;Ochrophyta;Diatomea;Bacillariophytina;Mediophyceae;Stephanodiscus;";"0.0";"0";"4";"4";"0";"4";"0";"457179";"373894"
"V4mis1";"SILVA (only NR);Eukaryota;SAR;Stramenopiles;Ochrophyta;Diatomea;Bacillariophytina;Mediophyceae;Talaroneis;";"0.0";"0";"1";"1";"0";"1";"0";"457182";"373894"
"V4mis1";"SILVA (only NR);Eukaryota;SAR;Stramenopiles;Ochrophyta;Diatomea;Bacillariophytina;Mediophyceae;Terpsinoe;";"0.0";"0";"2";"2";"0";"2";"0";"457181";"373894"
"V4mis1";"SILVA (only NR);Eukaryota;SAR;Stramenopiles;Ochrophyta;Diatomea;Bacillariophytina;Mediophyceae;Thalassiosira;";"2.4";"18.2";"97";"84";"2";"82";"13";"457099";"373892"
"V4mis1";"SILVA (only NR);Eukaryota;SAR;Stramenopiles;Ochrophyta;Diatomea;Bacillariophytina;Mediophyceae;Toxarium;";"0.0";"0";"2";"2";"0";"2";"0";"457181";"373894"
"V4mis1";"SILVA (only NR);Eukaryota;SAR;Stramenopiles;Ochrophyta;Diatomea;Bacillariophytina;Mediophyceae;Triceratium;";"0.0";"0";"5";"5";"0";"5";"0";"457178";"373894"
"V4mis1";"SILVA (only NR);Eukaryota;SAR;Stramenopiles;Ochrophyta;Diatomea;Bacillariophytina;Mediophyceae;uncultured;";"0.0";"0";"6";"6";"0";"6";"0";"457177";"373894"
"V4mis1";"SILVA (only NR);Eukaryota;SAR;Stramenopiles;Ochrophyta;Diatomea;Coscinodiscophytina;";"3.6";"18.2";"256";"253";"9";"244";"3";"456930";"373885"
"V4mis1";"SILVA (only NR);Eukaryota;SAR;Stramenopiles;Ochrophyta;Diatomea;Coscinodiscophytina;Actinocyclus;";"12.5";"18.2";"8";"8";"1";"7";"0";"457175";"373893"
"V4mis1";"SILVA (only NR);Eukaryota;SAR;Stramenopiles;Ochrophyta;Diatomea;Coscinodiscophytina;Actinoptychus;";"33.3";"18.2";"3";"3";"1";"2";"0";"457180";"373893"
"V4mis1";"SILVA (only NR);Eukaryota;SAR;Stramenopiles;Ochrophyta;Diatomea;Coscinodiscophytina;Aulacodiscus;";"0.0";"0";"2";"2";"0";"2";"0";"457181";"373894"
"V4mis1";"SILVA (only NR);Eukaryota;SAR;Stramenopiles;Ochrophyta;Diatomea;Coscinodiscophytina;Corethrids;";"0.0";"0";"4";"4";"0";"4";"0";"457179";"373894"
"V4mis1";"SILVA (only NR);Eukaryota;SAR;Stramenopiles;Ochrophyta;Diatomea;Coscinodiscophytina;Corethrids;Corethron;";"0.0";"0";"4";"4";"0";"4";"0";"457179";"373894"
"V4mis1";"SILVA (only NR);Eukaryota;SAR;Stramenopiles;Ochrophyta;Diatomea;Coscinodiscophytina;Coscinodiscus;";"12.5";"18.2";"8";"8";"1";"7";"0";"457175";"373893"
"V4mis1";"SILVA (only NR);Eukaryota;SAR;Stramenopiles;Ochrophyta;Diatomea;Coscinodiscophytina;Fragilariales;";"0.6";"18.2";"166";"164";"1";"163";"2";"457019";"373893"
"V4mis1";"SILVA (only NR);Eukaryota;SAR;Stramenopiles;Ochrophyta;Diatomea;Coscinodiscophytina;Fragilariales;Ardissonea;";"0.0";"0";"2";"2";"0";"2";"0";"457181";"373894"
"V4mis1";"SILVA (only NR);Eukaryota;SAR;Stramenopiles;Ochrophyta;Diatomea;Coscinodiscophytina;Fragilariales;Astrosyne;";"0.0";"0";"1";"1";"0";"1";"0";"457182";"373894"
"V4mis1";"SILVA (only NR);Eukaryota;SAR;Stramenopiles;Ochrophyta;Diatomea;Coscinodiscophytina;Fragilariales;Berkeleya;";"0.0";"0";"1";"1";"0";"1";"0";"457182";"373894"
"V4mis1";"SILVA (only NR);Eukaryota;SAR;Stramenopiles;Ochrophyta;Diatomea;Coscinodiscophytina;Fragilariales;Catacombas;";"0.0";"0";"1";"1";"0";"1";"0";"457182";"373894"
"V4mis1";"SILVA (only NR);Eukaryota;SAR;Stramenopiles;Ochrophyta;Diatomea;Coscinodiscophytina;Fragilariales;Climacosphenia;";"0.0";"0";"1";"1";"0";"1";"0";"457182";"373894"
"V4mis1";"SILVA (only NR);Eukaryota;SAR;Stramenopiles;Ochrophyta;Diatomea;Coscinodiscophytina;Fragilariales;Cyclophora;";"0.0";"0";"5";"5";"0";"5";"0";"457178";"373894"
"V4mis1";"SILVA (only NR);Eukaryota;SAR;Stramenopiles;Ochrophyta;Diatomea;Coscinodiscophytina;Fragilariales;Falcula;";"0.0";"0";"1";"1";"0";"1";"0";"457182";"373894"
"V4mis1";"SILVA (only NR);Eukaryota;SAR;Stramenopiles;Ochrophyta;Diatomea;Coscinodiscophytina;Fragilariales;Florella;";"0.0";"0";"1";"1";"0";"1";"0";"457182";"373894"
"V4mis1";"SILVA (only NR);Eukaryota;SAR;Stramenopiles;Ochrophyta;Diatomea;Coscinodiscophytina;Fragilariales;Fragilaria;";"5.6";"18.2";"18";"18";"1";"17";"0";"457165";"373893"
"V4mis1";"SILVA (only NR);Eukaryota;SAR;Stramenopiles;Ochrophyta;Diatomea;Coscinodiscophytina;Fragilariales;Fragilariaceae;";"0.0";"0";"2";"2";"0";"2";"0";"457181";"373894"
"V4mis1";"SILVA (only NR);Eukaryota;SAR;Stramenopiles;Ochrophyta;Diatomea;Coscinodiscophytina;Fragilariales;Fragilariaceae;Perideraion;";"0.0";"0";"2";"2";"0";"2";"0";"457181";"373894"
"V4mis1";"SILVA (only NR);Eukaryota;SAR;Stramenopiles;Ochrophyta;Diatomea;Coscinodiscophytina;Fragilariales;Fragilariforma;";"0.0";"0";"1";"1";"0";"1";"0";"457182";"373894"
"V4mis1";"SILVA (only NR);Eukaryota;SAR;Stramenopiles;Ochrophyta;Diatomea;Coscinodiscophytina;Fragilariales;Gedaniella;";"0.0";"0";"1";"1";"0";"1";"0";"457182";"373894"
"V4mis1";"SILVA (only NR);Eukaryota;SAR;Stramenopiles;Ochrophyta;Diatomea;Coscinodiscophytina;Fragilariales;Grammatophora;";"0.0";"0";"3";"3";"0";"3";"0";"457180";"373894"
"V4mis1";"SILVA (only NR);Eukaryota;SAR;Stramenopiles;Ochrophyta;Diatomea;Coscinodiscophytina;Fragilariales;Grammonema;";"0.0";"0";"3";"3";"0";"3";"0";"457180";"373894"
"V4mis1";"SILVA (only NR);Eukaryota;SAR;Stramenopiles;Ochrophyta;Diatomea;Coscinodiscophytina;Fragilariales;Hanicella;";"0.0";"0";"1";"1";"0";"1";"0";"457182";"373894"
"V4mis1";"SILVA (only NR);Eukaryota;SAR;Stramenopiles;Ochrophyta;Diatomea;Coscinodiscophytina;Fragilariales;Hyalosira;";"0.0";"0";"5";"5";"0";"5";"0";"457178";"373894"
"V4mis1";"SILVA (only NR);Eukaryota;SAR;Stramenopiles;Ochrophyta;Diatomea;Coscinodiscophytina;Fragilariales;Hyalosynedra;";"0.0";"0";"2";"2";"0";"2";"0";"457181";"373894"
"V4mis1";"SILVA (only NR);Eukaryota;SAR;Stramenopiles;Ochrophyta;Diatomea;Coscinodiscophytina;Fragilariales;Licmophora;";"0.0";"0";"29";"29";"0";"29";"0";"457154";"373894"
"V4mis1";"SILVA (only NR);Eukaryota;SAR;Stramenopiles;Ochrophyta;Diatomea;Coscinodiscophytina;Fragilariales;Licmosphenia;";"0.0";"0";"1";"1";"0";"1";"0";"457182";"373894"
"V4mis1";"SILVA (only NR);Eukaryota;SAR;Stramenopiles;Ochrophyta;Diatomea;Coscinodiscophytina;Fragilariales;Lucanicum;";"0.0";"0";"1";"1";"0";"1";"0";"457182";"373894"
"V4mis1";"SILVA (only NR);Eukaryota;SAR;Stramenopiles;Ochrophyta;Diatomea;Coscinodiscophytina;Fragilariales;Mastogloia;";"0.0";"0";"1";"1";"0";"1";"0";"457182";"373894"
"V4mis1";"SILVA (only NR);Eukaryota;SAR;Stramenopiles;Ochrophyta;Diatomea;Coscinodiscophytina;Fragilariales;Microtabella;";"0.0";"0";"2";"2";"0";"2";"0";"457181";"373894"
"V4mis1";"SILVA (only NR);Eukaryota;SAR;Stramenopiles;Ochrophyta;Diatomea;Coscinodiscophytina;Fragilariales;Nanofrustulum;";"0.0";"0";"3";"3";"0";"3";"0";"457180";"373894"
"V4mis1";"SILVA (only NR);Eukaryota;SAR;Stramenopiles;Ochrophyta;Diatomea;Coscinodiscophytina;Fragilariales;Opephora;";"0.0";"0";"1";"1";"0";"1";"0";"457182";"373894"
"V4mis1";"SILVA (only NR);Eukaryota;SAR;Stramenopiles;Ochrophyta;Diatomea;Coscinodiscophytina;Fragilariales;Plagiostriata;";"0.0";"0";"3";"3";"0";"3";"0";"457180";"373894"
"V4mis1";"SILVA (only NR);Eukaryota;SAR;Stramenopiles;Ochrophyta;Diatomea;Coscinodiscophytina;Fragilariales;Podocystis;";"0.0";"0";"2";"2";"0";"2";"0";"457181";"373894"
"V4mis1";"SILVA (only NR);Eukaryota;SAR;Stramenopiles;Ochrophyta;Diatomea;Coscinodiscophytina;Fragilariales;Protoraphis;";"0.0";"0";"2";"2";"0";"2";"0";"457181";"373894"
"V4mis1";"SILVA (only NR);Eukaryota;SAR;Stramenopiles;Ochrophyta;Diatomea;Coscinodiscophytina;Fragilariales;Pseudohimantidium;";"0.0";"0";"1";"1";"0";"1";"0";"457182";"373894"
"V4mis1";"SILVA (only NR);Eukaryota;SAR;Stramenopiles;Ochrophyta;Diatomea;Coscinodiscophytina;Fragilariales;Pseudostaurosira;";"0.0";"0";"1";"1";"0";"1";"0";"457182";"373894"
"V4mis1";"SILVA (only NR);Eukaryota;SAR;Stramenopiles;Ochrophyta;Diatomea;Coscinodiscophytina;Fragilariales;Pseudostriatella;";"0.0";"0";"1";"1";"0";"1";"0";"457182";"373894"
"V4mis1";"SILVA (only NR);Eukaryota;SAR;Stramenopiles;Ochrophyta;Diatomea;Coscinodiscophytina;Fragilariales;Pteroncola;";"0.0";"0";"1";"1";"0";"1";"0";"457182";"373894"
"V4mis1";"SILVA (only NR);Eukaryota;SAR;Stramenopiles;Ochrophyta;Diatomea;Coscinodiscophytina;Fragilariales;Rhabdonema;";"0.0";"0";"4";"4";"0";"4";"0";"457179";"373894"
"V4mis1";"SILVA (only NR);Eukaryota;SAR;Stramenopiles;Ochrophyta;Diatomea;Coscinodiscophytina;Fragilariales;Serratifera;";"0.0";"0";"6";"6";"0";"6";"0";"457177";"373894"
"V4mis1";"SILVA (only NR);Eukaryota;SAR;Stramenopiles;Ochrophyta;Diatomea;Coscinodiscophytina;Fragilariales;Stauroforma;";"0.0";"0";"1";"1";"0";"1";"0";"457182";"373894"
"V4mis1";"SILVA (only NR);Eukaryota;SAR;Stramenopiles;Ochrophyta;Diatomea;Coscinodiscophytina;Fragilariales;Staurosira;";"0.0";"0";"14";"14";"0";"14";"0";"457169";"373894"
"V4mis1";"SILVA (only NR);Eukaryota;SAR;Stramenopiles;Ochrophyta;Diatomea;Coscinodiscophytina;Fragilariales;Striatella;";"0.0";"0";"2";"2";"0";"2";"0";"457181";"373894"
"V4mis1";"SILVA (only NR);Eukaryota;SAR;Stramenopiles;Ochrophyta;Diatomea;Coscinodiscophytina;Fragilariales;Synedra;";"0.0";"0";"2";"2";"0";"2";"0";"457181";"373894"
"V4mis1";"SILVA (only NR);Eukaryota;SAR;Stramenopiles;Ochrophyta;Diatomea;Coscinodiscophytina;Fragilariales;Synedropsis;";"0.0";"0";"1";"1";"0";"1";"0";"457182";"373894"
"V4mis1";"SILVA (only NR);Eukaryota;SAR;Stramenopiles;Ochrophyta;Diatomea;Coscinodiscophytina;Fragilariales;Tabularia;";"0.0";"0";"1";"1";"0";"1";"0";"457182";"373894"
"V4mis1";"SILVA (only NR);Eukaryota;SAR;Stramenopiles;Ochrophyta;Diatomea;Coscinodiscophytina;Fragilariales;Thalassionema;";"0.0";"0";"7";"7";"0";"7";"0";"457176";"373894"
"V4mis1";"SILVA (only NR);Eukaryota;SAR;Stramenopiles;Ochrophyta;Diatomea;Coscinodiscophytina;Fragilariales;Ulnaria;";"0.0";"0";"6";"6";"0";"6";"0";"457177";"373894"
"V4mis1";"SILVA (only NR);Eukaryota;SAR;Stramenopiles;Ochrophyta;Diatomea;Coscinodiscophytina;Melosirids;";"0.0";"0";"27";"27";"0";"27";"0";"457156";"373894"
"V4mis1";"SILVA (only NR);Eukaryota;SAR;Stramenopiles;Ochrophyta;Diatomea;Coscinodiscophytina;Melosirids;Aulacoseira;";"0.0";"0";"14";"14";"0";"14";"0";"457169";"373894"
"V4mis1";"SILVA (only NR);Eukaryota;SAR;Stramenopiles;Ochrophyta;Diatomea;Coscinodiscophytina;Melosirids;Endictya;";"0.0";"0";"1";"1";"0";"1";"0";"457182";"373894"
"V4mis1";"SILVA (only NR);Eukaryota;SAR;Stramenopiles;Ochrophyta;Diatomea;Coscinodiscophytina;Melosirids;Hyalodiscus;";"0.0";"0";"2";"2";"0";"2";"0";"457181";"373894"
"V4mis1";"SILVA (only NR);Eukaryota;SAR;Stramenopiles;Ochrophyta;Diatomea;Coscinodiscophytina;Melosirids;Melosira;";"0.0";"0";"4";"4";"0";"4";"0";"457179";"373894"
"V4mis1";"SILVA (only NR);Eukaryota;SAR;Stramenopiles;Ochrophyta;Diatomea;Coscinodiscophytina;Melosirids;Paralia;";"0.0";"0";"3";"3";"0";"3";"0";"457180";"373894"
"V4mis1";"SILVA (only NR);Eukaryota;SAR;Stramenopiles;Ochrophyta;Diatomea;Coscinodiscophytina;Melosirids;Stephanopyxis;";"0.0";"0";"2";"2";"0";"2";"0";"457181";"373894"
"V4mis1";"SILVA (only NR);Eukaryota;SAR;Stramenopiles;Ochrophyta;Diatomea;Coscinodiscophytina;Palmerina;";"0.0";"0";"2";"2";"0";"2";"0";"457181";"373894"
"V4mis1";"SILVA (only NR);Eukaryota;SAR;Stramenopiles;Ochrophyta;Diatomea;Coscinodiscophytina;Rhizosolenids;";"14.8";"18.2";"28";"27";"4";"23";"1";"457156";"373890"
"V4mis1";"SILVA (only NR);Eukaryota;SAR;Stramenopiles;Ochrophyta;Diatomea;Coscinodiscophytina;Rhizosolenids;Guinardia;";"20.0";"18.2";"6";"5";"1";"4";"1";"457178";"373893"
"V4mis1";"SILVA (only NR);Eukaryota;SAR;Stramenopiles;Ochrophyta;Diatomea;Coscinodiscophytina;Rhizosolenids;Leptocylindrus;";"0.0";"0";"4";"4";"0";"4";"0";"457179";"373894"
"V4mis1";"SILVA (only NR);Eukaryota;SAR;Stramenopiles;Ochrophyta;Diatomea;Coscinodiscophytina;Rhizosolenids;Proboscia;";"0.0";"0";"5";"5";"0";"5";"0";"457178";"373894"
"V4mis1";"SILVA (only NR);Eukaryota;SAR;Stramenopiles;Ochrophyta;Diatomea;Coscinodiscophytina;Rhizosolenids;Pseudosolenia;";"100.0";"18.2";"2";"2";"2";"0";"0";"457181";"373892"
"V4mis1";"SILVA (only NR);Eukaryota;SAR;Stramenopiles;Ochrophyta;Diatomea;Coscinodiscophytina;Rhizosolenids;Rhizosolenia;";"0.0";"0";"6";"6";"0";"6";"0";"457177";"373894"
"V4mis1";"SILVA (only NR);Eukaryota;SAR;Stramenopiles;Ochrophyta;Diatomea;Coscinodiscophytina;Rhizosolenids;Tenuicylindrus;";"0.0";"0";"1";"1";"0";"1";"0";"457182";"373894"
"V4mis1";"SILVA (only NR);Eukaryota;SAR;Stramenopiles;Ochrophyta;Diatomea;Coscinodiscophytina;uncultured;";"0.0";"0";"3";"3";"0";"3";"0";"457180";"373894"
"V4mis1";"SILVA (only NR);Eukaryota;SAR;Stramenopiles;Ochrophyta;Diatomea;ME-Euk-FW10;";"0.0";"0";"22";"21";"0";"21";"1";"457162";"373894"
"V4mis1";"SILVA (only NR);Eukaryota;SAR;Stramenopiles;Ochrophyta;Dictyochophyceae;";"59.3";"18.2";"55";"54";"32";"22";"1";"457129";"373862"
"V4mis1";"SILVA (only NR);Eukaryota;SAR;Stramenopiles;Ochrophyta;Dictyochophyceae;Dictyochales;";"0.0";"0";"11";"11";"0";"11";"0";"457172";"373894"
"V4mis1";"SILVA (only NR);Eukaryota;SAR;Stramenopiles;Ochrophyta;Dictyochophyceae;Dictyochales;Dictyocha;";"0.0";"0";"5";"5";"0";"5";"0";"457178";"373894"
"V4mis1";"SILVA (only NR);Eukaryota;SAR;Stramenopiles;Ochrophyta;Dictyochophyceae;Dictyochales;Florenciella;";"0.0";"0";"6";"6";"0";"6";"0";"457177";"373894"
"V4mis1";"SILVA (only NR);Eukaryota;SAR;Stramenopiles;Ochrophyta;Dictyochophyceae;Florenciellales;";"0.0";"0";"2";"2";"0";"2";"0";"457181";"373894"
"V4mis1";"SILVA (only NR);Eukaryota;SAR;Stramenopiles;Ochrophyta;Dictyochophyceae;Florenciellales;Pseudochattonella;";"0.0";"0";"2";"2";"0";"2";"0";"457181";"373894"
"V4mis1";"SILVA (only NR);Eukaryota;SAR;Stramenopiles;Ochrophyta;Dictyochophyceae;Pedinellales;";"87.1";"18.2";"31";"31";"27";"4";"0";"457152";"373867"
"V4mis1";"SILVA (only NR);Eukaryota;SAR;Stramenopiles;Ochrophyta;Dictyochophyceae;Pedinellales;Ciliophrys;";"33.3";"18.2";"3";"3";"1";"2";"0";"457180";"373893"
"V4mis1";"SILVA (only NR);Eukaryota;SAR;Stramenopiles;Ochrophyta;Dictyochophyceae;Pedinellales;FV36-2G08;";"75.0";"18.2";"4";"4";"3";"1";"0";"457179";"373891"
"V4mis1";"SILVA (only NR);Eukaryota;SAR;Stramenopiles;Ochrophyta;Dictyochophyceae;Pedinellales;Helicopedinella;";"0.0";"0";"1";"1";"0";"1";"0";"457182";"373894"
"V4mis1";"SILVA (only NR);Eukaryota;SAR;Stramenopiles;Ochrophyta;Dictyochophyceae;Pedinellales;Pedinella;";"100.0";"18.2";"2";"2";"2";"0";"0";"457181";"373892"
"V4mis1";"SILVA (only NR);Eukaryota;SAR;Stramenopiles;Ochrophyta;Dictyochophyceae;Pedinellales;Pseudopedinella;";"100.0";"18.2";"6";"6";"6";"0";"0";"457177";"373888"
"V4mis1";"SILVA (only NR);Eukaryota;SAR;Stramenopiles;Ochrophyta;Dictyochophyceae;Pedinellales;Pteridomonas;";"100.0";"18.2";"6";"6";"6";"0";"0";"457177";"373888"
"V4mis1";"SILVA (only NR);Eukaryota;SAR;Stramenopiles;Ochrophyta;Dictyochophyceae;Rhizochromulinales;";"100.0";"18.2";"3";"3";"3";"0";"0";"457180";"373891"
"V4mis1";"SILVA (only NR);Eukaryota;SAR;Stramenopiles;Ochrophyta;Dictyochophyceae;Rhizochromulinales;Rhizochromulina;";"100.0";"18.2";"3";"3";"3";"0";"0";"457180";"373891"
"V4mis1";"SILVA (only NR);Eukaryota;SAR;Stramenopiles;Ochrophyta;Eustigmatophyceae;";"0.0";"0";"56";"55";"0";"55";"1";"457128";"373894"
"V4mis1";"SILVA (only NR);Eukaryota;SAR;Stramenopiles;Ochrophyta;Eustigmatophyceae;Eustigmatales;";"0.0";"0";"56";"55";"0";"55";"1";"457128";"373894"
"V4mis1";"SILVA (only NR);Eukaryota;SAR;Stramenopiles;Ochrophyta;Eustigmatophyceae;Eustigmatales;Characiopsis;";"0.0";"0";"1";"1";"0";"1";"0";"457182";"373894"
"V4mis1";"SILVA (only NR);Eukaryota;SAR;Stramenopiles;Ochrophyta;Eustigmatophyceae;Eustigmatales;Chlorobotrys;";"0.0";"0";"1";"1";"0";"1";"0";"457182";"373894"
"V4mis1";"SILVA (only NR);Eukaryota;SAR;Stramenopiles;Ochrophyta;Eustigmatophyceae;Eustigmatales;Goniochloris;";"0.0";"0";"5";"5";"0";"5";"0";"457178";"373894"
"V4mis1";"SILVA (only NR);Eukaryota;SAR;Stramenopiles;Ochrophyta;Eustigmatophyceae;Eustigmatales;Monodus;";"0.0";"0";"1";"1";"0";"1";"0";"457182";"373894"
"V4mis1";"SILVA (only NR);Eukaryota;SAR;Stramenopiles;Ochrophyta;Eustigmatophyceae;Eustigmatales;Nannochloropsis;";"0.0";"0";"15";"14";"0";"14";"1";"457169";"373894"
"V4mis1";"SILVA (only NR);Eukaryota;SAR;Stramenopiles;Ochrophyta;Eustigmatophyceae;Eustigmatales;Pseudocharaciopsis;";"0.0";"0";"2";"2";"0";"2";"0";"457181";"373894"
"V4mis1";"SILVA (only NR);Eukaryota;SAR;Stramenopiles;Ochrophyta;Eustigmatophyceae;Eustigmatales;Pseudostaurastrum;";"0.0";"0";"4";"4";"0";"4";"0";"457179";"373894"
"V4mis1";"SILVA (only NR);Eukaryota;SAR;Stramenopiles;Ochrophyta;Eustigmatophyceae;Eustigmatales;Tetraedriella;";"0.0";"0";"1";"1";"0";"1";"0";"457182";"373894"
"V4mis1";"SILVA (only NR);Eukaryota;SAR;Stramenopiles;Ochrophyta;Eustigmatophyceae;Eustigmatales;Trachydiscus;";"0.0";"0";"2";"2";"0";"2";"0";"457181";"373894"
"V4mis1";"SILVA (only NR);Eukaryota;SAR;Stramenopiles;Ochrophyta;Eustigmatophyceae;Eustigmatales;Vacuoliviride;";"0.0";"0";"1";"1";"0";"1";"0";"457182";"373894"
"V4mis1";"SILVA (only NR);Eukaryota;SAR;Stramenopiles;Ochrophyta;Eustigmatophyceae;Eustigmatales;Vischeria;";"0.0";"0";"1";"1";"0";"1";"0";"457182";"373894"
"V4mis1";"SILVA (only NR);Eukaryota;SAR;Stramenopiles;Ochrophyta;Eustigmatophyceae;Eustigmatales;phytoplankton;";"0.0";"0";"1";"1";"0";"1";"0";"457182";"373894"
"V4mis1";"SILVA (only NR);Eukaryota;SAR;Stramenopiles;Ochrophyta;Eustigmatophyceae;Eustigmatales;uncultured;";"0.0";"0";"7";"7";"0";"7";"0";"457176";"373894"
"V4mis1";"SILVA (only NR);Eukaryota;SAR;Stramenopiles;Ochrophyta;Incertae Sedis;";"0.0";"0";"1";"1";"0";"1";"0";"457182";"373894"
"V4mis1";"SILVA (only NR);Eukaryota;SAR;Stramenopiles;Ochrophyta;Incertae Sedis;Picophagus;";"0.0";"0";"1";"1";"0";"1";"0";"457182";"373894"
"V4mis1";"SILVA (only NR);Eukaryota;SAR;Stramenopiles;Ochrophyta;MOCH-2;";"0.0";"0";"4";"4";"0";"4";"0";"457179";"373894"
"V4mis1";"SILVA (only NR);Eukaryota;SAR;Stramenopiles;Ochrophyta;Pelagophyceae;";"0.0";"0";"38";"38";"0";"38";"0";"457145";"373894"
"V4mis1";"SILVA (only NR);Eukaryota;SAR;Stramenopiles;Ochrophyta;Pelagophyceae;Pelagomonadales;";"0.0";"0";"9";"9";"0";"9";"0";"457174";"373894"
"V4mis1";"SILVA (only NR);Eukaryota;SAR;Stramenopiles;Ochrophyta;Pelagophyceae;Pelagomonadales;Aureococcus;";"0.0";"0";"5";"5";"0";"5";"0";"457178";"373894"
"V4mis1";"SILVA (only NR);Eukaryota;SAR;Stramenopiles;Ochrophyta;Pelagophyceae;Pelagomonadales;Pelagomonas;";"0.0";"0";"1";"1";"0";"1";"0";"457182";"373894"
"V4mis1";"SILVA (only NR);Eukaryota;SAR;Stramenopiles;Ochrophyta;Pelagophyceae;Sarcinochrysidales;";"0.0";"0";"27";"27";"0";"27";"0";"457156";"373894"
"V4mis1";"SILVA (only NR);Eukaryota;SAR;Stramenopiles;Ochrophyta;Pelagophyceae;Sarcinochrysidales;Andersenia;";"0.0";"0";"1";"1";"0";"1";"0";"457182";"373894"
"V4mis1";"SILVA (only NR);Eukaryota;SAR;Stramenopiles;Ochrophyta;Pelagophyceae;Sarcinochrysidales;Ankylochrisis;";"0.0";"0";"6";"6";"0";"6";"0";"457177";"373894"
"V4mis1";"SILVA (only NR);Eukaryota;SAR;Stramenopiles;Ochrophyta;Pelagophyceae;Sarcinochrysidales;Aureoumbra;";"0.0";"0";"6";"6";"0";"6";"0";"457177";"373894"
"V4mis1";"SILVA (only NR);Eukaryota;SAR;Stramenopiles;Ochrophyta;Pelagophyceae;Sarcinochrysidales;Chrysophaeum;";"0.0";"0";"1";"1";"0";"1";"0";"457182";"373894"
"V4mis1";"SILVA (only NR);Eukaryota;SAR;Stramenopiles;Ochrophyta;Pelagophyceae;Sarcinochrysidales;SS1-E01-69;";"0.0";"0";"4";"4";"0";"4";"0";"457179";"373894"
"V4mis1";"SILVA (only NR);Eukaryota;SAR;Stramenopiles;Ochrophyta;Pelagophyceae;Sarcinochrysidales;Sarcinochrysis;";"0.0";"0";"5";"5";"0";"5";"0";"457178";"373894"
"V4mis1";"SILVA (only NR);Eukaryota;SAR;Stramenopiles;Ochrophyta;Phaeophyceae;";"0.0";"0";"66";"65";"0";"65";"1";"457118";"373894"
"V4mis1";"SILVA (only NR);Eukaryota;SAR;Stramenopiles;Ochrophyta;Phaeophyceae;Chorda;";"0.0";"0";"1";"1";"0";"1";"0";"457182";"373894"
"V4mis1";"SILVA (only NR);Eukaryota;SAR;Stramenopiles;Ochrophyta;Phaeophyceae;Desmarestiales;";"0.0";"0";"1";"1";"0";"1";"0";"457182";"373894"
"V4mis1";"SILVA (only NR);Eukaryota;SAR;Stramenopiles;Ochrophyta;Phaeophyceae;Desmarestiales;Desmarestia;";"0.0";"0";"1";"1";"0";"1";"0";"457182";"373894"
"V4mis1";"SILVA (only NR);Eukaryota;SAR;Stramenopiles;Ochrophyta;Phaeophyceae;Dictyotales;";"0.0";"0";"23";"23";"0";"23";"0";"457160";"373894"
"V4mis1";"SILVA (only NR);Eukaryota;SAR;Stramenopiles;Ochrophyta;Phaeophyceae;Dictyotales;Dictyopteris;";"0.0";"0";"2";"2";"0";"2";"0";"457181";"373894"
"V4mis1";"SILVA (only NR);Eukaryota;SAR;Stramenopiles;Ochrophyta;Phaeophyceae;Dictyotales;Dictyota;";"0.0";"0";"1";"1";"0";"1";"0";"457182";"373894"
"V4mis1";"SILVA (only NR);Eukaryota;SAR;Stramenopiles;Ochrophyta;Phaeophyceae;Dictyotales;Distromium;";"0.0";"0";"2";"2";"0";"2";"0";"457181";"373894"
"V4mis1";"SILVA (only NR);Eukaryota;SAR;Stramenopiles;Ochrophyta;Phaeophyceae;Dictyotales;Exallosorus;";"0.0";"0";"2";"2";"0";"2";"0";"457181";"373894"
"V4mis1";"SILVA (only NR);Eukaryota;SAR;Stramenopiles;Ochrophyta;Phaeophyceae;Dictyotales;Lobophora;";"0.0";"0";"1";"1";"0";"1";"0";"457182";"373894"
"V4mis1";"SILVA (only NR);Eukaryota;SAR;Stramenopiles;Ochrophyta;Phaeophyceae;Dictyotales;Lobospira;";"0.0";"0";"1";"1";"0";"1";"0";"457182";"373894"
"V4mis1";"SILVA (only NR);Eukaryota;SAR;Stramenopiles;Ochrophyta;Phaeophyceae;Dictyotales;Newhousia;";"0.0";"0";"1";"1";"0";"1";"0";"457182";"373894"
"V4mis1";"SILVA (only NR);Eukaryota;SAR;Stramenopiles;Ochrophyta;Phaeophyceae;Dictyotales;Padina;";"0.0";"0";"7";"7";"0";"7";"0";"457176";"373894"
"V4mis1";"SILVA (only NR);Eukaryota;SAR;Stramenopiles;Ochrophyta;Phaeophyceae;Dictyotales;Rugulopteryx;";"0.0";"0";"1";"1";"0";"1";"0";"457182";"373894"
"V4mis1";"SILVA (only NR);Eukaryota;SAR;Stramenopiles;Ochrophyta;Phaeophyceae;Dictyotales;Zonaria;";"0.0";"0";"4";"4";"0";"4";"0";"457179";"373894"
"V4mis1";"SILVA (only NR);Eukaryota;SAR;Stramenopiles;Ochrophyta;Phaeophyceae;Ectocarpales;";"0.0";"0";"21";"20";"0";"20";"1";"457163";"373894"
"V4mis1";"SILVA (only NR);Eukaryota;SAR;Stramenopiles;Ochrophyta;Phaeophyceae;Ectocarpales;Asterocladon;";"0.0";"0";"2";"2";"0";"2";"0";"457181";"373894"
"V4mis1";"SILVA (only NR);Eukaryota;SAR;Stramenopiles;Ochrophyta;Phaeophyceae;Ectocarpales;Ectocarpus;";"0.0";"0";"1";"1";"0";"1";"0";"457182";"373894"
"V4mis1";"SILVA (only NR);Eukaryota;SAR;Stramenopiles;Ochrophyta;Phaeophyceae;Ectocarpales;Halothrix;";"0.0";"0";"1";"1";"0";"1";"0";"457182";"373894"
"V4mis1";"SILVA (only NR);Eukaryota;SAR;Stramenopiles;Ochrophyta;Phaeophyceae;Ectocarpales;Heribaudiella;";"0.0";"0";"1";"1";"0";"1";"0";"457182";"373894"
"V4mis1";"SILVA (only NR);Eukaryota;SAR;Stramenopiles;Ochrophyta;Phaeophyceae;Ectocarpales;Ishige;";"0.0";"0";"2";"1";"0";"1";"1";"457182";"373894"
"V4mis1";"SILVA (only NR);Eukaryota;SAR;Stramenopiles;Ochrophyta;Phaeophyceae;Ectocarpales;Papenfussiella;";"0.0";"0";"1";"1";"0";"1";"0";"457182";"373894"
"V4mis1";"SILVA (only NR);Eukaryota;SAR;Stramenopiles;Ochrophyta;Phaeophyceae;Ectocarpales;Petalonia;";"0.0";"0";"1";"1";"0";"1";"0";"457182";"373894"
"V4mis1";"SILVA (only NR);Eukaryota;SAR;Stramenopiles;Ochrophyta;Phaeophyceae;Ectocarpales;Phaeostrophion;";"0.0";"0";"1";"1";"0";"1";"0";"457182";"373894"
"V4mis1";"SILVA (only NR);Eukaryota;SAR;Stramenopiles;Ochrophyta;Phaeophyceae;Ectocarpales;Porterinema;";"0.0";"0";"1";"1";"0";"1";"0";"457182";"373894"
"V4mis1";"SILVA (only NR);Eukaryota;SAR;Stramenopiles;Ochrophyta;Phaeophyceae;Ectocarpales;Pylaiella;";"0.0";"0";"2";"2";"0";"2";"0";"457181";"373894"
"V4mis1";"SILVA (only NR);Eukaryota;SAR;Stramenopiles;Ochrophyta;Phaeophyceae;Ectocarpales;Scytosiphon;";"0.0";"0";"2";"2";"0";"2";"0";"457181";"373894"
"V4mis1";"SILVA (only NR);Eukaryota;SAR;Stramenopiles;Ochrophyta;Phaeophyceae;Ectocarpales;Stschapovia;";"0.0";"0";"1";"1";"0";"1";"0";"457182";"373894"
"V4mis1";"SILVA (only NR);Eukaryota;SAR;Stramenopiles;Ochrophyta;Phaeophyceae;Ectocarpales;Tribonema;";"0.0";"0";"1";"1";"0";"1";"0";"457182";"373894"
"V4mis1";"SILVA (only NR);Eukaryota;SAR;Stramenopiles;Ochrophyta;Phaeophyceae;Fucales;";"0.0";"0";"9";"9";"0";"9";"0";"457174";"373894"
"V4mis1";"SILVA (only NR);Eukaryota;SAR;Stramenopiles;Ochrophyta;Phaeophyceae;Fucales;Coccophora;";"0.0";"0";"1";"1";"0";"1";"0";"457182";"373894"
"V4mis1";"SILVA (only NR);Eukaryota;SAR;Stramenopiles;Ochrophyta;Phaeophyceae;Fucales;Cystoseira;";"0.0";"0";"1";"1";"0";"1";"0";"457182";"373894"
"V4mis1";"SILVA (only NR);Eukaryota;SAR;Stramenopiles;Ochrophyta;Phaeophyceae;Fucales;Fucus;";"0.0";"0";"1";"1";"0";"1";"0";"457182";"373894"
"V4mis1";"SILVA (only NR);Eukaryota;SAR;Stramenopiles;Ochrophyta;Phaeophyceae;Fucales;Sargassum;";"0.0";"0";"5";"5";"0";"5";"0";"457178";"373894"
"V4mis1";"SILVA (only NR);Eukaryota;SAR;Stramenopiles;Ochrophyta;Phaeophyceae;Fucales;Silvetia;";"0.0";"0";"1";"1";"0";"1";"0";"457182";"373894"
"V4mis1";"SILVA (only NR);Eukaryota;SAR;Stramenopiles;Ochrophyta;Phaeophyceae;Laminariales;";"0.0";"0";"3";"3";"0";"3";"0";"457180";"373894"
"V4mis1";"SILVA (only NR);Eukaryota;SAR;Stramenopiles;Ochrophyta;Phaeophyceae;Laminariales;Akkesiphycus;";"0.0";"0";"1";"1";"0";"1";"0";"457182";"373894"
"V4mis1";"SILVA (only NR);Eukaryota;SAR;Stramenopiles;Ochrophyta;Phaeophyceae;Laminariales;Lessonia;";"0.0";"0";"2";"2";"0";"2";"0";"457181";"373894"
"V4mis1";"SILVA (only NR);Eukaryota;SAR;Stramenopiles;Ochrophyta;Phaeophyceae;Sphacelariales;";"0.0";"0";"2";"2";"0";"2";"0";"457181";"373894"
"V4mis1";"SILVA (only NR);Eukaryota;SAR;Stramenopiles;Ochrophyta;Phaeophyceae;Sphacelariales;Choristocarpus;";"0.0";"0";"1";"1";"0";"1";"0";"457182";"373894"
"V4mis1";"SILVA (only NR);Eukaryota;SAR;Stramenopiles;Ochrophyta;Phaeophyceae;Sphacelariales;Discosporangium;";"0.0";"0";"1";"1";"0";"1";"0";"457182";"373894"
"V4mis1";"SILVA (only NR);Eukaryota;SAR;Stramenopiles;Ochrophyta;Phaeophyceae;Tilopteridales;";"0.0";"0";"3";"3";"0";"3";"0";"457180";"373894"
"V4mis1";"SILVA (only NR);Eukaryota;SAR;Stramenopiles;Ochrophyta;Phaeophyceae;Tilopteridales;Phaeosiphoniella;";"0.0";"0";"1";"1";"0";"1";"0";"457182";"373894"
"V4mis1";"SILVA (only NR);Eukaryota;SAR;Stramenopiles;Ochrophyta;Phaeophyceae;Tilopteridales;Saccorhiza;";"0.0";"0";"1";"1";"0";"1";"0";"457182";"373894"
"V4mis1";"SILVA (only NR);Eukaryota;SAR;Stramenopiles;Ochrophyta;Phaeophyceae;Tilopteridales;Tilopteris;";"0.0";"0";"1";"1";"0";"1";"0";"457182";"373894"
"V4mis1";"SILVA (only NR);Eukaryota;SAR;Stramenopiles;Ochrophyta;Phaeothamniophyceae;";"0.0";"0";"8";"8";"0";"8";"0";"457175";"373894"
"V4mis1";"SILVA (only NR);Eukaryota;SAR;Stramenopiles;Ochrophyta;Phaeothamniophyceae;Phaeothamniales;";"0.0";"0";"4";"4";"0";"4";"0";"457179";"373894"
"V4mis1";"SILVA (only NR);Eukaryota;SAR;Stramenopiles;Ochrophyta;Phaeothamniophyceae;Phaeothamniales;Phaeothamnion;";"0.0";"0";"1";"1";"0";"1";"0";"457182";"373894"
"V4mis1";"SILVA (only NR);Eukaryota;SAR;Stramenopiles;Ochrophyta;Phaeothamniophyceae;Phaeothamniales;Stichogloea;";"0.0";"0";"1";"1";"0";"1";"0";"457182";"373894"
"V4mis1";"SILVA (only NR);Eukaryota;SAR;Stramenopiles;Ochrophyta;Phaeothamniophyceae;Pleurochloridales;";"0.0";"0";"4";"4";"0";"4";"0";"457179";"373894"
"V4mis1";"SILVA (only NR);Eukaryota;SAR;Stramenopiles;Ochrophyta;Phaeothamniophyceae;Pleurochloridales;Phaeobotrys;";"0.0";"0";"1";"1";"0";"1";"0";"457182";"373894"
"V4mis1";"SILVA (only NR);Eukaryota;SAR;Stramenopiles;Ochrophyta;Phaeothamniophyceae;Pleurochloridales;Pleurochloridella;";"0.0";"0";"2";"2";"0";"2";"0";"457181";"373894"
"V4mis1";"SILVA (only NR);Eukaryota;SAR;Stramenopiles;Ochrophyta;Phaeothamniophyceae;Pleurochloridales;Tetrasporopsis;";"0.0";"0";"1";"1";"0";"1";"0";"457182";"373894"
"V4mis1";"SILVA (only NR);Eukaryota;SAR;Stramenopiles;Ochrophyta;Pinguiophyceae;";"0.0";"0";"6";"6";"0";"6";"0";"457177";"373894"
"V4mis1";"SILVA (only NR);Eukaryota;SAR;Stramenopiles;Ochrophyta;Pinguiophyceae;Pinguiochrysidales;";"0.0";"0";"6";"6";"0";"6";"0";"457177";"373894"
"V4mis1";"SILVA (only NR);Eukaryota;SAR;Stramenopiles;Ochrophyta;Pinguiophyceae;Pinguiochrysidales;Glossomastix;";"0.0";"0";"1";"1";"0";"1";"0";"457182";"373894"
"V4mis1";"SILVA (only NR);Eukaryota;SAR;Stramenopiles;Ochrophyta;Pinguiophyceae;Pinguiochrysidales;Phaeomonas;";"0.0";"0";"2";"2";"0";"2";"0";"457181";"373894"
"V4mis1";"SILVA (only NR);Eukaryota;SAR;Stramenopiles;Ochrophyta;Pinguiophyceae;Pinguiochrysidales;Pinguiochrysis;";"0.0";"0";"1";"1";"0";"1";"0";"457182";"373894"
"V4mis1";"SILVA (only NR);Eukaryota;SAR;Stramenopiles;Ochrophyta;Pinguiophyceae;Pinguiochrysidales;Pinguiococcus;";"0.0";"0";"1";"1";"0";"1";"0";"457182";"373894"
"V4mis1";"SILVA (only NR);Eukaryota;SAR;Stramenopiles;Ochrophyta;Pinguiophyceae;Pinguiochrysidales;Polypodochrysis;";"0.0";"0";"1";"1";"0";"1";"0";"457182";"373894"
"V4mis1";"SILVA (only NR);Eukaryota;SAR;Stramenopiles;Ochrophyta;Raphidophyceae;";"0.0";"0";"23";"20";"0";"20";"3";"457163";"373894"
"V4mis1";"SILVA (only NR);Eukaryota;SAR;Stramenopiles;Ochrophyta;Raphidophyceae;Chattonellales;";"0.0";"0";"18";"16";"0";"16";"2";"457167";"373894"
"V4mis1";"SILVA (only NR);Eukaryota;SAR;Stramenopiles;Ochrophyta;Raphidophyceae;Chattonellales;Chattonella;";"0.0";"0";"2";"2";"0";"2";"0";"457181";"373894"
"V4mis1";"SILVA (only NR);Eukaryota;SAR;Stramenopiles;Ochrophyta;Raphidophyceae;Chattonellales;Chloromorum;";"0.0";"0";"2";"2";"0";"2";"0";"457181";"373894"
"V4mis1";"SILVA (only NR);Eukaryota;SAR;Stramenopiles;Ochrophyta;Raphidophyceae;Chattonellales;Fibrocapsa;";"0.0";"0";"1";"1";"0";"1";"0";"457182";"373894"
"V4mis1";"SILVA (only NR);Eukaryota;SAR;Stramenopiles;Ochrophyta;Raphidophyceae;Chattonellales;Gonyostomum;";"0.0";"0";"1";"1";"0";"1";"0";"457182";"373894"
"V4mis1";"SILVA (only NR);Eukaryota;SAR;Stramenopiles;Ochrophyta;Raphidophyceae;Chattonellales;Haramonas;";"0.0";"0";"3";"3";"0";"3";"0";"457180";"373894"
"V4mis1";"SILVA (only NR);Eukaryota;SAR;Stramenopiles;Ochrophyta;Raphidophyceae;Chattonellales;Heterosigma;";"0.0";"0";"1";"1";"0";"1";"0";"457182";"373894"
"V4mis1";"SILVA (only NR);Eukaryota;SAR;Stramenopiles;Ochrophyta;Raphidophyceae;Chattonellales;Isonoura-2009;";"0.0";"0";"2";"2";"0";"2";"0";"457181";"373894"
"V4mis1";"SILVA (only NR);Eukaryota;SAR;Stramenopiles;Ochrophyta;Raphidophyceae;Chattonellales;Merotricha;";"0.0";"0";"1";"1";"0";"1";"0";"457182";"373894"
"V4mis1";"SILVA (only NR);Eukaryota;SAR;Stramenopiles;Ochrophyta;Raphidophyceae;Chattonellales;Psammamonas;";"0.0";"0";"1";"1";"0";"1";"0";"457182";"373894"
"V4mis1";"SILVA (only NR);Eukaryota;SAR;Stramenopiles;Ochrophyta;Raphidophyceae;Chattonellales;Vacuolaria;";"0.0";"0";"1";"1";"0";"1";"0";"457182";"373894"
"V4mis1";"SILVA (only NR);Eukaryota;SAR;Stramenopiles;Ochrophyta;Raphidophyceae;Chattonellales;Viridilobus;";"0.0";"0";"1";"1";"0";"1";"0";"457182";"373894"
"V4mis1";"SILVA (only NR);Eukaryota;SAR;Stramenopiles;Ochrophyta;Raphidophyceae;Olisthodiscus;";"0.0";"0";"2";"2";"0";"2";"0";"457181";"373894"
"V4mis1";"SILVA (only NR);Eukaryota;SAR;Stramenopiles;Ochrophyta;Schizocladiophyceae;";"0.0";"0";"1";"1";"0";"1";"0";"457182";"373894"
"V4mis1";"SILVA (only NR);Eukaryota;SAR;Stramenopiles;Ochrophyta;Schizocladiophyceae;Schizocladia;";"0.0";"0";"1";"1";"0";"1";"0";"457182";"373894"
"V4mis1";"SILVA (only NR);Eukaryota;SAR;Stramenopiles;Ochrophyta;Synchromophyceae;";"0.0";"0";"4";"4";"0";"4";"0";"457179";"373894"
"V4mis1";"SILVA (only NR);Eukaryota;SAR;Stramenopiles;Ochrophyta;Synchromophyceae;Synchroma;";"0.0";"0";"4";"4";"0";"4";"0";"457179";"373894"
"V4mis1";"SILVA (only NR);Eukaryota;SAR;Stramenopiles;Ochrophyta;Xanthophyceae;";"0.0";"0";"36";"36";"0";"36";"0";"457147";"373894"
"V4mis1";"SILVA (only NR);Eukaryota;SAR;Stramenopiles;Ochrophyta;Xanthophyceae;Mischococcales;";"0.0";"0";"12";"12";"0";"12";"0";"457171";"373894"
"V4mis1";"SILVA (only NR);Eukaryota;SAR;Stramenopiles;Ochrophyta;Xanthophyceae;Mischococcales;Botrydiopsis;";"0.0";"0";"3";"3";"0";"3";"0";"457180";"373894"
"V4mis1";"SILVA (only NR);Eukaryota;SAR;Stramenopiles;Ochrophyta;Xanthophyceae;Mischococcales;Bumilleriopsis;";"0.0";"0";"2";"2";"0";"2";"0";"457181";"373894"
"V4mis1";"SILVA (only NR);Eukaryota;SAR;Stramenopiles;Ochrophyta;Xanthophyceae;Mischococcales;Chlorellidium;";"0.0";"0";"2";"2";"0";"2";"0";"457181";"373894"
"V4mis1";"SILVA (only NR);Eukaryota;SAR;Stramenopiles;Ochrophyta;Xanthophyceae;Mischococcales;Mischococcus;";"0.0";"0";"1";"1";"0";"1";"0";"457182";"373894"
"V4mis1";"SILVA (only NR);Eukaryota;SAR;Stramenopiles;Ochrophyta;Xanthophyceae;Mischococcales;Pleurochloris;";"0.0";"0";"1";"1";"0";"1";"0";"457182";"373894"
"V4mis1";"SILVA (only NR);Eukaryota;SAR;Stramenopiles;Ochrophyta;Xanthophyceae;Mischococcales;Pseudopleurochloris;";"0.0";"0";"1";"1";"0";"1";"0";"457182";"373894"
"V4mis1";"SILVA (only NR);Eukaryota;SAR;Stramenopiles;Ochrophyta;Xanthophyceae;Mischococcales;Sphaerosorus;";"0.0";"0";"1";"1";"0";"1";"0";"457182";"373894"
"V4mis1";"SILVA (only NR);Eukaryota;SAR;Stramenopiles;Ochrophyta;Xanthophyceae;Tribonematales;";"0.0";"0";"11";"11";"0";"11";"0";"457172";"373894"
"V4mis1";"SILVA (only NR);Eukaryota;SAR;Stramenopiles;Ochrophyta;Xanthophyceae;Tribonematales;Asterosiphon;";"0.0";"0";"1";"1";"0";"1";"0";"457182";"373894"
"V4mis1";"SILVA (only NR);Eukaryota;SAR;Stramenopiles;Ochrophyta;Xanthophyceae;Tribonematales;Botrydium;";"0.0";"0";"2";"2";"0";"2";"0";"457181";"373894"
"V4mis1";"SILVA (only NR);Eukaryota;SAR;Stramenopiles;Ochrophyta;Xanthophyceae;Tribonematales;Ophiocytium;";"0.0";"0";"3";"3";"0";"3";"0";"457180";"373894"
"V4mis1";"SILVA (only NR);Eukaryota;SAR;Stramenopiles;Ochrophyta;Xanthophyceae;Tribonematales;Tribonema;";"0.0";"0";"3";"3";"0";"3";"0";"457180";"373894"
"V4mis1";"SILVA (only NR);Eukaryota;SAR;Stramenopiles;Ochrophyta;Xanthophyceae;Tribonematales;Xanthonema;";"0.0";"0";"1";"1";"0";"1";"0";"457182";"373894"
"V4mis1";"SILVA (only NR);Eukaryota;SAR;Stramenopiles;Ochrophyta;Xanthophyceae;Vaucheriales;";"0.0";"0";"2";"2";"0";"2";"0";"457181";"373894"
"V4mis1";"SILVA (only NR);Eukaryota;SAR;Stramenopiles;Ochrophyta;Xanthophyceae;Vaucheriales;Vaucheria;";"0.0";"0";"2";"2";"0";"2";"0";"457181";"373894"
"V4mis1";"SILVA (only NR);Eukaryota;SAR;Stramenopiles;Ochrophyta;Xanthophyceae;uncultured;";"0.0";"0";"2";"2";"0";"2";"0";"457181";"373894"
"V4mis1";"SILVA (only NR);Eukaryota;SAR;Stramenopiles;Opalinata;";"0.0";"0";"5";"5";"0";"5";"0";"457178";"373894"
"V4mis1";"SILVA (only NR);Eukaryota;SAR;Stramenopiles;Opalinata;Opalinea;";"0.0";"0";"1";"1";"0";"1";"0";"457182";"373894"
"V4mis1";"SILVA (only NR);Eukaryota;SAR;Stramenopiles;Opalinata;Opalinea;Protoopalina;";"0.0";"0";"1";"1";"0";"1";"0";"457182";"373894"
"V4mis1";"SILVA (only NR);Eukaryota;SAR;Stramenopiles;Opalinata;Proteromonadea;";"0.0";"0";"1";"1";"0";"1";"0";"457182";"373894"
"V4mis1";"SILVA (only NR);Eukaryota;SAR;Stramenopiles;Opalinata;Proteromonadea;Proteromonas;";"0.0";"0";"1";"1";"0";"1";"0";"457182";"373894"
"V4mis1";"SILVA (only NR);Eukaryota;SAR;Stramenopiles;Peronosporomycetes;";"2.4";"18.2";"177";"169";"4";"165";"8";"457014";"373890"
"V4mis1";"SILVA (only NR);Eukaryota;SAR;Stramenopiles;Peronosporomycetes;Achlya;";"0.0";"0";"2";"2";"0";"2";"0";"457181";"373894"
"V4mis1";"SILVA (only NR);Eukaryota;SAR;Stramenopiles;Peronosporomycetes;Aphanomyces;";"0.0";"0";"6";"6";"0";"6";"0";"457177";"373894"
"V4mis1";"SILVA (only NR);Eukaryota;SAR;Stramenopiles;Peronosporomycetes;Aplanopsis;";"0.0";"0";"1";"1";"0";"1";"0";"457182";"373894"
"V4mis1";"SILVA (only NR);Eukaryota;SAR;Stramenopiles;Peronosporomycetes;Apodachlya;";"0.0";"0";"1";"1";"0";"1";"0";"457182";"373894"
"V4mis1";"SILVA (only NR);Eukaryota;SAR;Stramenopiles;Peronosporomycetes;Atkinsiella;";"0.0";"0";"1";"1";"0";"1";"0";"457182";"373894"
"V4mis1";"SILVA (only NR);Eukaryota;SAR;Stramenopiles;Peronosporomycetes;Eurychasma;";"0.0";"0";"1";"1";"0";"1";"0";"457182";"373894"
"V4mis1";"SILVA (only NR);Eukaryota;SAR;Stramenopiles;Peronosporomycetes;Haliphthoros;";"0.0";"0";"4";"4";"0";"4";"0";"457179";"373894"
"V4mis1";"SILVA (only NR);Eukaryota;SAR;Stramenopiles;Peronosporomycetes;Halodaphnea;";"0.0";"0";"2";"2";"0";"2";"0";"457181";"373894"
"V4mis1";"SILVA (only NR);Eukaryota;SAR;Stramenopiles;Peronosporomycetes;Halophytophthora;";"0.0";"0";"7";"7";"0";"7";"0";"457176";"373894"
"V4mis1";"SILVA (only NR);Eukaryota;SAR;Stramenopiles;Peronosporomycetes;Haptoglossa;";"0.0";"0";"5";"5";"0";"5";"0";"457178";"373894"
"V4mis1";"SILVA (only NR);Eukaryota;SAR;Stramenopiles;Peronosporomycetes;Lagenidium;";"0.0";"0";"4";"4";"0";"4";"0";"457179";"373894"
"V4mis1";"SILVA (only NR);Eukaryota;SAR;Stramenopiles;Peronosporomycetes;Leptolegnia;";"0.0";"0";"2";"2";"0";"2";"0";"457181";"373894"
"V4mis1";"SILVA (only NR);Eukaryota;SAR;Stramenopiles;Peronosporomycetes;Myzocytiopsis;";"0.0";"0";"3";"3";"0";"3";"0";"457180";"373894"
"V4mis1";"SILVA (only NR);Eukaryota;SAR;Stramenopiles;Peronosporomycetes;Olpidiopsis;";"0.0";"0";"5";"5";"0";"5";"0";"457178";"373894"
"V4mis1";"SILVA (only NR);Eukaryota;SAR;Stramenopiles;Peronosporomycetes;Phytophthora;";"7.7";"18.2";"52";"52";"4";"48";"0";"457131";"373890"
"V4mis1";"SILVA (only NR);Eukaryota;SAR;Stramenopiles;Peronosporomycetes;Phytopythium;";"0.0";"0";"3";"3";"0";"3";"0";"457180";"373894"
"V4mis1";"SILVA (only NR);Eukaryota;SAR;Stramenopiles;Peronosporomycetes;Pythium;";"0.0";"0";"23";"23";"0";"23";"0";"457160";"373894"
"V4mis1";"SILVA (only NR);Eukaryota;SAR;Stramenopiles;Peronosporomycetes;Salispina;";"0.0";"0";"2";"2";"0";"2";"0";"457181";"373894"
"V4mis1";"SILVA (only NR);Eukaryota;SAR;Stramenopiles;Peronosporomycetes;Saprolegnia;";"0.0";"0";"3";"3";"0";"3";"0";"457180";"373894"
"V4mis1";"SILVA (only NR);Eukaryota;SAR;Stramenopiles;Peronosporomycetes;Sapromyces;";"0.0";"0";"1";"1";"0";"1";"0";"457182";"373894"
"V4mis1";"SILVA (only NR);Eukaryota;SAR;Stramenopiles;Peronosporomycetes;uncultured;";"0.0";"0";"25";"17";"0";"17";"8";"457166";"373894"
"V4mis1";"SILVA (only NR);Eukaryota;SAR;Stramenopiles;Placididea;";"88.9";"18.2";"9";"9";"8";"1";"0";"457174";"373886"
"V4mis1";"SILVA (only NR);Eukaryota;SAR;Stramenopiles;Placididea;Placidia;";"50.0";"18.2";"2";"2";"1";"1";"0";"457181";"373893"
"V4mis1";"SILVA (only NR);Eukaryota;SAR;Stramenopiles;Placididea;Suigetsumonas;";"100.0";"18.2";"3";"3";"3";"0";"0";"457180";"373891"
"V4mis1";"SILVA (only NR);Eukaryota;SAR;Stramenopiles;Placididea;Wobblia;";"100.0";"18.2";"2";"2";"2";"0";"0";"457181";"373892"
"V4mis1";"SILVA (only NR);Eukaryota;SAR;Stramenopiles;uncultured;";"40.0";"18.2";"12";"10";"4";"6";"2";"457173";"373890"
"V4mis1";"SILVA (only NR);Eukaryota;uncultured;";"0.0";"0";"11";"11";"0";"11";"0";"457172";"373894"
"V4mis1";"SILVA (only NR);";"81.8";"100";"458561";"457262";"373967";"83295";"1299";"0";"0"
